"datetime","season","holiday","workingday","weather","temp","casual","registered","count"
"2011-01-01 00:00:00",1,0,0,1,9.84,3,13,16
"2011-01-01 01:00:00",1,0,0,1,9.02,8,32,40
"2011-01-01 02:00:00",1,0,0,1,9.02,5,27,32
"2011-01-01 03:00:00",1,0,0,1,9.84,3,10,13
"2011-01-01 04:00:00",1,0,0,1,9.84,0,1,1
"2011-01-01 05:00:00",1,0,0,2,9.84,0,1,1
"2011-01-01 06:00:00",1,0,0,1,9.02,2,0,2
"2011-01-01 07:00:00",1,0,0,1,8.2,1,2,3
"2011-01-01 08:00:00",1,0,0,1,9.84,1,7,8
"2011-01-01 09:00:00",1,0,0,1,13.12,8,6,14
"2011-01-01 10:00:00",1,0,0,1,15.58,12,24,36
"2011-01-01 11:00:00",1,0,0,1,14.76,26,30,56
"2011-01-01 12:00:00",1,0,0,1,17.22,29,55,84
"2011-01-01 13:00:00",1,0,0,2,18.86,47,47,94
"2011-01-01 14:00:00",1,0,0,2,18.86,35,71,106
"2011-01-01 15:00:00",1,0,0,2,18.04,40,70,110
"2011-01-01 16:00:00",1,0,0,2,17.22,41,52,93
"2011-01-01 17:00:00",1,0,0,2,18.04,15,52,67
"2011-01-01 18:00:00",1,0,0,3,17.22,9,26,35
"2011-01-01 19:00:00",1,0,0,3,17.22,6,31,37
"2011-01-01 20:00:00",1,0,0,2,16.4,11,25,36
"2011-01-01 21:00:00",1,0,0,2,16.4,3,31,34
"2011-01-01 22:00:00",1,0,0,2,16.4,11,17,28
"2011-01-01 23:00:00",1,0,0,2,18.86,15,24,39
"2011-01-02 00:00:00",1,0,0,2,18.86,4,13,17
"2011-01-02 01:00:00",1,0,0,2,18.04,1,16,17
"2011-01-02 02:00:00",1,0,0,2,17.22,1,8,9
"2011-01-02 03:00:00",1,0,0,2,18.86,2,4,6
"2011-01-02 04:00:00",1,0,0,2,18.86,2,1,3
"2011-01-02 06:00:00",1,0,0,3,17.22,0,2,2
"2011-01-02 07:00:00",1,0,0,2,16.4,0,1,1
"2011-01-02 08:00:00",1,0,0,3,16.4,0,8,8
"2011-01-02 09:00:00",1,0,0,2,15.58,1,19,20
"2011-01-02 10:00:00",1,0,0,2,14.76,7,46,53
"2011-01-02 11:00:00",1,0,0,2,14.76,16,54,70
"2011-01-02 12:00:00",1,0,0,2,14.76,20,73,93
"2011-01-02 13:00:00",1,0,0,2,14.76,11,64,75
"2011-01-02 14:00:00",1,0,0,3,14.76,4,55,59
"2011-01-02 15:00:00",1,0,0,3,13.94,19,55,74
"2011-01-02 16:00:00",1,0,0,3,13.94,9,67,76
"2011-01-02 17:00:00",1,0,0,1,13.94,7,58,65
"2011-01-02 18:00:00",1,0,0,2,14.76,10,43,53
"2011-01-02 19:00:00",1,0,0,1,13.12,1,29,30
"2011-01-02 20:00:00",1,0,0,1,12.3,5,17,22
"2011-01-02 21:00:00",1,0,0,1,10.66,11,20,31
"2011-01-02 22:00:00",1,0,0,1,9.84,0,9,9
"2011-01-02 23:00:00",1,0,0,1,9.02,0,8,8
"2011-01-03 00:00:00",1,0,1,1,9.02,0,5,5
"2011-01-03 01:00:00",1,0,1,1,8.2,0,2,2
"2011-01-03 04:00:00",1,0,1,1,6.56,0,1,1
"2011-01-03 05:00:00",1,0,1,1,6.56,0,3,3
"2011-01-03 06:00:00",1,0,1,1,5.74,0,30,30
"2011-01-03 07:00:00",1,0,1,1,5.74,1,63,64
"2011-01-03 08:00:00",1,0,1,1,5.74,1,153,154
"2011-01-03 09:00:00",1,0,1,1,6.56,7,81,88
"2011-01-03 10:00:00",1,0,1,1,7.38,11,33,44
"2011-01-03 11:00:00",1,0,1,1,8.2,10,41,51
"2011-01-03 12:00:00",1,0,1,1,9.02,13,48,61
"2011-01-03 13:00:00",1,0,1,1,9.84,8,53,61
"2011-01-03 14:00:00",1,0,1,1,10.66,11,66,77
"2011-01-03 15:00:00",1,0,1,1,10.66,14,58,72
"2011-01-03 16:00:00",1,0,1,1,10.66,9,67,76
"2011-01-03 17:00:00",1,0,1,1,9.84,11,146,157
"2011-01-03 18:00:00",1,0,1,1,9.84,9,148,157
"2011-01-03 19:00:00",1,0,1,1,8.2,8,102,110
"2011-01-03 20:00:00",1,0,1,1,8.2,3,49,52
"2011-01-03 21:00:00",1,0,1,1,7.38,3,49,52
"2011-01-03 22:00:00",1,0,1,1,5.74,0,20,20
"2011-01-03 23:00:00",1,0,1,1,7.38,1,11,12
"2011-01-04 00:00:00",1,0,1,1,6.56,0,5,5
"2011-01-04 01:00:00",1,0,1,1,6.56,0,2,2
"2011-01-04 02:00:00",1,0,1,1,5.74,0,1,1
"2011-01-04 04:00:00",1,0,1,1,5.74,0,2,2
"2011-01-04 05:00:00",1,0,1,1,4.92,0,4,4
"2011-01-04 06:00:00",1,0,1,1,4.92,0,36,36
"2011-01-04 07:00:00",1,0,1,1,4.92,2,92,94
"2011-01-04 08:00:00",1,0,1,1,5.74,2,177,179
"2011-01-04 09:00:00",1,0,1,1,6.56,2,98,100
"2011-01-04 10:00:00",1,0,1,2,6.56,5,37,42
"2011-01-04 11:00:00",1,0,1,1,9.02,7,50,57
"2011-01-04 12:00:00",1,0,1,1,9.02,12,66,78
"2011-01-04 13:00:00",1,0,1,1,9.84,18,79,97
"2011-01-04 14:00:00",1,0,1,1,10.66,9,54,63
"2011-01-04 15:00:00",1,0,1,1,11.48,17,48,65
"2011-01-04 16:00:00",1,0,1,1,12.3,15,68,83
"2011-01-04 17:00:00",1,0,1,1,11.48,10,202,212
"2011-01-04 18:00:00",1,0,1,1,10.66,3,179,182
"2011-01-04 19:00:00",1,0,1,1,9.84,2,110,112
"2011-01-04 20:00:00",1,0,1,1,9.84,1,53,54
"2011-01-04 21:00:00",1,0,1,1,9.02,0,48,48
"2011-01-04 22:00:00",1,0,1,1,9.02,1,34,35
"2011-01-04 23:00:00",1,0,1,1,8.2,2,9,11
"2011-01-05 00:00:00",1,0,1,1,8.2,0,6,6
"2011-01-05 01:00:00",1,0,1,1,6.56,0,6,6
"2011-01-05 02:00:00",1,0,1,1,6.56,0,2,2
"2011-01-05 04:00:00",1,0,1,1,9.84,0,2,2
"2011-01-05 05:00:00",1,0,1,1,9.02,0,3,3
"2011-01-05 06:00:00",1,0,1,1,8.2,0,33,33
"2011-01-05 07:00:00",1,0,1,1,7.38,1,87,88
"2011-01-05 08:00:00",1,0,1,1,8.2,3,192,195
"2011-01-05 09:00:00",1,0,1,1,9.02,6,109,115
"2011-01-05 10:00:00",1,0,1,1,9.02,4,53,57
"2011-01-05 11:00:00",1,0,1,1,10.66,12,34,46
"2011-01-05 12:00:00",1,0,1,1,10.66,5,74,79
"2011-01-05 13:00:00",1,0,1,1,11.48,6,65,71
"2011-01-05 14:00:00",1,0,1,1,12.3,10,52,62
"2011-01-05 15:00:00",1,0,1,1,12.3,7,55,62
"2011-01-05 16:00:00",1,0,1,1,12.3,4,85,89
"2011-01-05 17:00:00",1,0,1,1,9.84,4,186,190
"2011-01-05 18:00:00",1,0,1,1,9.84,3,166,169
"2011-01-05 19:00:00",1,0,1,1,9.84,5,127,132
"2011-01-05 20:00:00",1,0,1,1,9.02,7,82,89
"2011-01-05 21:00:00",1,0,1,1,8.2,3,40,43
"2011-01-05 22:00:00",1,0,1,1,7.38,1,41,42
"2011-01-05 23:00:00",1,0,1,1,8.2,1,18,19
"2011-01-06 00:00:00",1,0,1,1,7.38,0,11,11
"2011-01-06 01:00:00",1,0,1,1,6.56,0,4,4
"2011-01-06 02:00:00",1,0,1,1,6.56,0,2,2
"2011-01-06 04:00:00",1,0,1,2,6.56,0,1,1
"2011-01-06 05:00:00",1,0,1,2,5.74,0,4,4
"2011-01-06 06:00:00",1,0,1,2,5.74,0,36,36
"2011-01-06 07:00:00",1,0,1,2,6.56,0,95,95
"2011-01-06 08:00:00",1,0,1,1,6.56,3,216,219
"2011-01-06 09:00:00",1,0,1,2,7.38,6,116,122
"2011-01-06 10:00:00",1,0,1,1,8.2,3,42,45
"2011-01-06 11:00:00",1,0,1,1,9.02,2,57,59
"2011-01-06 12:00:00",1,0,1,1,10.66,6,78,84
"2011-01-06 13:00:00",1,0,1,1,10.66,12,55,67
"2011-01-06 14:00:00",1,0,1,1,11.48,11,59,70
"2011-01-06 15:00:00",1,0,1,1,11.48,8,54,62
"2011-01-06 16:00:00",1,0,1,1,10.66,12,74,86
"2011-01-06 17:00:00",1,0,1,1,9.02,9,163,172
"2011-01-06 18:00:00",1,0,1,1,9.02,5,158,163
"2011-01-06 19:00:00",1,0,1,1,9.02,3,109,112
"2011-01-06 20:00:00",1,0,1,1,8.2,3,66,69
"2011-01-06 21:00:00",1,0,1,2,9.02,0,48,48
"2011-01-06 22:00:00",1,0,1,2,9.02,1,51,52
"2011-01-06 23:00:00",1,0,1,2,8.2,4,19,23
"2011-01-07 00:00:00",1,0,1,2,8.2,4,13,17
"2011-01-07 01:00:00",1,0,1,2,8.2,2,5,7
"2011-01-07 02:00:00",1,0,1,2,8.2,0,1,1
"2011-01-07 04:00:00",1,0,1,2,8.2,0,1,1
"2011-01-07 05:00:00",1,0,1,3,9.02,0,5,5
"2011-01-07 06:00:00",1,0,1,2,8.2,8,26,34
"2011-01-07 07:00:00",1,0,1,1,8.2,8,76,84
"2011-01-07 08:00:00",1,0,1,1,8.2,20,190,210
"2011-01-07 09:00:00",1,0,1,1,8.2,9,125,134
"2011-01-07 10:00:00",1,0,1,1,9.02,16,47,63
"2011-01-07 11:00:00",1,0,1,2,8.2,19,48,67
"2011-01-07 12:00:00",1,0,1,2,8.2,9,50,59
"2011-01-07 13:00:00",1,0,1,2,8.2,9,64,73
"2011-01-07 14:00:00",1,0,1,2,8.2,7,43,50
"2011-01-07 15:00:00",1,0,1,2,8.2,9,63,72
"2011-01-07 16:00:00",1,0,1,2,8.2,5,82,87
"2011-01-07 17:00:00",1,0,1,2,8.2,9,178,187
"2011-01-07 18:00:00",1,0,1,1,8.2,7,116,123
"2011-01-07 19:00:00",1,0,1,1,6.56,3,92,95
"2011-01-07 20:00:00",1,0,1,1,7.38,1,50,51
"2011-01-07 21:00:00",1,0,1,1,7.38,0,39,39
"2011-01-07 22:00:00",1,0,1,2,7.38,2,34,36
"2011-01-07 23:00:00",1,0,1,2,7.38,1,14,15
"2011-01-08 00:00:00",1,0,0,2,7.38,1,24,25
"2011-01-08 01:00:00",1,0,0,2,7.38,1,15,16
"2011-01-08 02:00:00",1,0,0,2,7.38,3,13,16
"2011-01-08 03:00:00",1,0,0,3,7.38,0,7,7
"2011-01-08 04:00:00",1,0,0,3,7.38,0,1,1
"2011-01-08 05:00:00",1,0,0,2,6.56,0,5,5
"2011-01-08 06:00:00",1,0,0,2,6.56,0,2,2
"2011-01-08 07:00:00",1,0,0,2,6.56,1,8,9
"2011-01-08 08:00:00",1,0,0,3,6.56,0,15,15
"2011-01-08 09:00:00",1,0,0,3,6.56,0,20,20
"2011-01-08 10:00:00",1,0,0,2,7.38,5,56,61
"2011-01-08 11:00:00",1,0,0,2,8.2,2,60,62
"2011-01-08 12:00:00",1,0,0,2,8.2,8,90,98
"2011-01-08 13:00:00",1,0,0,1,8.2,7,95,102
"2011-01-08 14:00:00",1,0,0,1,8.2,12,83,95
"2011-01-08 15:00:00",1,0,0,1,8.2,5,69,74
"2011-01-08 16:00:00",1,0,0,1,7.38,8,68,76
"2011-01-08 17:00:00",1,0,0,1,6.56,5,64,69
"2011-01-08 18:00:00",1,0,0,1,5.74,3,52,55
"2011-01-08 19:00:00",1,0,0,1,5.74,4,26,30
"2011-01-08 20:00:00",1,0,0,1,4.92,0,28,28
"2011-01-08 21:00:00",1,0,0,1,4.92,2,35,37
"2011-01-08 22:00:00",1,0,0,1,4.92,1,33,34
"2011-01-08 23:00:00",1,0,0,1,4.1,0,22,22
"2011-01-09 00:00:00",1,0,0,1,4.1,1,24,25
"2011-01-09 01:00:00",1,0,0,1,4.1,0,12,12
"2011-01-09 02:00:00",1,0,0,1,4.1,0,11,11
"2011-01-09 03:00:00",1,0,0,1,4.1,0,4,4
"2011-01-09 04:00:00",1,0,0,1,3.28,0,1,1
"2011-01-09 05:00:00",1,0,0,1,3.28,0,1,1
"2011-01-09 06:00:00",1,0,0,1,4.1,0,1,1
"2011-01-09 07:00:00",1,0,0,1,3.28,1,5,6
"2011-01-09 08:00:00",1,0,0,1,4.1,0,10,10
"2011-01-09 09:00:00",1,0,0,1,4.92,0,19,19
"2011-01-09 10:00:00",1,0,0,1,5.74,0,49,49
"2011-01-09 11:00:00",1,0,0,1,6.56,2,47,49
"2011-01-09 12:00:00",1,0,0,1,7.38,4,79,83
"2011-01-09 13:00:00",1,0,0,1,8.2,6,69,75
"2011-01-09 14:00:00",1,0,0,1,9.02,8,64,72
"2011-01-09 15:00:00",1,0,0,1,9.02,5,77,82
"2011-01-09 16:00:00",1,0,0,1,8.2,13,79,92
"2011-01-09 17:00:00",1,0,0,1,7.38,3,59,62
"2011-01-09 18:00:00",1,0,0,1,6.56,4,44,48
"2011-01-09 19:00:00",1,0,0,1,6.56,1,40,41
"2011-01-09 20:00:00",1,0,0,1,5.74,0,38,38
"2011-01-09 21:00:00",1,0,0,1,5.74,1,19,20
"2011-01-09 22:00:00",1,0,0,1,5.74,5,10,15
"2011-01-09 23:00:00",1,0,0,1,4.92,0,6,6
"2011-01-10 00:00:00",1,0,1,1,4.92,2,3,5
"2011-01-10 01:00:00",1,0,1,1,4.92,1,0,1
"2011-01-10 02:00:00",1,0,1,1,4.92,0,3,3
"2011-01-10 03:00:00",1,0,1,1,4.92,0,1,1
"2011-01-10 04:00:00",1,0,1,1,4.1,1,2,3
"2011-01-10 05:00:00",1,0,1,1,4.1,0,3,3
"2011-01-10 06:00:00",1,0,1,1,4.92,0,31,31
"2011-01-10 07:00:00",1,0,1,1,4.92,2,75,77
"2011-01-10 08:00:00",1,0,1,2,4.92,4,184,188
"2011-01-10 09:00:00",1,0,1,2,5.74,2,92,94
"2011-01-10 10:00:00",1,0,1,2,5.74,0,31,31
"2011-01-10 11:00:00",1,0,1,2,6.56,2,28,30
"2011-01-10 12:00:00",1,0,1,2,8.2,5,47,52
"2011-01-10 13:00:00",1,0,1,2,8.2,4,50,54
"2011-01-10 14:00:00",1,0,1,2,8.2,0,47,47
"2011-01-10 15:00:00",1,0,1,2,8.2,2,43,45
"2011-01-10 16:00:00",1,0,1,1,8.2,4,70,74
"2011-01-10 17:00:00",1,0,1,1,8.2,4,174,178
"2011-01-10 18:00:00",1,0,1,1,8.2,1,154,155
"2011-01-10 19:00:00",1,0,1,1,6.56,3,92,95
"2011-01-10 20:00:00",1,0,1,1,6.56,1,73,74
"2011-01-10 21:00:00",1,0,1,1,5.74,1,37,38
"2011-01-10 22:00:00",1,0,1,1,5.74,2,22,24
"2011-01-10 23:00:00",1,0,1,1,5.74,0,18,18
"2011-01-11 00:00:00",1,0,1,1,5.74,2,10,12
"2011-01-11 01:00:00",1,0,1,1,5.74,0,3,3
"2011-01-11 02:00:00",1,0,1,2,6.56,0,3,3
"2011-01-11 05:00:00",1,0,1,2,6.56,0,6,6
"2011-01-11 06:00:00",1,0,1,2,6.56,0,27,27
"2011-01-11 07:00:00",1,0,1,2,6.56,2,97,99
"2011-01-11 08:00:00",1,0,1,2,7.38,3,214,217
"2011-01-11 09:00:00",1,0,1,2,7.38,3,127,130
"2011-01-11 10:00:00",1,0,1,2,8.2,3,51,54
"2011-01-11 11:00:00",1,0,1,2,8.2,4,31,35
"2011-01-11 12:00:00",1,0,1,2,8.2,2,55,57
"2011-01-11 13:00:00",1,0,1,2,8.2,6,46,52
"2011-01-11 14:00:00",1,0,1,2,8.2,3,60,63
"2011-01-11 15:00:00",1,0,1,2,6.56,2,45,47
"2011-01-11 16:00:00",1,0,1,2,6.56,4,72,76
"2011-01-11 17:00:00",1,0,1,2,6.56,6,130,136
"2011-01-11 18:00:00",1,0,1,3,6.56,1,94,95
"2011-01-11 19:00:00",1,0,1,3,6.56,0,51,51
"2011-01-11 20:00:00",1,0,1,3,6.56,0,32,32
"2011-01-11 21:00:00",1,0,1,3,6.56,0,20,20
"2011-01-11 22:00:00",1,0,1,3,6.56,1,28,29
"2011-01-11 23:00:00",1,0,1,3,6.56,1,18,19
"2011-01-12 00:00:00",1,0,1,2,6.56,0,7,7
"2011-01-12 01:00:00",1,0,1,2,6.56,0,6,6
"2011-01-12 02:00:00",1,0,1,1,5.74,0,1,1
"2011-01-12 05:00:00",1,0,1,1,5.74,0,5,5
"2011-01-12 06:00:00",1,0,1,1,4.92,0,16,16
"2011-01-12 07:00:00",1,0,1,1,5.74,0,54,54
"2011-01-12 08:00:00",1,0,1,1,6.56,3,125,128
"2011-01-12 09:00:00",1,0,1,1,6.56,3,78,81
"2011-01-12 10:00:00",1,0,1,1,7.38,0,39,39
"2011-01-12 11:00:00",1,0,1,1,8.2,3,32,35
"2011-01-12 12:00:00",1,0,1,1,8.2,3,52,55
"2011-01-12 13:00:00",1,0,1,1,9.02,0,49,49
"2011-01-12 14:00:00",1,0,1,1,8.2,0,44,44
"2011-01-12 15:00:00",1,0,1,1,8.2,1,48,49
"2011-01-12 16:00:00",1,0,1,1,9.02,5,63,68
"2011-01-12 17:00:00",1,0,1,1,8.2,0,139,139
"2011-01-12 18:00:00",1,0,1,1,8.2,2,135,137
"2011-01-12 19:00:00",1,0,1,1,7.38,1,82,83
"2011-01-12 20:00:00",1,0,1,1,6.56,2,54,56
"2011-01-12 21:00:00",1,0,1,1,6.56,0,57,57
"2011-01-12 22:00:00",1,0,1,1,6.56,1,32,33
"2011-01-12 23:00:00",1,0,1,1,5.74,1,19,20
"2011-01-13 00:00:00",1,0,1,1,5.74,1,6,7
"2011-01-13 01:00:00",1,0,1,1,5.74,0,2,2
"2011-01-13 02:00:00",1,0,1,1,5.74,0,2,2
"2011-01-13 03:00:00",1,0,1,1,5.74,0,3,3
"2011-01-13 04:00:00",1,0,1,1,5.74,0,4,4
"2011-01-13 05:00:00",1,0,1,1,5.74,0,3,3
"2011-01-13 06:00:00",1,0,1,1,4.92,0,28,28
"2011-01-13 07:00:00",1,0,1,1,4.92,0,72,72
"2011-01-13 08:00:00",1,0,1,1,5.74,5,197,202
"2011-01-13 09:00:00",1,0,1,1,5.74,2,137,139
"2011-01-13 10:00:00",1,0,1,2,6.56,2,36,38
"2011-01-13 11:00:00",1,0,1,2,8.2,4,33,37
"2011-01-13 12:00:00",1,0,1,1,8.2,3,49,52
"2011-01-13 13:00:00",1,0,1,1,9.02,2,81,83
"2011-01-13 14:00:00",1,0,1,1,9.02,3,39,42
"2011-01-13 15:00:00",1,0,1,1,9.84,5,55,60
"2011-01-13 16:00:00",1,0,1,1,9.84,2,76,78
"2011-01-13 17:00:00",1,0,1,1,8.2,4,158,162
"2011-01-13 18:00:00",1,0,1,1,8.2,3,141,144
"2011-01-13 19:00:00",1,0,1,1,6.56,1,98,99
"2011-01-13 20:00:00",1,0,1,1,6.56,0,64,64
"2011-01-13 21:00:00",1,0,1,1,5.74,0,40,40
"2011-01-13 22:00:00",1,0,1,1,5.74,0,30,30
"2011-01-13 23:00:00",1,0,1,1,4.92,1,14,15
"2011-01-14 00:00:00",1,0,1,1,4.92,0,14,14
"2011-01-14 01:00:00",1,0,1,1,4.1,0,5,5
"2011-01-14 02:00:00",1,0,1,1,4.1,0,1,1
"2011-01-14 03:00:00",1,0,1,1,4.1,0,1,1
"2011-01-14 05:00:00",1,0,1,1,4.1,0,8,8
"2011-01-14 06:00:00",1,0,1,1,4.1,0,17,17
"2011-01-14 07:00:00",1,0,1,1,4.1,0,70,70
"2011-01-14 08:00:00",1,0,1,1,4.92,2,156,158
"2011-01-14 09:00:00",1,0,1,1,5.74,0,117,117
"2011-01-14 10:00:00",1,0,1,1,7.38,4,40,44
"2011-01-14 11:00:00",1,0,1,1,7.38,6,47,53
"2011-01-14 12:00:00",1,0,1,1,8.2,2,59,61
"2011-01-14 13:00:00",1,0,1,1,9.02,4,73,77
"2011-01-14 14:00:00",1,0,1,1,9.02,5,59,64
"2011-01-14 15:00:00",1,0,1,1,9.84,9,59,68
"2011-01-14 16:00:00",1,0,1,1,9.02,3,87,90
"2011-01-14 17:00:00",1,0,1,1,9.02,4,155,159
"2011-01-14 18:00:00",1,0,1,1,8.2,5,134,139
"2011-01-14 19:00:00",1,0,1,1,6.56,3,89,92
"2011-01-14 20:00:00",1,0,1,1,7.38,0,68,68
"2011-01-14 21:00:00",1,0,1,1,6.56,4,48,52
"2011-01-14 22:00:00",1,0,1,2,6.56,2,34,36
"2011-01-14 23:00:00",1,0,1,2,7.38,1,26,27
"2011-01-15 00:00:00",1,0,0,1,7.38,3,25,28
"2011-01-15 01:00:00",1,0,0,2,6.56,2,18,20
"2011-01-15 02:00:00",1,0,0,2,6.56,0,12,12
"2011-01-15 03:00:00",1,0,0,2,6.56,1,7,8
"2011-01-15 04:00:00",1,0,0,2,6.56,0,5,5
"2011-01-15 05:00:00",1,0,0,1,6.56,0,1,1
"2011-01-15 06:00:00",1,0,0,1,5.74,1,2,3
"2011-01-15 07:00:00",1,0,0,1,5.74,1,9,10
"2011-01-15 08:00:00",1,0,0,1,5.74,1,22,23
"2011-01-15 09:00:00",1,0,0,1,6.56,2,31,33
"2011-01-15 10:00:00",1,0,0,1,7.38,2,57,59
"2011-01-15 11:00:00",1,0,0,1,8.2,18,54,72
"2011-01-15 12:00:00",1,0,0,1,9.84,15,74,89
"2011-01-15 13:00:00",1,0,0,1,11.48,21,80,101
"2011-01-15 14:00:00",1,0,0,1,12.3,26,92,118
"2011-01-15 15:00:00",1,0,0,2,13.12,21,108,129
"2011-01-15 16:00:00",1,0,0,2,13.94,33,95,128
"2011-01-15 17:00:00",1,0,0,2,13.12,29,54,83
"2011-01-15 18:00:00",1,0,0,2,12.3,15,69,84
"2011-01-15 19:00:00",1,0,0,2,13.12,14,60,74
"2011-01-15 20:00:00",1,0,0,2,13.12,6,35,41
"2011-01-15 21:00:00",1,0,0,2,13.12,6,51,57
"2011-01-15 22:00:00",1,0,0,2,12.3,0,26,26
"2011-01-15 23:00:00",1,0,0,1,12.3,5,39,44
"2011-01-16 00:00:00",1,0,0,1,10.66,6,33,39
"2011-01-16 01:00:00",1,0,0,1,10.66,4,19,23
"2011-01-16 02:00:00",1,0,0,1,10.66,3,13,16
"2011-01-16 03:00:00",1,0,0,1,9.02,9,6,15
"2011-01-16 04:00:00",1,0,0,1,10.66,0,1,1
"2011-01-16 05:00:00",1,0,0,2,10.66,1,1,2
"2011-01-16 06:00:00",1,0,0,2,10.66,0,1,1
"2011-01-16 07:00:00",1,0,0,2,9.84,0,3,3
"2011-01-16 08:00:00",1,0,0,1,9.02,0,18,18
"2011-01-16 09:00:00",1,0,0,1,9.02,3,29,32
"2011-01-16 10:00:00",1,0,0,1,9.02,8,71,79
"2011-01-16 11:00:00",1,0,0,1,9.84,23,70,93
"2011-01-16 12:00:00",1,0,0,1,9.84,29,75,104
"2011-01-16 13:00:00",1,0,0,1,10.66,23,95,118
"2011-01-16 14:00:00",1,0,0,1,11.48,22,69,91
"2011-01-16 15:00:00",1,0,0,1,10.66,35,78,113
"2011-01-16 16:00:00",1,0,0,1,9.84,22,77,99
"2011-01-16 17:00:00",1,0,0,1,9.02,23,82,105
"2011-01-16 18:00:00",1,0,0,1,8.2,11,56,67
"2011-01-16 19:00:00",1,0,0,1,7.38,14,47,61
"2011-01-16 20:00:00",1,0,0,1,7.38,7,50,57
"2011-01-16 21:00:00",1,0,0,1,7.38,6,22,28
"2011-01-16 22:00:00",1,0,0,2,8.2,2,19,21
"2011-01-16 23:00:00",1,0,0,2,8.2,0,18,18
"2011-01-17 00:00:00",1,1,0,2,8.2,1,16,17
"2011-01-17 01:00:00",1,1,0,2,8.2,1,15,16
"2011-01-17 02:00:00",1,1,0,2,7.38,0,8,8
"2011-01-17 03:00:00",1,1,0,2,7.38,0,2,2
"2011-01-17 04:00:00",1,1,0,2,7.38,1,2,3
"2011-01-17 05:00:00",1,1,0,2,7.38,0,1,1
"2011-01-17 06:00:00",1,1,0,2,7.38,0,5,5
"2011-01-17 07:00:00",1,1,0,2,6.56,4,9,13
"2011-01-17 08:00:00",1,1,0,2,6.56,3,30,33
"2011-01-17 09:00:00",1,1,0,2,6.56,8,39,47
"2011-01-17 10:00:00",1,1,0,2,6.56,7,50,57
"2011-01-17 11:00:00",1,1,0,2,6.56,9,55,64
"2011-01-17 12:00:00",1,1,0,2,7.38,10,70,80
"2011-01-17 13:00:00",1,1,0,2,7.38,13,80,93
"2011-01-17 14:00:00",1,1,0,2,7.38,12,74,86
"2011-01-17 15:00:00",1,1,0,2,8.2,21,72,93
"2011-01-17 16:00:00",1,1,0,2,8.2,6,76,82
"2011-01-17 17:00:00",1,1,0,1,8.2,4,67,71
"2011-01-17 18:00:00",1,1,0,2,7.38,7,85,92
"2011-01-17 19:00:00",1,1,0,3,7.38,2,58,60
"2011-01-17 20:00:00",1,1,0,3,6.56,4,29,33
"2011-01-17 21:00:00",1,1,0,3,6.56,3,24,27
"2011-01-17 22:00:00",1,1,0,3,5.74,0,13,13
"2011-01-17 23:00:00",1,1,0,3,6.56,1,3,4
"2011-01-18 12:00:00",1,0,1,2,8.2,0,3,3
"2011-01-18 13:00:00",1,0,1,2,8.2,0,22,22
"2011-01-18 14:00:00",1,0,1,2,9.02,2,26,28
"2011-01-18 15:00:00",1,0,1,2,9.02,3,32,35
"2011-01-18 16:00:00",1,0,1,2,9.02,0,61,61
"2011-01-18 17:00:00",1,0,1,2,9.02,1,124,125
"2011-01-18 18:00:00",1,0,1,2,9.02,1,132,133
"2011-01-18 19:00:00",1,0,1,2,9.02,1,98,99
"2011-01-18 20:00:00",1,0,1,2,9.02,0,83,83
"2011-01-18 21:00:00",1,0,1,2,9.02,0,41,41
"2011-01-18 22:00:00",1,0,1,2,9.02,0,33,33
"2011-01-18 23:00:00",1,0,1,2,9.02,1,19,20
"2011-01-19 00:00:00",1,0,1,2,9.02,0,3,3
"2011-01-19 01:00:00",1,0,1,3,9.02,1,6,7
"2011-01-19 02:00:00",1,0,1,3,9.02,0,3,3
"2011-01-19 04:00:00",1,0,1,3,9.02,1,1,2
"2011-01-19 05:00:00",1,0,1,2,9.02,0,7,7
"2011-01-19 06:00:00",1,0,1,2,9.02,0,32,32
"2011-01-19 07:00:00",1,0,1,2,9.84,1,89,90
"2011-01-19 08:00:00",1,0,1,2,9.84,1,196,197
"2011-01-19 09:00:00",1,0,1,2,9.84,2,107,109
"2011-01-19 10:00:00",1,0,1,2,10.66,1,46,47
"2011-01-19 11:00:00",1,0,1,2,11.48,5,47,52
"2011-01-19 12:00:00",1,0,1,2,12.3,5,65,70
"2011-01-19 13:00:00",1,0,1,1,16.4,11,67,78
"2011-01-19 14:00:00",1,0,1,1,16.4,7,68,75
"2011-01-19 15:00:00",1,0,1,1,16.4,4,78,82
"2011-01-19 16:00:00",1,0,1,1,15.58,10,94,104
"2011-01-19 17:00:00",1,0,1,1,14.76,7,190,197
"2011-01-19 18:00:00",1,0,1,1,13.94,5,156,161
"2011-01-19 19:00:00",1,0,1,1,13.12,4,108,112
"2011-01-19 20:00:00",1,0,1,1,13.12,2,74,76
"2011-01-19 21:00:00",1,0,1,1,13.12,4,55,59
"2011-01-19 22:00:00",1,0,1,1,12.3,6,53,59
"2011-01-19 23:00:00",1,0,1,1,12.3,1,27,28
"2011-02-01 00:00:00",1,0,1,2,6.56,2,6,8
"2011-02-01 01:00:00",1,0,1,2,6.56,0,3,3
"2011-02-01 02:00:00",1,0,1,2,6.56,0,2,2
"2011-02-01 03:00:00",1,0,1,2,6.56,0,2,2
"2011-02-01 05:00:00",1,0,1,3,5.74,0,3,3
"2011-02-01 06:00:00",1,0,1,3,5.74,0,22,22
"2011-02-01 07:00:00",1,0,1,3,6.56,0,52,52
"2011-02-01 08:00:00",1,0,1,3,6.56,3,132,135
"2011-02-01 09:00:00",1,0,1,2,6.56,2,114,116
"2011-02-01 10:00:00",1,0,1,2,6.56,0,47,47
"2011-02-01 11:00:00",1,0,1,2,7.38,2,49,51
"2011-02-01 12:00:00",1,0,1,2,8.2,2,53,55
"2011-02-01 13:00:00",1,0,1,2,8.2,3,49,52
"2011-02-01 14:00:00",1,0,1,2,9.02,5,49,54
"2011-02-01 15:00:00",1,0,1,2,9.84,7,45,52
"2011-02-01 16:00:00",1,0,1,2,9.84,3,61,64
"2011-02-01 17:00:00",1,0,1,2,9.84,4,172,176
"2011-02-01 18:00:00",1,0,1,2,9.84,3,165,168
"2011-02-01 19:00:00",1,0,1,2,9.84,3,105,108
"2011-02-01 20:00:00",1,0,1,2,9.02,5,69,74
"2011-02-01 21:00:00",1,0,1,2,9.02,0,64,64
"2011-02-01 22:00:00",1,0,1,2,9.02,2,34,36
"2011-02-01 23:00:00",1,0,1,3,8.2,1,15,16
"2011-02-02 00:00:00",1,0,1,3,9.02,0,2,2
"2011-02-02 01:00:00",1,0,1,3,9.02,0,3,3
"2011-02-02 02:00:00",1,0,1,3,9.02,4,0,4
"2011-02-02 03:00:00",1,0,1,3,9.02,0,1,1
"2011-02-02 04:00:00",1,0,1,3,9.02,0,1,1
"2011-02-02 05:00:00",1,0,1,3,9.02,0,3,3
"2011-02-02 06:00:00",1,0,1,3,9.02,1,17,18
"2011-02-02 07:00:00",1,0,1,3,9.02,1,48,49
"2011-02-02 08:00:00",1,0,1,3,9.02,1,154,155
"2011-02-02 09:00:00",1,0,1,2,9.84,4,119,123
"2011-02-02 10:00:00",1,0,1,2,9.02,2,59,61
"2011-02-02 11:00:00",1,0,1,2,9.84,5,47,52
"2011-02-02 12:00:00",1,0,1,2,9.84,3,61,64
"2011-02-02 13:00:00",1,0,1,1,13.94,1,74,75
"2011-02-02 14:00:00",1,0,1,1,15.58,2,61,63
"2011-02-02 15:00:00",1,0,1,1,15.58,10,66,76
"2011-02-02 16:00:00",1,0,1,1,14.76,8,95,103
"2011-02-02 17:00:00",1,0,1,1,14.76,7,183,190
"2011-02-02 18:00:00",1,0,1,1,13.94,7,175,182
"2011-02-02 19:00:00",1,0,1,1,11.48,3,88,91
"2011-02-02 20:00:00",1,0,1,1,9.84,4,71,75
"2011-02-02 21:00:00",1,0,1,1,9.02,1,62,63
"2011-02-02 22:00:00",1,0,1,1,9.02,5,35,40
"2011-02-02 23:00:00",1,0,1,1,8.2,3,29,32
"2011-02-03 00:00:00",1,0,1,1,8.2,1,11,12
"2011-02-03 01:00:00",1,0,1,1,8.2,0,5,5
"2011-02-03 02:00:00",1,0,1,1,7.38,0,2,2
"2011-02-03 03:00:00",1,0,1,1,7.38,0,1,1
"2011-02-03 05:00:00",1,0,1,1,6.56,0,2,2
"2011-02-03 06:00:00",1,0,1,1,6.56,0,39,39
"2011-02-03 07:00:00",1,0,1,1,5.74,1,86,87
"2011-02-03 08:00:00",1,0,1,1,5.74,4,184,188
"2011-02-03 09:00:00",1,0,1,1,6.56,6,127,133
"2011-02-03 10:00:00",1,0,1,1,7.38,2,50,52
"2011-02-03 11:00:00",1,0,1,1,7.38,9,55,64
"2011-02-03 12:00:00",1,0,1,1,8.2,2,67,69
"2011-02-03 13:00:00",1,0,1,1,8.2,4,47,51
"2011-02-03 14:00:00",1,0,1,1,9.02,4,43,47
"2011-02-03 15:00:00",1,0,1,1,9.02,4,56,60
"2011-02-03 16:00:00",1,0,1,1,9.02,5,73,78
"2011-02-03 17:00:00",1,0,1,1,8.2,5,170,175
"2011-02-03 18:00:00",1,0,1,1,8.2,2,145,147
"2011-02-03 19:00:00",1,0,1,1,8.2,4,92,96
"2011-02-03 20:00:00",1,0,1,1,8.2,1,108,109
"2011-02-03 21:00:00",1,0,1,1,7.38,1,53,54
"2011-02-03 22:00:00",1,0,1,1,7.38,2,39,41
"2011-02-03 23:00:00",1,0,1,1,8.2,4,34,38
"2011-02-04 00:00:00",1,0,1,2,8.2,3,10,13
"2011-02-04 01:00:00",1,0,1,2,6.56,0,7,7
"2011-02-04 02:00:00",1,0,1,2,5.74,0,1,1
"2011-02-04 03:00:00",1,0,1,2,5.74,0,1,1
"2011-02-04 05:00:00",1,0,1,2,5.74,0,7,7
"2011-02-04 06:00:00",1,0,1,2,6.56,2,26,28
"2011-02-04 07:00:00",1,0,1,1,5.74,0,87,87
"2011-02-04 08:00:00",1,0,1,1,5.74,3,217,220
"2011-02-04 09:00:00",1,0,1,2,6.56,3,124,127
"2011-02-04 10:00:00",1,0,1,2,8.2,5,46,51
"2011-02-04 11:00:00",1,0,1,1,9.02,3,61,64
"2011-02-04 12:00:00",1,0,1,2,9.84,8,78,86
"2011-02-04 13:00:00",1,0,1,2,10.66,9,73,82
"2011-02-04 14:00:00",1,0,1,2,11.48,15,76,91
"2011-02-04 15:00:00",1,0,1,2,11.48,9,81,90
"2011-02-04 16:00:00",1,0,1,2,12.3,8,91,99
"2011-02-04 17:00:00",1,0,1,2,10.66,10,195,205
"2011-02-04 18:00:00",1,0,1,2,9.84,3,152,155
"2011-02-04 19:00:00",1,0,1,2,9.84,1,102,103
"2011-02-04 20:00:00",1,0,1,2,9.84,2,69,71
"2011-02-04 21:00:00",1,0,1,2,9.84,2,41,43
"2011-02-04 22:00:00",1,0,1,2,9.84,1,45,46
"2011-02-04 23:00:00",1,0,1,2,9.84,1,30,31
"2011-02-05 00:00:00",1,0,0,2,9.84,3,36,39
"2011-02-05 01:00:00",1,0,0,2,9.84,1,17,18
"2011-02-05 02:00:00",1,0,0,2,9.84,5,12,17
"2011-02-05 03:00:00",1,0,0,2,9.84,1,10,11
"2011-02-05 04:00:00",1,0,0,3,9.02,0,8,8
"2011-02-05 05:00:00",1,0,0,3,8.2,0,9,9
"2011-02-05 06:00:00",1,0,0,3,8.2,0,4,4
"2011-02-05 07:00:00",1,0,0,3,9.02,0,4,4
"2011-02-05 08:00:00",1,0,0,3,8.2,0,10,10
"2011-02-05 09:00:00",1,0,0,3,8.2,3,17,20
"2011-02-05 10:00:00",1,0,0,3,8.2,3,31,34
"2011-02-05 11:00:00",1,0,0,3,9.02,1,46,47
"2011-02-05 12:00:00",1,0,0,3,9.02,10,42,52
"2011-02-05 13:00:00",1,0,0,3,9.02,10,62,72
"2011-02-05 14:00:00",1,0,0,3,9.02,5,50,55
"2011-02-05 15:00:00",1,0,0,3,9.02,11,49,60
"2011-02-05 16:00:00",1,0,0,3,9.02,8,63,71
"2011-02-05 17:00:00",1,0,0,2,9.84,14,64,78
"2011-02-05 18:00:00",1,0,0,2,11.48,2,81,83
"2011-02-05 19:00:00",1,0,0,2,11.48,6,78,84
"2011-02-05 20:00:00",1,0,0,1,12.3,5,64,69
"2011-02-05 21:00:00",1,0,0,1,10.66,3,53,56
"2011-02-05 22:00:00",1,0,0,1,10.66,2,43,45
"2011-02-05 23:00:00",1,0,0,1,10.66,7,52,59
"2011-02-06 00:00:00",1,0,0,1,10.66,2,37,39
"2011-02-06 01:00:00",1,0,0,1,10.66,4,40,44
"2011-02-06 02:00:00",1,0,0,1,10.66,0,20,20
"2011-02-06 03:00:00",1,0,0,1,10.66,3,10,13
"2011-02-06 04:00:00",1,0,0,1,10.66,0,2,2
"2011-02-06 05:00:00",1,0,0,1,10.66,0,1,1
"2011-02-06 06:00:00",1,0,0,1,10.66,0,1,1
"2011-02-06 07:00:00",1,0,0,1,9.84,0,8,8
"2011-02-06 08:00:00",1,0,0,1,9.84,2,21,23
"2011-02-06 09:00:00",1,0,0,1,11.48,7,38,45
"2011-02-06 10:00:00",1,0,0,1,12.3,15,74,89
"2011-02-06 11:00:00",1,0,0,1,13.12,28,89,117
"2011-02-06 12:00:00",1,0,0,1,13.94,48,126,174
"2011-02-06 13:00:00",1,0,0,1,13.94,47,135,182
"2011-02-06 14:00:00",1,0,0,1,13.94,47,114,161
"2011-02-06 15:00:00",1,0,0,1,13.94,52,130,182
"2011-02-06 16:00:00",1,0,0,1,13.94,42,115,157
"2011-02-06 17:00:00",1,0,0,1,13.94,24,97,121
"2011-02-06 18:00:00",1,0,0,1,12.3,13,65,78
"2011-02-06 19:00:00",1,0,0,1,11.48,1,20,21
"2011-02-06 20:00:00",1,0,0,1,11.48,5,21,26
"2011-02-06 21:00:00",1,0,0,1,10.66,5,22,27
"2011-02-06 22:00:00",1,0,0,1,10.66,5,57,62
"2011-02-06 23:00:00",1,0,0,1,9.84,4,26,30
"2011-02-07 00:00:00",1,0,1,1,9.84,1,14,15
"2011-02-07 01:00:00",1,0,1,1,9.02,1,4,5
"2011-02-07 02:00:00",1,0,1,1,8.2,0,3,3
"2011-02-07 03:00:00",1,0,1,1,8.2,0,1,1
"2011-02-07 04:00:00",1,0,1,1,8.2,1,1,2
"2011-02-07 05:00:00",1,0,1,1,8.2,1,9,10
"2011-02-07 06:00:00",1,0,1,1,7.38,1,29,30
"2011-02-07 07:00:00",1,0,1,1,7.38,6,89,95
"2011-02-07 08:00:00",1,0,1,2,6.56,7,223,230
"2011-02-07 09:00:00",1,0,1,1,9.02,3,115,118
"2011-02-07 10:00:00",1,0,1,1,9.84,6,49,55
"2011-02-07 11:00:00",1,0,1,1,12.3,11,36,47
"2011-02-07 12:00:00",1,0,1,2,13.12,7,59,66
"2011-02-07 13:00:00",1,0,1,2,14.76,10,54,64
"2011-02-07 14:00:00",1,0,1,2,14.76,8,52,60
"2011-02-07 15:00:00",1,0,1,2,15.58,4,46,50
"2011-02-07 16:00:00",1,0,1,2,14.76,16,98,114
"2011-02-07 17:00:00",1,0,1,2,13.12,9,207,216
"2011-02-07 18:00:00",1,0,1,2,13.94,5,170,175
"2011-02-07 19:00:00",1,0,1,2,13.12,5,123,128
"2011-02-07 20:00:00",1,0,1,2,13.12,6,82,88
"2011-02-07 21:00:00",1,0,1,1,13.12,3,75,78
"2011-02-07 22:00:00",1,0,1,1,11.48,3,34,37
"2011-02-07 23:00:00",1,0,1,2,12.3,6,19,25
"2011-02-08 00:00:00",1,0,1,2,11.48,4,6,10
"2011-02-08 01:00:00",1,0,1,2,11.48,0,4,4
"2011-02-08 02:00:00",1,0,1,2,10.66,1,1,2
"2011-02-08 03:00:00",1,0,1,3,11.48,0,1,1
"2011-02-08 04:00:00",1,0,1,1,10.66,0,3,3
"2011-02-08 05:00:00",1,0,1,1,10.66,0,2,2
"2011-02-08 06:00:00",1,0,1,1,10.66,0,39,39
"2011-02-08 07:00:00",1,0,1,1,9.84,3,97,100
"2011-02-08 08:00:00",1,0,1,1,9.84,7,236,243
"2011-02-08 09:00:00",1,0,1,1,9.84,7,128,135
"2011-02-08 10:00:00",1,0,1,1,9.02,4,44,48
"2011-02-08 11:00:00",1,0,1,1,9.02,1,49,50
"2011-02-08 12:00:00",1,0,1,1,9.84,2,63,65
"2011-02-08 13:00:00",1,0,1,2,9.84,2,48,50
"2011-02-08 14:00:00",1,0,1,1,9.02,3,61,64
"2011-02-08 15:00:00",1,0,1,1,9.02,6,45,51
"2011-02-08 16:00:00",1,0,1,1,9.02,4,79,83
"2011-02-08 17:00:00",1,0,1,1,9.02,4,172,176
"2011-02-08 18:00:00",1,0,1,1,8.2,1,151,152
"2011-02-08 19:00:00",1,0,1,1,6.56,1,100,101
"2011-02-08 20:00:00",1,0,1,1,6.56,3,53,56
"2011-02-08 21:00:00",1,0,1,1,5.74,8,46,54
"2011-02-08 22:00:00",1,0,1,1,4.92,0,29,29
"2011-02-08 23:00:00",1,0,1,1,4.92,3,9,12
"2011-02-09 00:00:00",1,0,1,1,4.1,0,17,17
"2011-02-09 01:00:00",1,0,1,1,4.1,0,7,7
"2011-02-09 02:00:00",1,0,1,1,3.28,1,2,3
"2011-02-09 03:00:00",1,0,1,1,2.46,0,2,2
"2011-02-09 05:00:00",1,0,1,1,2.46,0,7,7
"2011-02-09 06:00:00",1,0,1,1,2.46,0,43,43
"2011-02-09 07:00:00",1,0,1,1,2.46,4,95,99
"2011-02-09 08:00:00",1,0,1,1,4.1,1,198,199
"2011-02-09 09:00:00",1,0,1,1,4.92,4,119,123
"2011-02-09 10:00:00",1,0,1,1,5.74,8,51,59
"2011-02-09 11:00:00",1,0,1,2,5.74,1,40,41
"2011-02-09 12:00:00",1,0,1,2,7.38,4,57,61
"2011-02-09 13:00:00",1,0,1,1,7.38,2,67,69
"2011-02-09 14:00:00",1,0,1,1,8.2,2,56,58
"2011-02-09 15:00:00",1,0,1,2,8.2,3,61,64
"2011-02-09 16:00:00",1,0,1,2,8.2,7,72,79
"2011-02-09 17:00:00",1,0,1,2,8.2,9,157,166
"2011-02-09 18:00:00",1,0,1,2,7.38,2,168,170
"2011-02-09 19:00:00",1,0,1,3,5.74,1,87,88
"2011-02-09 20:00:00",1,0,1,3,5.74,0,84,84
"2011-02-09 21:00:00",1,0,1,2,5.74,0,83,83
"2011-02-09 22:00:00",1,0,1,3,6.56,4,42,46
"2011-02-09 23:00:00",1,0,1,3,6.56,0,37,37
"2011-02-10 00:00:00",1,0,1,3,5.74,0,16,16
"2011-02-10 01:00:00",1,0,1,3,5.74,0,7,7
"2011-02-10 02:00:00",1,0,1,3,5.74,0,3,3
"2011-02-10 04:00:00",1,0,1,2,5.74,0,1,1
"2011-02-10 05:00:00",1,0,1,2,4.92,0,6,6
"2011-02-10 06:00:00",1,0,1,2,4.92,0,26,26
"2011-02-10 07:00:00",1,0,1,1,4.1,0,99,99
"2011-02-10 08:00:00",1,0,1,1,4.1,5,173,178
"2011-02-10 09:00:00",1,0,1,1,4.92,1,121,122
"2011-02-10 10:00:00",1,0,1,1,4.92,1,34,35
"2011-02-10 11:00:00",1,0,1,1,5.74,1,44,45
"2011-02-10 12:00:00",1,0,1,1,6.56,4,65,69
"2011-02-10 13:00:00",1,0,1,1,7.38,3,59,62
"2011-02-10 14:00:00",1,0,1,1,8.2,6,42,48
"2011-02-10 15:00:00",1,0,1,1,8.2,0,50,50
"2011-02-10 16:00:00",1,0,1,1,8.2,4,76,80
"2011-02-10 17:00:00",1,0,1,1,7.38,6,159,165
"2011-02-10 18:00:00",1,0,1,1,6.56,3,157,160
"2011-02-10 19:00:00",1,0,1,1,5.74,2,110,112
"2011-02-10 20:00:00",1,0,1,1,5.74,4,93,97
"2011-02-10 21:00:00",1,0,1,1,5.74,2,70,72
"2011-02-10 22:00:00",1,0,1,1,4.92,4,47,51
"2011-02-10 23:00:00",1,0,1,1,4.92,1,33,34
"2011-02-11 00:00:00",1,0,1,1,4.1,2,12,14
"2011-02-11 01:00:00",1,0,1,1,4.1,1,6,7
"2011-02-11 02:00:00",1,0,1,1,4.1,0,3,3
"2011-02-11 05:00:00",1,0,1,1,3.28,0,4,4
"2011-02-11 06:00:00",1,0,1,1,4.1,1,23,24
"2011-02-11 07:00:00",1,0,1,1,3.28,1,73,74
"2011-02-11 08:00:00",1,0,1,1,4.1,4,212,216
"2011-02-11 09:00:00",1,0,1,1,4.92,8,132,140
"2011-02-11 10:00:00",1,0,1,1,5.74,5,39,44
"2011-02-11 11:00:00",1,0,1,1,9.02,12,52,64
"2011-02-11 12:00:00",1,0,1,1,9.02,7,64,71
"2011-02-11 13:00:00",1,0,1,1,9.84,21,89,110
"2011-02-11 14:00:00",1,0,1,1,12.3,17,67,84
"2011-02-11 15:00:00",1,0,1,1,13.12,12,62,74
"2011-02-11 16:00:00",1,0,1,1,12.3,14,111,125
"2011-02-11 17:00:00",1,0,1,1,12.3,18,193,211
"2011-02-11 18:00:00",1,0,1,1,11.48,9,165,174
"2011-02-11 19:00:00",1,0,1,1,10.66,7,94,101
"2011-02-11 20:00:00",1,0,1,1,9.02,2,61,63
"2011-02-11 21:00:00",1,0,1,1,8.2,1,46,47
"2011-02-11 22:00:00",1,0,1,1,8.2,2,41,43
"2011-02-11 23:00:00",1,0,1,1,7.38,5,48,53
"2011-02-12 00:00:00",1,0,0,1,6.56,3,27,30
"2011-02-12 01:00:00",1,0,0,1,5.74,2,22,24
"2011-02-12 02:00:00",1,0,0,1,5.74,2,13,15
"2011-02-12 03:00:00",1,0,0,1,4.92,3,7,10
"2011-02-12 04:00:00",1,0,0,1,4.92,0,4,4
"2011-02-12 05:00:00",1,0,0,1,4.92,0,1,1
"2011-02-12 06:00:00",1,0,0,1,4.92,1,1,2
"2011-02-12 07:00:00",1,0,0,1,4.92,2,9,11
"2011-02-12 08:00:00",1,0,0,1,5.74,2,28,30
"2011-02-12 09:00:00",1,0,0,1,6.56,5,38,43
"2011-02-12 10:00:00",1,0,0,1,9.02,13,71,84
"2011-02-12 11:00:00",1,0,0,1,12.3,30,84,114
"2011-02-12 12:00:00",1,0,0,1,12.3,27,93,120
"2011-02-12 13:00:00",1,0,0,1,12.3,32,103,135
"2011-02-12 14:00:00",1,0,0,1,13.94,30,90,120
"2011-02-12 15:00:00",1,0,0,1,13.94,47,127,174
"2011-02-12 16:00:00",1,0,0,1,13.94,42,103,145
"2011-02-12 17:00:00",1,0,0,1,13.12,24,113,137
"2011-02-12 18:00:00",1,0,0,1,11.48,4,60,64
"2011-02-12 19:00:00",1,0,0,1,11.48,2,39,41
"2011-02-12 20:00:00",1,0,0,1,10.66,1,39,40
"2011-02-12 21:00:00",1,0,0,1,10.66,9,42,51
"2011-02-12 22:00:00",1,0,0,1,9.84,6,39,45
"2011-02-12 23:00:00",1,0,0,1,9.02,1,31,32
"2011-02-13 00:00:00",1,0,0,1,8.2,5,34,39
"2011-02-13 01:00:00",1,0,0,1,8.2,1,23,24
"2011-02-13 02:00:00",1,0,0,2,8.2,1,19,20
"2011-02-13 03:00:00",1,0,0,2,8.2,4,8,12
"2011-02-13 04:00:00",1,0,0,2,8.2,0,2,2
"2011-02-13 06:00:00",1,0,0,2,8.2,2,3,5
"2011-02-13 07:00:00",1,0,0,2,9.02,0,3,3
"2011-02-13 08:00:00",1,0,0,2,9.02,1,11,12
"2011-02-13 09:00:00",1,0,0,2,9.84,12,35,47
"2011-02-13 10:00:00",1,0,0,1,12.3,19,86,105
"2011-02-13 11:00:00",1,0,0,1,13.12,26,86,112
"2011-02-13 12:00:00",1,0,0,1,14.76,58,94,152
"2011-02-13 13:00:00",1,0,0,1,15.58,62,92,154
"2011-02-13 14:00:00",1,0,0,2,16.4,51,110,161
"2011-02-13 15:00:00",1,0,0,2,16.4,40,122,162
"2011-02-13 16:00:00",1,0,0,2,17.22,28,106,134
"2011-02-13 17:00:00",1,0,0,1,17.22,30,95,125
"2011-02-13 18:00:00",1,0,0,1,16.4,17,78,95
"2011-02-13 19:00:00",1,0,0,1,16.4,11,50,61
"2011-02-13 20:00:00",1,0,0,1,16.4,15,32,47
"2011-02-13 21:00:00",1,0,0,1,16.4,6,45,51
"2011-02-13 22:00:00",1,0,0,1,16.4,5,31,36
"2011-02-13 23:00:00",1,0,0,1,16.4,3,27,30
"2011-02-14 00:00:00",1,0,1,1,15.58,3,8,11
"2011-02-14 01:00:00",1,0,1,1,15.58,1,6,7
"2011-02-14 02:00:00",1,0,1,1,14.76,0,2,2
"2011-02-14 03:00:00",1,0,1,1,13.94,1,1,2
"2011-02-14 04:00:00",1,0,1,1,13.12,0,2,2
"2011-02-14 05:00:00",1,0,1,1,13.12,0,3,3
"2011-02-14 06:00:00",1,0,1,1,13.94,1,25,26
"2011-02-14 07:00:00",1,0,1,1,13.94,2,96,98
"2011-02-14 08:00:00",1,0,1,1,15.58,7,249,256
"2011-02-14 09:00:00",1,0,1,1,16.4,8,122,130
"2011-02-14 10:00:00",1,0,1,1,18.04,9,46,55
"2011-02-14 11:00:00",1,0,1,1,21.32,10,43,53
"2011-02-14 12:00:00",1,0,1,1,22.96,27,99,126
"2011-02-14 13:00:00",1,0,1,1,23.78,27,93,120
"2011-02-14 14:00:00",1,0,1,1,24.6,14,76,90
"2011-02-14 15:00:00",1,0,1,1,22.96,19,71,90
"2011-02-14 16:00:00",1,0,1,1,21.32,16,102,118
"2011-02-14 17:00:00",1,0,1,1,18.86,25,218,243
"2011-02-14 18:00:00",1,0,1,1,16.4,11,194,205
"2011-02-14 19:00:00",1,0,1,1,15.58,12,86,98
"2011-02-14 20:00:00",1,0,1,1,14.76,5,65,70
"2011-02-14 21:00:00",1,0,1,1,14.76,8,35,43
"2011-02-14 22:00:00",1,0,1,1,13.94,1,44,45
"2011-02-14 23:00:00",1,0,1,1,13.12,1,19,20
"2011-02-15 00:00:00",1,0,1,1,12.3,7,12,19
"2011-02-15 01:00:00",1,0,1,1,12.3,0,5,5
"2011-02-15 02:00:00",1,0,1,1,11.48,1,2,3
"2011-02-15 04:00:00",1,0,1,1,9.02,0,1,1
"2011-02-15 05:00:00",1,0,1,1,9.02,0,4,4
"2011-02-15 06:00:00",1,0,1,1,8.2,0,30,30
"2011-02-15 07:00:00",1,0,1,1,8.2,2,103,105
"2011-02-15 08:00:00",1,0,1,1,8.2,10,213,223
"2011-02-15 09:00:00",1,0,1,1,9.02,2,108,110
"2011-02-15 10:00:00",1,0,1,1,9.84,5,47,52
"2011-02-15 11:00:00",1,0,1,1,10.66,11,46,57
"2011-02-15 12:00:00",1,0,1,1,11.48,6,65,71
"2011-02-15 13:00:00",1,0,1,1,13.12,14,68,82
"2011-02-15 14:00:00",1,0,1,1,13.94,10,69,79
"2011-02-15 15:00:00",1,0,1,1,13.94,11,74,85
"2011-02-15 16:00:00",1,0,1,1,13.94,21,77,98
"2011-02-15 17:00:00",1,0,1,1,13.12,15,191,206
"2011-02-15 18:00:00",1,0,1,1,12.3,14,198,212
"2011-02-15 19:00:00",1,0,1,1,11.48,3,142,145
"2011-02-15 20:00:00",1,0,1,1,10.66,3,98,101
"2011-02-15 21:00:00",1,0,1,1,9.84,5,61,66
"2011-02-15 22:00:00",1,0,1,1,9.84,0,41,41
"2011-02-15 23:00:00",1,0,1,2,9.02,0,20,20
"2011-02-16 00:00:00",1,0,1,1,9.02,0,15,15
"2011-02-16 01:00:00",1,0,1,1,8.2,0,9,9
"2011-02-16 03:00:00",1,0,1,2,8.2,0,1,1
"2011-02-16 04:00:00",1,0,1,1,8.2,0,1,1
"2011-02-16 05:00:00",1,0,1,1,8.2,0,5,5
"2011-02-16 06:00:00",1,0,1,1,8.2,1,32,33
"2011-02-16 07:00:00",1,0,1,2,8.2,5,103,108
"2011-02-16 08:00:00",1,0,1,2,9.02,6,224,230
"2011-02-16 09:00:00",1,0,1,1,9.84,2,122,124
"2011-02-16 10:00:00",1,0,1,1,10.66,14,55,69
"2011-02-16 11:00:00",1,0,1,1,13.94,7,59,66
"2011-02-16 12:00:00",1,0,1,1,15.58,14,72,86
"2011-02-16 13:00:00",1,0,1,1,17.22,13,80,93
"2011-02-16 14:00:00",1,0,1,1,18.86,17,65,82
"2011-02-16 15:00:00",1,0,1,1,18.86,35,82,117
"2011-02-16 16:00:00",1,0,1,1,18.86,26,96,122
"2011-02-16 17:00:00",1,0,1,1,18.86,11,244,255
"2011-02-16 18:00:00",1,0,1,1,16.4,20,202,222
"2011-02-16 19:00:00",1,0,1,1,13.94,18,143,161
"2011-02-16 20:00:00",1,0,1,1,15.58,10,108,118
"2011-02-16 21:00:00",1,0,1,1,14.76,5,87,92
"2011-02-16 22:00:00",1,0,1,1,13.94,12,61,73
"2011-02-16 23:00:00",1,0,1,1,15.58,2,31,33
"2011-02-17 00:00:00",1,0,1,1,13.94,1,16,17
"2011-02-17 01:00:00",1,0,1,1,13.94,0,6,6
"2011-02-17 02:00:00",1,0,1,2,13.94,2,4,6
"2011-02-17 03:00:00",1,0,1,1,13.94,3,1,4
"2011-02-17 04:00:00",1,0,1,1,13.12,3,1,4
"2011-02-17 05:00:00",1,0,1,1,13.12,1,11,12
"2011-02-17 06:00:00",1,0,1,1,12.3,3,44,47
"2011-02-17 07:00:00",1,0,1,1,13.12,7,119,126
"2011-02-17 08:00:00",1,0,1,1,13.12,18,267,285
"2011-02-17 09:00:00",1,0,1,1,14.76,16,163,179
"2011-02-17 10:00:00",1,0,1,1,15.58,18,70,88
"2011-02-17 11:00:00",1,0,1,2,18.04,19,71,90
"2011-02-17 12:00:00",1,0,1,1,19.68,15,86,101
"2011-02-17 13:00:00",1,0,1,1,22.14,15,108,123
"2011-02-17 14:00:00",1,0,1,1,24.6,26,55,81
"2011-02-17 15:00:00",1,0,1,1,24.6,15,91,106
"2011-02-17 16:00:00",1,0,1,2,22.96,29,117,146
"2011-02-17 17:00:00",1,0,1,2,23.78,18,256,274
"2011-02-17 18:00:00",1,0,1,2,22.14,11,211,222
"2011-02-17 19:00:00",1,0,1,1,19.68,14,161,175
"2011-02-17 20:00:00",1,0,1,1,19.68,8,131,139
"2011-02-17 21:00:00",1,0,1,1,21.32,5,119,124
"2011-02-17 22:00:00",1,0,1,1,20.5,8,68,76
"2011-02-17 23:00:00",1,0,1,1,18.86,4,40,44
"2011-02-18 00:00:00",1,0,1,1,18.04,12,20,32
"2011-02-18 01:00:00",1,0,1,1,18.04,1,7,8
"2011-02-18 02:00:00",1,0,1,1,18.04,2,5,7
"2011-02-18 03:00:00",1,0,1,1,18.86,2,6,8
"2011-02-18 04:00:00",1,0,1,1,18.86,0,1,1
"2011-02-18 05:00:00",1,0,1,2,18.86,1,6,7
"2011-02-18 06:00:00",1,0,1,2,18.04,2,48,50
"2011-02-18 07:00:00",1,0,1,2,17.22,8,108,116
"2011-02-18 08:00:00",1,0,1,2,17.22,26,246,272
"2011-02-18 09:00:00",1,0,1,2,17.22,15,154,169
"2011-02-18 10:00:00",1,0,1,2,18.04,17,78,95
"2011-02-18 11:00:00",1,0,1,1,18.04,31,82,113
"2011-02-18 12:00:00",1,0,1,1,20.5,59,126,185
"2011-02-18 13:00:00",1,0,1,1,24.6,45,131,176
"2011-02-18 14:00:00",1,0,1,1,27.06,73,118,191
"2011-02-18 15:00:00",1,0,1,1,27.06,55,117,172
"2011-02-18 16:00:00",1,0,1,1,27.06,68,164,232
"2011-02-18 17:00:00",1,0,1,1,27.06,52,275,327
"2011-02-18 18:00:00",1,0,1,1,26.24,29,195,224
"2011-02-18 19:00:00",1,0,1,1,25.42,16,146,162
"2011-02-18 20:00:00",1,0,1,1,24.6,19,105,124
"2011-02-18 21:00:00",1,0,1,1,23.78,11,61,72
"2011-02-18 22:00:00",1,0,1,1,22.14,19,88,107
"2011-02-18 23:00:00",1,0,1,1,21.32,16,61,77
"2011-02-19 00:00:00",1,0,0,1,19.68,6,23,29
"2011-02-19 01:00:00",1,0,0,1,18.86,10,21,31
"2011-02-19 02:00:00",1,0,0,1,18.04,3,14,17
"2011-02-19 03:00:00",1,0,0,1,17.22,0,7,7
"2011-02-19 04:00:00",1,0,0,1,16.4,0,3,3
"2011-02-19 05:00:00",1,0,0,1,16.4,0,3,3
"2011-02-19 06:00:00",1,0,0,1,16.4,3,3,6
"2011-02-19 07:00:00",1,0,0,1,15.58,6,16,22
"2011-02-19 08:00:00",1,0,0,1,15.58,9,36,45
"2011-02-19 09:00:00",1,0,0,1,16.4,18,37,55
"2011-02-19 10:00:00",1,0,0,1,17.22,34,72,106
"2011-02-19 11:00:00",1,0,0,1,18.04,47,76,123
"2011-02-19 12:00:00",1,0,0,1,18.04,38,81,119
"2011-02-19 13:00:00",1,0,0,1,18.04,52,103,155
"2011-02-19 14:00:00",1,0,0,1,18.86,102,94,196
"2011-02-19 15:00:00",1,0,0,1,18.04,84,87,171
"2011-02-19 16:00:00",1,0,0,1,18.04,39,81,120
"2011-02-19 17:00:00",1,0,0,1,17.22,36,91,127
"2011-02-19 18:00:00",1,0,0,1,14.76,21,67,88
"2011-02-19 19:00:00",1,0,0,1,13.94,5,54,59
"2011-02-19 20:00:00",1,0,0,1,13.12,9,38,47
"2011-02-19 21:00:00",1,0,0,1,13.12,4,29,33
"2011-02-19 22:00:00",1,0,0,1,12.3,2,42,44
"2011-02-19 23:00:00",1,0,0,1,11.48,4,25,29
"2011-03-01 00:00:00",1,0,1,1,12.3,0,7,7
"2011-03-01 01:00:00",1,0,1,1,10.66,0,3,3
"2011-03-01 02:00:00",1,0,1,1,9.84,0,4,4
"2011-03-01 03:00:00",1,0,1,1,9.02,0,2,2
"2011-03-01 04:00:00",1,0,1,1,9.02,0,1,1
"2011-03-01 05:00:00",1,0,1,1,8.2,1,1,2
"2011-03-01 06:00:00",1,0,1,1,8.2,0,46,46
"2011-03-01 07:00:00",1,0,1,1,8.2,2,105,107
"2011-03-01 08:00:00",1,0,1,1,8.2,10,204,214
"2011-03-01 09:00:00",1,0,1,1,9.02,8,116,124
"2011-03-01 10:00:00",1,0,1,1,9.84,13,55,68
"2011-03-01 11:00:00",1,0,1,1,11.48,8,48,56
"2011-03-01 12:00:00",1,0,1,1,12.3,6,80,86
"2011-03-01 13:00:00",1,0,1,1,13.12,13,65,78
"2011-03-01 14:00:00",1,0,1,1,13.12,18,61,79
"2011-03-01 15:00:00",1,0,1,1,13.94,7,57,64
"2011-03-01 16:00:00",1,0,1,1,13.94,10,92,102
"2011-03-01 17:00:00",1,0,1,1,13.94,12,230,242
"2011-03-01 18:00:00",1,0,1,1,13.12,10,214,224
"2011-03-01 19:00:00",1,0,1,1,12.3,4,115,119
"2011-03-01 20:00:00",1,0,1,1,12.3,2,86,88
"2011-03-01 21:00:00",1,0,1,1,10.66,8,55,63
"2011-03-01 22:00:00",1,0,1,1,9.84,3,44,47
"2011-03-01 23:00:00",1,0,1,1,9.84,2,23,25
"2011-03-02 00:00:00",1,0,1,1,9.02,3,5,8
"2011-03-02 01:00:00",1,0,1,1,9.02,0,4,4
"2011-03-02 02:00:00",1,0,1,1,9.02,0,2,2
"2011-03-02 03:00:00",1,0,1,1,9.02,3,1,4
"2011-03-02 04:00:00",1,0,1,1,8.2,1,0,1
"2011-03-02 05:00:00",1,0,1,1,9.02,0,5,5
"2011-03-02 06:00:00",1,0,1,1,9.02,1,39,40
"2011-03-02 07:00:00",1,0,1,1,9.02,2,108,110
"2011-03-02 08:00:00",1,0,1,1,9.84,13,243,256
"2011-03-02 09:00:00",1,0,1,1,11.48,7,141,148
"2011-03-02 10:00:00",1,0,1,1,13.12,11,65,76
"2011-03-02 11:00:00",1,0,1,1,13.94,8,65,73
"2011-03-02 12:00:00",1,0,1,1,16.4,20,62,82
"2011-03-02 13:00:00",1,0,1,1,20.5,35,90,125
"2011-03-02 14:00:00",1,0,1,1,21.32,21,75,96
"2011-03-02 15:00:00",1,0,1,1,22.14,19,91,110
"2011-03-02 16:00:00",1,0,1,1,22.14,27,112,139
"2011-03-02 17:00:00",1,0,1,1,20.5,30,238,268
"2011-03-02 18:00:00",1,0,1,1,18.86,8,193,201
"2011-03-02 19:00:00",1,0,1,1,16.4,6,144,150
"2011-03-02 20:00:00",1,0,1,1,14.76,9,86,95
"2011-03-02 21:00:00",1,0,1,1,13.94,3,68,71
"2011-03-02 22:00:00",1,0,1,1,12.3,4,44,48
"2011-03-02 23:00:00",1,0,1,1,10.66,0,22,22
"2011-03-03 00:00:00",1,0,1,1,9.84,3,10,13
"2011-03-03 01:00:00",1,0,1,1,9.84,0,1,1
"2011-03-03 02:00:00",1,0,1,1,8.2,1,2,3
"2011-03-03 03:00:00",1,0,1,1,8.2,0,1,1
"2011-03-03 04:00:00",1,0,1,1,6.56,0,1,1
"2011-03-03 05:00:00",1,0,1,1,5.74,1,7,8
"2011-03-03 06:00:00",1,0,1,1,5.74,1,34,35
"2011-03-03 07:00:00",1,0,1,1,4.92,1,110,111
"2011-03-03 08:00:00",1,0,1,1,5.74,4,216,220
"2011-03-03 09:00:00",1,0,1,1,6.56,10,135,145
"2011-03-03 10:00:00",1,0,1,1,7.38,7,49,56
"2011-03-03 11:00:00",1,0,1,1,8.2,10,40,50
"2011-03-03 12:00:00",1,0,1,1,9.02,7,65,72
"2011-03-03 13:00:00",1,0,1,1,9.02,13,67,80
"2011-03-03 14:00:00",1,0,1,1,9.84,18,60,78
"2011-03-03 15:00:00",1,0,1,1,9.84,6,62,68
"2011-03-03 16:00:00",1,0,1,1,10.66,6,65,71
"2011-03-03 17:00:00",1,0,1,1,10.66,17,185,202
"2011-03-03 18:00:00",1,0,1,1,9.84,6,161,167
"2011-03-03 19:00:00",1,0,1,1,8.2,5,101,106
"2011-03-03 20:00:00",1,0,1,1,8.2,1,69,70
"2011-03-03 21:00:00",1,0,1,1,7.38,3,48,51
"2011-03-03 22:00:00",1,0,1,1,8.2,3,50,53
"2011-03-03 23:00:00",1,0,1,2,7.38,0,23,23
"2011-03-04 00:00:00",1,0,1,2,8.2,0,12,12
"2011-03-04 01:00:00",1,0,1,2,7.38,0,4,4
"2011-03-04 02:00:00",1,0,1,2,7.38,0,2,2
"2011-03-04 03:00:00",1,0,1,2,7.38,0,1,1
"2011-03-04 04:00:00",1,0,1,2,7.38,1,0,1
"2011-03-04 05:00:00",1,0,1,2,6.56,0,7,7
"2011-03-04 06:00:00",1,0,1,2,6.56,1,28,29
"2011-03-04 07:00:00",1,0,1,1,6.56,0,83,83
"2011-03-04 08:00:00",1,0,1,1,7.38,6,222,228
"2011-03-04 09:00:00",1,0,1,1,9.02,12,138,150
"2011-03-04 10:00:00",1,0,1,1,9.84,10,56,66
"2011-03-04 11:00:00",1,0,1,1,11.48,16,73,89
"2011-03-04 12:00:00",1,0,1,1,13.12,10,87,97
"2011-03-04 13:00:00",1,0,1,1,13.94,13,74,87
"2011-03-04 14:00:00",1,0,1,1,14.76,30,65,95
"2011-03-04 15:00:00",1,0,1,1,14.76,31,75,106
"2011-03-04 16:00:00",1,0,1,1,14.76,17,101,118
"2011-03-04 17:00:00",1,0,1,2,14.76,22,206,228
"2011-03-04 18:00:00",1,0,1,2,13.94,15,172,187
"2011-03-04 19:00:00",1,0,1,1,13.12,5,102,107
"2011-03-04 20:00:00",1,0,1,2,12.3,9,78,87
"2011-03-04 21:00:00",1,0,1,2,12.3,6,64,70
"2011-03-04 22:00:00",1,0,1,1,12.3,4,40,44
"2011-03-04 23:00:00",1,0,1,2,12.3,6,40,46
"2011-03-05 00:00:00",1,0,0,2,11.48,4,15,19
"2011-03-05 01:00:00",1,0,0,2,12.3,5,20,25
"2011-03-05 02:00:00",1,0,0,2,12.3,5,15,20
"2011-03-05 03:00:00",1,0,0,2,12.3,0,2,2
"2011-03-05 04:00:00",1,0,0,2,12.3,0,1,1
"2011-03-05 05:00:00",1,0,0,2,12.3,0,3,3
"2011-03-05 06:00:00",1,0,0,2,12.3,1,3,4
"2011-03-05 07:00:00",1,0,0,2,12.3,5,10,15
"2011-03-05 08:00:00",1,0,0,2,12.3,11,34,45
"2011-03-05 09:00:00",1,0,0,2,13.12,15,48,63
"2011-03-05 10:00:00",1,0,0,2,13.94,34,69,103
"2011-03-05 11:00:00",1,0,0,2,16.4,43,116,159
"2011-03-05 12:00:00",1,0,0,2,18.04,46,121,167
"2011-03-05 13:00:00",1,0,0,2,18.86,60,130,190
"2011-03-05 14:00:00",1,0,0,2,19.68,80,118,198
"2011-03-05 15:00:00",1,0,0,2,18.86,83,122,205
"2011-03-05 16:00:00",1,0,0,2,19.68,74,130,204
"2011-03-05 17:00:00",1,0,0,2,19.68,60,104,164
"2011-03-05 18:00:00",1,0,0,2,19.68,37,115,152
"2011-03-05 19:00:00",1,0,0,2,18.86,27,62,89
"2011-03-05 20:00:00",1,0,0,2,18.04,12,58,70
"2011-03-05 21:00:00",1,0,0,2,18.04,12,60,72
"2011-03-05 22:00:00",1,0,0,2,17.22,16,47,63
"2011-03-05 23:00:00",1,0,0,2,18.04,10,34,44
"2011-03-06 00:00:00",1,0,0,2,17.22,11,41,52
"2011-03-06 01:00:00",1,0,0,2,17.22,12,27,39
"2011-03-06 02:00:00",1,0,0,2,16.4,5,27,32
"2011-03-06 03:00:00",1,0,0,2,17.22,2,9,11
"2011-03-06 04:00:00",1,0,0,2,17.22,0,3,3
"2011-03-06 06:00:00",1,0,0,2,17.22,1,1,2
"2011-03-06 07:00:00",1,0,0,3,17.22,0,5,5
"2011-03-06 08:00:00",1,0,0,2,16.4,1,8,9
"2011-03-06 09:00:00",1,0,0,2,17.22,4,18,22
"2011-03-06 10:00:00",1,0,0,2,17.22,4,27,31
"2011-03-06 11:00:00",1,0,0,2,17.22,18,44,62
"2011-03-06 12:00:00",1,0,0,2,18.86,10,69,79
"2011-03-06 13:00:00",1,0,0,2,18.86,22,83,105
"2011-03-06 14:00:00",1,0,0,3,18.04,12,27,39
"2011-03-06 15:00:00",1,0,0,3,18.04,3,4,7
"2011-03-06 16:00:00",1,0,0,3,14.76,3,8,11
"2011-03-06 17:00:00",1,0,0,3,13.94,2,23,25
"2011-03-06 18:00:00",1,0,0,3,13.12,0,23,23
"2011-03-06 19:00:00",1,0,0,3,12.3,0,11,11
"2011-03-06 20:00:00",1,0,0,3,11.48,3,8,11
"2011-03-06 21:00:00",1,0,0,3,9.84,1,6,7
"2011-03-06 22:00:00",1,0,0,2,9.02,0,10,10
"2011-03-06 23:00:00",1,0,0,2,9.02,0,9,9
"2011-03-07 00:00:00",1,0,1,3,8.2,0,4,4
"2011-03-07 01:00:00",1,0,1,3,8.2,0,2,2
"2011-03-07 03:00:00",1,0,1,1,8.2,0,1,1
"2011-03-07 04:00:00",1,0,1,1,8.2,1,0,1
"2011-03-07 05:00:00",1,0,1,1,8.2,0,1,1
"2011-03-07 06:00:00",1,0,1,1,8.2,3,31,34
"2011-03-07 07:00:00",1,0,1,1,8.2,3,88,91
"2011-03-07 08:00:00",1,0,1,1,8.2,11,200,211
"2011-03-07 09:00:00",1,0,1,1,9.02,5,129,134
"2011-03-07 10:00:00",1,0,1,1,9.84,15,43,58
"2011-03-07 11:00:00",1,0,1,1,10.66,19,41,60
"2011-03-07 12:00:00",1,0,1,1,12.3,28,68,96
"2011-03-07 13:00:00",1,0,1,1,13.12,16,54,70
"2011-03-07 14:00:00",1,0,1,1,13.12,21,56,77
"2011-03-07 15:00:00",1,0,1,1,13.94,32,64,96
"2011-03-07 16:00:00",1,0,1,1,13.94,26,96,122
"2011-03-07 17:00:00",1,0,1,1,13.94,27,206,233
"2011-03-07 18:00:00",1,0,1,1,13.12,19,214,233
"2011-03-07 19:00:00",1,0,1,1,12.3,11,134,145
"2011-03-07 20:00:00",1,0,1,1,12.3,5,87,92
"2011-03-07 21:00:00",1,0,1,1,11.48,1,53,54
"2011-03-07 22:00:00",1,0,1,1,10.66,1,34,35
"2011-03-07 23:00:00",1,0,1,1,11.48,0,22,22
"2011-03-08 00:00:00",1,0,1,1,10.66,1,9,10
"2011-03-08 01:00:00",1,0,1,1,9.84,0,4,4
"2011-03-08 02:00:00",1,0,1,1,9.84,1,0,1
"2011-03-08 03:00:00",1,0,1,1,9.84,5,2,7
"2011-03-08 04:00:00",1,0,1,1,9.02,0,2,2
"2011-03-08 05:00:00",1,0,1,1,8.2,2,8,10
"2011-03-08 06:00:00",1,0,1,1,8.2,3,42,45
"2011-03-08 07:00:00",1,0,1,1,7.38,9,119,128
"2011-03-08 08:00:00",1,0,1,1,9.02,10,247,257
"2011-03-08 09:00:00",1,0,1,1,10.66,11,140,151
"2011-03-08 10:00:00",1,0,1,2,12.3,25,46,71
"2011-03-08 11:00:00",1,0,1,2,14.76,26,52,78
"2011-03-08 12:00:00",1,0,1,2,14.76,29,70,99
"2011-03-08 13:00:00",1,0,1,2,15.58,25,73,98
"2011-03-08 14:00:00",1,0,1,2,15.58,16,56,72
"2011-03-08 15:00:00",1,0,1,2,14.76,35,77,112
"2011-03-08 16:00:00",1,0,1,1,15.58,26,82,108
"2011-03-08 17:00:00",1,0,1,1,14.76,39,209,248
"2011-03-08 18:00:00",1,0,1,1,13.94,21,214,235
"2011-03-08 19:00:00",1,0,1,1,13.94,9,141,150
"2011-03-08 20:00:00",1,0,1,1,13.12,2,74,76
"2011-03-08 21:00:00",1,0,1,1,12.3,7,68,75
"2011-03-08 22:00:00",1,0,1,1,12.3,11,44,55
"2011-03-08 23:00:00",1,0,1,1,11.48,3,38,41
"2011-03-09 00:00:00",1,0,1,1,10.66,0,9,9
"2011-03-09 01:00:00",1,0,1,1,10.66,0,4,4
"2011-03-09 02:00:00",1,0,1,1,10.66,1,1,2
"2011-03-09 03:00:00",1,0,1,1,9.84,1,2,3
"2011-03-09 04:00:00",1,0,1,1,9.84,0,2,2
"2011-03-09 05:00:00",1,0,1,2,9.84,1,7,8
"2011-03-09 06:00:00",1,0,1,2,9.84,5,44,49
"2011-03-09 07:00:00",1,0,1,2,9.84,18,123,141
"2011-03-09 08:00:00",1,0,1,2,9.84,11,238,249
"2011-03-09 09:00:00",1,0,1,2,10.66,5,136,141
"2011-03-09 10:00:00",1,0,1,2,12.3,8,49,57
"2011-03-09 11:00:00",1,0,1,2,13.12,15,44,59
"2011-03-09 12:00:00",1,0,1,2,13.12,14,84,98
"2011-03-09 13:00:00",1,0,1,2,13.12,17,82,99
"2011-03-09 14:00:00",1,0,1,2,13.94,10,61,71
"2011-03-09 15:00:00",1,0,1,2,14.76,15,64,79
"2011-03-09 16:00:00",1,0,1,2,13.94,10,102,112
"2011-03-09 17:00:00",1,0,1,2,13.94,18,176,194
"2011-03-09 18:00:00",1,0,1,2,13.94,12,176,188
"2011-03-09 19:00:00",1,0,1,2,13.94,11,123,134
"2011-03-09 20:00:00",1,0,1,2,13.12,4,87,91
"2011-03-09 21:00:00",1,0,1,2,13.12,10,52,62
"2011-03-09 22:00:00",1,0,1,3,13.12,4,17,21
"2011-03-09 23:00:00",1,0,1,3,13.94,1,17,18
"2011-03-10 00:00:00",1,0,1,3,13.94,3,0,3
"2011-03-10 01:00:00",1,0,1,3,13.94,0,2,2
"2011-03-10 02:00:00",1,0,1,3,13.94,0,1,1
"2011-03-10 05:00:00",1,0,1,3,14.76,1,2,3
"2011-03-10 06:00:00",1,0,1,3,14.76,0,12,12
"2011-03-10 07:00:00",1,0,1,3,15.58,1,36,37
"2011-03-10 08:00:00",1,0,1,3,15.58,1,43,44
"2011-03-10 09:00:00",1,0,1,3,16.4,1,23,24
"2011-03-10 10:00:00",1,0,1,3,16.4,0,17,17
"2011-03-10 11:00:00",1,0,1,3,16.4,6,5,11
"2011-03-10 12:00:00",1,0,1,3,17.22,4,30,34
"2011-03-10 13:00:00",1,0,1,3,17.22,1,11,12
"2011-03-10 14:00:00",1,0,1,3,18.04,0,12,12
"2011-03-10 15:00:00",1,0,1,3,18.04,3,11,14
"2011-03-10 16:00:00",1,0,1,3,17.22,1,20,21
"2011-03-10 17:00:00",1,0,1,2,18.04,2,109,111
"2011-03-10 18:00:00",1,0,1,3,18.04,2,80,82
"2011-03-10 19:00:00",1,0,1,3,18.04,5,51,56
"2011-03-10 20:00:00",1,0,1,3,14.76,9,29,38
"2011-03-10 21:00:00",1,0,1,3,14.76,1,27,28
"2011-03-10 22:00:00",1,0,1,2,13.94,4,30,34
"2011-03-10 23:00:00",1,0,1,3,13.94,1,26,27
"2011-03-11 00:00:00",1,0,1,2,13.94,0,6,6
"2011-03-11 01:00:00",1,0,1,3,13.94,0,8,8
"2011-03-11 02:00:00",1,0,1,3,13.94,2,3,5
"2011-03-11 03:00:00",1,0,1,2,13.12,0,2,2
"2011-03-11 05:00:00",1,0,1,1,12.3,1,6,7
"2011-03-11 06:00:00",1,0,1,1,10.66,1,31,32
"2011-03-11 07:00:00",1,0,1,1,10.66,10,104,114
"2011-03-11 08:00:00",1,0,1,1,11.48,15,244,259
"2011-03-11 09:00:00",1,0,1,2,12.3,13,143,156
"2011-03-11 10:00:00",1,0,1,2,13.12,18,60,78
"2011-03-11 11:00:00",1,0,1,2,13.12,14,67,81
"2011-03-11 12:00:00",1,0,1,2,13.94,15,96,111
"2011-03-11 13:00:00",1,0,1,1,14.76,15,92,107
"2011-03-11 14:00:00",1,0,1,2,14.76,25,64,89
"2011-03-11 15:00:00",1,0,1,2,13.94,21,64,85
"2011-03-11 16:00:00",1,0,1,2,13.94,18,95,113
"2011-03-11 17:00:00",1,0,1,1,13.94,23,200,223
"2011-03-11 18:00:00",1,0,1,1,13.12,19,134,153
"2011-03-11 19:00:00",1,0,1,1,12.3,7,111,118
"2011-03-11 20:00:00",1,0,1,1,12.3,6,70,76
"2011-03-11 21:00:00",1,0,1,2,12.3,10,43,53
"2011-03-11 22:00:00",1,0,1,1,12.3,11,53,64
"2011-03-11 23:00:00",1,0,1,1,12.3,3,34,37
"2011-03-12 00:00:00",1,0,0,1,10.66,4,30,34
"2011-03-12 01:00:00",1,0,0,1,9.84,3,15,18
"2011-03-12 02:00:00",1,0,0,1,9.84,0,14,14
"2011-03-12 03:00:00",1,0,0,1,9.84,1,6,7
"2011-03-12 04:00:00",1,0,0,1,9.84,0,1,1
"2011-03-12 05:00:00",1,0,0,1,9.02,0,2,2
"2011-03-12 06:00:00",1,0,0,1,9.02,2,2,4
"2011-03-12 07:00:00",1,0,0,1,9.84,4,19,23
"2011-03-12 08:00:00",1,0,0,1,10.66,9,44,53
"2011-03-12 09:00:00",1,0,0,1,11.48,25,76,101
"2011-03-12 10:00:00",1,0,0,1,13.12,21,78,99
"2011-03-12 11:00:00",1,0,0,1,13.94,36,83,119
"2011-03-12 12:00:00",1,0,0,1,13.94,51,107,158
"2011-03-12 13:00:00",1,0,0,1,14.76,62,95,157
"2011-03-12 14:00:00",1,0,0,1,16.4,70,96,166
"2011-03-12 15:00:00",1,0,0,1,17.22,81,101,182
"2011-03-12 16:00:00",1,0,0,1,18.86,100,144,244
"2011-03-12 17:00:00",1,0,0,1,18.86,99,114,213
"2011-03-12 18:00:00",1,0,0,1,17.22,54,91,145
"2011-03-12 19:00:00",1,0,0,1,17.22,26,86,112
"2011-03-12 20:00:00",1,0,0,1,16.4,22,64,86
"2011-03-12 21:00:00",1,0,0,1,15.58,36,46,82
"2011-03-12 22:00:00",1,0,0,1,14.76,7,56,63
"2011-03-12 23:00:00",1,0,0,1,15.58,11,38,49
"2011-03-13 00:00:00",1,0,0,1,15.58,3,35,38
"2011-03-13 01:00:00",1,0,0,1,14.76,10,23,33
"2011-03-13 03:00:00",1,0,0,1,13.94,6,17,23
"2011-03-13 04:00:00",1,0,0,1,13.94,4,9,13
"2011-03-13 05:00:00",1,0,0,1,14.76,0,3,3
"2011-03-13 06:00:00",1,0,0,1,13.94,0,2,2
"2011-03-13 07:00:00",1,0,0,1,14.76,2,8,10
"2011-03-13 08:00:00",1,0,0,1,16.4,11,23,34
"2011-03-13 09:00:00",1,0,0,1,16.4,8,36,44
"2011-03-13 10:00:00",1,0,0,1,17.22,36,86,122
"2011-03-13 11:00:00",1,0,0,1,18.04,88,93,181
"2011-03-13 12:00:00",1,0,0,1,18.86,74,120,194
"2011-03-13 13:00:00",1,0,0,1,18.86,97,124,221
"2011-03-13 14:00:00",1,0,0,1,18.86,144,106,250
"2011-03-13 15:00:00",1,0,0,1,19.68,149,155,304
"2011-03-13 16:00:00",1,0,0,1,18.86,124,132,256
"2011-03-13 17:00:00",1,0,0,1,18.04,98,143,241
"2011-03-13 18:00:00",1,0,0,1,16.4,55,92,147
"2011-03-13 19:00:00",1,0,0,1,14.76,28,73,101
"2011-03-13 20:00:00",1,0,0,1,13.12,23,54,77
"2011-03-13 21:00:00",1,0,0,1,12.3,9,49,58
"2011-03-13 22:00:00",1,0,0,1,12.3,8,29,37
"2011-03-13 23:00:00",1,0,0,1,10.66,5,23,28
"2011-03-14 00:00:00",1,0,1,1,10.66,4,7,11
"2011-03-14 01:00:00",1,0,1,1,10.66,0,1,1
"2011-03-14 02:00:00",1,0,1,1,10.66,0,1,1
"2011-03-14 03:00:00",1,0,1,1,10.66,0,3,3
"2011-03-14 05:00:00",1,0,1,1,9.84,0,8,8
"2011-03-14 06:00:00",1,0,1,1,10.66,1,27,28
"2011-03-14 07:00:00",1,0,1,2,11.48,4,84,88
"2011-03-14 08:00:00",1,0,1,2,12.3,24,217,241
"2011-03-14 09:00:00",1,0,1,1,13.12,13,127,140
"2011-03-14 10:00:00",1,0,1,1,13.94,27,57,84
"2011-03-14 11:00:00",1,0,1,1,14.76,26,45,71
"2011-03-14 12:00:00",1,0,1,1,15.58,40,54,94
"2011-03-14 13:00:00",1,0,1,1,15.58,24,51,75
"2011-03-14 14:00:00",1,0,1,2,15.58,27,52,79
"2011-03-14 15:00:00",1,0,1,1,15.58,24,77,101
"2011-03-14 16:00:00",1,0,1,1,16.4,27,80,107
"2011-03-14 17:00:00",1,0,1,1,15.58,42,229,271
"2011-03-14 18:00:00",1,0,1,1,14.76,25,210,235
"2011-03-14 19:00:00",1,0,1,1,14.76,17,133,150
"2011-03-14 20:00:00",1,0,1,1,13.94,23,106,129
"2011-03-14 21:00:00",1,0,1,1,13.94,5,58,63
"2011-03-14 22:00:00",1,0,1,1,13.12,4,43,47
"2011-03-14 23:00:00",1,0,1,1,13.12,2,17,19
"2011-03-15 00:00:00",1,0,1,1,13.12,7,7,14
"2011-03-15 01:00:00",1,0,1,1,12.3,4,6,10
"2011-03-15 02:00:00",1,0,1,1,12.3,1,2,3
"2011-03-15 04:00:00",1,0,1,1,9.84,1,1,2
"2011-03-15 05:00:00",1,0,1,1,9.84,0,11,11
"2011-03-15 06:00:00",1,0,1,1,9.02,3,32,35
"2011-03-15 07:00:00",1,0,1,1,9.84,10,109,119
"2011-03-15 08:00:00",1,0,1,1,10.66,23,259,282
"2011-03-15 09:00:00",1,0,1,2,12.3,10,147,157
"2011-03-15 10:00:00",1,0,1,2,13.12,22,56,78
"2011-03-15 11:00:00",1,0,1,2,13.94,27,51,78
"2011-03-15 12:00:00",1,0,1,2,14.76,32,70,102
"2011-03-15 13:00:00",1,0,1,2,14.76,23,74,97
"2011-03-15 14:00:00",1,0,1,2,15.58,14,74,88
"2011-03-15 15:00:00",1,0,1,2,15.58,24,66,90
"2011-03-15 16:00:00",1,0,1,2,15.58,21,93,114
"2011-03-15 17:00:00",1,0,1,2,14.76,22,195,217
"2011-03-15 18:00:00",1,0,1,2,14.76,18,207,225
"2011-03-15 19:00:00",1,0,1,2,13.94,14,138,152
"2011-03-15 20:00:00",1,0,1,2,13.94,9,79,88
"2011-03-15 21:00:00",1,0,1,3,13.12,2,53,55
"2011-03-15 22:00:00",1,0,1,2,13.12,1,20,21
"2011-03-15 23:00:00",1,0,1,2,13.12,1,17,18
"2011-03-16 00:00:00",1,0,1,3,12.3,0,8,8
"2011-03-16 01:00:00",1,0,1,3,12.3,1,2,3
"2011-03-16 03:00:00",1,0,1,2,11.48,1,2,3
"2011-03-16 04:00:00",1,0,1,2,12.3,0,1,1
"2011-03-16 05:00:00",1,0,1,2,12.3,0,3,3
"2011-03-16 06:00:00",1,0,1,2,12.3,1,30,31
"2011-03-16 07:00:00",1,0,1,2,12.3,10,101,111
"2011-03-16 08:00:00",1,0,1,2,13.12,26,227,253
"2011-03-16 09:00:00",1,0,1,2,13.12,10,144,154
"2011-03-16 10:00:00",1,0,1,2,14.76,19,49,68
"2011-03-16 11:00:00",1,0,1,2,14.76,13,62,75
"2011-03-16 12:00:00",1,0,1,2,16.4,23,65,88
"2011-03-16 13:00:00",1,0,1,2,16.4,18,81,99
"2011-03-16 14:00:00",1,0,1,2,16.4,33,67,100
"2011-03-16 15:00:00",1,0,1,2,16.4,22,79,101
"2011-03-16 16:00:00",1,0,1,2,16.4,30,121,151
"2011-03-16 17:00:00",1,0,1,2,18.04,37,216,253
"2011-03-16 18:00:00",1,0,1,2,18.04,26,211,237
"2011-03-16 19:00:00",1,0,1,2,18.04,18,150,168
"2011-03-16 20:00:00",1,0,1,2,17.22,10,111,121
"2011-03-16 21:00:00",1,0,1,2,17.22,3,75,78
"2011-03-16 22:00:00",1,0,1,2,16.4,11,48,59
"2011-03-16 23:00:00",1,0,1,1,16.4,9,18,27
"2011-03-17 00:00:00",1,0,1,1,15.58,4,19,23
"2011-03-17 01:00:00",1,0,1,1,14.76,1,11,12
"2011-03-17 02:00:00",1,0,1,1,13.94,3,5,8
"2011-03-17 03:00:00",1,0,1,1,13.94,1,1,2
"2011-03-17 04:00:00",1,0,1,1,13.94,0,3,3
"2011-03-17 05:00:00",1,0,1,1,13.12,0,13,13
"2011-03-17 06:00:00",1,0,1,1,13.12,4,47,51
"2011-03-17 07:00:00",1,0,1,1,13.12,12,128,140
"2011-03-17 08:00:00",1,0,1,1,14.76,17,282,299
"2011-03-17 09:00:00",1,0,1,1,16.4,23,162,185
"2011-03-17 10:00:00",1,0,1,1,18.04,9,69,78
"2011-03-17 11:00:00",1,0,1,1,18.04,20,66,86
"2011-03-17 12:00:00",1,0,1,1,20.5,24,81,105
"2011-03-17 13:00:00",1,0,1,2,21.32,26,85,111
"2011-03-17 14:00:00",1,0,1,1,20.5,32,87,119
"2011-03-17 15:00:00",1,0,1,1,21.32,30,95,125
"2011-03-17 16:00:00",1,0,1,1,20.5,34,108,142
"2011-03-17 17:00:00",1,0,1,1,20.5,48,265,313
"2011-03-17 18:00:00",1,0,1,2,18.86,50,260,310
"2011-03-17 19:00:00",1,0,1,1,18.04,18,189,207
"2011-03-17 20:00:00",1,0,1,1,17.22,25,112,137
"2011-03-17 21:00:00",1,0,1,1,17.22,19,119,138
"2011-03-17 22:00:00",1,0,1,1,16.4,17,70,87
"2011-03-17 23:00:00",1,0,1,1,17.22,7,43,50
"2011-03-18 00:00:00",1,0,1,1,17.22,5,24,29
"2011-03-18 01:00:00",1,0,1,1,16.4,4,12,16
"2011-03-18 02:00:00",1,0,1,1,16.4,5,9,14
"2011-03-18 03:00:00",1,0,1,1,14.76,1,4,5
"2011-03-18 05:00:00",1,0,1,1,15.58,2,8,10
"2011-03-18 06:00:00",1,0,1,1,16.4,1,35,36
"2011-03-18 07:00:00",1,0,1,1,16.4,11,112,123
"2011-03-18 08:00:00",1,0,1,1,17.22,24,256,280
"2011-03-18 09:00:00",1,0,1,1,18.86,18,192,210
"2011-03-18 10:00:00",1,0,1,1,21.32,43,74,117
"2011-03-18 11:00:00",1,0,1,1,22.14,55,104,159
"2011-03-18 12:00:00",1,0,1,2,22.96,72,123,195
"2011-03-18 13:00:00",1,0,1,1,26.24,57,118,175
"2011-03-18 14:00:00",1,0,1,1,27.06,71,103,174
"2011-03-18 15:00:00",1,0,1,2,27.88,62,111,173
"2011-03-18 16:00:00",1,0,1,1,27.88,67,137,204
"2011-03-18 17:00:00",1,0,1,1,28.7,95,237,332
"2011-03-18 18:00:00",1,0,1,1,27.88,84,247,331
"2011-03-18 19:00:00",1,0,1,1,27.06,58,132,190
"2011-03-18 20:00:00",1,0,1,1,25.42,46,103,149
"2011-03-18 21:00:00",1,0,1,1,25.42,22,91,113
"2011-03-18 22:00:00",1,0,1,1,25.42,55,63,118
"2011-03-18 23:00:00",1,0,1,2,24.6,26,60,86
"2011-03-19 00:00:00",1,0,0,2,24.6,26,50,76
"2011-03-19 01:00:00",1,0,0,2,23.78,16,35,51
"2011-03-19 02:00:00",1,0,0,2,22.96,5,20,25
"2011-03-19 03:00:00",1,0,0,2,22.14,1,7,8
"2011-03-19 04:00:00",1,0,0,1,21.32,1,2,3
"2011-03-19 05:00:00",1,0,0,1,21.32,0,2,2
"2011-03-19 06:00:00",1,0,0,1,18.04,0,10,10
"2011-03-19 07:00:00",1,0,0,1,16.4,4,9,13
"2011-03-19 08:00:00",1,0,0,1,17.22,11,37,48
"2011-03-19 09:00:00",1,0,0,1,17.22,35,41,76
"2011-03-19 10:00:00",1,0,0,1,18.04,55,85,140
"2011-03-19 11:00:00",1,0,0,1,18.86,90,106,196
"2011-03-19 12:00:00",1,0,0,1,18.86,126,141,267
"2011-03-19 13:00:00",1,0,0,1,20.5,174,127,301
"2011-03-19 14:00:00",1,0,0,1,20.5,168,144,312
"2011-03-19 15:00:00",1,0,0,1,20.5,170,143,313
"2011-03-19 16:00:00",1,0,0,1,20.5,175,129,304
"2011-03-19 17:00:00",1,0,0,1,19.68,138,140,278
"2011-03-19 18:00:00",1,0,0,1,18.86,92,125,217
"2011-03-19 19:00:00",1,0,0,1,18.04,38,116,154
"2011-03-19 20:00:00",1,0,0,1,17.22,39,69,108
"2011-03-19 21:00:00",1,0,0,1,16.4,20,73,93
"2011-03-19 22:00:00",1,0,0,1,16.4,27,45,72
"2011-03-19 23:00:00",1,0,0,1,15.58,13,37,50
"2011-04-01 00:00:00",2,0,1,3,10.66,0,6,6
"2011-04-01 01:00:00",2,0,1,3,10.66,0,4,4
"2011-04-01 02:00:00",2,0,1,3,10.66,0,7,7
"2011-04-01 03:00:00",2,0,1,2,9.84,0,4,4
"2011-04-01 04:00:00",2,0,1,2,9.84,0,3,3
"2011-04-01 05:00:00",2,0,1,3,9.84,1,11,12
"2011-04-01 06:00:00",2,0,1,3,9.84,2,26,28
"2011-04-01 07:00:00",2,0,1,3,9.84,4,91,95
"2011-04-01 08:00:00",2,0,1,2,10.66,8,198,206
"2011-04-01 09:00:00",2,0,1,1,13.12,11,162,173
"2011-04-01 10:00:00",2,0,1,1,13.12,12,63,75
"2011-04-01 11:00:00",2,0,1,1,13.12,17,72,89
"2011-04-01 12:00:00",2,0,1,1,13.94,15,80,95
"2011-04-01 13:00:00",2,0,1,1,14.76,18,92,110
"2011-04-01 14:00:00",2,0,1,2,14.76,26,61,87
"2011-04-01 15:00:00",2,0,1,1,13.94,30,81,111
"2011-04-01 16:00:00",2,0,1,1,13.94,42,125,167
"2011-04-01 17:00:00",2,0,1,1,13.94,36,245,281
"2011-04-01 18:00:00",2,0,1,1,13.94,36,205,241
"2011-04-01 19:00:00",2,0,1,1,13.94,16,120,136
"2011-04-01 20:00:00",2,0,1,1,13.12,2,75,77
"2011-04-01 21:00:00",2,0,1,1,13.12,9,84,93
"2011-04-01 22:00:00",2,0,1,1,12.3,10,64,74
"2011-04-01 23:00:00",2,0,1,1,12.3,12,41,53
"2011-04-02 00:00:00",2,0,0,2,12.3,3,29,32
"2011-04-02 01:00:00",2,0,0,1,10.66,4,28,32
"2011-04-02 02:00:00",2,0,0,1,9.84,1,20,21
"2011-04-02 03:00:00",2,0,0,1,9.84,1,8,9
"2011-04-02 04:00:00",2,0,0,1,9.84,0,5,5
"2011-04-02 05:00:00",2,0,0,2,9.84,1,4,5
"2011-04-02 06:00:00",2,0,0,1,10.66,5,7,12
"2011-04-02 07:00:00",2,0,0,2,10.66,2,16,18
"2011-04-02 08:00:00",2,0,0,1,12.3,10,45,55
"2011-04-02 09:00:00",2,0,0,2,13.94,22,65,87
"2011-04-02 10:00:00",2,0,0,2,14.76,41,113,154
"2011-04-02 11:00:00",2,0,0,2,16.4,72,126,198
"2011-04-02 12:00:00",2,0,0,3,13.12,84,100,184
"2011-04-02 13:00:00",2,0,0,1,13.94,56,81,137
"2011-04-02 14:00:00",2,0,0,3,13.12,97,93,190
"2011-04-02 15:00:00",2,0,0,3,13.94,72,64,136
"2011-04-02 16:00:00",2,0,0,1,15.58,111,85,196
"2011-04-02 17:00:00",2,0,0,1,15.58,89,95,184
"2011-04-02 18:00:00",2,0,0,1,15.58,69,110,179
"2011-04-02 19:00:00",2,0,0,1,14.76,71,77,148
"2011-04-02 20:00:00",2,0,0,1,13.94,29,56,85
"2011-04-02 21:00:00",2,0,0,1,13.12,24,53,77
"2011-04-02 22:00:00",2,0,0,1,13.12,14,41,55
"2011-04-02 23:00:00",2,0,0,1,13.12,20,33,53
"2011-04-03 00:00:00",2,0,0,1,12.3,8,31,39
"2011-04-03 01:00:00",2,0,0,1,12.3,8,26,34
"2011-04-03 02:00:00",2,0,0,1,10.66,5,19,24
"2011-04-03 03:00:00",2,0,0,1,12.3,3,8,11
"2011-04-03 04:00:00",2,0,0,1,11.48,3,0,3
"2011-04-03 05:00:00",2,0,0,1,11.48,1,4,5
"2011-04-03 06:00:00",2,0,0,1,11.48,10,23,33
"2011-04-03 07:00:00",2,0,0,1,13.12,13,20,33
"2011-04-03 08:00:00",2,0,0,1,13.94,18,44,62
"2011-04-03 09:00:00",2,0,0,1,14.76,68,74,142
"2011-04-03 10:00:00",2,0,0,1,16.4,111,104,215
"2011-04-03 11:00:00",2,0,0,1,17.22,139,104,243
"2011-04-03 12:00:00",2,0,0,1,18.04,166,147,313
"2011-04-03 13:00:00",2,0,0,1,18.04,219,148,367
"2011-04-03 14:00:00",2,0,0,1,18.86,240,109,349
"2011-04-03 15:00:00",2,0,0,2,18.86,174,118,292
"2011-04-03 16:00:00",2,0,0,2,18.86,147,156,303
"2011-04-03 17:00:00",2,0,0,2,18.86,148,126,274
"2011-04-03 18:00:00",2,0,0,2,18.86,71,101,172
"2011-04-03 19:00:00",2,0,0,2,17.22,51,93,144
"2011-04-03 20:00:00",2,0,0,3,17.22,24,55,79
"2011-04-03 21:00:00",2,0,0,2,17.22,8,37,45
"2011-04-03 22:00:00",2,0,0,1,16.4,7,29,36
"2011-04-03 23:00:00",2,0,0,1,16.4,9,22,31
"2011-04-04 00:00:00",2,0,1,1,16.4,1,5,6
"2011-04-04 01:00:00",2,0,1,1,16.4,7,4,11
"2011-04-04 02:00:00",2,0,1,1,15.58,1,1,2
"2011-04-04 03:00:00",2,0,1,1,15.58,1,0,1
"2011-04-04 04:00:00",2,0,1,1,15.58,1,1,2
"2011-04-04 05:00:00",2,0,1,1,16.4,0,7,7
"2011-04-04 06:00:00",2,0,1,1,17.22,3,43,46
"2011-04-04 07:00:00",2,0,1,2,18.04,7,150,157
"2011-04-04 08:00:00",2,0,1,2,18.86,31,308,339
"2011-04-04 09:00:00",2,0,1,2,20.5,24,134,158
"2011-04-04 10:00:00",2,0,1,2,22.14,35,55,90
"2011-04-04 11:00:00",2,0,1,1,24.6,58,66,124
"2011-04-04 12:00:00",2,0,1,1,26.24,59,98,157
"2011-04-04 13:00:00",2,0,1,1,27.88,47,92,139
"2011-04-04 14:00:00",2,0,1,2,30.34,47,76,123
"2011-04-04 15:00:00",2,0,1,1,31.16,47,96,143
"2011-04-04 16:00:00",2,0,1,1,31.16,59,130,189
"2011-04-04 17:00:00",2,0,1,1,30.34,83,283,366
"2011-04-04 18:00:00",2,0,1,2,29.52,78,308,386
"2011-04-04 19:00:00",2,0,1,1,28.7,51,227,278
"2011-04-04 20:00:00",2,0,1,2,28.7,40,133,173
"2011-04-04 21:00:00",2,0,1,2,28.7,19,76,95
"2011-04-04 22:00:00",2,0,1,2,27.88,17,58,75
"2011-04-04 23:00:00",2,0,1,2,26.24,18,30,48
"2011-04-05 00:00:00",2,0,1,1,25.42,10,12,22
"2011-04-05 01:00:00",2,0,1,3,25.42,10,5,15
"2011-04-05 02:00:00",2,0,1,2,22.14,0,5,5
"2011-04-05 03:00:00",2,0,1,2,22.14,1,3,4
"2011-04-05 04:00:00",2,0,1,3,20.5,0,2,2
"2011-04-05 05:00:00",2,0,1,3,18.86,0,5,5
"2011-04-05 06:00:00",2,0,1,2,19.68,2,36,38
"2011-04-05 07:00:00",2,0,1,2,19.68,10,124,134
"2011-04-05 08:00:00",2,0,1,3,15.58,9,148,157
"2011-04-05 09:00:00",2,0,1,3,14.76,2,44,46
"2011-04-05 10:00:00",2,0,1,3,13.94,3,25,28
"2011-04-05 11:00:00",2,0,1,3,13.12,1,18,19
"2011-04-05 12:00:00",2,0,1,2,13.94,6,32,38
"2011-04-05 13:00:00",2,0,1,2,14.76,5,51,56
"2011-04-05 14:00:00",2,0,1,2,14.76,9,67,76
"2011-04-05 15:00:00",2,0,1,1,16.4,6,62,68
"2011-04-05 16:00:00",2,0,1,1,15.58,17,113,130
"2011-04-05 17:00:00",2,0,1,1,17.22,27,246,273
"2011-04-05 18:00:00",2,0,1,1,15.58,19,248,267
"2011-04-05 19:00:00",2,0,1,1,14.76,12,148,160
"2011-04-05 20:00:00",2,0,1,1,13.94,4,87,91
"2011-04-05 21:00:00",2,0,1,1,13.94,8,81,89
"2011-04-05 22:00:00",2,0,1,1,13.12,3,43,46
"2011-04-05 23:00:00",2,0,1,1,12.3,3,23,26
"2011-04-06 00:00:00",2,0,1,1,12.3,0,15,15
"2011-04-06 01:00:00",2,0,1,1,10.66,0,2,2
"2011-04-06 02:00:00",2,0,1,1,9.84,0,5,5
"2011-04-06 03:00:00",2,0,1,1,10.66,0,4,4
"2011-04-06 04:00:00",2,0,1,1,9.84,0,1,1
"2011-04-06 05:00:00",2,0,1,1,9.84,1,12,13
"2011-04-06 06:00:00",2,0,1,1,9.84,4,52,56
"2011-04-06 07:00:00",2,0,1,1,10.66,3,130,133
"2011-04-06 08:00:00",2,0,1,1,13.12,17,308,325
"2011-04-06 09:00:00",2,0,1,1,14.76,8,157,165
"2011-04-06 10:00:00",2,0,1,1,16.4,21,48,69
"2011-04-06 11:00:00",2,0,1,1,17.22,23,70,93
"2011-04-06 12:00:00",2,0,1,1,18.04,22,112,134
"2011-04-06 13:00:00",2,0,1,1,18.86,29,83,112
"2011-04-06 14:00:00",2,0,1,1,20.5,35,80,115
"2011-04-06 15:00:00",2,0,1,1,21.32,34,83,117
"2011-04-06 16:00:00",2,0,1,1,22.14,27,142,169
"2011-04-06 17:00:00",2,0,1,1,21.32,53,303,356
"2011-04-06 18:00:00",2,0,1,1,21.32,43,282,325
"2011-04-06 19:00:00",2,0,1,1,20.5,36,196,232
"2011-04-06 20:00:00",2,0,1,1,18.86,15,126,141
"2011-04-06 21:00:00",2,0,1,1,18.86,18,84,102
"2011-04-06 22:00:00",2,0,1,1,18.86,13,71,84
"2011-04-06 23:00:00",2,0,1,1,18.86,11,29,40
"2011-04-07 00:00:00",2,0,1,1,18.86,5,15,20
"2011-04-07 01:00:00",2,0,1,1,17.22,2,11,13
"2011-04-07 02:00:00",2,0,1,1,17.22,0,7,7
"2011-04-07 03:00:00",2,0,1,1,14.76,0,3,3
"2011-04-07 04:00:00",2,0,1,1,13.94,0,1,1
"2011-04-07 05:00:00",2,0,1,1,13.94,0,6,6
"2011-04-07 06:00:00",2,0,1,1,13.12,5,59,64
"2011-04-07 07:00:00",2,0,1,2,13.94,8,152,160
"2011-04-07 08:00:00",2,0,1,1,14.76,23,291,314
"2011-04-07 09:00:00",2,0,1,2,16.4,15,155,170
"2011-04-07 10:00:00",2,0,1,2,17.22,29,66,95
"2011-04-07 11:00:00",2,0,1,2,18.86,36,86,122
"2011-04-07 12:00:00",2,0,1,2,18.86,39,114,153
"2011-04-07 13:00:00",2,0,1,2,21.32,36,99,135
"2011-04-07 14:00:00",2,0,1,1,22.96,46,111,157
"2011-04-07 15:00:00",2,0,1,1,24.6,27,133,160
"2011-04-07 16:00:00",2,0,1,1,24.6,52,161,213
"2011-04-07 17:00:00",2,0,1,1,21.32,63,280,343
"2011-04-07 18:00:00",2,0,1,1,19.68,68,265,333
"2011-04-07 19:00:00",2,0,1,1,18.86,34,192,226
"2011-04-07 20:00:00",2,0,1,1,18.04,37,166,203
"2011-04-07 21:00:00",2,0,1,2,18.04,19,89,108
"2011-04-07 22:00:00",2,0,1,2,16.4,18,63,81
"2011-04-07 23:00:00",2,0,1,1,15.58,9,45,54
"2011-04-08 00:00:00",2,0,1,2,14.76,4,21,25
"2011-04-08 01:00:00",2,0,1,2,13.94,3,6,9
"2011-04-08 02:00:00",2,0,1,3,13.94,3,10,13
"2011-04-08 03:00:00",2,0,1,3,13.94,0,1,1
"2011-04-08 04:00:00",2,0,1,2,13.94,0,1,1
"2011-04-08 05:00:00",2,0,1,2,13.12,1,8,9
"2011-04-08 06:00:00",2,0,1,2,13.94,2,33,35
"2011-04-08 07:00:00",2,0,1,3,13.94,4,109,113
"2011-04-08 08:00:00",2,0,1,3,13.94,13,208,221
"2011-04-08 09:00:00",2,0,1,2,14.76,17,168,185
"2011-04-08 10:00:00",2,0,1,2,14.76,10,63,73
"2011-04-08 11:00:00",2,0,1,2,16.4,19,79,98
"2011-04-08 12:00:00",2,0,1,3,15.58,29,51,80
"2011-04-08 13:00:00",2,0,1,3,14.76,7,35,42
"2011-04-08 14:00:00",2,0,1,3,13.94,2,13,15
"2011-04-08 15:00:00",2,0,1,3,13.94,1,24,25
"2011-04-08 16:00:00",2,0,1,2,13.12,2,58,60
"2011-04-08 17:00:00",2,0,1,3,13.12,10,138,148
"2011-04-08 18:00:00",2,0,1,3,13.12,8,54,62
"2011-04-08 19:00:00",2,0,1,3,12.3,1,52,53
"2011-04-08 20:00:00",2,0,1,2,12.3,12,51,63
"2011-04-08 21:00:00",2,0,1,2,12.3,11,43,54
"2011-04-08 22:00:00",2,0,1,2,12.3,9,42,51
"2011-04-08 23:00:00",2,0,1,2,12.3,4,31,35
"2011-04-09 00:00:00",2,0,0,2,12.3,5,26,31
"2011-04-09 01:00:00",2,0,0,2,12.3,3,17,20
"2011-04-09 02:00:00",2,0,0,2,13.12,2,15,17
"2011-04-09 03:00:00",2,0,0,3,12.3,3,11,14
"2011-04-09 04:00:00",2,0,0,3,12.3,0,3,3
"2011-04-09 05:00:00",2,0,0,2,12.3,0,5,5
"2011-04-09 06:00:00",2,0,0,2,12.3,0,13,13
"2011-04-09 07:00:00",2,0,0,2,12.3,8,13,21
"2011-04-09 08:00:00",2,0,0,2,13.12,7,47,54
"2011-04-09 09:00:00",2,0,0,2,13.94,27,71,98
"2011-04-09 10:00:00",2,0,0,2,13.94,43,90,133
"2011-04-09 11:00:00",2,0,0,2,14.76,51,91,142
"2011-04-09 12:00:00",2,0,0,2,14.76,79,123,202
"2011-04-09 13:00:00",2,0,0,2,14.76,114,108,222
"2011-04-09 14:00:00",2,0,0,2,14.76,94,118,212
"2011-04-09 15:00:00",2,0,0,2,14.76,85,116,201
"2011-04-09 16:00:00",2,0,0,2,15.58,73,118,191
"2011-04-09 17:00:00",2,0,0,2,15.58,128,129,257
"2011-04-09 18:00:00",2,0,0,2,15.58,48,129,177
"2011-04-09 19:00:00",2,0,0,2,15.58,47,83,130
"2011-04-09 20:00:00",2,0,0,2,15.58,19,74,93
"2011-04-09 21:00:00",2,0,0,2,14.76,10,65,75
"2011-04-09 22:00:00",2,0,0,2,14.76,21,66,87
"2011-04-09 23:00:00",2,0,0,2,15.58,12,45,57
"2011-04-10 00:00:00",2,0,0,2,15.58,5,48,53
"2011-04-10 01:00:00",2,0,0,2,15.58,6,31,37
"2011-04-10 02:00:00",2,0,0,2,15.58,12,24,36
"2011-04-10 03:00:00",2,0,0,2,15.58,5,11,16
"2011-04-10 04:00:00",2,0,0,2,14.76,3,2,5
"2011-04-10 05:00:00",2,0,0,2,14.76,0,4,4
"2011-04-10 06:00:00",2,0,0,2,14.76,0,4,4
"2011-04-10 07:00:00",2,0,0,2,14.76,3,7,10
"2011-04-10 08:00:00",2,0,0,2,15.58,17,38,55
"2011-04-10 09:00:00",2,0,0,2,15.58,31,50,81
"2011-04-10 10:00:00",2,0,0,2,16.4,69,81,150
"2011-04-10 11:00:00",2,0,0,2,16.4,93,109,202
"2011-04-10 12:00:00",2,0,0,2,17.22,94,136,230
"2011-04-10 13:00:00",2,0,0,1,18.86,121,142,263
"2011-04-10 14:00:00",2,0,0,1,20.5,148,133,281
"2011-04-10 15:00:00",2,0,0,1,20.5,156,141,297
"2011-04-10 16:00:00",2,0,0,2,21.32,135,153,288
"2011-04-10 17:00:00",2,0,0,2,21.32,84,152,236
"2011-04-10 18:00:00",2,0,0,1,20.5,103,137,240
"2011-04-10 19:00:00",2,0,0,1,20.5,47,84,131
"2011-04-10 20:00:00",2,0,0,1,18.86,21,71,92
"2011-04-10 21:00:00",2,0,0,1,18.04,18,77,95
"2011-04-10 22:00:00",2,0,0,1,18.04,12,45,57
"2011-04-10 23:00:00",2,0,0,1,18.86,5,27,32
"2011-04-11 00:00:00",2,0,1,1,19.68,7,16,23
"2011-04-11 01:00:00",2,0,1,1,18.86,1,3,4
"2011-04-11 02:00:00",2,0,1,1,18.86,7,2,9
"2011-04-11 04:00:00",2,0,1,1,18.86,0,1,1
"2011-04-11 05:00:00",2,0,1,1,18.86,1,12,13
"2011-04-11 06:00:00",2,0,1,2,18.86,2,59,61
"2011-04-11 07:00:00",2,0,1,2,20.5,12,164,176
"2011-04-11 08:00:00",2,0,1,2,21.32,28,286,314
"2011-04-11 09:00:00",2,0,1,2,22.96,33,132,165
"2011-04-11 10:00:00",2,0,1,2,22.96,41,55,96
"2011-04-11 11:00:00",2,0,1,2,24.6,45,59,104
"2011-04-11 12:00:00",2,0,1,2,24.6,37,97,134
"2011-04-11 13:00:00",2,0,1,2,26.24,62,77,139
"2011-04-11 14:00:00",2,0,1,2,29.52,60,85,145
"2011-04-11 15:00:00",2,0,1,1,30.34,56,85,141
"2011-04-11 16:00:00",2,0,1,1,30.34,73,162,235
"2011-04-11 17:00:00",2,0,1,1,30.34,100,352,452
"2011-04-11 18:00:00",2,0,1,1,29.52,93,290,383
"2011-04-11 19:00:00",2,0,1,1,29.52,73,211,284
"2011-04-11 20:00:00",2,0,1,1,27.88,44,122,166
"2011-04-11 21:00:00",2,0,1,1,27.06,39,119,158
"2011-04-11 22:00:00",2,0,1,2,26.24,25,66,91
"2011-04-11 23:00:00",2,0,1,3,23.78,16,38,54
"2011-04-12 00:00:00",2,0,1,2,25.42,11,13,24
"2011-04-12 01:00:00",2,0,1,2,25.42,6,7,13
"2011-04-12 02:00:00",2,0,1,2,24.6,7,7,14
"2011-04-12 03:00:00",2,0,1,2,23.78,0,1,1
"2011-04-12 04:00:00",2,0,1,2,22.96,4,2,6
"2011-04-12 05:00:00",2,0,1,2,22.14,1,15,16
"2011-04-12 06:00:00",2,0,1,2,22.14,3,55,58
"2011-04-12 07:00:00",2,0,1,2,22.14,12,177,189
"2011-04-12 08:00:00",2,0,1,3,19.68,15,211,226
"2011-04-12 09:00:00",2,0,1,3,18.86,4,50,54
"2011-04-12 10:00:00",2,0,1,3,20.5,6,34,40
"2011-04-12 11:00:00",2,0,1,1,21.32,11,38,49
"2011-04-12 12:00:00",2,0,1,2,22.96,9,83,92
"2011-04-12 13:00:00",2,0,1,3,22.14,22,84,106
"2011-04-12 14:00:00",2,0,1,2,20.5,16,28,44
"2011-04-12 15:00:00",2,0,1,2,19.68,24,54,78
"2011-04-12 16:00:00",2,0,1,2,19.68,19,80,99
"2011-04-12 17:00:00",2,0,1,3,18.04,29,262,291
"2011-04-12 18:00:00",2,0,1,3,18.04,21,203,224
"2011-04-12 19:00:00",2,0,1,2,17.22,3,127,130
"2011-04-12 20:00:00",2,0,1,2,17.22,9,94,103
"2011-04-12 21:00:00",2,0,1,2,17.22,10,74,84
"2011-04-12 22:00:00",2,0,1,2,16.4,7,47,54
"2011-04-12 23:00:00",2,0,1,2,16.4,8,31,39
"2011-04-13 00:00:00",2,0,1,2,16.4,3,12,15
"2011-04-13 01:00:00",2,0,1,2,16.4,0,1,1
"2011-04-13 02:00:00",2,0,1,3,16.4,0,2,2
"2011-04-13 03:00:00",2,0,1,3,16.4,0,2,2
"2011-04-13 04:00:00",2,0,1,3,16.4,1,2,3
"2011-04-13 05:00:00",2,0,1,3,15.58,1,4,5
"2011-04-13 06:00:00",2,0,1,3,15.58,1,33,34
"2011-04-13 07:00:00",2,0,1,3,14.76,3,67,70
"2011-04-13 08:00:00",2,0,1,3,15.58,6,158,164
"2011-04-13 09:00:00",2,0,1,2,15.58,2,63,65
"2011-04-13 10:00:00",2,0,1,2,16.4,4,42,46
"2011-04-13 11:00:00",2,0,1,2,17.22,4,57,61
"2011-04-13 12:00:00",2,0,1,3,17.22,12,83,95
"2011-04-13 13:00:00",2,0,1,2,18.04,6,55,61
"2011-04-13 14:00:00",2,0,1,2,17.22,24,82,106
"2011-04-13 15:00:00",2,0,1,2,18.04,12,69,81
"2011-04-13 16:00:00",2,0,1,1,18.86,23,119,142
"2011-04-13 17:00:00",2,0,1,1,18.86,25,284,309
"2011-04-13 18:00:00",2,0,1,1,18.04,28,293,321
"2011-04-13 19:00:00",2,0,1,1,18.04,15,160,175
"2011-04-13 20:00:00",2,0,1,1,18.04,7,119,126
"2011-04-13 21:00:00",2,0,1,1,17.22,17,100,117
"2011-04-13 22:00:00",2,0,1,1,17.22,10,89,99
"2011-04-13 23:00:00",2,0,1,1,16.4,5,57,62
"2011-04-14 00:00:00",2,0,1,1,15.58,3,18,21
"2011-04-14 01:00:00",2,0,1,1,15.58,1,9,10
"2011-04-14 02:00:00",2,0,1,1,14.76,0,3,3
"2011-04-14 03:00:00",2,0,1,1,13.94,0,2,2
"2011-04-14 04:00:00",2,0,1,1,13.94,1,8,9
"2011-04-14 05:00:00",2,0,1,1,13.94,2,12,14
"2011-04-14 06:00:00",2,0,1,1,13.94,4,66,70
"2011-04-14 07:00:00",2,0,1,1,15.58,11,182,193
"2011-04-14 08:00:00",2,0,1,1,17.22,21,316,337
"2011-04-14 09:00:00",2,0,1,1,18.86,18,152,170
"2011-04-14 10:00:00",2,0,1,1,20.5,21,68,89
"2011-04-14 11:00:00",2,0,1,1,21.32,28,87,115
"2011-04-14 12:00:00",2,0,1,1,22.14,35,110,145
"2011-04-14 13:00:00",2,0,1,1,22.96,38,121,159
"2011-04-14 14:00:00",2,0,1,1,22.96,36,101,137
"2011-04-14 15:00:00",2,0,1,1,24.6,57,85,142
"2011-04-14 16:00:00",2,0,1,1,24.6,49,153,202
"2011-04-14 17:00:00",2,0,1,1,24.6,50,338,388
"2011-04-14 18:00:00",2,0,1,1,22.96,47,290,337
"2011-04-14 19:00:00",2,0,1,1,22.14,37,222,259
"2011-04-14 20:00:00",2,0,1,1,20.5,22,147,169
"2011-04-14 21:00:00",2,0,1,1,18.86,19,126,145
"2011-04-14 22:00:00",2,0,1,1,19.68,22,82,104
"2011-04-14 23:00:00",2,0,1,1,18.86,7,40,47
"2011-04-15 00:00:00",2,1,0,1,18.04,6,21,27
"2011-04-15 01:00:00",2,1,0,1,18.04,6,9,15
"2011-04-15 02:00:00",2,1,0,1,16.4,8,10,18
"2011-04-15 03:00:00",2,1,0,1,16.4,0,3,3
"2011-04-15 04:00:00",2,1,0,1,15.58,0,3,3
"2011-04-15 05:00:00",2,1,0,1,14.76,2,11,13
"2011-04-15 06:00:00",2,1,0,1,14.76,5,42,47
"2011-04-15 07:00:00",2,1,0,1,16.4,10,139,149
"2011-04-15 08:00:00",2,1,0,1,18.04,21,279,300
"2011-04-15 09:00:00",2,1,0,1,20.5,16,162,178
"2011-04-15 10:00:00",2,1,0,1,20.5,31,91,122
"2011-04-15 11:00:00",2,1,0,1,21.32,41,95,136
"2011-04-15 12:00:00",2,1,0,1,21.32,45,155,200
"2011-04-15 13:00:00",2,1,0,1,22.14,47,133,180
"2011-04-15 14:00:00",2,1,0,1,22.14,57,106,163
"2011-04-15 15:00:00",2,1,0,1,22.14,50,112,162
"2011-04-15 16:00:00",2,1,0,1,21.32,70,173,243
"2011-04-15 17:00:00",2,1,0,2,20.5,64,267,331
"2011-04-15 18:00:00",2,1,0,2,18.86,47,216,263
"2011-04-15 19:00:00",2,1,0,1,17.22,41,168,209
"2011-04-15 20:00:00",2,1,0,2,16.4,26,92,118
"2011-04-15 21:00:00",2,1,0,2,16.4,25,77,102
"2011-04-15 22:00:00",2,1,0,2,15.58,16,64,80
"2011-04-15 23:00:00",2,1,0,2,14.76,8,56,64
"2011-04-16 00:00:00",2,0,0,2,14.76,7,36,43
"2011-04-16 01:00:00",2,0,0,2,14.76,5,28,33
"2011-04-16 02:00:00",2,0,0,2,14.76,5,19,24
"2011-04-16 03:00:00",2,0,0,2,14.76,5,9,14
"2011-04-16 04:00:00",2,0,0,2,14.76,1,4,5
"2011-04-16 05:00:00",2,0,0,2,15.58,1,3,4
"2011-04-16 06:00:00",2,0,0,3,16.4,1,9,10
"2011-04-16 07:00:00",2,0,0,2,16.4,3,18,21
"2011-04-16 08:00:00",2,0,0,3,16.4,7,38,45
"2011-04-16 09:00:00",2,0,0,3,16.4,2,27,29
"2011-04-16 10:00:00",2,0,0,3,17.22,1,21,22
"2011-04-16 11:00:00",2,0,0,3,17.22,4,27,31
"2011-04-16 12:00:00",2,0,0,2,18.86,6,26,32
"2011-04-16 13:00:00",2,0,0,3,18.86,9,49,58
"2011-04-16 14:00:00",2,0,0,3,21.32,14,49,63
"2011-04-16 15:00:00",2,0,0,3,21.32,16,62,78
"2011-04-16 16:00:00",2,0,0,3,20.5,6,27,33
"2011-04-16 17:00:00",2,0,0,3,20.5,1,14,15
"2011-04-16 18:00:00",2,0,0,2,20.5,6,32,38
"2011-04-16 19:00:00",2,0,0,2,21.32,9,62,71
"2011-04-16 20:00:00",2,0,0,3,18.04,4,49,53
"2011-04-16 21:00:00",2,0,0,2,18.04,1,13,14
"2011-04-16 22:00:00",2,0,0,3,17.22,2,22,24
"2011-04-16 23:00:00",2,0,0,2,18.04,5,30,35
"2011-04-17 00:00:00",2,0,0,2,18.04,4,29,33
"2011-04-17 01:00:00",2,0,0,1,17.22,6,25,31
"2011-04-17 02:00:00",2,0,0,1,16.4,4,25,29
"2011-04-17 03:00:00",2,0,0,1,16.4,12,13,25
"2011-04-17 04:00:00",2,0,0,1,14.76,2,5,7
"2011-04-17 05:00:00",2,0,0,1,14.76,2,1,3
"2011-04-17 06:00:00",2,0,0,1,14.76,3,5,8
"2011-04-17 07:00:00",2,0,0,1,14.76,2,14,16
"2011-04-17 08:00:00",2,0,0,1,15.58,7,36,43
"2011-04-17 09:00:00",2,0,0,1,16.4,31,71,102
"2011-04-17 10:00:00",2,0,0,1,17.22,91,120,211
"2011-04-17 11:00:00",2,0,0,1,18.86,119,185,304
"2011-04-17 12:00:00",2,0,0,1,18.86,167,187,354
"2011-04-17 13:00:00",2,0,0,1,20.5,181,162,343
"2011-04-17 14:00:00",2,0,0,1,21.32,170,191,361
"2011-04-17 15:00:00",2,0,0,1,22.14,179,209,388
"2011-04-17 16:00:00",2,0,0,1,22.14,161,182,343
"2011-04-17 17:00:00",2,0,0,1,22.96,143,163,306
"2011-04-17 18:00:00",2,0,0,1,22.96,102,175,277
"2011-04-17 19:00:00",2,0,0,1,22.96,75,135,210
"2011-04-17 20:00:00",2,0,0,1,21.32,44,97,141
"2011-04-17 21:00:00",2,0,0,1,20.5,13,70,83
"2011-04-17 22:00:00",2,0,0,1,20.5,21,49,70
"2011-04-17 23:00:00",2,0,0,1,18.04,19,37,56
"2011-04-18 00:00:00",2,0,1,1,18.86,15,24,39
"2011-04-18 01:00:00",2,0,1,1,18.86,11,8,19
"2011-04-18 02:00:00",2,0,1,1,17.22,14,2,16
"2011-04-18 03:00:00",2,0,1,1,17.22,6,1,7
"2011-04-18 04:00:00",2,0,1,1,16.4,2,4,6
"2011-04-18 05:00:00",2,0,1,1,16.4,0,16,16
"2011-04-18 06:00:00",2,0,1,1,16.4,3,51,54
"2011-04-18 07:00:00",2,0,1,1,18.86,12,156,168
"2011-04-18 08:00:00",2,0,1,1,18.86,20,277,297
"2011-04-18 09:00:00",2,0,1,2,20.5,37,132,169
"2011-04-18 10:00:00",2,0,1,2,21.32,41,68,109
"2011-04-18 11:00:00",2,0,1,2,22.14,36,87,123
"2011-04-18 12:00:00",2,0,1,2,22.96,60,124,184
"2011-04-18 13:00:00",2,0,1,2,22.96,41,128,169
"2011-04-18 14:00:00",2,0,1,2,23.78,49,95,144
"2011-04-18 15:00:00",2,0,1,2,24.6,64,112,176
"2011-04-18 16:00:00",2,0,1,1,24.6,40,165,205
"2011-04-18 17:00:00",2,0,1,1,23.78,66,362,428
"2011-04-18 18:00:00",2,0,1,1,26.24,41,321,362
"2011-04-18 19:00:00",2,0,1,1,22.96,42,244,286
"2011-04-18 20:00:00",2,0,1,1,24.6,29,136,165
"2011-04-18 21:00:00",2,0,1,1,22.96,20,131,151
"2011-04-18 22:00:00",2,0,1,1,21.32,9,81,90
"2011-04-18 23:00:00",2,0,1,1,20.5,11,35,46
"2011-04-19 00:00:00",2,0,1,1,20.5,2,23,25
"2011-04-19 01:00:00",2,0,1,1,18.86,5,2,7
"2011-04-19 02:00:00",2,0,1,1,18.86,8,5,13
"2011-04-19 03:00:00",2,0,1,1,19.68,0,3,3
"2011-04-19 04:00:00",2,0,1,1,18.86,1,4,5
"2011-04-19 05:00:00",2,0,1,2,18.86,1,17,18
"2011-04-19 06:00:00",2,0,1,2,19.68,2,63,65
"2011-04-19 07:00:00",2,0,1,2,21.32,22,166,188
"2011-04-19 08:00:00",2,0,1,2,20.5,20,331,351
"2011-04-19 09:00:00",2,0,1,3,21.32,23,139,162
"2011-04-19 10:00:00",2,0,1,2,20.5,15,60,75
"2011-04-19 11:00:00",2,0,1,2,22.14,19,53,72
"2011-04-19 12:00:00",2,0,1,2,22.14,19,84,103
"2011-04-19 13:00:00",2,0,1,2,22.14,26,103,129
"2011-04-19 14:00:00",2,0,1,2,22.14,19,88,107
"2011-04-19 15:00:00",2,0,1,2,22.14,44,83,127
"2011-04-19 16:00:00",2,0,1,1,22.96,30,162,192
"2011-04-19 17:00:00",2,0,1,1,22.96,39,372,411
"2011-04-19 18:00:00",2,0,1,2,22.14,44,377,421
"2011-04-19 19:00:00",2,0,1,2,20.5,28,248,276
"2011-04-19 20:00:00",2,0,1,2,20.5,20,148,168
"2011-04-19 21:00:00",2,0,1,2,20.5,8,114,122
"2011-04-19 22:00:00",2,0,1,1,19.68,3,109,112
"2011-04-19 23:00:00",2,0,1,1,18.86,11,41,52
"2011-05-01 00:00:00",2,0,0,1,17.22,19,77,96
"2011-05-01 01:00:00",2,0,0,1,17.22,9,50,59
"2011-05-01 02:00:00",2,0,0,1,17.22,7,43,50
"2011-05-01 03:00:00",2,0,0,1,16.4,8,15,23
"2011-05-01 04:00:00",2,0,0,1,16.4,6,11,17
"2011-05-01 05:00:00",2,0,0,1,16.4,0,10,10
"2011-05-01 06:00:00",2,0,0,2,16.4,4,9,13
"2011-05-01 07:00:00",2,0,0,2,17.22,7,26,33
"2011-05-01 08:00:00",2,0,0,2,18.04,16,43,59
"2011-05-01 09:00:00",2,0,0,2,18.86,45,96,141
"2011-05-01 10:00:00",2,0,0,2,19.68,109,155,264
"2011-05-01 11:00:00",2,0,0,1,18.86,109,141,250
"2011-05-01 12:00:00",2,0,0,2,19.68,109,172,281
"2011-05-01 13:00:00",2,0,0,2,20.5,123,209,332
"2011-05-01 14:00:00",2,0,0,2,20.5,85,153,238
"2011-05-01 15:00:00",2,0,0,2,20.5,113,153,266
"2011-05-01 16:00:00",2,0,0,2,20.5,75,139,214
"2011-05-01 17:00:00",2,0,0,2,19.68,60,136,196
"2011-05-01 18:00:00",2,0,0,2,18.86,33,126,159
"2011-05-01 19:00:00",2,0,0,2,18.86,47,131,178
"2011-05-01 20:00:00",2,0,0,2,18.86,35,86,121
"2011-05-01 21:00:00",2,0,0,2,18.86,23,82,105
"2011-05-01 22:00:00",2,0,0,2,18.86,32,68,100
"2011-05-01 23:00:00",2,0,0,1,18.86,64,82,146
"2011-05-02 00:00:00",2,0,1,1,18.86,68,109,177
"2011-05-02 01:00:00",2,0,1,1,18.86,41,73,114
"2011-05-02 02:00:00",2,0,1,2,18.04,16,19,35
"2011-05-02 03:00:00",2,0,1,1,18.04,9,7,16
"2011-05-02 04:00:00",2,0,1,1,18.04,9,8,17
"2011-05-02 05:00:00",2,0,1,2,18.04,4,16,20
"2011-05-02 06:00:00",2,0,1,1,18.04,3,59,62
"2011-05-02 07:00:00",2,0,1,2,18.86,16,193,209
"2011-05-02 08:00:00",2,0,1,2,19.68,21,350,371
"2011-05-02 09:00:00",2,0,1,2,20.5,41,131,172
"2011-05-02 10:00:00",2,0,1,2,22.14,31,77,108
"2011-05-02 11:00:00",2,0,1,1,23.78,34,96,130
"2011-05-02 12:00:00",2,0,1,1,25.42,40,147,187
"2011-05-02 13:00:00",2,0,1,2,25.42,51,119,170
"2011-05-02 14:00:00",2,0,1,1,26.24,48,133,181
"2011-05-02 15:00:00",2,0,1,1,27.06,45,110,155
"2011-05-02 16:00:00",2,0,1,1,27.06,49,220,269
"2011-05-02 17:00:00",2,0,1,1,27.06,65,472,537
"2011-05-02 18:00:00",2,0,1,2,26.24,68,450,518
"2011-05-02 19:00:00",2,0,1,2,25.42,46,268,314
"2011-05-02 20:00:00",2,0,1,2,25.42,44,174,218
"2011-05-02 21:00:00",2,0,1,2,24.6,54,178,232
"2011-05-02 22:00:00",2,0,1,2,24.6,28,97,125
"2011-05-02 23:00:00",2,0,1,2,22.96,16,48,64
"2011-05-03 00:00:00",2,0,1,2,22.96,0,16,16
"2011-05-03 01:00:00",2,0,1,2,22.96,0,14,14
"2011-05-03 02:00:00",2,0,1,2,22.96,0,5,5
"2011-05-03 03:00:00",2,0,1,1,22.14,0,2,2
"2011-05-03 04:00:00",2,0,1,1,21.32,3,1,4
"2011-05-03 05:00:00",2,0,1,1,21.32,0,14,14
"2011-05-03 06:00:00",2,0,1,2,21.32,7,102,109
"2011-05-03 07:00:00",2,0,1,2,22.14,17,248,265
"2011-05-03 08:00:00",2,0,1,2,22.96,24,435,459
"2011-05-03 09:00:00",2,0,1,2,24.6,29,157,186
"2011-05-03 10:00:00",2,0,1,2,26.24,36,91,127
"2011-05-03 11:00:00",2,0,1,2,27.06,20,120,140
"2011-05-03 12:00:00",2,0,1,2,27.88,48,169,217
"2011-05-03 13:00:00",2,0,1,2,28.7,50,144,194
"2011-05-03 14:00:00",2,0,1,2,28.7,36,122,158
"2011-05-03 15:00:00",2,0,1,2,28.7,37,117,154
"2011-05-03 16:00:00",2,0,1,1,29.52,46,225,271
"2011-05-03 17:00:00",2,0,1,1,28.7,53,464,517
"2011-05-03 18:00:00",2,0,1,1,28.7,59,485,544
"2011-05-03 19:00:00",2,0,1,1,27.88,42,323,365
"2011-05-03 20:00:00",2,0,1,1,27.06,28,262,290
"2011-05-03 21:00:00",2,0,1,2,26.24,42,183,225
"2011-05-03 22:00:00",2,0,1,2,23.78,14,99,113
"2011-05-03 23:00:00",2,0,1,2,22.96,12,50,62
"2011-05-04 00:00:00",2,0,1,3,21.32,5,22,27
"2011-05-04 01:00:00",2,0,1,3,20.5,1,6,7
"2011-05-04 02:00:00",2,0,1,3,20.5,0,4,4
"2011-05-04 03:00:00",2,0,1,3,17.22,0,1,1
"2011-05-04 04:00:00",2,0,1,3,15.58,1,2,3
"2011-05-04 05:00:00",2,0,1,3,14.76,1,8,9
"2011-05-04 06:00:00",2,0,1,3,13.94,0,21,21
"2011-05-04 07:00:00",2,0,1,3,13.94,6,46,52
"2011-05-04 08:00:00",2,0,1,3,13.94,5,74,79
"2011-05-04 09:00:00",2,0,1,3,13.94,5,35,40
"2011-05-04 10:00:00",2,0,1,2,13.94,5,26,31
"2011-05-04 11:00:00",2,0,1,1,16.4,3,69,72
"2011-05-04 12:00:00",2,0,1,2,18.04,19,105,124
"2011-05-04 13:00:00",2,0,1,2,18.86,15,128,143
"2011-05-04 14:00:00",2,0,1,1,20.5,13,94,107
"2011-05-04 15:00:00",2,0,1,1,19.68,22,107,129
"2011-05-04 16:00:00",2,0,1,1,20.5,22,173,195
"2011-05-04 17:00:00",2,0,1,1,16.4,22,388,410
"2011-05-04 18:00:00",2,0,1,1,17.22,29,367,396
"2011-05-04 19:00:00",2,0,1,1,17.22,30,266,296
"2011-05-04 20:00:00",2,0,1,1,16.4,17,174,191
"2011-05-04 21:00:00",2,0,1,1,16.4,17,133,150
"2011-05-04 22:00:00",2,0,1,1,15.58,9,80,89
"2011-05-04 23:00:00",2,0,1,1,14.76,8,49,57
"2011-05-05 00:00:00",2,0,1,1,14.76,4,23,27
"2011-05-05 01:00:00",2,0,1,1,13.94,4,6,10
"2011-05-05 02:00:00",2,0,1,1,13.94,1,4,5
"2011-05-05 03:00:00",2,0,1,1,13.94,0,4,4
"2011-05-05 04:00:00",2,0,1,1,13.94,4,3,7
"2011-05-05 05:00:00",2,0,1,1,13.94,1,29,30
"2011-05-05 06:00:00",2,0,1,1,13.94,3,86,89
"2011-05-05 07:00:00",2,0,1,1,15.58,16,255,271
"2011-05-05 08:00:00",2,0,1,1,17.22,25,415,440
"2011-05-05 09:00:00",2,0,1,1,18.86,20,164,184
"2011-05-05 10:00:00",2,0,1,1,20.5,30,98,128
"2011-05-05 11:00:00",2,0,1,1,21.32,43,105,148
"2011-05-05 12:00:00",2,0,1,1,21.32,27,169,196
"2011-05-05 13:00:00",2,0,1,1,22.14,50,142,192
"2011-05-05 14:00:00",2,0,1,1,22.14,19,135,154
"2011-05-05 15:00:00",2,0,1,1,22.96,27,120,147
"2011-05-05 16:00:00",2,0,1,1,23.78,36,233,269
"2011-05-05 17:00:00",2,0,1,1,22.96,66,467,533
"2011-05-05 18:00:00",2,0,1,1,22.96,64,456,520
"2011-05-05 19:00:00",2,0,1,1,22.14,56,305,361
"2011-05-05 20:00:00",2,0,1,1,20.5,33,225,258
"2011-05-05 21:00:00",2,0,1,1,20.5,39,141,180
"2011-05-05 22:00:00",2,0,1,1,19.68,30,135,165
"2011-05-05 23:00:00",2,0,1,1,18.86,16,99,115
"2011-05-06 00:00:00",2,0,1,1,18.04,13,43,56
"2011-05-06 01:00:00",2,0,1,1,16.4,8,24,32
"2011-05-06 02:00:00",2,0,1,1,15.58,1,15,16
"2011-05-06 03:00:00",2,0,1,1,14.76,3,6,9
"2011-05-06 04:00:00",2,0,1,1,14.76,0,1,1
"2011-05-06 05:00:00",2,0,1,1,13.94,0,16,16
"2011-05-06 06:00:00",2,0,1,1,14.76,8,74,82
"2011-05-06 07:00:00",2,0,1,1,16.4,20,202,222
"2011-05-06 08:00:00",2,0,1,1,17.22,35,415,450
"2011-05-06 09:00:00",2,0,1,1,18.86,27,161,188
"2011-05-06 10:00:00",2,0,1,2,22.14,30,97,127
"2011-05-06 11:00:00",2,0,1,2,22.14,42,123,165
"2011-05-06 12:00:00",2,0,1,1,22.96,48,198,246
"2011-05-06 13:00:00",2,0,1,1,23.78,71,182,253
"2011-05-06 14:00:00",2,0,1,1,24.6,86,127,213
"2011-05-06 15:00:00",2,0,1,1,24.6,89,171,260
"2011-05-06 16:00:00",2,0,1,1,24.6,82,262,344
"2011-05-06 17:00:00",2,0,1,1,23.78,83,470,553
"2011-05-06 18:00:00",2,0,1,3,22.14,85,385,470
"2011-05-06 19:00:00",2,0,1,3,22.14,39,253,292
"2011-05-06 20:00:00",2,0,1,1,21.32,29,161,190
"2011-05-06 21:00:00",2,0,1,1,19.68,22,130,152
"2011-05-06 22:00:00",2,0,1,1,18.86,46,105,151
"2011-05-06 23:00:00",2,0,1,1,18.04,27,93,120
"2011-05-07 00:00:00",2,0,0,1,17.22,10,76,86
"2011-05-07 01:00:00",2,0,0,1,17.22,8,50,58
"2011-05-07 02:00:00",2,0,0,1,17.22,5,47,52
"2011-05-07 03:00:00",2,0,0,1,17.22,9,9,18
"2011-05-07 04:00:00",2,0,0,1,16.4,1,4,5
"2011-05-07 05:00:00",2,0,0,1,18.86,4,3,7
"2011-05-07 06:00:00",2,0,0,1,17.22,1,12,13
"2011-05-07 07:00:00",2,0,0,1,19.68,8,32,40
"2011-05-07 08:00:00",2,0,0,1,21.32,19,96,115
"2011-05-07 09:00:00",2,0,0,1,22.14,54,164,218
"2011-05-07 10:00:00",2,0,0,1,22.96,90,208,298
"2011-05-07 11:00:00",2,0,0,1,22.96,132,215,347
"2011-05-07 12:00:00",2,0,0,1,24.6,129,244,373
"2011-05-07 13:00:00",2,0,0,1,24.6,196,240,436
"2011-05-07 14:00:00",2,0,0,3,24.6,143,235,378
"2011-05-07 15:00:00",2,0,0,1,24.6,148,230,378
"2011-05-07 16:00:00",2,0,0,1,24.6,119,223,342
"2011-05-07 17:00:00",2,0,0,1,23.78,138,216,354
"2011-05-07 18:00:00",2,0,0,1,23.78,114,175,289
"2011-05-07 19:00:00",2,0,0,1,22.96,88,179,267
"2011-05-07 20:00:00",2,0,0,1,22.96,82,137,219
"2011-05-07 21:00:00",2,0,0,1,22.14,58,124,182
"2011-05-07 22:00:00",2,0,0,1,22.14,26,94,120
"2011-05-07 23:00:00",2,0,0,1,20.5,30,89,119
"2011-05-08 00:00:00",2,0,0,2,20.5,22,78,100
"2011-05-08 01:00:00",2,0,0,2,21.32,8,56,64
"2011-05-08 02:00:00",2,0,0,1,19.68,17,42,59
"2011-05-08 03:00:00",2,0,0,1,18.86,10,21,31
"2011-05-08 04:00:00",2,0,0,1,17.22,2,8,10
"2011-05-08 05:00:00",2,0,0,2,18.04,0,5,5
"2011-05-08 06:00:00",2,0,0,2,18.04,2,4,6
"2011-05-08 07:00:00",2,0,0,2,18.86,8,15,23
"2011-05-08 08:00:00",2,0,0,1,21.32,28,58,86
"2011-05-08 09:00:00",2,0,0,1,22.96,48,112,160
"2011-05-08 10:00:00",2,0,0,1,23.78,91,153,244
"2011-05-08 11:00:00",2,0,0,1,23.78,142,198,340
"2011-05-08 12:00:00",2,0,0,1,24.6,139,243,382
"2011-05-08 13:00:00",2,0,0,1,24.6,166,224,390
"2011-05-08 14:00:00",2,0,0,1,24.6,126,240,366
"2011-05-08 15:00:00",2,0,0,1,24.6,128,230,358
"2011-05-08 16:00:00",2,0,0,1,24.6,122,263,385
"2011-05-08 17:00:00",2,0,0,3,23.78,106,245,351
"2011-05-08 18:00:00",2,0,0,1,23.78,63,205,268
"2011-05-08 19:00:00",2,0,0,1,22.96,61,178,239
"2011-05-08 20:00:00",2,0,0,1,21.32,42,132,174
"2011-05-08 21:00:00",2,0,0,1,21.32,32,95,127
"2011-05-08 22:00:00",2,0,0,1,20.5,29,86,115
"2011-05-08 23:00:00",2,0,0,1,18.86,9,41,50
"2011-05-09 00:00:00",2,0,1,1,18.86,31,22,53
"2011-05-09 01:00:00",2,0,1,1,18.04,25,8,33
"2011-05-09 02:00:00",2,0,1,1,18.04,6,2,8
"2011-05-09 03:00:00",2,0,1,1,18.86,0,7,7
"2011-05-09 04:00:00",2,0,1,1,17.22,0,4,4
"2011-05-09 05:00:00",2,0,1,1,17.22,0,23,23
"2011-05-09 06:00:00",2,0,1,1,18.04,2,87,89
"2011-05-09 07:00:00",2,0,1,1,19.68,16,221,237
"2011-05-09 08:00:00",2,0,1,1,21.32,23,351,374
"2011-05-09 09:00:00",2,0,1,1,22.14,36,142,178
"2011-05-09 10:00:00",2,0,1,1,22.96,24,95,119
"2011-05-09 11:00:00",2,0,1,1,24.6,26,99,125
"2011-05-09 12:00:00",2,0,1,1,24.6,35,160,195
"2011-05-09 13:00:00",2,0,1,1,25.42,36,138,174
"2011-05-09 14:00:00",2,0,1,1,25.42,44,118,162
"2011-05-09 15:00:00",2,0,1,1,25.42,51,148,199
"2011-05-09 16:00:00",2,0,1,1,26.24,49,255,304
"2011-05-09 17:00:00",2,0,1,1,25.42,59,539,598
"2011-05-09 18:00:00",2,0,1,1,25.42,66,458,524
"2011-05-09 19:00:00",2,0,1,1,23.78,45,339,384
"2011-05-09 20:00:00",2,0,1,1,22.14,25,214,239
"2011-05-09 21:00:00",2,0,1,1,21.32,28,128,156
"2011-05-09 22:00:00",2,0,1,1,21.32,21,95,116
"2011-05-09 23:00:00",2,0,1,1,20.5,16,45,61
"2011-05-10 00:00:00",2,0,1,1,19.68,6,12,18
"2011-05-10 01:00:00",2,0,1,1,18.86,3,12,15
"2011-05-10 02:00:00",2,0,1,1,18.04,1,4,5
"2011-05-10 03:00:00",2,0,1,1,18.04,1,3,4
"2011-05-10 04:00:00",2,0,1,1,17.22,0,2,2
"2011-05-10 05:00:00",2,0,1,1,16.4,1,28,29
"2011-05-10 06:00:00",2,0,1,1,17.22,9,103,112
"2011-05-10 07:00:00",2,0,1,2,18.04,13,301,314
"2011-05-10 08:00:00",2,0,1,2,20.5,28,397,425
"2011-05-10 09:00:00",2,0,1,2,21.32,29,176,205
"2011-05-10 10:00:00",2,0,1,2,22.96,27,100,127
"2011-05-10 11:00:00",2,0,1,2,22.96,17,108,125
"2011-05-10 12:00:00",2,0,1,2,24.6,47,170,217
"2011-05-10 13:00:00",2,0,1,2,25.42,50,152,202
"2011-05-10 14:00:00",2,0,1,2,25.42,42,134,176
"2011-05-10 15:00:00",2,0,1,2,26.24,28,152,180
"2011-05-10 16:00:00",2,0,1,1,27.06,56,271,327
"2011-05-10 17:00:00",2,0,1,1,26.24,79,532,611
"2011-05-10 18:00:00",2,0,1,1,26.24,70,480,550
"2011-05-10 19:00:00",2,0,1,1,24.6,69,365,434
"2011-05-10 20:00:00",2,0,1,1,22.14,50,241,291
"2011-05-10 21:00:00",2,0,1,1,22.14,30,173,203
"2011-05-10 22:00:00",2,0,1,1,21.32,29,121,150
"2011-05-10 23:00:00",2,0,1,2,21.32,9,72,81
"2011-05-11 00:00:00",2,0,1,2,21.32,8,30,38
"2011-05-11 01:00:00",2,0,1,2,20.5,4,16,20
"2011-05-11 02:00:00",2,0,1,1,21.32,6,4,10
"2011-05-11 03:00:00",2,0,1,1,20.5,0,3,3
"2011-05-11 04:00:00",2,0,1,2,19.68,0,2,2
"2011-05-11 05:00:00",2,0,1,1,18.86,0,20,20
"2011-05-11 06:00:00",2,0,1,1,18.86,6,93,99
"2011-05-11 07:00:00",2,0,1,1,19.68,25,293,318
"2011-05-11 08:00:00",2,0,1,1,19.68,21,421,442
"2011-05-11 09:00:00",2,0,1,1,21.32,21,182,203
"2011-05-11 10:00:00",2,0,1,1,22.14,30,124,154
"2011-05-11 11:00:00",2,0,1,1,22.96,18,123,141
"2011-05-11 12:00:00",2,0,1,1,24.6,41,185,226
"2011-05-11 13:00:00",2,0,1,1,25.42,36,157,193
"2011-05-11 14:00:00",2,0,1,1,25.42,36,141,177
"2011-05-11 15:00:00",2,0,1,1,26.24,48,131,179
"2011-05-11 16:00:00",2,0,1,1,27.06,49,240,289
"2011-05-11 17:00:00",2,0,1,1,26.24,17,242,259
"2011-05-11 18:00:00",2,0,1,1,25.42,40,234,274
"2011-05-11 19:00:00",2,0,1,1,22.96,60,341,401
"2011-05-11 20:00:00",2,0,1,1,22.14,28,245,273
"2011-05-11 21:00:00",2,0,1,1,22.14,32,202,234
"2011-05-11 22:00:00",2,0,1,1,20.5,12,134,146
"2011-05-11 23:00:00",2,0,1,1,18.86,12,69,81
"2011-05-12 00:00:00",2,0,1,2,18.86,5,39,44
"2011-05-12 01:00:00",2,0,1,1,18.86,1,16,17
"2011-05-12 02:00:00",2,0,1,1,18.04,1,14,15
"2011-05-12 03:00:00",2,0,1,1,18.04,0,5,5
"2011-05-12 04:00:00",2,0,1,1,17.22,1,5,6
"2011-05-12 05:00:00",2,0,1,1,17.22,2,27,29
"2011-05-12 06:00:00",2,0,1,1,18.04,9,103,112
"2011-05-12 07:00:00",2,0,1,1,18.86,14,283,297
"2011-05-12 08:00:00",2,0,1,1,19.68,27,394,421
"2011-05-12 09:00:00",2,0,1,2,20.5,21,191,212
"2011-05-12 10:00:00",2,0,1,2,22.14,28,119,147
"2011-05-12 11:00:00",2,0,1,1,23.78,43,136,179
"2011-05-12 12:00:00",2,0,1,1,23.78,43,164,207
"2011-05-12 13:00:00",2,0,1,2,25.42,48,170,218
"2011-05-12 14:00:00",2,0,1,2,25.42,43,148,191
"2011-05-12 15:00:00",2,0,1,2,26.24,54,163,217
"2011-05-12 16:00:00",2,0,1,2,26.24,50,238,288
"2011-05-12 17:00:00",2,0,1,2,26.24,54,540,594
"2011-05-12 18:00:00",2,0,1,1,25.42,64,463,527
"2011-05-12 19:00:00",2,0,1,2,24.6,59,305,364
"2011-05-12 20:00:00",2,0,1,1,24.6,56,220,276
"2011-05-12 21:00:00",2,0,1,1,22.96,31,192,223
"2011-05-12 22:00:00",2,0,1,1,22.14,25,147,172
"2011-05-12 23:00:00",2,0,1,2,22.14,16,87,103
"2011-05-13 00:00:00",2,0,1,2,21.32,6,46,52
"2011-05-13 01:00:00",2,0,1,1,21.32,5,15,20
"2011-05-13 02:00:00",2,0,1,2,20.5,3,8,11
"2011-05-13 03:00:00",2,0,1,2,20.5,2,2,4
"2011-05-13 04:00:00",2,0,1,3,20.5,2,3,5
"2011-05-13 05:00:00",2,0,1,2,20.5,1,24,25
"2011-05-13 06:00:00",2,0,1,3,20.5,6,76,82
"2011-05-13 07:00:00",2,0,1,3,20.5,16,141,157
"2011-05-13 08:00:00",2,0,1,2,20.5,26,361,387
"2011-05-13 09:00:00",2,0,1,2,20.5,18,215,233
"2011-05-13 10:00:00",2,0,1,2,21.32,31,99,130
"2011-05-13 11:00:00",2,0,1,2,21.32,56,90,146
"2011-05-13 12:00:00",2,0,1,2,21.32,53,170,223
"2011-05-13 13:00:00",2,0,1,2,21.32,69,157,226
"2011-05-13 14:00:00",2,0,1,2,21.32,70,120,190
"2011-05-13 15:00:00",2,0,1,2,21.32,56,142,198
"2011-05-13 16:00:00",2,0,1,2,21.32,44,256,300
"2011-05-13 17:00:00",2,0,1,3,21.32,62,429,491
"2011-05-13 18:00:00",2,0,1,3,21.32,39,359,398
"2011-05-13 19:00:00",2,0,1,2,21.32,25,245,270
"2011-05-13 20:00:00",2,0,1,2,21.32,22,130,152
"2011-05-13 21:00:00",2,0,1,2,21.32,24,130,154
"2011-05-13 22:00:00",2,0,1,2,21.32,25,107,132
"2011-05-13 23:00:00",2,0,1,3,20.5,31,88,119
"2011-05-14 00:00:00",2,0,0,2,20.5,24,78,102
"2011-05-14 01:00:00",2,0,0,2,20.5,18,64,82
"2011-05-14 02:00:00",2,0,0,2,20.5,15,37,52
"2011-05-14 03:00:00",2,0,0,2,20.5,5,30,35
"2011-05-14 04:00:00",2,0,0,2,20.5,1,4,5
"2011-05-14 05:00:00",2,0,0,2,20.5,7,7,14
"2011-05-14 06:00:00",2,0,0,2,20.5,2,9,11
"2011-05-14 07:00:00",2,0,0,3,19.68,4,28,32
"2011-05-14 08:00:00",2,0,0,3,20.5,16,72,88
"2011-05-14 09:00:00",2,0,0,2,21.32,14,86,100
"2011-05-14 10:00:00",2,0,0,2,21.32,34,133,167
"2011-05-14 11:00:00",2,0,0,2,21.32,72,207,279
"2011-05-14 12:00:00",2,0,0,3,21.32,75,204,279
"2011-05-14 13:00:00",2,0,0,3,21.32,68,180,248
"2011-05-14 14:00:00",2,0,0,2,22.14,57,159,216
"2011-05-14 15:00:00",2,0,0,2,22.14,73,221,294
"2011-05-14 16:00:00",2,0,0,2,22.14,107,188,295
"2011-05-14 17:00:00",2,0,0,2,22.96,78,194,272
"2011-05-14 18:00:00",2,0,0,2,22.96,88,216,304
"2011-05-14 19:00:00",2,0,0,3,22.14,69,179,248
"2011-05-14 20:00:00",2,0,0,3,22.14,42,115,157
"2011-05-14 21:00:00",2,0,0,3,22.14,15,44,59
"2011-05-14 22:00:00",2,0,0,3,22.14,7,19,26
"2011-05-14 23:00:00",2,0,0,3,21.32,11,33,44
"2011-05-15 00:00:00",2,0,0,2,21.32,5,34,39
"2011-05-15 01:00:00",2,0,0,2,21.32,4,43,47
"2011-05-15 02:00:00",2,0,0,2,21.32,13,37,50
"2011-05-15 03:00:00",2,0,0,2,21.32,11,21,32
"2011-05-15 04:00:00",2,0,0,2,21.32,5,8,13
"2011-05-15 05:00:00",2,0,0,3,21.32,3,11,14
"2011-05-15 06:00:00",2,0,0,2,21.32,3,14,17
"2011-05-15 07:00:00",2,0,0,2,21.32,4,38,42
"2011-05-15 08:00:00",2,0,0,2,22.14,24,46,70
"2011-05-15 09:00:00",2,0,0,1,23.78,36,98,134
"2011-05-15 10:00:00",2,0,0,1,23.78,73,153,226
"2011-05-15 11:00:00",2,0,0,1,24.6,120,202,322
"2011-05-15 12:00:00",2,0,0,1,25.42,120,247,367
"2011-05-15 13:00:00",2,0,0,1,25.42,195,261,456
"2011-05-15 14:00:00",2,0,0,1,26.24,183,254,437
"2011-05-15 15:00:00",2,0,0,1,27.06,206,253,459
"2011-05-15 16:00:00",2,0,0,1,26.24,158,282,440
"2011-05-15 17:00:00",2,0,0,3,22.96,137,255,392
"2011-05-15 18:00:00",2,0,0,1,22.96,60,177,237
"2011-05-15 19:00:00",2,0,0,1,22.96,78,153,231
"2011-05-15 20:00:00",2,0,0,1,22.14,53,138,191
"2011-05-15 21:00:00",2,0,0,1,22.14,44,107,151
"2011-05-15 22:00:00",2,0,0,1,22.96,29,88,117
"2011-05-15 23:00:00",2,0,0,1,22.14,18,51,69
"2011-05-16 00:00:00",2,0,1,1,21.32,17,21,38
"2011-05-16 01:00:00",2,0,1,1,21.32,6,8,14
"2011-05-16 02:00:00",2,0,1,1,20.5,4,9,13
"2011-05-16 03:00:00",2,0,1,1,20.5,1,3,4
"2011-05-16 04:00:00",2,0,1,1,20.5,1,5,6
"2011-05-16 05:00:00",2,0,1,1,20.5,1,20,21
"2011-05-16 06:00:00",2,0,1,1,21.32,11,93,104
"2011-05-16 07:00:00",2,0,1,1,21.32,27,245,272
"2011-05-16 08:00:00",2,0,1,1,22.96,28,366,394
"2011-05-16 09:00:00",2,0,1,1,24.6,38,156,194
"2011-05-16 10:00:00",2,0,1,1,25.42,37,75,112
"2011-05-16 11:00:00",2,0,1,1,26.24,56,129,185
"2011-05-16 12:00:00",2,0,1,1,27.06,72,137,209
"2011-05-16 13:00:00",2,0,1,1,27.88,61,153,214
"2011-05-16 14:00:00",2,0,1,1,27.88,76,117,193
"2011-05-16 15:00:00",2,0,1,1,29.52,55,110,165
"2011-05-16 16:00:00",2,0,1,3,24.6,45,181,226
"2011-05-16 17:00:00",2,0,1,1,23.78,47,227,274
"2011-05-16 18:00:00",2,0,1,3,23.78,55,398,453
"2011-05-16 19:00:00",2,0,1,1,23.78,36,272,308
"2011-05-16 20:00:00",2,0,1,1,23.78,31,167,198
"2011-05-16 21:00:00",2,0,1,1,23.78,28,149,177
"2011-05-16 22:00:00",2,0,1,1,22.96,22,105,127
"2011-05-16 23:00:00",2,0,1,1,22.96,18,39,57
"2011-05-17 00:00:00",2,0,1,2,22.96,13,18,31
"2011-05-17 01:00:00",2,0,1,3,22.96,7,6,13
"2011-05-17 02:00:00",2,0,1,3,22.96,4,4,8
"2011-05-17 03:00:00",2,0,1,3,22.14,1,3,4
"2011-05-17 04:00:00",2,0,1,3,22.14,2,2,4
"2011-05-17 05:00:00",2,0,1,3,21.32,0,22,22
"2011-05-17 06:00:00",2,0,1,3,21.32,0,49,49
"2011-05-17 07:00:00",2,0,1,2,21.32,13,138,151
"2011-05-17 08:00:00",2,0,1,2,21.32,22,325,347
"2011-05-17 09:00:00",2,0,1,2,22.14,17,190,207
"2011-05-17 10:00:00",2,0,1,3,22.14,31,73,104
"2011-05-17 11:00:00",2,0,1,2,22.96,26,104,130
"2011-05-17 12:00:00",2,0,1,3,22.96,38,115,153
"2011-05-17 13:00:00",2,0,1,2,22.96,31,141,172
"2011-05-17 14:00:00",2,0,1,1,25.42,61,123,184
"2011-05-17 15:00:00",2,0,1,1,25.42,79,131,210
"2011-05-17 16:00:00",2,0,1,1,25.42,73,217,290
"2011-05-17 17:00:00",2,0,1,1,25.42,83,521,604
"2011-05-17 18:00:00",2,0,1,1,24.6,54,426,480
"2011-05-17 19:00:00",2,0,1,1,24.6,51,298,349
"2011-05-17 20:00:00",2,0,1,1,23.78,30,253,283
"2011-05-17 21:00:00",2,0,1,1,22.14,23,151,174
"2011-05-17 22:00:00",2,0,1,2,22.14,12,86,98
"2011-05-17 23:00:00",2,0,1,2,22.14,7,49,56
"2011-05-18 00:00:00",2,0,1,2,22.14,8,15,23
"2011-05-18 01:00:00",2,0,1,2,22.14,3,9,12
"2011-05-18 02:00:00",2,0,1,3,21.32,1,5,6
"2011-05-18 03:00:00",2,0,1,3,21.32,6,3,9
"2011-05-18 04:00:00",2,0,1,3,21.32,1,2,3
"2011-05-18 05:00:00",2,0,1,1,21.32,0,9,9
"2011-05-18 06:00:00",2,0,1,1,21.32,2,99,101
"2011-05-18 07:00:00",2,0,1,1,22.14,14,260,274
"2011-05-18 08:00:00",2,0,1,1,22.96,25,428,453
"2011-05-18 09:00:00",2,0,1,3,22.96,26,176,202
"2011-05-18 10:00:00",2,0,1,3,22.14,33,73,106
"2011-05-18 11:00:00",2,0,1,2,22.14,6,17,23
"2011-05-18 12:00:00",2,0,1,1,22.96,12,42,54
"2011-05-18 13:00:00",2,0,1,2,22.96,30,92,122
"2011-05-18 14:00:00",2,0,1,2,23.78,44,94,138
"2011-05-18 15:00:00",2,0,1,1,24.6,34,133,167
"2011-05-18 16:00:00",2,0,1,1,24.6,53,241,294
"2011-05-18 17:00:00",2,0,1,1,24.6,78,487,565
"2011-05-18 18:00:00",2,0,1,1,24.6,58,431,489
"2011-05-18 19:00:00",2,0,1,3,22.96,43,288,331
"2011-05-18 20:00:00",2,0,1,3,22.96,24,189,213
"2011-05-18 21:00:00",2,0,1,1,21.32,11,74,85
"2011-05-18 22:00:00",2,0,1,1,21.32,14,103,117
"2011-05-18 23:00:00",2,0,1,1,21.32,10,49,59
"2011-05-19 00:00:00",2,0,1,1,21.32,6,23,29
"2011-05-19 01:00:00",2,0,1,1,20.5,2,4,6
"2011-05-19 02:00:00",2,0,1,1,20.5,3,12,15
"2011-05-19 03:00:00",2,0,1,1,19.68,1,3,4
"2011-05-19 04:00:00",2,0,1,1,19.68,2,3,5
"2011-05-19 05:00:00",2,0,1,1,19.68,2,24,26
"2011-05-19 06:00:00",2,0,1,2,20.5,17,86,103
"2011-05-19 07:00:00",2,0,1,2,20.5,18,239,257
"2011-05-19 08:00:00",2,0,1,2,21.32,34,453,487
"2011-05-19 09:00:00",2,0,1,2,22.14,40,176,216
"2011-05-19 10:00:00",2,0,1,2,22.14,35,95,130
"2011-05-19 11:00:00",2,0,1,3,22.14,53,111,164
"2011-05-19 12:00:00",2,0,1,2,23.78,38,130,168
"2011-05-19 13:00:00",2,0,1,3,23.78,44,139,183
"2011-05-19 14:00:00",2,0,1,3,22.14,43,137,180
"2011-05-19 15:00:00",2,0,1,1,22.96,63,125,188
"2011-05-19 16:00:00",2,0,1,1,23.78,55,247,302
"2011-05-19 17:00:00",2,0,1,1,22.96,60,487,547
"2011-05-19 18:00:00",2,0,1,1,24.6,59,454,513
"2011-05-19 19:00:00",2,0,1,1,23.78,65,345,410
"2011-05-19 20:00:00",2,0,1,1,22.14,46,236,282
"2011-05-19 21:00:00",2,0,1,1,22.14,29,180,209
"2011-05-19 22:00:00",2,0,1,3,20.5,11,68,79
"2011-05-19 23:00:00",2,0,1,1,19.68,9,63,72
"2011-06-01 00:00:00",2,0,1,1,28.7,9,25,34
"2011-06-01 01:00:00",2,0,1,1,28.7,8,9,17
"2011-06-01 02:00:00",2,0,1,1,28.7,0,3,3
"2011-06-01 03:00:00",2,0,1,1,27.88,0,6,6
"2011-06-01 04:00:00",2,0,1,2,27.88,0,4,4
"2011-06-01 05:00:00",2,0,1,2,27.06,2,19,21
"2011-06-01 06:00:00",2,0,1,2,27.88,7,121,128
"2011-06-01 07:00:00",2,0,1,2,28.7,19,265,284
"2011-06-01 08:00:00",2,0,1,2,29.52,37,417,454
"2011-06-01 09:00:00",2,0,1,2,30.34,34,173,207
"2011-06-01 10:00:00",2,0,1,2,31.16,31,84,115
"2011-06-01 11:00:00",2,0,1,2,33.62,26,86,112
"2011-06-01 12:00:00",2,0,1,1,35.26,32,137,169
"2011-06-01 13:00:00",2,0,1,1,36.9,29,125,154
"2011-06-01 14:00:00",2,0,1,1,36.9,40,105,145
"2011-06-01 15:00:00",2,0,1,1,36.9,25,127,152
"2011-06-01 16:00:00",2,0,1,1,35.26,39,227,266
"2011-06-01 17:00:00",2,0,1,1,35.26,52,434,486
"2011-06-01 18:00:00",2,0,1,3,33.62,31,278,309
"2011-06-01 19:00:00",2,0,1,2,30.34,16,248,264
"2011-06-01 20:00:00",2,0,1,2,30.34,23,233,256
"2011-06-01 21:00:00",2,0,1,1,30.34,29,161,190
"2011-06-01 22:00:00",2,0,1,1,30.34,14,115,129
"2011-06-01 23:00:00",2,0,1,1,30.34,10,59,69
"2011-06-02 00:00:00",2,0,1,1,30.34,11,31,42
"2011-06-02 01:00:00",2,0,1,1,29.52,3,12,15
"2011-06-02 02:00:00",2,0,1,1,28.7,0,6,6
"2011-06-02 03:00:00",2,0,1,1,27.06,0,4,4
"2011-06-02 04:00:00",2,0,1,1,27.06,0,3,3
"2011-06-02 05:00:00",2,0,1,1,27.06,3,28,31
"2011-06-02 06:00:00",2,0,1,1,27.06,7,106,113
"2011-06-02 07:00:00",2,0,1,1,28.7,19,285,304
"2011-06-02 08:00:00",2,0,1,1,28.7,25,442,467
"2011-06-02 09:00:00",2,0,1,1,29.52,28,197,225
"2011-06-02 10:00:00",2,0,1,1,29.52,33,106,139
"2011-06-02 11:00:00",2,0,1,1,30.34,42,123,165
"2011-06-02 12:00:00",2,0,1,1,31.16,39,193,232
"2011-06-02 13:00:00",2,0,1,1,32.8,35,168,203
"2011-06-02 14:00:00",2,0,1,1,31.98,43,142,185
"2011-06-02 15:00:00",2,0,1,1,32.8,44,144,188
"2011-06-02 16:00:00",2,0,1,1,32.8,63,255,318
"2011-06-02 17:00:00",2,0,1,1,31.16,88,484,572
"2011-06-02 18:00:00",2,0,1,1,30.34,74,451,525
"2011-06-02 19:00:00",2,0,1,1,29.52,58,321,379
"2011-06-02 20:00:00",2,0,1,1,28.7,51,286,337
"2011-06-02 21:00:00",2,0,1,1,27.06,33,215,248
"2011-06-02 22:00:00",2,0,1,1,26.24,14,141,155
"2011-06-02 23:00:00",2,0,1,1,25.42,23,89,112
"2011-06-03 00:00:00",2,0,1,1,25.42,15,53,68
"2011-06-03 01:00:00",2,0,1,1,24.6,7,15,22
"2011-06-03 02:00:00",2,0,1,1,22.96,0,12,12
"2011-06-03 03:00:00",2,0,1,1,22.14,0,5,5
"2011-06-03 04:00:00",2,0,1,1,21.32,1,5,6
"2011-06-03 05:00:00",2,0,1,1,21.32,4,24,28
"2011-06-03 06:00:00",2,0,1,1,22.14,8,98,106
"2011-06-03 07:00:00",2,0,1,1,22.14,25,252,277
"2011-06-03 08:00:00",2,0,1,2,22.96,31,471,502
"2011-06-03 09:00:00",2,0,1,1,23.78,36,194,230
"2011-06-03 10:00:00",2,0,1,1,25.42,54,107,161
"2011-06-03 11:00:00",2,0,1,1,26.24,57,135,192
"2011-06-03 12:00:00",2,0,1,1,27.06,51,208,259
"2011-06-03 13:00:00",2,0,1,1,27.88,58,190,248
"2011-06-03 14:00:00",2,0,1,1,28.7,66,174,240
"2011-06-03 15:00:00",2,0,1,1,28.7,56,156,212
"2011-06-03 16:00:00",2,0,1,1,29.52,63,286,349
"2011-06-03 17:00:00",2,0,1,1,29.52,73,485,558
"2011-06-03 18:00:00",2,0,1,1,28.7,76,488,564
"2011-06-03 19:00:00",2,0,1,1,27.88,53,338,391
"2011-06-03 20:00:00",2,0,1,1,26.24,57,236,293
"2011-06-03 21:00:00",2,0,1,1,26.24,51,196,247
"2011-06-03 22:00:00",2,0,1,1,25.42,26,145,171
"2011-06-03 23:00:00",2,0,1,1,23.78,30,141,171
"2011-06-04 00:00:00",2,0,0,1,22.96,24,69,93
"2011-06-04 01:00:00",2,0,0,1,22.14,14,80,94
"2011-06-04 02:00:00",2,0,0,1,22.14,18,41,59
"2011-06-04 03:00:00",2,0,0,1,21.32,8,10,18
"2011-06-04 04:00:00",2,0,0,1,21.32,4,11,15
"2011-06-04 05:00:00",2,0,0,1,20.5,3,5,8
"2011-06-04 06:00:00",2,0,0,1,22.14,11,17,28
"2011-06-04 07:00:00",2,0,0,1,22.96,27,60,87
"2011-06-04 08:00:00",2,0,0,1,24.6,29,96,125
"2011-06-04 09:00:00",2,0,0,1,25.42,55,169,224
"2011-06-04 10:00:00",2,0,0,1,26.24,115,202,317
"2011-06-04 11:00:00",2,0,0,1,27.06,120,249,369
"2011-06-04 12:00:00",2,0,0,1,28.7,150,270,420
"2011-06-04 13:00:00",2,0,0,1,30.34,188,268,456
"2011-06-04 14:00:00",2,0,0,1,30.34,193,258,451
"2011-06-04 15:00:00",2,0,0,2,30.34,180,224,404
"2011-06-04 16:00:00",2,0,0,2,29.52,168,272,440
"2011-06-04 17:00:00",2,0,0,2,29.52,142,202,344
"2011-06-04 18:00:00",2,0,0,2,30.34,127,214,341
"2011-06-04 19:00:00",2,0,0,2,28.7,79,206,285
"2011-06-04 20:00:00",2,0,0,2,28.7,90,149,239
"2011-06-04 21:00:00",2,0,0,2,27.06,46,139,185
"2011-06-04 22:00:00",2,0,0,1,26.24,49,141,190
"2011-06-04 23:00:00",2,0,0,2,26.24,29,121,150
"2011-06-05 00:00:00",2,0,0,1,26.24,23,90,113
"2011-06-05 01:00:00",2,0,0,2,26.24,26,70,96
"2011-06-05 02:00:00",2,0,0,2,26.24,16,48,64
"2011-06-05 03:00:00",2,0,0,2,25.42,22,25,47
"2011-06-05 04:00:00",2,0,0,2,25.42,4,8,12
"2011-06-05 05:00:00",2,0,0,2,25.42,1,5,6
"2011-06-05 06:00:00",2,0,0,2,25.42,10,11,21
"2011-06-05 07:00:00",2,0,0,2,24.6,8,19,27
"2011-06-05 08:00:00",2,0,0,2,24.6,24,74,98
"2011-06-05 09:00:00",2,0,0,2,24.6,53,111,164
"2011-06-05 10:00:00",2,0,0,2,25.42,83,168,251
"2011-06-05 11:00:00",2,0,0,2,26.24,121,214,335
"2011-06-05 12:00:00",2,0,0,2,26.24,123,212,335
"2011-06-05 13:00:00",2,0,0,1,27.06,154,213,367
"2011-06-05 14:00:00",2,0,0,1,28.7,161,224,385
"2011-06-05 15:00:00",2,0,0,1,28.7,161,256,417
"2011-06-05 16:00:00",2,0,0,1,29.52,138,260,398
"2011-06-05 17:00:00",2,0,0,1,30.34,126,264,390
"2011-06-05 18:00:00",2,0,0,1,28.7,124,239,363
"2011-06-05 19:00:00",2,0,0,1,27.88,108,249,357
"2011-06-05 20:00:00",2,0,0,1,27.06,84,195,279
"2011-06-05 21:00:00",2,0,0,1,26.24,54,111,165
"2011-06-05 22:00:00",2,0,0,1,26.24,36,94,130
"2011-06-05 23:00:00",2,0,0,1,25.42,25,61,86
"2011-06-06 00:00:00",2,0,1,1,25.42,11,18,29
"2011-06-06 01:00:00",2,0,1,1,24.6,9,5,14
"2011-06-06 02:00:00",2,0,1,1,23.78,4,4,8
"2011-06-06 03:00:00",2,0,1,1,23.78,2,3,5
"2011-06-06 04:00:00",2,0,1,1,22.96,4,4,8
"2011-06-06 05:00:00",2,0,1,1,22.96,7,24,31
"2011-06-06 06:00:00",2,0,1,1,23.78,11,101,112
"2011-06-06 07:00:00",2,0,1,1,25.42,18,281,299
"2011-06-06 08:00:00",2,0,1,1,26.24,28,410,438
"2011-06-06 09:00:00",2,0,1,1,28.7,26,162,188
"2011-06-06 10:00:00",2,0,1,1,29.52,31,64,95
"2011-06-06 11:00:00",2,0,1,1,30.34,39,72,111
"2011-06-06 12:00:00",2,0,1,1,31.16,25,128,153
"2011-06-06 13:00:00",2,0,1,1,31.98,28,152,180
"2011-06-06 14:00:00",2,0,1,1,31.98,46,99,145
"2011-06-06 15:00:00",2,0,1,1,32.8,38,127,165
"2011-06-06 16:00:00",2,0,1,1,31.16,34,233,267
"2011-06-06 17:00:00",2,0,1,1,31.98,63,516,579
"2011-06-06 18:00:00",2,0,1,1,31.16,56,500,556
"2011-06-06 19:00:00",2,0,1,1,29.52,64,343,407
"2011-06-06 20:00:00",2,0,1,1,27.88,59,277,336
"2011-06-06 21:00:00",2,0,1,1,27.06,29,160,189
"2011-06-06 22:00:00",2,0,1,1,27.06,36,137,173
"2011-06-06 23:00:00",2,0,1,1,26.24,5,55,60
"2011-06-07 00:00:00",2,0,1,1,26.24,5,15,20
"2011-06-07 01:00:00",2,0,1,1,25.42,2,2,4
"2011-06-07 02:00:00",2,0,1,1,24.6,3,2,5
"2011-06-07 03:00:00",2,0,1,1,24.6,1,1,2
"2011-06-07 04:00:00",2,0,1,1,23.78,2,3,5
"2011-06-07 05:00:00",2,0,1,1,23.78,2,30,32
"2011-06-07 06:00:00",2,0,1,1,24.6,10,116,126
"2011-06-07 07:00:00",2,0,1,2,26.24,23,311,334
"2011-06-07 08:00:00",2,0,1,2,27.88,45,432,477
"2011-06-07 09:00:00",2,0,1,2,29.52,27,190,217
"2011-06-07 10:00:00",2,0,1,2,31.16,37,86,123
"2011-06-07 11:00:00",2,0,1,2,31.16,38,113,151
"2011-06-07 12:00:00",2,0,1,2,32.8,42,141,183
"2011-06-07 13:00:00",2,0,1,2,32.8,55,141,196
"2011-06-07 14:00:00",2,0,1,2,32.8,34,112,146
"2011-06-07 15:00:00",2,0,1,2,33.62,56,127,183
"2011-06-07 16:00:00",2,0,1,1,32.8,55,253,308
"2011-06-07 17:00:00",2,0,1,1,32.8,64,475,539
"2011-06-07 18:00:00",2,0,1,1,31.98,72,479,551
"2011-06-07 19:00:00",2,0,1,1,31.16,69,355,424
"2011-06-07 20:00:00",2,0,1,1,30.34,45,301,346
"2011-06-07 21:00:00",2,0,1,1,29.52,31,187,218
"2011-06-07 22:00:00",2,0,1,1,28.7,27,126,153
"2011-06-07 23:00:00",2,0,1,1,27.88,18,72,90
"2011-06-08 00:00:00",2,0,1,1,27.06,12,29,41
"2011-06-08 01:00:00",2,0,1,1,27.06,3,20,23
"2011-06-08 02:00:00",2,0,1,1,26.24,0,7,7
"2011-06-08 03:00:00",2,0,1,1,26.24,2,1,3
"2011-06-08 04:00:00",2,0,1,1,25.42,0,6,6
"2011-06-08 05:00:00",2,0,1,1,25.42,0,21,21
"2011-06-08 06:00:00",2,0,1,1,26.24,13,103,116
"2011-06-08 07:00:00",2,0,1,1,27.06,24,329,353
"2011-06-08 08:00:00",2,0,1,1,31.16,46,435,481
"2011-06-08 09:00:00",2,0,1,1,31.16,34,168,202
"2011-06-08 10:00:00",2,0,1,1,33.62,27,63,90
"2011-06-08 11:00:00",2,0,1,1,34.44,28,106,134
"2011-06-08 12:00:00",2,0,1,1,36.08,15,134,149
"2011-06-08 13:00:00",2,0,1,1,36.9,20,116,136
"2011-06-08 14:00:00",2,0,1,1,37.72,44,111,155
"2011-06-08 15:00:00",2,0,1,1,37.72,28,100,128
"2011-06-08 16:00:00",2,0,1,1,37.72,34,199,233
"2011-06-08 17:00:00",2,0,1,1,37.72,80,426,506
"2011-06-08 18:00:00",2,0,1,1,36.9,61,398,459
"2011-06-08 19:00:00",2,0,1,1,33.62,61,323,384
"2011-06-08 20:00:00",2,0,1,1,32.8,55,225,280
"2011-06-08 21:00:00",2,0,1,1,32.8,34,168,202
"2011-06-08 22:00:00",2,0,1,1,31.16,37,139,176
"2011-06-08 23:00:00",2,0,1,1,31.16,18,98,116
"2011-06-09 00:00:00",2,0,1,2,30.34,7,40,47
"2011-06-09 01:00:00",2,0,1,1,30.34,3,13,16
"2011-06-09 02:00:00",2,0,1,2,29.52,0,6,6
"2011-06-09 03:00:00",2,0,1,2,29.52,0,2,2
"2011-06-09 04:00:00",2,0,1,2,29.52,2,4,6
"2011-06-09 05:00:00",2,0,1,2,28.7,1,19,20
"2011-06-09 06:00:00",2,0,1,2,29.52,13,105,118
"2011-06-09 07:00:00",2,0,1,2,29.52,31,283,314
"2011-06-09 08:00:00",2,0,1,2,31.16,32,400,432
"2011-06-09 09:00:00",2,0,1,1,34.44,20,148,168
"2011-06-09 10:00:00",2,0,1,1,35.26,20,74,94
"2011-06-09 11:00:00",2,0,1,1,36.9,36,82,118
"2011-06-09 12:00:00",2,0,1,1,37.72,40,100,140
"2011-06-09 13:00:00",2,0,1,1,36.9,18,118,136
"2011-06-09 14:00:00",2,0,1,1,37.72,25,93,118
"2011-06-09 15:00:00",2,0,1,1,38.54,18,86,104
"2011-06-09 16:00:00",2,0,1,1,37.72,30,170,200
"2011-06-09 17:00:00",2,0,1,1,36.9,54,355,409
"2011-06-09 18:00:00",2,0,1,1,36.08,52,414,466
"2011-06-09 19:00:00",2,0,1,2,34.44,55,271,326
"2011-06-09 20:00:00",2,0,1,2,32.8,40,214,254
"2011-06-09 21:00:00",2,0,1,3,31.16,29,142,171
"2011-06-09 22:00:00",2,0,1,2,30.34,22,131,153
"2011-06-09 23:00:00",2,0,1,2,30.34,15,82,97
"2011-06-10 00:00:00",2,0,1,3,28.7,8,61,69
"2011-06-10 01:00:00",2,0,1,3,28.7,5,18,23
"2011-06-10 02:00:00",2,0,1,1,27.88,6,7,13
"2011-06-10 03:00:00",2,0,1,1,27.88,3,3,6
"2011-06-10 04:00:00",2,0,1,1,27.06,0,4,4
"2011-06-10 05:00:00",2,0,1,1,27.06,0,28,28
"2011-06-10 06:00:00",2,0,1,1,27.06,10,94,104
"2011-06-10 07:00:00",2,0,1,1,29.52,25,242,267
"2011-06-10 08:00:00",2,0,1,1,30.34,29,423,452
"2011-06-10 09:00:00",2,0,1,1,31.16,37,176,213
"2011-06-10 10:00:00",2,0,1,1,31.98,23,88,111
"2011-06-10 11:00:00",2,0,1,1,33.62,46,107,153
"2011-06-10 12:00:00",2,0,1,1,34.44,40,167,207
"2011-06-10 13:00:00",2,0,1,1,34.44,40,149,189
"2011-06-10 14:00:00",2,0,1,1,35.26,44,121,165
"2011-06-10 15:00:00",2,0,1,1,34.44,49,163,212
"2011-06-10 16:00:00",2,0,1,1,33.62,46,239,285
"2011-06-10 17:00:00",2,0,1,1,33.62,63,454,517
"2011-06-10 18:00:00",2,0,1,1,32.8,96,367,463
"2011-06-10 19:00:00",2,0,1,1,31.98,61,245,306
"2011-06-10 20:00:00",2,0,1,1,31.16,53,197,250
"2011-06-10 21:00:00",2,0,1,1,31.16,55,163,218
"2011-06-10 22:00:00",2,0,1,1,29.52,40,145,185
"2011-06-10 23:00:00",2,0,1,1,29.52,36,110,146
"2011-06-11 00:00:00",2,0,0,1,28.7,28,89,117
"2011-06-11 01:00:00",2,0,0,1,28.7,10,67,77
"2011-06-11 02:00:00",2,0,0,1,28.7,10,50,60
"2011-06-11 03:00:00",2,0,0,1,27.88,10,18,28
"2011-06-11 04:00:00",2,0,0,1,27.88,4,9,13
"2011-06-11 05:00:00",2,0,0,1,27.88,4,12,16
"2011-06-11 06:00:00",2,0,0,1,28.7,9,31,40
"2011-06-11 07:00:00",2,0,0,1,29.52,18,50,68
"2011-06-11 08:00:00",2,0,0,1,30.34,32,111,143
"2011-06-11 09:00:00",2,0,0,1,30.34,59,171,230
"2011-06-11 10:00:00",2,0,0,1,30.34,91,173,264
"2011-06-11 11:00:00",2,0,0,1,31.16,110,215,325
"2011-06-11 12:00:00",2,0,0,1,32.8,112,235,347
"2011-06-11 13:00:00",2,0,0,1,32.8,150,237,387
"2011-06-11 14:00:00",2,0,0,1,33.62,148,232,380
"2011-06-11 15:00:00",2,0,0,1,33.62,142,232,374
"2011-06-11 16:00:00",2,0,0,2,32.8,169,225,394
"2011-06-11 17:00:00",2,0,0,2,30.34,147,190,337
"2011-06-11 18:00:00",2,0,0,2,29.52,131,155,286
"2011-06-11 19:00:00",2,0,0,1,28.7,97,167,264
"2011-06-11 20:00:00",2,0,0,1,27.88,95,180,275
"2011-06-11 21:00:00",2,0,0,1,27.06,76,144,220
"2011-06-11 22:00:00",2,0,0,1,27.06,53,137,190
"2011-06-11 23:00:00",2,0,0,1,27.06,24,107,131
"2011-06-12 00:00:00",2,0,0,1,27.06,19,100,119
"2011-06-12 01:00:00",2,0,0,1,26.24,19,74,93
"2011-06-12 02:00:00",2,0,0,1,26.24,9,57,66
"2011-06-12 03:00:00",2,0,0,1,26.24,8,20,28
"2011-06-12 04:00:00",2,0,0,1,25.42,8,6,14
"2011-06-12 05:00:00",2,0,0,1,25.42,5,5,10
"2011-06-12 06:00:00",2,0,0,1,25.42,5,9,14
"2011-06-12 07:00:00",2,0,0,1,26.24,7,27,34
"2011-06-12 08:00:00",2,0,0,1,28.7,28,64,92
"2011-06-12 09:00:00",2,0,0,1,29.52,75,107,182
"2011-06-12 10:00:00",2,0,0,1,31.16,120,191,311
"2011-06-12 11:00:00",2,0,0,1,31.98,131,236,367
"2011-06-12 12:00:00",2,0,0,1,33.62,176,244,420
"2011-06-12 13:00:00",2,0,0,1,31.98,109,264,373
"2011-06-12 14:00:00",2,0,0,1,33.62,96,219,315
"2011-06-12 15:00:00",2,0,0,1,32.8,142,218,360
"2011-06-12 16:00:00",2,0,0,3,27.88,115,235,350
"2011-06-12 17:00:00",2,0,0,3,27.88,94,158,252
"2011-06-12 18:00:00",2,0,0,1,28.7,69,187,256
"2011-06-12 19:00:00",2,0,0,1,28.7,67,156,223
"2011-06-12 20:00:00",2,0,0,1,27.06,62,144,206
"2011-06-12 21:00:00",2,0,0,1,27.06,39,101,140
"2011-06-12 22:00:00",2,0,0,1,26.24,31,97,128
"2011-06-12 23:00:00",2,0,0,1,26.24,33,74,107
"2011-06-13 00:00:00",2,0,1,1,26.24,8,20,28
"2011-06-13 01:00:00",2,0,1,1,26.24,6,10,16
"2011-06-13 02:00:00",2,0,1,1,25.42,2,8,10
"2011-06-13 03:00:00",2,0,1,1,24.6,1,6,7
"2011-06-13 04:00:00",2,0,1,1,22.96,1,3,4
"2011-06-13 05:00:00",2,0,1,1,22.14,2,27,29
"2011-06-13 06:00:00",2,0,1,1,22.14,7,98,105
"2011-06-13 07:00:00",2,0,1,1,22.96,26,302,328
"2011-06-13 08:00:00",2,0,1,1,23.78,44,432,476
"2011-06-13 09:00:00",2,0,1,1,25.42,35,189,224
"2011-06-13 10:00:00",2,0,1,1,26.24,38,80,118
"2011-06-13 11:00:00",2,0,1,1,27.06,53,106,159
"2011-06-13 12:00:00",2,0,1,1,27.06,35,161,196
"2011-06-13 13:00:00",2,0,1,1,28.7,53,174,227
"2011-06-13 14:00:00",2,0,1,1,28.7,55,145,200
"2011-06-13 15:00:00",2,0,1,1,28.7,58,127,185
"2011-06-13 16:00:00",2,0,1,1,28.7,64,262,326
"2011-06-13 17:00:00",2,0,1,1,28.7,72,529,601
"2011-06-13 18:00:00",2,0,1,1,28.7,76,510,586
"2011-06-13 19:00:00",2,0,1,1,27.06,75,348,423
"2011-06-13 20:00:00",2,0,1,1,26.24,78,253,331
"2011-06-13 21:00:00",2,0,1,1,26.24,40,178,218
"2011-06-13 22:00:00",2,0,1,1,25.42,20,114,134
"2011-06-13 23:00:00",2,0,1,1,25.42,14,75,89
"2011-06-14 00:00:00",2,0,1,1,24.6,13,18,31
"2011-06-14 01:00:00",2,0,1,1,24.6,3,10,13
"2011-06-14 02:00:00",2,0,1,1,24.6,2,8,10
"2011-06-14 03:00:00",2,0,1,1,23.78,1,1,2
"2011-06-14 04:00:00",2,0,1,1,22.14,0,3,3
"2011-06-14 05:00:00",2,0,1,1,22.14,3,23,26
"2011-06-14 06:00:00",2,0,1,1,22.14,6,107,113
"2011-06-14 07:00:00",2,0,1,1,22.96,19,346,365
"2011-06-14 08:00:00",2,0,1,1,23.78,45,441,486
"2011-06-14 09:00:00",2,0,1,1,25.42,19,174,193
"2011-06-14 10:00:00",2,0,1,1,25.42,33,97,130
"2011-06-14 11:00:00",2,0,1,1,26.24,40,103,143
"2011-06-14 12:00:00",2,0,1,1,26.24,30,139,169
"2011-06-14 13:00:00",2,0,1,1,26.24,33,176,209
"2011-06-14 14:00:00",2,0,1,2,26.24,41,118,159
"2011-06-14 15:00:00",2,0,1,1,26.24,42,136,178
"2011-06-14 16:00:00",2,0,1,1,27.88,51,279,330
"2011-06-14 17:00:00",2,0,1,3,26.24,85,484,569
"2011-06-14 18:00:00",2,0,1,1,25.42,65,473,538
"2011-06-14 19:00:00",2,0,1,1,26.24,51,335,386
"2011-06-14 20:00:00",2,0,1,1,24.6,60,237,297
"2011-06-14 21:00:00",2,0,1,1,24.6,37,206,243
"2011-06-14 22:00:00",2,0,1,1,23.78,29,159,188
"2011-06-14 23:00:00",2,0,1,1,22.96,19,91,110
"2011-06-15 00:00:00",2,0,1,1,22.96,8,44,52
"2011-06-15 01:00:00",2,0,1,1,22.14,0,14,14
"2011-06-15 02:00:00",2,0,1,1,21.32,0,9,9
"2011-06-15 03:00:00",2,0,1,1,20.5,0,1,1
"2011-06-15 04:00:00",2,0,1,1,20.5,0,4,4
"2011-06-15 05:00:00",2,0,1,1,19.68,1,20,21
"2011-06-15 06:00:00",2,0,1,1,20.5,11,110,121
"2011-06-15 07:00:00",2,0,1,1,22.14,22,348,370
"2011-06-15 08:00:00",2,0,1,1,23.78,53,445,498
"2011-06-15 09:00:00",2,0,1,1,24.6,22,185,207
"2011-06-15 10:00:00",2,0,1,1,26.24,27,108,135
"2011-06-15 11:00:00",2,0,1,1,27.88,49,115,164
"2011-06-15 12:00:00",2,0,1,1,28.7,33,178,211
"2011-06-15 13:00:00",2,0,1,1,30.34,43,146,189
"2011-06-15 14:00:00",2,0,1,1,30.34,50,128,178
"2011-06-15 15:00:00",2,0,1,1,31.16,33,131,164
"2011-06-15 16:00:00",2,0,1,1,31.16,47,265,312
"2011-06-15 17:00:00",2,0,1,1,30.34,83,555,638
"2011-06-15 18:00:00",2,0,1,1,29.52,80,527,607
"2011-06-15 19:00:00",2,0,1,1,28.7,54,362,416
"2011-06-15 20:00:00",2,0,1,1,27.06,57,273,330
"2011-06-15 21:00:00",2,0,1,1,26.24,48,209,257
"2011-06-15 22:00:00",2,0,1,1,25.42,31,144,175
"2011-06-15 23:00:00",2,0,1,1,25.42,17,90,107
"2011-06-16 00:00:00",2,0,1,1,24.6,9,38,47
"2011-06-16 01:00:00",2,0,1,1,23.78,4,13,17
"2011-06-16 02:00:00",2,0,1,1,24.6,1,4,5
"2011-06-16 03:00:00",2,0,1,2,22.96,0,4,4
"2011-06-16 04:00:00",2,0,1,2,22.96,0,6,6
"2011-06-16 05:00:00",2,0,1,1,24.6,7,18,25
"2011-06-16 06:00:00",2,0,1,3,23.78,8,104,112
"2011-06-16 07:00:00",2,0,1,3,22.96,16,172,188
"2011-06-16 08:00:00",2,0,1,2,24.6,24,364,388
"2011-06-16 09:00:00",2,0,1,2,25.42,29,232,261
"2011-06-16 10:00:00",2,0,1,2,27.06,18,103,121
"2011-06-16 11:00:00",2,0,1,2,27.88,33,117,150
"2011-06-16 12:00:00",2,0,1,1,29.52,41,165,206
"2011-06-16 13:00:00",2,0,1,2,29.52,37,114,151
"2011-06-16 14:00:00",2,0,1,2,29.52,39,114,153
"2011-06-16 15:00:00",2,0,1,2,28.7,32,127,159
"2011-06-16 16:00:00",2,0,1,3,27.06,36,258,294
"2011-06-16 17:00:00",2,0,1,2,26.24,42,230,272
"2011-06-16 18:00:00",2,0,1,1,26.24,26,299,325
"2011-06-16 19:00:00",2,0,1,1,25.42,58,269,327
"2011-06-16 20:00:00",2,0,1,1,25.42,25,176,201
"2011-06-16 21:00:00",2,0,1,3,25.42,34,154,188
"2011-06-16 22:00:00",2,0,1,3,25.42,24,127,151
"2011-06-16 23:00:00",2,0,1,3,24.6,2,14,16
"2011-06-17 00:00:00",2,0,1,1,22.96,3,21,24
"2011-06-17 01:00:00",2,0,1,1,22.96,4,19,23
"2011-06-17 02:00:00",2,0,1,1,22.96,2,11,13
"2011-06-17 03:00:00",2,0,1,1,22.96,1,5,6
"2011-06-17 04:00:00",2,0,1,1,22.14,1,5,6
"2011-06-17 05:00:00",2,0,1,1,22.14,1,12,13
"2011-06-17 06:00:00",2,0,1,1,22.96,8,89,97
"2011-06-17 07:00:00",2,0,1,1,24.6,25,225,250
"2011-06-17 08:00:00",2,0,1,2,24.6,28,426,454
"2011-06-17 09:00:00",2,0,1,1,28.7,28,196,224
"2011-06-17 10:00:00",2,0,1,1,28.7,44,126,170
"2011-06-17 11:00:00",2,0,1,1,27.88,43,138,181
"2011-06-17 12:00:00",2,0,1,1,28.7,49,194,243
"2011-06-17 13:00:00",2,0,1,1,30.34,48,156,204
"2011-06-17 14:00:00",2,0,1,1,31.16,73,142,215
"2011-06-17 15:00:00",2,0,1,1,31.98,62,181,243
"2011-06-17 16:00:00",2,0,1,1,31.16,69,286,355
"2011-06-17 17:00:00",2,0,1,3,31.16,85,467,552
"2011-06-17 18:00:00",2,0,1,3,31.16,62,388,450
"2011-06-17 19:00:00",2,0,1,3,26.24,53,275,328
"2011-06-17 20:00:00",2,0,1,1,26.24,40,192,232
"2011-06-17 21:00:00",2,0,1,1,26.24,49,159,208
"2011-06-17 22:00:00",2,0,1,1,25.42,48,127,175
"2011-06-17 23:00:00",2,0,1,1,25.42,37,141,178
"2011-06-18 00:00:00",2,0,0,1,25.42,21,83,104
"2011-06-18 01:00:00",2,0,0,1,25.42,15,80,95
"2011-06-18 02:00:00",2,0,0,1,24.6,16,37,53
"2011-06-18 03:00:00",2,0,0,1,24.6,4,16,20
"2011-06-18 04:00:00",2,0,0,1,24.6,1,4,5
"2011-06-18 05:00:00",2,0,0,1,25.42,1,6,7
"2011-06-18 06:00:00",2,0,0,1,25.42,9,18,27
"2011-06-18 07:00:00",2,0,0,1,26.24,12,45,57
"2011-06-18 08:00:00",2,0,0,1,27.06,28,103,131
"2011-06-18 09:00:00",2,0,0,1,28.7,62,156,218
"2011-06-18 10:00:00",2,0,0,1,29.52,68,176,244
"2011-06-18 11:00:00",2,0,0,1,29.52,134,270,404
"2011-06-18 12:00:00",2,0,0,1,30.34,162,258,420
"2011-06-18 13:00:00",2,0,0,1,31.16,135,192,327
"2011-06-18 14:00:00",2,0,0,2,32.8,138,196,334
"2011-06-18 15:00:00",2,0,0,2,33.62,153,214,367
"2011-06-18 16:00:00",2,0,0,2,31.16,193,275,468
"2011-06-18 17:00:00",2,0,0,2,31.16,210,239,449
"2011-06-18 18:00:00",2,0,0,2,30.34,118,263,381
"2011-06-18 19:00:00",2,0,0,2,30.34,99,227,326
"2011-06-18 20:00:00",2,0,0,2,29.52,61,127,188
"2011-06-18 21:00:00",2,0,0,2,29.52,58,125,183
"2011-06-18 22:00:00",2,0,0,2,29.52,56,105,161
"2011-06-18 23:00:00",2,0,0,2,29.52,53,97,150
"2011-06-19 00:00:00",2,0,0,1,28.7,18,71,89
"2011-06-19 01:00:00",2,0,0,2,28.7,17,59,76
"2011-06-19 02:00:00",2,0,0,1,27.88,13,59,72
"2011-06-19 03:00:00",2,0,0,2,27.06,14,16,30
"2011-06-19 04:00:00",2,0,0,2,27.06,7,10,17
"2011-06-19 05:00:00",2,0,0,2,27.06,7,12,19
"2011-06-19 06:00:00",2,0,0,2,27.06,11,22,33
"2011-06-19 07:00:00",2,0,0,2,27.06,35,36,71
"2011-06-19 08:00:00",2,0,0,3,27.88,25,59,84
"2011-06-19 09:00:00",2,0,0,2,27.88,58,111,169
"2011-06-19 10:00:00",2,0,0,2,28.7,86,158,244
"2011-06-19 11:00:00",2,0,0,2,29.52,141,236,377
"2011-06-19 12:00:00",2,0,0,2,30.34,141,255,396
"2011-06-19 13:00:00",2,0,0,2,30.34,149,214,363
"2011-06-19 14:00:00",2,0,0,3,30.34,124,193,317
"2011-06-19 15:00:00",2,0,0,2,30.34,146,216,362
"2011-06-19 16:00:00",2,0,0,2,31.16,121,257,378
"2011-06-19 17:00:00",2,0,0,1,30.34,159,238,397
"2011-06-19 18:00:00",2,0,0,2,30.34,78,218,296
"2011-06-19 19:00:00",2,0,0,1,29.52,94,217,311
"2011-06-19 20:00:00",2,0,0,1,28.7,86,146,232
"2011-06-19 21:00:00",2,0,0,1,27.88,57,110,167
"2011-06-19 22:00:00",2,0,0,1,27.06,38,114,152
"2011-06-19 23:00:00",2,0,0,1,27.06,14,78,92
"2011-07-01 00:00:00",3,0,1,1,27.06,20,48,68
"2011-07-01 01:00:00",3,0,1,1,27.06,15,16,31
"2011-07-01 02:00:00",3,0,1,1,25.42,6,7,13
"2011-07-01 03:00:00",3,0,1,1,26.24,5,6,11
"2011-07-01 04:00:00",3,0,1,1,25.42,1,5,6
"2011-07-01 05:00:00",3,0,1,1,24.6,3,27,30
"2011-07-01 06:00:00",3,0,1,1,25.42,11,97,108
"2011-07-01 07:00:00",3,0,1,1,27.06,25,218,243
"2011-07-01 08:00:00",3,0,1,1,28.7,39,453,492
"2011-07-01 09:00:00",3,0,1,1,30.34,58,202,260
"2011-07-01 10:00:00",3,0,1,1,31.16,61,109,170
"2011-07-01 11:00:00",3,0,1,1,32.8,68,146,214
"2011-07-01 12:00:00",3,0,1,1,32.8,83,180,263
"2011-07-01 13:00:00",3,0,1,1,32.8,83,209,292
"2011-07-01 14:00:00",3,0,1,1,33.62,78,225,303
"2011-07-01 15:00:00",3,0,1,1,33.62,82,299,381
"2011-07-01 16:00:00",3,0,1,1,33.62,85,342,427
"2011-07-01 17:00:00",3,0,1,1,33.62,99,362,461
"2011-07-01 18:00:00",3,0,1,1,32.8,98,324,422
"2011-07-01 19:00:00",3,0,1,1,31.98,80,238,318
"2011-07-01 20:00:00",3,0,1,1,29.52,84,185,269
"2011-07-01 21:00:00",3,0,1,1,28.7,69,149,218
"2011-07-01 22:00:00",3,0,1,1,28.7,49,173,222
"2011-07-01 23:00:00",3,0,1,1,27.88,44,96,140
"2011-07-02 00:00:00",3,0,0,1,27.88,31,84,115
"2011-07-02 01:00:00",3,0,0,1,27.06,20,58,78
"2011-07-02 02:00:00",3,0,0,1,26.24,9,43,52
"2011-07-02 03:00:00",3,0,0,1,26.24,5,21,26
"2011-07-02 04:00:00",3,0,0,1,25.42,3,8,11
"2011-07-02 05:00:00",3,0,0,1,23.78,1,13,14
"2011-07-02 06:00:00",3,0,0,1,25.42,11,21,32
"2011-07-02 07:00:00",3,0,0,1,26.24,10,35,45
"2011-07-02 08:00:00",3,0,0,1,27.88,38,94,132
"2011-07-02 09:00:00",3,0,0,1,30.34,55,124,179
"2011-07-02 10:00:00",3,0,0,1,32.8,103,168,271
"2011-07-02 11:00:00",3,0,0,1,32.8,144,213,357
"2011-07-02 12:00:00",3,0,0,1,33.62,142,232,374
"2011-07-02 13:00:00",3,0,0,1,33.62,178,226,404
"2011-07-02 14:00:00",3,0,0,1,34.44,177,215,392
"2011-07-02 15:00:00",3,0,0,1,35.26,168,163,331
"2011-07-02 16:00:00",3,0,0,1,36.08,206,192,398
"2011-07-02 17:00:00",3,0,0,1,34.44,179,170,349
"2011-07-02 18:00:00",3,0,0,1,33.62,193,190,383
"2011-07-02 19:00:00",3,0,0,1,32.8,156,149,305
"2011-07-02 20:00:00",3,0,0,1,31.16,136,148,284
"2011-07-02 21:00:00",3,0,0,1,30.34,95,137,232
"2011-07-02 22:00:00",3,0,0,1,29.52,78,123,201
"2011-07-02 23:00:00",3,0,0,1,29.52,66,88,154
"2011-07-03 00:00:00",3,0,0,1,28.7,47,97,144
"2011-07-03 01:00:00",3,0,0,2,28.7,23,55,78
"2011-07-03 02:00:00",3,0,0,1,28.7,19,50,69
"2011-07-03 03:00:00",3,0,0,3,27.88,8,25,33
"2011-07-03 04:00:00",3,0,0,3,27.88,3,2,5
"2011-07-03 05:00:00",3,0,0,3,25.42,0,1,1
"2011-07-03 06:00:00",3,0,0,2,25.42,0,3,3
"2011-07-03 07:00:00",3,0,0,2,26.24,3,22,25
"2011-07-03 08:00:00",3,0,0,1,27.88,39,53,92
"2011-07-03 09:00:00",3,0,0,1,28.7,82,99,181
"2011-07-03 10:00:00",3,0,0,1,30.34,131,133,264
"2011-07-03 11:00:00",3,0,0,1,31.16,215,175,390
"2011-07-03 12:00:00",3,0,0,1,32.8,198,206,404
"2011-07-03 13:00:00",3,0,0,1,32.8,248,173,421
"2011-07-03 14:00:00",3,0,0,1,33.62,225,150,375
"2011-07-03 15:00:00",3,0,0,1,34.44,194,182,376
"2011-07-03 16:00:00",3,0,0,1,34.44,195,219,414
"2011-07-03 17:00:00",3,0,0,3,32.8,181,177,358
"2011-07-03 18:00:00",3,0,0,3,32.8,74,107,181
"2011-07-03 19:00:00",3,0,0,2,27.06,100,83,183
"2011-07-03 20:00:00",3,0,0,3,27.06,83,93,176
"2011-07-03 21:00:00",3,0,0,2,27.06,75,92,167
"2011-07-03 22:00:00",3,0,0,2,27.06,69,93,162
"2011-07-03 23:00:00",3,0,0,1,26.24,70,77,147
"2011-07-04 00:00:00",3,1,0,1,26.24,63,77,140
"2011-07-04 01:00:00",3,1,0,1,26.24,43,76,119
"2011-07-04 02:00:00",3,1,0,1,26.24,33,30,63
"2011-07-04 03:00:00",3,1,0,1,26.24,13,13,26
"2011-07-04 04:00:00",3,1,0,2,27.06,8,4,12
"2011-07-04 05:00:00",3,1,0,2,26.24,1,3,4
"2011-07-04 06:00:00",3,1,0,1,26.24,5,11,16
"2011-07-04 07:00:00",3,1,0,1,27.06,17,19,36
"2011-07-04 08:00:00",3,1,0,1,28.7,42,44,86
"2011-07-04 09:00:00",3,1,0,2,29.52,142,96,238
"2011-07-04 10:00:00",3,1,0,2,31.16,166,114,280
"2011-07-04 11:00:00",3,1,0,2,31.16,177,172,349
"2011-07-04 12:00:00",3,1,0,2,31.98,237,210,447
"2011-07-04 13:00:00",3,1,0,2,31.98,242,181,423
"2011-07-04 14:00:00",3,1,0,1,32.8,235,173,408
"2011-07-04 15:00:00",3,1,0,1,33.62,224,184,408
"2011-07-04 16:00:00",3,1,0,1,33.62,236,216,452
"2011-07-04 17:00:00",3,1,0,1,32.8,240,196,436
"2011-07-04 18:00:00",3,1,0,1,32.8,222,196,418
"2011-07-04 19:00:00",3,1,0,2,31.98,170,205,375
"2011-07-04 20:00:00",3,1,0,2,31.16,195,191,386
"2011-07-04 21:00:00",3,1,0,2,30.34,195,262,457
"2011-07-04 22:00:00",3,1,0,2,30.34,115,211,326
"2011-07-04 23:00:00",3,1,0,2,29.52,44,94,138
"2011-07-05 00:00:00",3,0,1,2,28.7,19,36,55
"2011-07-05 01:00:00",3,0,1,1,28.7,15,24,39
"2011-07-05 02:00:00",3,0,1,1,27.06,8,5,13
"2011-07-05 03:00:00",3,0,1,1,27.06,1,7,8
"2011-07-05 04:00:00",3,0,1,1,27.06,1,4,5
"2011-07-05 05:00:00",3,0,1,1,27.06,1,19,20
"2011-07-05 06:00:00",3,0,1,1,27.06,3,91,94
"2011-07-05 07:00:00",3,0,1,1,28.7,22,248,270
"2011-07-05 08:00:00",3,0,1,1,29.52,41,391,432
"2011-07-05 09:00:00",3,0,1,1,30.34,50,177,227
"2011-07-05 10:00:00",3,0,1,1,31.16,55,84,139
"2011-07-05 11:00:00",3,0,1,1,31.98,75,97,172
"2011-07-05 12:00:00",3,0,1,1,32.8,71,130,201
"2011-07-05 13:00:00",3,0,1,1,33.62,67,136,203
"2011-07-05 14:00:00",3,0,1,1,32.8,66,112,178
"2011-07-05 15:00:00",3,0,1,1,33.62,51,111,162
"2011-07-05 16:00:00",3,0,1,1,33.62,79,202,281
"2011-07-05 17:00:00",3,0,1,1,33.62,79,466,545
"2011-07-05 18:00:00",3,0,1,1,32.8,70,426,496
"2011-07-05 19:00:00",3,0,1,1,32.8,71,297,368
"2011-07-05 20:00:00",3,0,1,1,31.16,59,225,284
"2011-07-05 21:00:00",3,0,1,1,31.98,77,168,245
"2011-07-05 22:00:00",3,0,1,1,31.16,31,124,155
"2011-07-05 23:00:00",3,0,1,1,30.34,19,54,73
"2011-07-06 00:00:00",3,0,1,1,29.52,11,26,37
"2011-07-06 01:00:00",3,0,1,1,28.7,4,11,15
"2011-07-06 02:00:00",3,0,1,1,28.7,1,4,5
"2011-07-06 03:00:00",3,0,1,1,28.7,0,6,6
"2011-07-06 04:00:00",3,0,1,2,27.88,0,6,6
"2011-07-06 05:00:00",3,0,1,1,27.88,5,30,35
"2011-07-06 06:00:00",3,0,1,1,28.7,9,112,121
"2011-07-06 07:00:00",3,0,1,2,29.52,24,288,312
"2011-07-06 08:00:00",3,0,1,2,29.52,31,397,428
"2011-07-06 09:00:00",3,0,1,3,28.7,31,158,189
"2011-07-06 10:00:00",3,0,1,3,28.7,13,30,43
"2011-07-06 11:00:00",3,0,1,2,29.52,24,103,127
"2011-07-06 12:00:00",3,0,1,2,30.34,38,114,152
"2011-07-06 13:00:00",3,0,1,2,30.34,33,107,140
"2011-07-06 14:00:00",3,0,1,1,31.16,50,113,163
"2011-07-06 15:00:00",3,0,1,1,31.16,55,130,185
"2011-07-06 16:00:00",3,0,1,1,31.16,57,218,275
"2011-07-06 17:00:00",3,0,1,1,31.98,79,517,596
"2011-07-06 18:00:00",3,0,1,1,31.16,77,486,563
"2011-07-06 19:00:00",3,0,1,1,30.34,71,323,394
"2011-07-06 20:00:00",3,0,1,1,29.52,55,257,312
"2011-07-06 21:00:00",3,0,1,1,28.7,66,175,241
"2011-07-06 22:00:00",3,0,1,1,28.7,30,156,186
"2011-07-06 23:00:00",3,0,1,1,27.88,20,78,98
"2011-07-07 00:00:00",3,0,1,1,27.06,6,29,35
"2011-07-07 01:00:00",3,0,1,1,27.06,2,14,16
"2011-07-07 02:00:00",3,0,1,1,27.06,1,7,8
"2011-07-07 03:00:00",3,0,1,1,26.24,2,2,4
"2011-07-07 04:00:00",3,0,1,1,26.24,0,4,4
"2011-07-07 05:00:00",3,0,1,1,26.24,2,30,32
"2011-07-07 06:00:00",3,0,1,2,26.24,11,107,118
"2011-07-07 07:00:00",3,0,1,2,27.06,13,279,292
"2011-07-07 08:00:00",3,0,1,2,28.7,28,415,443
"2011-07-07 09:00:00",3,0,1,1,30.34,25,154,179
"2011-07-07 10:00:00",3,0,1,1,31.98,29,72,101
"2011-07-07 11:00:00",3,0,1,1,33.62,30,112,142
"2011-07-07 12:00:00",3,0,1,1,34.44,32,139,171
"2011-07-07 13:00:00",3,0,1,1,35.26,48,107,155
"2011-07-07 14:00:00",3,0,1,1,35.26,39,121,160
"2011-07-07 15:00:00",3,0,1,1,35.26,47,119,166
"2011-07-07 16:00:00",3,0,1,1,35.26,47,218,265
"2011-07-07 17:00:00",3,0,1,1,35.26,80,489,569
"2011-07-07 18:00:00",3,0,1,1,34.44,70,492,562
"2011-07-07 19:00:00",3,0,1,1,33.62,79,286,365
"2011-07-07 20:00:00",3,0,1,1,31.16,61,224,285
"2011-07-07 21:00:00",3,0,1,1,30.34,39,170,209
"2011-07-07 22:00:00",3,0,1,1,30.34,32,150,182
"2011-07-07 23:00:00",3,0,1,1,29.52,31,98,129
"2011-07-08 00:00:00",3,0,1,1,30.34,6,41,47
"2011-07-08 01:00:00",3,0,1,1,29.52,9,25,34
"2011-07-08 02:00:00",3,0,1,2,28.7,10,12,22
"2011-07-08 03:00:00",3,0,1,1,27.88,2,4,6
"2011-07-08 04:00:00",3,0,1,1,28.7,7,4,11
"2011-07-08 05:00:00",3,0,1,1,27.88,3,24,27
"2011-07-08 06:00:00",3,0,1,1,28.7,11,91,102
"2011-07-08 07:00:00",3,0,1,2,28.7,30,302,332
"2011-07-08 08:00:00",3,0,1,2,29.52,36,421,457
"2011-07-08 09:00:00",3,0,1,2,31.16,30,211,241
"2011-07-08 10:00:00",3,0,1,2,30.34,30,108,138
"2011-07-08 11:00:00",3,0,1,2,30.34,61,104,165
"2011-07-08 12:00:00",3,0,1,2,31.16,49,164,213
"2011-07-08 13:00:00",3,0,1,2,31.98,54,175,229
"2011-07-08 14:00:00",3,0,1,2,32.8,53,163,216
"2011-07-08 15:00:00",3,0,1,2,32.8,39,102,141
"2011-07-08 16:00:00",3,0,1,3,27.88,27,105,132
"2011-07-08 17:00:00",3,0,1,3,27.06,6,161,167
"2011-07-08 18:00:00",3,0,1,1,27.06,35,281,316
"2011-07-08 19:00:00",3,0,1,1,27.06,45,225,270
"2011-07-08 20:00:00",3,0,1,1,27.06,30,220,250
"2011-07-08 21:00:00",3,0,1,2,27.06,46,158,204
"2011-07-08 22:00:00",3,0,1,2,27.06,33,136,169
"2011-07-08 23:00:00",3,0,1,2,27.06,40,111,151
"2011-07-09 00:00:00",3,0,0,2,27.06,31,90,121
"2011-07-09 01:00:00",3,0,0,2,26.24,5,48,53
"2011-07-09 02:00:00",3,0,0,1,26.24,12,43,55
"2011-07-09 03:00:00",3,0,0,1,26.24,7,23,30
"2011-07-09 04:00:00",3,0,0,1,26.24,2,4,6
"2011-07-09 05:00:00",3,0,0,2,25.42,4,11,15
"2011-07-09 06:00:00",3,0,0,2,26.24,11,27,38
"2011-07-09 07:00:00",3,0,0,1,27.06,21,50,71
"2011-07-09 08:00:00",3,0,0,1,28.7,68,114,182
"2011-07-09 09:00:00",3,0,0,1,30.34,77,170,247
"2011-07-09 10:00:00",3,0,0,1,31.16,87,177,264
"2011-07-09 11:00:00",3,0,0,1,31.98,101,189,290
"2011-07-09 12:00:00",3,0,0,1,32.8,145,221,366
"2011-07-09 13:00:00",3,0,0,1,33.62,167,249,416
"2011-07-09 14:00:00",3,0,0,1,34.44,158,215,373
"2011-07-09 15:00:00",3,0,0,1,34.44,182,220,402
"2011-07-09 16:00:00",3,0,0,1,33.62,171,245,416
"2011-07-09 17:00:00",3,0,0,1,34.44,160,241,401
"2011-07-09 18:00:00",3,0,0,1,33.62,132,246,378
"2011-07-09 19:00:00",3,0,0,1,31.16,128,178,306
"2011-07-09 20:00:00",3,0,0,1,31.16,129,185,314
"2011-07-09 21:00:00",3,0,0,1,30.34,83,155,238
"2011-07-09 22:00:00",3,0,0,1,29.52,60,154,214
"2011-07-09 23:00:00",3,0,0,1,29.52,47,93,140
"2011-07-10 00:00:00",3,0,0,1,28.7,42,112,154
"2011-07-10 01:00:00",3,0,0,1,28.7,19,94,113
"2011-07-10 02:00:00",3,0,0,1,27.88,28,68,96
"2011-07-10 03:00:00",3,0,0,1,27.06,6,19,25
"2011-07-10 04:00:00",3,0,0,1,27.06,0,5,5
"2011-07-10 05:00:00",3,0,0,1,27.06,7,10,17
"2011-07-10 06:00:00",3,0,0,1,26.24,8,17,25
"2011-07-10 07:00:00",3,0,0,1,28.7,27,38,65
"2011-07-10 08:00:00",3,0,0,1,29.52,27,65,92
"2011-07-10 09:00:00",3,0,0,1,30.34,62,107,169
"2011-07-10 10:00:00",3,0,0,1,31.16,95,173,268
"2011-07-10 11:00:00",3,0,0,1,31.98,110,177,287
"2011-07-10 12:00:00",3,0,0,1,33.62,133,244,377
"2011-07-10 13:00:00",3,0,0,1,32.8,139,228,367
"2011-07-10 14:00:00",3,0,0,1,33.62,122,227,349
"2011-07-10 15:00:00",3,0,0,1,34.44,142,219,361
"2011-07-10 16:00:00",3,0,0,1,34.44,128,244,372
"2011-07-10 17:00:00",3,0,0,1,34.44,146,217,363
"2011-07-10 18:00:00",3,0,0,1,33.62,141,222,363
"2011-07-10 19:00:00",3,0,0,1,32.8,120,183,303
"2011-07-10 20:00:00",3,0,0,1,31.16,101,167,268
"2011-07-10 21:00:00",3,0,0,1,30.34,65,162,227
"2011-07-10 22:00:00",3,0,0,1,30.34,56,87,143
"2011-07-10 23:00:00",3,0,0,1,29.52,19,53,72
"2011-07-11 00:00:00",3,0,1,1,28.7,10,25,35
"2011-07-11 01:00:00",3,0,1,1,28.7,5,5,10
"2011-07-11 02:00:00",3,0,1,1,28.7,8,4,12
"2011-07-11 03:00:00",3,0,1,1,27.88,2,8,10
"2011-07-11 04:00:00",3,0,1,1,27.06,0,4,4
"2011-07-11 05:00:00",3,0,1,1,27.06,5,21,26
"2011-07-11 06:00:00",3,0,1,1,27.88,19,102,121
"2011-07-11 07:00:00",3,0,1,1,28.7,28,289,317
"2011-07-11 08:00:00",3,0,1,1,30.34,35,385,420
"2011-07-11 09:00:00",3,0,1,1,31.98,41,167,208
"2011-07-11 10:00:00",3,0,1,1,32.8,44,73,117
"2011-07-11 11:00:00",3,0,1,1,33.62,39,89,128
"2011-07-11 12:00:00",3,0,1,1,34.44,40,108,148
"2011-07-11 13:00:00",3,0,1,1,35.26,22,119,141
"2011-07-11 14:00:00",3,0,1,1,35.26,40,94,134
"2011-07-11 15:00:00",3,0,1,1,35.26,38,108,146
"2011-07-11 16:00:00",3,0,1,1,35.26,57,182,239
"2011-07-11 17:00:00",3,0,1,1,35.26,59,455,514
"2011-07-11 18:00:00",3,0,1,1,35.26,57,415,472
"2011-07-11 19:00:00",3,0,1,1,34.44,80,293,373
"2011-07-11 20:00:00",3,0,1,1,29.52,42,194,236
"2011-07-11 21:00:00",3,0,1,1,28.7,21,109,130
"2011-07-11 22:00:00",3,0,1,1,29.52,20,70,90
"2011-07-11 23:00:00",3,0,1,1,28.7,11,44,55
"2011-07-12 00:00:00",3,0,1,1,28.7,3,19,22
"2011-07-12 01:00:00",3,0,1,1,28.7,6,8,14
"2011-07-12 02:00:00",3,0,1,1,28.7,2,7,9
"2011-07-12 03:00:00",3,0,1,2,28.7,2,6,8
"2011-07-12 04:00:00",3,0,1,1,28.7,0,6,6
"2011-07-12 05:00:00",3,0,1,1,28.7,4,21,25
"2011-07-12 06:00:00",3,0,1,1,30.34,13,102,115
"2011-07-12 07:00:00",3,0,1,1,31.16,29,301,330
"2011-07-12 08:00:00",3,0,1,1,31.16,35,382,417
"2011-07-12 09:00:00",3,0,1,1,31.98,27,149,176
"2011-07-12 10:00:00",3,0,1,1,33.62,38,85,123
"2011-07-12 11:00:00",3,0,1,1,33.62,39,86,125
"2011-07-12 12:00:00",3,0,1,1,35.26,38,125,163
"2011-07-12 13:00:00",3,0,1,1,35.26,32,104,136
"2011-07-12 14:00:00",3,0,1,1,36.9,33,91,124
"2011-07-12 15:00:00",3,0,1,1,36.9,37,111,148
"2011-07-12 16:00:00",3,0,1,1,35.26,25,177,202
"2011-07-12 17:00:00",3,0,1,1,36.08,48,380,428
"2011-07-12 18:00:00",3,0,1,1,35.26,39,472,511
"2011-07-12 19:00:00",3,0,1,1,34.44,42,295,337
"2011-07-12 20:00:00",3,0,1,1,33.62,57,251,308
"2011-07-12 21:00:00",3,0,1,1,33.62,49,209,258
"2011-07-12 22:00:00",3,0,1,1,32.8,44,150,194
"2011-07-12 23:00:00",3,0,1,1,31.98,20,59,79
"2011-07-13 00:00:00",3,0,1,1,31.16,9,37,46
"2011-07-13 01:00:00",3,0,1,1,31.16,1,11,12
"2011-07-13 02:00:00",3,0,1,1,31.16,2,3,5
"2011-07-13 03:00:00",3,0,1,1,30.34,0,4,4
"2011-07-13 04:00:00",3,0,1,1,30.34,0,5,5
"2011-07-13 05:00:00",3,0,1,1,30.34,4,22,26
"2011-07-13 06:00:00",3,0,1,1,30.34,18,103,121
"2011-07-13 07:00:00",3,0,1,1,31.16,32,281,313
"2011-07-13 08:00:00",3,0,1,1,32.8,31,418,449
"2011-07-13 09:00:00",3,0,1,1,33.62,23,163,186
"2011-07-13 10:00:00",3,0,1,1,33.62,33,80,113
"2011-07-13 11:00:00",3,0,1,1,34.44,55,110,165
"2011-07-13 12:00:00",3,0,1,1,34.44,40,134,174
"2011-07-13 13:00:00",3,0,1,3,33.62,39,119,158
"2011-07-13 14:00:00",3,0,1,3,33.62,27,89,116
"2011-07-13 15:00:00",3,0,1,3,26.24,13,33,46
"2011-07-13 16:00:00",3,0,1,2,27.06,23,118,141
"2011-07-13 17:00:00",3,0,1,1,28.7,70,418,488
"2011-07-13 18:00:00",3,0,1,1,29.52,51,412,463
"2011-07-13 19:00:00",3,0,1,1,28.7,79,340,419
"2011-07-13 20:00:00",3,0,1,1,28.7,61,281,342
"2011-07-13 21:00:00",3,0,1,1,28.7,56,194,250
"2011-07-13 22:00:00",3,0,1,1,27.88,48,136,184
"2011-07-13 23:00:00",3,0,1,1,27.06,33,83,116
"2011-07-14 00:00:00",3,0,1,1,27.06,14,32,46
"2011-07-14 01:00:00",3,0,1,1,27.06,4,21,25
"2011-07-14 02:00:00",3,0,1,1,26.24,3,7,10
"2011-07-14 03:00:00",3,0,1,1,25.42,1,5,6
"2011-07-14 04:00:00",3,0,1,1,25.42,0,6,6
"2011-07-14 05:00:00",3,0,1,1,24.6,6,22,28
"2011-07-14 06:00:00",3,0,1,1,24.6,14,116,130
"2011-07-14 07:00:00",3,0,1,1,25.42,23,311,334
"2011-07-14 08:00:00",3,0,1,1,26.24,53,433,486
"2011-07-14 09:00:00",3,0,1,1,27.88,29,195,224
"2011-07-14 10:00:00",3,0,1,1,28.7,32,95,127
"2011-07-14 11:00:00",3,0,1,1,29.52,38,110,148
"2011-07-14 12:00:00",3,0,1,1,30.34,51,172,223
"2011-07-14 13:00:00",3,0,1,1,31.16,39,138,177
"2011-07-14 14:00:00",3,0,1,1,30.34,49,129,178
"2011-07-14 15:00:00",3,0,1,1,31.16,42,138,180
"2011-07-14 16:00:00",3,0,1,1,31.16,43,231,274
"2011-07-14 17:00:00",3,0,1,1,30.34,78,517,595
"2011-07-14 18:00:00",3,0,1,1,29.52,94,484,578
"2011-07-14 19:00:00",3,0,1,1,29.52,67,333,400
"2011-07-14 20:00:00",3,0,1,1,28.7,81,267,348
"2011-07-14 21:00:00",3,0,1,1,27.06,58,203,261
"2011-07-14 22:00:00",3,0,1,1,26.24,42,134,176
"2011-07-14 23:00:00",3,0,1,1,26.24,27,97,124
"2011-07-15 00:00:00",3,0,1,1,25.42,23,57,80
"2011-07-15 01:00:00",3,0,1,1,25.42,7,13,20
"2011-07-15 02:00:00",3,0,1,1,24.6,16,22,38
"2011-07-15 03:00:00",3,0,1,1,24.6,1,6,7
"2011-07-15 04:00:00",3,0,1,1,24.6,2,8,10
"2011-07-15 05:00:00",3,0,1,1,24.6,7,16,23
"2011-07-15 06:00:00",3,0,1,2,24.6,12,108,120
"2011-07-15 07:00:00",3,0,1,1,26.24,17,257,274
"2011-07-15 08:00:00",3,0,1,1,26.24,50,514,564
"2011-07-15 09:00:00",3,0,1,1,27.88,31,176,207
"2011-07-15 10:00:00",3,0,1,2,27.06,59,107,166
"2011-07-15 11:00:00",3,0,1,1,28.7,73,137,210
"2011-07-15 12:00:00",3,0,1,1,28.7,61,177,238
"2011-07-15 13:00:00",3,0,1,1,28.7,85,162,247
"2011-07-15 14:00:00",3,0,1,1,28.7,105,160,265
"2011-07-15 15:00:00",3,0,1,1,29.52,74,163,237
"2011-07-15 16:00:00",3,0,1,1,29.52,96,265,361
"2011-07-15 17:00:00",3,0,1,1,30.34,104,483,587
"2011-07-15 18:00:00",3,0,1,1,29.52,102,394,496
"2011-07-15 19:00:00",3,0,1,1,28.7,114,280,394
"2011-07-15 20:00:00",3,0,1,1,28.7,92,251,343
"2011-07-15 21:00:00",3,0,1,1,27.06,75,186,261
"2011-07-15 22:00:00",3,0,1,1,27.06,71,152,223
"2011-07-15 23:00:00",3,0,1,1,26.24,41,126,167
"2011-07-16 00:00:00",3,0,0,1,25.42,42,68,110
"2011-07-16 01:00:00",3,0,0,1,24.6,24,51,75
"2011-07-16 02:00:00",3,0,0,1,24.6,10,48,58
"2011-07-16 03:00:00",3,0,0,1,24.6,6,20,26
"2011-07-16 04:00:00",3,0,0,1,24.6,9,7,16
"2011-07-16 05:00:00",3,0,0,1,23.78,4,6,10
"2011-07-16 06:00:00",3,0,0,1,24.6,16,21,37
"2011-07-16 07:00:00",3,0,0,1,25.42,14,38,52
"2011-07-16 08:00:00",3,0,0,1,27.06,37,90,127
"2011-07-16 09:00:00",3,0,0,1,28.7,72,150,222
"2011-07-16 10:00:00",3,0,0,1,29.52,114,208,322
"2011-07-16 11:00:00",3,0,0,1,30.34,171,225,396
"2011-07-16 12:00:00",3,0,0,1,31.16,187,276,463
"2011-07-16 13:00:00",3,0,0,1,31.16,221,276,497
"2011-07-16 14:00:00",3,0,0,1,30.34,201,232,433
"2011-07-16 15:00:00",3,0,0,1,31.16,205,223,428
"2011-07-16 16:00:00",3,0,0,1,31.16,183,242,425
"2011-07-16 17:00:00",3,0,0,1,31.16,234,241,475
"2011-07-16 18:00:00",3,0,0,1,31.16,185,243,428
"2011-07-16 19:00:00",3,0,0,1,30.34,164,242,406
"2011-07-16 20:00:00",3,0,0,1,29.52,108,188,296
"2011-07-16 21:00:00",3,0,0,1,28.7,85,167,252
"2011-07-16 22:00:00",3,0,0,1,28.7,65,136,201
"2011-07-16 23:00:00",3,0,0,1,27.88,61,107,168
"2011-07-17 00:00:00",3,0,0,1,27.06,34,91,125
"2011-07-17 01:00:00",3,0,0,1,26.24,16,86,102
"2011-07-17 02:00:00",3,0,0,1,26.24,28,66,94
"2011-07-17 03:00:00",3,0,0,1,26.24,21,26,47
"2011-07-17 04:00:00",3,0,0,1,25.42,4,6,10
"2011-07-17 05:00:00",3,0,0,1,26.24,4,8,12
"2011-07-17 06:00:00",3,0,0,1,25.42,10,11,21
"2011-07-17 07:00:00",3,0,0,1,26.24,20,30,50
"2011-07-17 08:00:00",3,0,0,1,27.88,45,73,118
"2011-07-17 09:00:00",3,0,0,1,29.52,74,110,184
"2011-07-17 10:00:00",3,0,0,1,30.34,127,177,304
"2011-07-17 11:00:00",3,0,0,1,31.16,147,244,391
"2011-07-17 12:00:00",3,0,0,1,31.16,177,243,420
"2011-07-17 13:00:00",3,0,0,1,32.8,200,272,472
"2011-07-17 14:00:00",3,0,0,1,32.8,168,262,430
"2011-07-17 15:00:00",3,0,0,1,33.62,129,195,324
"2011-07-17 16:00:00",3,0,0,1,32.8,129,188,317
"2011-07-17 17:00:00",3,0,0,1,32.8,133,236,369
"2011-07-17 18:00:00",3,0,0,1,32.8,147,243,390
"2011-07-17 19:00:00",3,0,0,1,31.16,145,234,379
"2011-07-17 20:00:00",3,0,0,1,31.16,85,177,262
"2011-07-17 21:00:00",3,0,0,1,30.34,59,148,207
"2011-07-17 22:00:00",3,0,0,1,29.52,65,116,181
"2011-07-17 23:00:00",3,0,0,1,28.7,39,54,93
"2011-07-18 00:00:00",3,0,1,1,28.7,21,30,51
"2011-07-18 01:00:00",3,0,1,1,28.7,17,8,25
"2011-07-18 02:00:00",3,0,1,1,27.06,2,8,10
"2011-07-18 03:00:00",3,0,1,1,27.06,3,4,7
"2011-07-18 04:00:00",3,0,1,1,26.24,1,3,4
"2011-07-18 05:00:00",3,0,1,1,26.24,2,15,17
"2011-07-18 06:00:00",3,0,1,1,26.24,10,95,105
"2011-07-18 07:00:00",3,0,1,1,27.88,22,255,277
"2011-07-18 08:00:00",3,0,1,1,28.7,18,329,347
"2011-07-18 09:00:00",3,0,1,1,30.34,33,170,203
"2011-07-18 10:00:00",3,0,1,1,31.16,52,78,130
"2011-07-18 11:00:00",3,0,1,1,32.8,42,99,141
"2011-07-18 12:00:00",3,0,1,1,32.8,39,126,165
"2011-07-18 13:00:00",3,0,1,1,33.62,27,125,152
"2011-07-18 14:00:00",3,0,1,1,33.62,32,106,138
"2011-07-18 15:00:00",3,0,1,1,34.44,53,111,164
"2011-07-18 16:00:00",3,0,1,1,34.44,45,220,265
"2011-07-18 17:00:00",3,0,1,1,34.44,72,473,545
"2011-07-18 18:00:00",3,0,1,1,33.62,80,478,558
"2011-07-18 19:00:00",3,0,1,1,32.8,63,335,398
"2011-07-18 20:00:00",3,0,1,1,31.98,91,232,323
"2011-07-18 21:00:00",3,0,1,1,30.34,48,154,202
"2011-07-18 22:00:00",3,0,1,1,31.16,36,104,140
"2011-07-18 23:00:00",3,0,1,1,30.34,32,59,91
"2011-07-19 00:00:00",3,0,1,1,30.34,25,26,51
"2011-07-19 01:00:00",3,0,1,2,30.34,7,6,13
"2011-07-19 02:00:00",3,0,1,1,29.52,9,4,13
"2011-07-19 03:00:00",3,0,1,1,29.52,2,1,3
"2011-07-19 04:00:00",3,0,1,1,29.52,1,4,5
"2011-07-19 05:00:00",3,0,1,2,28.7,0,19,19
"2011-07-19 06:00:00",3,0,1,2,29.52,8,126,134
"2011-07-19 07:00:00",3,0,1,2,30.34,28,287,315
"2011-07-19 08:00:00",3,0,1,2,31.16,31,381,412
"2011-07-19 09:00:00",3,0,1,2,32.8,22,177,199
"2011-07-19 10:00:00",3,0,1,2,33.62,29,112,141
"2011-07-19 11:00:00",3,0,1,1,33.62,29,98,127
"2011-07-19 12:00:00",3,0,1,1,34.44,26,127,153
"2011-07-19 13:00:00",3,0,1,1,35.26,33,139,172
"2011-07-19 14:00:00",3,0,1,1,35.26,41,111,152
"2011-07-19 15:00:00",3,0,1,1,36.08,48,110,158
"2011-07-19 16:00:00",3,0,1,1,36.9,61,216,277
"2011-07-19 17:00:00",3,0,1,1,32.8,68,445,513
"2011-07-19 18:00:00",3,0,1,1,32.8,80,450,530
"2011-07-19 19:00:00",3,0,1,1,31.16,54,334,388
"2011-07-19 20:00:00",3,0,1,1,30.34,48,229,277
"2011-07-19 21:00:00",3,0,1,1,30.34,47,194,241
"2011-07-19 22:00:00",3,0,1,1,30.34,36,120,156
"2011-07-19 23:00:00",3,0,1,3,29.52,19,73,92
"2011-08-01 00:00:00",3,0,1,1,29.52,7,22,29
"2011-08-01 01:00:00",3,0,1,1,29.52,5,12,17
"2011-08-01 02:00:00",3,0,1,1,28.7,4,7,11
"2011-08-01 03:00:00",3,0,1,1,28.7,0,4,4
"2011-08-01 04:00:00",3,0,1,1,27.06,2,2,4
"2011-08-01 05:00:00",3,0,1,1,27.06,2,24,26
"2011-08-01 06:00:00",3,0,1,1,27.06,3,97,100
"2011-08-01 07:00:00",3,0,1,1,30.34,24,258,282
"2011-08-01 08:00:00",3,0,1,1,32.8,35,347,382
"2011-08-01 09:00:00",3,0,1,1,33.62,27,139,166
"2011-08-01 10:00:00",3,0,1,1,35.26,27,70,97
"2011-08-01 11:00:00",3,0,1,1,36.08,53,66,119
"2011-08-01 12:00:00",3,0,1,1,36.9,53,115,168
"2011-08-01 13:00:00",3,0,1,1,36.9,38,112,150
"2011-08-01 14:00:00",3,0,1,1,37.72,37,86,123
"2011-08-01 15:00:00",3,0,1,1,36.9,52,77,129
"2011-08-01 16:00:00",3,0,1,1,36.9,34,197,231
"2011-08-01 17:00:00",3,0,1,1,31.16,69,445,514
"2011-08-01 18:00:00",3,0,1,1,31.98,68,475,543
"2011-08-01 19:00:00",3,0,1,1,30.34,63,350,413
"2011-08-01 20:00:00",3,0,1,1,29.52,49,256,305
"2011-08-01 21:00:00",3,0,1,1,28.7,42,178,220
"2011-08-01 22:00:00",3,0,1,1,28.7,21,116,137
"2011-08-01 23:00:00",3,0,1,1,27.88,14,82,96
"2011-08-02 00:00:00",3,0,1,1,27.06,11,18,29
"2011-08-02 01:00:00",3,0,1,1,27.06,4,8,12
"2011-08-02 02:00:00",3,0,1,1,27.88,2,6,8
"2011-08-02 03:00:00",3,0,1,1,27.06,0,5,5
"2011-08-02 04:00:00",3,0,1,1,27.06,0,10,10
"2011-08-02 05:00:00",3,0,1,1,27.06,4,17,21
"2011-08-02 06:00:00",3,0,1,1,27.88,12,105,117
"2011-08-02 07:00:00",3,0,1,1,29.52,15,320,335
"2011-08-02 08:00:00",3,0,1,1,30.34,37,398,435
"2011-08-02 09:00:00",3,0,1,1,31.98,31,182,213
"2011-08-02 10:00:00",3,0,1,1,33.62,50,90,140
"2011-08-02 11:00:00",3,0,1,1,34.44,32,96,128
"2011-08-02 12:00:00",3,0,1,1,35.26,45,112,157
"2011-08-02 13:00:00",3,0,1,1,35.26,50,153,203
"2011-08-02 14:00:00",3,0,1,1,36.9,45,114,159
"2011-08-02 15:00:00",3,0,1,1,36.9,48,120,168
"2011-08-02 16:00:00",3,0,1,1,36.9,58,216,274
"2011-08-02 17:00:00",3,0,1,2,36.9,63,493,556
"2011-08-02 18:00:00",3,0,1,2,35.26,65,491,556
"2011-08-02 19:00:00",3,0,1,2,35.26,85,369,454
"2011-08-02 20:00:00",3,0,1,2,33.62,40,248,288
"2011-08-02 21:00:00",3,0,1,1,32.8,53,201,254
"2011-08-02 22:00:00",3,0,1,2,31.98,22,169,191
"2011-08-02 23:00:00",3,0,1,2,32.8,29,103,132
"2011-08-03 00:00:00",3,0,1,2,32.8,11,32,43
"2011-08-03 01:00:00",3,0,1,2,31.98,7,9,16
"2011-08-03 02:00:00",3,0,1,2,31.98,2,9,11
"2011-08-03 03:00:00",3,0,1,2,31.16,0,4,4
"2011-08-03 04:00:00",3,0,1,2,31.16,0,7,7
"2011-08-03 05:00:00",3,0,1,2,31.16,2,22,24
"2011-08-03 06:00:00",3,0,1,3,29.52,9,101,110
"2011-08-03 07:00:00",3,0,1,2,30.34,19,252,271
"2011-08-03 08:00:00",3,0,1,2,30.34,29,408,437
"2011-08-03 09:00:00",3,0,1,2,30.34,23,172,195
"2011-08-03 10:00:00",3,0,1,3,30.34,9,59,68
"2011-08-03 11:00:00",3,0,1,2,30.34,29,93,122
"2011-08-03 12:00:00",3,0,1,3,31.16,19,142,161
"2011-08-03 13:00:00",3,0,1,2,31.16,37,107,144
"2011-08-03 14:00:00",3,0,1,2,31.16,43,104,147
"2011-08-03 15:00:00",3,0,1,2,28.7,31,87,118
"2011-08-03 16:00:00",3,0,1,3,27.88,21,129,150
"2011-08-03 17:00:00",3,0,1,2,28.7,47,378,425
"2011-08-03 18:00:00",3,0,1,3,28.7,49,443,492
"2011-08-03 19:00:00",3,0,1,3,28.7,51,270,321
"2011-08-03 20:00:00",3,0,1,3,28.7,7,80,87
"2011-08-03 21:00:00",3,0,1,2,27.88,7,81,88
"2011-08-03 22:00:00",3,0,1,3,27.88,11,66,77
"2011-08-03 23:00:00",3,0,1,2,27.88,4,52,56
"2011-08-04 00:00:00",3,0,1,2,27.88,2,15,17
"2011-08-04 01:00:00",3,0,1,2,27.06,3,14,17
"2011-08-04 02:00:00",3,0,1,2,27.06,2,5,7
"2011-08-04 03:00:00",3,0,1,3,27.06,0,3,3
"2011-08-04 04:00:00",3,0,1,2,27.88,0,7,7
"2011-08-04 05:00:00",3,0,1,2,27.88,3,17,20
"2011-08-04 06:00:00",3,0,1,2,27.88,7,90,97
"2011-08-04 07:00:00",3,0,1,2,27.88,11,271,282
"2011-08-04 08:00:00",3,0,1,2,28.7,29,369,398
"2011-08-04 09:00:00",3,0,1,1,29.52,25,162,187
"2011-08-04 10:00:00",3,0,1,1,29.52,24,89,113
"2011-08-04 11:00:00",3,0,1,2,30.34,37,112,149
"2011-08-04 12:00:00",3,0,1,2,31.16,53,152,205
"2011-08-04 13:00:00",3,0,1,1,31.16,63,142,205
"2011-08-04 14:00:00",3,0,1,1,32.8,53,114,167
"2011-08-04 15:00:00",3,0,1,1,32.8,50,115,165
"2011-08-04 16:00:00",3,0,1,1,31.16,70,220,290
"2011-08-04 17:00:00",3,0,1,1,31.16,91,464,555
"2011-08-04 18:00:00",3,0,1,1,28.7,88,435,523
"2011-08-04 19:00:00",3,0,1,1,28.7,65,301,366
"2011-08-04 20:00:00",3,0,1,2,28.7,41,245,286
"2011-08-04 21:00:00",3,0,1,2,28.7,25,186,211
"2011-08-04 22:00:00",3,0,1,1,27.88,33,141,174
"2011-08-04 23:00:00",3,0,1,1,27.06,24,108,132
"2011-08-05 00:00:00",3,0,1,1,27.06,13,41,54
"2011-08-05 01:00:00",3,0,1,1,26.24,3,16,19
"2011-08-05 02:00:00",3,0,1,1,27.06,5,14,19
"2011-08-05 03:00:00",3,0,1,1,26.24,0,6,6
"2011-08-05 04:00:00",3,0,1,1,26.24,1,6,7
"2011-08-05 05:00:00",3,0,1,1,26.24,0,16,16
"2011-08-05 06:00:00",3,0,1,1,26.24,7,94,101
"2011-08-05 07:00:00",3,0,1,1,27.06,23,247,270
"2011-08-05 08:00:00",3,0,1,1,28.7,39,415,454
"2011-08-05 09:00:00",3,0,1,1,29.52,43,183,226
"2011-08-05 10:00:00",3,0,1,1,30.34,50,113,163
"2011-08-05 11:00:00",3,0,1,2,31.16,44,103,147
"2011-08-05 12:00:00",3,0,1,1,31.16,57,159,216
"2011-08-05 13:00:00",3,0,1,1,31.98,40,164,204
"2011-08-05 14:00:00",3,0,1,2,31.98,81,164,245
"2011-08-05 15:00:00",3,0,1,1,31.16,50,160,210
"2011-08-05 16:00:00",3,0,1,1,32.8,76,254,330
"2011-08-05 17:00:00",3,0,1,1,31.98,84,466,550
"2011-08-05 18:00:00",3,0,1,1,31.16,105,361,466
"2011-08-05 19:00:00",3,0,1,1,30.34,90,282,372
"2011-08-05 20:00:00",3,0,1,1,29.52,70,221,291
"2011-08-05 21:00:00",3,0,1,1,28.7,54,119,173
"2011-08-05 22:00:00",3,0,1,1,28.7,51,137,188
"2011-08-05 23:00:00",3,0,1,1,27.88,37,102,139
"2011-08-06 00:00:00",3,0,0,1,27.06,29,104,133
"2011-08-06 01:00:00",3,0,0,1,27.06,17,50,67
"2011-08-06 02:00:00",3,0,0,1,27.06,14,39,53
"2011-08-06 03:00:00",3,0,0,2,27.06,14,28,42
"2011-08-06 04:00:00",3,0,0,2,27.06,5,5,10
"2011-08-06 05:00:00",3,0,0,1,26.24,2,4,6
"2011-08-06 06:00:00",3,0,0,1,26.24,5,22,27
"2011-08-06 07:00:00",3,0,0,1,27.88,14,49,63
"2011-08-06 08:00:00",3,0,0,1,27.88,27,94,121
"2011-08-06 09:00:00",3,0,0,1,30.34,60,155,215
"2011-08-06 10:00:00",3,0,0,2,30.34,91,199,290
"2011-08-06 11:00:00",3,0,0,1,31.98,138,211,349
"2011-08-06 12:00:00",3,0,0,1,32.8,130,252,382
"2011-08-06 13:00:00",3,0,0,2,32.8,176,265,441
"2011-08-06 14:00:00",3,0,0,1,33.62,176,204,380
"2011-08-06 15:00:00",3,0,0,2,34.44,130,232,362
"2011-08-06 16:00:00",3,0,0,3,30.34,155,188,343
"2011-08-06 17:00:00",3,0,0,3,30.34,61,88,149
"2011-08-06 18:00:00",3,0,0,2,29.52,81,130,211
"2011-08-06 19:00:00",3,0,0,3,29.52,57,114,171
"2011-08-06 20:00:00",3,0,0,3,29.52,58,79,137
"2011-08-06 21:00:00",3,0,0,2,28.7,28,86,114
"2011-08-06 22:00:00",3,0,0,2,28.7,24,96,120
"2011-08-06 23:00:00",3,0,0,3,28.7,29,79,108
"2011-08-07 00:00:00",3,0,0,2,28.7,14,66,80
"2011-08-07 01:00:00",3,0,0,2,28.7,10,63,73
"2011-08-07 02:00:00",3,0,0,2,28.7,18,48,66
"2011-08-07 03:00:00",3,0,0,2,28.7,9,23,32
"2011-08-07 04:00:00",3,0,0,1,28.7,1,5,6
"2011-08-07 05:00:00",3,0,0,1,28.7,1,4,5
"2011-08-07 06:00:00",3,0,0,1,28.7,3,10,13
"2011-08-07 07:00:00",3,0,0,1,28.7,11,28,39
"2011-08-07 08:00:00",3,0,0,1,29.52,23,66,89
"2011-08-07 09:00:00",3,0,0,1,31.16,82,102,184
"2011-08-07 10:00:00",3,0,0,1,32.8,88,178,266
"2011-08-07 11:00:00",3,0,0,1,33.62,113,156,269
"2011-08-07 12:00:00",3,0,0,1,36.9,161,209,370
"2011-08-07 13:00:00",3,0,0,1,36.9,118,206,324
"2011-08-07 14:00:00",3,0,0,1,35.26,130,192,322
"2011-08-07 15:00:00",3,0,0,3,29.52,118,208,326
"2011-08-07 16:00:00",3,0,0,3,29.52,74,119,193
"2011-08-07 17:00:00",3,0,0,3,30.34,63,131,194
"2011-08-07 18:00:00",3,0,0,1,29.52,74,155,229
"2011-08-07 19:00:00",3,0,0,1,29.52,68,160,228
"2011-08-07 20:00:00",3,0,0,1,29.52,50,133,183
"2011-08-07 21:00:00",3,0,0,1,29.52,36,100,136
"2011-08-07 22:00:00",3,0,0,1,28.7,21,82,103
"2011-08-07 23:00:00",3,0,0,1,28.7,12,43,55
"2011-08-08 00:00:00",3,0,1,1,28.7,13,17,30
"2011-08-08 01:00:00",3,0,1,1,27.88,4,8,12
"2011-08-08 02:00:00",3,0,1,1,27.06,4,3,7
"2011-08-08 03:00:00",3,0,1,1,27.06,1,0,1
"2011-08-08 04:00:00",3,0,1,1,27.06,2,8,10
"2011-08-08 05:00:00",3,0,1,1,28.7,1,14,15
"2011-08-08 06:00:00",3,0,1,1,28.7,8,87,95
"2011-08-08 07:00:00",3,0,1,1,29.52,18,249,267
"2011-08-08 08:00:00",3,0,1,1,30.34,29,320,349
"2011-08-08 09:00:00",3,0,1,1,31.16,37,146,183
"2011-08-08 10:00:00",3,0,1,1,32.8,62,62,124
"2011-08-08 11:00:00",3,0,1,1,33.62,90,89,179
"2011-08-08 12:00:00",3,0,1,1,33.62,48,134,182
"2011-08-08 13:00:00",3,0,1,1,34.44,43,108,151
"2011-08-08 14:00:00",3,0,1,1,33.62,41,109,150
"2011-08-08 15:00:00",3,0,1,1,34.44,40,86,126
"2011-08-08 16:00:00",3,0,1,1,35.26,64,218,282
"2011-08-08 17:00:00",3,0,1,1,35.26,67,460,527
"2011-08-08 18:00:00",3,0,1,1,34.44,64,465,529
"2011-08-08 19:00:00",3,0,1,1,33.62,64,352,416
"2011-08-08 20:00:00",3,0,1,1,32.8,71,215,286
"2011-08-08 21:00:00",3,0,1,1,31.16,30,156,186
"2011-08-08 22:00:00",3,0,1,1,31.16,26,121,147
"2011-08-08 23:00:00",3,0,1,1,30.34,19,53,72
"2011-08-09 00:00:00",3,0,1,1,29.52,10,25,35
"2011-08-09 01:00:00",3,0,1,1,29.52,5,9,14
"2011-08-09 02:00:00",3,0,1,1,29.52,9,3,12
"2011-08-09 03:00:00",3,0,1,1,29.52,0,3,3
"2011-08-09 04:00:00",3,0,1,1,28.7,1,6,7
"2011-08-09 05:00:00",3,0,1,1,28.7,5,25,30
"2011-08-09 06:00:00",3,0,1,1,29.52,6,95,101
"2011-08-09 07:00:00",3,0,1,1,29.52,30,313,343
"2011-08-09 08:00:00",3,0,1,1,30.34,40,352,392
"2011-08-09 09:00:00",3,0,1,2,31.98,34,141,175
"2011-08-09 10:00:00",3,0,1,2,32.8,55,89,144
"2011-08-09 11:00:00",3,0,1,1,32.8,61,88,149
"2011-08-09 12:00:00",3,0,1,1,33.62,60,125,185
"2011-08-09 13:00:00",3,0,1,1,34.44,48,127,175
"2011-08-09 14:00:00",3,0,1,1,35.26,53,95,148
"2011-08-09 15:00:00",3,0,1,1,35.26,58,106,164
"2011-08-09 16:00:00",3,0,1,1,35.26,57,228,285
"2011-08-09 17:00:00",3,0,1,1,32.8,79,453,532
"2011-08-09 18:00:00",3,0,1,1,32.8,97,488,585
"2011-08-09 19:00:00",3,0,1,1,32.8,69,302,371
"2011-08-09 20:00:00",3,0,1,1,32.8,34,258,292
"2011-08-09 21:00:00",3,0,1,1,31.98,46,184,230
"2011-08-09 22:00:00",3,0,1,1,31.98,28,127,155
"2011-08-09 23:00:00",3,0,1,1,31.16,22,53,75
"2011-08-10 00:00:00",3,0,1,1,30.34,19,18,37
"2011-08-10 01:00:00",3,0,1,1,29.52,7,10,17
"2011-08-10 02:00:00",3,0,1,1,29.52,1,10,11
"2011-08-10 03:00:00",3,0,1,1,28.7,1,3,4
"2011-08-10 04:00:00",3,0,1,1,28.7,1,4,5
"2011-08-10 05:00:00",3,0,1,1,27.88,2,30,32
"2011-08-10 06:00:00",3,0,1,1,27.88,9,110,119
"2011-08-10 07:00:00",3,0,1,1,28.7,16,289,305
"2011-08-10 08:00:00",3,0,1,1,30.34,38,361,399
"2011-08-10 09:00:00",3,0,1,1,31.16,32,148,180
"2011-08-10 10:00:00",3,0,1,1,32.8,41,72,113
"2011-08-10 11:00:00",3,0,1,1,32.8,54,95,149
"2011-08-10 12:00:00",3,0,1,1,33.62,74,166,240
"2011-08-10 13:00:00",3,0,1,1,33.62,41,150,191
"2011-08-10 14:00:00",3,0,1,1,34.44,62,116,178
"2011-08-10 15:00:00",3,0,1,1,35.26,53,141,194
"2011-08-10 16:00:00",3,0,1,1,35.26,76,206,282
"2011-08-10 17:00:00",3,0,1,1,34.44,71,513,584
"2011-08-10 18:00:00",3,0,1,1,33.62,70,489,559
"2011-08-10 19:00:00",3,0,1,1,32.8,79,334,413
"2011-08-10 20:00:00",3,0,1,1,31.16,59,253,312
"2011-08-10 21:00:00",3,0,1,1,31.16,47,162,209
"2011-08-10 22:00:00",3,0,1,1,30.34,17,122,139
"2011-08-10 23:00:00",3,0,1,1,30.34,14,94,108
"2011-08-11 00:00:00",3,0,1,1,28.7,6,40,46
"2011-08-11 01:00:00",3,0,1,1,28.7,9,17,26
"2011-08-11 02:00:00",3,0,1,1,27.06,3,8,11
"2011-08-11 03:00:00",3,0,1,1,26.24,2,7,9
"2011-08-11 04:00:00",3,0,1,1,26.24,1,4,5
"2011-08-11 05:00:00",3,0,1,1,26.24,2,23,25
"2011-08-11 06:00:00",3,0,1,1,25.42,5,101,106
"2011-08-11 07:00:00",3,0,1,1,27.06,15,292,307
"2011-08-11 08:00:00",3,0,1,1,28.7,29,361,390
"2011-08-11 09:00:00",3,0,1,1,29.52,31,166,197
"2011-08-11 10:00:00",3,0,1,1,30.34,36,96,132
"2011-08-11 11:00:00",3,0,1,1,31.16,59,128,187
"2011-08-11 12:00:00",3,0,1,1,31.98,50,164,214
"2011-08-11 13:00:00",3,0,1,1,31.16,51,166,217
"2011-08-11 14:00:00",3,0,1,1,32.8,39,103,142
"2011-08-11 15:00:00",3,0,1,1,32.8,52,126,178
"2011-08-11 16:00:00",3,0,1,1,32.8,57,241,298
"2011-08-11 17:00:00",3,0,1,1,32.8,96,486,582
"2011-08-11 18:00:00",3,0,1,1,31.98,74,497,571
"2011-08-11 19:00:00",3,0,1,1,30.34,48,323,371
"2011-08-11 20:00:00",3,0,1,1,29.52,56,232,288
"2011-08-11 21:00:00",3,0,1,1,28.7,35,171,206
"2011-08-11 22:00:00",3,0,1,1,28.7,34,123,157
"2011-08-11 23:00:00",3,0,1,1,27.06,22,105,127
"2011-08-12 00:00:00",3,0,1,1,26.24,12,53,65
"2011-08-12 01:00:00",3,0,1,1,26.24,4,19,23
"2011-08-12 02:00:00",3,0,1,1,25.42,0,15,15
"2011-08-12 03:00:00",3,0,1,1,25.42,0,9,9
"2011-08-12 04:00:00",3,0,1,1,25.42,0,5,5
"2011-08-12 05:00:00",3,0,1,1,24.6,2,24,26
"2011-08-12 06:00:00",3,0,1,1,25.42,3,73,76
"2011-08-12 07:00:00",3,0,1,1,26.24,17,247,264
"2011-08-12 08:00:00",3,0,1,1,27.88,29,397,426
"2011-08-12 09:00:00",3,0,1,1,29.52,27,178,205
"2011-08-12 10:00:00",3,0,1,1,30.34,44,86,130
"2011-08-12 11:00:00",3,0,1,1,31.16,48,108,156
"2011-08-12 12:00:00",3,0,1,1,32.8,55,167,222
"2011-08-12 13:00:00",3,0,1,1,31.98,74,179,253
"2011-08-12 14:00:00",3,0,1,1,32.8,51,135,186
"2011-08-12 15:00:00",3,0,1,1,32.8,59,190,249
"2011-08-12 16:00:00",3,0,1,1,33.62,68,266,334
"2011-08-12 17:00:00",3,0,1,1,33.62,93,423,516
"2011-08-12 18:00:00",3,0,1,1,31.16,89,376,465
"2011-08-12 19:00:00",3,0,1,1,30.34,101,284,385
"2011-08-12 20:00:00",3,0,1,1,29.52,77,210,287
"2011-08-12 21:00:00",3,0,1,1,28.7,73,153,226
"2011-08-12 22:00:00",3,0,1,1,27.88,74,157,231
"2011-08-12 23:00:00",3,0,1,1,27.88,51,100,151
"2011-08-13 00:00:00",3,0,0,1,27.88,15,69,84
"2011-08-13 01:00:00",3,0,0,2,27.88,13,64,77
"2011-08-13 02:00:00",3,0,0,1,27.88,16,58,74
"2011-08-13 03:00:00",3,0,0,1,27.06,9,18,27
"2011-08-13 04:00:00",3,0,0,2,26.24,5,5,10
"2011-08-13 05:00:00",3,0,0,1,26.24,3,15,18
"2011-08-13 06:00:00",3,0,0,1,26.24,3,19,22
"2011-08-13 07:00:00",3,0,0,2,27.06,10,34,44
"2011-08-13 08:00:00",3,0,0,2,28.7,28,90,118
"2011-08-13 09:00:00",3,0,0,2,28.7,70,138,208
"2011-08-13 10:00:00",3,0,0,2,29.52,97,163,260
"2011-08-13 11:00:00",3,0,0,2,30.34,122,192,314
"2011-08-13 12:00:00",3,0,0,2,27.06,175,246,421
"2011-08-13 13:00:00",3,0,0,2,30.34,61,92,153
"2011-08-13 14:00:00",3,0,0,1,30.34,113,146,259
"2011-08-13 15:00:00",3,0,0,3,27.88,150,208,358
"2011-08-13 16:00:00",3,0,0,2,28.7,148,133,281
"2011-08-13 17:00:00",3,0,0,2,29.52,97,172,269
"2011-08-13 18:00:00",3,0,0,1,28.7,123,169,292
"2011-08-13 19:00:00",3,0,0,2,27.88,67,170,237
"2011-08-13 20:00:00",3,0,0,2,27.88,78,105,183
"2011-08-13 21:00:00",3,0,0,2,27.88,40,127,167
"2011-08-13 22:00:00",3,0,0,2,27.88,36,118,154
"2011-08-13 23:00:00",3,0,0,2,27.06,25,95,120
"2011-08-14 00:00:00",3,0,0,3,27.06,19,71,90
"2011-08-14 01:00:00",3,0,0,3,26.24,16,57,73
"2011-08-14 02:00:00",3,0,0,3,26.24,13,49,62
"2011-08-14 03:00:00",3,0,0,2,26.24,5,22,27
"2011-08-14 04:00:00",3,0,0,3,26.24,1,2,3
"2011-08-14 05:00:00",3,0,0,2,26.24,1,9,10
"2011-08-14 06:00:00",3,0,0,2,26.24,2,4,6
"2011-08-14 07:00:00",3,0,0,2,27.06,4,20,24
"2011-08-14 08:00:00",3,0,0,2,27.06,20,21,41
"2011-08-14 09:00:00",3,0,0,3,27.06,27,76,103
"2011-08-14 10:00:00",3,0,0,1,28.7,67,116,183
"2011-08-14 11:00:00",3,0,0,1,28.7,81,117,198
"2011-08-14 12:00:00",3,0,0,2,28.7,98,183,281
"2011-08-14 13:00:00",3,0,0,1,29.52,144,233,377
"2011-08-14 14:00:00",3,0,0,1,30.34,126,244,370
"2011-08-14 15:00:00",3,0,0,1,30.34,128,203,331
"2011-08-14 16:00:00",3,0,0,1,30.34,116,176,292
"2011-08-14 17:00:00",3,0,0,1,31.16,133,196,329
"2011-08-14 18:00:00",3,0,0,1,30.34,125,222,347
"2011-08-14 19:00:00",3,0,0,1,29.52,75,184,259
"2011-08-14 20:00:00",3,0,0,1,28.7,67,126,193
"2011-08-14 21:00:00",3,0,0,3,24.6,51,104,155
"2011-08-14 22:00:00",3,0,0,3,24.6,14,25,39
"2011-08-14 23:00:00",3,0,0,3,24.6,5,22,27
"2011-08-15 00:00:00",3,0,1,3,24.6,7,18,25
"2011-08-15 01:00:00",3,0,1,2,24.6,1,9,10
"2011-08-15 02:00:00",3,0,1,2,24.6,0,3,3
"2011-08-15 03:00:00",3,0,1,1,24.6,1,6,7
"2011-08-15 04:00:00",3,0,1,1,24.6,1,4,5
"2011-08-15 05:00:00",3,0,1,2,24.6,3,14,17
"2011-08-15 06:00:00",3,0,1,1,24.6,3,87,90
"2011-08-15 07:00:00",3,0,1,1,24.6,10,248,258
"2011-08-15 08:00:00",3,0,1,1,26.24,29,326,355
"2011-08-15 09:00:00",3,0,1,1,26.24,52,170,222
"2011-08-15 10:00:00",3,0,1,1,27.88,54,87,141
"2011-08-15 11:00:00",3,0,1,2,29.52,41,112,153
"2011-08-15 12:00:00",3,0,1,1,30.34,62,116,178
"2011-08-15 13:00:00",3,0,1,1,31.98,53,140,193
"2011-08-15 14:00:00",3,0,1,1,30.34,56,95,151
"2011-08-15 15:00:00",3,0,1,3,30.34,49,133,182
"2011-08-15 16:00:00",3,0,1,1,30.34,58,225,283
"2011-08-15 17:00:00",3,0,1,1,30.34,59,471,530
"2011-08-15 18:00:00",3,0,1,1,28.7,70,413,483
"2011-08-15 19:00:00",3,0,1,1,28.7,54,343,397
"2011-08-15 20:00:00",3,0,1,1,27.06,45,240,285
"2011-08-15 21:00:00",3,0,1,1,27.06,34,150,184
"2011-08-15 22:00:00",3,0,1,1,27.06,22,76,98
"2011-08-15 23:00:00",3,0,1,1,26.24,11,77,88
"2011-08-16 00:00:00",3,0,1,1,26.24,8,23,31
"2011-08-16 01:00:00",3,0,1,1,26.24,4,12,16
"2011-08-16 02:00:00",3,0,1,1,25.42,1,3,4
"2011-08-16 03:00:00",3,0,1,1,25.42,1,5,6
"2011-08-16 04:00:00",3,0,1,1,26.24,0,5,5
"2011-08-16 05:00:00",3,0,1,1,25.42,1,29,30
"2011-08-16 06:00:00",3,0,1,1,25.42,4,115,119
"2011-08-16 07:00:00",3,0,1,1,26.24,18,328,346
"2011-08-16 08:00:00",3,0,1,1,28.7,24,417,441
"2011-08-16 09:00:00",3,0,1,1,27.88,27,171,198
"2011-08-16 10:00:00",3,0,1,1,28.7,28,83,111
"2011-08-16 11:00:00",3,0,1,1,30.34,40,110,150
"2011-08-16 12:00:00",3,0,1,1,31.16,42,120,162
"2011-08-16 13:00:00",3,0,1,1,31.16,45,147,192
"2011-08-16 14:00:00",3,0,1,1,31.16,65,117,182
"2011-08-16 15:00:00",3,0,1,1,32.8,36,123,159
"2011-08-16 16:00:00",3,0,1,1,32.8,55,248,303
"2011-08-16 17:00:00",3,0,1,1,31.16,75,525,600
"2011-08-16 18:00:00",3,0,1,1,31.16,54,516,570
"2011-08-16 19:00:00",3,0,1,1,30.34,56,320,376
"2011-08-16 20:00:00",3,0,1,1,30.34,48,232,280
"2011-08-16 21:00:00",3,0,1,1,29.52,38,177,215
"2011-08-16 22:00:00",3,0,1,1,28.7,31,121,152
"2011-08-16 23:00:00",3,0,1,1,27.06,20,57,77
"2011-08-17 00:00:00",3,0,1,1,27.06,8,16,24
"2011-08-17 01:00:00",3,0,1,1,26.24,2,12,14
"2011-08-17 02:00:00",3,0,1,1,27.06,0,6,6
"2011-08-17 03:00:00",3,0,1,1,26.24,1,4,5
"2011-08-17 04:00:00",3,0,1,1,26.24,0,5,5
"2011-08-17 05:00:00",3,0,1,1,26.24,0,28,28
"2011-08-17 06:00:00",3,0,1,1,25.42,4,101,105
"2011-08-17 07:00:00",3,0,1,1,27.06,12,296,308
"2011-08-17 08:00:00",3,0,1,1,28.7,35,452,487
"2011-08-17 09:00:00",3,0,1,1,30.34,31,178,209
"2011-08-17 10:00:00",3,0,1,1,31.16,27,91,118
"2011-08-17 11:00:00",3,0,1,1,31.98,20,108,128
"2011-08-17 12:00:00",3,0,1,1,32.8,26,163,189
"2011-08-17 13:00:00",3,0,1,1,32.8,38,138,176
"2011-08-17 14:00:00",3,0,1,1,33.62,54,138,192
"2011-08-17 15:00:00",3,0,1,1,32.8,42,117,159
"2011-08-17 16:00:00",3,0,1,1,33.62,62,238,300
"2011-08-17 17:00:00",3,0,1,1,32.8,46,506,552
"2011-08-17 18:00:00",3,0,1,1,31.16,86,470,556
"2011-08-17 19:00:00",3,0,1,1,31.16,50,297,347
"2011-08-17 20:00:00",3,0,1,1,30.34,37,243,280
"2011-08-17 21:00:00",3,0,1,1,29.52,38,192,230
"2011-08-17 22:00:00",3,0,1,1,28.7,29,142,171
"2011-08-17 23:00:00",3,0,1,1,28.7,20,85,105
"2011-08-18 00:00:00",3,0,1,1,27.88,18,38,56
"2011-08-18 01:00:00",3,0,1,2,27.06,13,11,24
"2011-08-18 02:00:00",3,0,1,1,27.06,2,4,6
"2011-08-18 03:00:00",3,0,1,1,27.06,0,6,6
"2011-08-18 04:00:00",3,0,1,1,26.24,0,9,9
"2011-08-18 05:00:00",3,0,1,1,26.24,0,27,27
"2011-08-18 06:00:00",3,0,1,2,26.24,6,97,103
"2011-08-18 07:00:00",3,0,1,1,26.24,19,289,308
"2011-08-18 08:00:00",3,0,1,1,27.06,27,393,420
"2011-08-18 09:00:00",3,0,1,1,29.52,42,186,228
"2011-08-18 10:00:00",3,0,1,1,30.34,37,92,129
"2011-08-18 11:00:00",3,0,1,1,31.16,44,97,141
"2011-08-18 12:00:00",3,0,1,1,32.8,34,139,173
"2011-08-18 13:00:00",3,0,1,1,32.8,33,154,187
"2011-08-18 14:00:00",3,0,1,1,33.62,67,115,182
"2011-08-18 15:00:00",3,0,1,1,32.8,56,118,174
"2011-08-18 16:00:00",3,0,1,1,32.8,49,196,245
"2011-08-18 17:00:00",3,0,1,3,32.8,44,365,409
"2011-08-18 18:00:00",3,0,1,3,31.16,48,226,274
"2011-08-18 19:00:00",3,0,1,1,27.06,26,115,141
"2011-08-18 20:00:00",3,0,1,1,27.06,24,141,165
"2011-08-18 21:00:00",3,0,1,2,27.88,12,137,149
"2011-08-18 22:00:00",3,0,1,2,28.7,18,117,135
"2011-08-18 23:00:00",3,0,1,2,28.7,20,94,114
"2011-08-19 00:00:00",3,0,1,3,27.88,9,53,62
"2011-08-19 01:00:00",3,0,1,3,26.24,1,19,20
"2011-08-19 02:00:00",3,0,1,3,26.24,0,8,8
"2011-08-19 03:00:00",3,0,1,1,26.24,2,1,3
"2011-08-19 04:00:00",3,0,1,1,26.24,1,7,8
"2011-08-19 05:00:00",3,0,1,1,26.24,1,16,17
"2011-08-19 06:00:00",3,0,1,1,26.24,2,91,93
"2011-08-19 07:00:00",3,0,1,2,27.06,12,251,263
"2011-08-19 08:00:00",3,0,1,2,27.06,30,368,398
"2011-08-19 09:00:00",3,0,1,1,28.7,31,187,218
"2011-08-19 10:00:00",3,0,1,1,29.52,57,108,165
"2011-08-19 11:00:00",3,0,1,2,29.52,45,120,165
"2011-08-19 12:00:00",3,0,1,2,30.34,54,168,222
"2011-08-19 13:00:00",3,0,1,2,31.16,63,169,232
"2011-08-19 14:00:00",3,0,1,1,31.98,78,142,220
"2011-08-19 15:00:00",3,0,1,1,32.8,66,156,222
"2011-08-19 16:00:00",3,0,1,1,32.8,66,261,327
"2011-08-19 17:00:00",3,0,1,1,31.16,85,442,527
"2011-08-19 18:00:00",3,0,1,1,31.16,88,337,425
"2011-08-19 19:00:00",3,0,1,3,25.42,33,132,165
"2011-08-19 20:00:00",3,0,1,3,25.42,12,46,58
"2011-08-19 21:00:00",3,0,1,1,25.42,18,89,107
"2011-08-19 22:00:00",3,0,1,1,24.6,25,97,122
"2011-08-19 23:00:00",3,0,1,2,24.6,18,88,106
"2011-09-01 00:00:00",3,0,1,1,24.6,18,33,51
"2011-09-01 01:00:00",3,0,1,1,24.6,7,14,21
"2011-09-01 02:00:00",3,0,1,1,23.78,14,11,25
"2011-09-01 03:00:00",3,0,1,1,23.78,7,7,14
"2011-09-01 04:00:00",3,0,1,1,22.96,0,7,7
"2011-09-01 05:00:00",3,0,1,1,22.96,1,22,23
"2011-09-01 06:00:00",3,0,1,1,24.6,2,103,105
"2011-09-01 07:00:00",3,0,1,1,24.6,7,335,342
"2011-09-01 08:00:00",3,0,1,1,25.42,31,467,498
"2011-09-01 09:00:00",3,0,1,1,26.24,29,178,207
"2011-09-01 10:00:00",3,0,1,1,27.88,46,92,138
"2011-09-01 11:00:00",3,0,1,1,29.52,51,141,192
"2011-09-01 12:00:00",3,0,1,2,29.52,64,165,229
"2011-09-01 13:00:00",3,0,1,2,29.52,50,169,219
"2011-09-01 14:00:00",3,0,1,3,29.52,54,144,198
"2011-09-01 15:00:00",3,0,1,1,29.52,39,135,174
"2011-09-01 16:00:00",3,0,1,1,30.34,55,253,308
"2011-09-01 17:00:00",3,0,1,1,29.52,61,567,628
"2011-09-01 18:00:00",3,0,1,1,29.52,69,462,531
"2011-09-01 19:00:00",3,0,1,1,28.7,79,364,443
"2011-09-01 20:00:00",3,0,1,1,27.06,33,247,280
"2011-09-01 21:00:00",3,0,1,2,27.06,17,160,177
"2011-09-01 22:00:00",3,0,1,2,27.06,34,145,179
"2011-09-01 23:00:00",3,0,1,1,26.24,15,111,126
"2011-09-02 00:00:00",3,0,1,1,26.24,6,58,64
"2011-09-02 01:00:00",3,0,1,3,25.42,4,28,32
"2011-09-02 02:00:00",3,0,1,3,25.42,9,11,20
"2011-09-02 03:00:00",3,0,1,2,24.6,4,4,8
"2011-09-02 04:00:00",3,0,1,1,24.6,2,2,4
"2011-09-02 05:00:00",3,0,1,2,24.6,0,20,20
"2011-09-02 06:00:00",3,0,1,1,24.6,3,73,76
"2011-09-02 07:00:00",3,0,1,1,24.6,6,253,259
"2011-09-02 08:00:00",3,0,1,1,25.42,22,434,456
"2011-09-02 09:00:00",3,0,1,2,25.42,30,190,220
"2011-09-02 10:00:00",3,0,1,2,26.24,34,106,140
"2011-09-02 11:00:00",3,0,1,2,27.06,51,141,192
"2011-09-02 12:00:00",3,0,1,2,27.06,82,178,260
"2011-09-02 13:00:00",3,0,1,2,27.88,72,207,279
"2011-09-02 14:00:00",3,0,1,2,28.7,75,208,283
"2011-09-02 15:00:00",3,0,1,2,28.7,69,277,346
"2011-09-02 16:00:00",3,0,1,2,28.7,82,299,381
"2011-09-02 17:00:00",3,0,1,2,27.88,78,377,455
"2011-09-02 18:00:00",3,0,1,2,27.88,50,305,355
"2011-09-02 19:00:00",3,0,1,1,27.06,67,220,287
"2011-09-02 20:00:00",3,0,1,1,26.24,38,158,196
"2011-09-02 21:00:00",3,0,1,2,26.24,28,121,149
"2011-09-02 22:00:00",3,0,1,2,26.24,33,114,147
"2011-09-02 23:00:00",3,0,1,2,26.24,30,68,98
"2011-09-03 00:00:00",3,0,0,2,26.24,22,65,87
"2011-09-03 01:00:00",3,0,0,2,26.24,17,57,74
"2011-09-03 02:00:00",3,0,0,2,26.24,15,26,41
"2011-09-03 03:00:00",3,0,0,1,25.42,17,18,35
"2011-09-03 04:00:00",3,0,0,1,25.42,3,4,7
"2011-09-03 05:00:00",3,0,0,1,25.42,3,9,12
"2011-09-03 06:00:00",3,0,0,1,25.42,4,19,23
"2011-09-03 07:00:00",3,0,0,1,25.42,5,33,38
"2011-09-03 08:00:00",3,0,0,1,26.24,24,65,89
"2011-09-03 09:00:00",3,0,0,2,27.06,83,118,201
"2011-09-03 10:00:00",3,0,0,3,27.06,90,168,258
"2011-09-03 11:00:00",3,0,0,3,27.06,66,128,194
"2011-09-03 12:00:00",3,0,0,1,28.7,97,160,257
"2011-09-03 13:00:00",3,0,0,1,28.7,153,200,353
"2011-09-03 14:00:00",3,0,0,2,29.52,204,176,380
"2011-09-03 15:00:00",3,0,0,1,29.52,187,201,388
"2011-09-03 16:00:00",3,0,0,1,29.52,186,188,374
"2011-09-03 17:00:00",3,0,0,1,29.52,170,201,371
"2011-09-03 18:00:00",3,0,0,1,29.52,160,179,339
"2011-09-03 19:00:00",3,0,0,1,28.7,147,148,295
"2011-09-03 20:00:00",3,0,0,1,28.7,99,120,219
"2011-09-03 21:00:00",3,0,0,1,27.88,71,93,164
"2011-09-03 22:00:00",3,0,0,1,27.88,66,96,162
"2011-09-03 23:00:00",3,0,0,1,27.06,46,77,123
"2011-09-04 00:00:00",3,0,0,1,27.06,33,76,109
"2011-09-04 01:00:00",3,0,0,1,27.06,37,38,75
"2011-09-04 02:00:00",3,0,0,1,27.06,17,43,60
"2011-09-04 03:00:00",3,0,0,1,26.24,20,23,43
"2011-09-04 04:00:00",3,0,0,1,26.24,0,4,4
"2011-09-04 05:00:00",3,0,0,1,26.24,1,5,6
"2011-09-04 06:00:00",3,0,0,1,26.24,0,3,3
"2011-09-04 07:00:00",3,0,0,1,27.06,10,20,30
"2011-09-04 08:00:00",3,0,0,1,27.06,21,49,70
"2011-09-04 09:00:00",3,0,0,1,27.06,87,102,189
"2011-09-04 10:00:00",3,0,0,1,28.7,150,147,297
"2011-09-04 11:00:00",3,0,0,1,30.34,174,163,337
"2011-09-04 12:00:00",3,0,0,1,31.16,214,221,435
"2011-09-04 13:00:00",3,0,0,2,31.98,245,174,419
"2011-09-04 14:00:00",3,0,0,1,31.98,205,156,361
"2011-09-04 15:00:00",3,0,0,1,31.98,218,192,410
"2011-09-04 16:00:00",3,0,0,1,32.8,196,141,337
"2011-09-04 17:00:00",3,0,0,1,31.16,204,172,376
"2011-09-04 18:00:00",3,0,0,1,31.16,187,169,356
"2011-09-04 19:00:00",3,0,0,1,30.34,178,150,328
"2011-09-04 20:00:00",3,0,0,1,30.34,104,125,229
"2011-09-04 21:00:00",3,0,0,1,29.52,104,103,207
"2011-09-04 22:00:00",3,0,0,2,29.52,70,85,155
"2011-09-04 23:00:00",3,0,0,2,29.52,46,58,104
"2011-09-05 00:00:00",3,1,0,2,28.7,31,66,97
"2011-09-05 01:00:00",3,1,0,2,27.88,19,35,54
"2011-09-05 02:00:00",3,1,0,2,27.88,17,22,39
"2011-09-05 03:00:00",3,1,0,2,27.88,4,12,16
"2011-09-05 04:00:00",3,1,0,2,27.88,3,5,8
"2011-09-05 05:00:00",3,1,0,2,27.06,2,4,6
"2011-09-05 06:00:00",3,1,0,2,27.06,6,5,11
"2011-09-05 07:00:00",3,1,0,1,27.06,11,30,41
"2011-09-05 08:00:00",3,1,0,2,27.06,45,56,101
"2011-09-05 09:00:00",3,1,0,3,27.88,63,89,152
"2011-09-05 10:00:00",3,1,0,2,28.7,107,137,244
"2011-09-05 11:00:00",3,1,0,2,28.7,101,207,308
"2011-09-05 12:00:00",3,1,0,2,29.52,141,212,353
"2011-09-05 13:00:00",3,1,0,2,30.34,154,235,389
"2011-09-05 14:00:00",3,1,0,1,30.34,145,212,357
"2011-09-05 15:00:00",3,1,0,2,27.88,111,142,253
"2011-09-05 16:00:00",3,1,0,2,27.88,92,192,284
"2011-09-05 17:00:00",3,1,0,2,27.06,37,77,114
"2011-09-05 18:00:00",3,1,0,1,27.06,31,92,123
"2011-09-05 19:00:00",3,1,0,3,27.06,52,123,175
"2011-09-05 20:00:00",3,1,0,3,27.06,26,56,82
"2011-09-05 21:00:00",3,1,0,2,27.06,20,40,60
"2011-09-05 22:00:00",3,1,0,2,24.6,15,49,64
"2011-09-05 23:00:00",3,1,0,3,22.96,3,17,20
"2011-09-06 00:00:00",3,0,1,3,22.14,1,7,8
"2011-09-06 02:00:00",3,0,1,3,22.14,0,2,2
"2011-09-06 03:00:00",3,0,1,3,22.14,1,0,1
"2011-09-06 04:00:00",3,0,1,2,22.14,1,3,4
"2011-09-06 05:00:00",3,0,1,3,22.14,1,20,21
"2011-09-06 06:00:00",3,0,1,2,22.14,0,72,72
"2011-09-06 07:00:00",3,0,1,2,22.14,6,166,172
"2011-09-06 08:00:00",3,0,1,3,22.14,15,349,364
"2011-09-06 09:00:00",3,0,1,2,22.14,18,167,185
"2011-09-06 10:00:00",3,0,1,3,22.14,16,90,106
"2011-09-06 11:00:00",3,0,1,3,22.14,11,78,89
"2011-09-06 12:00:00",3,0,1,3,22.14,16,51,67
"2011-09-06 13:00:00",3,0,1,3,22.14,5,24,29
"2011-09-06 14:00:00",3,0,1,3,22.14,3,21,24
"2011-09-06 15:00:00",3,0,1,3,22.14,18,71,89
"2011-09-06 16:00:00",3,0,1,3,22.14,11,95,106
"2011-09-06 17:00:00",3,0,1,2,22.14,15,276,291
"2011-09-06 18:00:00",3,0,1,2,22.14,22,351,373
"2011-09-06 19:00:00",3,0,1,2,22.14,12,269,281
"2011-09-06 20:00:00",3,0,1,3,22.14,13,150,163
"2011-09-06 21:00:00",3,0,1,3,22.14,12,109,121
"2011-09-06 22:00:00",3,0,1,2,22.14,5,79,84
"2011-09-06 23:00:00",3,0,1,3,22.14,2,56,58
"2011-09-07 00:00:00",3,0,1,2,22.14,1,12,13
"2011-09-07 01:00:00",3,0,1,3,22.14,2,3,5
"2011-09-07 02:00:00",3,0,1,2,22.14,2,4,6
"2011-09-07 03:00:00",3,0,1,3,22.96,1,1,2
"2011-09-07 04:00:00",3,0,1,3,22.96,0,4,4
"2011-09-07 05:00:00",3,0,1,2,22.96,1,15,16
"2011-09-07 06:00:00",3,0,1,3,24.6,1,74,75
"2011-09-07 07:00:00",3,0,1,3,24.6,3,83,86
"2011-09-07 08:00:00",3,0,1,3,25.42,9,319,328
"2011-09-07 09:00:00",3,0,1,3,24.6,14,176,190
"2011-09-07 10:00:00",3,0,1,3,24.6,3,63,66
"2011-09-07 11:00:00",3,0,1,3,24.6,1,9,10
"2011-09-07 12:00:00",3,0,1,3,22.96,1,21,22
"2011-09-07 13:00:00",3,0,1,3,24.6,2,9,11
"2011-09-07 14:00:00",3,0,1,3,24.6,1,24,25
"2011-09-07 15:00:00",3,0,1,3,25.42,3,55,58
"2011-09-07 16:00:00",3,0,1,1,26.24,7,137,144
"2011-09-07 17:00:00",3,0,1,3,26.24,21,264,285
"2011-09-07 18:00:00",3,0,1,3,26.24,18,219,237
"2011-09-07 19:00:00",3,0,1,2,26.24,14,212,226
"2011-09-07 20:00:00",3,0,1,3,26.24,3,93,96
"2011-09-07 21:00:00",3,0,1,3,26.24,4,34,38
"2011-09-07 22:00:00",3,0,1,3,25.42,3,26,29
"2011-09-07 23:00:00",3,0,1,3,25.42,3,21,24
"2011-09-08 00:00:00",3,0,1,3,24.6,3,11,14
"2011-09-08 01:00:00",3,0,1,3,25.42,0,4,4
"2011-09-08 03:00:00",3,0,1,3,25.42,0,2,2
"2011-09-08 04:00:00",3,0,1,2,25.42,0,3,3
"2011-09-08 05:00:00",3,0,1,3,25.42,1,13,14
"2011-09-08 06:00:00",3,0,1,3,25.42,1,55,56
"2011-09-08 07:00:00",3,0,1,3,25.42,7,172,179
"2011-09-08 08:00:00",3,0,1,3,25.42,7,188,195
"2011-09-08 09:00:00",3,0,1,2,25.42,4,65,69
"2011-09-08 10:00:00",3,0,1,2,26.24,8,57,65
"2011-09-08 11:00:00",3,0,1,2,26.24,16,82,98
"2011-09-08 12:00:00",3,0,1,2,27.06,17,85,102
"2011-09-08 13:00:00",3,0,1,2,27.88,14,112,126
"2011-09-08 14:00:00",3,0,1,2,28.7,15,105,120
"2011-09-08 15:00:00",3,0,1,3,27.06,24,115,139
"2011-09-08 16:00:00",3,0,1,3,26.24,5,151,156
"2011-09-08 17:00:00",3,0,1,3,26.24,11,102,113
"2011-09-08 18:00:00",3,0,1,3,26.24,2,66,68
"2011-09-08 19:00:00",3,0,1,3,25.42,1,51,52
"2011-09-08 20:00:00",3,0,1,2,25.42,6,83,89
"2011-09-08 21:00:00",3,0,1,3,26.24,6,76,82
"2011-09-08 22:00:00",3,0,1,3,25.42,5,65,70
"2011-09-08 23:00:00",3,0,1,3,25.42,0,26,26
"2011-09-09 00:00:00",3,0,1,3,26.24,1,15,16
"2011-09-09 01:00:00",3,0,1,2,25.42,0,8,8
"2011-09-09 02:00:00",3,0,1,2,25.42,1,7,8
"2011-09-09 03:00:00",3,0,1,2,25.42,1,1,2
"2011-09-09 04:00:00",3,0,1,3,25.42,0,3,3
"2011-09-09 05:00:00",3,0,1,2,25.42,0,14,14
"2011-09-09 06:00:00",3,0,1,2,25.42,3,54,57
"2011-09-09 07:00:00",3,0,1,3,25.42,4,104,108
"2011-09-09 08:00:00",3,0,1,3,25.42,12,276,288
"2011-09-09 09:00:00",3,0,1,3,25.42,5,131,136
"2011-09-09 10:00:00",3,0,1,2,25.42,2,27,29
"2011-09-09 11:00:00",3,0,1,2,25.42,6,66,72
"2011-09-09 12:00:00",3,0,1,1,26.24,4,71,75
"2011-09-09 13:00:00",3,0,1,1,28.7,14,108,122
"2011-09-09 14:00:00",3,0,1,1,29.52,29,119,148
"2011-09-09 15:00:00",3,0,1,1,30.34,27,161,188
"2011-09-09 16:00:00",3,0,1,1,30.34,41,244,285
"2011-09-09 17:00:00",3,0,1,1,28.7,54,451,505
"2011-09-09 18:00:00",3,0,1,1,28.7,33,377,410
"2011-09-09 19:00:00",3,0,1,1,27.06,33,316,349
"2011-09-09 20:00:00",3,0,1,1,26.24,30,180,210
"2011-09-09 21:00:00",3,0,1,1,27.06,49,154,203
"2011-09-09 22:00:00",3,0,1,1,25.42,33,127,160
"2011-09-09 23:00:00",3,0,1,1,25.42,35,113,148
"2011-09-10 00:00:00",3,0,0,1,25.42,32,84,116
"2011-09-10 01:00:00",3,0,0,2,25.42,16,67,83
"2011-09-10 02:00:00",3,0,0,2,24.6,18,46,64
"2011-09-10 03:00:00",3,0,0,1,23.78,8,29,37
"2011-09-10 04:00:00",3,0,0,1,23.78,3,4,7
"2011-09-10 05:00:00",3,0,0,1,23.78,2,6,8
"2011-09-10 06:00:00",3,0,0,1,23.78,0,6,6
"2011-09-10 07:00:00",3,0,0,1,24.6,9,43,52
"2011-09-10 08:00:00",3,0,0,1,25.42,16,103,119
"2011-09-10 09:00:00",3,0,0,1,26.24,39,168,207
"2011-09-10 10:00:00",3,0,0,1,28.7,85,233,318
"2011-09-10 11:00:00",3,0,0,1,29.52,108,252,360
"2011-09-10 12:00:00",3,0,0,1,29.52,144,260,404
"2011-09-10 13:00:00",3,0,0,1,30.34,131,239,370
"2011-09-10 14:00:00",3,0,0,1,30.34,129,230,359
"2011-09-10 15:00:00",3,0,0,1,30.34,217,263,480
"2011-09-10 16:00:00",3,0,0,1,30.34,170,261,431
"2011-09-10 17:00:00",3,0,0,1,30.34,185,275,460
"2011-09-10 18:00:00",3,0,0,1,29.52,119,241,360
"2011-09-10 19:00:00",3,0,0,1,28.7,101,214,315
"2011-09-10 20:00:00",3,0,0,1,27.06,78,167,245
"2011-09-10 21:00:00",3,0,0,1,26.24,59,171,230
"2011-09-10 22:00:00",3,0,0,1,26.24,49,126,175
"2011-09-10 23:00:00",3,0,0,2,25.42,32,107,139
"2011-09-11 00:00:00",3,0,0,1,25.42,29,79,108
"2011-09-11 01:00:00",3,0,0,2,25.42,22,66,88
"2011-09-11 02:00:00",3,0,0,2,25.42,16,60,76
"2011-09-11 03:00:00",3,0,0,2,25.42,15,30,45
"2011-09-11 04:00:00",3,0,0,1,24.6,3,6,9
"2011-09-11 05:00:00",3,0,0,1,24.6,15,24,39
"2011-09-11 06:00:00",3,0,0,1,23.78,4,16,20
"2011-09-11 07:00:00",3,0,0,1,24.6,9,28,37
"2011-09-11 08:00:00",3,0,0,1,26.24,25,69,94
"2011-09-11 09:00:00",3,0,0,1,27.06,59,168,227
"2011-09-11 10:00:00",3,0,0,1,28.7,120,214,334
"2011-09-11 11:00:00",3,0,0,1,28.7,144,258,402
"2011-09-11 12:00:00",3,0,0,1,28.7,113,298,411
"2011-09-11 13:00:00",3,0,0,1,30.34,119,231,350
"2011-09-11 14:00:00",3,0,0,1,29.52,120,222,342
"2011-09-11 15:00:00",3,0,0,1,30.34,134,270,404
"2011-09-11 16:00:00",3,0,0,1,29.52,180,303,483
"2011-09-11 17:00:00",3,0,0,1,29.52,152,228,380
"2011-09-11 18:00:00",3,0,0,1,27.88,110,229,339
"2011-09-11 19:00:00",3,0,0,1,26.24,101,232,333
"2011-09-11 20:00:00",3,0,0,1,25.42,65,161,226
"2011-09-11 21:00:00",3,0,0,1,26.24,45,114,159
"2011-09-11 22:00:00",3,0,0,1,25.42,21,74,95
"2011-09-11 23:00:00",3,0,0,3,23.78,12,33,45
"2011-09-12 00:00:00",3,0,1,1,22.96,5,11,16
"2011-09-12 01:00:00",3,0,1,1,22.96,1,11,12
"2011-09-12 02:00:00",3,0,1,1,22.96,2,0,2
"2011-09-12 04:00:00",3,0,1,1,22.14,0,4,4
"2011-09-12 05:00:00",3,0,1,1,22.96,1,23,24
"2011-09-12 06:00:00",3,0,1,1,22.96,1,108,109
"2011-09-12 07:00:00",3,0,1,1,23.78,12,300,312
"2011-09-12 08:00:00",3,0,1,1,24.6,26,382,408
"2011-09-12 09:00:00",3,0,1,1,26.24,21,155,176
"2011-09-12 10:00:00",3,0,1,1,27.88,40,89,129
"2011-09-12 11:00:00",3,0,1,1,28.7,34,131,165
"2011-09-12 12:00:00",3,0,1,1,29.52,37,147,184
"2011-09-12 13:00:00",3,0,1,1,29.52,43,120,163
"2011-09-12 14:00:00",3,0,1,1,30.34,60,129,189
"2011-09-12 15:00:00",3,0,1,1,30.34,60,152,212
"2011-09-12 16:00:00",3,0,1,1,29.52,60,238,298
"2011-09-12 17:00:00",3,0,1,1,29.52,75,515,590
"2011-09-12 18:00:00",3,0,1,1,28.7,56,515,571
"2011-09-12 19:00:00",3,0,1,1,27.88,63,373,436
"2011-09-12 20:00:00",3,0,1,1,27.06,41,258,299
"2011-09-12 21:00:00",3,0,1,1,26.24,29,166,195
"2011-09-12 22:00:00",3,0,1,1,25.42,16,134,150
"2011-09-12 23:00:00",3,0,1,1,25.42,7,62,69
"2011-09-13 00:00:00",3,0,1,1,24.6,7,19,26
"2011-09-13 01:00:00",3,0,1,1,23.78,4,6,10
"2011-09-13 02:00:00",3,0,1,1,24.6,2,0,2
"2011-09-13 03:00:00",3,0,1,1,23.78,2,2,4
"2011-09-13 04:00:00",3,0,1,1,22.96,2,6,8
"2011-09-13 05:00:00",3,0,1,1,22.96,1,19,20
"2011-09-13 06:00:00",3,0,1,1,22.96,6,116,122
"2011-09-13 07:00:00",3,0,1,1,23.78,14,348,362
"2011-09-13 08:00:00",3,0,1,1,24.6,26,399,425
"2011-09-13 09:00:00",3,0,1,1,26.24,35,179,214
"2011-09-13 10:00:00",3,0,1,1,27.88,42,93,135
"2011-09-13 11:00:00",3,0,1,1,28.7,33,120,153
"2011-09-13 12:00:00",3,0,1,1,29.52,43,144,187
"2011-09-13 13:00:00",3,0,1,1,30.34,48,136,184
"2011-09-13 14:00:00",3,0,1,1,30.34,51,139,190
"2011-09-13 15:00:00",3,0,1,1,30.34,35,145,180
"2011-09-13 16:00:00",3,0,1,1,30.34,41,251,292
"2011-09-13 17:00:00",3,0,1,1,30.34,72,507,579
"2011-09-13 18:00:00",3,0,1,1,28.7,67,472,539
"2011-09-13 19:00:00",3,0,1,1,27.88,55,341,396
"2011-09-13 20:00:00",3,0,1,1,27.06,31,241,272
"2011-09-13 21:00:00",3,0,1,1,26.24,45,200,245
"2011-09-13 22:00:00",3,0,1,1,26.24,24,120,144
"2011-09-13 23:00:00",3,0,1,1,26.24,15,59,74
"2011-09-14 00:00:00",3,0,1,1,25.42,5,28,33
"2011-09-14 01:00:00",3,0,1,1,25.42,1,7,8
"2011-09-14 02:00:00",3,0,1,1,24.6,1,4,5
"2011-09-14 03:00:00",3,0,1,1,24.6,1,7,8
"2011-09-14 04:00:00",3,0,1,1,24.6,1,8,9
"2011-09-14 05:00:00",3,0,1,1,23.78,1,30,31
"2011-09-14 06:00:00",3,0,1,1,23.78,7,138,145
"2011-09-14 07:00:00",3,0,1,1,24.6,20,350,370
"2011-09-14 08:00:00",3,0,1,1,25.42,33,396,429
"2011-09-14 09:00:00",3,0,1,1,26.24,19,183,202
"2011-09-14 10:00:00",3,0,1,1,28.7,27,115,142
"2011-09-14 11:00:00",3,0,1,1,29.52,43,121,164
"2011-09-14 12:00:00",3,0,1,1,30.34,56,156,212
"2011-09-14 13:00:00",3,0,1,1,31.16,39,139,178
"2011-09-14 14:00:00",3,0,1,1,31.98,19,105,124
"2011-09-14 15:00:00",3,0,1,1,31.98,30,146,176
"2011-09-14 16:00:00",3,0,1,1,31.16,36,241,277
"2011-09-14 17:00:00",3,0,1,1,31.16,87,512,599
"2011-09-14 18:00:00",3,0,1,1,29.52,83,503,586
"2011-09-14 19:00:00",3,0,1,2,28.7,44,337,381
"2011-09-14 20:00:00",3,0,1,2,29.52,40,221,261
"2011-09-14 21:00:00",3,0,1,2,27.06,24,189,213
"2011-09-14 22:00:00",3,0,1,2,27.06,20,140,160
"2011-09-14 23:00:00",3,0,1,2,26.24,10,62,72
"2011-09-15 00:00:00",3,0,1,1,26.24,3,34,37
"2011-09-15 01:00:00",3,0,1,1,26.24,0,20,20
"2011-09-15 02:00:00",3,0,1,1,25.42,0,5,5
"2011-09-15 03:00:00",3,0,1,1,25.42,3,5,8
"2011-09-15 04:00:00",3,0,1,1,24.6,2,5,7
"2011-09-15 05:00:00",3,0,1,1,24.6,1,30,31
"2011-09-15 06:00:00",3,0,1,2,24.6,5,119,124
"2011-09-15 07:00:00",3,0,1,2,25.42,17,321,338
"2011-09-15 08:00:00",3,0,1,1,26.24,27,364,391
"2011-09-15 09:00:00",3,0,1,2,26.24,23,186,209
"2011-09-15 10:00:00",3,0,1,2,27.06,25,96,121
"2011-09-15 11:00:00",3,0,1,2,27.88,39,120,159
"2011-09-15 12:00:00",3,0,1,2,27.06,31,148,179
"2011-09-15 13:00:00",3,0,1,2,26.24,38,151,189
"2011-09-15 14:00:00",3,0,1,2,26.24,36,134,170
"2011-09-15 15:00:00",3,0,1,2,24.6,25,110,135
"2011-09-15 16:00:00",3,0,1,2,22.14,29,193,222
"2011-09-15 17:00:00",3,0,1,3,19.68,31,230,261
"2011-09-15 18:00:00",3,0,1,3,19.68,22,222,244
"2011-09-15 19:00:00",3,0,1,1,18.86,20,212,232
"2011-09-15 20:00:00",3,0,1,1,18.86,25,223,248
"2011-09-15 21:00:00",3,0,1,1,18.86,11,134,145
"2011-09-15 22:00:00",3,0,1,1,18.04,7,108,115
"2011-09-15 23:00:00",3,0,1,1,18.04,8,61,69
"2011-09-16 00:00:00",3,0,1,1,17.22,5,43,48
"2011-09-16 01:00:00",3,0,1,1,17.22,7,19,26
"2011-09-16 02:00:00",3,0,1,1,16.4,3,7,10
"2011-09-16 03:00:00",3,0,1,1,16.4,2,4,6
"2011-09-16 04:00:00",3,0,1,1,16.4,1,3,4
"2011-09-16 05:00:00",3,0,1,1,15.58,2,30,32
"2011-09-16 06:00:00",3,0,1,1,15.58,6,87,93
"2011-09-16 07:00:00",3,0,1,1,16.4,16,283,299
"2011-09-16 08:00:00",3,0,1,1,17.22,23,386,409
"2011-09-16 09:00:00",3,0,1,1,18.86,21,189,210
"2011-09-16 10:00:00",3,0,1,2,20.5,36,104,140
"2011-09-16 11:00:00",3,0,1,2,20.5,40,139,179
"2011-09-16 12:00:00",3,0,1,2,21.32,39,212,251
"2011-09-16 13:00:00",3,0,1,2,22.14,55,168,223
"2011-09-16 14:00:00",3,0,1,2,22.14,49,176,225
"2011-09-16 15:00:00",3,0,1,2,22.14,38,165,203
"2011-09-16 16:00:00",3,0,1,2,21.32,67,291,358
"2011-09-16 17:00:00",3,0,1,2,21.32,86,480,566
"2011-09-16 18:00:00",3,0,1,2,21.32,55,427,482
"2011-09-16 19:00:00",3,0,1,2,20.5,59,256,315
"2011-09-16 20:00:00",3,0,1,2,20.5,41,184,225
"2011-09-16 21:00:00",3,0,1,2,20.5,39,124,163
"2011-09-16 22:00:00",3,0,1,1,19.68,32,135,167
"2011-09-16 23:00:00",3,0,1,1,20.5,20,106,126
"2011-09-17 00:00:00",3,0,0,1,18.86,28,80,108
"2011-09-17 01:00:00",3,0,0,1,18.86,28,52,80
"2011-09-17 02:00:00",3,0,0,1,18.86,18,61,79
"2011-09-17 03:00:00",3,0,0,1,18.86,7,21,28
"2011-09-17 04:00:00",3,0,0,1,18.86,1,4,5
"2011-09-17 05:00:00",3,0,0,1,18.86,2,3,5
"2011-09-17 06:00:00",3,0,0,2,18.86,5,17,22
"2011-09-17 07:00:00",3,0,0,2,18.86,4,33,37
"2011-09-17 08:00:00",3,0,0,2,18.86,27,81,108
"2011-09-17 09:00:00",3,0,0,2,19.68,32,145,177
"2011-09-17 10:00:00",3,0,0,2,20.5,72,177,249
"2011-09-17 11:00:00",3,0,0,2,21.32,119,248,367
"2011-09-17 12:00:00",3,0,0,2,21.32,115,257,372
"2011-09-17 13:00:00",3,0,0,2,21.32,124,225,349
"2011-09-17 14:00:00",3,0,0,2,21.32,123,174,297
"2011-09-17 15:00:00",3,0,0,2,21.32,148,206,354
"2011-09-17 16:00:00",3,0,0,1,22.14,116,189,305
"2011-09-17 17:00:00",3,0,0,1,21.32,141,218,359
"2011-09-17 18:00:00",3,0,0,2,21.32,95,234,329
"2011-09-17 19:00:00",3,0,0,1,21.32,70,186,256
"2011-09-17 20:00:00",3,0,0,1,21.32,43,133,176
"2011-09-17 21:00:00",3,0,0,2,20.5,49,121,170
"2011-09-17 22:00:00",3,0,0,1,20.5,31,112,143
"2011-09-17 23:00:00",3,0,0,1,18.86,36,100,136
"2011-09-18 00:00:00",3,0,0,1,18.86,24,88,112
"2011-09-18 01:00:00",3,0,0,1,18.86,13,66,79
"2011-09-18 02:00:00",3,0,0,1,18.04,21,68,89
"2011-09-18 03:00:00",3,0,0,1,18.04,11,25,36
"2011-09-18 04:00:00",3,0,0,1,18.04,1,0,1
"2011-09-18 05:00:00",3,0,0,1,18.04,1,5,6
"2011-09-18 06:00:00",3,0,0,1,18.04,2,10,12
"2011-09-18 07:00:00",3,0,0,1,18.86,15,29,44
"2011-09-18 08:00:00",3,0,0,1,18.86,16,53,69
"2011-09-18 09:00:00",3,0,0,1,19.68,46,94,140
"2011-09-18 10:00:00",3,0,0,1,20.5,82,178,260
"2011-09-18 11:00:00",3,0,0,1,21.32,116,201,317
"2011-09-18 12:00:00",3,0,0,1,22.14,135,229,364
"2011-09-18 13:00:00",3,0,0,1,22.96,162,214,376
"2011-09-18 14:00:00",3,0,0,2,23.78,127,184,311
"2011-09-18 15:00:00",3,0,0,2,23.78,132,233,365
"2011-09-18 16:00:00",3,0,0,2,22.96,134,235,369
"2011-09-18 17:00:00",3,0,0,2,22.96,95,230,325
"2011-09-18 18:00:00",3,0,0,2,22.96,66,223,289
"2011-09-18 19:00:00",3,0,0,2,22.14,54,191,245
"2011-09-18 20:00:00",3,0,0,2,22.14,44,136,180
"2011-09-18 21:00:00",3,0,0,2,22.14,37,110,147
"2011-09-18 22:00:00",3,0,0,2,22.14,9,75,84
"2011-09-18 23:00:00",3,0,0,1,22.14,10,44,54
"2011-09-19 00:00:00",3,0,1,2,21.32,14,23,37
"2011-09-19 01:00:00",3,0,1,2,21.32,3,7,10
"2011-09-19 02:00:00",3,0,1,2,21.32,6,7,13
"2011-09-19 03:00:00",3,0,1,2,20.5,1,4,5
"2011-09-19 04:00:00",3,0,1,2,20.5,2,6,8
"2011-09-19 05:00:00",3,0,1,2,20.5,2,26,28
"2011-09-19 06:00:00",3,0,1,1,20.5,6,107,113
"2011-09-19 07:00:00",3,0,1,2,20.5,20,312,332
"2011-09-19 08:00:00",3,0,1,2,21.32,29,391,420
"2011-09-19 09:00:00",3,0,1,2,22.14,32,183,215
"2011-09-19 10:00:00",3,0,1,2,22.96,21,84,105
"2011-09-19 11:00:00",3,0,1,2,23.78,41,98,139
"2011-09-19 12:00:00",3,0,1,2,23.78,51,138,189
"2011-09-19 13:00:00",3,0,1,2,24.6,53,124,177
"2011-09-19 14:00:00",3,0,1,2,24.6,45,143,188
"2011-09-19 15:00:00",3,0,1,2,24.6,44,143,187
"2011-09-19 16:00:00",3,0,1,2,24.6,55,208,263
"2011-09-19 17:00:00",3,0,1,2,23.78,85,483,568
"2011-09-19 18:00:00",3,0,1,2,22.96,56,484,540
"2011-09-19 19:00:00",3,0,1,2,22.96,41,333,374
"2011-09-19 20:00:00",3,0,1,2,22.96,27,204,231
"2011-09-19 21:00:00",3,0,1,2,22.96,19,181,200
"2011-09-19 22:00:00",3,0,1,2,22.96,25,104,129
"2011-09-19 23:00:00",3,0,1,2,22.96,13,55,68
"2011-10-01 00:00:00",4,0,0,1,20.5,24,106,130
"2011-10-01 01:00:00",4,0,0,1,19.68,11,47,58
"2011-10-01 02:00:00",4,0,0,1,18.86,21,46,67
"2011-10-01 03:00:00",4,0,0,1,18.86,8,17,25
"2011-10-01 04:00:00",4,0,0,1,18.04,2,6,8
"2011-10-01 05:00:00",4,0,0,2,18.04,1,4,5
"2011-10-01 06:00:00",4,0,0,1,17.22,4,15,19
"2011-10-01 07:00:00",4,0,0,3,17.22,6,30,36
"2011-10-01 08:00:00",4,0,0,2,16.4,9,58,67
"2011-10-01 09:00:00",4,0,0,3,16.4,17,112,129
"2011-10-01 10:00:00",4,0,0,3,16.4,21,100,121
"2011-10-01 11:00:00",4,0,0,3,15.58,30,102,132
"2011-10-01 12:00:00",4,0,0,2,16.4,28,130,158
"2011-10-01 13:00:00",4,0,0,2,16.4,27,98,125
"2011-10-01 14:00:00",4,0,0,2,17.22,33,147,180
"2011-10-01 15:00:00",4,0,0,2,17.22,41,154,195
"2011-10-01 16:00:00",4,0,0,2,16.4,58,165,223
"2011-10-01 17:00:00",4,0,0,3,16.4,58,170,228
"2011-10-01 18:00:00",4,0,0,3,15.58,23,117,140
"2011-10-01 19:00:00",4,0,0,2,15.58,27,99,126
"2011-10-01 20:00:00",4,0,0,3,14.76,8,58,66
"2011-10-01 21:00:00",4,0,0,3,14.76,3,53,56
"2011-10-01 22:00:00",4,0,0,2,14.76,12,58,70
"2011-10-01 23:00:00",4,0,0,3,14.76,8,57,65
"2011-10-02 00:00:00",4,0,0,3,14.76,4,43,47
"2011-10-02 01:00:00",4,0,0,3,13.94,1,23,24
"2011-10-02 02:00:00",4,0,0,3,13.94,3,27,30
"2011-10-02 03:00:00",4,0,0,3,13.94,4,5,9
"2011-10-02 04:00:00",4,0,0,2,13.94,4,3,7
"2011-10-02 05:00:00",4,0,0,1,13.12,0,7,7
"2011-10-02 06:00:00",4,0,0,1,13.12,2,13,15
"2011-10-02 07:00:00",4,0,0,1,13.94,5,24,29
"2011-10-02 08:00:00",4,0,0,2,13.94,14,50,64
"2011-10-02 09:00:00",4,0,0,1,14.76,19,96,115
"2011-10-02 10:00:00",4,0,0,2,14.76,60,188,248
"2011-10-02 11:00:00",4,0,0,2,15.58,74,218,292
"2011-10-02 12:00:00",4,0,0,2,16.4,78,243,321
"2011-10-02 13:00:00",4,0,0,3,16.4,84,224,308
"2011-10-02 14:00:00",4,0,0,3,14.76,61,195,256
"2011-10-02 15:00:00",4,0,0,3,14.76,29,144,173
"2011-10-02 16:00:00",4,0,0,3,14.76,44,162,206
"2011-10-02 17:00:00",4,0,0,3,14.76,32,135,167
"2011-10-02 18:00:00",4,0,0,2,14.76,16,158,174
"2011-10-02 19:00:00",4,0,0,2,15.58,34,128,162
"2011-10-02 20:00:00",4,0,0,2,14.76,16,71,87
"2011-10-02 21:00:00",4,0,0,1,14.76,17,71,88
"2011-10-02 22:00:00",4,0,0,3,14.76,9,55,64
"2011-10-02 23:00:00",4,0,0,1,14.76,6,19,25
"2011-10-03 00:00:00",4,0,1,1,13.94,3,13,16
"2011-10-03 01:00:00",4,0,1,1,14.76,1,5,6
"2011-10-03 02:00:00",4,0,1,1,14.76,0,4,4
"2011-10-03 03:00:00",4,0,1,1,14.76,1,6,7
"2011-10-03 04:00:00",4,0,1,1,13.94,2,6,8
"2011-10-03 05:00:00",4,0,1,2,14.76,4,17,21
"2011-10-03 06:00:00",4,0,1,2,14.76,3,91,94
"2011-10-03 07:00:00",4,0,1,2,14.76,8,241,249
"2011-10-03 08:00:00",4,0,1,2,14.76,13,359,372
"2011-10-03 09:00:00",4,0,1,2,16.4,12,141,153
"2011-10-03 10:00:00",4,0,1,2,16.4,19,82,101
"2011-10-03 11:00:00",4,0,1,2,16.4,26,100,126
"2011-10-03 12:00:00",4,0,1,2,16.4,29,118,147
"2011-10-03 13:00:00",4,0,1,3,17.22,16,102,118
"2011-10-03 14:00:00",4,0,1,3,16.4,26,94,120
"2011-10-03 15:00:00",4,0,1,3,16.4,22,79,101
"2011-10-03 16:00:00",4,0,1,2,16.4,16,202,218
"2011-10-03 17:00:00",4,0,1,2,16.4,40,455,495
"2011-10-03 18:00:00",4,0,1,2,16.4,28,384,412
"2011-10-03 19:00:00",4,0,1,1,16.4,15,300,315
"2011-10-03 20:00:00",4,0,1,3,16.4,13,191,204
"2011-10-03 21:00:00",4,0,1,2,16.4,10,128,138
"2011-10-03 22:00:00",4,0,1,2,16.4,12,79,91
"2011-10-03 23:00:00",4,0,1,2,16.4,11,43,54
"2011-10-04 00:00:00",4,0,1,2,16.4,5,22,27
"2011-10-04 01:00:00",4,0,1,2,16.4,1,8,9
"2011-10-04 02:00:00",4,0,1,2,16.4,1,2,3
"2011-10-04 03:00:00",4,0,1,1,16.4,3,3,6
"2011-10-04 04:00:00",4,0,1,1,16.4,3,4,7
"2011-10-04 05:00:00",4,0,1,1,16.4,2,25,27
"2011-10-04 06:00:00",4,0,1,1,16.4,3,109,112
"2011-10-04 07:00:00",4,0,1,1,17.22,11,298,309
"2011-10-04 08:00:00",4,0,1,1,18.04,28,372,400
"2011-10-04 09:00:00",4,0,1,1,18.86,19,168,187
"2011-10-04 10:00:00",4,0,1,1,19.68,19,107,126
"2011-10-04 11:00:00",4,0,1,1,22.14,22,102,124
"2011-10-04 12:00:00",4,0,1,1,22.96,39,160,199
"2011-10-04 13:00:00",4,0,1,1,22.96,20,153,173
"2011-10-04 14:00:00",4,0,1,1,23.78,27,156,183
"2011-10-04 15:00:00",4,0,1,1,23.78,28,166,194
"2011-10-04 16:00:00",4,0,1,1,23.78,36,273,309
"2011-10-04 17:00:00",4,0,1,1,22.96,55,530,585
"2011-10-04 18:00:00",4,0,1,1,22.14,68,456,524
"2011-10-04 19:00:00",4,0,1,1,21.32,35,310,345
"2011-10-04 20:00:00",4,0,1,1,21.32,25,236,261
"2011-10-04 21:00:00",4,0,1,1,20.5,22,144,166
"2011-10-04 22:00:00",4,0,1,1,20.5,8,106,114
"2011-10-04 23:00:00",4,0,1,1,19.68,6,60,66
"2011-10-05 00:00:00",4,0,1,1,19.68,7,36,43
"2011-10-05 01:00:00",4,0,1,1,19.68,4,7,11
"2011-10-05 02:00:00",4,0,1,1,18.86,1,2,3
"2011-10-05 03:00:00",4,0,1,1,18.86,1,5,6
"2011-10-05 04:00:00",4,0,1,1,18.04,1,4,5
"2011-10-05 05:00:00",4,0,1,1,18.04,3,29,32
"2011-10-05 06:00:00",4,0,1,1,18.04,5,112,117
"2011-10-05 07:00:00",4,0,1,1,18.86,9,292,301
"2011-10-05 08:00:00",4,0,1,1,21.32,26,441,467
"2011-10-05 09:00:00",4,0,1,1,22.14,32,187,219
"2011-10-05 10:00:00",4,0,1,1,22.96,30,103,133
"2011-10-05 11:00:00",4,0,1,1,24.6,32,138,170
"2011-10-05 12:00:00",4,0,1,1,25.42,34,180,214
"2011-10-05 13:00:00",4,0,1,1,26.24,30,189,219
"2011-10-05 14:00:00",4,0,1,1,26.24,34,156,190
"2011-10-05 15:00:00",4,0,1,1,26.24,35,147,182
"2011-10-05 16:00:00",4,0,1,1,26.24,37,245,282
"2011-10-05 17:00:00",4,0,1,1,26.24,66,525,591
"2011-10-05 18:00:00",4,0,1,1,24.6,57,536,593
"2011-10-05 19:00:00",4,0,1,1,23.78,40,334,374
"2011-10-05 20:00:00",4,0,1,1,21.32,18,228,246
"2011-10-05 21:00:00",4,0,1,1,20.5,28,173,201
"2011-10-05 22:00:00",4,0,1,1,21.32,20,134,154
"2011-10-05 23:00:00",4,0,1,1,20.5,9,64,73
"2011-10-06 00:00:00",4,0,1,1,20.5,6,34,40
"2011-10-06 01:00:00",4,0,1,1,19.68,5,17,22
"2011-10-06 02:00:00",4,0,1,1,18.86,2,8,10
"2011-10-06 03:00:00",4,0,1,1,18.04,1,4,5
"2011-10-06 04:00:00",4,0,1,1,18.04,0,5,5
"2011-10-06 05:00:00",4,0,1,1,17.22,0,24,24
"2011-10-06 06:00:00",4,0,1,1,16.4,4,110,114
"2011-10-06 07:00:00",4,0,1,1,17.22,15,287,302
"2011-10-06 08:00:00",4,0,1,1,18.04,20,437,457
"2011-10-06 09:00:00",4,0,1,1,18.86,20,188,208
"2011-10-06 10:00:00",4,0,1,1,21.32,24,105,129
"2011-10-06 11:00:00",4,0,1,1,22.14,29,115,144
"2011-10-06 12:00:00",4,0,1,1,22.96,46,180,226
"2011-10-06 13:00:00",4,0,1,1,22.96,33,158,191
"2011-10-06 14:00:00",4,0,1,1,23.78,56,139,195
"2011-10-06 15:00:00",4,0,1,1,23.78,62,157,219
"2011-10-06 16:00:00",4,0,1,1,23.78,51,272,323
"2011-10-06 17:00:00",4,0,1,1,22.96,63,505,568
"2011-10-06 18:00:00",4,0,1,1,22.14,59,479,538
"2011-10-06 19:00:00",4,0,1,1,21.32,38,305,343
"2011-10-06 20:00:00",4,0,1,1,20.5,29,231,260
"2011-10-06 21:00:00",4,0,1,1,18.86,34,161,195
"2011-10-06 22:00:00",4,0,1,1,18.86,24,124,148
"2011-10-06 23:00:00",4,0,1,1,18.04,18,81,99
"2011-10-07 00:00:00",4,0,1,1,18.04,19,48,67
"2011-10-07 01:00:00",4,0,1,1,18.04,3,25,28
"2011-10-07 02:00:00",4,0,1,1,17.22,0,5,5
"2011-10-07 03:00:00",4,0,1,1,16.4,1,9,10
"2011-10-07 04:00:00",4,0,1,1,16.4,0,5,5
"2011-10-07 05:00:00",4,0,1,1,17.22,3,24,27
"2011-10-07 06:00:00",4,0,1,1,17.22,3,84,87
"2011-10-07 07:00:00",4,0,1,1,17.22,5,237,242
"2011-10-07 08:00:00",4,0,1,1,18.86,31,386,417
"2011-10-07 09:00:00",4,0,1,1,19.68,34,207,241
"2011-10-07 10:00:00",4,0,1,1,21.32,48,126,174
"2011-10-07 11:00:00",4,0,1,1,22.96,80,150,230
"2011-10-07 12:00:00",4,0,1,1,24.6,61,174,235
"2011-10-07 13:00:00",4,0,1,1,24.6,95,210,305
"2011-10-07 14:00:00",4,0,1,1,25.42,77,179,256
"2011-10-07 15:00:00",4,0,1,1,27.06,68,202,270
"2011-10-07 16:00:00",4,0,1,1,26.24,73,346,419
"2011-10-07 17:00:00",4,0,1,1,24.6,101,462,563
"2011-10-07 18:00:00",4,0,1,1,22.96,94,371,465
"2011-10-07 19:00:00",4,0,1,1,22.96,51,243,294
"2011-10-07 20:00:00",4,0,1,1,22.14,30,167,197
"2011-10-07 21:00:00",4,0,1,1,20.5,22,144,166
"2011-10-07 22:00:00",4,0,1,1,20.5,27,119,146
"2011-10-07 23:00:00",4,0,1,1,20.5,23,113,136
"2011-10-08 00:00:00",4,0,0,1,19.68,17,72,89
"2011-10-08 01:00:00",4,0,0,1,18.86,14,51,65
"2011-10-08 02:00:00",4,0,0,1,18.86,4,41,45
"2011-10-08 03:00:00",4,0,0,1,18.04,4,16,20
"2011-10-08 04:00:00",4,0,0,1,17.22,3,7,10
"2011-10-08 05:00:00",4,0,0,1,17.22,1,7,8
"2011-10-08 06:00:00",4,0,0,1,17.22,6,16,22
"2011-10-08 07:00:00",4,0,0,1,17.22,27,46,73
"2011-10-08 08:00:00",4,0,0,1,18.86,14,89,103
"2011-10-08 09:00:00",4,0,0,1,20.5,54,163,217
"2011-10-08 10:00:00",4,0,0,1,21.32,120,217,337
"2011-10-08 11:00:00",4,0,0,1,23.78,176,221,397
"2011-10-08 12:00:00",4,0,0,1,25.42,191,255,446
"2011-10-08 13:00:00",4,0,0,1,25.42,256,229,485
"2011-10-08 14:00:00",4,0,0,1,25.42,251,214,465
"2011-10-08 15:00:00",4,0,0,1,27.06,262,234,496
"2011-10-08 16:00:00",4,0,0,1,26.24,221,230,451
"2011-10-08 17:00:00",4,0,0,1,25.42,174,219,393
"2011-10-08 18:00:00",4,0,0,1,24.6,135,224,359
"2011-10-08 19:00:00",4,0,0,1,22.14,76,172,248
"2011-10-08 20:00:00",4,0,0,1,21.32,78,124,202
"2011-10-08 21:00:00",4,0,0,1,21.32,54,133,187
"2011-10-08 22:00:00",4,0,0,1,20.5,45,104,149
"2011-10-08 23:00:00",4,0,0,1,19.68,52,90,142
"2011-10-09 00:00:00",4,0,0,1,18.86,46,83,129
"2011-10-09 01:00:00",4,0,0,1,18.86,15,63,78
"2011-10-09 02:00:00",4,0,0,1,18.86,20,35,55
"2011-10-09 03:00:00",4,0,0,1,18.04,10,20,30
"2011-10-09 04:00:00",4,0,0,1,18.04,7,7,14
"2011-10-09 05:00:00",4,0,0,1,18.04,1,14,15
"2011-10-09 06:00:00",4,0,0,1,18.04,7,14,21
"2011-10-09 07:00:00",4,0,0,1,18.04,18,26,44
"2011-10-09 08:00:00",4,0,0,1,18.86,25,82,107
"2011-10-09 09:00:00",4,0,0,1,20.5,66,119,185
"2011-10-09 10:00:00",4,0,0,1,22.96,155,210,365
"2011-10-09 11:00:00",4,0,0,1,25.42,189,234,423
"2011-10-09 12:00:00",4,0,0,1,26.24,212,243,455
"2011-10-09 13:00:00",4,0,0,1,27.06,225,193,418
"2011-10-09 14:00:00",4,0,0,1,27.88,272,228,500
"2011-10-09 15:00:00",4,0,0,1,27.88,198,209,407
"2011-10-09 16:00:00",4,0,0,1,27.06,223,247,470
"2011-10-09 17:00:00",4,0,0,1,25.42,208,230,438
"2011-10-09 18:00:00",4,0,0,1,26.24,186,228,414
"2011-10-09 19:00:00",4,0,0,1,22.96,116,186,302
"2011-10-09 20:00:00",4,0,0,1,22.96,59,134,193
"2011-10-09 21:00:00",4,0,0,1,22.14,53,120,173
"2011-10-09 22:00:00",4,0,0,2,21.32,48,104,152
"2011-10-09 23:00:00",4,0,0,1,20.5,38,85,123
"2011-10-10 00:00:00",4,1,0,1,20.5,11,42,53
"2011-10-10 01:00:00",4,1,0,1,19.68,4,30,34
"2011-10-10 02:00:00",4,1,0,1,19.68,4,15,19
"2011-10-10 03:00:00",4,1,0,1,18.86,2,9,11
"2011-10-10 04:00:00",4,1,0,1,18.86,2,4,6
"2011-10-10 05:00:00",4,1,0,1,18.86,2,19,21
"2011-10-10 06:00:00",4,1,0,1,18.04,5,39,44
"2011-10-10 07:00:00",4,1,0,1,18.86,12,102,114
"2011-10-10 08:00:00",4,1,0,1,21.32,27,227,254
"2011-10-10 09:00:00",4,1,0,1,22.14,58,161,219
"2011-10-10 10:00:00",4,1,0,1,22.96,107,158,265
"2011-10-10 11:00:00",4,1,0,1,25.42,139,183,322
"2011-10-10 12:00:00",4,1,0,2,28.7,164,201,365
"2011-10-10 13:00:00",4,1,0,1,29.52,146,219,365
"2011-10-10 14:00:00",4,1,0,1,30.34,147,223,370
"2011-10-10 15:00:00",4,1,0,2,29.52,130,254,384
"2011-10-10 16:00:00",4,1,0,2,28.7,154,248,402
"2011-10-10 17:00:00",4,1,0,2,27.06,125,334,459
"2011-10-10 18:00:00",4,1,0,2,26.24,108,365,473
"2011-10-10 19:00:00",4,1,0,2,23.78,69,267,336
"2011-10-10 20:00:00",4,1,0,1,24.6,37,188,225
"2011-10-10 21:00:00",4,1,0,1,22.96,27,148,175
"2011-10-10 22:00:00",4,1,0,1,22.96,22,104,126
"2011-10-10 23:00:00",4,1,0,2,22.14,12,63,75
"2011-10-11 00:00:00",4,0,1,2,22.14,14,16,30
"2011-10-11 01:00:00",4,0,1,2,21.32,2,9,11
"2011-10-11 02:00:00",4,0,1,2,21.32,1,4,5
"2011-10-11 03:00:00",4,0,1,2,21.32,2,1,3
"2011-10-11 04:00:00",4,0,1,2,21.32,0,5,5
"2011-10-11 05:00:00",4,0,1,2,21.32,0,20,20
"2011-10-11 06:00:00",4,0,1,1,21.32,9,114,123
"2011-10-11 07:00:00",4,0,1,2,21.32,19,333,352
"2011-10-11 08:00:00",4,0,1,2,22.96,31,375,406
"2011-10-11 09:00:00",4,0,1,2,24.6,40,195,235
"2011-10-11 10:00:00",4,0,1,2,24.6,38,111,149
"2011-10-11 11:00:00",4,0,1,2,24.6,31,92,123
"2011-10-11 12:00:00",4,0,1,2,24.6,51,130,181
"2011-10-11 13:00:00",4,0,1,2,24.6,42,138,180
"2011-10-11 14:00:00",4,0,1,3,24.6,54,117,171
"2011-10-11 15:00:00",4,0,1,2,24.6,36,139,175
"2011-10-11 16:00:00",4,0,1,2,24.6,63,257,320
"2011-10-11 17:00:00",4,0,1,2,24.6,70,534,604
"2011-10-11 18:00:00",4,0,1,2,24.6,46,493,539
"2011-10-11 19:00:00",4,0,1,2,23.78,33,285,318
"2011-10-11 20:00:00",4,0,1,2,23.78,31,203,234
"2011-10-11 21:00:00",4,0,1,2,23.78,17,158,175
"2011-10-11 22:00:00",4,0,1,2,22.96,27,120,147
"2011-10-11 23:00:00",4,0,1,2,22.96,10,47,57
"2011-10-12 00:00:00",4,0,1,2,22.96,2,23,25
"2011-10-12 01:00:00",4,0,1,3,22.96,2,8,10
"2011-10-12 02:00:00",4,0,1,2,22.96,0,2,2
"2011-10-12 03:00:00",4,0,1,3,22.14,0,2,2
"2011-10-12 04:00:00",4,0,1,3,22.14,1,6,7
"2011-10-12 05:00:00",4,0,1,2,22.14,0,22,22
"2011-10-12 06:00:00",4,0,1,2,22.14,5,107,112
"2011-10-12 07:00:00",4,0,1,2,22.14,15,244,259
"2011-10-12 08:00:00",4,0,1,2,22.14,27,377,404
"2011-10-12 09:00:00",4,0,1,2,22.14,14,183,197
"2011-10-12 10:00:00",4,0,1,2,22.14,15,98,113
"2011-10-12 11:00:00",4,0,1,3,22.14,18,102,120
"2011-10-12 12:00:00",4,0,1,3,22.14,9,53,62
"2011-10-12 13:00:00",4,0,1,3,22.14,25,76,101
"2011-10-12 14:00:00",4,0,1,3,22.14,8,70,78
"2011-10-12 15:00:00",4,0,1,3,22.14,3,42,45
"2011-10-12 16:00:00",4,0,1,2,22.96,5,50,55
"2011-10-12 17:00:00",4,0,1,3,22.14,16,235,251
"2011-10-12 18:00:00",4,0,1,3,22.14,11,161,172
"2011-10-12 19:00:00",4,0,1,3,22.14,7,102,109
"2011-10-12 20:00:00",4,0,1,3,22.14,9,81,90
"2011-10-12 21:00:00",4,0,1,3,22.14,9,74,83
"2011-10-12 22:00:00",4,0,1,3,22.14,3,40,43
"2011-10-12 23:00:00",4,0,1,3,22.14,13,41,54
"2011-10-13 00:00:00",4,0,1,2,22.14,1,14,15
"2011-10-13 01:00:00",4,0,1,2,22.14,3,9,12
"2011-10-13 02:00:00",4,0,1,2,22.14,0,4,4
"2011-10-13 03:00:00",4,0,1,2,22.14,2,4,6
"2011-10-13 04:00:00",4,0,1,2,22.14,2,5,7
"2011-10-13 05:00:00",4,0,1,2,22.14,1,16,17
"2011-10-13 06:00:00",4,0,1,3,22.14,1,51,52
"2011-10-13 07:00:00",4,0,1,3,22.14,5,76,81
"2011-10-13 08:00:00",4,0,1,3,22.14,10,199,209
"2011-10-13 09:00:00",4,0,1,3,22.96,3,106,109
"2011-10-13 10:00:00",4,0,1,3,22.96,16,53,69
"2011-10-13 11:00:00",4,0,1,2,25.42,8,76,84
"2011-10-13 12:00:00",4,0,1,2,25.42,10,95,105
"2011-10-13 13:00:00",4,0,1,2,26.24,20,142,162
"2011-10-13 14:00:00",4,0,1,1,27.06,22,111,133
"2011-10-13 15:00:00",4,0,1,1,27.06,27,128,155
"2011-10-13 16:00:00",4,0,1,1,27.06,36,240,276
"2011-10-13 17:00:00",4,0,1,3,25.42,47,432,479
"2011-10-13 18:00:00",4,0,1,3,25.42,20,248,268
"2011-10-13 19:00:00",4,0,1,2,25.42,18,187,205
"2011-10-13 20:00:00",4,0,1,1,25.42,15,166,181
"2011-10-13 21:00:00",4,0,1,1,25.42,8,115,123
"2011-10-13 22:00:00",4,0,1,1,25.42,13,101,114
"2011-10-13 23:00:00",4,0,1,2,23.78,2,45,47
"2011-10-14 00:00:00",4,0,1,1,23.78,10,29,39
"2011-10-14 01:00:00",4,0,1,1,23.78,8,16,24
"2011-10-14 02:00:00",4,0,1,1,22.96,0,6,6
"2011-10-14 03:00:00",4,0,1,1,22.96,1,6,7
"2011-10-14 04:00:00",4,0,1,1,22.96,0,8,8
"2011-10-14 05:00:00",4,0,1,2,22.96,0,17,17
"2011-10-14 06:00:00",4,0,1,3,22.96,4,90,94
"2011-10-14 07:00:00",4,0,1,3,22.96,10,137,147
"2011-10-14 08:00:00",4,0,1,2,22.96,23,186,209
"2011-10-14 09:00:00",4,0,1,2,22.96,16,164,180
"2011-10-14 10:00:00",4,0,1,3,22.14,17,108,125
"2011-10-14 11:00:00",4,0,1,3,21.32,11,76,87
"2011-10-14 12:00:00",4,0,1,3,21.32,13,62,75
"2011-10-14 13:00:00",4,0,1,1,22.96,18,114,132
"2011-10-14 14:00:00",4,0,1,1,25.42,37,119,156
"2011-10-14 15:00:00",4,0,1,1,25.42,61,169,230
"2011-10-14 16:00:00",4,0,1,1,24.6,80,264,344
"2011-10-14 17:00:00",4,0,1,1,23.78,55,426,481
"2011-10-14 18:00:00",4,0,1,1,22.14,62,361,423
"2011-10-14 19:00:00",4,0,1,1,22.14,27,221,248
"2011-10-14 20:00:00",4,0,1,1,21.32,19,177,196
"2011-10-14 21:00:00",4,0,1,1,20.5,22,156,178
"2011-10-14 22:00:00",4,0,1,1,18.86,20,123,143
"2011-10-14 23:00:00",4,0,1,1,18.86,15,80,95
"2011-10-15 00:00:00",4,0,0,1,18.86,18,88,106
"2011-10-15 01:00:00",4,0,0,1,18.86,9,64,73
"2011-10-15 02:00:00",4,0,0,1,18.86,17,39,56
"2011-10-15 03:00:00",4,0,0,1,18.04,5,18,23
"2011-10-15 04:00:00",4,0,0,1,17.22,0,6,6
"2011-10-15 05:00:00",4,0,0,1,17.22,1,6,7
"2011-10-15 06:00:00",4,0,0,1,16.4,5,15,20
"2011-10-15 07:00:00",4,0,0,1,16.4,17,40,57
"2011-10-15 08:00:00",4,0,0,1,18.86,24,101,125
"2011-10-15 09:00:00",4,0,0,1,21.32,50,157,207
"2011-10-15 10:00:00",4,0,0,1,22.14,115,207,322
"2011-10-15 11:00:00",4,0,0,1,22.96,153,221,374
"2011-10-15 12:00:00",4,0,0,1,23.78,195,261,456
"2011-10-15 13:00:00",4,0,0,1,24.6,171,223,394
"2011-10-15 14:00:00",4,0,0,1,24.6,242,230,472
"2011-10-15 15:00:00",4,0,0,1,25.42,166,211,377
"2011-10-15 16:00:00",4,0,0,1,25.42,179,264,443
"2011-10-15 17:00:00",4,0,0,1,23.78,177,264,441
"2011-10-15 18:00:00",4,0,0,1,22.14,121,251,372
"2011-10-15 19:00:00",4,0,0,1,20.5,61,177,238
"2011-10-15 20:00:00",4,0,0,1,20.5,42,137,179
"2011-10-15 21:00:00",4,0,0,1,20.5,53,115,168
"2011-10-15 22:00:00",4,0,0,1,20.5,45,121,166
"2011-10-15 23:00:00",4,0,0,1,19.68,33,102,135
"2011-10-16 00:00:00",4,0,0,1,18.86,22,85,107
"2011-10-16 01:00:00",4,0,0,1,18.04,13,64,77
"2011-10-16 02:00:00",4,0,0,1,17.22,13,52,65
"2011-10-16 03:00:00",4,0,0,1,17.22,11,31,42
"2011-10-16 04:00:00",4,0,0,1,17.22,5,7,12
"2011-10-16 05:00:00",4,0,0,1,17.22,1,6,7
"2011-10-16 06:00:00",4,0,0,1,15.58,3,7,10
"2011-10-16 07:00:00",4,0,0,1,16.4,9,39,48
"2011-10-16 08:00:00",4,0,0,1,18.04,28,71,99
"2011-10-16 09:00:00",4,0,0,1,20.5,39,151,190
"2011-10-16 10:00:00",4,0,0,1,22.14,121,226,347
"2011-10-16 11:00:00",4,0,0,1,22.96,159,218,377
"2011-10-16 12:00:00",4,0,0,1,23.78,167,277,444
"2011-10-16 13:00:00",4,0,0,1,24.6,169,269,438
"2011-10-16 14:00:00",4,0,0,1,24.6,204,258,462
"2011-10-16 15:00:00",4,0,0,1,25.42,182,230,412
"2011-10-16 16:00:00",4,0,0,1,24.6,177,289,466
"2011-10-16 17:00:00",4,0,0,1,23.78,152,253,405
"2011-10-16 18:00:00",4,0,0,1,22.96,102,226,328
"2011-10-16 19:00:00",4,0,0,1,22.14,52,181,233
"2011-10-16 20:00:00",4,0,0,1,22.14,49,129,178
"2011-10-16 21:00:00",4,0,0,1,22.14,14,88,102
"2011-10-16 22:00:00",4,0,0,1,22.96,42,88,130
"2011-10-16 23:00:00",4,0,0,1,22.96,14,48,62
"2011-10-17 00:00:00",4,0,1,1,22.14,12,25,37
"2011-10-17 01:00:00",4,0,1,1,22.96,2,15,17
"2011-10-17 02:00:00",4,0,1,1,22.96,4,3,7
"2011-10-17 03:00:00",4,0,1,1,22.96,0,2,2
"2011-10-17 04:00:00",4,0,1,1,21.32,2,3,5
"2011-10-17 05:00:00",4,0,1,1,20.5,1,28,29
"2011-10-17 06:00:00",4,0,1,1,20.5,7,107,114
"2011-10-17 07:00:00",4,0,1,2,20.5,10,299,309
"2011-10-17 08:00:00",4,0,1,2,20.5,33,381,414
"2011-10-17 09:00:00",4,0,1,2,20.5,26,180,206
"2011-10-17 10:00:00",4,0,1,1,21.32,43,92,135
"2011-10-17 11:00:00",4,0,1,1,22.96,35,131,166
"2011-10-17 12:00:00",4,0,1,1,22.96,39,166,205
"2011-10-17 13:00:00",4,0,1,1,22.96,49,156,205
"2011-10-17 14:00:00",4,0,1,1,23.78,44,122,166
"2011-10-17 15:00:00",4,0,1,1,22.96,66,142,208
"2011-10-17 16:00:00",4,0,1,1,23.78,64,238,302
"2011-10-17 17:00:00",4,0,1,1,22.96,80,540,620
"2011-10-17 18:00:00",4,0,1,1,22.96,49,469,518
"2011-10-17 19:00:00",4,0,1,1,22.14,45,288,333
"2011-10-17 20:00:00",4,0,1,1,21.32,40,189,229
"2011-10-17 21:00:00",4,0,1,1,20.5,36,141,177
"2011-10-17 22:00:00",4,0,1,1,20.5,16,88,104
"2011-10-17 23:00:00",4,0,1,2,19.68,10,52,62
"2011-10-18 00:00:00",4,0,1,1,19.68,8,23,31
"2011-10-18 01:00:00",4,0,1,2,18.86,4,7,11
"2011-10-18 02:00:00",4,0,1,1,18.04,1,4,5
"2011-10-18 03:00:00",4,0,1,1,18.04,0,1,1
"2011-10-18 04:00:00",4,0,1,2,18.04,0,4,4
"2011-10-18 05:00:00",4,0,1,2,18.86,2,19,21
"2011-10-18 06:00:00",4,0,1,1,18.86,4,105,109
"2011-10-18 07:00:00",4,0,1,1,18.86,15,326,341
"2011-10-18 08:00:00",4,0,1,1,20.5,25,474,499
"2011-10-18 09:00:00",4,0,1,2,21.32,29,198,227
"2011-10-18 10:00:00",4,0,1,2,22.96,27,75,102
"2011-10-18 11:00:00",4,0,1,2,24.6,35,112,147
"2011-10-18 12:00:00",4,0,1,2,25.42,42,159,201
"2011-10-18 13:00:00",4,0,1,2,26.24,48,171,219
"2011-10-18 14:00:00",4,0,1,2,25.42,32,137,169
"2011-10-18 15:00:00",4,0,1,1,25.42,66,139,205
"2011-10-18 16:00:00",4,0,1,1,25.42,58,246,304
"2011-10-18 17:00:00",4,0,1,1,24.6,72,553,625
"2011-10-18 18:00:00",4,0,1,1,22.96,58,512,570
"2011-10-18 19:00:00",4,0,1,1,22.96,31,286,317
"2011-10-18 20:00:00",4,0,1,1,22.14,23,204,227
"2011-10-18 21:00:00",4,0,1,2,22.14,28,178,206
"2011-10-18 22:00:00",4,0,1,2,21.32,22,115,137
"2011-10-18 23:00:00",4,0,1,2,21.32,7,63,70
"2011-10-19 00:00:00",4,0,1,2,21.32,11,23,34
"2011-10-19 01:00:00",4,0,1,2,21.32,7,9,16
"2011-10-19 02:00:00",4,0,1,2,21.32,1,6,7
"2011-10-19 04:00:00",4,0,1,3,20.5,0,3,3
"2011-10-19 05:00:00",4,0,1,3,20.5,0,3,3
"2011-10-19 06:00:00",4,0,1,3,21.32,3,28,31
"2011-10-19 07:00:00",4,0,1,3,21.32,1,67,68
"2011-10-19 08:00:00",4,0,1,3,22.14,10,200,210
"2011-10-19 09:00:00",4,0,1,3,21.32,17,185,202
"2011-10-19 10:00:00",4,0,1,3,21.32,14,109,123
"2011-10-19 11:00:00",4,0,1,3,21.32,33,116,149
"2011-10-19 12:00:00",4,0,1,3,21.32,13,117,130
"2011-10-19 13:00:00",4,0,1,2,22.14,20,86,106
"2011-10-19 14:00:00",4,0,1,3,22.14,17,80,97
"2011-10-19 15:00:00",4,0,1,3,22.14,21,99,120
"2011-10-19 16:00:00",4,0,1,3,22.96,21,180,201
"2011-10-19 17:00:00",4,0,1,3,22.96,11,170,181
"2011-10-19 18:00:00",4,0,1,3,22.96,8,132,140
"2011-10-19 19:00:00",4,0,1,2,24.6,8,189,197
"2011-10-19 20:00:00",4,0,1,3,24.6,5,140,145
"2011-10-19 21:00:00",4,0,1,2,23.78,6,79,85
"2011-10-19 22:00:00",4,0,1,2,23.78,13,94,107
"2011-10-19 23:00:00",4,0,1,2,23.78,14,55,69
"2011-11-01 00:00:00",4,0,1,2,14.76,3,18,21
"2011-11-01 01:00:00",4,0,1,1,14.76,3,8,11
"2011-11-01 02:00:00",4,0,1,2,14.76,1,3,4
"2011-11-01 03:00:00",4,0,1,2,14.76,1,5,6
"2011-11-01 04:00:00",4,0,1,1,13.94,1,7,8
"2011-11-01 05:00:00",4,0,1,1,13.12,0,18,18
"2011-11-01 06:00:00",4,0,1,1,13.12,3,90,93
"2011-11-01 07:00:00",4,0,1,1,13.94,8,246,254
"2011-11-01 08:00:00",4,0,1,1,14.76,17,402,419
"2011-11-01 09:00:00",4,0,1,1,16.4,16,206,222
"2011-11-01 10:00:00",4,0,1,1,18.04,21,114,135
"2011-11-01 11:00:00",4,0,1,1,18.86,16,101,117
"2011-11-01 12:00:00",4,0,1,1,20.5,23,153,176
"2011-11-01 13:00:00",4,0,1,1,19.68,20,147,167
"2011-11-01 14:00:00",4,0,1,1,20.5,32,118,150
"2011-11-01 15:00:00",4,0,1,1,20.5,38,148,186
"2011-11-01 16:00:00",4,0,1,1,19.68,46,252,298
"2011-11-01 17:00:00",4,0,1,1,18.04,36,470,506
"2011-11-01 18:00:00",4,0,1,1,17.22,39,421,460
"2011-11-01 19:00:00",4,0,1,1,17.22,39,274,313
"2011-11-01 20:00:00",4,0,1,1,16.4,18,191,209
"2011-11-01 21:00:00",4,0,1,1,14.76,13,114,127
"2011-11-01 22:00:00",4,0,1,1,14.76,5,91,96
"2011-11-01 23:00:00",4,0,1,1,13.94,11,61,72
"2011-11-02 00:00:00",4,0,1,1,13.12,0,19,19
"2011-11-02 01:00:00",4,0,1,1,12.3,2,8,10
"2011-11-02 02:00:00",4,0,1,1,12.3,0,2,2
"2011-11-02 03:00:00",4,0,1,1,12.3,0,2,2
"2011-11-02 04:00:00",4,0,1,1,12.3,0,4,4
"2011-11-02 05:00:00",4,0,1,1,12.3,0,27,27
"2011-11-02 06:00:00",4,0,1,1,12.3,1,91,92
"2011-11-02 07:00:00",4,0,1,1,12.3,11,240,251
"2011-11-02 08:00:00",4,0,1,1,13.12,20,452,472
"2011-11-02 09:00:00",4,0,1,1,13.94,15,213,228
"2011-11-02 10:00:00",4,0,1,1,16.4,25,108,133
"2011-11-02 11:00:00",4,0,1,1,17.22,27,117,144
"2011-11-02 12:00:00",4,0,1,1,18.86,32,157,189
"2011-11-02 13:00:00",4,0,1,1,19.68,22,139,161
"2011-11-02 14:00:00",4,0,1,1,20.5,40,132,172
"2011-11-02 15:00:00",4,0,1,1,19.68,26,161,187
"2011-11-02 16:00:00",4,0,1,1,19.68,35,231,266
"2011-11-02 17:00:00",4,0,1,1,18.04,30,523,553
"2011-11-02 18:00:00",4,0,1,1,17.22,31,448,479
"2011-11-02 19:00:00",4,0,1,1,16.4,25,257,282
"2011-11-02 20:00:00",4,0,1,1,16.4,5,177,182
"2011-11-02 21:00:00",4,0,1,1,15.58,13,155,168
"2011-11-02 22:00:00",4,0,1,1,14.76,7,99,106
"2011-11-02 23:00:00",4,0,1,1,14.76,3,54,57
"2011-11-03 00:00:00",4,0,1,1,14.76,3,28,31
"2011-11-03 01:00:00",4,0,1,1,13.94,3,12,15
"2011-11-03 02:00:00",4,0,1,1,13.94,2,5,7
"2011-11-03 03:00:00",4,0,1,1,13.94,1,4,5
"2011-11-03 04:00:00",4,0,1,1,13.12,1,3,4
"2011-11-03 05:00:00",4,0,1,1,13.12,1,27,28
"2011-11-03 06:00:00",4,0,1,1,13.94,3,96,99
"2011-11-03 07:00:00",4,0,1,2,13.12,12,280,292
"2011-11-03 08:00:00",4,0,1,2,13.94,8,394,402
"2011-11-03 09:00:00",4,0,1,2,14.76,9,155,164
"2011-11-03 10:00:00",4,0,1,2,16.4,12,98,110
"2011-11-03 11:00:00",4,0,1,1,18.04,12,108,120
"2011-11-03 12:00:00",4,0,1,1,20.5,17,162,179
"2011-11-03 13:00:00",4,0,1,2,21.32,19,150,169
"2011-11-03 14:00:00",4,0,1,1,21.32,32,120,152
"2011-11-03 15:00:00",4,0,1,1,21.32,24,138,162
"2011-11-03 16:00:00",4,0,1,1,21.32,33,234,267
"2011-11-03 17:00:00",4,0,1,1,19.68,33,465,498
"2011-11-03 18:00:00",4,0,1,1,18.86,24,409,433
"2011-11-03 19:00:00",4,0,1,1,18.04,18,234,252
"2011-11-03 20:00:00",4,0,1,1,17.22,11,198,209
"2011-11-03 21:00:00",4,0,1,1,16.4,4,140,144
"2011-11-03 22:00:00",4,0,1,1,16.4,21,116,137
"2011-11-03 23:00:00",4,0,1,1,16.4,15,80,95
"2011-11-04 00:00:00",4,0,1,2,16.4,11,32,43
"2011-11-04 01:00:00",4,0,1,2,16.4,1,16,17
"2011-11-04 02:00:00",4,0,1,2,16.4,2,8,10
"2011-11-04 03:00:00",4,0,1,2,15.58,1,7,8
"2011-11-04 04:00:00",4,0,1,2,15.58,1,6,7
"2011-11-04 05:00:00",4,0,1,2,15.58,0,23,23
"2011-11-04 06:00:00",4,0,1,2,15.58,2,64,66
"2011-11-04 07:00:00",4,0,1,2,16.4,10,235,245
"2011-11-04 08:00:00",4,0,1,2,16.4,8,387,395
"2011-11-04 09:00:00",4,0,1,2,17.22,15,239,254
"2011-11-04 10:00:00",4,0,1,2,17.22,19,115,134
"2011-11-04 11:00:00",4,0,1,2,18.04,34,128,162
"2011-11-04 12:00:00",4,0,1,2,19.68,44,153,197
"2011-11-04 13:00:00",4,0,1,1,18.04,33,161,194
"2011-11-04 14:00:00",4,0,1,1,18.04,54,147,201
"2011-11-04 15:00:00",4,0,1,1,18.86,45,192,237
"2011-11-04 16:00:00",4,0,1,1,18.86,53,237,290
"2011-11-04 17:00:00",4,0,1,1,17.22,42,438,480
"2011-11-04 18:00:00",4,0,1,1,17.22,35,339,374
"2011-11-04 19:00:00",4,0,1,1,16.4,14,182,196
"2011-11-04 20:00:00",4,0,1,1,14.76,15,171,186
"2011-11-04 21:00:00",4,0,1,1,13.94,8,115,123
"2011-11-04 22:00:00",4,0,1,1,13.94,6,109,115
"2011-11-04 23:00:00",4,0,1,1,13.12,17,72,89
"2011-11-05 00:00:00",4,0,0,1,13.12,4,48,52
"2011-11-05 01:00:00",4,0,0,1,13.12,5,57,62
"2011-11-05 02:00:00",4,0,0,1,12.3,7,24,31
"2011-11-05 03:00:00",4,0,0,1,12.3,0,8,8
"2011-11-05 04:00:00",4,0,0,1,11.48,3,5,8
"2011-11-05 05:00:00",4,0,0,1,10.66,0,2,2
"2011-11-05 06:00:00",4,0,0,1,10.66,3,20,23
"2011-11-05 07:00:00",4,0,0,1,10.66,3,31,34
"2011-11-05 08:00:00",4,0,0,1,11.48,4,80,84
"2011-11-05 09:00:00",4,0,0,1,12.3,30,111,141
"2011-11-05 10:00:00",4,0,0,1,13.12,56,171,227
"2011-11-05 11:00:00",4,0,0,1,14.76,69,169,238
"2011-11-05 12:00:00",4,0,0,1,14.76,137,235,372
"2011-11-05 13:00:00",4,0,0,1,16.4,148,207,355
"2011-11-05 14:00:00",4,0,0,1,17.22,159,227,386
"2011-11-05 15:00:00",4,0,0,1,16.4,141,202,343
"2011-11-05 16:00:00",4,0,0,1,16.4,128,207,335
"2011-11-05 17:00:00",4,0,0,1,15.58,100,234,334
"2011-11-05 18:00:00",4,0,0,1,14.76,52,185,237
"2011-11-05 19:00:00",4,0,0,1,13.94,45,159,204
"2011-11-05 20:00:00",4,0,0,1,13.12,29,136,165
"2011-11-05 21:00:00",4,0,0,1,13.12,19,99,118
"2011-11-05 22:00:00",4,0,0,1,12.3,10,72,82
"2011-11-05 23:00:00",4,0,0,1,11.48,4,81,85
"2011-11-06 00:00:00",4,0,0,1,11.48,10,65,75
"2011-11-06 01:00:00",4,0,0,1,10.66,11,104,115
"2011-11-06 02:00:00",4,0,0,1,10.66,6,23,29
"2011-11-06 03:00:00",4,0,0,1,9.84,5,4,9
"2011-11-06 04:00:00",4,0,0,1,9.84,0,6,6
"2011-11-06 05:00:00",4,0,0,1,9.84,0,5,5
"2011-11-06 06:00:00",4,0,0,1,10.66,5,11,16
"2011-11-06 07:00:00",4,0,0,1,10.66,4,24,28
"2011-11-06 08:00:00",4,0,0,2,11.48,19,71,90
"2011-11-06 09:00:00",4,0,0,2,12.3,36,134,170
"2011-11-06 10:00:00",4,0,0,1,14.76,76,186,262
"2011-11-06 11:00:00",4,0,0,1,17.22,104,216,320
"2011-11-06 12:00:00",4,0,0,1,18.04,120,226,346
"2011-11-06 13:00:00",4,0,0,1,18.86,105,209,314
"2011-11-06 14:00:00",4,0,0,1,18.86,101,219,320
"2011-11-06 15:00:00",4,0,0,1,19.68,96,210,306
"2011-11-06 16:00:00",4,0,0,1,18.86,84,263,347
"2011-11-06 17:00:00",4,0,0,1,18.04,71,185,256
"2011-11-06 18:00:00",4,0,0,1,17.22,39,146,185
"2011-11-06 19:00:00",4,0,0,1,15.58,21,130,151
"2011-11-06 20:00:00",4,0,0,1,14.76,16,100,116
"2011-11-06 21:00:00",4,0,0,1,14.76,11,77,88
"2011-11-06 22:00:00",4,0,0,1,14.76,5,40,45
"2011-11-06 23:00:00",4,0,0,1,13.94,7,43,50
"2011-11-07 00:00:00",4,0,1,1,13.94,1,14,15
"2011-11-07 01:00:00",4,0,1,1,13.94,2,6,8
"2011-11-07 02:00:00",4,0,1,1,13.12,0,2,2
"2011-11-07 03:00:00",4,0,1,1,13.12,0,3,3
"2011-11-07 04:00:00",4,0,1,1,13.12,2,4,6
"2011-11-07 05:00:00",4,0,1,1,12.3,1,25,26
"2011-11-07 06:00:00",4,0,1,2,11.48,2,97,99
"2011-11-07 07:00:00",4,0,1,2,11.48,6,305,311
"2011-11-07 08:00:00",4,0,1,2,12.3,13,397,410
"2011-11-07 09:00:00",4,0,1,2,13.94,18,156,174
"2011-11-07 10:00:00",4,0,1,1,14.76,28,95,123
"2011-11-07 11:00:00",4,0,1,1,17.22,28,100,128
"2011-11-07 12:00:00",4,0,1,1,18.86,21,158,179
"2011-11-07 13:00:00",4,0,1,1,22.14,32,157,189
"2011-11-07 14:00:00",4,0,1,1,22.96,30,115,145
"2011-11-07 15:00:00",4,0,1,1,22.96,38,132,170
"2011-11-07 16:00:00",4,0,1,1,21.32,40,255,295
"2011-11-07 17:00:00",4,0,1,1,20.5,39,489,528
"2011-11-07 18:00:00",4,0,1,1,18.86,18,407,425
"2011-11-07 19:00:00",4,0,1,1,18.86,20,280,300
"2011-11-07 20:00:00",4,0,1,1,16.4,17,187,204
"2011-11-07 21:00:00",4,0,1,1,15.58,10,129,139
"2011-11-07 22:00:00",4,0,1,1,14.76,6,102,108
"2011-11-07 23:00:00",4,0,1,1,14.76,1,47,48
"2011-11-08 00:00:00",4,0,1,1,13.94,0,18,18
"2011-11-08 01:00:00",4,0,1,1,13.12,3,8,11
"2011-11-08 02:00:00",4,0,1,1,13.12,0,1,1
"2011-11-08 03:00:00",4,0,1,1,13.12,0,3,3
"2011-11-08 04:00:00",4,0,1,1,12.3,0,4,4
"2011-11-08 05:00:00",4,0,1,1,12.3,1,17,18
"2011-11-08 06:00:00",4,0,1,1,12.3,3,96,99
"2011-11-08 07:00:00",4,0,1,1,12.3,7,316,323
"2011-11-08 08:00:00",4,0,1,1,13.12,11,455,466
"2011-11-08 09:00:00",4,0,1,1,14.76,14,177,191
"2011-11-08 10:00:00",4,0,1,1,17.22,25,104,129
"2011-11-08 11:00:00",4,0,1,1,18.86,21,126,147
"2011-11-08 12:00:00",4,0,1,1,21.32,28,175,203
"2011-11-08 13:00:00",4,0,1,1,22.14,31,165,196
"2011-11-08 14:00:00",4,0,1,1,22.96,32,129,161
"2011-11-08 15:00:00",4,0,1,1,23.78,33,155,188
"2011-11-08 16:00:00",4,0,1,1,22.96,39,250,289
"2011-11-08 17:00:00",4,0,1,1,21.32,40,459,499
"2011-11-08 18:00:00",4,0,1,1,19.68,30,432,462
"2011-11-08 19:00:00",4,0,1,1,18.86,14,264,278
"2011-11-08 20:00:00",4,0,1,1,16.4,12,169,181
"2011-11-08 21:00:00",4,0,1,1,16.4,16,166,182
"2011-11-08 22:00:00",4,0,1,1,14.76,13,95,108
"2011-11-08 23:00:00",4,0,1,1,14.76,3,45,48
"2011-11-09 00:00:00",4,0,1,1,14.76,0,13,13
"2011-11-09 01:00:00",4,0,1,1,13.94,0,10,10
"2011-11-09 02:00:00",4,0,1,1,13.12,0,5,5
"2011-11-09 03:00:00",4,0,1,1,13.12,0,4,4
"2011-11-09 04:00:00",4,0,1,1,13.12,0,4,4
"2011-11-09 05:00:00",4,0,1,1,12.3,0,28,28
"2011-11-09 06:00:00",4,0,1,1,12.3,0,98,98
"2011-11-09 07:00:00",4,0,1,1,12.3,0,300,300
"2011-11-09 08:00:00",4,0,1,1,13.12,19,437,456
"2011-11-09 09:00:00",4,0,1,1,13.94,22,197,219
"2011-11-09 10:00:00",4,0,1,1,16.4,16,89,105
"2011-11-09 11:00:00",4,0,1,1,18.86,21,131,152
"2011-11-09 12:00:00",4,0,1,1,20.5,24,156,180
"2011-11-09 13:00:00",4,0,1,1,20.5,31,136,167
"2011-11-09 14:00:00",4,0,1,1,21.32,26,153,179
"2011-11-09 15:00:00",4,0,1,1,21.32,21,130,151
"2011-11-09 16:00:00",4,0,1,1,21.32,24,257,281
"2011-11-09 17:00:00",4,0,1,1,18.86,27,458,485
"2011-11-09 18:00:00",4,0,1,1,18.04,21,387,408
"2011-11-09 19:00:00",4,0,1,1,18.04,12,292,304
"2011-11-09 20:00:00",4,0,1,1,18.04,18,201,219
"2011-11-09 21:00:00",4,0,1,1,16.4,9,152,161
"2011-11-09 22:00:00",4,0,1,1,16.4,9,105,114
"2011-11-09 23:00:00",4,0,1,1,15.58,5,61,66
"2011-11-10 00:00:00",4,0,1,1,16.4,0,24,24
"2011-11-10 01:00:00",4,0,1,2,16.4,1,10,11
"2011-11-10 02:00:00",4,0,1,2,15.58,0,5,5
"2011-11-10 03:00:00",4,0,1,1,15.58,0,11,11
"2011-11-10 04:00:00",4,0,1,1,15.58,1,2,3
"2011-11-10 05:00:00",4,0,1,2,14.76,1,22,23
"2011-11-10 06:00:00",4,0,1,2,14.76,4,110,114
"2011-11-10 07:00:00",4,0,1,2,15.58,6,266,272
"2011-11-10 08:00:00",4,0,1,2,16.4,18,418,436
"2011-11-10 09:00:00",4,0,1,2,17.22,23,188,211
"2011-11-10 10:00:00",4,0,1,2,18.04,17,100,117
"2011-11-10 11:00:00",4,0,1,2,18.86,9,99,108
"2011-11-10 12:00:00",4,0,1,2,17.22,18,149,167
"2011-11-10 13:00:00",4,0,1,3,14.76,9,87,96
"2011-11-10 14:00:00",4,0,1,3,14.76,6,58,64
"2011-11-10 15:00:00",4,0,1,3,14.76,5,57,62
"2011-11-10 16:00:00",4,0,1,3,14.76,6,67,73
"2011-11-10 17:00:00",4,0,1,3,14.76,9,168,177
"2011-11-10 18:00:00",4,0,1,2,14.76,10,263,273
"2011-11-10 19:00:00",4,0,1,2,14.76,19,192,211
"2011-11-10 20:00:00",4,0,1,2,14.76,8,160,168
"2011-11-10 21:00:00",4,0,1,1,14.76,6,130,136
"2011-11-10 22:00:00",4,0,1,1,14.76,5,84,89
"2011-11-10 23:00:00",4,0,1,2,13.94,9,73,82
"2011-11-11 00:00:00",4,1,0,1,13.94,10,56,66
"2011-11-11 01:00:00",4,1,0,1,13.12,3,16,19
"2011-11-11 02:00:00",4,1,0,1,13.12,1,10,11
"2011-11-11 03:00:00",4,1,0,1,12.3,0,6,6
"2011-11-11 04:00:00",4,1,0,1,12.3,0,8,8
"2011-11-11 05:00:00",4,1,0,1,12.3,0,13,13
"2011-11-11 06:00:00",4,1,0,1,11.48,0,46,46
"2011-11-11 07:00:00",4,1,0,1,11.48,5,116,121
"2011-11-11 08:00:00",4,1,0,1,12.3,9,249,258
"2011-11-11 09:00:00",4,1,0,1,13.12,15,186,201
"2011-11-11 10:00:00",4,1,0,1,13.12,38,162,200
"2011-11-11 11:00:00",4,1,0,1,13.94,20,150,170
"2011-11-11 12:00:00",4,1,0,1,13.94,41,198,239
"2011-11-11 13:00:00",4,1,0,1,15.58,57,179,236
"2011-11-11 14:00:00",4,1,0,1,15.58,64,183,247
"2011-11-11 15:00:00",4,1,0,1,14.76,29,187,216
"2011-11-11 16:00:00",4,1,0,1,14.76,49,189,238
"2011-11-11 17:00:00",4,1,0,1,13.94,24,286,310
"2011-11-11 18:00:00",4,1,0,1,13.94,23,185,208
"2011-11-11 19:00:00",4,1,0,1,13.12,17,182,199
"2011-11-11 20:00:00",4,1,0,1,13.12,12,97,109
"2011-11-11 21:00:00",4,1,0,1,12.3,4,79,83
"2011-11-11 22:00:00",4,1,0,1,13.12,13,78,91
"2011-11-11 23:00:00",4,1,0,1,12.3,6,67,73
"2011-11-12 00:00:00",4,0,0,1,9.84,12,52,64
"2011-11-12 01:00:00",4,0,0,1,9.84,9,45,54
"2011-11-12 02:00:00",4,0,0,1,9.84,7,39,46
"2011-11-12 03:00:00",4,0,0,1,9.84,4,13,17
"2011-11-12 04:00:00",4,0,0,1,8.2,0,7,7
"2011-11-12 05:00:00",4,0,0,1,9.02,1,3,4
"2011-11-12 06:00:00",4,0,0,1,9.02,0,7,7
"2011-11-12 07:00:00",4,0,0,1,9.02,3,24,27
"2011-11-12 08:00:00",4,0,0,1,10.66,14,87,101
"2011-11-12 09:00:00",4,0,0,1,12.3,18,142,160
"2011-11-12 10:00:00",4,0,0,1,13.94,62,170,232
"2011-11-12 11:00:00",4,0,0,1,15.58,102,213,315
"2011-11-12 12:00:00",4,0,0,1,18.04,142,224,366
"2011-11-12 13:00:00",4,0,0,1,19.68,128,225,353
"2011-11-12 14:00:00",4,0,0,1,20.5,191,244,435
"2011-11-12 15:00:00",4,0,0,1,21.32,165,221,386
"2011-11-12 16:00:00",4,0,0,1,21.32,137,224,361
"2011-11-12 17:00:00",4,0,0,1,20.5,92,193,285
"2011-11-12 18:00:00",4,0,0,1,17.22,53,150,203
"2011-11-12 19:00:00",4,0,0,1,17.22,32,139,171
"2011-11-12 20:00:00",4,0,0,1,17.22,31,101,132
"2011-11-12 21:00:00",4,0,0,1,17.22,19,103,122
"2011-11-12 22:00:00",4,0,0,1,17.22,30,88,118
"2011-11-12 23:00:00",4,0,0,1,16.4,23,78,101
"2011-11-13 00:00:00",4,0,0,2,16.4,12,61,73
"2011-11-13 01:00:00",4,0,0,2,14.76,13,58,71
"2011-11-13 02:00:00",4,0,0,1,14.76,9,48,57
"2011-11-13 03:00:00",4,0,0,2,14.76,8,20,28
"2011-11-13 04:00:00",4,0,0,2,14.76,1,5,6
"2011-11-13 05:00:00",4,0,0,1,13.94,2,3,5
"2011-11-13 06:00:00",4,0,0,1,13.94,5,18,23
"2011-11-13 07:00:00",4,0,0,1,13.94,13,30,43
"2011-11-13 08:00:00",4,0,0,1,13.94,24,55,79
"2011-11-13 09:00:00",4,0,0,1,16.4,38,97,135
"2011-11-13 10:00:00",4,0,0,1,18.04,63,178,241
"2011-11-13 11:00:00",4,0,0,1,18.86,108,187,295
"2011-11-13 12:00:00",4,0,0,2,21.32,112,242,354
"2011-11-13 13:00:00",4,0,0,2,21.32,105,234,339
"2011-11-13 14:00:00",4,0,0,2,22.14,108,263,371
"2011-11-13 15:00:00",4,0,0,2,20.5,89,221,310
"2011-11-13 16:00:00",4,0,0,2,22.14,93,226,319
"2011-11-13 17:00:00",4,0,0,1,21.32,44,187,231
"2011-11-13 18:00:00",4,0,0,1,21.32,35,155,190
"2011-11-13 19:00:00",4,0,0,1,20.5,36,121,157
"2011-11-13 20:00:00",4,0,0,1,20.5,24,115,139
"2011-11-13 21:00:00",4,0,0,1,19.68,19,76,95
"2011-11-13 22:00:00",4,0,0,1,19.68,25,64,89
"2011-11-13 23:00:00",4,0,0,1,18.86,18,49,67
"2011-11-14 00:00:00",4,0,1,1,18.86,8,22,30
"2011-11-14 01:00:00",4,0,1,1,18.86,5,6,11
"2011-11-14 02:00:00",4,0,1,1,18.86,7,10,17
"2011-11-14 03:00:00",4,0,1,1,18.04,4,3,7
"2011-11-14 04:00:00",4,0,1,1,18.04,0,5,5
"2011-11-14 05:00:00",4,0,1,2,18.04,0,19,19
"2011-11-14 06:00:00",4,0,1,2,18.04,10,104,114
"2011-11-14 07:00:00",4,0,1,1,18.04,11,311,322
"2011-11-14 08:00:00",4,0,1,2,18.86,27,425,452
"2011-11-14 09:00:00",4,0,1,2,19.68,29,204,233
"2011-11-14 10:00:00",4,0,1,2,20.5,26,85,111
"2011-11-14 11:00:00",4,0,1,2,22.14,22,106,128
"2011-11-14 12:00:00",4,0,1,1,22.96,36,166,202
"2011-11-14 13:00:00",4,0,1,1,24.6,50,153,203
"2011-11-14 14:00:00",4,0,1,1,25.42,47,138,185
"2011-11-14 15:00:00",4,0,1,1,26.24,53,142,195
"2011-11-14 16:00:00",4,0,1,1,25.42,51,264,315
"2011-11-14 17:00:00",4,0,1,1,25.42,55,464,519
"2011-11-14 18:00:00",4,0,1,1,22.96,29,460,489
"2011-11-14 19:00:00",4,0,1,1,24.6,28,274,302
"2011-11-14 20:00:00",4,0,1,1,24.6,30,210,240
"2011-11-14 21:00:00",4,0,1,1,24.6,37,176,213
"2011-11-14 22:00:00",4,0,1,1,23.78,17,96,113
"2011-11-14 23:00:00",4,0,1,1,22.96,13,48,61
"2011-11-15 00:00:00",4,0,1,1,22.96,7,15,22
"2011-11-15 01:00:00",4,0,1,1,22.96,5,5,10
"2011-11-15 02:00:00",4,0,1,1,22.96,7,8,15
"2011-11-15 03:00:00",4,0,1,2,22.14,0,4,4
"2011-11-15 04:00:00",4,0,1,1,22.96,1,6,7
"2011-11-15 05:00:00",4,0,1,1,22.14,2,26,28
"2011-11-15 06:00:00",4,0,1,2,22.96,4,104,108
"2011-11-15 07:00:00",4,0,1,2,22.14,21,298,319
"2011-11-15 08:00:00",4,0,1,2,22.14,27,453,480
"2011-11-15 09:00:00",4,0,1,2,22.96,26,174,200
"2011-11-15 10:00:00",4,0,1,2,22.96,23,115,138
"2011-11-15 11:00:00",4,0,1,2,22.96,18,116,134
"2011-11-15 12:00:00",4,0,1,2,22.14,28,148,176
"2011-11-15 13:00:00",4,0,1,3,22.14,21,132,153
"2011-11-15 14:00:00",4,0,1,2,22.14,27,120,147
"2011-11-15 15:00:00",4,0,1,2,22.14,36,155,191
"2011-11-15 16:00:00",4,0,1,2,21.32,31,240,271
"2011-11-15 17:00:00",4,0,1,2,20.5,29,422,451
"2011-11-15 18:00:00",4,0,1,2,20.5,27,414,441
"2011-11-15 19:00:00",4,0,1,2,20.5,27,259,286
"2011-11-15 20:00:00",4,0,1,2,19.68,26,212,238
"2011-11-15 21:00:00",4,0,1,2,20.5,23,145,168
"2011-11-15 22:00:00",4,0,1,2,18.86,19,109,128
"2011-11-15 23:00:00",4,0,1,2,18.86,14,66,80
"2011-11-16 00:00:00",4,0,1,2,18.86,5,26,31
"2011-11-16 01:00:00",4,0,1,3,18.86,0,5,5
"2011-11-16 02:00:00",4,0,1,2,18.86,4,6,10
"2011-11-16 03:00:00",4,0,1,2,18.86,2,3,5
"2011-11-16 04:00:00",4,0,1,2,18.04,1,3,4
"2011-11-16 05:00:00",4,0,1,3,18.86,0,13,13
"2011-11-16 06:00:00",4,0,1,2,18.86,4,52,56
"2011-11-16 07:00:00",4,0,1,3,18.86,7,130,137
"2011-11-16 08:00:00",4,0,1,3,18.86,9,223,232
"2011-11-16 09:00:00",4,0,1,3,18.86,5,77,82
"2011-11-16 10:00:00",4,0,1,3,18.86,4,32,36
"2011-11-16 11:00:00",4,0,1,3,18.86,7,53,60
"2011-11-16 12:00:00",4,0,1,3,18.86,5,49,54
"2011-11-16 13:00:00",4,0,1,3,18.86,6,52,58
"2011-11-16 14:00:00",4,0,1,2,18.86,12,49,61
"2011-11-16 15:00:00",4,0,1,3,19.68,16,50,66
"2011-11-16 16:00:00",4,0,1,3,19.68,13,110,123
"2011-11-16 17:00:00",4,0,1,2,19.68,17,216,233
"2011-11-16 18:00:00",4,0,1,3,18.86,13,176,189
"2011-11-16 19:00:00",4,0,1,3,18.86,3,108,111
"2011-11-16 20:00:00",4,0,1,3,18.04,5,94,99
"2011-11-16 21:00:00",4,0,1,3,18.04,3,72,75
"2011-11-16 22:00:00",4,0,1,3,17.22,1,45,46
"2011-11-16 23:00:00",4,0,1,3,17.22,3,28,31
"2011-11-17 00:00:00",4,0,1,2,17.22,2,22,24
"2011-11-17 01:00:00",4,0,1,2,17.22,0,5,5
"2011-11-17 02:00:00",4,0,1,2,17.22,0,5,5
"2011-11-17 03:00:00",4,0,1,2,17.22,0,3,3
"2011-11-17 04:00:00",4,0,1,2,16.4,1,3,4
"2011-11-17 05:00:00",4,0,1,3,13.94,1,21,22
"2011-11-17 06:00:00",4,0,1,3,14.76,3,72,75
"2011-11-17 07:00:00",4,0,1,3,13.94,4,164,168
"2011-11-17 08:00:00",4,0,1,3,13.94,12,343,355
"2011-11-17 09:00:00",4,0,1,2,13.94,14,184,198
"2011-11-17 10:00:00",4,0,1,2,13.94,7,74,81
"2011-11-17 11:00:00",4,0,1,3,13.12,4,93,97
"2011-11-17 12:00:00",4,0,1,2,13.94,6,115,121
"2011-11-17 13:00:00",4,0,1,2,13.94,15,109,124
"2011-11-17 14:00:00",4,0,1,2,13.94,5,105,110
"2011-11-17 15:00:00",4,0,1,2,13.94,10,106,116
"2011-11-17 16:00:00",4,0,1,1,13.12,8,187,195
"2011-11-17 17:00:00",4,0,1,1,13.12,20,379,399
"2011-11-17 18:00:00",4,0,1,1,13.12,9,298,307
"2011-11-17 19:00:00",4,0,1,1,12.3,7,210,217
"2011-11-17 20:00:00",4,0,1,1,12.3,7,162,169
"2011-11-17 21:00:00",4,0,1,1,12.3,3,113,116
"2011-11-17 22:00:00",4,0,1,1,10.66,1,83,84
"2011-11-17 23:00:00",4,0,1,1,10.66,0,58,58
"2011-11-18 00:00:00",4,0,1,1,10.66,2,28,30
"2011-11-18 01:00:00",4,0,1,1,10.66,0,10,10
"2011-11-18 02:00:00",4,0,1,1,9.84,2,8,10
"2011-11-18 03:00:00",4,0,1,1,9.84,0,2,2
"2011-11-18 04:00:00",4,0,1,1,9.02,0,5,5
"2011-11-18 05:00:00",4,0,1,1,9.02,0,22,22
"2011-11-18 06:00:00",4,0,1,1,9.02,1,70,71
"2011-11-18 07:00:00",4,0,1,1,9.02,5,211,216
"2011-11-18 08:00:00",4,0,1,1,9.02,6,369,375
"2011-11-18 09:00:00",4,0,1,1,10.66,6,207,213
"2011-11-18 10:00:00",4,0,1,1,10.66,10,105,115
"2011-11-18 11:00:00",4,0,1,1,12.3,18,122,140
"2011-11-18 12:00:00",4,0,1,1,13.12,22,143,165
"2011-11-18 13:00:00",4,0,1,1,13.94,31,146,177
"2011-11-18 14:00:00",4,0,1,1,13.94,31,123,154
"2011-11-18 15:00:00",4,0,1,1,13.94,27,151,178
"2011-11-18 16:00:00",4,0,1,1,13.94,19,190,209
"2011-11-18 17:00:00",4,0,1,1,13.12,17,361,378
"2011-11-18 18:00:00",4,0,1,1,12.3,16,312,328
"2011-11-18 19:00:00",4,0,1,1,11.48,7,183,190
"2011-11-18 20:00:00",4,0,1,1,11.48,8,129,137
"2011-11-18 21:00:00",4,0,1,1,11.48,3,108,111
"2011-11-18 22:00:00",4,0,1,1,10.66,9,88,97
"2011-11-18 23:00:00",4,0,1,1,10.66,5,54,59
"2011-11-19 00:00:00",4,0,0,1,10.66,4,49,53
"2011-11-19 01:00:00",4,0,0,1,10.66,1,34,35
"2011-11-19 02:00:00",4,0,0,1,9.84,12,34,46
"2011-11-19 03:00:00",4,0,0,1,10.66,4,11,15
"2011-11-19 04:00:00",4,0,0,1,10.66,4,4,8
"2011-11-19 05:00:00",4,0,0,1,9.84,0,2,2
"2011-11-19 06:00:00",4,0,0,1,9.84,2,10,12
"2011-11-19 07:00:00",4,0,0,1,9.84,3,38,41
"2011-11-19 08:00:00",4,0,0,1,10.66,12,80,92
"2011-11-19 09:00:00",4,0,0,1,11.48,12,130,142
"2011-11-19 10:00:00",4,0,0,1,13.12,35,165,200
"2011-11-19 11:00:00",4,0,0,1,14.76,50,183,233
"2011-11-19 12:00:00",4,0,0,1,16.4,93,218,311
"2011-11-19 13:00:00",4,0,0,1,17.22,118,245,363
"2011-11-19 14:00:00",4,0,0,1,17.22,121,228,349
"2011-11-19 15:00:00",4,0,0,1,17.22,120,262,382
"2011-11-19 16:00:00",4,0,0,1,17.22,99,188,287
"2011-11-19 17:00:00",4,0,0,1,16.4,61,171,232
"2011-11-19 18:00:00",4,0,0,1,15.58,36,172,208
"2011-11-19 19:00:00",4,0,0,2,13.94,33,149,182
"2011-11-19 20:00:00",4,0,0,2,14.76,48,115,163
"2011-11-19 21:00:00",4,0,0,2,14.76,29,79,108
"2011-11-19 22:00:00",4,0,0,2,15.58,26,80,106
"2011-11-19 23:00:00",4,0,0,1,15.58,20,73,93
"2011-12-01 00:00:00",4,0,1,1,11.48,1,19,20
"2011-12-01 01:00:00",4,0,1,1,10.66,1,9,10
"2011-12-01 02:00:00",4,0,1,1,10.66,1,8,9
"2011-12-01 03:00:00",4,0,1,1,10.66,1,6,7
"2011-12-01 04:00:00",4,0,1,1,10.66,0,1,1
"2011-12-01 05:00:00",4,0,1,1,10.66,1,23,24
"2011-12-01 06:00:00",4,0,1,1,9.84,5,92,97
"2011-12-01 07:00:00",4,0,1,1,9.84,11,265,276
"2011-12-01 08:00:00",4,0,1,1,10.66,15,462,477
"2011-12-01 09:00:00",4,0,1,1,12.3,9,215,224
"2011-12-01 10:00:00",4,0,1,1,13.12,7,86,93
"2011-12-01 11:00:00",4,0,1,1,13.94,7,95,102
"2011-12-01 12:00:00",4,0,1,1,14.76,9,139,148
"2011-12-01 13:00:00",4,0,1,1,16.4,17,137,154
"2011-12-01 14:00:00",4,0,1,1,16.4,20,130,150
"2011-12-01 15:00:00",4,0,1,1,16.4,10,144,154
"2011-12-01 16:00:00",4,0,1,1,16.4,9,192,201
"2011-12-01 17:00:00",4,0,1,1,14.76,9,409,418
"2011-12-01 18:00:00",4,0,1,1,14.76,12,393,405
"2011-12-01 19:00:00",4,0,1,1,13.94,9,219,228
"2011-12-01 20:00:00",4,0,1,1,13.94,12,178,190
"2011-12-01 21:00:00",4,0,1,1,12.3,8,154,162
"2011-12-01 22:00:00",4,0,1,1,12.3,5,99,104
"2011-12-01 23:00:00",4,0,1,1,10.66,3,70,73
"2011-12-02 00:00:00",4,0,1,1,10.66,6,32,38
"2011-12-02 01:00:00",4,0,1,1,9.84,1,14,15
"2011-12-02 02:00:00",4,0,1,1,9.84,0,10,10
"2011-12-02 03:00:00",4,0,1,1,9.02,0,1,1
"2011-12-02 04:00:00",4,0,1,1,9.02,0,3,3
"2011-12-02 05:00:00",4,0,1,1,9.02,0,23,23
"2011-12-02 06:00:00",4,0,1,1,9.02,3,84,87
"2011-12-02 07:00:00",4,0,1,1,9.02,6,199,205
"2011-12-02 08:00:00",4,0,1,1,9.84,13,432,445
"2011-12-02 09:00:00",4,0,1,1,11.48,12,234,246
"2011-12-02 10:00:00",4,0,1,1,12.3,16,89,105
"2011-12-02 11:00:00",4,0,1,1,13.94,18,142,160
"2011-12-02 12:00:00",4,0,1,1,14.76,18,186,204
"2011-12-02 13:00:00",4,0,1,1,16.4,19,188,207
"2011-12-02 14:00:00",4,0,1,1,17.22,25,145,170
"2011-12-02 15:00:00",4,0,1,1,17.22,24,175,199
"2011-12-02 16:00:00",4,0,1,1,17.22,22,254,276
"2011-12-02 17:00:00",4,0,1,1,17.22,20,391,411
"2011-12-02 18:00:00",4,0,1,1,16.4,10,362,372
"2011-12-02 19:00:00",4,0,1,1,13.94,13,252,265
"2011-12-02 20:00:00",4,0,1,1,15.58,12,178,190
"2011-12-02 21:00:00",4,0,1,1,13.94,9,102,111
"2011-12-02 22:00:00",4,0,1,1,13.12,7,95,102
"2011-12-02 23:00:00",4,0,1,1,13.12,14,81,95
"2011-12-03 00:00:00",4,0,0,1,12.3,10,65,75
"2011-12-03 01:00:00",4,0,0,1,10.66,9,62,71
"2011-12-03 02:00:00",4,0,0,1,10.66,9,41,50
"2011-12-03 03:00:00",4,0,0,1,9.84,4,5,9
"2011-12-03 04:00:00",4,0,0,1,9.02,1,7,8
"2011-12-03 05:00:00",4,0,0,1,9.84,0,6,6
"2011-12-03 06:00:00",4,0,0,1,9.84,1,10,11
"2011-12-03 07:00:00",4,0,0,1,9.02,2,24,26
"2011-12-03 08:00:00",4,0,0,1,9.84,1,62,63
"2011-12-03 09:00:00",4,0,0,1,10.66,25,99,124
"2011-12-03 10:00:00",4,0,0,1,13.12,22,173,195
"2011-12-03 11:00:00",4,0,0,1,13.12,48,227,275
"2011-12-03 12:00:00",4,0,0,1,14.76,78,280,358
"2011-12-03 13:00:00",4,0,0,1,14.76,70,222,292
"2011-12-03 14:00:00",4,0,0,1,14.76,92,251,343
"2011-12-03 15:00:00",4,0,0,1,15.58,100,237,337
"2011-12-03 16:00:00",4,0,0,1,15.58,75,230,305
"2011-12-03 17:00:00",4,0,0,1,14.76,46,186,232
"2011-12-03 18:00:00",4,0,0,1,13.94,31,193,224
"2011-12-03 19:00:00",4,0,0,1,12.3,31,144,175
"2011-12-03 20:00:00",4,0,0,1,12.3,17,110,127
"2011-12-03 21:00:00",4,0,0,2,12.3,5,104,109
"2011-12-03 22:00:00",4,0,0,2,13.12,17,97,114
"2011-12-03 23:00:00",4,0,0,1,12.3,12,73,85
"2011-12-04 00:00:00",4,0,0,1,12.3,19,64,83
"2011-12-04 01:00:00",4,0,0,1,12.3,20,54,74
"2011-12-04 02:00:00",4,0,0,1,10.66,11,51,62
"2011-12-04 03:00:00",4,0,0,1,11.48,7,34,41
"2011-12-04 04:00:00",4,0,0,1,10.66,2,9,11
"2011-12-04 05:00:00",4,0,0,1,10.66,2,2,4
"2011-12-04 06:00:00",4,0,0,1,9.84,1,3,4
"2011-12-04 07:00:00",4,0,0,1,10.66,3,23,26
"2011-12-04 08:00:00",4,0,0,1,10.66,7,48,55
"2011-12-04 09:00:00",4,0,0,1,12.3,12,114,126
"2011-12-04 10:00:00",4,0,0,1,13.12,36,180,216
"2011-12-04 11:00:00",4,0,0,1,13.94,48,206,254
"2011-12-04 12:00:00",4,0,0,1,14.76,82,247,329
"2011-12-04 13:00:00",4,0,0,1,16.4,88,269,357
"2011-12-04 14:00:00",4,0,0,1,17.22,77,246,323
"2011-12-04 15:00:00",4,0,0,1,17.22,69,227,296
"2011-12-04 16:00:00",4,0,0,1,17.22,64,266,330
"2011-12-04 17:00:00",4,0,0,1,15.58,38,207,245
"2011-12-04 18:00:00",4,0,0,1,15.58,10,161,171
"2011-12-04 19:00:00",4,0,0,1,15.58,15,158,173
"2011-12-04 20:00:00",4,0,0,1,14.76,8,116,124
"2011-12-04 21:00:00",4,0,0,1,14.76,7,65,72
"2011-12-04 22:00:00",4,0,0,1,13.94,5,59,64
"2011-12-04 23:00:00",4,0,0,1,13.94,3,42,45
"2011-12-05 00:00:00",4,0,1,1,13.12,3,21,24
"2011-12-05 01:00:00",4,0,1,1,13.12,2,10,12
"2011-12-05 02:00:00",4,0,1,1,13.12,0,8,8
"2011-12-05 03:00:00",4,0,1,1,13.12,0,2,2
"2011-12-05 04:00:00",4,0,1,1,12.3,0,7,7
"2011-12-05 05:00:00",4,0,1,1,12.3,1,24,25
"2011-12-05 06:00:00",4,0,1,1,12.3,1,89,90
"2011-12-05 07:00:00",4,0,1,1,13.12,9,274,283
"2011-12-05 08:00:00",4,0,1,1,13.12,12,392,404
"2011-12-05 09:00:00",4,0,1,2,14.76,12,178,190
"2011-12-05 10:00:00",4,0,1,2,14.76,9,78,87
"2011-12-05 11:00:00",4,0,1,2,14.76,17,106,123
"2011-12-05 12:00:00",4,0,1,2,16.4,29,125,154
"2011-12-05 13:00:00",4,0,1,2,17.22,18,153,171
"2011-12-05 14:00:00",4,0,1,2,18.86,7,126,133
"2011-12-05 15:00:00",4,0,1,2,18.86,16,132,148
"2011-12-05 16:00:00",4,0,1,1,20.5,10,238,248
"2011-12-05 17:00:00",4,0,1,1,17.22,16,430,446
"2011-12-05 18:00:00",4,0,1,1,18.04,13,386,399
"2011-12-05 19:00:00",4,0,1,2,18.86,13,295,308
"2011-12-05 20:00:00",4,0,1,2,18.86,15,190,205
"2011-12-05 21:00:00",4,0,1,2,18.04,10,166,176
"2011-12-05 22:00:00",4,0,1,2,18.04,12,94,106
"2011-12-05 23:00:00",4,0,1,2,18.86,8,54,62
"2011-12-06 00:00:00",4,0,1,2,20.5,3,25,28
"2011-12-06 01:00:00",4,0,1,2,18.86,2,14,16
"2011-12-06 02:00:00",4,0,1,2,18.86,0,3,3
"2011-12-06 03:00:00",4,0,1,2,18.86,0,3,3
"2011-12-06 04:00:00",4,0,1,3,18.86,0,7,7
"2011-12-06 05:00:00",4,0,1,3,18.86,0,20,20
"2011-12-06 06:00:00",4,0,1,2,18.04,5,81,86
"2011-12-06 07:00:00",4,0,1,2,18.86,7,227,234
"2011-12-06 08:00:00",4,0,1,2,18.86,13,401,414
"2011-12-06 09:00:00",4,0,1,2,18.86,4,200,204
"2011-12-06 10:00:00",4,0,1,3,18.86,6,44,50
"2011-12-06 11:00:00",4,0,1,3,18.86,4,28,32
"2011-12-06 12:00:00",4,0,1,3,18.86,5,50,55
"2011-12-06 13:00:00",4,0,1,3,18.86,6,65,71
"2011-12-06 14:00:00",4,0,1,3,19.68,6,69,75
"2011-12-06 15:00:00",4,0,1,3,20.5,2,43,45
"2011-12-06 16:00:00",4,0,1,3,18.86,4,84,88
"2011-12-06 17:00:00",4,0,1,2,18.86,13,249,262
"2011-12-06 18:00:00",4,0,1,2,18.86,17,287,304
"2011-12-06 19:00:00",4,0,1,3,18.86,10,223,233
"2011-12-06 20:00:00",4,0,1,3,18.86,3,107,110
"2011-12-06 21:00:00",4,0,1,2,18.04,6,108,114
"2011-12-06 22:00:00",4,0,1,3,18.86,5,82,87
"2011-12-06 23:00:00",4,0,1,3,18.86,5,48,53
"2011-12-07 00:00:00",4,0,1,1,18.04,3,30,33
"2011-12-07 01:00:00",4,0,1,2,18.86,4,9,13
"2011-12-07 02:00:00",4,0,1,3,18.86,2,4,6
"2011-12-07 03:00:00",4,0,1,3,18.86,0,3,3
"2011-12-07 04:00:00",4,0,1,3,18.86,0,1,1
"2011-12-07 05:00:00",4,0,1,3,18.86,0,3,3
"2011-12-07 06:00:00",4,0,1,3,19.68,0,18,18
"2011-12-07 07:00:00",4,0,1,3,18.04,3,43,46
"2011-12-07 08:00:00",4,0,1,3,18.04,6,80,86
"2011-12-07 09:00:00",4,0,1,3,18.04,0,64,64
"2011-12-07 10:00:00",4,0,1,3,18.04,1,32,33
"2011-12-07 11:00:00",4,0,1,3,18.04,3,47,50
"2011-12-07 12:00:00",4,0,1,3,18.04,4,29,33
"2011-12-07 13:00:00",4,0,1,3,18.04,5,28,33
"2011-12-07 14:00:00",4,0,1,3,18.04,1,24,25
"2011-12-07 15:00:00",4,0,1,3,17.22,5,25,30
"2011-12-07 16:00:00",4,0,1,3,17.22,3,28,31
"2011-12-07 17:00:00",4,0,1,3,16.4,4,48,52
"2011-12-07 18:00:00",4,0,1,3,16.4,3,48,51
"2011-12-07 19:00:00",4,0,1,3,13.94,2,31,33
"2011-12-07 20:00:00",4,0,1,3,13.94,1,25,26
"2011-12-07 21:00:00",4,0,1,3,12.3,0,6,6
"2011-12-07 22:00:00",4,0,1,3,9.84,0,13,13
"2011-12-07 23:00:00",4,0,1,1,9.84,0,16,16
"2011-12-08 00:00:00",4,0,1,2,10.66,0,21,21
"2011-12-08 01:00:00",4,0,1,1,10.66,1,6,7
"2011-12-08 02:00:00",4,0,1,1,11.48,0,4,4
"2011-12-08 03:00:00",4,0,1,1,10.66,0,1,1
"2011-12-08 04:00:00",4,0,1,2,9.84,0,2,2
"2011-12-08 05:00:00",4,0,1,1,9.02,0,12,12
"2011-12-08 06:00:00",4,0,1,1,9.02,0,71,71
"2011-12-08 07:00:00",4,0,1,1,9.02,11,233,244
"2011-12-08 08:00:00",4,0,1,1,9.02,11,418,429
"2011-12-08 09:00:00",4,0,1,1,9.84,7,218,225
"2011-12-08 10:00:00",4,0,1,1,10.66,1,109,110
"2011-12-08 11:00:00",4,0,1,1,11.48,6,100,106
"2011-12-08 12:00:00",4,0,1,1,11.48,8,148,156
"2011-12-08 13:00:00",4,0,1,1,12.3,9,115,124
"2011-12-08 14:00:00",4,0,1,1,13.12,16,121,137
"2011-12-08 15:00:00",4,0,1,1,13.12,19,98,117
"2011-12-08 16:00:00",4,0,1,1,13.12,7,201,208
"2011-12-08 17:00:00",4,0,1,1,12.3,10,321,331
"2011-12-08 18:00:00",4,0,1,1,11.48,12,306,318
"2011-12-08 19:00:00",4,0,1,1,10.66,12,220,232
"2011-12-08 20:00:00",4,0,1,1,10.66,5,170,175
"2011-12-08 21:00:00",4,0,1,1,11.48,4,135,139
"2011-12-08 22:00:00",4,0,1,1,10.66,8,84,92
"2011-12-08 23:00:00",4,0,1,1,9.84,3,58,61
"2011-12-09 00:00:00",4,0,1,1,9.84,8,26,34
"2011-12-09 01:00:00",4,0,1,1,9.84,2,12,14
"2011-12-09 02:00:00",4,0,1,1,9.84,2,10,12
"2011-12-09 03:00:00",4,0,1,1,9.02,1,5,6
"2011-12-09 04:00:00",4,0,1,1,9.02,1,1,2
"2011-12-09 05:00:00",4,0,1,1,9.02,0,20,20
"2011-12-09 06:00:00",4,0,1,1,9.02,1,62,63
"2011-12-09 07:00:00",4,0,1,1,9.02,4,195,199
"2011-12-09 08:00:00",4,0,1,1,9.84,7,378,385
"2011-12-09 09:00:00",4,0,1,1,10.66,8,256,264
"2011-12-09 10:00:00",4,0,1,2,12.3,11,115,126
"2011-12-09 11:00:00",4,0,1,1,13.12,15,121,136
"2011-12-09 12:00:00",4,0,1,1,14.76,27,146,173
"2011-12-09 13:00:00",4,0,1,1,15.58,27,141,168
"2011-12-09 14:00:00",4,0,1,1,15.58,24,163,187
"2011-12-09 15:00:00",4,0,1,1,15.58,29,160,189
"2011-12-09 16:00:00",4,0,1,1,14.76,24,226,250
"2011-12-09 17:00:00",4,0,1,1,13.94,10,352,362
"2011-12-09 18:00:00",4,0,1,1,13.94,10,308,318
"2011-12-09 19:00:00",4,0,1,1,13.94,10,189,199
"2011-12-09 20:00:00",4,0,1,1,12.3,10,140,150
"2011-12-09 21:00:00",4,0,1,1,12.3,9,131,140
"2011-12-09 22:00:00",4,0,1,1,11.48,15,114,129
"2011-12-09 23:00:00",4,0,1,1,11.48,6,88,94
"2011-12-10 00:00:00",4,0,0,2,10.66,11,66,77
"2011-12-10 01:00:00",4,0,0,2,10.66,11,55,66
"2011-12-10 02:00:00",4,0,0,2,11.48,12,48,60
"2011-12-10 03:00:00",4,0,0,2,11.48,5,20,25
"2011-12-10 04:00:00",4,0,0,2,10.66,0,3,3
"2011-12-10 05:00:00",4,0,0,1,10.66,0,6,6
"2011-12-10 06:00:00",4,0,0,1,9.84,1,10,11
"2011-12-10 07:00:00",4,0,0,1,9.84,0,11,11
"2011-12-10 08:00:00",4,0,0,1,10.66,5,68,73
"2011-12-10 09:00:00",4,0,0,1,11.48,15,134,149
"2011-12-10 10:00:00",4,0,0,1,13.12,31,161,192
"2011-12-10 11:00:00",4,0,0,1,13.12,44,192,236
"2011-12-10 12:00:00",4,0,0,1,13.12,48,235,283
"2011-12-10 13:00:00",4,0,0,1,13.94,47,239,286
"2011-12-10 14:00:00",4,0,0,1,13.94,51,242,293
"2011-12-10 15:00:00",4,0,0,1,13.94,60,239,299
"2011-12-10 16:00:00",4,0,0,1,13.12,58,183,241
"2011-12-10 17:00:00",4,0,0,1,11.48,34,151,185
"2011-12-10 18:00:00",4,0,0,1,10.66,28,144,172
"2011-12-10 19:00:00",4,0,0,1,10.66,15,139,154
"2011-12-10 20:00:00",4,0,0,1,9.84,10,114,124
"2011-12-10 21:00:00",4,0,0,1,9.02,4,79,83
"2011-12-10 22:00:00",4,0,0,1,9.02,7,88,95
"2011-12-10 23:00:00",4,0,0,1,8.2,5,61,66
"2011-12-11 00:00:00",4,0,0,1,8.2,5,69,74
"2011-12-11 01:00:00",4,0,0,1,6.56,8,54,62
"2011-12-11 02:00:00",4,0,0,1,7.38,5,47,52
"2011-12-11 03:00:00",4,0,0,1,6.56,2,17,19
"2011-12-11 04:00:00",4,0,0,1,6.56,0,5,5
"2011-12-11 05:00:00",4,0,0,1,7.38,0,6,6
"2011-12-11 06:00:00",4,0,0,1,6.56,0,10,10
"2011-12-11 07:00:00",4,0,0,1,7.38,1,30,31
"2011-12-11 08:00:00",4,0,0,1,6.56,4,68,72
"2011-12-11 09:00:00",4,0,0,1,8.2,19,88,107
"2011-12-11 10:00:00",4,0,0,1,9.84,30,164,194
"2011-12-11 11:00:00",4,0,0,1,10.66,31,166,197
"2011-12-11 12:00:00",4,0,0,1,10.66,42,246,288
"2011-12-11 13:00:00",4,0,0,1,12.3,44,224,268
"2011-12-11 14:00:00",4,0,0,1,12.3,44,198,242
"2011-12-11 15:00:00",4,0,0,1,12.3,47,219,266
"2011-12-11 16:00:00",4,0,0,1,12.3,32,174,206
"2011-12-11 17:00:00",4,0,0,1,11.48,13,150,163
"2011-12-11 18:00:00",4,0,0,1,9.84,12,151,163
"2011-12-11 19:00:00",4,0,0,1,9.02,7,98,105
"2011-12-11 20:00:00",4,0,0,1,9.02,10,62,72
"2011-12-11 21:00:00",4,0,0,1,9.02,10,53,63
"2011-12-11 22:00:00",4,0,0,1,9.02,7,36,43
"2011-12-11 23:00:00",4,0,0,1,8.2,4,31,35
"2011-12-12 00:00:00",4,0,1,1,8.2,4,16,20
"2011-12-12 01:00:00",4,0,1,1,8.2,0,9,9
"2011-12-12 02:00:00",4,0,1,1,8.2,0,4,4
"2011-12-12 03:00:00",4,0,1,1,7.38,0,2,2
"2011-12-12 04:00:00",4,0,1,1,7.38,0,3,3
"2011-12-12 05:00:00",4,0,1,1,6.56,0,21,21
"2011-12-12 06:00:00",4,0,1,1,6.56,1,63,64
"2011-12-12 07:00:00",4,0,1,1,5.74,4,231,235
"2011-12-12 08:00:00",4,0,1,2,6.56,7,378,385
"2011-12-12 09:00:00",4,0,1,2,7.38,12,208,220
"2011-12-12 10:00:00",4,0,1,2,9.02,14,91,105
"2011-12-12 11:00:00",4,0,1,2,10.66,15,100,115
"2011-12-12 12:00:00",4,0,1,1,11.48,7,138,145
"2011-12-12 13:00:00",4,0,1,2,12.3,13,153,166
"2011-12-12 14:00:00",4,0,1,2,13.12,16,95,111
"2011-12-12 15:00:00",4,0,1,2,13.12,8,124,132
"2011-12-12 16:00:00",4,0,1,2,13.12,5,209,214
"2011-12-12 17:00:00",4,0,1,2,12.3,7,352,359
"2011-12-12 18:00:00",4,0,1,1,12.3,8,349,357
"2011-12-12 19:00:00",4,0,1,1,11.48,9,232,241
"2011-12-12 20:00:00",4,0,1,1,12.3,8,157,165
"2011-12-12 21:00:00",4,0,1,1,10.66,2,119,121
"2011-12-12 22:00:00",4,0,1,1,10.66,0,71,71
"2011-12-12 23:00:00",4,0,1,1,9.84,3,42,45
"2011-12-13 00:00:00",4,0,1,1,9.02,1,16,17
"2011-12-13 01:00:00",4,0,1,1,8.2,0,4,4
"2011-12-13 02:00:00",4,0,1,1,8.2,1,1,2
"2011-12-13 03:00:00",4,0,1,1,7.38,0,3,3
"2011-12-13 04:00:00",4,0,1,1,8.2,0,4,4
"2011-12-13 05:00:00",4,0,1,1,7.38,0,20,20
"2011-12-13 06:00:00",4,0,1,1,8.2,0,92,92
"2011-12-13 07:00:00",4,0,1,1,6.56,2,221,223
"2011-12-13 08:00:00",4,0,1,1,8.2,9,391,400
"2011-12-13 09:00:00",4,0,1,1,10.66,10,223,233
"2011-12-13 10:00:00",4,0,1,1,12.3,3,99,102
"2011-12-13 11:00:00",4,0,1,1,13.94,9,115,124
"2011-12-13 12:00:00",4,0,1,1,14.76,20,147,167
"2011-12-13 13:00:00",4,0,1,1,16.4,7,120,127
"2011-12-13 14:00:00",4,0,1,1,16.4,18,116,134
"2011-12-13 15:00:00",4,0,1,1,16.4,7,144,151
"2011-12-13 16:00:00",4,0,1,1,15.58,13,194,207
"2011-12-13 17:00:00",4,0,1,1,14.76,17,381,398
"2011-12-13 18:00:00",4,0,1,1,13.94,12,370,382
"2011-12-13 19:00:00",4,0,1,1,13.12,5,262,267
"2011-12-13 20:00:00",4,0,1,1,13.12,7,154,161
"2011-12-13 21:00:00",4,0,1,1,12.3,5,134,139
"2011-12-13 22:00:00",4,0,1,1,12.3,5,102,107
"2011-12-13 23:00:00",4,0,1,1,10.66,4,55,59
"2011-12-14 00:00:00",4,0,1,1,10.66,0,22,22
"2011-12-14 01:00:00",4,0,1,1,10.66,0,8,8
"2011-12-14 02:00:00",4,0,1,1,10.66,0,2,2
"2011-12-14 03:00:00",4,0,1,1,11.48,0,3,3
"2011-12-14 04:00:00",4,0,1,1,10.66,0,4,4
"2011-12-14 05:00:00",4,0,1,2,10.66,0,26,26
"2011-12-14 06:00:00",4,0,1,2,10.66,0,87,87
"2011-12-14 07:00:00",4,0,1,1,11.48,4,243,247
"2011-12-14 08:00:00",4,0,1,2,10.66,9,458,467
"2011-12-14 09:00:00",4,0,1,2,12.3,9,230,239
"2011-12-14 10:00:00",4,0,1,2,13.12,9,133,142
"2011-12-14 11:00:00",4,0,1,2,13.94,12,103,115
"2011-12-14 12:00:00",4,0,1,2,14.76,6,138,144
"2011-12-14 13:00:00",4,0,1,2,14.76,14,119,133
"2011-12-14 14:00:00",4,0,1,2,15.58,17,134,151
"2011-12-14 15:00:00",4,0,1,2,15.58,24,143,167
"2011-12-14 16:00:00",4,0,1,2,15.58,12,233,245
"2011-12-14 17:00:00",4,0,1,2,14.76,19,377,396
"2011-12-14 18:00:00",4,0,1,2,14.76,11,379,390
"2011-12-14 19:00:00",4,0,1,2,14.76,9,259,268
"2011-12-14 20:00:00",4,0,1,2,13.94,6,169,175
"2011-12-14 21:00:00",4,0,1,2,13.94,9,145,154
"2011-12-14 22:00:00",4,0,1,1,13.94,5,99,104
"2011-12-14 23:00:00",4,0,1,1,13.12,3,48,51
"2011-12-15 00:00:00",4,0,1,1,13.12,5,45,50
"2011-12-15 01:00:00",4,0,1,2,13.12,5,15,20
"2011-12-15 02:00:00",4,0,1,2,13.12,2,5,7
"2011-12-15 03:00:00",4,0,1,2,13.12,1,2,3
"2011-12-15 04:00:00",4,0,1,2,13.12,0,6,6
"2011-12-15 05:00:00",4,0,1,2,13.12,0,24,24
"2011-12-15 06:00:00",4,0,1,1,13.12,2,90,92
"2011-12-15 07:00:00",4,0,1,1,13.12,6,252,258
"2011-12-15 08:00:00",4,0,1,2,13.94,8,449,457
"2011-12-15 09:00:00",4,0,1,2,14.76,6,274,280
"2011-12-15 10:00:00",4,0,1,2,16.4,4,105,109
"2011-12-15 11:00:00",4,0,1,2,16.4,9,126,135
"2011-12-15 12:00:00",4,0,1,2,18.86,17,140,157
"2011-12-15 13:00:00",4,0,1,2,20.5,14,150,164
"2011-12-15 14:00:00",4,0,1,2,21.32,8,124,132
"2011-12-15 15:00:00",4,0,1,3,21.32,6,76,82
"2011-12-15 16:00:00",4,0,1,3,18.86,7,124,131
"2011-12-15 17:00:00",4,0,1,2,21.32,14,310,324
"2011-12-15 18:00:00",4,0,1,2,21.32,14,363,377
"2011-12-15 19:00:00",4,0,1,2,21.32,13,274,287
"2011-12-15 20:00:00",4,0,1,1,21.32,12,209,221
"2011-12-15 21:00:00",4,0,1,1,20.5,10,145,155
"2011-12-15 22:00:00",4,0,1,1,21.32,8,116,124
"2011-12-15 23:00:00",4,0,1,1,21.32,10,104,114
"2011-12-16 00:00:00",4,0,1,1,20.5,12,60,72
"2011-12-16 01:00:00",4,0,1,1,20.5,3,28,31
"2011-12-16 02:00:00",4,0,1,1,19.68,0,23,23
"2011-12-16 03:00:00",4,0,1,1,18.86,2,3,5
"2011-12-16 04:00:00",4,0,1,2,20.5,1,4,5
"2011-12-16 05:00:00",4,0,1,1,19.68,0,26,26
"2011-12-16 06:00:00",4,0,1,2,18.04,2,80,82
"2011-12-16 07:00:00",4,0,1,2,15.58,5,226,231
"2011-12-16 08:00:00",4,0,1,1,14.76,10,449,459
"2011-12-16 09:00:00",4,0,1,1,14.76,8,235,243
"2011-12-16 10:00:00",4,0,1,1,13.94,10,122,132
"2011-12-16 11:00:00",4,0,1,2,13.94,9,135,144
"2011-12-16 12:00:00",4,0,1,2,13.94,10,163,173
"2011-12-16 13:00:00",4,0,1,2,13.94,12,125,137
"2011-12-16 14:00:00",4,0,1,2,13.94,13,115,128
"2011-12-16 15:00:00",4,0,1,2,13.12,12,141,153
"2011-12-16 16:00:00",4,0,1,2,13.12,12,212,224
"2011-12-16 17:00:00",4,0,1,2,13.12,13,352,365
"2011-12-16 18:00:00",4,0,1,2,13.12,10,285,295
"2011-12-16 19:00:00",4,0,1,2,13.12,11,203,214
"2011-12-16 20:00:00",4,0,1,2,13.12,6,146,152
"2011-12-16 21:00:00",4,0,1,2,13.12,7,95,102
"2011-12-16 22:00:00",4,0,1,2,12.3,6,100,106
"2011-12-16 23:00:00",4,0,1,2,12.3,4,71,75
"2011-12-17 00:00:00",4,0,0,1,12.3,3,59,62
"2011-12-17 01:00:00",4,0,0,2,12.3,4,39,43
"2011-12-17 02:00:00",4,0,0,2,11.48,11,47,58
"2011-12-17 03:00:00",4,0,0,1,10.66,4,22,26
"2011-12-17 04:00:00",4,0,0,1,9.84,0,9,9
"2011-12-17 05:00:00",4,0,0,2,10.66,2,7,9
"2011-12-17 06:00:00",4,0,0,2,10.66,0,17,17
"2011-12-17 07:00:00",4,0,0,2,10.66,0,20,20
"2011-12-17 08:00:00",4,0,0,2,10.66,4,55,59
"2011-12-17 09:00:00",4,0,0,2,10.66,5,95,100
"2011-12-17 10:00:00",4,0,0,2,10.66,10,171,181
"2011-12-17 11:00:00",4,0,0,2,11.48,21,188,209
"2011-12-17 12:00:00",4,0,0,2,11.48,28,216,244
"2011-12-17 13:00:00",4,0,0,2,11.48,32,204,236
"2011-12-17 14:00:00",4,0,0,1,11.48,30,207,237
"2011-12-17 15:00:00",4,0,0,1,11.48,33,195,228
"2011-12-17 16:00:00",4,0,0,1,11.48,30,192,222
"2011-12-17 17:00:00",4,0,0,1,10.66,12,153,165
"2011-12-17 18:00:00",4,0,0,1,10.66,7,150,157
"2011-12-17 19:00:00",4,0,0,3,9.84,11,95,106
"2011-12-17 20:00:00",4,0,0,1,9.02,7,99,106
"2011-12-17 21:00:00",4,0,0,1,8.2,8,88,96
"2011-12-17 22:00:00",4,0,0,1,8.2,7,73,80
"2011-12-17 23:00:00",4,0,0,1,8.2,6,63,69
"2011-12-18 00:00:00",4,0,0,1,8.2,7,64,71
"2011-12-18 01:00:00",4,0,0,1,8.2,3,43,46
"2011-12-18 02:00:00",4,0,0,1,9.02,2,39,41
"2011-12-18 03:00:00",4,0,0,1,9.02,2,16,18
"2011-12-18 04:00:00",4,0,0,1,9.02,0,1,1
"2011-12-18 05:00:00",4,0,0,1,8.2,1,4,5
"2011-12-18 06:00:00",4,0,0,1,8.2,0,3,3
"2011-12-18 07:00:00",4,0,0,1,8.2,1,11,12
"2011-12-18 08:00:00",4,0,0,1,8.2,1,31,32
"2011-12-18 09:00:00",4,0,0,1,9.02,6,75,81
"2011-12-18 10:00:00",4,0,0,1,9.84,7,122,129
"2011-12-18 11:00:00",4,0,0,2,9.84,20,168,188
"2011-12-18 12:00:00",4,0,0,1,10.66,26,202,228
"2011-12-18 13:00:00",4,0,0,1,12.3,18,210,228
"2011-12-18 14:00:00",4,0,0,1,12.3,19,200,219
"2011-12-18 15:00:00",4,0,0,1,13.12,23,184,207
"2011-12-18 16:00:00",4,0,0,1,11.48,27,207,234
"2011-12-18 17:00:00",4,0,0,1,11.48,10,126,136
"2011-12-18 18:00:00",4,0,0,1,11.48,15,123,138
"2011-12-18 19:00:00",4,0,0,1,10.66,5,130,135
"2011-12-18 20:00:00",4,0,0,1,9.84,10,94,104
"2011-12-18 21:00:00",4,0,0,1,9.02,9,80,89
"2011-12-18 22:00:00",4,0,0,1,9.02,2,47,49
"2011-12-18 23:00:00",4,0,0,1,8.2,6,31,37
"2011-12-19 00:00:00",4,0,1,1,8.2,3,14,17
"2011-12-19 01:00:00",4,0,1,1,7.38,3,8,11
"2011-12-19 02:00:00",4,0,1,1,7.38,0,3,3
"2011-12-19 03:00:00",4,0,1,1,6.56,0,3,3
"2011-12-19 04:00:00",4,0,1,1,6.56,0,4,4
"2011-12-19 05:00:00",4,0,1,1,5.74,0,21,21
"2011-12-19 06:00:00",4,0,1,1,6.56,0,68,68
"2011-12-19 07:00:00",4,0,1,1,7.38,4,187,191
"2011-12-19 08:00:00",4,0,1,1,8.2,8,389,397
"2011-12-19 09:00:00",4,0,1,1,9.02,17,166,183
"2011-12-19 10:00:00",4,0,1,1,9.84,12,96,108
"2011-12-19 11:00:00",4,0,1,1,10.66,22,105,127
"2011-12-19 12:00:00",4,0,1,1,12.3,13,128,141
"2011-12-19 13:00:00",4,0,1,1,13.94,15,127,142
"2011-12-19 14:00:00",4,0,1,1,14.76,30,107,137
"2011-12-19 15:00:00",4,0,1,1,15.58,24,135,159
"2011-12-19 16:00:00",4,0,1,1,16.4,19,189,208
"2011-12-19 17:00:00",4,0,1,1,15.58,16,362,378
"2011-12-19 18:00:00",4,0,1,1,14.76,11,343,354
"2011-12-19 19:00:00",4,0,1,2,14.76,17,234,251
"2011-12-19 20:00:00",4,0,1,1,16.4,9,197,206
"2011-12-19 21:00:00",4,0,1,2,14.76,15,112,127
"2011-12-19 22:00:00",4,0,1,2,14.76,12,95,107
"2011-12-19 23:00:00",4,0,1,1,14.76,10,50,60
"2012-01-01 00:00:00",1,0,0,1,14.76,5,43,48
"2012-01-01 01:00:00",1,0,0,1,14.76,15,78,93
"2012-01-01 02:00:00",1,0,0,1,13.12,16,59,75
"2012-01-01 03:00:00",1,0,0,1,12.3,11,41,52
"2012-01-01 04:00:00",1,0,0,1,11.48,0,8,8
"2012-01-01 05:00:00",1,0,0,1,11.48,0,5,5
"2012-01-01 06:00:00",1,0,0,1,10.66,1,1,2
"2012-01-01 07:00:00",1,0,0,1,10.66,1,6,7
"2012-01-01 08:00:00",1,0,0,1,10.66,4,10,14
"2012-01-01 09:00:00",1,0,0,1,10.66,13,27,40
"2012-01-01 10:00:00",1,0,0,1,12.3,18,52,70
"2012-01-01 11:00:00",1,0,0,1,13.94,40,98,138
"2012-01-01 12:00:00",1,0,0,1,16.4,58,143,201
"2012-01-01 13:00:00",1,0,0,1,17.22,82,141,223
"2012-01-01 14:00:00",1,0,0,1,18.04,120,147,267
"2012-01-01 15:00:00",1,0,0,1,18.86,101,164,265
"2012-01-01 16:00:00",1,0,0,2,18.04,68,147,215
"2012-01-01 17:00:00",1,0,0,2,19.68,36,75,111
"2012-01-01 18:00:00",1,0,0,3,18.86,25,81,106
"2012-01-01 19:00:00",1,0,0,3,17.22,20,85,105
"2012-01-01 20:00:00",1,0,0,2,18.04,25,58,83
"2012-01-01 21:00:00",1,0,0,2,18.04,10,61,71
"2012-01-01 22:00:00",1,0,0,1,18.86,13,53,66
"2012-01-01 23:00:00",1,0,0,1,18.04,4,25,29
"2012-01-02 00:00:00",1,1,0,1,16.4,8,31,39
"2012-01-02 01:00:00",1,1,0,1,14.76,1,11,12
"2012-01-02 02:00:00",1,1,0,1,14.76,1,6,7
"2012-01-02 04:00:00",1,1,0,1,11.48,0,4,4
"2012-01-02 05:00:00",1,1,0,1,11.48,1,3,4
"2012-01-02 06:00:00",1,1,0,1,10.66,0,14,14
"2012-01-02 07:00:00",1,1,0,1,9.84,0,16,16
"2012-01-02 08:00:00",1,1,0,1,9.84,2,51,53
"2012-01-02 09:00:00",1,1,0,1,9.84,15,53,68
"2012-01-02 10:00:00",1,1,0,1,10.66,20,89,109
"2012-01-02 11:00:00",1,1,0,1,10.66,33,142,175
"2012-01-02 12:00:00",1,1,0,1,11.48,41,161,202
"2012-01-02 13:00:00",1,1,0,1,12.3,26,150,176
"2012-01-02 14:00:00",1,1,0,1,12.3,10,141,151
"2012-01-02 15:00:00",1,1,0,1,11.48,29,139,168
"2012-01-02 16:00:00",1,1,0,1,10.66,10,144,154
"2012-01-02 17:00:00",1,1,0,1,10.66,17,136,153
"2012-01-02 18:00:00",1,1,0,1,10.66,13,113,126
"2012-01-02 19:00:00",1,1,0,1,9.84,4,89,93
"2012-01-02 20:00:00",1,1,0,1,9.84,5,83,88
"2012-01-02 21:00:00",1,1,0,2,9.84,3,63,66
"2012-01-02 22:00:00",1,1,0,2,9.02,3,36,39
"2012-01-02 23:00:00",1,1,0,1,9.02,2,32,34
"2012-01-03 00:00:00",1,0,1,1,8.2,0,13,13
"2012-01-03 01:00:00",1,0,1,1,7.38,1,5,6
"2012-01-03 02:00:00",1,0,1,1,7.38,0,3,3
"2012-01-03 03:00:00",1,0,1,1,6.56,0,2,2
"2012-01-03 04:00:00",1,0,1,1,6.56,0,5,5
"2012-01-03 05:00:00",1,0,1,1,5.74,0,12,12
"2012-01-03 06:00:00",1,0,1,1,5.74,4,81,85
"2012-01-03 07:00:00",1,0,1,1,5.74,2,168,170
"2012-01-03 08:00:00",1,0,1,1,6.56,5,349,354
"2012-01-03 09:00:00",1,0,1,1,6.56,8,145,153
"2012-01-03 10:00:00",1,0,1,1,6.56,5,55,60
"2012-01-03 11:00:00",1,0,1,1,7.38,12,63,75
"2012-01-03 12:00:00",1,0,1,1,7.38,4,70,74
"2012-01-03 13:00:00",1,0,1,1,7.38,5,68,73
"2012-01-03 14:00:00",1,0,1,1,6.56,7,72,79
"2012-01-03 15:00:00",1,0,1,1,6.56,9,68,77
"2012-01-03 16:00:00",1,0,1,1,5.74,7,129,136
"2012-01-03 17:00:00",1,0,1,1,5.74,4,241,245
"2012-01-03 18:00:00",1,0,1,1,5.74,10,214,224
"2012-01-03 19:00:00",1,0,1,1,4.92,4,152,156
"2012-01-03 20:00:00",1,0,1,1,4.92,0,115,115
"2012-01-03 21:00:00",1,0,1,1,4.1,2,66,68
"2012-01-03 22:00:00",1,0,1,1,4.1,0,33,33
"2012-01-03 23:00:00",1,0,1,1,4.1,0,18,18
"2012-01-04 00:00:00",1,0,1,1,3.28,0,9,9
"2012-01-04 01:00:00",1,0,1,1,1.64,0,3,3
"2012-01-04 02:00:00",1,0,1,1,0.82,0,1,1
"2012-01-04 03:00:00",1,0,1,1,0.82,0,1,1
"2012-01-04 04:00:00",1,0,1,1,0.82,0,2,2
"2012-01-04 05:00:00",1,0,1,1,0.82,0,14,14
"2012-01-04 06:00:00",1,0,1,1,0.82,0,59,59
"2012-01-04 07:00:00",1,0,1,1,0.82,1,151,152
"2012-01-04 08:00:00",1,0,1,1,0.82,5,310,315
"2012-01-04 09:00:00",1,0,1,1,1.64,7,173,180
"2012-01-04 10:00:00",1,0,1,1,2.46,7,57,64
"2012-01-04 11:00:00",1,0,1,2,3.28,6,40,46
"2012-01-04 12:00:00",1,0,1,2,4.1,9,75,84
"2012-01-04 13:00:00",1,0,1,2,5.74,9,82,91
"2012-01-04 14:00:00",1,0,1,2,5.74,6,69,75
"2012-01-04 15:00:00",1,0,1,2,7.38,9,81,90
"2012-01-04 16:00:00",1,0,1,2,7.38,8,123,131
"2012-01-04 17:00:00",1,0,1,2,8.2,9,272,281
"2012-01-04 18:00:00",1,0,1,2,8.2,9,280,289
"2012-01-04 19:00:00",1,0,1,2,8.2,2,182,184
"2012-01-04 20:00:00",1,0,1,2,8.2,2,121,123
"2012-01-04 21:00:00",1,0,1,2,8.2,2,88,90
"2012-01-04 22:00:00",1,0,1,2,8.2,4,48,52
"2012-01-04 23:00:00",1,0,1,2,8.2,0,32,32
"2012-01-05 00:00:00",1,0,1,2,9.02,1,13,14
"2012-01-05 01:00:00",1,0,1,1,8.2,0,5,5
"2012-01-05 02:00:00",1,0,1,1,8.2,0,4,4
"2012-01-05 03:00:00",1,0,1,1,8.2,0,4,4
"2012-01-05 04:00:00",1,0,1,2,8.2,0,5,5
"2012-01-05 05:00:00",1,0,1,2,8.2,0,26,26
"2012-01-05 06:00:00",1,0,1,2,8.2,0,78,78
"2012-01-05 07:00:00",1,0,1,2,8.2,3,212,215
"2012-01-05 08:00:00",1,0,1,2,8.2,11,377,388
"2012-01-05 09:00:00",1,0,1,2,9.02,7,220,227
"2012-01-05 10:00:00",1,0,1,2,9.84,5,81,86
"2012-01-05 11:00:00",1,0,1,1,12.3,6,78,84
"2012-01-05 12:00:00",1,0,1,1,12.3,6,114,120
"2012-01-05 13:00:00",1,0,1,1,13.94,6,112,118
"2012-01-05 14:00:00",1,0,1,1,13.94,13,104,117
"2012-01-05 15:00:00",1,0,1,1,14.76,6,113,119
"2012-01-05 16:00:00",1,0,1,1,14.76,19,178,197
"2012-01-05 17:00:00",1,0,1,2,14.76,19,393,412
"2012-01-05 18:00:00",1,0,1,1,13.94,9,374,383
"2012-01-05 19:00:00",1,0,1,1,13.94,10,255,265
"2012-01-05 20:00:00",1,0,1,1,12.3,5,172,177
"2012-01-05 21:00:00",1,0,1,1,10.66,9,88,97
"2012-01-05 22:00:00",1,0,1,1,10.66,1,70,71
"2012-01-05 23:00:00",1,0,1,1,9.84,4,56,60
"2012-01-06 00:00:00",1,0,1,1,9.02,1,24,25
"2012-01-06 01:00:00",1,0,1,1,9.02,2,6,8
"2012-01-06 02:00:00",1,0,1,1,9.02,2,3,5
"2012-01-06 03:00:00",1,0,1,1,9.02,1,3,4
"2012-01-06 04:00:00",1,0,1,1,9.02,0,3,3
"2012-01-06 05:00:00",1,0,1,2,8.2,0,13,13
"2012-01-06 06:00:00",1,0,1,2,9.02,1,69,70
"2012-01-06 07:00:00",1,0,1,2,9.84,4,201,205
"2012-01-06 08:00:00",1,0,1,1,9.84,11,436,447
"2012-01-06 09:00:00",1,0,1,1,9.84,4,237,241
"2012-01-06 10:00:00",1,0,1,1,10.66,14,102,116
"2012-01-06 11:00:00",1,0,1,1,12.3,8,130,138
"2012-01-06 12:00:00",1,0,1,1,14.76,23,168,191
"2012-01-06 13:00:00",1,0,1,1,16.4,16,188,204
"2012-01-06 14:00:00",1,0,1,1,18.86,26,152,178
"2012-01-06 15:00:00",1,0,1,1,21.32,44,178,222
"2012-01-06 16:00:00",1,0,1,1,21.32,35,259,294
"2012-01-06 17:00:00",1,0,1,1,18.86,20,456,476
"2012-01-06 18:00:00",1,0,1,1,20.5,28,391,419
"2012-01-06 19:00:00",1,0,1,1,18.86,11,261,272
"2012-01-06 20:00:00",1,0,1,1,17.22,14,163,177
"2012-01-06 21:00:00",1,0,1,1,16.4,17,137,154
"2012-01-06 22:00:00",1,0,1,1,14.76,12,123,135
"2012-01-06 23:00:00",1,0,1,1,14.76,13,88,101
"2012-01-07 00:00:00",1,0,0,1,14.76,2,77,79
"2012-01-07 01:00:00",1,0,0,1,15.58,6,56,62
"2012-01-07 02:00:00",1,0,0,1,14.76,2,36,38
"2012-01-07 03:00:00",1,0,0,1,13.12,1,19,20
"2012-01-07 04:00:00",1,0,0,1,13.12,1,9,10
"2012-01-07 05:00:00",1,0,0,1,10.66,2,7,9
"2012-01-07 06:00:00",1,0,0,1,10.66,0,7,7
"2012-01-07 07:00:00",1,0,0,1,9.02,0,20,20
"2012-01-07 08:00:00",1,0,0,1,9.84,0,64,64
"2012-01-07 09:00:00",1,0,0,1,9.02,14,116,130
"2012-01-07 10:00:00",1,0,0,1,11.48,43,160,203
"2012-01-07 11:00:00",1,0,0,1,13.94,74,250,324
"2012-01-07 12:00:00",1,0,0,1,16.4,100,276,376
"2012-01-07 13:00:00",1,0,0,1,18.04,149,296,445
"2012-01-07 14:00:00",1,0,0,1,20.5,156,356,512
"2012-01-07 15:00:00",1,0,0,1,23.78,132,317,449
"2012-01-07 16:00:00",1,0,0,2,22.96,133,268,401
"2012-01-07 17:00:00",1,0,0,2,22.14,87,235,322
"2012-01-07 18:00:00",1,0,0,1,22.14,49,248,297
"2012-01-07 19:00:00",1,0,0,1,21.32,44,171,215
"2012-01-07 20:00:00",1,0,0,1,20.5,21,149,170
"2012-01-07 21:00:00",1,0,0,1,18.04,22,118,140
"2012-01-07 22:00:00",1,0,0,1,18.04,16,93,109
"2012-01-07 23:00:00",1,0,0,1,17.22,16,103,119
"2012-01-08 00:00:00",1,0,0,1,15.58,14,77,91
"2012-01-08 01:00:00",1,0,0,1,13.94,10,62,72
"2012-01-08 02:00:00",1,0,0,1,14.76,10,57,67
"2012-01-08 03:00:00",1,0,0,1,13.94,6,26,32
"2012-01-08 04:00:00",1,0,0,1,13.12,2,4,6
"2012-01-08 05:00:00",1,0,0,2,13.12,0,2,2
"2012-01-08 06:00:00",1,0,0,2,12.3,0,2,2
"2012-01-08 07:00:00",1,0,0,2,12.3,1,23,24
"2012-01-08 08:00:00",1,0,0,1,12.3,4,53,57
"2012-01-08 09:00:00",1,0,0,1,13.12,23,102,125
"2012-01-08 10:00:00",1,0,0,1,13.94,27,181,208
"2012-01-08 11:00:00",1,0,0,1,14.76,55,201,256
"2012-01-08 12:00:00",1,0,0,1,15.58,78,273,351
"2012-01-08 13:00:00",1,0,0,1,16.4,77,266,343
"2012-01-08 14:00:00",1,0,0,1,16.4,75,253,328
"2012-01-08 15:00:00",1,0,0,1,16.4,89,241,330
"2012-01-08 16:00:00",1,0,0,1,16.4,58,256,314
"2012-01-08 17:00:00",1,0,0,1,15.58,22,197,219
"2012-01-08 18:00:00",1,0,0,1,13.94,19,162,181
"2012-01-08 19:00:00",1,0,0,1,13.12,8,104,112
"2012-01-08 20:00:00",1,0,0,1,12.3,7,119,126
"2012-01-08 21:00:00",1,0,0,1,11.48,10,81,91
"2012-01-08 22:00:00",1,0,0,1,10.66,4,54,58
"2012-01-08 23:00:00",1,0,0,1,10.66,0,30,30
"2012-01-09 00:00:00",1,0,1,1,9.84,3,12,15
"2012-01-09 01:00:00",1,0,1,1,9.84,1,4,5
"2012-01-09 02:00:00",1,0,1,1,9.84,2,3,5
"2012-01-09 03:00:00",1,0,1,1,9.84,0,3,3
"2012-01-09 04:00:00",1,0,1,1,9.02,0,4,4
"2012-01-09 05:00:00",1,0,1,2,8.2,0,21,21
"2012-01-09 06:00:00",1,0,1,2,9.02,3,85,88
"2012-01-09 07:00:00",1,0,1,2,9.02,1,239,240
"2012-01-09 08:00:00",1,0,1,2,9.02,13,407,420
"2012-01-09 09:00:00",1,0,1,2,9.02,9,188,197
"2012-01-09 10:00:00",1,0,1,1,9.84,13,95,108
"2012-01-09 11:00:00",1,0,1,2,10.66,6,82,88
"2012-01-09 12:00:00",1,0,1,2,10.66,10,93,103
"2012-01-09 13:00:00",1,0,1,2,10.66,3,77,80
"2012-01-09 14:00:00",1,0,1,3,9.02,5,45,50
"2012-01-09 15:00:00",1,0,1,3,9.02,5,64,69
"2012-01-09 16:00:00",1,0,1,3,9.02,3,46,49
"2012-01-09 17:00:00",1,0,1,3,9.02,5,147,152
"2012-01-09 18:00:00",1,0,1,4,8.2,6,158,164
"2012-01-09 19:00:00",1,0,1,3,8.2,3,187,190
"2012-01-09 20:00:00",1,0,1,2,8.2,5,127,132
"2012-01-09 21:00:00",1,0,1,2,8.2,1,78,79
"2012-01-09 22:00:00",1,0,1,2,8.2,8,54,62
"2012-01-09 23:00:00",1,0,1,2,9.02,1,51,52
"2012-01-10 00:00:00",1,0,1,2,9.02,0,14,14
"2012-01-10 01:00:00",1,0,1,2,9.02,2,3,5
"2012-01-10 02:00:00",1,0,1,2,9.02,2,2,4
"2012-01-10 04:00:00",1,0,1,2,8.2,0,4,4
"2012-01-10 05:00:00",1,0,1,1,16.4,0,23,23
"2012-01-10 06:00:00",1,0,1,2,7.38,0,79,79
"2012-01-10 07:00:00",1,0,1,2,7.38,3,219,222
"2012-01-10 08:00:00",1,0,1,2,7.38,6,465,471
"2012-01-10 09:00:00",1,0,1,2,7.38,11,184,195
"2012-01-10 10:00:00",1,0,1,2,7.38,3,80,83
"2012-01-10 11:00:00",1,0,1,1,17.22,8,93,101
"2012-01-10 12:00:00",1,0,1,1,17.22,13,127,140
"2012-01-10 13:00:00",1,0,1,1,17.22,15,163,178
"2012-01-10 14:00:00",1,0,1,1,17.22,10,96,106
"2012-01-10 15:00:00",1,0,1,1,17.22,17,119,136
"2012-01-10 16:00:00",1,0,1,1,17.22,15,225,240
"2012-01-10 17:00:00",1,0,1,1,17.22,14,446,460
"2012-01-10 18:00:00",1,0,1,1,16.4,13,372,385
"2012-01-10 19:00:00",1,0,1,1,15.58,11,270,281
"2012-01-10 20:00:00",1,0,1,1,13.94,10,190,200
"2012-01-10 21:00:00",1,0,1,1,13.12,7,109,116
"2012-01-10 22:00:00",1,0,1,1,12.3,10,104,114
"2012-01-10 23:00:00",1,0,1,1,10.66,3,38,41
"2012-01-11 00:00:00",1,0,1,1,10.66,2,26,28
"2012-01-11 01:00:00",1,0,1,1,9.84,1,6,7
"2012-01-11 02:00:00",1,0,1,1,8.2,0,5,5
"2012-01-11 03:00:00",1,0,1,1,9.02,0,4,4
"2012-01-11 04:00:00",1,0,1,1,8.2,0,2,2
"2012-01-11 05:00:00",1,0,1,1,8.2,0,22,22
"2012-01-11 06:00:00",1,0,1,1,8.2,2,72,74
"2012-01-11 07:00:00",1,0,1,1,8.2,9,247,256
"2012-01-11 08:00:00",1,0,1,1,8.2,11,488,499
"2012-01-11 09:00:00",1,0,1,2,8.2,7,218,225
"2012-01-11 10:00:00",1,0,1,2,9.84,13,84,97
"2012-01-11 11:00:00",1,0,1,2,10.66,9,90,99
"2012-01-11 12:00:00",1,0,1,3,12.3,4,51,55
"2012-01-11 13:00:00",1,0,1,3,13.12,8,57,65
"2012-01-11 14:00:00",1,0,1,3,13.12,3,70,73
"2012-01-11 15:00:00",1,0,1,2,13.94,6,73,79
"2012-01-11 16:00:00",1,0,1,2,13.94,6,112,118
"2012-01-11 17:00:00",1,0,1,3,13.94,6,128,134
"2012-01-11 18:00:00",1,0,1,3,13.94,2,96,98
"2012-01-11 19:00:00",1,0,1,3,13.12,1,92,93
"2012-01-11 20:00:00",1,0,1,3,13.12,2,55,57
"2012-01-11 21:00:00",1,0,1,3,13.94,0,29,29
"2012-01-11 22:00:00",1,0,1,3,13.94,0,49,49
"2012-01-11 23:00:00",1,0,1,3,13.94,0,9,9
"2012-01-12 00:00:00",1,0,1,3,13.94,0,3,3
"2012-01-12 01:00:00",1,0,1,3,14.76,0,3,3
"2012-01-12 02:00:00",1,0,1,3,14.76,1,1,2
"2012-01-12 03:00:00",1,0,1,3,14.76,0,3,3
"2012-01-12 04:00:00",1,0,1,3,14.76,0,2,2
"2012-01-12 05:00:00",1,0,1,3,13.94,0,16,16
"2012-01-12 06:00:00",1,0,1,3,14.76,1,88,89
"2012-01-12 07:00:00",1,0,1,2,13.94,2,218,220
"2012-01-12 08:00:00",1,0,1,1,13.12,11,497,508
"2012-01-12 09:00:00",1,0,1,1,13.12,10,220,230
"2012-01-12 10:00:00",1,0,1,1,13.94,6,84,90
"2012-01-12 11:00:00",1,0,1,2,13.94,18,101,119
"2012-01-12 12:00:00",1,0,1,2,13.94,14,130,144
"2012-01-12 13:00:00",1,0,1,1,17.22,13,170,183
"2012-01-12 14:00:00",1,0,1,1,17.22,24,132,156
"2012-01-12 15:00:00",1,0,1,1,18.04,32,156,188
"2012-01-12 16:00:00",1,0,1,1,18.86,33,248,281
"2012-01-12 17:00:00",1,0,1,1,18.86,23,472,495
"2012-01-12 18:00:00",1,0,1,1,18.04,22,399,421
"2012-01-12 19:00:00",1,0,1,2,17.22,17,313,330
"2012-01-12 20:00:00",1,0,1,2,17.22,11,229,240
"2012-01-12 21:00:00",1,0,1,1,18.04,12,162,174
"2012-01-12 22:00:00",1,0,1,1,15.58,12,121,133
"2012-01-12 23:00:00",1,0,1,1,16.4,7,60,67
"2012-01-13 00:00:00",1,0,1,2,16.4,4,38,42
"2012-01-13 01:00:00",1,0,1,2,15.58,0,12,12
"2012-01-13 02:00:00",1,0,1,1,16.4,1,13,14
"2012-01-13 03:00:00",1,0,1,1,14.76,3,4,7
"2012-01-13 04:00:00",1,0,1,3,13.12,1,2,3
"2012-01-13 05:00:00",1,0,1,2,12.3,0,21,21
"2012-01-13 06:00:00",1,0,1,2,10.66,2,71,73
"2012-01-13 07:00:00",1,0,1,1,10.66,3,174,177
"2012-01-13 08:00:00",1,0,1,1,9.84,11,408,419
"2012-01-13 09:00:00",1,0,1,1,9.02,10,204,214
"2012-01-13 10:00:00",1,0,1,1,9.84,2,101,103
"2012-01-13 11:00:00",1,0,1,1,9.84,12,102,114
"2012-01-13 12:00:00",1,0,1,1,9.84,14,140,154
"2012-01-13 13:00:00",1,0,1,1,10.66,14,140,154
"2012-01-13 14:00:00",1,0,1,1,10.66,10,119,129
"2012-01-13 15:00:00",1,0,1,1,10.66,15,123,138
"2012-01-13 16:00:00",1,0,1,1,11.48,18,215,233
"2012-01-13 17:00:00",1,0,1,1,11.48,15,317,332
"2012-01-13 18:00:00",1,0,1,1,10.66,7,294,301
"2012-01-13 19:00:00",1,0,1,1,10.66,7,199,206
"2012-01-13 20:00:00",1,0,1,1,9.84,6,130,136
"2012-01-13 21:00:00",1,0,1,1,9.84,7,95,102
"2012-01-13 22:00:00",1,0,1,1,8.2,7,58,65
"2012-01-13 23:00:00",1,0,1,1,7.38,5,60,65
"2012-01-14 00:00:00",1,0,0,1,6.56,2,42,44
"2012-01-14 01:00:00",1,0,0,1,6.56,6,44,50
"2012-01-14 02:00:00",1,0,0,1,6.56,6,32,38
"2012-01-14 03:00:00",1,0,0,1,5.74,6,14,20
"2012-01-14 04:00:00",1,0,0,1,5.74,0,3,3
"2012-01-14 05:00:00",1,0,0,1,5.74,0,4,4
"2012-01-14 06:00:00",1,0,0,1,5.74,0,5,5
"2012-01-14 07:00:00",1,0,0,1,5.74,0,24,24
"2012-01-14 08:00:00",1,0,0,1,4.92,3,89,92
"2012-01-14 09:00:00",1,0,0,1,5.74,3,78,81
"2012-01-14 10:00:00",1,0,0,1,6.56,14,135,149
"2012-01-14 11:00:00",1,0,0,1,8.2,28,150,178
"2012-01-14 12:00:00",1,0,0,1,9.02,30,189,219
"2012-01-14 13:00:00",1,0,0,1,9.02,38,182,220
"2012-01-14 14:00:00",1,0,0,1,9.84,52,179,231
"2012-01-14 15:00:00",1,0,0,1,9.84,49,177,226
"2012-01-14 16:00:00",1,0,0,1,9.84,28,178,206
"2012-01-14 17:00:00",1,0,0,1,9.84,15,129,144
"2012-01-14 18:00:00",1,0,0,1,9.02,21,122,143
"2012-01-14 19:00:00",1,0,0,1,8.2,12,90,102
"2012-01-14 20:00:00",1,0,0,1,8.2,8,95,103
"2012-01-14 21:00:00",1,0,0,1,7.38,3,66,69
"2012-01-14 22:00:00",1,0,0,1,6.56,4,62,66
"2012-01-14 23:00:00",1,0,0,1,6.56,5,71,76
"2012-01-15 00:00:00",1,0,0,1,6.56,9,50,59
"2012-01-15 01:00:00",1,0,0,2,6.56,2,40,42
"2012-01-15 02:00:00",1,0,0,2,6.56,5,38,43
"2012-01-15 03:00:00",1,0,0,2,6.56,1,24,25
"2012-01-15 04:00:00",1,0,0,2,6.56,1,5,6
"2012-01-15 05:00:00",1,0,0,2,6.56,0,5,5
"2012-01-15 06:00:00",1,0,0,2,5.74,1,7,8
"2012-01-15 07:00:00",1,0,0,1,4.92,3,14,17
"2012-01-15 08:00:00",1,0,0,1,4.92,2,34,36
"2012-01-15 09:00:00",1,0,0,1,4.92,10,80,90
"2012-01-15 10:00:00",1,0,0,1,5.74,11,115,126
"2012-01-15 11:00:00",1,0,0,1,6.56,21,144,165
"2012-01-15 12:00:00",1,0,0,1,7.38,42,192,234
"2012-01-15 13:00:00",1,0,0,1,8.2,40,184,224
"2012-01-15 14:00:00",1,0,0,1,8.2,25,163,188
"2012-01-15 15:00:00",1,0,0,1,9.02,33,173,206
"2012-01-15 16:00:00",1,0,0,1,9.02,31,174,205
"2012-01-15 17:00:00",1,0,0,1,9.02,15,131,146
"2012-01-15 18:00:00",1,0,0,1,7.38,7,113,120
"2012-01-15 19:00:00",1,0,0,1,6.56,9,101,110
"2012-01-15 20:00:00",1,0,0,1,6.56,10,85,95
"2012-01-15 21:00:00",1,0,0,1,6.56,1,71,72
"2012-01-15 22:00:00",1,0,0,1,7.38,2,58,60
"2012-01-15 23:00:00",1,0,0,1,6.56,3,26,29
"2012-01-16 00:00:00",1,1,0,1,5.74,2,23,25
"2012-01-16 01:00:00",1,1,0,1,5.74,2,18,20
"2012-01-16 02:00:00",1,1,0,1,5.74,3,14,17
"2012-01-16 03:00:00",1,1,0,1,4.92,0,3,3
"2012-01-16 04:00:00",1,1,0,1,4.92,2,6,8
"2012-01-16 05:00:00",1,1,0,1,4.92,1,5,6
"2012-01-16 06:00:00",1,1,0,1,4.1,0,13,13
"2012-01-16 07:00:00",1,1,0,1,4.1,5,28,33
"2012-01-16 08:00:00",1,1,0,1,4.1,3,75,78
"2012-01-16 09:00:00",1,1,0,1,4.1,7,89,96
"2012-01-16 10:00:00",1,1,0,2,5.74,19,107,126
"2012-01-16 11:00:00",1,1,0,1,6.56,21,158,179
"2012-01-16 12:00:00",1,1,0,1,8.2,20,165,185
"2012-01-16 13:00:00",1,1,0,2,9.84,26,202,228
"2012-01-16 14:00:00",1,1,0,1,9.84,23,158,181
"2012-01-16 15:00:00",1,1,0,1,10.66,17,175,192
"2012-01-16 16:00:00",1,1,0,1,10.66,22,158,180
"2012-01-16 17:00:00",1,1,0,1,10.66,19,174,193
"2012-01-16 18:00:00",1,1,0,1,10.66,6,175,181
"2012-01-16 19:00:00",1,1,0,1,10.66,10,134,144
"2012-01-16 20:00:00",1,1,0,1,10.66,2,88,90
"2012-01-16 21:00:00",1,1,0,1,11.48,3,46,49
"2012-01-16 22:00:00",1,1,0,2,12.3,4,39,43
"2012-01-16 23:00:00",1,1,0,3,10.66,0,28,28
"2012-01-17 00:00:00",1,0,1,2,10.66,0,12,12
"2012-01-17 01:00:00",1,0,1,2,11.48,0,2,2
"2012-01-17 02:00:00",1,0,1,3,11.48,0,12,12
"2012-01-17 04:00:00",1,0,1,3,13.12,0,2,2
"2012-01-17 05:00:00",1,0,1,3,13.12,0,13,13
"2012-01-17 06:00:00",1,0,1,3,12.3,0,57,57
"2012-01-17 07:00:00",1,0,1,3,12.3,5,121,126
"2012-01-17 08:00:00",1,0,1,3,12.3,3,90,93
"2012-01-17 09:00:00",1,0,1,3,13.12,7,61,68
"2012-01-17 10:00:00",1,0,1,3,12.3,1,61,62
"2012-01-17 11:00:00",1,0,1,2,13.94,2,73,75
"2012-01-17 12:00:00",1,0,1,2,13.12,3,83,86
"2012-01-17 13:00:00",1,0,1,2,15.58,8,95,103
"2012-01-17 14:00:00",1,0,1,1,18.04,12,120,132
"2012-01-17 15:00:00",1,0,1,1,18.04,6,123,129
"2012-01-17 16:00:00",1,0,1,1,18.86,14,205,219
"2012-01-17 17:00:00",1,0,1,1,18.86,20,442,462
"2012-01-17 18:00:00",1,0,1,1,18.86,12,451,463
"2012-01-17 19:00:00",1,0,1,1,18.86,11,297,308
"2012-01-17 20:00:00",1,0,1,1,18.86,11,169,180
"2012-01-17 21:00:00",1,0,1,1,18.86,6,174,180
"2012-01-17 22:00:00",1,0,1,1,18.86,5,85,90
"2012-01-17 23:00:00",1,0,1,1,18.86,1,60,61
"2012-01-18 00:00:00",1,0,1,2,18.86,3,14,17
"2012-01-18 01:00:00",1,0,1,2,18.86,0,10,10
"2012-01-18 02:00:00",1,0,1,2,18.04,1,1,2
"2012-01-18 03:00:00",1,0,1,2,18.04,1,3,4
"2012-01-18 04:00:00",1,0,1,1,13.94,0,1,1
"2012-01-18 05:00:00",1,0,1,1,13.94,0,29,29
"2012-01-18 06:00:00",1,0,1,1,13.94,0,88,88
"2012-01-18 07:00:00",1,0,1,1,13.12,1,262,263
"2012-01-18 08:00:00",1,0,1,1,12.3,15,474,489
"2012-01-18 09:00:00",1,0,1,1,11.48,6,196,202
"2012-01-18 10:00:00",1,0,1,1,12.3,5,88,93
"2012-01-18 11:00:00",1,0,1,1,12.3,4,110,114
"2012-01-18 12:00:00",1,0,1,1,12.3,6,155,161
"2012-01-18 13:00:00",1,0,1,1,12.3,6,124,130
"2012-01-18 14:00:00",1,0,1,1,12.3,7,98,105
"2012-01-18 15:00:00",1,0,1,1,12.3,8,122,130
"2012-01-18 16:00:00",1,0,1,1,11.48,13,163,176
"2012-01-18 17:00:00",1,0,1,1,10.66,8,338,346
"2012-01-18 18:00:00",1,0,1,1,9.84,8,347,355
"2012-01-18 19:00:00",1,0,1,1,9.02,5,251,256
"2012-01-18 20:00:00",1,0,1,1,9.02,1,164,165
"2012-01-18 21:00:00",1,0,1,1,8.2,5,119,124
"2012-01-18 22:00:00",1,0,1,1,7.38,4,74,78
"2012-01-18 23:00:00",1,0,1,1,6.56,2,36,38
"2012-01-19 00:00:00",1,0,1,1,5.74,0,16,16
"2012-01-19 01:00:00",1,0,1,1,5.74,0,5,5
"2012-01-19 02:00:00",1,0,1,1,5.74,0,3,3
"2012-01-19 03:00:00",1,0,1,1,4.92,0,4,4
"2012-01-19 04:00:00",1,0,1,1,4.92,0,1,1
"2012-01-19 05:00:00",1,0,1,1,4.92,0,19,19
"2012-01-19 06:00:00",1,0,1,1,4.92,0,86,86
"2012-01-19 07:00:00",1,0,1,1,4.92,2,204,206
"2012-01-19 08:00:00",1,0,1,1,4.92,9,414,423
"2012-01-19 09:00:00",1,0,1,1,4.92,6,204,210
"2012-01-19 10:00:00",1,0,1,1,5.74,10,98,108
"2012-01-19 11:00:00",1,0,1,1,6.56,6,93,99
"2012-01-19 12:00:00",1,0,1,1,8.2,5,106,111
"2012-01-19 13:00:00",1,0,1,1,9.02,6,118,124
"2012-01-19 14:00:00",1,0,1,1,9.84,15,104,119
"2012-01-19 15:00:00",1,0,1,1,10.66,9,118,127
"2012-01-19 16:00:00",1,0,1,1,10.66,8,185,193
"2012-01-19 17:00:00",1,0,1,2,10.66,21,364,385
"2012-01-19 18:00:00",1,0,1,2,10.66,16,345,361
"2012-01-19 19:00:00",1,0,1,2,10.66,5,229,234
"2012-01-19 20:00:00",1,0,1,1,10.66,7,184,191
"2012-01-19 21:00:00",1,0,1,1,10.66,4,117,121
"2012-01-19 22:00:00",1,0,1,2,10.66,0,90,90
"2012-01-19 23:00:00",1,0,1,1,10.66,1,55,56
"2012-02-01 00:00:00",1,0,1,1,18.04,0,31,31
"2012-02-01 01:00:00",1,0,1,1,18.04,0,4,4
"2012-02-01 02:00:00",1,0,1,1,18.04,1,6,7
"2012-02-01 03:00:00",1,0,1,1,18.04,0,3,3
"2012-02-01 04:00:00",1,0,1,1,16.4,0,1,1
"2012-02-01 05:00:00",1,0,1,1,16.4,0,18,18
"2012-02-01 06:00:00",1,0,1,3,16.4,0,67,67
"2012-02-01 07:00:00",1,0,1,3,15.58,7,201,208
"2012-02-01 08:00:00",1,0,1,3,14.76,15,505,520
"2012-02-01 09:00:00",1,0,1,2,14.76,9,267,276
"2012-02-01 10:00:00",1,0,1,1,16.4,9,124,133
"2012-02-01 11:00:00",1,0,1,1,16.4,27,116,143
"2012-02-01 12:00:00",1,0,1,1,18.04,26,153,179
"2012-02-01 13:00:00",1,0,1,1,18.86,12,174,186
"2012-02-01 14:00:00",1,0,1,1,25.42,33,159,192
"2012-02-01 15:00:00",1,0,1,1,24.6,25,169,194
"2012-02-01 16:00:00",1,0,1,1,24.6,22,261,283
"2012-02-01 17:00:00",1,0,1,1,23.78,31,508,539
"2012-02-01 18:00:00",1,0,1,1,22.96,12,514,526
"2012-02-01 19:00:00",1,0,1,1,22.14,20,315,335
"2012-02-01 20:00:00",1,0,1,1,21.32,10,254,264
"2012-02-01 21:00:00",1,0,1,1,21.32,16,217,233
"2012-02-01 22:00:00",1,0,1,1,20.5,7,133,140
"2012-02-01 23:00:00",1,0,1,1,18.86,22,75,97
"2012-02-02 00:00:00",1,0,1,1,18.86,7,24,31
"2012-02-02 01:00:00",1,0,1,2,18.86,3,14,17
"2012-02-02 02:00:00",1,0,1,2,17.22,2,7,9
"2012-02-02 03:00:00",1,0,1,2,17.22,0,2,2
"2012-02-02 04:00:00",1,0,1,3,16.4,0,1,1
"2012-02-02 05:00:00",1,0,1,3,16.4,0,19,19
"2012-02-02 06:00:00",1,0,1,3,14.76,1,73,74
"2012-02-02 07:00:00",1,0,1,3,14.76,4,201,205
"2012-02-02 08:00:00",1,0,1,3,16.4,9,436,445
"2012-02-02 09:00:00",1,0,1,3,15.58,15,213,228
"2012-02-02 10:00:00",1,0,1,3,17.22,6,72,78
"2012-02-02 11:00:00",1,0,1,3,16.4,6,99,105
"2012-02-02 12:00:00",1,0,1,1,17.22,8,140,148
"2012-02-02 13:00:00",1,0,1,2,17.22,13,124,137
"2012-02-02 14:00:00",1,0,1,1,16.4,12,129,141
"2012-02-02 15:00:00",1,0,1,1,18.86,24,150,174
"2012-02-02 16:00:00",1,0,1,1,18.86,18,211,229
"2012-02-02 17:00:00",1,0,1,1,17.22,13,437,450
"2012-02-02 18:00:00",1,0,1,1,16.4,17,393,410
"2012-02-02 19:00:00",1,0,1,1,15.58,16,311,327
"2012-02-02 20:00:00",1,0,1,1,14.76,9,204,213
"2012-02-02 21:00:00",1,0,1,1,13.94,4,144,148
"2012-02-02 22:00:00",1,0,1,1,13.12,3,106,109
"2012-02-02 23:00:00",1,0,1,1,13.12,0,61,61
"2012-02-03 00:00:00",1,0,1,1,13.12,1,37,38
"2012-02-03 01:00:00",1,0,1,1,12.3,3,19,22
"2012-02-03 02:00:00",1,0,1,1,12.3,0,6,6
"2012-02-03 03:00:00",1,0,1,1,11.48,0,4,4
"2012-02-03 04:00:00",1,0,1,1,10.66,0,2,2
"2012-02-03 05:00:00",1,0,1,1,10.66,0,17,17
"2012-02-03 06:00:00",1,0,1,1,9.84,0,88,88
"2012-02-03 07:00:00",1,0,1,1,9.84,10,216,226
"2012-02-03 08:00:00",1,0,1,1,9.84,12,429,441
"2012-02-03 09:00:00",1,0,1,1,9.84,18,252,270
"2012-02-03 10:00:00",1,0,1,1,11.48,15,114,129
"2012-02-03 11:00:00",1,0,1,1,13.12,15,149,164
"2012-02-03 12:00:00",1,0,1,1,13.94,25,191,216
"2012-02-03 13:00:00",1,0,1,1,14.76,25,173,198
"2012-02-03 14:00:00",1,0,1,1,14.76,22,148,170
"2012-02-03 15:00:00",1,0,1,1,15.58,48,168,216
"2012-02-03 16:00:00",1,0,1,1,16.4,36,275,311
"2012-02-03 17:00:00",1,0,1,1,16.4,30,458,488
"2012-02-03 18:00:00",1,0,1,1,15.58,17,368,385
"2012-02-03 19:00:00",1,0,1,1,13.94,11,256,267
"2012-02-03 20:00:00",1,0,1,1,13.94,8,155,163
"2012-02-03 21:00:00",1,0,1,1,13.94,8,126,134
"2012-02-03 22:00:00",1,0,1,1,13.94,3,116,119
"2012-02-03 23:00:00",1,0,1,1,10.66,3,74,77
"2012-02-04 00:00:00",1,0,0,1,10.66,10,76,86
"2012-02-04 01:00:00",1,0,0,1,10.66,0,43,43
"2012-02-04 02:00:00",1,0,0,1,9.84,6,38,44
"2012-02-04 03:00:00",1,0,0,1,9.84,1,17,18
"2012-02-04 04:00:00",1,0,0,1,9.84,1,5,6
"2012-02-04 05:00:00",1,0,0,1,9.84,1,3,4
"2012-02-04 06:00:00",1,0,0,1,9.02,1,4,5
"2012-02-04 07:00:00",1,0,0,2,9.84,1,27,28
"2012-02-04 08:00:00",1,0,0,1,9.84,4,86,90
"2012-02-04 09:00:00",1,0,0,1,9.84,16,141,157
"2012-02-04 10:00:00",1,0,0,1,9.84,31,193,224
"2012-02-04 11:00:00",1,0,0,1,12.3,46,224,270
"2012-02-04 12:00:00",1,0,0,2,12.3,40,260,300
"2012-02-04 13:00:00",1,0,0,2,12.3,58,244,302
"2012-02-04 14:00:00",1,0,0,2,13.12,47,229,276
"2012-02-04 15:00:00",1,0,0,2,13.12,61,244,305
"2012-02-04 16:00:00",1,0,0,2,13.94,20,123,143
"2012-02-04 17:00:00",1,0,0,3,12.3,13,54,67
"2012-02-04 18:00:00",1,0,0,3,11.48,6,58,64
"2012-02-04 19:00:00",1,0,0,3,10.66,5,75,80
"2012-02-04 20:00:00",1,0,0,3,9.84,4,73,77
"2012-02-04 21:00:00",1,0,0,3,9.84,4,74,78
"2012-02-04 22:00:00",1,0,0,2,9.84,4,91,95
"2012-02-04 23:00:00",1,0,0,2,9.84,4,66,70
"2012-02-05 00:00:00",1,0,0,2,9.84,3,58,61
"2012-02-05 01:00:00",1,0,0,2,9.84,5,46,51
"2012-02-05 02:00:00",1,0,0,2,9.84,4,59,63
"2012-02-05 03:00:00",1,0,0,3,9.84,4,13,17
"2012-02-05 04:00:00",1,0,0,2,9.84,0,9,9
"2012-02-05 05:00:00",1,0,0,3,10.66,0,4,4
"2012-02-05 06:00:00",1,0,0,2,10.66,0,4,4
"2012-02-05 07:00:00",1,0,0,2,9.84,0,16,16
"2012-02-05 08:00:00",1,0,0,2,9.84,4,58,62
"2012-02-05 09:00:00",1,0,0,2,9.84,9,83,92
"2012-02-05 10:00:00",1,0,0,2,10.66,10,138,148
"2012-02-05 11:00:00",1,0,0,2,10.66,22,160,182
"2012-02-05 12:00:00",1,0,0,2,10.66,25,223,248
"2012-02-05 13:00:00",1,0,0,2,11.48,33,241,274
"2012-02-05 14:00:00",1,0,0,1,12.3,40,203,243
"2012-02-05 15:00:00",1,0,0,2,12.3,55,217,272
"2012-02-05 16:00:00",1,0,0,1,12.3,35,261,296
"2012-02-05 17:00:00",1,0,0,1,13.12,31,275,306
"2012-02-05 18:00:00",1,0,0,1,12.3,10,171,181
"2012-02-05 19:00:00",1,0,0,1,12.3,6,63,69
"2012-02-05 20:00:00",1,0,0,1,11.48,3,47,50
"2012-02-05 21:00:00",1,0,0,1,11.48,6,60,66
"2012-02-05 22:00:00",1,0,0,1,10.66,9,182,191
"2012-02-05 23:00:00",1,0,0,1,9.84,4,38,42
"2012-02-06 00:00:00",1,0,1,1,9.84,7,14,21
"2012-02-06 01:00:00",1,0,1,1,9.02,0,6,6
"2012-02-06 02:00:00",1,0,1,1,9.02,0,3,3
"2012-02-06 04:00:00",1,0,1,1,7.38,0,2,2
"2012-02-06 05:00:00",1,0,1,1,7.38,0,17,17
"2012-02-06 06:00:00",1,0,1,1,6.56,0,72,72
"2012-02-06 07:00:00",1,0,1,1,6.56,5,229,234
"2012-02-06 08:00:00",1,0,1,1,6.56,10,434,444
"2012-02-06 09:00:00",1,0,1,1,7.38,8,269,277
"2012-02-06 10:00:00",1,0,1,1,9.02,20,96,116
"2012-02-06 11:00:00",1,0,1,1,10.66,12,104,116
"2012-02-06 12:00:00",1,0,1,1,13.12,19,131,150
"2012-02-06 13:00:00",1,0,1,1,15.58,17,124,141
"2012-02-06 14:00:00",1,0,1,1,16.4,14,126,140
"2012-02-06 15:00:00",1,0,1,1,17.22,25,146,171
"2012-02-06 16:00:00",1,0,1,1,16.4,13,215,228
"2012-02-06 17:00:00",1,0,1,1,16.4,13,417,430
"2012-02-06 18:00:00",1,0,1,1,15.58,11,426,437
"2012-02-06 19:00:00",1,0,1,1,14.76,7,284,291
"2012-02-06 20:00:00",1,0,1,1,13.94,7,194,201
"2012-02-06 21:00:00",1,0,1,1,13.12,11,143,154
"2012-02-06 22:00:00",1,0,1,1,12.3,4,83,87
"2012-02-06 23:00:00",1,0,1,1,12.3,3,43,46
"2012-02-07 00:00:00",1,0,1,1,12.3,1,22,23
"2012-02-07 01:00:00",1,0,1,1,11.48,8,6,14
"2012-02-07 02:00:00",1,0,1,1,12.3,0,4,4
"2012-02-07 03:00:00",1,0,1,2,12.3,1,1,2
"2012-02-07 04:00:00",1,0,1,2,12.3,0,3,3
"2012-02-07 05:00:00",1,0,1,1,13.12,0,15,15
"2012-02-07 06:00:00",1,0,1,1,13.12,2,98,100
"2012-02-07 07:00:00",1,0,1,1,13.12,6,293,299
"2012-02-07 08:00:00",1,0,1,1,12.3,7,522,529
"2012-02-07 09:00:00",1,0,1,1,13.12,11,278,289
"2012-02-07 10:00:00",1,0,1,1,13.94,12,104,116
"2012-02-07 11:00:00",1,0,1,1,14.76,9,120,129
"2012-02-07 12:00:00",1,0,1,1,16.4,9,163,172
"2012-02-07 13:00:00",1,0,1,1,18.04,15,169,184
"2012-02-07 14:00:00",1,0,1,1,18.04,11,127,138
"2012-02-07 15:00:00",1,0,1,1,18.04,13,133,146
"2012-02-07 16:00:00",1,0,1,1,18.04,19,257,276
"2012-02-07 17:00:00",1,0,1,1,18.04,15,494,509
"2012-02-07 18:00:00",1,0,1,1,17.22,10,508,518
"2012-02-07 19:00:00",1,0,1,1,15.58,11,327,338
"2012-02-07 20:00:00",1,0,1,1,14.76,6,206,212
"2012-02-07 21:00:00",1,0,1,1,13.94,20,170,190
"2012-02-07 22:00:00",1,0,1,1,13.12,11,107,118
"2012-02-07 23:00:00",1,0,1,1,13.12,2,49,51
"2012-02-08 00:00:00",1,0,1,1,12.3,2,21,23
"2012-02-08 01:00:00",1,0,1,1,11.48,1,9,10
"2012-02-08 02:00:00",1,0,1,1,10.66,0,1,1
"2012-02-08 03:00:00",1,0,1,1,10.66,0,1,1
"2012-02-08 04:00:00",1,0,1,1,9.84,0,1,1
"2012-02-08 05:00:00",1,0,1,1,9.84,0,20,20
"2012-02-08 06:00:00",1,0,1,2,9.84,3,95,98
"2012-02-08 07:00:00",1,0,1,2,9.84,5,276,281
"2012-02-08 08:00:00",1,0,1,2,9.84,13,495,508
"2012-02-08 09:00:00",1,0,1,2,9.84,8,245,253
"2012-02-08 10:00:00",1,0,1,2,10.66,1,107,108
"2012-02-08 11:00:00",1,0,1,2,10.66,5,97,102
"2012-02-08 12:00:00",1,0,1,2,11.48,14,124,138
"2012-02-08 13:00:00",1,0,1,2,11.48,15,111,126
"2012-02-08 14:00:00",1,0,1,2,12.3,8,100,108
"2012-02-08 15:00:00",1,0,1,3,12.3,5,49,54
"2012-02-08 16:00:00",1,0,1,3,10.66,2,73,75
"2012-02-08 17:00:00",1,0,1,3,9.84,8,147,155
"2012-02-08 18:00:00",1,0,1,3,9.84,4,163,167
"2012-02-08 19:00:00",1,0,1,3,9.84,3,158,161
"2012-02-08 20:00:00",1,0,1,3,9.84,3,122,125
"2012-02-08 21:00:00",1,0,1,3,9.84,3,126,129
"2012-02-08 22:00:00",1,0,1,2,9.84,3,95,98
"2012-02-08 23:00:00",1,0,1,2,9.84,3,57,60
"2012-02-09 00:00:00",1,0,1,2,9.84,3,23,26
"2012-02-09 01:00:00",1,0,1,2,9.84,2,10,12
"2012-02-09 02:00:00",1,0,1,1,9.02,0,2,2
"2012-02-09 03:00:00",1,0,1,1,9.02,0,4,4
"2012-02-09 04:00:00",1,0,1,2,9.02,0,1,1
"2012-02-09 05:00:00",1,0,1,1,8.2,0,18,18
"2012-02-09 06:00:00",1,0,1,1,8.2,1,75,76
"2012-02-09 07:00:00",1,0,1,1,8.2,4,263,267
"2012-02-09 08:00:00",1,0,1,1,8.2,11,473,484
"2012-02-09 09:00:00",1,0,1,1,8.2,9,229,238
"2012-02-09 10:00:00",1,0,1,1,9.02,7,90,97
"2012-02-09 11:00:00",1,0,1,1,9.84,4,95,99
"2012-02-09 12:00:00",1,0,1,1,10.66,10,148,158
"2012-02-09 13:00:00",1,0,1,1,12.3,10,144,154
"2012-02-09 14:00:00",1,0,1,1,13.12,18,126,144
"2012-02-09 15:00:00",1,0,1,1,13.12,14,120,134
"2012-02-09 16:00:00",1,0,1,1,13.94,15,223,238
"2012-02-09 17:00:00",1,0,1,1,13.94,12,387,399
"2012-02-09 18:00:00",1,0,1,1,13.94,13,404,417
"2012-02-09 19:00:00",1,0,1,1,13.12,8,287,295
"2012-02-09 20:00:00",1,0,1,1,13.12,2,197,199
"2012-02-09 21:00:00",1,0,1,1,12.3,8,169,177
"2012-02-09 22:00:00",1,0,1,2,12.3,3,104,107
"2012-02-09 23:00:00",1,0,1,2,12.3,9,75,84
"2012-02-10 00:00:00",1,0,1,2,11.48,4,39,43
"2012-02-10 01:00:00",1,0,1,2,11.48,2,11,13
"2012-02-10 02:00:00",1,0,1,1,10.66,7,9,16
"2012-02-10 03:00:00",1,0,1,1,10.66,0,5,5
"2012-02-10 04:00:00",1,0,1,1,10.66,0,2,2
"2012-02-10 05:00:00",1,0,1,1,9.84,0,17,17
"2012-02-10 06:00:00",1,0,1,1,8.2,3,61,64
"2012-02-10 07:00:00",1,0,1,1,8.2,5,225,230
"2012-02-10 08:00:00",1,0,1,1,8.2,1,447,448
"2012-02-10 09:00:00",1,0,1,1,9.02,10,265,275
"2012-02-10 10:00:00",1,0,1,2,10.66,5,119,124
"2012-02-10 11:00:00",1,0,1,2,11.48,19,134,153
"2012-02-10 12:00:00",1,0,1,2,12.3,8,168,176
"2012-02-10 13:00:00",1,0,1,2,12.3,22,170,192
"2012-02-10 14:00:00",1,0,1,2,13.12,8,138,146
"2012-02-10 15:00:00",1,0,1,2,13.12,27,164,191
"2012-02-10 16:00:00",1,0,1,2,13.94,28,240,268
"2012-02-10 17:00:00",1,0,1,2,13.94,15,381,396
"2012-02-10 18:00:00",1,0,1,3,12.3,14,345,359
"2012-02-10 19:00:00",1,0,1,2,13.12,16,246,262
"2012-02-10 20:00:00",1,0,1,2,13.12,7,144,151
"2012-02-10 21:00:00",1,0,1,2,13.12,14,108,122
"2012-02-10 22:00:00",1,0,1,2,13.12,11,102,113
"2012-02-10 23:00:00",1,0,1,2,12.3,1,64,65
"2012-02-11 00:00:00",1,0,0,2,12.3,3,50,53
"2012-02-11 01:00:00",1,0,0,3,11.48,2,43,45
"2012-02-11 02:00:00",1,0,0,3,10.66,2,24,26
"2012-02-11 03:00:00",1,0,0,3,9.84,0,9,9
"2012-02-11 04:00:00",1,0,0,3,9.84,0,4,4
"2012-02-11 05:00:00",1,0,0,3,9.02,0,2,2
"2012-02-11 06:00:00",1,0,0,3,9.02,1,8,9
"2012-02-11 07:00:00",1,0,0,3,9.02,0,19,19
"2012-02-11 08:00:00",1,0,0,3,9.02,1,77,78
"2012-02-11 09:00:00",1,0,0,3,9.02,5,85,90
"2012-02-11 10:00:00",1,0,0,3,9.02,23,143,166
"2012-02-11 11:00:00",1,0,0,2,9.84,26,157,183
"2012-02-11 12:00:00",1,0,0,2,10.66,25,196,221
"2012-02-11 13:00:00",1,0,0,2,10.66,18,217,235
"2012-02-11 14:00:00",1,0,0,2,10.66,38,205,243
"2012-02-11 15:00:00",1,0,0,2,12.3,12,112,124
"2012-02-11 16:00:00",1,0,0,3,9.02,12,134,146
"2012-02-11 17:00:00",1,0,0,3,9.02,13,131,144
"2012-02-11 18:00:00",1,0,0,2,9.02,3,105,108
"2012-02-11 19:00:00",1,0,0,2,8.2,2,85,87
"2012-02-11 20:00:00",1,0,0,2,6.56,1,62,63
"2012-02-11 21:00:00",1,0,0,1,5.74,5,43,48
"2012-02-11 22:00:00",1,0,0,2,5.74,0,46,46
"2012-02-11 23:00:00",1,0,0,3,4.92,0,20,20
"2012-02-12 00:00:00",1,0,0,3,4.1,0,21,21
"2012-02-12 01:00:00",1,0,0,3,3.28,0,24,24
"2012-02-12 02:00:00",1,0,0,2,4.1,1,26,27
"2012-02-12 03:00:00",1,0,0,2,4.1,0,14,14
"2012-02-12 04:00:00",1,0,0,2,4.1,0,1,1
"2012-02-12 05:00:00",1,0,0,1,4.1,0,3,3
"2012-02-12 06:00:00",1,0,0,1,4.1,0,2,2
"2012-02-12 07:00:00",1,0,0,1,3.28,0,18,18
"2012-02-12 08:00:00",1,0,0,1,3.28,0,26,26
"2012-02-12 09:00:00",1,0,0,1,4.1,3,60,63
"2012-02-12 10:00:00",1,0,0,1,4.92,8,83,91
"2012-02-12 11:00:00",1,0,0,1,4.92,3,121,124
"2012-02-12 12:00:00",1,0,0,1,5.74,7,133,140
"2012-02-12 13:00:00",1,0,0,1,6.56,10,128,138
"2012-02-12 14:00:00",1,0,0,1,6.56,9,102,111
"2012-02-12 15:00:00",1,0,0,1,6.56,5,150,155
"2012-02-12 16:00:00",1,0,0,1,8.2,16,148,164
"2012-02-12 17:00:00",1,0,0,1,7.38,4,83,87
"2012-02-12 18:00:00",1,0,0,1,6.56,4,92,96
"2012-02-12 19:00:00",1,0,0,1,6.56,2,78,80
"2012-02-12 20:00:00",1,0,0,1,5.74,1,56,57
"2012-02-12 21:00:00",1,0,0,1,5.74,0,36,36
"2012-02-12 22:00:00",1,0,0,1,5.74,0,28,28
"2012-02-12 23:00:00",1,0,0,1,5.74,0,23,23
"2012-02-13 00:00:00",1,0,1,1,5.74,0,9,9
"2012-02-13 01:00:00",1,0,1,1,4.92,0,6,6
"2012-02-13 02:00:00",1,0,1,1,5.74,0,4,4
"2012-02-13 03:00:00",1,0,1,1,4.92,0,1,1
"2012-02-13 04:00:00",1,0,1,1,4.92,0,2,2
"2012-02-13 05:00:00",1,0,1,1,4.1,0,17,17
"2012-02-13 06:00:00",1,0,1,1,4.1,1,71,72
"2012-02-13 07:00:00",1,0,1,1,4.1,1,194,195
"2012-02-13 08:00:00",1,0,1,1,4.1,4,413,417
"2012-02-13 09:00:00",1,0,1,1,4.92,7,198,205
"2012-02-13 10:00:00",1,0,1,1,5.74,1,70,71
"2012-02-13 11:00:00",1,0,1,1,9.02,5,85,90
"2012-02-13 12:00:00",1,0,1,1,11.48,7,111,118
"2012-02-13 13:00:00",1,0,1,1,13.12,11,129,140
"2012-02-13 14:00:00",1,0,1,1,13.94,10,125,135
"2012-02-13 15:00:00",1,0,1,1,14.76,10,145,155
"2012-02-13 16:00:00",1,0,1,1,14.76,5,206,211
"2012-02-13 17:00:00",1,0,1,1,14.76,8,399,407
"2012-02-13 18:00:00",1,0,1,1,13.94,6,399,405
"2012-02-13 19:00:00",1,0,1,1,13.94,7,256,263
"2012-02-13 20:00:00",1,0,1,1,12.3,4,210,214
"2012-02-13 21:00:00",1,0,1,1,11.48,2,145,147
"2012-02-13 22:00:00",1,0,1,1,10.66,3,99,102
"2012-02-13 23:00:00",1,0,1,1,11.48,2,34,36
"2012-02-14 00:00:00",1,0,1,2,10.66,0,14,14
"2012-02-14 01:00:00",1,0,1,2,10.66,0,6,6
"2012-02-14 02:00:00",1,0,1,2,11.48,0,3,3
"2012-02-14 03:00:00",1,0,1,2,10.66,0,3,3
"2012-02-14 04:00:00",1,0,1,2,10.66,0,2,2
"2012-02-14 05:00:00",1,0,1,2,10.66,2,20,22
"2012-02-14 06:00:00",1,0,1,2,10.66,1,89,90
"2012-02-14 07:00:00",1,0,1,2,9.84,4,276,280
"2012-02-14 08:00:00",1,0,1,2,9.84,3,510,513
"2012-02-14 09:00:00",1,0,1,2,10.66,6,256,262
"2012-02-14 10:00:00",1,0,1,2,10.66,8,90,98
"2012-02-14 11:00:00",1,0,1,2,12.3,5,107,112
"2012-02-14 12:00:00",1,0,1,2,12.3,10,162,172
"2012-02-14 13:00:00",1,0,1,2,14.76,6,167,173
"2012-02-14 14:00:00",1,0,1,1,16.4,13,111,124
"2012-02-14 15:00:00",1,0,1,2,17.22,7,138,145
"2012-02-14 16:00:00",1,0,1,1,17.22,15,251,266
"2012-02-14 17:00:00",1,0,1,1,17.22,19,504,523
"2012-02-14 18:00:00",1,0,1,2,15.58,8,398,406
"2012-02-14 19:00:00",1,0,1,2,14.76,11,270,281
"2012-02-14 20:00:00",1,0,1,2,15.58,6,178,184
"2012-02-14 21:00:00",1,0,1,2,14.76,4,105,109
"2012-02-14 22:00:00",1,0,1,2,14.76,5,72,77
"2012-02-14 23:00:00",1,0,1,2,14.76,2,55,57
"2012-02-15 00:00:00",1,0,1,1,13.12,0,22,22
"2012-02-15 01:00:00",1,0,1,1,13.94,0,5,5
"2012-02-15 02:00:00",1,0,1,1,12.3,0,4,4
"2012-02-15 03:00:00",1,0,1,1,11.48,0,3,3
"2012-02-15 04:00:00",1,0,1,1,11.48,0,1,1
"2012-02-15 05:00:00",1,0,1,1,11.48,0,25,25
"2012-02-15 06:00:00",1,0,1,1,12.3,3,92,95
"2012-02-15 07:00:00",1,0,1,2,12.3,3,318,321
"2012-02-15 08:00:00",1,0,1,1,13.12,7,508,515
"2012-02-15 09:00:00",1,0,1,1,13.12,5,226,231
"2012-02-15 10:00:00",1,0,1,1,13.94,12,108,120
"2012-02-15 11:00:00",1,0,1,1,14.76,13,125,138
"2012-02-15 12:00:00",1,0,1,1,15.58,11,152,163
"2012-02-15 13:00:00",1,0,1,1,16.4,11,159,170
"2012-02-15 14:00:00",1,0,1,1,17.22,6,128,134
"2012-02-15 15:00:00",1,0,1,1,17.22,7,164,171
"2012-02-15 16:00:00",1,0,1,1,17.22,9,222,231
"2012-02-15 17:00:00",1,0,1,1,17.22,17,470,487
"2012-02-15 18:00:00",1,0,1,1,16.4,9,459,468
"2012-02-15 19:00:00",1,0,1,1,15.58,9,302,311
"2012-02-15 20:00:00",1,0,1,1,14.76,4,207,211
"2012-02-15 21:00:00",1,0,1,1,13.94,8,170,178
"2012-02-15 22:00:00",1,0,1,1,13.94,3,104,107
"2012-02-15 23:00:00",1,0,1,1,13.94,4,54,58
"2012-02-16 00:00:00",1,0,1,2,12.3,1,22,23
"2012-02-16 01:00:00",1,0,1,2,12.3,0,5,5
"2012-02-16 02:00:00",1,0,1,2,12.3,1,6,7
"2012-02-16 03:00:00",1,0,1,2,12.3,0,1,1
"2012-02-16 04:00:00",1,0,1,3,12.3,0,3,3
"2012-02-16 05:00:00",1,0,1,2,12.3,0,20,20
"2012-02-16 06:00:00",1,0,1,2,12.3,4,83,87
"2012-02-16 07:00:00",1,0,1,2,12.3,3,285,288
"2012-02-16 08:00:00",1,0,1,2,12.3,9,489,498
"2012-02-16 09:00:00",1,0,1,2,12.3,3,199,202
"2012-02-16 10:00:00",1,0,1,3,13.12,2,42,44
"2012-02-16 11:00:00",1,0,1,3,13.12,2,69,71
"2012-02-16 12:00:00",1,0,1,3,13.12,1,44,45
"2012-02-16 13:00:00",1,0,1,3,13.94,2,62,64
"2012-02-16 14:00:00",1,0,1,3,13.12,1,30,31
"2012-02-16 15:00:00",1,0,1,3,13.94,3,50,53
"2012-02-16 16:00:00",1,0,1,3,13.94,8,110,118
"2012-02-16 17:00:00",1,0,1,3,13.94,8,281,289
"2012-02-16 18:00:00",1,0,1,3,13.94,8,345,353
"2012-02-16 19:00:00",1,0,1,2,13.12,4,254,258
"2012-02-16 20:00:00",1,0,1,2,13.12,5,211,216
"2012-02-16 21:00:00",1,0,1,2,13.94,3,142,145
"2012-02-16 22:00:00",1,0,1,2,13.12,3,108,111
"2012-02-16 23:00:00",1,0,1,1,13.12,3,70,73
"2012-02-17 00:00:00",1,0,1,2,12.3,2,32,34
"2012-02-17 01:00:00",1,0,1,2,12.3,2,16,18
"2012-02-17 02:00:00",1,0,1,2,12.3,1,11,12
"2012-02-17 03:00:00",1,0,1,2,11.48,0,1,1
"2012-02-17 04:00:00",1,0,1,2,11.48,0,1,1
"2012-02-17 05:00:00",1,0,1,2,11.48,0,16,16
"2012-02-17 06:00:00",1,0,1,2,11.48,1,70,71
"2012-02-17 07:00:00",1,0,1,2,11.48,4,222,226
"2012-02-17 08:00:00",1,0,1,2,10.66,4,516,520
"2012-02-17 09:00:00",1,0,1,2,10.66,8,275,283
"2012-02-17 10:00:00",1,0,1,1,13.94,13,103,116
"2012-02-17 11:00:00",1,0,1,1,14.76,9,133,142
"2012-02-17 12:00:00",1,0,1,1,15.58,21,177,198
"2012-02-17 13:00:00",1,0,1,1,16.4,34,171,205
"2012-02-17 14:00:00",1,0,1,1,16.4,33,137,170
"2012-02-17 15:00:00",1,0,1,1,17.22,41,180,221
"2012-02-17 16:00:00",1,0,1,1,17.22,56,251,307
"2012-02-17 17:00:00",1,0,1,1,17.22,36,429,465
"2012-02-17 18:00:00",1,0,1,1,16.4,15,362,377
"2012-02-17 19:00:00",1,0,1,1,15.58,16,266,282
"2012-02-17 20:00:00",1,0,1,1,16.4,13,158,171
"2012-02-17 21:00:00",1,0,1,1,15.58,15,114,129
"2012-02-17 22:00:00",1,0,1,1,14.76,15,92,107
"2012-02-17 23:00:00",1,0,1,1,14.76,10,72,82
"2012-02-18 00:00:00",1,0,0,1,13.94,5,81,86
"2012-02-18 01:00:00",1,0,0,1,13.12,7,38,45
"2012-02-18 02:00:00",1,0,0,1,12.3,6,39,45
"2012-02-18 03:00:00",1,0,0,1,11.48,3,15,18
"2012-02-18 04:00:00",1,0,0,1,10.66,3,4,7
"2012-02-18 05:00:00",1,0,0,1,9.84,0,1,1
"2012-02-18 06:00:00",1,0,0,1,9.84,1,8,9
"2012-02-18 07:00:00",1,0,0,1,9.84,8,33,41
"2012-02-18 08:00:00",1,0,0,1,9.02,10,92,102
"2012-02-18 09:00:00",1,0,0,1,9.02,22,116,138
"2012-02-18 10:00:00",1,0,0,1,10.66,48,157,205
"2012-02-18 11:00:00",1,0,0,1,13.12,102,184,286
"2012-02-18 12:00:00",1,0,0,1,14.76,128,241,369
"2012-02-18 13:00:00",1,0,0,1,16.4,165,219,384
"2012-02-18 14:00:00",1,0,0,1,18.04,183,244,427
"2012-02-18 15:00:00",1,0,0,1,17.22,229,270,499
"2012-02-18 16:00:00",1,0,0,1,18.04,186,218,404
"2012-02-18 17:00:00",1,0,0,1,19.68,142,222,364
"2012-02-18 18:00:00",1,0,0,1,18.86,70,176,246
"2012-02-18 19:00:00",1,0,0,1,18.04,38,150,188
"2012-02-18 20:00:00",1,0,0,1,18.04,25,123,148
"2012-02-18 21:00:00",1,0,0,1,18.04,25,89,114
"2012-02-18 22:00:00",1,0,0,1,16.4,17,101,118
"2012-02-18 23:00:00",1,0,0,2,14.76,12,62,74
"2012-02-19 00:00:00",1,0,0,2,13.94,9,65,74
"2012-02-19 01:00:00",1,0,0,2,13.12,10,62,72
"2012-02-19 02:00:00",1,0,0,2,12.3,3,45,48
"2012-02-19 03:00:00",1,0,0,2,12.3,3,12,15
"2012-02-19 04:00:00",1,0,0,2,11.48,0,3,3
"2012-02-19 05:00:00",1,0,0,2,10.66,1,1,2
"2012-02-19 06:00:00",1,0,0,1,9.84,0,5,5
"2012-02-19 07:00:00",1,0,0,2,9.84,2,12,14
"2012-02-19 08:00:00",1,0,0,2,9.84,8,48,56
"2012-02-19 09:00:00",1,0,0,2,9.84,20,73,93
"2012-02-19 10:00:00",1,0,0,2,10.66,49,142,191
"2012-02-19 11:00:00",1,0,0,2,10.66,82,144,226
"2012-02-19 12:00:00",1,0,0,2,11.48,71,184,255
"2012-02-19 13:00:00",1,0,0,1,12.3,64,197,261
"2012-02-19 14:00:00",1,0,0,2,13.12,48,189,237
"2012-02-19 15:00:00",1,0,0,2,12.3,85,168,253
"2012-02-19 16:00:00",1,0,0,2,13.12,62,150,212
"2012-02-19 17:00:00",1,0,0,2,12.3,22,135,157
"2012-02-19 18:00:00",1,0,0,2,12.3,23,144,167
"2012-02-19 19:00:00",1,0,0,2,12.3,18,101,119
"2012-02-19 20:00:00",1,0,0,2,12.3,22,81,103
"2012-02-19 21:00:00",1,0,0,3,10.66,3,33,36
"2012-02-19 22:00:00",1,0,0,3,9.84,8,47,55
"2012-02-19 23:00:00",1,0,0,2,9.02,5,30,35
"2012-03-01 00:00:00",1,0,1,2,17.22,1,10,11
"2012-03-01 01:00:00",1,0,1,3,18.86,0,12,12
"2012-03-01 02:00:00",1,0,1,2,18.86,0,6,6
"2012-03-01 03:00:00",1,0,1,1,18.86,0,3,3
"2012-03-01 04:00:00",1,0,1,1,19.68,0,5,5
"2012-03-01 05:00:00",1,0,1,1,19.68,0,18,18
"2012-03-01 06:00:00",1,0,1,2,17.22,2,107,109
"2012-03-01 07:00:00",1,0,1,2,18.04,8,296,304
"2012-03-01 08:00:00",1,0,1,1,17.22,15,579,594
"2012-03-01 09:00:00",1,0,1,1,18.86,5,281,286
"2012-03-01 10:00:00",1,0,1,1,21.32,11,122,133
"2012-03-01 11:00:00",1,0,1,1,22.96,19,149,168
"2012-03-01 12:00:00",1,0,1,1,22.96,16,204,220
"2012-03-01 13:00:00",1,0,1,1,23.78,24,187,211
"2012-03-01 14:00:00",1,0,1,1,23.78,37,174,211
"2012-03-01 15:00:00",1,0,1,1,24.6,31,192,223
"2012-03-01 16:00:00",1,0,1,1,23.78,38,323,361
"2012-03-01 17:00:00",1,0,1,1,22.96,49,551,600
"2012-03-01 18:00:00",1,0,1,1,22.14,27,498,525
"2012-03-01 19:00:00",1,0,1,1,19.68,11,317,328
"2012-03-01 20:00:00",1,0,1,1,18.04,12,242,254
"2012-03-01 21:00:00",1,0,1,1,17.22,7,190,197
"2012-03-01 22:00:00",1,0,1,1,15.58,3,123,126
"2012-03-01 23:00:00",1,0,1,1,14.76,9,76,85
"2012-03-02 00:00:00",1,0,1,1,13.94,1,45,46
"2012-03-02 01:00:00",1,0,1,1,13.94,2,18,20
"2012-03-02 02:00:00",1,0,1,1,13.94,2,4,6
"2012-03-02 03:00:00",1,0,1,1,13.12,0,3,3
"2012-03-02 04:00:00",1,0,1,1,13.12,0,2,2
"2012-03-02 05:00:00",1,0,1,1,12.3,0,24,24
"2012-03-02 06:00:00",1,0,1,1,12.3,4,88,92
"2012-03-02 07:00:00",1,0,1,1,12.3,4,258,262
"2012-03-02 08:00:00",1,0,1,1,11.48,16,533,549
"2012-03-02 09:00:00",1,0,1,1,12.3,15,299,314
"2012-03-02 10:00:00",1,0,1,1,14.76,14,118,132
"2012-03-02 11:00:00",1,0,1,1,15.58,40,154,194
"2012-03-02 12:00:00",1,0,1,1,16.4,40,194,234
"2012-03-02 13:00:00",1,0,1,1,17.22,31,191,222
"2012-03-02 14:00:00",1,0,1,2,18.04,29,176,205
"2012-03-02 15:00:00",1,0,1,2,17.22,5,73,78
"2012-03-02 16:00:00",1,0,1,3,16.4,1,49,50
"2012-03-02 17:00:00",1,0,1,3,14.76,5,123,128
"2012-03-02 18:00:00",1,0,1,3,14.76,6,154,160
"2012-03-02 19:00:00",1,0,1,3,14.76,12,162,174
"2012-03-02 20:00:00",1,0,1,2,14.76,7,93,100
"2012-03-02 21:00:00",1,0,1,3,14.76,2,99,101
"2012-03-02 22:00:00",1,0,1,2,14.76,6,69,75
"2012-03-02 23:00:00",1,0,1,2,14.76,4,19,23
"2012-03-03 00:00:00",1,0,0,3,14.76,1,21,22
"2012-03-03 01:00:00",1,0,0,3,14.76,0,44,44
"2012-03-03 02:00:00",1,0,0,3,14.76,4,34,38
"2012-03-03 03:00:00",1,0,0,2,14.76,1,20,21
"2012-03-03 04:00:00",1,0,0,2,14.76,0,2,2
"2012-03-03 05:00:00",1,0,0,2,14.76,1,1,2
"2012-03-03 06:00:00",1,0,0,2,14.76,1,6,7
"2012-03-03 07:00:00",1,0,0,2,14.76,2,14,16
"2012-03-03 08:00:00",1,0,0,3,14.76,2,46,48
"2012-03-03 09:00:00",1,0,0,3,15.58,7,87,94
"2012-03-03 10:00:00",1,0,0,2,16.4,31,137,168
"2012-03-03 11:00:00",1,0,0,2,16.4,33,181,214
"2012-03-03 12:00:00",1,0,0,2,17.22,47,252,299
"2012-03-03 13:00:00",1,0,0,1,18.04,87,252,339
"2012-03-03 14:00:00",1,0,0,2,18.86,151,279,430
"2012-03-03 15:00:00",1,0,0,1,19.68,145,254,399
"2012-03-03 16:00:00",1,0,0,1,20.5,167,300,467
"2012-03-03 17:00:00",1,0,0,1,20.5,106,279,385
"2012-03-03 18:00:00",1,0,0,1,20.5,53,250,303
"2012-03-03 19:00:00",1,0,0,1,18.86,34,191,225
"2012-03-03 20:00:00",1,0,0,1,18.04,28,121,149
"2012-03-03 21:00:00",1,0,0,1,18.86,24,130,154
"2012-03-03 22:00:00",1,0,0,1,18.04,19,115,134
"2012-03-03 23:00:00",1,0,0,1,17.22,12,94,106
"2012-03-04 00:00:00",1,0,0,2,16.4,5,67,72
"2012-03-04 01:00:00",1,0,0,2,15.58,16,60,76
"2012-03-04 02:00:00",1,0,0,2,14.76,14,66,80
"2012-03-04 03:00:00",1,0,0,2,14.76,5,21,26
"2012-03-04 04:00:00",1,0,0,2,13.94,3,11,14
"2012-03-04 05:00:00",1,0,0,2,13.94,0,5,5
"2012-03-04 06:00:00",1,0,0,2,12.3,0,5,5
"2012-03-04 07:00:00",1,0,0,2,12.3,2,21,23
"2012-03-04 08:00:00",1,0,0,1,12.3,12,54,66
"2012-03-04 09:00:00",1,0,0,1,12.3,14,104,118
"2012-03-04 10:00:00",1,0,0,1,12.3,31,161,192
"2012-03-04 11:00:00",1,0,0,1,13.12,64,192,256
"2012-03-04 12:00:00",1,0,0,1,13.94,71,256,327
"2012-03-04 13:00:00",1,0,0,1,14.76,108,256,364
"2012-03-04 14:00:00",1,0,0,1,14.76,106,226,332
"2012-03-04 15:00:00",1,0,0,1,14.76,82,252,334
"2012-03-04 16:00:00",1,0,0,1,14.76,68,231,299
"2012-03-04 17:00:00",1,0,0,1,13.94,49,214,263
"2012-03-04 18:00:00",1,0,0,1,13.12,20,164,184
"2012-03-04 19:00:00",1,0,0,1,12.3,12,120,132
"2012-03-04 20:00:00",1,0,0,1,11.48,8,80,88
"2012-03-04 21:00:00",1,0,0,1,11.48,9,70,79
"2012-03-04 22:00:00",1,0,0,1,10.66,9,53,62
"2012-03-04 23:00:00",1,0,0,1,10.66,2,24,26
"2012-03-05 00:00:00",1,0,1,1,9.84,2,15,17
"2012-03-05 01:00:00",1,0,1,1,9.84,3,3,6
"2012-03-05 02:00:00",1,0,1,1,9.84,1,3,4
"2012-03-05 03:00:00",1,0,1,1,9.02,0,1,1
"2012-03-05 04:00:00",1,0,1,1,8.2,0,1,1
"2012-03-05 05:00:00",1,0,1,1,8.2,1,17,18
"2012-03-05 06:00:00",1,0,1,1,7.38,2,89,91
"2012-03-05 07:00:00",1,0,1,1,7.38,7,253,260
"2012-03-05 08:00:00",1,0,1,1,8.2,13,415,428
"2012-03-05 09:00:00",1,0,1,2,9.02,11,186,197
"2012-03-05 10:00:00",1,0,1,2,9.84,12,74,86
"2012-03-05 11:00:00",1,0,1,2,10.66,17,86,103
"2012-03-05 12:00:00",1,0,1,2,10.66,15,122,137
"2012-03-05 13:00:00",1,0,1,2,10.66,11,109,120
"2012-03-05 14:00:00",1,0,1,2,11.48,13,115,128
"2012-03-05 15:00:00",1,0,1,2,12.3,20,110,130
"2012-03-05 16:00:00",1,0,1,1,12.3,30,180,210
"2012-03-05 17:00:00",1,0,1,3,12.3,11,376,387
"2012-03-05 18:00:00",1,0,1,3,11.48,12,363,375
"2012-03-05 19:00:00",1,0,1,1,10.66,6,220,226
"2012-03-05 20:00:00",1,0,1,1,10.66,8,171,179
"2012-03-05 21:00:00",1,0,1,1,10.66,4,116,120
"2012-03-05 22:00:00",1,0,1,1,9.84,2,76,78
"2012-03-05 23:00:00",1,0,1,1,9.02,2,29,31
"2012-03-06 00:00:00",1,0,1,1,9.02,0,8,8
"2012-03-06 01:00:00",1,0,1,1,8.2,0,6,6
"2012-03-06 02:00:00",1,0,1,1,8.2,0,4,4
"2012-03-06 03:00:00",1,0,1,1,7.38,0,1,1
"2012-03-06 04:00:00",1,0,1,1,7.38,0,3,3
"2012-03-06 05:00:00",1,0,1,1,7.38,0,25,25
"2012-03-06 06:00:00",1,0,1,1,7.38,3,99,102
"2012-03-06 07:00:00",1,0,1,1,6.56,5,270,275
"2012-03-06 08:00:00",1,0,1,1,6.56,14,487,501
"2012-03-06 09:00:00",1,0,1,1,9.02,11,222,233
"2012-03-06 10:00:00",1,0,1,1,9.84,16,113,129
"2012-03-06 11:00:00",1,0,1,1,10.66,20,110,130
"2012-03-06 12:00:00",1,0,1,1,10.66,9,129,138
"2012-03-06 13:00:00",1,0,1,1,12.3,16,148,164
"2012-03-06 14:00:00",1,0,1,1,13.12,20,116,136
"2012-03-06 15:00:00",1,0,1,1,13.94,24,142,166
"2012-03-06 16:00:00",1,0,1,1,14.76,22,228,250
"2012-03-06 17:00:00",1,0,1,1,14.76,21,425,446
"2012-03-06 18:00:00",1,0,1,1,13.94,15,442,457
"2012-03-06 19:00:00",1,0,1,1,13.94,9,278,287
"2012-03-06 20:00:00",1,0,1,1,13.12,3,184,187
"2012-03-06 21:00:00",1,0,1,1,13.12,5,143,148
"2012-03-06 22:00:00",1,0,1,1,11.48,5,101,106
"2012-03-06 23:00:00",1,0,1,1,11.48,3,51,54
"2012-03-07 00:00:00",1,0,1,1,11.48,3,12,15
"2012-03-07 01:00:00",1,0,1,1,12.3,1,4,5
"2012-03-07 02:00:00",1,0,1,1,12.3,0,4,4
"2012-03-07 03:00:00",1,0,1,1,12.3,1,2,3
"2012-03-07 04:00:00",1,0,1,1,11.48,0,3,3
"2012-03-07 05:00:00",1,0,1,1,11.48,0,18,18
"2012-03-07 06:00:00",1,0,1,1,11.48,4,104,108
"2012-03-07 07:00:00",1,0,1,1,10.66,12,332,344
"2012-03-07 08:00:00",1,0,1,1,11.48,12,554,566
"2012-03-07 09:00:00",1,0,1,1,12.3,12,252,264
"2012-03-07 10:00:00",1,0,1,1,14.76,20,127,147
"2012-03-07 11:00:00",1,0,1,1,17.22,33,128,161
"2012-03-07 12:00:00",1,0,1,1,18.04,40,175,215
"2012-03-07 13:00:00",1,0,1,1,20.5,26,179,205
"2012-03-07 14:00:00",1,0,1,1,21.32,38,137,175
"2012-03-07 15:00:00",1,0,1,1,22.14,44,165,209
"2012-03-07 16:00:00",1,0,1,1,22.96,34,254,288
"2012-03-07 17:00:00",1,0,1,1,22.96,58,554,612
"2012-03-07 18:00:00",1,0,1,1,22.96,35,509,544
"2012-03-07 19:00:00",1,0,1,1,22.14,16,345,361
"2012-03-07 20:00:00",1,0,1,1,20.5,18,242,260
"2012-03-07 21:00:00",1,0,1,1,18.04,11,177,188
"2012-03-07 22:00:00",1,0,1,1,18.86,10,149,159
"2012-03-07 23:00:00",1,0,1,1,18.04,4,58,62
"2012-03-08 00:00:00",1,0,1,1,18.04,11,35,46
"2012-03-08 01:00:00",1,0,1,1,18.86,4,17,21
"2012-03-08 02:00:00",1,0,1,1,18.86,6,5,11
"2012-03-08 03:00:00",1,0,1,1,18.86,0,3,3
"2012-03-08 04:00:00",1,0,1,1,18.04,0,2,2
"2012-03-08 05:00:00",1,0,1,1,17.22,1,28,29
"2012-03-08 06:00:00",1,0,1,1,17.22,4,105,109
"2012-03-08 07:00:00",1,0,1,1,17.22,8,326,334
"2012-03-08 08:00:00",1,0,1,1,18.04,12,573,585
"2012-03-08 09:00:00",1,0,1,1,18.86,19,282,301
"2012-03-08 10:00:00",1,0,1,1,20.5,19,119,138
"2012-03-08 11:00:00",1,0,1,2,22.14,48,156,204
"2012-03-08 12:00:00",1,0,1,2,22.96,27,224,251
"2012-03-08 13:00:00",1,0,1,2,24.6,35,198,233
"2012-03-08 14:00:00",1,0,1,2,25.42,48,155,203
"2012-03-08 15:00:00",1,0,1,1,26.24,24,161,185
"2012-03-08 16:00:00",1,0,1,2,25.42,37,305,342
"2012-03-08 17:00:00",1,0,1,1,25.42,52,545,597
"2012-03-08 18:00:00",1,0,1,2,25.42,45,545,590
"2012-03-08 19:00:00",1,0,1,2,24.6,21,395,416
"2012-03-08 20:00:00",1,0,1,2,24.6,20,282,302
"2012-03-08 21:00:00",1,0,1,1,24.6,27,206,233
"2012-03-08 22:00:00",1,0,1,1,22.96,12,141,153
"2012-03-08 23:00:00",1,0,1,2,22.96,6,88,94
"2012-03-09 00:00:00",1,0,1,2,23.78,3,51,54
"2012-03-09 01:00:00",1,0,1,3,22.96,4,22,26
"2012-03-09 02:00:00",1,0,1,3,19.68,2,9,11
"2012-03-09 03:00:00",1,0,1,1,18.86,0,7,7
"2012-03-09 04:00:00",1,0,1,3,16.4,0,1,1
"2012-03-09 05:00:00",1,0,1,3,16.4,2,27,29
"2012-03-09 06:00:00",1,0,1,2,16.4,2,83,85
"2012-03-09 07:00:00",1,0,1,2,15.58,6,262,268
"2012-03-09 08:00:00",1,0,1,2,13.94,17,484,501
"2012-03-09 09:00:00",1,0,1,2,13.94,17,267,284
"2012-03-09 10:00:00",1,0,1,2,13.94,14,145,159
"2012-03-09 11:00:00",1,0,1,2,14.76,17,170,187
"2012-03-09 12:00:00",1,0,1,1,14.76,27,174,201
"2012-03-09 13:00:00",1,0,1,2,15.58,49,175,224
"2012-03-09 14:00:00",1,0,1,1,17.22,49,129,178
"2012-03-09 15:00:00",1,0,1,1,18.86,50,188,238
"2012-03-09 16:00:00",1,0,1,1,19.68,51,292,343
"2012-03-09 17:00:00",1,0,1,1,18.86,68,498,566
"2012-03-09 18:00:00",1,0,1,1,18.04,30,440,470
"2012-03-09 19:00:00",1,0,1,1,17.22,12,232,244
"2012-03-09 20:00:00",1,0,1,1,15.58,3,156,159
"2012-03-09 21:00:00",1,0,1,1,14.76,8,133,141
"2012-03-09 22:00:00",1,0,1,1,13.94,7,100,107
"2012-03-09 23:00:00",1,0,1,1,13.12,9,77,86
"2012-03-10 00:00:00",1,0,0,1,12.3,9,68,77
"2012-03-10 01:00:00",1,0,0,1,12.3,1,50,51
"2012-03-10 02:00:00",1,0,0,1,10.66,12,30,42
"2012-03-10 03:00:00",1,0,0,1,10.66,0,16,16
"2012-03-10 04:00:00",1,0,0,1,9.84,1,3,4
"2012-03-10 05:00:00",1,0,0,1,9.02,3,7,10
"2012-03-10 06:00:00",1,0,0,1,9.02,1,11,12
"2012-03-10 07:00:00",1,0,0,1,9.02,4,36,40
"2012-03-10 08:00:00",1,0,0,1,9.02,15,96,111
"2012-03-10 09:00:00",1,0,0,1,9.84,21,127,148
"2012-03-10 10:00:00",1,0,0,1,10.66,47,176,223
"2012-03-10 11:00:00",1,0,0,1,12.3,56,218,274
"2012-03-10 12:00:00",1,0,0,1,12.3,88,241,329
"2012-03-10 13:00:00",1,0,0,1,13.12,89,268,357
"2012-03-10 14:00:00",1,0,0,1,13.94,117,262,379
"2012-03-10 15:00:00",1,0,0,1,13.94,132,274,406
"2012-03-10 16:00:00",1,0,0,1,14.76,115,275,390
"2012-03-10 17:00:00",1,0,0,1,14.76,104,250,354
"2012-03-10 18:00:00",1,0,0,1,14.76,67,230,297
"2012-03-10 19:00:00",1,0,0,1,13.94,25,159,184
"2012-03-10 20:00:00",1,0,0,1,13.12,20,101,121
"2012-03-10 21:00:00",1,0,0,1,12.3,16,94,110
"2012-03-10 22:00:00",1,0,0,1,10.66,19,81,100
"2012-03-10 23:00:00",1,0,0,1,10.66,6,77,83
"2012-03-11 00:00:00",1,0,0,1,10.66,7,62,69
"2012-03-11 01:00:00",1,0,0,1,9.84,4,57,61
"2012-03-11 03:00:00",1,0,0,1,9.84,15,51,66
"2012-03-11 04:00:00",1,0,0,1,9.84,7,15,22
"2012-03-11 05:00:00",1,0,0,1,9.84,2,5,7
"2012-03-11 06:00:00",1,0,0,1,9.84,2,8,10
"2012-03-11 07:00:00",1,0,0,1,9.02,2,15,17
"2012-03-11 08:00:00",1,0,0,1,9.02,4,68,72
"2012-03-11 09:00:00",1,0,0,1,10.66,20,70,90
"2012-03-11 10:00:00",1,0,0,1,13.12,71,147,218
"2012-03-11 11:00:00",1,0,0,1,14.76,90,209,299
"2012-03-11 12:00:00",1,0,0,1,16.4,146,264,410
"2012-03-11 13:00:00",1,0,0,1,17.22,176,288,464
"2012-03-11 14:00:00",1,0,0,1,18.86,212,289,501
"2012-03-11 15:00:00",1,0,0,1,20.5,201,286,487
"2012-03-11 16:00:00",1,0,0,1,20.5,208,301,509
"2012-03-11 17:00:00",1,0,0,1,21.32,199,299,498
"2012-03-11 18:00:00",1,0,0,1,21.32,133,256,389
"2012-03-11 19:00:00",1,0,0,1,20.5,55,203,258
"2012-03-11 20:00:00",1,0,0,1,18.04,42,129,171
"2012-03-11 21:00:00",1,0,0,1,17.22,37,110,147
"2012-03-11 22:00:00",1,0,0,1,16.4,13,81,94
"2012-03-11 23:00:00",1,0,0,1,16.4,12,40,52
"2012-03-12 00:00:00",1,0,1,1,15.58,4,20,24
"2012-03-12 01:00:00",1,0,1,1,15.58,1,9,10
"2012-03-12 02:00:00",1,0,1,1,15.58,4,5,9
"2012-03-12 03:00:00",1,0,1,1,14.76,0,2,2
"2012-03-12 04:00:00",1,0,1,1,13.94,0,3,3
"2012-03-12 05:00:00",1,0,1,1,13.94,1,15,16
"2012-03-12 06:00:00",1,0,1,1,13.94,2,86,88
"2012-03-12 07:00:00",1,0,1,1,13.94,9,259,268
"2012-03-12 08:00:00",1,0,1,1,13.94,17,547,564
"2012-03-12 09:00:00",1,0,1,1,15.58,21,260,281
"2012-03-12 10:00:00",1,0,1,1,16.4,39,98,137
"2012-03-12 11:00:00",1,0,1,1,18.04,39,111,150
"2012-03-12 12:00:00",1,0,1,1,19.68,59,162,221
"2012-03-12 13:00:00",1,0,1,2,22.14,74,176,250
"2012-03-12 14:00:00",1,0,1,2,23.78,76,145,221
"2012-03-12 15:00:00",1,0,1,1,22.96,74,159,233
"2012-03-12 16:00:00",1,0,1,1,25.42,77,255,332
"2012-03-12 17:00:00",1,0,1,2,25.42,87,557,644
"2012-03-12 18:00:00",1,0,1,2,24.6,89,623,712
"2012-03-12 19:00:00",1,0,1,2,22.96,67,379,446
"2012-03-12 20:00:00",1,0,1,2,22.96,49,237,286
"2012-03-12 21:00:00",1,0,1,2,22.14,22,183,205
"2012-03-12 22:00:00",1,0,1,2,22.96,17,116,133
"2012-03-12 23:00:00",1,0,1,1,22.96,10,53,63
"2012-03-13 00:00:00",1,0,1,2,22.96,5,21,26
"2012-03-13 01:00:00",1,0,1,2,21.32,2,14,16
"2012-03-13 02:00:00",1,0,1,3,21.32,0,1,1
"2012-03-13 03:00:00",1,0,1,3,21.32,0,2,2
"2012-03-13 04:00:00",1,0,1,2,18.86,0,1,1
"2012-03-13 05:00:00",1,0,1,2,18.86,0,24,24
"2012-03-13 06:00:00",1,0,1,3,18.86,5,108,113
"2012-03-13 07:00:00",1,0,1,2,18.86,16,292,308
"2012-03-13 08:00:00",1,0,1,1,18.86,22,571,593
"2012-03-13 09:00:00",1,0,1,1,19.68,18,324,342
"2012-03-13 10:00:00",1,0,1,1,21.32,28,115,143
"2012-03-13 11:00:00",1,0,1,1,22.14,64,155,219
"2012-03-13 12:00:00",1,0,1,1,24.6,47,197,244
"2012-03-13 13:00:00",1,0,1,1,24.6,53,180,233
"2012-03-13 14:00:00",1,0,1,1,26.24,52,160,212
"2012-03-13 15:00:00",1,0,1,1,28.7,68,196,264
"2012-03-13 16:00:00",1,0,1,1,29.52,53,312,365
"2012-03-13 17:00:00",1,0,1,1,28.7,62,614,676
"2012-03-13 18:00:00",1,0,1,1,28.7,96,638,734
"2012-03-13 19:00:00",1,0,1,1,26.24,50,429,479
"2012-03-13 20:00:00",1,0,1,1,24.6,45,306,351
"2012-03-13 21:00:00",1,0,1,1,23.78,44,200,244
"2012-03-13 22:00:00",1,0,1,1,22.96,24,146,170
"2012-03-13 23:00:00",1,0,1,1,22.96,8,79,87
"2012-03-14 00:00:00",1,0,1,1,22.14,5,34,39
"2012-03-14 01:00:00",1,0,1,1,21.32,2,25,27
"2012-03-14 02:00:00",1,0,1,1,20.5,0,2,2
"2012-03-14 03:00:00",1,0,1,1,19.68,1,3,4
"2012-03-14 04:00:00",1,0,1,1,19.68,1,4,5
"2012-03-14 05:00:00",1,0,1,1,18.04,2,25,27
"2012-03-14 06:00:00",1,0,1,1,18.04,1,120,121
"2012-03-14 07:00:00",1,0,1,1,18.04,20,348,368
"2012-03-14 08:00:00",1,0,1,1,18.04,34,628,662
"2012-03-14 09:00:00",1,0,1,1,21.32,26,325,351
"2012-03-14 10:00:00",1,0,1,1,22.96,38,150,188
"2012-03-14 11:00:00",1,0,1,2,25.42,65,155,220
"2012-03-14 12:00:00",1,0,1,2,26.24,55,212,267
"2012-03-14 13:00:00",1,0,1,1,27.06,57,197,254
"2012-03-14 14:00:00",1,0,1,1,28.7,61,163,224
"2012-03-14 15:00:00",1,0,1,1,28.7,86,197,283
"2012-03-14 16:00:00",1,0,1,1,29.52,78,278,356
"2012-03-14 17:00:00",1,0,1,1,28.7,140,642,782
"2012-03-14 18:00:00",1,0,1,1,28.7,102,647,749
"2012-03-14 19:00:00",1,0,1,1,26.24,70,402,472
"2012-03-14 20:00:00",1,0,1,1,25.42,44,286,330
"2012-03-14 21:00:00",1,0,1,1,24.6,47,241,288
"2012-03-14 22:00:00",1,0,1,1,21.32,43,159,202
"2012-03-14 23:00:00",1,0,1,1,22.96,19,72,91
"2012-03-15 00:00:00",1,0,1,1,22.14,14,46,60
"2012-03-15 01:00:00",1,0,1,1,20.5,15,8,23
"2012-03-15 02:00:00",1,0,1,1,20.5,14,5,19
"2012-03-15 03:00:00",1,0,1,1,20.5,0,7,7
"2012-03-15 04:00:00",1,0,1,1,18.04,11,3,14
"2012-03-15 05:00:00",1,0,1,1,18.86,2,24,26
"2012-03-15 06:00:00",1,0,1,1,18.04,4,113,117
"2012-03-15 07:00:00",1,0,1,1,18.04,14,367,381
"2012-03-15 08:00:00",1,0,1,1,18.04,21,602,623
"2012-03-15 09:00:00",1,0,1,1,19.68,30,285,315
"2012-03-15 10:00:00",1,0,1,1,21.32,34,130,164
"2012-03-15 11:00:00",1,0,1,1,22.96,60,151,211
"2012-03-15 12:00:00",1,0,1,2,25.42,59,206,265
"2012-03-15 13:00:00",1,0,1,2,27.06,62,211,273
"2012-03-15 14:00:00",1,0,1,2,29.52,81,177,258
"2012-03-15 15:00:00",1,0,1,1,29.52,100,187,287
"2012-03-15 16:00:00",1,0,1,1,29.52,95,331,426
"2012-03-15 17:00:00",1,0,1,1,28.7,79,634,713
"2012-03-15 18:00:00",1,0,1,1,27.06,98,648,746
"2012-03-15 19:00:00",1,0,1,2,26.24,72,353,425
"2012-03-15 20:00:00",1,0,1,2,23.78,60,270,330
"2012-03-15 21:00:00",1,0,1,1,22.14,36,207,243
"2012-03-15 22:00:00",1,0,1,1,21.32,32,137,169
"2012-03-15 23:00:00",1,0,1,1,19.68,12,85,97
"2012-03-16 00:00:00",1,0,1,1,18.04,8,49,57
"2012-03-16 01:00:00",1,0,1,2,17.22,4,22,26
"2012-03-16 02:00:00",1,0,1,2,17.22,0,4,4
"2012-03-16 03:00:00",1,0,1,2,16.4,0,3,3
"2012-03-16 04:00:00",1,0,1,2,16.4,0,3,3
"2012-03-16 05:00:00",1,0,1,2,16.4,2,30,32
"2012-03-16 06:00:00",1,0,1,2,16.4,3,96,99
"2012-03-16 07:00:00",1,0,1,2,16.4,13,265,278
"2012-03-16 08:00:00",1,0,1,2,16.4,28,534,562
"2012-03-16 09:00:00",1,0,1,2,17.22,35,277,312
"2012-03-16 10:00:00",1,0,1,2,16.4,44,136,180
"2012-03-16 11:00:00",1,0,1,2,18.04,40,167,207
"2012-03-16 12:00:00",1,0,1,2,18.04,72,222,294
"2012-03-16 13:00:00",1,0,1,2,18.86,52,208,260
"2012-03-16 14:00:00",1,0,1,2,19.68,56,146,202
"2012-03-16 15:00:00",1,0,1,3,18.86,19,88,107
"2012-03-16 16:00:00",1,0,1,3,19.68,18,111,129
"2012-03-16 17:00:00",1,0,1,3,19.68,23,235,258
"2012-03-16 18:00:00",1,0,1,3,19.68,31,377,408
"2012-03-16 19:00:00",1,0,1,2,18.86,23,273,296
"2012-03-16 20:00:00",1,0,1,1,18.86,31,204,235
"2012-03-16 21:00:00",1,0,1,2,18.04,8,144,152
"2012-03-16 22:00:00",1,0,1,2,18.04,16,132,148
"2012-03-16 23:00:00",1,0,1,2,18.04,22,104,126
"2012-03-17 00:00:00",1,0,0,2,18.04,13,87,100
"2012-03-17 01:00:00",1,0,0,2,18.04,12,57,69
"2012-03-17 02:00:00",1,0,0,2,18.04,10,32,42
"2012-03-17 03:00:00",1,0,0,2,18.04,2,24,26
"2012-03-17 04:00:00",1,0,0,2,17.22,0,2,2
"2012-03-17 05:00:00",1,0,0,2,17.22,5,3,8
"2012-03-17 06:00:00",1,0,0,2,17.22,1,29,30
"2012-03-17 07:00:00",1,0,0,2,16.4,29,57,86
"2012-03-17 08:00:00",1,0,0,2,17.22,63,155,218
"2012-03-17 09:00:00",1,0,0,2,18.04,104,217,321
"2012-03-17 10:00:00",1,0,0,2,20.5,140,303,443
"2012-03-17 11:00:00",1,0,0,2,21.32,226,359,585
"2012-03-17 12:00:00",1,0,0,1,22.96,286,365,651
"2012-03-17 13:00:00",1,0,0,1,24.6,286,400,686
"2012-03-17 14:00:00",1,0,0,1,25.42,352,338,690
"2012-03-17 15:00:00",1,0,0,1,26.24,357,322,679
"2012-03-17 16:00:00",1,0,0,1,26.24,367,318,685
"2012-03-17 17:00:00",1,0,0,1,26.24,291,357,648
"2012-03-17 18:00:00",1,0,0,1,25.42,221,339,560
"2012-03-17 19:00:00",1,0,0,1,23.78,155,262,417
"2012-03-17 20:00:00",1,0,0,1,22.96,89,182,271
"2012-03-17 21:00:00",1,0,0,1,22.14,54,169,223
"2012-03-17 22:00:00",1,0,0,1,22.14,58,153,211
"2012-03-17 23:00:00",1,0,0,1,20.5,34,151,185
"2012-03-18 00:00:00",1,0,0,1,18.86,27,80,107
"2012-03-18 01:00:00",1,0,0,1,18.86,25,88,113
"2012-03-18 02:00:00",1,0,0,2,18.86,15,41,56
"2012-03-18 03:00:00",1,0,0,2,18.04,3,15,18
"2012-03-18 04:00:00",1,0,0,2,17.22,6,8,14
"2012-03-18 05:00:00",1,0,0,2,16.4,0,6,6
"2012-03-18 06:00:00",1,0,0,2,16.4,2,9,11
"2012-03-18 07:00:00",1,0,0,3,17.22,17,25,42
"2012-03-18 08:00:00",1,0,0,2,17.22,25,71,96
"2012-03-18 09:00:00",1,0,0,2,17.22,65,113,178
"2012-03-18 10:00:00",1,0,0,2,17.22,139,212,351
"2012-03-18 11:00:00",1,0,0,2,18.04,129,239,368
"2012-03-18 12:00:00",1,0,0,2,18.04,222,281,503
"2012-03-18 13:00:00",1,0,0,2,18.86,198,346,544
"2012-03-18 14:00:00",1,0,0,2,20.5,218,303,521
"2012-03-18 15:00:00",1,0,0,1,22.14,240,314,554
"2012-03-18 16:00:00",1,0,0,1,22.14,229,312,541
"2012-03-18 17:00:00",1,0,0,1,22.96,233,308,541
"2012-03-18 18:00:00",1,0,0,1,22.96,165,294,459
"2012-03-18 19:00:00",1,0,0,1,22.96,118,234,352
"2012-03-18 20:00:00",1,0,0,1,21.32,59,139,198
"2012-03-18 21:00:00",1,0,0,1,21.32,44,129,173
"2012-03-18 22:00:00",1,0,0,1,20.5,21,79,100
"2012-03-18 23:00:00",1,0,0,1,19.68,7,39,46
"2012-03-19 00:00:00",1,0,1,1,19.68,4,19,23
"2012-03-19 01:00:00",1,0,1,1,18.86,0,15,15
"2012-03-19 02:00:00",1,0,1,1,18.86,1,7,8
"2012-03-19 03:00:00",1,0,1,1,18.86,0,2,2
"2012-03-19 04:00:00",1,0,1,1,18.04,0,3,3
"2012-03-19 05:00:00",1,0,1,1,18.04,0,31,31
"2012-03-19 06:00:00",1,0,1,1,18.86,2,118,120
"2012-03-19 07:00:00",1,0,1,1,18.86,25,329,354
"2012-03-19 08:00:00",1,0,1,1,18.86,16,563,579
"2012-03-19 09:00:00",1,0,1,1,20.5,55,276,331
"2012-03-19 10:00:00",1,0,1,1,21.32,56,128,184
"2012-03-19 11:00:00",1,0,1,1,22.96,56,145,201
"2012-03-19 12:00:00",1,0,1,1,24.6,71,211,282
"2012-03-19 13:00:00",1,0,1,1,25.42,69,194,263
"2012-03-19 14:00:00",1,0,1,2,26.24,60,200,260
"2012-03-19 15:00:00",1,0,1,1,26.24,97,189,286
"2012-03-19 16:00:00",1,0,1,1,27.06,65,320,385
"2012-03-19 17:00:00",1,0,1,1,26.24,106,615,721
"2012-03-19 18:00:00",1,0,1,1,26.24,120,681,801
"2012-03-19 19:00:00",1,0,1,1,25.42,86,463,549
"2012-03-19 20:00:00",1,0,1,1,24.6,34,296,330
"2012-03-19 21:00:00",1,0,1,1,24.6,33,190,223
"2012-03-19 22:00:00",1,0,1,2,22.96,17,131,148
"2012-03-19 23:00:00",1,0,1,2,22.96,9,45,54
"2012-04-01 00:00:00",2,0,0,2,14.76,8,59,67
"2012-04-01 01:00:00",2,0,0,2,14.76,13,49,62
"2012-04-01 02:00:00",2,0,0,2,14.76,20,61,81
"2012-04-01 03:00:00",2,0,0,2,13.94,4,21,25
"2012-04-01 04:00:00",2,0,0,2,13.94,3,9,12
"2012-04-01 05:00:00",2,0,0,2,13.94,8,10,18
"2012-04-01 06:00:00",2,0,0,2,14.76,9,88,97
"2012-04-01 07:00:00",2,0,0,2,14.76,29,55,84
"2012-04-01 08:00:00",2,0,0,2,14.76,37,88,125
"2012-04-01 09:00:00",2,0,0,2,14.76,102,173,275
"2012-04-01 10:00:00",2,0,0,2,16.4,132,228,360
"2012-04-01 11:00:00",2,0,0,2,16.4,180,271,451
"2012-04-01 12:00:00",2,0,0,2,17.22,187,258,445
"2012-04-01 13:00:00",2,0,0,2,18.04,190,274,464
"2012-04-01 14:00:00",2,0,0,2,19.68,283,278,561
"2012-04-01 15:00:00",2,0,0,1,20.5,295,278,573
"2012-04-01 16:00:00",2,0,0,1,21.32,236,275,511
"2012-04-01 17:00:00",2,0,0,1,21.32,232,323,555
"2012-04-01 18:00:00",2,0,0,1,21.32,153,279,432
"2012-04-01 19:00:00",2,0,0,1,21.32,110,236,346
"2012-04-01 20:00:00",2,0,0,2,20.5,66,166,232
"2012-04-01 21:00:00",2,0,0,2,20.5,33,101,134
"2012-04-01 22:00:00",2,0,0,3,20.5,7,61,68
"2012-04-01 23:00:00",2,0,0,3,18.86,10,53,63
"2012-04-02 00:00:00",2,0,1,3,18.04,6,11,17
"2012-04-02 01:00:00",2,0,1,3,17.22,0,5,5
"2012-04-02 02:00:00",2,0,1,3,18.04,2,3,5
"2012-04-02 04:00:00",2,0,1,1,16.4,2,2,4
"2012-04-02 05:00:00",2,0,1,1,16.4,2,22,24
"2012-04-02 06:00:00",2,0,1,1,14.76,6,104,110
"2012-04-02 07:00:00",2,0,1,1,13.94,12,294,306
"2012-04-02 08:00:00",2,0,1,1,14.76,36,553,589
"2012-04-02 09:00:00",2,0,1,1,15.58,52,265,317
"2012-04-02 10:00:00",2,0,1,1,16.4,85,119,204
"2012-04-02 11:00:00",2,0,1,1,17.22,81,128,209
"2012-04-02 12:00:00",2,0,1,1,18.04,100,181,281
"2012-04-02 13:00:00",2,0,1,1,18.86,97,184,281
"2012-04-02 14:00:00",2,0,1,1,18.86,127,141,268
"2012-04-02 15:00:00",2,0,1,1,19.68,132,192,324
"2012-04-02 16:00:00",2,0,1,1,20.5,104,291,395
"2012-04-02 17:00:00",2,0,1,1,20.5,128,601,729
"2012-04-02 18:00:00",2,0,1,1,20.5,75,543,618
"2012-04-02 19:00:00",2,0,1,1,20.5,66,428,494
"2012-04-02 20:00:00",2,0,1,1,18.86,48,281,329
"2012-04-02 21:00:00",2,0,1,1,18.86,24,214,238
"2012-04-02 22:00:00",2,0,1,1,17.22,17,106,123
"2012-04-02 23:00:00",2,0,1,1,18.04,6,60,66
"2012-04-03 00:00:00",2,0,1,1,16.4,1,32,33
"2012-04-03 01:00:00",2,0,1,1,15.58,0,11,11
"2012-04-03 02:00:00",2,0,1,1,14.76,0,5,5
"2012-04-03 03:00:00",2,0,1,1,15.58,0,3,3
"2012-04-03 04:00:00",2,0,1,1,13.12,0,1,1
"2012-04-03 05:00:00",2,0,1,1,13.12,2,25,27
"2012-04-03 06:00:00",2,0,1,1,12.3,2,98,100
"2012-04-03 07:00:00",2,0,1,1,13.12,14,327,341
"2012-04-03 08:00:00",2,0,1,1,13.94,27,577,604
"2012-04-03 09:00:00",2,0,1,1,17.22,54,354,408
"2012-04-03 10:00:00",2,0,1,1,18.04,77,142,219
"2012-04-03 11:00:00",2,0,1,1,19.68,91,167,258
"2012-04-03 12:00:00",2,0,1,1,21.32,101,230,331
"2012-04-03 13:00:00",2,0,1,1,22.96,120,225,345
"2012-04-03 14:00:00",2,0,1,1,22.96,120,191,311
"2012-04-03 15:00:00",2,0,1,1,24.6,109,207,316
"2012-04-03 16:00:00",2,0,1,1,25.42,145,340,485
"2012-04-03 17:00:00",2,0,1,1,25.42,123,634,757
"2012-04-03 18:00:00",2,0,1,1,24.6,139,661,800
"2012-04-03 19:00:00",2,0,1,1,22.96,98,460,558
"2012-04-03 20:00:00",2,0,1,1,22.96,54,325,379
"2012-04-03 21:00:00",2,0,1,1,22.14,33,210,243
"2012-04-03 22:00:00",2,0,1,1,20.5,25,133,158
"2012-04-03 23:00:00",2,0,1,1,20.5,13,66,79
"2012-04-04 00:00:00",2,0,1,1,19.68,18,23,41
"2012-04-04 01:00:00",2,0,1,1,18.86,0,11,11
"2012-04-04 02:00:00",2,0,1,1,18.86,0,5,5
"2012-04-04 03:00:00",2,0,1,1,18.04,0,3,3
"2012-04-04 04:00:00",2,0,1,1,17.22,0,1,1
"2012-04-04 05:00:00",2,0,1,1,17.22,0,27,27
"2012-04-04 06:00:00",2,0,1,2,17.22,6,120,126
"2012-04-04 07:00:00",2,0,1,2,18.04,12,354,366
"2012-04-04 08:00:00",2,0,1,2,18.04,31,653,684
"2012-04-04 09:00:00",2,0,1,2,19.68,47,316,363
"2012-04-04 10:00:00",2,0,1,2,22.14,68,99,167
"2012-04-04 11:00:00",2,0,1,2,24.6,61,152,213
"2012-04-04 12:00:00",2,0,1,2,24.6,73,210,283
"2012-04-04 13:00:00",2,0,1,2,24.6,70,181,251
"2012-04-04 14:00:00",2,0,1,2,25.42,82,176,258
"2012-04-04 15:00:00",2,0,1,2,26.24,86,182,268
"2012-04-04 16:00:00",2,0,1,2,26.24,86,304,390
"2012-04-04 17:00:00",2,0,1,1,27.06,99,645,744
"2012-04-04 18:00:00",2,0,1,1,27.06,113,646,759
"2012-04-04 19:00:00",2,0,1,1,27.06,75,419,494
"2012-04-04 20:00:00",2,0,1,1,26.24,39,333,372
"2012-04-04 21:00:00",2,0,1,1,24.6,43,255,298
"2012-04-04 22:00:00",2,0,1,1,22.96,30,151,181
"2012-04-04 23:00:00",2,0,1,1,21.32,19,112,131
"2012-04-05 00:00:00",2,0,1,1,21.32,12,33,45
"2012-04-05 01:00:00",2,0,1,1,19.68,4,9,13
"2012-04-05 02:00:00",2,0,1,1,18.86,7,11,18
"2012-04-05 03:00:00",2,0,1,1,17.22,0,5,5
"2012-04-05 04:00:00",2,0,1,1,15.58,0,1,1
"2012-04-05 05:00:00",2,0,1,1,15.58,1,28,29
"2012-04-05 06:00:00",2,0,1,1,14.76,8,118,126
"2012-04-05 07:00:00",2,0,1,1,13.94,15,339,354
"2012-04-05 08:00:00",2,0,1,1,14.76,28,610,638
"2012-04-05 09:00:00",2,0,1,1,16.4,61,290,351
"2012-04-05 10:00:00",2,0,1,1,17.22,88,158,246
"2012-04-05 11:00:00",2,0,1,2,17.22,109,159,268
"2012-04-05 12:00:00",2,0,1,1,18.04,66,210,276
"2012-04-05 13:00:00",2,0,1,1,18.86,89,202,291
"2012-04-05 14:00:00",2,0,1,1,18.86,143,144,287
"2012-04-05 15:00:00",2,0,1,1,20.5,98,171,269
"2012-04-05 16:00:00",2,0,1,1,20.5,84,318,402
"2012-04-05 17:00:00",2,0,1,1,20.5,145,677,822
"2012-04-05 18:00:00",2,0,1,1,20.5,80,618,698
"2012-04-05 19:00:00",2,0,1,1,19.68,64,423,487
"2012-04-05 20:00:00",2,0,1,1,18.04,33,279,312
"2012-04-05 21:00:00",2,0,1,1,17.22,25,209,234
"2012-04-05 22:00:00",2,0,1,1,16.4,20,129,149
"2012-04-05 23:00:00",2,0,1,1,16.4,12,124,136
"2012-04-06 00:00:00",2,0,1,1,16.4,12,49,61
"2012-04-06 01:00:00",2,0,1,1,14.76,10,28,38
"2012-04-06 02:00:00",2,0,1,1,14.76,6,5,11
"2012-04-06 03:00:00",2,0,1,1,13.94,3,5,8
"2012-04-06 04:00:00",2,0,1,1,13.94,2,3,5
"2012-04-06 05:00:00",2,0,1,1,13.12,0,23,23
"2012-04-06 06:00:00",2,0,1,1,12.3,0,80,80
"2012-04-06 07:00:00",2,0,1,1,12.3,15,231,246
"2012-04-06 08:00:00",2,0,1,1,12.3,19,489,508
"2012-04-06 09:00:00",2,0,1,1,13.94,58,318,376
"2012-04-06 10:00:00",2,0,1,1,14.76,81,157,238
"2012-04-06 11:00:00",2,0,1,1,16.4,112,179,291
"2012-04-06 12:00:00",2,0,1,1,17.22,113,224,337
"2012-04-06 13:00:00",2,0,1,1,18.04,173,238,411
"2012-04-06 14:00:00",2,0,1,1,19.68,240,250,490
"2012-04-06 15:00:00",2,0,1,1,20.5,218,319,537
"2012-04-06 16:00:00",2,0,1,1,20.5,184,352,536
"2012-04-06 17:00:00",2,0,1,1,21.32,172,483,655
"2012-04-06 18:00:00",2,0,1,1,20.5,104,380,484
"2012-04-06 19:00:00",2,0,1,1,19.68,115,297,412
"2012-04-06 20:00:00",2,0,1,1,18.86,61,191,252
"2012-04-06 21:00:00",2,0,1,1,18.04,54,136,190
"2012-04-06 22:00:00",2,0,1,1,16.4,34,124,158
"2012-04-06 23:00:00",2,0,1,1,17.22,21,92,113
"2012-04-07 00:00:00",2,0,0,1,17.22,9,85,94
"2012-04-07 01:00:00",2,0,0,1,16.4,9,60,69
"2012-04-07 02:00:00",2,0,0,1,14.76,11,25,36
"2012-04-07 03:00:00",2,0,0,1,14.76,7,21,28
"2012-04-07 04:00:00",2,0,0,1,13.12,3,4,7
"2012-04-07 05:00:00",2,0,0,1,13.12,0,2,2
"2012-04-07 06:00:00",2,0,0,1,13.12,1,18,19
"2012-04-07 07:00:00",2,0,0,1,13.12,14,40,54
"2012-04-07 08:00:00",2,0,0,1,13.94,29,94,123
"2012-04-07 09:00:00",2,0,0,1,16.4,103,173,276
"2012-04-07 10:00:00",2,0,0,1,17.22,187,176,363
"2012-04-07 11:00:00",2,0,0,1,18.04,251,244,495
"2012-04-07 12:00:00",2,0,0,1,18.86,320,270,590
"2012-04-07 13:00:00",2,0,0,1,20.5,355,288,643
"2012-04-07 14:00:00",2,0,0,1,20.5,326,252,578
"2012-04-07 15:00:00",2,0,0,1,21.32,321,305,626
"2012-04-07 16:00:00",2,0,0,1,22.14,354,261,615
"2012-04-07 17:00:00",2,0,0,1,22.14,299,268,567
"2012-04-07 18:00:00",2,0,0,1,22.14,227,290,517
"2012-04-07 19:00:00",2,0,0,1,22.14,170,243,413
"2012-04-07 20:00:00",2,0,0,1,20.5,73,135,208
"2012-04-07 21:00:00",2,0,0,1,20.5,75,159,234
"2012-04-07 22:00:00",2,0,0,1,19.68,76,106,182
"2012-04-07 23:00:00",2,0,0,1,18.86,32,86,118
"2012-04-08 00:00:00",2,0,0,1,18.04,21,64,85
"2012-04-08 01:00:00",2,0,0,1,18.04,14,50,64
"2012-04-08 02:00:00",2,0,0,1,18.04,7,25,32
"2012-04-08 03:00:00",2,0,0,1,17.22,8,18,26
"2012-04-08 04:00:00",2,0,0,1,16.4,0,7,7
"2012-04-08 05:00:00",2,0,0,1,15.58,4,8,12
"2012-04-08 06:00:00",2,0,0,1,14.76,7,21,28
"2012-04-08 07:00:00",2,0,0,1,15.58,12,25,37
"2012-04-08 08:00:00",2,0,0,1,16.4,19,65,84
"2012-04-08 09:00:00",2,0,0,1,18.04,71,108,179
"2012-04-08 10:00:00",2,0,0,1,20.5,113,186,299
"2012-04-08 11:00:00",2,0,0,1,20.5,195,209,404
"2012-04-08 12:00:00",2,0,0,1,22.14,198,259,457
"2012-04-08 13:00:00",2,0,0,1,23.78,229,254,483
"2012-04-08 14:00:00",2,0,0,1,24.6,254,249,503
"2012-04-08 15:00:00",2,0,0,1,25.42,260,226,486
"2012-04-08 16:00:00",2,0,0,1,26.24,232,244,476
"2012-04-08 17:00:00",2,0,0,1,25.42,185,226,411
"2012-04-08 18:00:00",2,0,0,1,25.42,151,159,310
"2012-04-08 19:00:00",2,0,0,1,24.6,89,187,276
"2012-04-08 20:00:00",2,0,0,1,22.96,65,146,211
"2012-04-08 21:00:00",2,0,0,1,21.32,53,77,130
"2012-04-08 22:00:00",2,0,0,1,20.5,33,85,118
"2012-04-08 23:00:00",2,0,0,1,20.5,10,41,51
"2012-04-09 00:00:00",2,0,1,1,19.68,8,29,37
"2012-04-09 01:00:00",2,0,1,1,18.86,4,12,16
"2012-04-09 02:00:00",2,0,1,1,18.86,2,4,6
"2012-04-09 03:00:00",2,0,1,1,18.04,0,3,3
"2012-04-09 04:00:00",2,0,1,1,18.04,2,3,5
"2012-04-09 05:00:00",2,0,1,1,18.04,2,30,32
"2012-04-09 06:00:00",2,0,1,1,17.22,3,108,111
"2012-04-09 07:00:00",2,0,1,1,17.22,11,320,331
"2012-04-09 08:00:00",2,0,1,1,18.04,22,595,617
"2012-04-09 09:00:00",2,0,1,1,18.86,50,236,286
"2012-04-09 10:00:00",2,0,1,1,20.5,65,113,178
"2012-04-09 11:00:00",2,0,1,1,21.32,96,127,223
"2012-04-09 12:00:00",2,0,1,1,22.14,94,186,280
"2012-04-09 13:00:00",2,0,1,1,22.14,108,173,281
"2012-04-09 14:00:00",2,0,1,1,22.96,66,152,218
"2012-04-09 15:00:00",2,0,1,1,23.78,82,173,255
"2012-04-09 16:00:00",2,0,1,1,22.96,81,310,391
"2012-04-09 17:00:00",2,0,1,1,22.14,67,565,632
"2012-04-09 18:00:00",2,0,1,1,22.14,60,586,646
"2012-04-09 19:00:00",2,0,1,1,21.32,35,386,421
"2012-04-09 20:00:00",2,0,1,1,20.5,21,255,276
"2012-04-09 21:00:00",2,0,1,3,19.68,14,151,165
"2012-04-09 22:00:00",2,0,1,2,18.86,6,102,108
"2012-04-09 23:00:00",2,0,1,1,18.04,6,61,67
"2012-04-10 00:00:00",2,0,1,2,18.04,3,23,26
"2012-04-10 01:00:00",2,0,1,1,17.22,0,9,9
"2012-04-10 02:00:00",2,0,1,1,14.76,0,2,2
"2012-04-10 03:00:00",2,0,1,1,14.76,0,2,2
"2012-04-10 04:00:00",2,0,1,1,13.94,0,2,2
"2012-04-10 05:00:00",2,0,1,1,13.94,0,24,24
"2012-04-10 06:00:00",2,0,1,1,13.94,3,100,103
"2012-04-10 07:00:00",2,0,1,1,13.94,16,368,384
"2012-04-10 08:00:00",2,0,1,1,15.58,22,670,692
"2012-04-10 09:00:00",2,0,1,1,17.22,16,303,319
"2012-04-10 10:00:00",2,0,1,1,18.86,49,132,181
"2012-04-10 11:00:00",2,0,1,1,20.5,78,161,239
"2012-04-10 12:00:00",2,0,1,1,22.14,75,184,259
"2012-04-10 13:00:00",2,0,1,1,21.32,81,202,283
"2012-04-10 14:00:00",2,0,1,1,22.14,75,149,224
"2012-04-10 15:00:00",2,0,1,1,22.96,46,157,203
"2012-04-10 16:00:00",2,0,1,1,23.78,66,296,362
"2012-04-10 17:00:00",2,0,1,1,22.96,88,656,744
"2012-04-10 18:00:00",2,0,1,1,22.14,78,626,704
"2012-04-10 19:00:00",2,0,1,1,21.32,51,428,479
"2012-04-10 20:00:00",2,0,1,1,18.86,34,248,282
"2012-04-10 21:00:00",2,0,1,1,18.04,15,191,206
"2012-04-10 22:00:00",2,0,1,1,16.4,9,118,127
"2012-04-10 23:00:00",2,0,1,1,14.76,14,48,62
"2012-04-11 00:00:00",2,0,1,1,13.94,8,22,30
"2012-04-11 01:00:00",2,0,1,1,13.94,3,9,12
"2012-04-11 02:00:00",2,0,1,1,13.12,0,2,2
"2012-04-11 03:00:00",2,0,1,1,12.3,0,2,2
"2012-04-11 05:00:00",2,0,1,1,11.48,1,26,27
"2012-04-11 06:00:00",2,0,1,1,11.48,3,103,106
"2012-04-11 07:00:00",2,0,1,1,11.48,18,303,321
"2012-04-11 08:00:00",2,0,1,1,12.3,14,581,595
"2012-04-11 09:00:00",2,0,1,2,13.12,20,282,302
"2012-04-11 10:00:00",2,0,1,2,13.94,26,127,153
"2012-04-11 11:00:00",2,0,1,2,15.58,38,142,180
"2012-04-11 12:00:00",2,0,1,2,14.76,35,147,182
"2012-04-11 13:00:00",2,0,1,2,16.4,16,147,163
"2012-04-11 14:00:00",2,0,1,1,14.76,34,101,135
"2012-04-11 15:00:00",2,0,1,3,15.58,50,152,202
"2012-04-11 16:00:00",2,0,1,1,18.04,51,256,307
"2012-04-11 17:00:00",2,0,1,1,17.22,52,527,579
"2012-04-11 18:00:00",2,0,1,3,16.4,39,546,585
"2012-04-11 19:00:00",2,0,1,1,16.4,28,356,384
"2012-04-11 20:00:00",2,0,1,1,14.76,22,213,235
"2012-04-11 21:00:00",2,0,1,1,13.94,11,154,165
"2012-04-11 22:00:00",2,0,1,1,13.94,4,130,134
"2012-04-11 23:00:00",2,0,1,1,13.94,9,52,61
"2012-04-12 00:00:00",2,0,1,1,13.12,1,22,23
"2012-04-12 01:00:00",2,0,1,1,13.12,2,7,9
"2012-04-12 02:00:00",2,0,1,1,13.12,0,4,4
"2012-04-12 03:00:00",2,0,1,1,13.12,2,3,5
"2012-04-12 04:00:00",2,0,1,1,12.3,0,1,1
"2012-04-12 05:00:00",2,0,1,1,12.3,0,21,21
"2012-04-12 06:00:00",2,0,1,1,12.3,2,94,96
"2012-04-12 07:00:00",2,0,1,1,12.3,12,294,306
"2012-04-12 08:00:00",2,0,1,1,13.12,20,604,624
"2012-04-12 09:00:00",2,0,1,1,14.76,16,271,287
"2012-04-12 10:00:00",2,0,1,1,16.4,38,103,141
"2012-04-12 11:00:00",2,0,1,1,17.22,50,174,224
"2012-04-12 12:00:00",2,0,1,1,18.86,60,199,259
"2012-04-12 13:00:00",2,0,1,1,19.68,55,148,203
"2012-04-12 14:00:00",2,0,1,1,20.5,74,150,224
"2012-04-12 15:00:00",2,0,1,1,19.68,42,169,211
"2012-04-12 16:00:00",2,0,1,1,19.68,54,299,353
"2012-04-12 17:00:00",2,0,1,1,20.5,60,596,656
"2012-04-12 18:00:00",2,0,1,1,20.5,63,547,610
"2012-04-12 19:00:00",2,0,1,1,18.86,50,383,433
"2012-04-12 20:00:00",2,0,1,1,18.04,26,254,280
"2012-04-12 21:00:00",2,0,1,1,17.22,13,174,187
"2012-04-12 22:00:00",2,0,1,1,17.22,15,143,158
"2012-04-12 23:00:00",2,0,1,1,17.22,8,86,94
"2012-04-13 00:00:00",2,0,1,1,16.4,14,41,55
"2012-04-13 01:00:00",2,0,1,1,14.76,2,28,30
"2012-04-13 02:00:00",2,0,1,1,13.94,6,5,11
"2012-04-13 03:00:00",2,0,1,1,13.94,3,8,11
"2012-04-13 04:00:00",2,0,1,2,13.94,1,4,5
"2012-04-13 05:00:00",2,0,1,2,13.94,2,19,21
"2012-04-13 06:00:00",2,0,1,1,13.12,0,84,84
"2012-04-13 07:00:00",2,0,1,1,13.94,13,283,296
"2012-04-13 08:00:00",2,0,1,1,15.58,24,539,563
"2012-04-13 09:00:00",2,0,1,1,17.22,36,294,330
"2012-04-13 10:00:00",2,0,1,1,18.04,59,133,192
"2012-04-13 11:00:00",2,0,1,1,18.86,75,158,233
"2012-04-13 12:00:00",2,0,1,1,20.5,104,218,322
"2012-04-13 13:00:00",2,0,1,1,21.32,112,246,358
"2012-04-13 14:00:00",2,0,1,1,21.32,125,223,348
"2012-04-13 15:00:00",2,0,1,1,22.14,115,237,352
"2012-04-13 16:00:00",2,0,1,1,22.96,113,350,463
"2012-04-13 17:00:00",2,0,1,1,22.96,117,621,738
"2012-04-13 18:00:00",2,0,1,1,22.14,107,564,671
"2012-04-13 19:00:00",2,0,1,1,22.14,75,352,427
"2012-04-13 20:00:00",2,0,1,1,20.5,44,242,286
"2012-04-13 21:00:00",2,0,1,1,20.5,36,153,189
"2012-04-13 22:00:00",2,0,1,1,18.04,34,181,215
"2012-04-13 23:00:00",2,0,1,1,17.22,35,163,198
"2012-04-14 00:00:00",2,0,0,1,16.4,11,85,96
"2012-04-14 01:00:00",2,0,0,1,16.4,10,60,70
"2012-04-14 02:00:00",2,0,0,1,15.58,3,53,56
"2012-04-14 03:00:00",2,0,0,1,14.76,6,26,32
"2012-04-14 04:00:00",2,0,0,1,14.76,5,9,14
"2012-04-14 05:00:00",2,0,0,1,14.76,2,5,7
"2012-04-14 06:00:00",2,0,0,1,13.94,2,19,21
"2012-04-14 07:00:00",2,0,0,1,14.76,8,56,64
"2012-04-14 08:00:00",2,0,0,1,14.76,24,136,160
"2012-04-14 09:00:00",2,0,0,1,17.22,59,206,265
"2012-04-14 10:00:00",2,0,0,1,18.86,139,267,406
"2012-04-14 11:00:00",2,0,0,1,21.32,207,357,564
"2012-04-14 12:00:00",2,0,0,1,23.78,274,404,678
"2012-04-14 13:00:00",2,0,0,1,25.42,308,370,678
"2012-04-14 14:00:00",2,0,0,2,26.24,288,372,660
"2012-04-14 15:00:00",2,0,0,2,26.24,311,347,658
"2012-04-14 16:00:00",2,0,0,2,26.24,253,329,582
"2012-04-14 17:00:00",2,0,0,2,25.42,251,309,560
"2012-04-14 18:00:00",2,0,0,2,25.42,197,284,481
"2012-04-14 19:00:00",2,0,0,2,24.6,163,296,459
"2012-04-14 20:00:00",2,0,0,2,22.96,112,209,321
"2012-04-14 21:00:00",2,0,0,2,22.96,53,167,220
"2012-04-14 22:00:00",2,0,0,2,22.14,64,148,212
"2012-04-14 23:00:00",2,0,0,2,22.14,45,151,196
"2012-04-15 00:00:00",2,0,0,2,22.14,30,94,124
"2012-04-15 01:00:00",2,0,0,2,22.14,17,89,106
"2012-04-15 02:00:00",2,0,0,2,22.14,20,54,74
"2012-04-15 03:00:00",2,0,0,2,21.32,18,27,45
"2012-04-15 04:00:00",2,0,0,2,22.14,2,10,12
"2012-04-15 05:00:00",2,0,0,1,20.5,4,6,10
"2012-04-15 06:00:00",2,0,0,1,20.5,5,11,16
"2012-04-15 07:00:00",2,0,0,1,20.5,16,30,46
"2012-04-15 08:00:00",2,0,0,1,21.32,33,64,97
"2012-04-15 09:00:00",2,0,0,1,22.14,97,154,251
"2012-04-15 10:00:00",2,0,0,1,23.78,186,235,421
"2012-04-15 11:00:00",2,0,0,1,25.42,227,301,528
"2012-04-15 12:00:00",2,0,0,1,26.24,275,360,635
"2012-04-15 13:00:00",2,0,0,1,27.06,298,383,681
"2012-04-15 14:00:00",2,0,0,1,28.7,282,346,628
"2012-04-15 15:00:00",2,0,0,1,28.7,266,351,617
"2012-04-15 16:00:00",2,0,0,1,29.52,286,330,616
"2012-04-15 17:00:00",2,0,0,1,28.7,262,361,623
"2012-04-15 18:00:00",2,0,0,1,28.7,184,295,479
"2012-04-15 19:00:00",2,0,0,1,28.7,114,265,379
"2012-04-15 20:00:00",2,0,0,1,26.24,86,205,291
"2012-04-15 21:00:00",2,0,0,1,25.42,76,153,229
"2012-04-15 22:00:00",2,0,0,1,27.88,37,97,134
"2012-04-15 23:00:00",2,0,0,1,27.06,25,65,90
"2012-04-16 00:00:00",2,1,0,1,26.24,15,26,41
"2012-04-16 01:00:00",2,1,0,1,25.42,7,21,28
"2012-04-16 02:00:00",2,1,0,1,24.6,5,9,14
"2012-04-16 03:00:00",2,1,0,1,23.78,3,5,8
"2012-04-16 04:00:00",2,1,0,1,22.14,0,6,6
"2012-04-16 05:00:00",2,1,0,1,22.14,4,34,38
"2012-04-16 06:00:00",2,1,0,1,21.32,10,123,133
"2012-04-16 07:00:00",2,1,0,1,21.32,20,367,387
"2012-04-16 08:00:00",2,1,0,2,22.96,48,549,597
"2012-04-16 09:00:00",2,1,0,1,25.42,59,238,297
"2012-04-16 10:00:00",2,1,0,1,25.42,75,149,224
"2012-04-16 11:00:00",2,1,0,1,26.24,115,136,251
"2012-04-16 12:00:00",2,1,0,1,27.88,75,196,271
"2012-04-16 13:00:00",2,1,0,1,30.34,79,184,263
"2012-04-16 14:00:00",2,1,0,1,31.16,105,183,288
"2012-04-16 15:00:00",2,1,0,1,32.8,81,194,275
"2012-04-16 16:00:00",2,1,0,1,32.8,92,266,358
"2012-04-16 17:00:00",2,1,0,1,32.8,111,601,712
"2012-04-16 18:00:00",2,1,0,1,32.8,87,589,676
"2012-04-16 19:00:00",2,1,0,1,31.16,61,461,522
"2012-04-16 20:00:00",2,1,0,1,30.34,48,327,375
"2012-04-16 21:00:00",2,1,0,1,27.88,39,232,271
"2012-04-16 22:00:00",2,1,0,1,27.88,35,179,214
"2012-04-16 23:00:00",2,1,0,1,28.7,24,97,121
"2012-04-17 00:00:00",2,0,1,1,27.06,10,33,43
"2012-04-17 01:00:00",2,0,1,1,26.24,6,5,11
"2012-04-17 02:00:00",2,0,1,1,22.96,1,3,4
"2012-04-17 03:00:00",2,0,1,1,22.96,0,6,6
"2012-04-17 04:00:00",2,0,1,1,27.06,3,6,9
"2012-04-17 05:00:00",2,0,1,1,24.6,1,29,30
"2012-04-17 06:00:00",2,0,1,1,24.6,8,136,144
"2012-04-17 07:00:00",2,0,1,1,24.6,18,443,461
"2012-04-17 08:00:00",2,0,1,1,24.6,42,631,673
"2012-04-17 09:00:00",2,0,1,1,24.6,71,329,400
"2012-04-17 10:00:00",2,0,1,1,24.6,52,165,217
"2012-04-17 11:00:00",2,0,1,1,24.6,65,174,239
"2012-04-17 12:00:00",2,0,1,1,24.6,65,179,244
"2012-04-17 13:00:00",2,0,1,1,25.42,52,187,239
"2012-04-17 14:00:00",2,0,1,1,26.24,59,198,257
"2012-04-17 15:00:00",2,0,1,1,27.06,91,217,308
"2012-04-17 16:00:00",2,0,1,1,27.88,50,320,370
"2012-04-17 17:00:00",2,0,1,1,26.24,108,673,781
"2012-04-17 18:00:00",2,0,1,1,26.24,105,670,775
"2012-04-17 19:00:00",2,0,1,1,24.6,73,464,537
"2012-04-17 20:00:00",2,0,1,1,24.6,44,358,402
"2012-04-17 21:00:00",2,0,1,1,22.96,37,260,297
"2012-04-17 22:00:00",2,0,1,1,22.14,18,144,162
"2012-04-17 23:00:00",2,0,1,1,22.14,10,72,82
"2012-04-18 00:00:00",2,0,1,1,22.14,3,35,38
"2012-04-18 01:00:00",2,0,1,1,21.32,1,13,14
"2012-04-18 02:00:00",2,0,1,2,20.5,1,8,9
"2012-04-18 03:00:00",2,0,1,2,20.5,0,6,6
"2012-04-18 04:00:00",2,0,1,2,20.5,0,7,7
"2012-04-18 05:00:00",2,0,1,2,20.5,0,34,34
"2012-04-18 06:00:00",2,0,1,2,20.5,6,128,134
"2012-04-18 07:00:00",2,0,1,2,20.5,10,408,418
"2012-04-18 08:00:00",2,0,1,3,20.5,25,551,576
"2012-04-18 09:00:00",2,0,1,3,19.68,20,245,265
"2012-04-18 10:00:00",2,0,1,3,19.68,31,116,147
"2012-04-18 11:00:00",2,0,1,3,18.86,14,105,119
"2012-04-18 12:00:00",2,0,1,3,18.86,15,95,110
"2012-04-18 13:00:00",2,0,1,3,18.86,13,51,64
"2012-04-18 14:00:00",2,0,1,3,18.04,8,43,51
"2012-04-18 15:00:00",2,0,1,3,17.22,10,88,98
"2012-04-18 16:00:00",2,0,1,2,17.22,36,199,235
"2012-04-18 17:00:00",2,0,1,2,17.22,46,442,488
"2012-04-18 18:00:00",2,0,1,2,17.22,27,478,505
"2012-04-18 19:00:00",2,0,1,2,17.22,26,342,368
"2012-04-18 20:00:00",2,0,1,2,17.22,8,252,260
"2012-04-18 21:00:00",2,0,1,2,17.22,24,165,189
"2012-04-18 22:00:00",2,0,1,2,17.22,9,153,162
"2012-04-18 23:00:00",2,0,1,2,17.22,14,56,70
"2012-04-19 00:00:00",2,0,1,3,17.22,5,20,25
"2012-04-19 01:00:00",2,0,1,3,17.22,2,11,13
"2012-04-19 02:00:00",2,0,1,2,17.22,2,4,6
"2012-04-19 03:00:00",2,0,1,2,17.22,1,3,4
"2012-04-19 04:00:00",2,0,1,2,17.22,0,4,4
"2012-04-19 05:00:00",2,0,1,1,16.4,0,30,30
"2012-04-19 06:00:00",2,0,1,2,16.4,4,116,120
"2012-04-19 07:00:00",2,0,1,2,16.4,15,391,406
"2012-04-19 08:00:00",2,0,1,2,17.22,26,651,677
"2012-04-19 09:00:00",2,0,1,2,18.86,31,270,301
"2012-04-19 10:00:00",2,0,1,1,19.68,46,143,189
"2012-04-19 11:00:00",2,0,1,1,21.32,46,183,229
"2012-04-19 12:00:00",2,0,1,1,22.14,51,213,264
"2012-04-19 13:00:00",2,0,1,1,22.96,52,186,238
"2012-04-19 14:00:00",2,0,1,1,23.78,54,183,237
"2012-04-19 15:00:00",2,0,1,1,24.6,66,196,262
"2012-04-19 16:00:00",2,0,1,1,25.42,63,324,387
"2012-04-19 17:00:00",2,0,1,1,24.6,85,663,748
"2012-04-19 18:00:00",2,0,1,1,24.6,99,677,776
"2012-04-19 19:00:00",2,0,1,1,23.78,70,516,586
"2012-04-19 20:00:00",2,0,1,1,22.96,52,352,404
"2012-04-19 21:00:00",2,0,1,1,21.32,27,240,267
"2012-04-19 22:00:00",2,0,1,1,21.32,29,219,248
"2012-04-19 23:00:00",2,0,1,1,20.5,20,124,144
"2012-05-01 00:00:00",2,0,1,2,20.5,7,28,35
"2012-05-01 01:00:00",2,0,1,2,20.5,0,21,21
"2012-05-01 02:00:00",2,0,1,2,20.5,1,7,8
"2012-05-01 03:00:00",2,0,1,2,20.5,1,2,3
"2012-05-01 04:00:00",2,0,1,2,21.32,1,7,8
"2012-05-01 05:00:00",2,0,1,2,21.32,0,17,17
"2012-05-01 06:00:00",2,0,1,3,21.32,2,24,26
"2012-05-01 07:00:00",2,0,1,2,20.5,8,161,169
"2012-05-01 08:00:00",2,0,1,2,21.32,19,538,557
"2012-05-01 09:00:00",2,0,1,2,22.14,18,331,349
"2012-05-01 10:00:00",2,0,1,1,25.42,30,144,174
"2012-05-01 11:00:00",2,0,1,2,27.06,50,179,229
"2012-05-01 12:00:00",2,0,1,2,28.7,41,228,269
"2012-05-01 13:00:00",2,0,1,2,29.52,41,208,249
"2012-05-01 14:00:00",2,0,1,2,30.34,37,167,204
"2012-05-01 15:00:00",2,0,1,2,30.34,48,186,234
"2012-05-01 16:00:00",2,0,1,1,30.34,41,313,354
"2012-05-01 17:00:00",2,0,1,1,30.34,65,616,681
"2012-05-01 18:00:00",2,0,1,1,28.7,81,662,743
"2012-05-01 19:00:00",2,0,1,1,28.7,58,429,487
"2012-05-01 20:00:00",2,0,1,1,27.06,36,299,335
"2012-05-01 21:00:00",2,0,1,1,26.24,31,251,282
"2012-05-01 22:00:00",2,0,1,1,26.24,21,190,211
"2012-05-01 23:00:00",2,0,1,1,24.6,16,79,95
"2012-05-02 00:00:00",2,0,1,1,24.6,4,43,47
"2012-05-02 01:00:00",2,0,1,1,22.96,8,7,15
"2012-05-02 02:00:00",2,0,1,1,22.96,7,9,16
"2012-05-02 03:00:00",2,0,1,1,22.96,0,6,6
"2012-05-02 04:00:00",2,0,1,1,22.14,2,2,4
"2012-05-02 05:00:00",2,0,1,1,22.14,2,31,33
"2012-05-02 06:00:00",2,0,1,3,22.96,3,117,120
"2012-05-02 07:00:00",2,0,1,2,22.14,14,344,358
"2012-05-02 08:00:00",2,0,1,2,22.96,26,640,666
"2012-05-02 09:00:00",2,0,1,2,22.96,26,289,315
"2012-05-02 10:00:00",2,0,1,2,23.78,28,147,175
"2012-05-02 11:00:00",2,0,1,2,23.78,39,145,184
"2012-05-02 12:00:00",2,0,1,2,23.78,35,210,245
"2012-05-02 13:00:00",2,0,1,2,23.78,49,179,228
"2012-05-02 14:00:00",2,0,1,1,25.42,51,189,240
"2012-05-02 15:00:00",2,0,1,1,26.24,52,204,256
"2012-05-02 16:00:00",2,0,1,1,26.24,54,313,367
"2012-05-02 17:00:00",2,0,1,1,24.6,70,659,729
"2012-05-02 18:00:00",2,0,1,1,22.96,43,770,813
"2012-05-02 19:00:00",2,0,1,1,22.14,43,461,504
"2012-05-02 20:00:00",2,0,1,1,21.32,42,296,338
"2012-05-02 21:00:00",2,0,1,1,21.32,21,218,239
"2012-05-02 22:00:00",2,0,1,1,20.5,27,146,173
"2012-05-02 23:00:00",2,0,1,2,20.5,21,77,98
"2012-05-03 00:00:00",2,0,1,2,19.68,15,75,90
"2012-05-03 01:00:00",2,0,1,2,18.86,9,15,24
"2012-05-03 02:00:00",2,0,1,2,18.86,4,13,17
"2012-05-03 03:00:00",2,0,1,2,18.86,2,4,6
"2012-05-03 04:00:00",2,0,1,2,18.86,0,2,2
"2012-05-03 05:00:00",2,0,1,2,18.86,1,20,21
"2012-05-03 06:00:00",2,0,1,2,18.86,8,128,136
"2012-05-03 07:00:00",2,0,1,3,18.04,8,376,384
"2012-05-03 08:00:00",2,0,1,3,18.86,19,608,627
"2012-05-03 09:00:00",2,0,1,2,19.68,25,279,304
"2012-05-03 10:00:00",2,0,1,2,21.32,36,132,168
"2012-05-03 11:00:00",2,0,1,1,22.14,34,167,201
"2012-05-03 12:00:00",2,0,1,1,22.96,64,237,301
"2012-05-03 13:00:00",2,0,1,1,24.6,48,217,265
"2012-05-03 14:00:00",2,0,1,1,26.24,33,171,204
"2012-05-03 15:00:00",2,0,1,1,27.06,63,220,283
"2012-05-03 16:00:00",2,0,1,1,27.88,45,325,370
"2012-05-03 17:00:00",2,0,1,1,29.52,87,617,704
"2012-05-03 18:00:00",2,0,1,1,29.52,64,642,706
"2012-05-03 19:00:00",2,0,1,1,28.7,55,467,522
"2012-05-03 20:00:00",2,0,1,1,26.24,52,368,420
"2012-05-03 21:00:00",2,0,1,1,25.42,42,257,299
"2012-05-03 22:00:00",2,0,1,1,25.42,29,217,246
"2012-05-03 23:00:00",2,0,1,1,24.6,21,100,121
"2012-05-04 00:00:00",2,0,1,1,24.6,19,70,89
"2012-05-04 01:00:00",2,0,1,1,24.6,15,33,48
"2012-05-04 02:00:00",2,0,1,1,23.78,0,11,11
"2012-05-04 03:00:00",2,0,1,1,22.96,0,14,14
"2012-05-04 04:00:00",2,0,1,1,22.96,0,4,4
"2012-05-04 05:00:00",2,0,1,1,22.96,0,24,24
"2012-05-04 06:00:00",2,0,1,1,22.14,8,127,135
"2012-05-04 07:00:00",2,0,1,1,22.96,9,347,356
"2012-05-04 08:00:00",2,0,1,1,22.96,34,584,618
"2012-05-04 09:00:00",2,0,1,1,24.6,32,262,294
"2012-05-04 10:00:00",2,0,1,2,25.42,45,154,199
"2012-05-04 11:00:00",2,0,1,2,28.7,77,181,258
"2012-05-04 12:00:00",2,0,1,3,25.42,46,125,171
"2012-05-04 13:00:00",2,0,1,2,26.24,71,207,278
"2012-05-04 14:00:00",2,0,1,2,27.06,83,159,242
"2012-05-04 15:00:00",2,0,1,2,29.52,103,240,343
"2012-05-04 16:00:00",2,0,1,1,31.16,82,358,440
"2012-05-04 17:00:00",2,0,1,1,28.7,96,547,643
"2012-05-04 18:00:00",2,0,1,1,28.7,77,564,641
"2012-05-04 19:00:00",2,0,1,1,28.7,64,388,452
"2012-05-04 20:00:00",2,0,1,1,27.88,58,255,313
"2012-05-04 21:00:00",2,0,1,1,26.24,49,186,235
"2012-05-04 22:00:00",2,0,1,1,24.6,50,182,232
"2012-05-04 23:00:00",2,0,1,1,24.6,51,205,256
"2012-05-05 00:00:00",2,0,0,1,24.6,42,111,153
"2012-05-05 01:00:00",2,0,0,1,24.6,28,79,107
"2012-05-05 02:00:00",2,0,0,1,23.78,24,51,75
"2012-05-05 03:00:00",2,0,0,1,23.78,11,21,32
"2012-05-05 04:00:00",2,0,0,1,22.96,0,9,9
"2012-05-05 05:00:00",2,0,0,1,22.96,8,14,22
"2012-05-05 06:00:00",2,0,0,2,22.14,9,33,42
"2012-05-05 07:00:00",2,0,0,1,22.96,8,79,87
"2012-05-05 08:00:00",2,0,0,1,23.78,42,155,197
"2012-05-05 09:00:00",2,0,0,1,25.42,61,223,284
"2012-05-05 10:00:00",2,0,0,1,27.06,148,284,432
"2012-05-05 11:00:00",2,0,0,1,28.7,221,354,575
"2012-05-05 12:00:00",2,0,0,1,29.52,220,330,550
"2012-05-05 13:00:00",2,0,0,1,30.34,217,307,524
"2012-05-05 14:00:00",2,0,0,3,28.7,187,241,428
"2012-05-05 15:00:00",2,0,0,3,27.06,241,300,541
"2012-05-05 16:00:00",2,0,0,2,27.88,230,310,540
"2012-05-05 17:00:00",2,0,0,2,27.88,204,298,502
"2012-05-05 18:00:00",2,0,0,2,27.06,156,278,434
"2012-05-05 19:00:00",2,0,0,2,25.42,151,254,405
"2012-05-05 20:00:00",2,0,0,1,24.6,100,209,309
"2012-05-05 21:00:00",2,0,0,2,23.78,86,183,269
"2012-05-05 22:00:00",2,0,0,2,23.78,67,150,217
"2012-05-05 23:00:00",2,0,0,2,22.96,35,114,149
"2012-05-06 00:00:00",2,0,0,2,22.96,23,111,134
"2012-05-06 01:00:00",2,0,0,2,22.14,37,84,121
"2012-05-06 02:00:00",2,0,0,2,22.14,29,64,93
"2012-05-06 03:00:00",2,0,0,2,22.14,9,19,28
"2012-05-06 04:00:00",2,0,0,3,21.32,9,7,16
"2012-05-06 05:00:00",2,0,0,3,21.32,1,10,11
"2012-05-06 06:00:00",2,0,0,3,21.32,3,14,17
"2012-05-06 07:00:00",2,0,0,3,21.32,5,31,36
"2012-05-06 08:00:00",2,0,0,2,20.5,23,91,114
"2012-05-06 09:00:00",2,0,0,2,21.32,63,128,191
"2012-05-06 10:00:00",2,0,0,2,22.14,112,221,333
"2012-05-06 11:00:00",2,0,0,1,22.96,144,270,414
"2012-05-06 12:00:00",2,0,0,2,24.6,207,351,558
"2012-05-06 13:00:00",2,0,0,2,24.6,197,368,565
"2012-05-06 14:00:00",2,0,0,2,24.6,226,292,518
"2012-05-06 15:00:00",2,0,0,2,25.42,229,342,571
"2012-05-06 16:00:00",2,0,0,2,25.42,181,363,544
"2012-05-06 17:00:00",2,0,0,2,25.42,195,316,511
"2012-05-06 18:00:00",2,0,0,2,25.42,131,332,463
"2012-05-06 19:00:00",2,0,0,2,24.6,117,266,383
"2012-05-06 20:00:00",2,0,0,1,24.6,73,203,276
"2012-05-06 21:00:00",2,0,0,1,22.96,55,148,203
"2012-05-06 22:00:00",2,0,0,1,22.96,44,113,157
"2012-05-06 23:00:00",2,0,0,1,21.32,22,80,102
"2012-05-07 00:00:00",2,0,1,2,21.32,13,21,34
"2012-05-07 01:00:00",2,0,1,2,21.32,1,8,9
"2012-05-07 02:00:00",2,0,1,1,20.5,1,5,6
"2012-05-07 03:00:00",2,0,1,1,20.5,2,3,5
"2012-05-07 04:00:00",2,0,1,2,18.86,0,2,2
"2012-05-07 05:00:00",2,0,1,1,18.86,2,21,23
"2012-05-07 06:00:00",2,0,1,1,18.86,8,134,142
"2012-05-07 07:00:00",2,0,1,2,19.68,18,367,385
"2012-05-07 08:00:00",2,0,1,2,20.5,31,608,639
"2012-05-07 09:00:00",2,0,1,2,20.5,61,289,350
"2012-05-07 10:00:00",2,0,1,2,21.32,62,128,190
"2012-05-07 11:00:00",2,0,1,2,22.14,64,149,213
"2012-05-07 12:00:00",2,0,1,2,22.96,74,189,263
"2012-05-07 13:00:00",2,0,1,2,24.6,75,197,272
"2012-05-07 14:00:00",2,0,1,2,25.42,59,180,239
"2012-05-07 15:00:00",2,0,1,2,25.42,76,186,262
"2012-05-07 16:00:00",2,0,1,2,24.6,68,320,388
"2012-05-07 17:00:00",2,0,1,2,24.6,102,667,769
"2012-05-07 18:00:00",2,0,1,2,24.6,78,602,680
"2012-05-07 19:00:00",2,0,1,1,23.78,83,463,546
"2012-05-07 20:00:00",2,0,1,1,22.14,46,277,323
"2012-05-07 21:00:00",2,0,1,2,22.14,37,210,247
"2012-05-07 22:00:00",2,0,1,2,22.14,26,147,173
"2012-05-07 23:00:00",2,0,1,2,22.14,21,92,113
"2012-05-08 00:00:00",2,0,1,2,21.32,10,28,38
"2012-05-08 01:00:00",2,0,1,2,21.32,6,3,9
"2012-05-08 02:00:00",2,0,1,2,21.32,9,7,16
"2012-05-08 03:00:00",2,0,1,2,21.32,2,4,6
"2012-05-08 04:00:00",2,0,1,2,21.32,0,5,5
"2012-05-08 05:00:00",2,0,1,2,21.32,0,20,20
"2012-05-08 06:00:00",2,0,1,1,20.5,7,158,165
"2012-05-08 07:00:00",2,0,1,1,21.32,21,442,463
"2012-05-08 08:00:00",2,0,1,2,22.14,36,605,641
"2012-05-08 09:00:00",2,0,1,2,22.96,37,258,295
"2012-05-08 10:00:00",2,0,1,2,23.78,46,111,157
"2012-05-08 11:00:00",2,0,1,2,24.6,60,157,217
"2012-05-08 12:00:00",2,0,1,2,25.42,60,203,263
"2012-05-08 13:00:00",2,0,1,3,26.24,53,166,219
"2012-05-08 14:00:00",2,0,1,3,25.42,8,63,71
"2012-05-08 15:00:00",2,0,1,3,25.42,40,94,134
"2012-05-08 16:00:00",2,0,1,3,26.24,54,335,389
"2012-05-08 17:00:00",2,0,1,2,26.24,77,640,717
"2012-05-08 18:00:00",2,0,1,2,26.24,69,641,710
"2012-05-08 19:00:00",2,0,1,2,26.24,59,399,458
"2012-05-08 20:00:00",2,0,1,2,26.24,40,262,302
"2012-05-08 21:00:00",2,0,1,2,26.24,21,202,223
"2012-05-08 22:00:00",2,0,1,3,24.6,13,134,147
"2012-05-08 23:00:00",2,0,1,3,24.6,10,53,63
"2012-05-09 00:00:00",2,0,1,2,23.78,8,27,35
"2012-05-09 01:00:00",2,0,1,2,24.6,3,11,14
"2012-05-09 02:00:00",2,0,1,3,22.96,0,1,1
"2012-05-09 03:00:00",2,0,1,3,22.96,0,2,2
"2012-05-09 04:00:00",2,0,1,3,22.96,0,5,5
"2012-05-09 05:00:00",2,0,1,2,22.96,1,27,28
"2012-05-09 06:00:00",2,0,1,2,22.96,5,121,126
"2012-05-09 07:00:00",2,0,1,2,22.96,17,401,418
"2012-05-09 08:00:00",2,0,1,2,24.6,28,594,622
"2012-05-09 09:00:00",2,0,1,2,24.6,40,285,325
"2012-05-09 10:00:00",2,0,1,2,25.42,40,113,153
"2012-05-09 11:00:00",2,0,1,2,25.42,45,156,201
"2012-05-09 12:00:00",2,0,1,2,25.42,58,222,280
"2012-05-09 13:00:00",2,0,1,2,26.24,50,216,266
"2012-05-09 14:00:00",2,0,1,2,26.24,68,175,243
"2012-05-09 15:00:00",2,0,1,2,26.24,68,191,259
"2012-05-09 16:00:00",2,0,1,2,27.06,68,289,357
"2012-05-09 17:00:00",2,0,1,2,26.24,76,629,705
"2012-05-09 18:00:00",2,0,1,3,21.32,23,349,372
"2012-05-09 19:00:00",2,0,1,3,20.5,2,96,98
"2012-05-09 20:00:00",2,0,1,3,20.5,3,48,51
"2012-05-09 21:00:00",2,0,1,3,20.5,4,30,34
"2012-05-09 22:00:00",2,0,1,3,19.68,5,62,67
"2012-05-09 23:00:00",2,0,1,3,19.68,8,47,55
"2012-05-10 00:00:00",2,0,1,3,20.5,2,31,33
"2012-05-10 01:00:00",2,0,1,2,19.68,2,9,11
"2012-05-10 02:00:00",2,0,1,2,19.68,0,3,3
"2012-05-10 03:00:00",2,0,1,1,18.86,0,3,3
"2012-05-10 04:00:00",2,0,1,1,18.86,0,2,2
"2012-05-10 05:00:00",2,0,1,1,18.86,1,23,24
"2012-05-10 06:00:00",2,0,1,1,18.04,9,130,139
"2012-05-10 07:00:00",2,0,1,1,18.04,8,393,401
"2012-05-10 08:00:00",2,0,1,1,18.86,27,603,630
"2012-05-10 09:00:00",2,0,1,1,20.5,62,299,361
"2012-05-10 10:00:00",2,0,1,1,20.5,42,112,154
"2012-05-10 11:00:00",2,0,1,1,21.32,77,179,256
"2012-05-10 12:00:00",2,0,1,1,21.32,65,207,272
"2012-05-10 13:00:00",2,0,1,1,22.14,90,228,318
"2012-05-10 14:00:00",2,0,1,1,22.96,61,186,247
"2012-05-10 15:00:00",2,0,1,1,22.14,79,192,271
"2012-05-10 16:00:00",2,0,1,1,23.78,87,334,421
"2012-05-10 17:00:00",2,0,1,1,24.6,84,648,732
"2012-05-10 18:00:00",2,0,1,1,22.96,109,661,770
"2012-05-10 19:00:00",2,0,1,1,22.14,84,469,553
"2012-05-10 20:00:00",2,0,1,1,21.32,59,315,374
"2012-05-10 21:00:00",2,0,1,1,20.5,19,211,230
"2012-05-10 22:00:00",2,0,1,1,20.5,36,196,232
"2012-05-10 23:00:00",2,0,1,1,19.68,23,112,135
"2012-05-11 00:00:00",2,0,1,1,18.86,17,47,64
"2012-05-11 01:00:00",2,0,1,1,18.86,14,32,46
"2012-05-11 02:00:00",2,0,1,1,18.86,15,16,31
"2012-05-11 03:00:00",2,0,1,1,18.86,5,8,13
"2012-05-11 04:00:00",2,0,1,1,17.22,3,6,9
"2012-05-11 05:00:00",2,0,1,1,17.22,3,23,26
"2012-05-11 06:00:00",2,0,1,1,17.22,7,128,135
"2012-05-11 07:00:00",2,0,1,1,17.22,6,345,351
"2012-05-11 08:00:00",2,0,1,1,18.86,41,579,620
"2012-05-11 09:00:00",2,0,1,1,19.68,34,288,322
"2012-05-11 10:00:00",2,0,1,1,21.32,69,141,210
"2012-05-11 11:00:00",2,0,1,1,22.96,88,203,291
"2012-05-11 12:00:00",2,0,1,1,22.96,89,259,348
"2012-05-11 13:00:00",2,0,1,1,24.6,100,263,363
"2012-05-11 14:00:00",2,0,1,1,25.42,116,218,334
"2012-05-11 15:00:00",2,0,1,1,25.42,140,299,439
"2012-05-11 16:00:00",2,0,1,1,25.42,128,397,525
"2012-05-11 17:00:00",2,0,1,1,26.24,102,677,779
"2012-05-11 18:00:00",2,0,1,1,26.24,78,518,596
"2012-05-11 19:00:00",2,0,1,1,26.24,73,430,503
"2012-05-11 20:00:00",2,0,1,1,25.42,64,277,341
"2012-05-11 21:00:00",2,0,1,1,24.6,45,225,270
"2012-05-11 22:00:00",2,0,1,1,22.96,44,190,234
"2012-05-11 23:00:00",2,0,1,1,22.14,38,142,180
"2012-05-12 00:00:00",2,0,0,1,21.32,25,111,136
"2012-05-12 01:00:00",2,0,0,1,20.5,14,79,93
"2012-05-12 02:00:00",2,0,0,1,18.86,10,46,56
"2012-05-12 03:00:00",2,0,0,1,19.68,14,20,34
"2012-05-12 04:00:00",2,0,0,1,18.04,3,6,9
"2012-05-12 05:00:00",2,0,0,1,17.22,5,8,13
"2012-05-12 06:00:00",2,0,0,1,17.22,10,23,33
"2012-05-12 07:00:00",2,0,0,1,17.22,10,57,67
"2012-05-12 08:00:00",2,0,0,1,21.32,22,156,178
"2012-05-12 09:00:00",2,0,0,1,22.14,87,248,335
"2012-05-12 10:00:00",2,0,0,1,22.96,132,279,411
"2012-05-12 11:00:00",2,0,0,1,25.42,157,365,522
"2012-05-12 12:00:00",2,0,0,1,26.24,206,353,559
"2012-05-12 13:00:00",2,0,0,1,26.24,293,366,659
"2012-05-12 14:00:00",2,0,0,1,27.06,257,358,615
"2012-05-12 15:00:00",2,0,0,1,27.88,269,321,590
"2012-05-12 16:00:00",2,0,0,2,28.7,254,337,591
"2012-05-12 17:00:00",2,0,0,2,27.06,233,343,576
"2012-05-12 18:00:00",2,0,0,2,27.06,164,382,546
"2012-05-12 19:00:00",2,0,0,2,26.24,166,273,439
"2012-05-12 20:00:00",2,0,0,1,25.42,113,174,287
"2012-05-12 21:00:00",2,0,0,2,24.6,74,156,230
"2012-05-12 22:00:00",2,0,0,1,22.96,62,212,274
"2012-05-12 23:00:00",2,0,0,1,23.78,42,134,176
"2012-05-13 00:00:00",2,0,0,1,22.96,19,79,98
"2012-05-13 01:00:00",2,0,0,2,22.14,22,72,94
"2012-05-13 02:00:00",2,0,0,2,22.14,22,60,82
"2012-05-13 03:00:00",2,0,0,2,22.14,2,26,28
"2012-05-13 04:00:00",2,0,0,2,22.14,2,7,9
"2012-05-13 05:00:00",2,0,0,1,21.32,4,8,12
"2012-05-13 06:00:00",2,0,0,1,21.32,6,15,21
"2012-05-13 07:00:00",2,0,0,1,21.32,18,42,60
"2012-05-13 08:00:00",2,0,0,1,22.96,32,124,156
"2012-05-13 09:00:00",2,0,0,1,24.6,79,143,222
"2012-05-13 10:00:00",2,0,0,1,24.6,128,222,350
"2012-05-13 11:00:00",2,0,0,1,25.42,150,278,428
"2012-05-13 12:00:00",2,0,0,1,26.24,189,342,531
"2012-05-13 13:00:00",2,0,0,1,27.88,255,347,602
"2012-05-13 14:00:00",2,0,0,1,28.7,228,324,552
"2012-05-13 15:00:00",2,0,0,1,29.52,190,309,499
"2012-05-13 16:00:00",2,0,0,1,29.52,225,339,564
"2012-05-13 17:00:00",2,0,0,1,28.7,191,287,478
"2012-05-13 18:00:00",2,0,0,2,27.88,129,260,389
"2012-05-13 19:00:00",2,0,0,2,27.06,107,232,339
"2012-05-13 20:00:00",2,0,0,2,27.06,67,163,230
"2012-05-13 21:00:00",2,0,0,2,26.24,48,121,169
"2012-05-13 22:00:00",2,0,0,2,25.42,42,89,131
"2012-05-13 23:00:00",2,0,0,2,25.42,17,57,74
"2012-05-14 00:00:00",2,0,1,2,24.6,21,14,35
"2012-05-14 01:00:00",2,0,1,2,24.6,5,6,11
"2012-05-14 02:00:00",2,0,1,1,24.6,1,1,2
"2012-05-14 03:00:00",2,0,1,2,23.78,0,2,2
"2012-05-14 04:00:00",2,0,1,2,22.14,3,3,6
"2012-05-14 05:00:00",2,0,1,2,22.14,1,25,26
"2012-05-14 06:00:00",2,0,1,3,21.32,3,62,65
"2012-05-14 07:00:00",2,0,1,3,21.32,3,72,75
"2012-05-14 08:00:00",2,0,1,3,22.14,1,155,156
"2012-05-14 09:00:00",2,0,1,3,22.14,5,105,110
"2012-05-14 10:00:00",2,0,1,3,22.14,6,53,59
"2012-05-14 11:00:00",2,0,1,2,22.96,12,67,79
"2012-05-14 12:00:00",2,0,1,2,22.96,53,132,185
"2012-05-14 13:00:00",2,0,1,2,25.42,33,143,176
"2012-05-14 14:00:00",2,0,1,2,25.42,43,128,171
"2012-05-14 15:00:00",2,0,1,2,25.42,40,156,196
"2012-05-14 16:00:00",2,0,1,3,25.42,20,91,111
"2012-05-14 17:00:00",2,0,1,3,22.96,25,204,229
"2012-05-14 18:00:00",2,0,1,2,23.78,17,283,300
"2012-05-14 19:00:00",2,0,1,3,23.78,10,294,304
"2012-05-14 20:00:00",2,0,1,2,23.78,11,178,189
"2012-05-14 21:00:00",2,0,1,2,23.78,7,145,152
"2012-05-14 22:00:00",2,0,1,2,23.78,11,118,129
"2012-05-14 23:00:00",2,0,1,2,23.78,11,64,75
"2012-05-15 00:00:00",2,0,1,2,22.96,7,25,32
"2012-05-15 01:00:00",2,0,1,3,22.96,5,14,19
"2012-05-15 02:00:00",2,0,1,2,22.96,1,3,4
"2012-05-15 03:00:00",2,0,1,3,23.78,1,5,6
"2012-05-15 04:00:00",2,0,1,3,22.96,1,4,5
"2012-05-15 05:00:00",2,0,1,3,22.96,0,8,8
"2012-05-15 06:00:00",2,0,1,3,22.96,2,22,24
"2012-05-15 07:00:00",2,0,1,3,22.96,1,91,92
"2012-05-15 08:00:00",2,0,1,2,23.78,8,401,409
"2012-05-15 09:00:00",2,0,1,2,23.78,28,327,355
"2012-05-15 10:00:00",2,0,1,1,25.42,27,144,171
"2012-05-15 11:00:00",2,0,1,1,26.24,38,186,224
"2012-05-15 12:00:00",2,0,1,1,26.24,44,220,264
"2012-05-15 13:00:00",2,0,1,3,26.24,35,204,239
"2012-05-15 14:00:00",2,0,1,2,26.24,39,145,184
"2012-05-15 15:00:00",2,0,1,2,28.7,51,205,256
"2012-05-15 16:00:00",2,0,1,1,27.88,74,300,374
"2012-05-15 17:00:00",2,0,1,1,27.88,75,603,678
"2012-05-15 18:00:00",2,0,1,1,28.7,68,665,733
"2012-05-15 19:00:00",2,0,1,1,27.06,57,455,512
"2012-05-15 20:00:00",2,0,1,3,26.24,30,233,263
"2012-05-15 21:00:00",2,0,1,3,26.24,11,98,109
"2012-05-15 22:00:00",2,0,1,1,23.78,9,74,83
"2012-05-15 23:00:00",2,0,1,3,22.96,13,58,71
"2012-05-16 00:00:00",2,0,1,2,23.78,12,27,39
"2012-05-16 01:00:00",2,0,1,2,23.78,7,14,21
"2012-05-16 02:00:00",2,0,1,1,22.96,5,14,19
"2012-05-16 03:00:00",2,0,1,1,22.96,1,5,6
"2012-05-16 04:00:00",2,0,1,1,22.14,1,3,4
"2012-05-16 05:00:00",2,0,1,1,22.14,4,34,38
"2012-05-16 06:00:00",2,0,1,1,22.14,8,150,158
"2012-05-16 07:00:00",2,0,1,1,22.96,14,426,440
"2012-05-16 08:00:00",2,0,1,1,23.78,33,617,650
"2012-05-16 09:00:00",2,0,1,2,24.6,33,314,347
"2012-05-16 10:00:00",2,0,1,1,27.06,43,149,192
"2012-05-16 11:00:00",2,0,1,1,28.7,55,212,267
"2012-05-16 12:00:00",2,0,1,1,28.7,59,271,330
"2012-05-16 13:00:00",2,0,1,1,29.52,77,273,350
"2012-05-16 14:00:00",2,0,1,1,29.52,42,221,263
"2012-05-16 15:00:00",2,0,1,2,29.52,52,222,274
"2012-05-16 16:00:00",2,0,1,1,29.52,70,376,446
"2012-05-16 17:00:00",2,0,1,1,29.52,104,769,873
"2012-05-16 18:00:00",2,0,1,1,29.52,97,749,846
"2012-05-16 19:00:00",2,0,1,1,28.7,91,499,590
"2012-05-16 20:00:00",2,0,1,1,27.06,61,398,459
"2012-05-16 21:00:00",2,0,1,1,26.24,63,330,393
"2012-05-16 22:00:00",2,0,1,1,26.24,33,253,286
"2012-05-16 23:00:00",2,0,1,1,25.42,26,107,133
"2012-05-17 00:00:00",2,0,1,1,24.6,30,49,79
"2012-05-17 01:00:00",2,0,1,1,24.6,12,16,28
"2012-05-17 02:00:00",2,0,1,1,24.6,8,8,16
"2012-05-17 03:00:00",2,0,1,1,24.6,0,3,3
"2012-05-17 04:00:00",2,0,1,1,24.6,3,13,16
"2012-05-17 05:00:00",2,0,1,1,22.96,1,34,35
"2012-05-17 06:00:00",2,0,1,1,22.14,10,149,159
"2012-05-17 07:00:00",2,0,1,1,22.14,25,449,474
"2012-05-17 08:00:00",2,0,1,1,21.32,29,605,634
"2012-05-17 09:00:00",2,0,1,1,22.14,57,289,346
"2012-05-17 10:00:00",2,0,1,1,22.96,43,162,205
"2012-05-17 11:00:00",2,0,1,1,23.78,77,202,279
"2012-05-17 12:00:00",2,0,1,1,24.6,72,276,348
"2012-05-17 13:00:00",2,0,1,1,25.42,86,241,327
"2012-05-17 14:00:00",2,0,1,1,26.24,68,202,270
"2012-05-17 15:00:00",2,0,1,1,26.24,83,233,316
"2012-05-17 16:00:00",2,0,1,1,27.06,86,344,430
"2012-05-17 17:00:00",2,0,1,1,27.06,133,719,852
"2012-05-17 18:00:00",2,0,1,1,27.06,134,734,868
"2012-05-17 19:00:00",2,0,1,1,26.24,86,451,537
"2012-05-17 20:00:00",2,0,1,1,24.6,83,363,446
"2012-05-17 21:00:00",2,0,1,1,23.78,45,254,299
"2012-05-17 22:00:00",2,0,1,1,22.96,42,209,251
"2012-05-17 23:00:00",2,0,1,1,22.14,29,137,166
"2012-05-18 00:00:00",2,0,1,1,21.32,13,57,70
"2012-05-18 01:00:00",2,0,1,1,20.5,16,33,49
"2012-05-18 02:00:00",2,0,1,1,19.68,12,9,21
"2012-05-18 03:00:00",2,0,1,1,18.86,6,8,14
"2012-05-18 04:00:00",2,0,1,1,18.86,0,11,11
"2012-05-18 05:00:00",2,0,1,1,18.86,1,33,34
"2012-05-18 06:00:00",2,0,1,1,18.04,14,168,182
"2012-05-18 07:00:00",2,0,1,1,18.86,40,475,515
"2012-05-18 08:00:00",2,0,1,1,21.32,49,696,745
"2012-05-18 09:00:00",2,0,1,1,22.96,57,304,361
"2012-05-18 10:00:00",2,0,1,1,24.6,74,181,255
"2012-05-18 11:00:00",2,0,1,1,25.42,109,225,334
"2012-05-18 12:00:00",2,0,1,1,25.42,108,252,360
"2012-05-18 13:00:00",2,0,1,1,26.24,98,297,395
"2012-05-18 14:00:00",2,0,1,1,27.06,108,242,350
"2012-05-18 15:00:00",2,0,1,1,27.06,131,260,391
"2012-05-18 16:00:00",2,0,1,1,27.06,151,417,568
"2012-05-18 17:00:00",2,0,1,1,27.06,124,688,812
"2012-05-18 18:00:00",2,0,1,1,26.24,99,570,669
"2012-05-18 19:00:00",2,0,1,1,25.42,91,392,483
"2012-05-18 20:00:00",2,0,1,1,25.42,73,264,337
"2012-05-18 21:00:00",2,0,1,1,24.6,49,209,258
"2012-05-18 22:00:00",2,0,1,1,22.96,57,194,251
"2012-05-18 23:00:00",2,0,1,1,21.32,41,133,174
"2012-05-19 00:00:00",2,0,0,1,21.32,30,118,148
"2012-05-19 01:00:00",2,0,0,1,20.5,20,84,104
"2012-05-19 02:00:00",2,0,0,1,20.5,13,56,69
"2012-05-19 03:00:00",2,0,0,1,20.5,10,23,33
"2012-05-19 04:00:00",2,0,0,1,19.68,6,8,14
"2012-05-19 05:00:00",2,0,0,1,18.86,1,11,12
"2012-05-19 06:00:00",2,0,0,1,18.04,12,38,50
"2012-05-19 07:00:00",2,0,0,1,18.86,28,67,95
"2012-05-19 08:00:00",2,0,0,1,21.32,33,162,195
"2012-05-19 09:00:00",2,0,0,1,22.96,79,213,292
"2012-05-19 10:00:00",2,0,0,1,22.96,177,275,452
"2012-05-19 11:00:00",2,0,0,1,25.42,235,351,586
"2012-05-19 12:00:00",2,0,0,1,27.06,276,366,642
"2012-05-19 13:00:00",2,0,0,1,28.7,332,372,704
"2012-05-19 14:00:00",2,0,0,1,29.52,361,369,730
"2012-05-19 15:00:00",2,0,0,1,29.52,356,316,672
"2012-05-19 16:00:00",2,0,0,1,30.34,331,311,642
"2012-05-19 17:00:00",2,0,0,1,30.34,279,347,626
"2012-05-19 18:00:00",2,0,0,1,30.34,254,391,645
"2012-05-19 19:00:00",2,0,0,1,28.7,203,229,432
"2012-05-19 20:00:00",2,0,0,1,27.88,118,197,315
"2012-05-19 21:00:00",2,0,0,1,26.24,81,178,259
"2012-05-19 22:00:00",2,0,0,1,26.24,104,234,338
"2012-05-19 23:00:00",2,0,0,1,24.6,71,168,239
"2012-06-01 00:00:00",2,0,1,1,27.06,10,76,86
"2012-06-01 01:00:00",2,0,1,1,26.24,0,34,34
"2012-06-01 02:00:00",2,0,1,1,26.24,3,13,16
"2012-06-01 03:00:00",2,0,1,2,25.42,0,4,4
"2012-06-01 04:00:00",2,0,1,2,25.42,1,5,6
"2012-06-01 05:00:00",2,0,1,2,25.42,4,41,45
"2012-06-01 06:00:00",2,0,1,3,25.42,5,136,141
"2012-06-01 07:00:00",2,0,1,2,26.24,33,369,402
"2012-06-01 08:00:00",2,0,1,2,26.24,19,675,694
"2012-06-01 09:00:00",2,0,1,2,26.24,24,274,298
"2012-06-01 10:00:00",2,0,1,2,27.06,49,155,204
"2012-06-01 11:00:00",2,0,1,2,28.7,42,193,235
"2012-06-01 12:00:00",2,0,1,2,28.7,72,238,310
"2012-06-01 13:00:00",2,0,1,1,29.52,76,240,316
"2012-06-01 14:00:00",2,0,1,3,29.52,55,199,254
"2012-06-01 15:00:00",2,0,1,3,29.52,45,213,258
"2012-06-01 16:00:00",2,0,1,3,30.34,36,186,222
"2012-06-01 17:00:00",2,0,1,3,28.7,25,202,227
"2012-06-01 18:00:00",2,0,1,3,25.42,10,100,110
"2012-06-01 19:00:00",2,0,1,3,25.42,4,41,45
"2012-06-01 20:00:00",2,0,1,3,25.42,1,38,39
"2012-06-01 21:00:00",2,0,1,3,26.24,12,73,85
"2012-06-01 22:00:00",2,0,1,3,24.6,1,22,23
"2012-06-01 23:00:00",2,0,1,3,24.6,6,67,73
"2012-06-02 00:00:00",2,0,0,2,22.96,5,81,86
"2012-06-02 01:00:00",2,0,0,2,22.96,15,61,76
"2012-06-02 02:00:00",2,0,0,2,22.14,3,38,41
"2012-06-02 03:00:00",2,0,0,1,22.96,8,18,26
"2012-06-02 04:00:00",2,0,0,1,22.14,2,11,13
"2012-06-02 05:00:00",2,0,0,1,20.5,1,11,12
"2012-06-02 06:00:00",2,0,0,2,20.5,5,31,36
"2012-06-02 07:00:00",2,0,0,1,21.32,9,77,86
"2012-06-02 08:00:00",2,0,0,1,22.14,30,180,210
"2012-06-02 09:00:00",2,0,0,1,22.96,89,243,332
"2012-06-02 10:00:00",2,0,0,1,24.6,145,348,493
"2012-06-02 11:00:00",2,0,0,1,23.78,179,357,536
"2012-06-02 12:00:00",2,0,0,1,25.42,250,418,668
"2012-06-02 13:00:00",2,0,0,1,25.42,279,400,679
"2012-06-02 14:00:00",2,0,0,1,26.24,259,388,647
"2012-06-02 15:00:00",2,0,0,1,26.24,297,405,702
"2012-06-02 16:00:00",2,0,0,1,26.24,275,369,644
"2012-06-02 17:00:00",2,0,0,1,26.24,248,338,586
"2012-06-02 18:00:00",2,0,0,1,26.24,171,341,512
"2012-06-02 19:00:00",2,0,0,1,26.24,185,369,554
"2012-06-02 20:00:00",2,0,0,1,25.42,139,260,399
"2012-06-02 21:00:00",2,0,0,1,24.6,96,220,316
"2012-06-02 22:00:00",2,0,0,1,23.78,52,176,228
"2012-06-02 23:00:00",2,0,0,1,22.96,53,185,238
"2012-06-03 00:00:00",2,0,0,1,22.14,27,142,169
"2012-06-03 01:00:00",2,0,0,1,22.14,21,100,121
"2012-06-03 02:00:00",2,0,0,1,21.32,22,67,89
"2012-06-03 03:00:00",2,0,0,1,21.32,16,34,50
"2012-06-03 04:00:00",2,0,0,1,20.5,1,12,13
"2012-06-03 05:00:00",2,0,0,1,20.5,1,11,12
"2012-06-03 06:00:00",2,0,0,1,18.86,6,16,22
"2012-06-03 07:00:00",2,0,0,1,20.5,6,29,35
"2012-06-03 08:00:00",2,0,0,1,22.14,30,110,140
"2012-06-03 09:00:00",2,0,0,1,24.6,70,230,300
"2012-06-03 10:00:00",2,0,0,1,25.42,127,277,404
"2012-06-03 11:00:00",2,0,0,1,26.24,199,312,511
"2012-06-03 12:00:00",2,0,0,1,27.06,276,408,684
"2012-06-03 13:00:00",2,0,0,1,27.88,265,421,686
"2012-06-03 14:00:00",2,0,0,1,27.88,267,411,678
"2012-06-03 15:00:00",2,0,0,1,28.7,236,408,644
"2012-06-03 16:00:00",2,0,0,1,28.7,226,436,662
"2012-06-03 17:00:00",2,0,0,1,28.7,192,386,578
"2012-06-03 18:00:00",2,0,0,1,28.7,153,343,496
"2012-06-03 19:00:00",2,0,0,1,27.88,116,337,453
"2012-06-03 20:00:00",2,0,0,1,27.06,84,230,314
"2012-06-03 21:00:00",2,0,0,1,25.42,66,180,246
"2012-06-03 22:00:00",2,0,0,1,25.42,61,165,226
"2012-06-03 23:00:00",2,0,0,1,23.78,26,82,108
"2012-06-04 00:00:00",2,0,1,1,23.78,11,38,49
"2012-06-04 01:00:00",2,0,1,3,22.96,4,10,14
"2012-06-04 02:00:00",2,0,1,1,22.96,1,10,11
"2012-06-04 03:00:00",2,0,1,2,22.96,0,5,5
"2012-06-04 04:00:00",2,0,1,1,22.14,2,6,8
"2012-06-04 05:00:00",2,0,1,1,21.32,2,33,35
"2012-06-04 06:00:00",2,0,1,1,21.32,4,135,139
"2012-06-04 07:00:00",2,0,1,1,22.96,13,504,517
"2012-06-04 08:00:00",2,0,1,1,24.6,22,643,665
"2012-06-04 09:00:00",2,0,1,1,25.42,38,244,282
"2012-06-04 10:00:00",2,0,1,1,26.24,67,120,187
"2012-06-04 11:00:00",2,0,1,1,26.24,71,168,239
"2012-06-04 12:00:00",2,0,1,1,26.24,62,220,282
"2012-06-04 13:00:00",2,0,1,1,26.24,85,189,274
"2012-06-04 14:00:00",2,0,1,1,25.42,84,186,270
"2012-06-04 15:00:00",2,0,1,1,27.06,77,215,292
"2012-06-04 16:00:00",2,0,1,1,27.06,73,375,448
"2012-06-04 17:00:00",2,0,1,1,26.24,101,733,834
"2012-06-04 18:00:00",2,0,1,1,26.24,103,719,822
"2012-06-04 19:00:00",2,0,1,1,25.42,91,554,645
"2012-06-04 20:00:00",2,0,1,1,24.6,71,390,461
"2012-06-04 21:00:00",2,0,1,1,23.78,40,225,265
"2012-06-04 22:00:00",2,0,1,1,22.96,41,127,168
"2012-06-04 23:00:00",2,0,1,1,23.78,8,78,86
"2012-06-05 00:00:00",2,0,1,1,22.14,6,28,34
"2012-06-05 01:00:00",2,0,1,2,21.32,2,18,20
"2012-06-05 02:00:00",2,0,1,3,21.32,0,8,8
"2012-06-05 03:00:00",2,0,1,3,20.5,0,5,5
"2012-06-05 04:00:00",2,0,1,3,20.5,1,4,5
"2012-06-05 05:00:00",2,0,1,3,19.68,1,35,36
"2012-06-05 06:00:00",2,0,1,1,19.68,7,177,184
"2012-06-05 07:00:00",2,0,1,1,19.68,29,540,569
"2012-06-05 08:00:00",2,0,1,2,19.68,30,680,710
"2012-06-05 09:00:00",2,0,1,2,21.32,50,285,335
"2012-06-05 10:00:00",2,0,1,2,21.32,58,118,176
"2012-06-05 11:00:00",2,0,1,2,22.96,65,162,227
"2012-06-05 12:00:00",2,0,1,2,22.14,45,202,247
"2012-06-05 13:00:00",2,0,1,2,24.6,66,201,267
"2012-06-05 14:00:00",2,0,1,2,23.78,82,194,276
"2012-06-05 15:00:00",2,0,1,2,23.78,54,218,272
"2012-06-05 16:00:00",2,0,1,1,24.6,91,382,473
"2012-06-05 17:00:00",2,0,1,1,24.6,86,764,850
"2012-06-05 18:00:00",2,0,1,1,24.6,111,679,790
"2012-06-05 19:00:00",2,0,1,1,23.78,68,445,513
"2012-06-05 20:00:00",2,0,1,1,22.96,44,371,415
"2012-06-05 21:00:00",2,0,1,1,22.14,30,253,283
"2012-06-05 22:00:00",2,0,1,1,22.96,22,171,193
"2012-06-05 23:00:00",2,0,1,1,22.14,20,93,113
"2012-06-06 00:00:00",2,0,1,1,21.32,3,46,49
"2012-06-06 01:00:00",2,0,1,1,21.32,6,21,27
"2012-06-06 02:00:00",2,0,1,1,20.5,4,7,11
"2012-06-06 03:00:00",2,0,1,1,18.86,0,8,8
"2012-06-06 04:00:00",2,0,1,1,18.86,3,7,10
"2012-06-06 05:00:00",2,0,1,1,19.68,1,37,38
"2012-06-06 06:00:00",2,0,1,1,19.68,7,165,172
"2012-06-06 07:00:00",2,0,1,1,20.5,16,531,547
"2012-06-06 08:00:00",2,0,1,1,22.14,31,637,668
"2012-06-06 09:00:00",2,0,1,1,22.96,35,268,303
"2012-06-06 10:00:00",2,0,1,1,24.6,55,148,203
"2012-06-06 11:00:00",2,0,1,1,25.42,65,161,226
"2012-06-06 12:00:00",2,0,1,1,25.42,80,235,315
"2012-06-06 13:00:00",2,0,1,1,25.42,73,230,303
"2012-06-06 14:00:00",2,0,1,1,26.24,111,191,302
"2012-06-06 15:00:00",2,0,1,1,26.24,75,225,300
"2012-06-06 16:00:00",2,0,1,1,26.24,107,345,452
"2012-06-06 17:00:00",2,0,1,1,25.42,72,652,724
"2012-06-06 18:00:00",2,0,1,3,24.6,94,688,782
"2012-06-06 19:00:00",2,0,1,1,22.96,52,486,538
"2012-06-06 20:00:00",2,0,1,1,22.14,59,349,408
"2012-06-06 21:00:00",2,0,1,1,22.14,38,260,298
"2012-06-06 22:00:00",2,0,1,1,21.32,27,221,248
"2012-06-06 23:00:00",2,0,1,1,21.32,13,110,123
"2012-06-07 00:00:00",2,0,1,1,21.32,9,50,59
"2012-06-07 01:00:00",2,0,1,1,21.32,5,17,22
"2012-06-07 02:00:00",2,0,1,1,21.32,0,12,12
"2012-06-07 03:00:00",2,0,1,1,20.5,0,5,5
"2012-06-07 04:00:00",2,0,1,1,18.86,0,6,6
"2012-06-07 05:00:00",2,0,1,1,19.68,0,34,34
"2012-06-07 06:00:00",2,0,1,1,18.86,5,165,170
"2012-06-07 07:00:00",2,0,1,1,20.5,20,506,526
"2012-06-07 08:00:00",2,0,1,1,21.32,20,661,681
"2012-06-07 09:00:00",2,0,1,1,23.78,37,300,337
"2012-06-07 10:00:00",2,0,1,1,24.6,56,154,210
"2012-06-07 11:00:00",2,0,1,1,27.06,67,170,237
"2012-06-07 12:00:00",2,0,1,1,28.7,62,274,336
"2012-06-07 13:00:00",2,0,1,1,28.7,65,250,315
"2012-06-07 14:00:00",2,0,1,1,29.52,67,198,265
"2012-06-07 15:00:00",2,0,1,1,30.34,99,234,333
"2012-06-07 16:00:00",2,0,1,1,29.52,77,389,466
"2012-06-07 17:00:00",2,0,1,1,29.52,91,778,869
"2012-06-07 18:00:00",2,0,1,1,28.7,110,703,813
"2012-06-07 19:00:00",2,0,1,1,28.7,65,537,602
"2012-06-07 20:00:00",2,0,1,1,27.06,76,402,478
"2012-06-07 21:00:00",2,0,1,1,25.42,30,283,313
"2012-06-07 22:00:00",2,0,1,1,24.6,35,193,228
"2012-06-07 23:00:00",2,0,1,1,22.96,42,135,177
"2012-06-08 00:00:00",2,0,1,1,22.96,18,59,77
"2012-06-08 01:00:00",2,0,1,1,22.96,4,25,29
"2012-06-08 02:00:00",2,0,1,1,22.96,2,17,19
"2012-06-08 03:00:00",2,0,1,1,22.14,0,8,8
"2012-06-08 04:00:00",2,0,1,1,21.32,1,9,10
"2012-06-08 05:00:00",2,0,1,1,20.5,1,28,29
"2012-06-08 06:00:00",2,0,1,1,21.32,8,131,139
"2012-06-08 07:00:00",2,0,1,1,21.32,19,409,428
"2012-06-08 08:00:00",2,0,1,1,23.78,37,663,700
"2012-06-08 09:00:00",2,0,1,1,25.42,47,335,382
"2012-06-08 10:00:00",2,0,1,1,27.06,62,187,249
"2012-06-08 11:00:00",2,0,1,1,28.7,65,199,264
"2012-06-08 12:00:00",2,0,1,1,29.52,89,280,369
"2012-06-08 13:00:00",2,0,1,1,30.34,129,287,416
"2012-06-08 14:00:00",2,0,1,1,31.16,128,245,373
"2012-06-08 15:00:00",2,0,1,1,31.16,98,299,397
"2012-06-08 16:00:00",2,0,1,1,31.16,111,412,523
"2012-06-08 17:00:00",2,0,1,1,31.16,114,679,793
"2012-06-08 18:00:00",2,0,1,1,31.16,147,576,723
"2012-06-08 19:00:00",2,0,1,1,30.34,95,460,555
"2012-06-08 20:00:00",2,0,1,1,29.52,117,291,408
"2012-06-08 21:00:00",2,0,1,1,28.7,83,256,339
"2012-06-08 22:00:00",2,0,1,1,27.88,61,230,291
"2012-06-08 23:00:00",2,0,1,1,26.24,52,163,215
"2012-06-09 00:00:00",2,0,0,1,26.24,54,152,206
"2012-06-09 01:00:00",2,0,0,1,26.24,34,89,123
"2012-06-09 02:00:00",2,0,0,1,26.24,21,68,89
"2012-06-09 03:00:00",2,0,0,1,25.42,12,28,40
"2012-06-09 04:00:00",2,0,0,1,25.42,2,6,8
"2012-06-09 05:00:00",2,0,0,1,24.6,4,15,19
"2012-06-09 06:00:00",2,0,0,1,22.96,17,63,80
"2012-06-09 07:00:00",2,0,0,1,23.78,26,61,87
"2012-06-09 08:00:00",2,0,0,1,25.42,42,202,244
"2012-06-09 09:00:00",2,0,0,1,26.24,99,241,340
"2012-06-09 10:00:00",2,0,0,1,28.7,168,298,466
"2012-06-09 11:00:00",2,0,0,1,31.16,218,351,569
"2012-06-09 12:00:00",2,0,0,1,32.8,196,335,531
"2012-06-09 13:00:00",2,0,0,1,33.62,236,349,585
"2012-06-09 14:00:00",2,0,0,1,33.62,239,354,593
"2012-06-09 15:00:00",2,0,0,1,34.44,218,337,555
"2012-06-09 16:00:00",2,0,0,1,33.62,219,315,534
"2012-06-09 17:00:00",2,0,0,1,34.44,238,257,495
"2012-06-09 18:00:00",2,0,0,1,33.62,175,276,451
"2012-06-09 19:00:00",2,0,0,1,32.8,128,232,360
"2012-06-09 20:00:00",2,0,0,1,31.16,125,238,363
"2012-06-09 21:00:00",2,0,0,1,30.34,105,211,316
"2012-06-09 22:00:00",2,0,0,1,28.7,63,151,214
"2012-06-09 23:00:00",2,0,0,1,27.88,69,161,230
"2012-06-10 00:00:00",2,0,0,1,27.06,33,125,158
"2012-06-10 01:00:00",2,0,0,1,26.24,32,84,116
"2012-06-10 02:00:00",2,0,0,1,26.24,17,56,73
"2012-06-10 03:00:00",2,0,0,1,26.24,6,23,29
"2012-06-10 04:00:00",2,0,0,1,25.42,1,9,10
"2012-06-10 05:00:00",2,0,0,1,25.42,3,10,13
"2012-06-10 06:00:00",2,0,0,1,25.42,3,27,30
"2012-06-10 07:00:00",2,0,0,1,24.6,21,41,62
"2012-06-10 08:00:00",2,0,0,1,26.24,59,122,181
"2012-06-10 09:00:00",2,0,0,1,28.7,91,175,266
"2012-06-10 10:00:00",2,0,0,1,31.16,148,265,413
"2012-06-10 11:00:00",2,0,0,1,31.16,184,315,499
"2012-06-10 12:00:00",2,0,0,1,33.62,173,329,502
"2012-06-10 13:00:00",2,0,0,1,34.44,204,288,492
"2012-06-10 14:00:00",2,0,0,1,34.44,186,314,500
"2012-06-10 15:00:00",2,0,0,1,34.44,159,316,475
"2012-06-10 16:00:00",2,0,0,1,34.44,173,335,508
"2012-06-10 17:00:00",2,0,0,1,33.62,184,337,521
"2012-06-10 18:00:00",2,0,0,1,33.62,164,326,490
"2012-06-10 19:00:00",2,0,0,1,33.62,115,260,375
"2012-06-10 20:00:00",2,0,0,1,31.16,113,250,363
"2012-06-10 21:00:00",2,0,0,1,29.52,83,170,253
"2012-06-10 22:00:00",2,0,0,1,28.7,42,117,159
"2012-06-10 23:00:00",2,0,0,1,29.52,30,80,110
"2012-06-11 00:00:00",2,0,1,1,28.7,8,33,41
"2012-06-11 01:00:00",2,0,1,1,27.06,9,15,24
"2012-06-11 02:00:00",2,0,1,1,27.06,5,12,17
"2012-06-11 03:00:00",2,0,1,1,26.24,2,4,6
"2012-06-11 04:00:00",2,0,1,1,26.24,0,7,7
"2012-06-11 05:00:00",2,0,1,1,26.24,1,36,37
"2012-06-11 06:00:00",2,0,1,1,25.42,8,136,144
"2012-06-11 07:00:00",2,0,1,1,26.24,25,478,503
"2012-06-11 08:00:00",2,0,1,1,27.06,38,613,651
"2012-06-11 09:00:00",2,0,1,1,28.7,57,259,316
"2012-06-11 10:00:00",2,0,1,1,29.52,52,95,147
"2012-06-11 11:00:00",2,0,1,2,31.16,59,143,202
"2012-06-11 12:00:00",2,0,1,2,32.8,63,198,261
"2012-06-11 13:00:00",2,0,1,2,32.8,63,185,248
"2012-06-11 14:00:00",2,0,1,2,33.62,66,193,259
"2012-06-11 15:00:00",2,0,1,1,32.8,72,187,259
"2012-06-11 16:00:00",2,0,1,2,32.8,87,340,427
"2012-06-11 17:00:00",2,0,1,2,32.8,85,715,800
"2012-06-11 18:00:00",2,0,1,2,32.8,105,726,831
"2012-06-11 19:00:00",2,0,1,2,31.16,89,507,596
"2012-06-11 20:00:00",2,0,1,2,30.34,61,333,394
"2012-06-11 21:00:00",2,0,1,2,29.52,32,218,250
"2012-06-11 22:00:00",2,0,1,2,29.52,22,142,164
"2012-06-11 23:00:00",2,0,1,2,28.7,8,72,80
"2012-06-12 00:00:00",2,0,1,2,28.7,2,26,28
"2012-06-12 01:00:00",2,0,1,2,27.88,5,11,16
"2012-06-12 02:00:00",2,0,1,2,27.88,0,6,6
"2012-06-12 03:00:00",2,0,1,2,27.06,3,9,12
"2012-06-12 04:00:00",2,0,1,3,24.6,0,4,4
"2012-06-12 05:00:00",2,0,1,3,24.6,1,28,29
"2012-06-12 06:00:00",2,0,1,2,24.6,6,130,136
"2012-06-12 07:00:00",2,0,1,3,25.42,16,287,303
"2012-06-12 08:00:00",2,0,1,2,25.42,15,598,613
"2012-06-12 09:00:00",2,0,1,2,26.24,31,254,285
"2012-06-12 10:00:00",2,0,1,3,26.24,29,96,125
"2012-06-12 11:00:00",2,0,1,3,27.06,8,57,65
"2012-06-12 12:00:00",2,0,1,3,27.06,19,76,95
"2012-06-12 13:00:00",2,0,1,3,27.06,11,48,59
"2012-06-12 14:00:00",2,0,1,3,26.24,12,48,60
"2012-06-12 15:00:00",2,0,1,3,27.06,22,94,116
"2012-06-12 16:00:00",2,0,1,2,27.06,30,209,239
"2012-06-12 17:00:00",2,0,1,2,27.06,56,625,681
"2012-06-12 18:00:00",2,0,1,1,27.88,57,596,653
"2012-06-12 19:00:00",2,0,1,1,27.88,47,444,491
"2012-06-12 20:00:00",2,0,1,1,27.88,36,350,386
"2012-06-12 21:00:00",2,0,1,1,27.88,41,233,274
"2012-06-12 22:00:00",2,0,1,1,27.06,19,188,207
"2012-06-12 23:00:00",2,0,1,3,27.06,11,78,89
"2012-06-13 00:00:00",2,0,1,2,27.06,7,27,34
"2012-06-13 01:00:00",2,0,1,1,26.24,7,21,28
"2012-06-13 02:00:00",2,0,1,1,25.42,0,4,4
"2012-06-13 03:00:00",2,0,1,1,25.42,1,7,8
"2012-06-13 04:00:00",2,0,1,1,24.6,1,9,10
"2012-06-13 05:00:00",2,0,1,1,24.6,2,38,40
"2012-06-13 06:00:00",2,0,1,1,24.6,6,188,194
"2012-06-13 07:00:00",2,0,1,1,24.6,25,480,505
"2012-06-13 08:00:00",2,0,1,2,25.42,41,672,713
"2012-06-13 09:00:00",2,0,1,2,26.24,54,298,352
"2012-06-13 10:00:00",2,0,1,2,26.24,64,134,198
"2012-06-13 11:00:00",2,0,1,2,27.06,64,182,246
"2012-06-13 12:00:00",2,0,1,2,27.88,93,241,334
"2012-06-13 13:00:00",2,0,1,2,28.7,52,203,255
"2012-06-13 14:00:00",2,0,1,2,29.52,98,222,320
"2012-06-13 15:00:00",2,0,1,1,29.52,65,216,281
"2012-06-13 16:00:00",2,0,1,1,29.52,72,320,392
"2012-06-13 17:00:00",2,0,1,1,29.52,75,782,857
"2012-06-13 18:00:00",2,0,1,1,29.52,104,640,744
"2012-06-13 19:00:00",2,0,1,1,28.7,123,548,671
"2012-06-13 20:00:00",2,0,1,1,27.88,86,362,448
"2012-06-13 21:00:00",2,0,1,1,26.24,79,317,396
"2012-06-13 22:00:00",2,0,1,1,25.42,29,209,238
"2012-06-13 23:00:00",2,0,1,1,25.42,25,128,153
"2012-06-14 00:00:00",2,0,1,1,24.6,3,45,48
"2012-06-14 01:00:00",2,0,1,1,24.6,4,17,21
"2012-06-14 02:00:00",2,0,1,2,25.42,1,8,9
"2012-06-14 03:00:00",2,0,1,2,25.42,1,4,5
"2012-06-14 04:00:00",2,0,1,2,24.6,0,6,6
"2012-06-14 05:00:00",2,0,1,2,24.6,0,40,40
"2012-06-14 06:00:00",2,0,1,1,23.78,12,169,181
"2012-06-14 07:00:00",2,0,1,1,24.6,26,480,506
"2012-06-14 08:00:00",2,0,1,1,24.6,37,682,719
"2012-06-14 09:00:00",2,0,1,1,25.42,45,312,357
"2012-06-14 10:00:00",2,0,1,1,26.24,47,132,179
"2012-06-14 11:00:00",2,0,1,1,27.06,60,168,228
"2012-06-14 12:00:00",2,0,1,2,27.06,55,210,265
"2012-06-14 13:00:00",2,0,1,1,27.88,71,213,284
"2012-06-14 14:00:00",2,0,1,1,28.7,84,214,298
"2012-06-14 15:00:00",2,0,1,1,30.34,111,213,324
"2012-06-14 16:00:00",2,0,1,1,29.52,70,368,438
"2012-06-14 17:00:00",2,0,1,1,29.52,117,750,867
"2012-06-14 18:00:00",2,0,1,1,30.34,107,716,823
"2012-06-14 19:00:00",2,0,1,1,28.7,96,483,579
"2012-06-14 20:00:00",2,0,1,1,27.06,84,351,435
"2012-06-14 21:00:00",2,0,1,1,26.24,67,270,337
"2012-06-14 22:00:00",2,0,1,2,26.24,46,196,242
"2012-06-14 23:00:00",2,0,1,2,25.42,36,136,172
"2012-06-15 00:00:00",2,0,1,1,24.6,26,68,94
"2012-06-15 01:00:00",2,0,1,1,23.78,9,42,51
"2012-06-15 02:00:00",2,0,1,1,22.96,0,15,15
"2012-06-15 03:00:00",2,0,1,1,22.96,2,3,5
"2012-06-15 04:00:00",2,0,1,1,22.96,1,13,14
"2012-06-15 05:00:00",2,0,1,1,22.14,2,31,33
"2012-06-15 06:00:00",2,0,1,1,22.14,9,142,151
"2012-06-15 07:00:00",2,0,1,1,22.96,17,413,430
"2012-06-15 08:00:00",2,0,1,1,24.6,44,609,653
"2012-06-15 09:00:00",2,0,1,1,25.42,58,308,366
"2012-06-15 10:00:00",2,0,1,1,26.24,56,160,216
"2012-06-15 11:00:00",2,0,1,1,27.06,106,180,286
"2012-06-15 12:00:00",2,0,1,1,28.7,111,292,403
"2012-06-15 13:00:00",2,0,1,1,28.7,121,272,393
"2012-06-15 14:00:00",2,0,1,1,29.52,121,255,376
"2012-06-15 15:00:00",2,0,1,1,29.52,107,270,377
"2012-06-15 16:00:00",2,0,1,1,29.52,132,426,558
"2012-06-15 17:00:00",2,0,1,1,30.34,125,698,823
"2012-06-15 18:00:00",2,0,1,1,29.52,121,572,693
"2012-06-15 19:00:00",2,0,1,1,28.7,98,369,467
"2012-06-15 20:00:00",2,0,1,1,27.88,89,296,385
"2012-06-15 21:00:00",2,0,1,1,27.06,83,250,333
"2012-06-15 22:00:00",2,0,1,1,26.24,79,242,321
"2012-06-15 23:00:00",2,0,1,1,25.42,46,176,222
"2012-06-16 00:00:00",2,0,0,1,23.78,25,112,137
"2012-06-16 01:00:00",2,0,0,1,22.96,16,79,95
"2012-06-16 02:00:00",2,0,0,1,23.78,12,55,67
"2012-06-16 03:00:00",2,0,0,1,22.96,8,19,27
"2012-06-16 04:00:00",2,0,0,1,22.14,3,5,8
"2012-06-16 05:00:00",2,0,0,1,22.14,2,21,23
"2012-06-16 06:00:00",2,0,0,1,22.14,11,36,47
"2012-06-16 07:00:00",2,0,0,1,22.14,10,68,78
"2012-06-16 08:00:00",2,0,0,1,23.78,47,157,204
"2012-06-16 09:00:00",2,0,0,1,24.6,88,279,367
"2012-06-16 10:00:00",2,0,0,1,26.24,139,296,435
"2012-06-16 11:00:00",2,0,0,1,27.06,213,353,566
"2012-06-16 12:00:00",2,0,0,1,27.88,254,349,603
"2012-06-16 13:00:00",2,0,0,1,29.52,293,324,617
"2012-06-16 14:00:00",2,0,0,1,29.52,264,309,573
"2012-06-16 15:00:00",2,0,0,1,30.34,295,288,583
"2012-06-16 16:00:00",2,0,0,2,29.52,238,304,542
"2012-06-16 17:00:00",2,0,0,2,29.52,244,349,593
"2012-06-16 18:00:00",2,0,0,2,29.52,256,315,571
"2012-06-16 19:00:00",2,0,0,2,28.7,184,277,461
"2012-06-16 20:00:00",2,0,0,2,27.06,123,229,352
"2012-06-16 21:00:00",2,0,0,2,26.24,98,192,290
"2012-06-16 22:00:00",2,0,0,1,25.42,91,189,280
"2012-06-16 23:00:00",2,0,0,1,24.6,49,134,183
"2012-06-17 00:00:00",2,0,0,1,22.96,31,117,148
"2012-06-17 01:00:00",2,0,0,1,22.96,21,67,88
"2012-06-17 02:00:00",2,0,0,1,22.96,19,55,74
"2012-06-17 03:00:00",2,0,0,1,22.14,6,22,28
"2012-06-17 04:00:00",2,0,0,1,22.14,2,16,18
"2012-06-17 05:00:00",2,0,0,1,22.14,4,13,17
"2012-06-17 06:00:00",2,0,0,1,21.32,7,16,23
"2012-06-17 07:00:00",2,0,0,1,21.32,18,30,48
"2012-06-17 08:00:00",2,0,0,1,22.96,24,95,119
"2012-06-17 09:00:00",2,0,0,1,22.96,91,183,274
"2012-06-17 10:00:00",2,0,0,1,23.78,148,288,436
"2012-06-17 11:00:00",2,0,0,1,25.42,196,350,546
"2012-06-17 12:00:00",2,0,0,1,25.42,260,355,615
"2012-06-17 13:00:00",2,0,0,1,26.24,267,347,614
"2012-06-17 14:00:00",2,0,0,1,26.24,255,327,582
"2012-06-17 15:00:00",2,0,0,1,27.06,203,260,463
"2012-06-17 16:00:00",2,0,0,1,27.06,240,340,580
"2012-06-17 17:00:00",2,0,0,1,26.24,232,361,593
"2012-06-17 18:00:00",2,0,0,1,26.24,203,310,513
"2012-06-17 19:00:00",2,0,0,1,26.24,146,244,390
"2012-06-17 20:00:00",2,0,0,1,25.42,101,201,302
"2012-06-17 21:00:00",2,0,0,1,25.42,76,170,246
"2012-06-17 22:00:00",2,0,0,1,24.6,55,98,153
"2012-06-17 23:00:00",2,0,0,1,23.78,29,79,108
"2012-06-18 00:00:00",2,0,1,1,22.96,12,28,40
"2012-06-18 01:00:00",2,0,1,1,22.14,9,5,14
"2012-06-18 02:00:00",2,0,1,1,22.14,3,6,9
"2012-06-18 03:00:00",2,0,1,2,21.32,1,3,4
"2012-06-18 04:00:00",2,0,1,2,22.14,0,9,9
"2012-06-18 05:00:00",2,0,1,3,21.32,1,22,23
"2012-06-18 06:00:00",2,0,1,3,21.32,0,37,37
"2012-06-18 07:00:00",2,0,1,3,21.32,10,135,145
"2012-06-18 08:00:00",2,0,1,2,22.14,27,447,474
"2012-06-18 09:00:00",2,0,1,2,22.14,28,222,250
"2012-06-18 10:00:00",2,0,1,3,22.14,13,78,91
"2012-06-18 11:00:00",2,0,1,2,22.14,25,96,121
"2012-06-18 12:00:00",2,0,1,3,22.96,29,139,168
"2012-06-18 13:00:00",2,0,1,2,23.78,51,174,225
"2012-06-18 14:00:00",2,0,1,2,23.78,59,160,219
"2012-06-18 15:00:00",2,0,1,2,24.6,61,176,237
"2012-06-18 16:00:00",2,0,1,2,24.6,53,279,332
"2012-06-18 17:00:00",2,0,1,2,24.6,54,669,723
"2012-06-18 18:00:00",2,0,1,2,25.42,47,595,642
"2012-06-18 19:00:00",2,0,1,2,25.42,52,411,463
"2012-06-18 20:00:00",2,0,1,2,25.42,45,317,362
"2012-06-18 21:00:00",2,0,1,2,25.42,35,238,273
"2012-06-18 22:00:00",2,0,1,2,25.42,21,143,164
"2012-06-18 23:00:00",2,0,1,3,24.6,17,57,74
"2012-06-19 00:00:00",2,0,1,2,24.6,5,30,35
"2012-06-19 01:00:00",2,0,1,2,24.6,1,13,14
"2012-06-19 02:00:00",2,0,1,2,24.6,1,14,15
"2012-06-19 03:00:00",2,0,1,2,24.6,1,7,8
"2012-06-19 04:00:00",2,0,1,2,24.6,1,9,10
"2012-06-19 05:00:00",2,0,1,2,24.6,3,34,37
"2012-06-19 06:00:00",2,0,1,2,24.6,9,152,161
"2012-06-19 07:00:00",2,0,1,2,24.6,18,462,480
"2012-06-19 08:00:00",2,0,1,2,24.6,40,633,673
"2012-06-19 09:00:00",2,0,1,1,26.24,40,288,328
"2012-06-19 10:00:00",2,0,1,1,26.24,44,136,180
"2012-06-19 11:00:00",2,0,1,1,27.06,56,174,230
"2012-06-19 12:00:00",2,0,1,1,28.7,70,222,292
"2012-06-19 13:00:00",2,0,1,1,30.34,69,203,272
"2012-06-19 14:00:00",2,0,1,1,31.16,61,166,227
"2012-06-19 15:00:00",2,0,1,1,31.98,72,187,259
"2012-06-19 16:00:00",2,0,1,1,32.8,48,286,334
"2012-06-19 17:00:00",2,0,1,1,32.8,86,725,811
"2012-06-19 18:00:00",2,0,1,1,32.8,91,704,795
"2012-06-19 19:00:00",2,0,1,1,32.8,82,432,514
"2012-06-19 20:00:00",2,0,1,1,32.8,59,399,458
"2012-06-19 21:00:00",2,0,1,1,31.16,37,239,276
"2012-06-19 22:00:00",2,0,1,1,29.52,51,240,291
"2012-06-19 23:00:00",2,0,1,1,29.52,23,102,125
"2012-07-01 00:00:00",3,0,0,1,31.16,27,122,149
"2012-07-01 01:00:00",3,0,0,1,30.34,12,81,93
"2012-07-01 02:00:00",3,0,0,1,29.52,21,69,90
"2012-07-01 03:00:00",3,0,0,1,29.52,6,27,33
"2012-07-01 04:00:00",3,0,0,1,28.7,0,4,4
"2012-07-01 05:00:00",3,0,0,1,27.88,3,7,10
"2012-07-01 06:00:00",3,0,0,1,28.7,8,19,27
"2012-07-01 07:00:00",3,0,0,1,30.34,13,37,50
"2012-07-01 08:00:00",3,0,0,1,31.98,36,106,142
"2012-07-01 09:00:00",3,0,0,1,33.62,51,168,219
"2012-07-01 10:00:00",3,0,0,1,35.26,98,268,366
"2012-07-01 11:00:00",3,0,0,1,36.08,121,256,377
"2012-07-01 12:00:00",3,0,0,1,36.9,114,319,433
"2012-07-01 13:00:00",3,0,0,1,37.72,111,309,420
"2012-07-01 14:00:00",3,0,0,1,37.72,98,346,444
"2012-07-01 15:00:00",3,0,0,1,36.9,101,244,345
"2012-07-01 16:00:00",3,0,0,1,37.72,85,228,313
"2012-07-01 17:00:00",3,0,0,1,37.72,90,323,413
"2012-07-01 18:00:00",3,0,0,1,36.08,95,275,370
"2012-07-01 19:00:00",3,0,0,1,34.44,103,279,382
"2012-07-01 20:00:00",3,0,0,1,34.44,88,244,332
"2012-07-01 21:00:00",3,0,0,1,34.44,77,181,258
"2012-07-01 22:00:00",3,0,0,1,33.62,41,110,151
"2012-07-01 23:00:00",3,0,0,3,31.98,22,88,110
"2012-07-02 00:00:00",3,0,1,2,31.16,12,31,43
"2012-07-02 01:00:00",3,0,1,2,31.16,3,14,17
"2012-07-02 02:00:00",3,0,1,2,30.34,1,14,15
"2012-07-02 03:00:00",3,0,1,2,29.52,0,5,5
"2012-07-02 04:00:00",3,0,1,2,29.52,2,10,12
"2012-07-02 05:00:00",3,0,1,2,29.52,3,37,40
"2012-07-02 06:00:00",3,0,1,1,28.7,4,132,136
"2012-07-02 07:00:00",3,0,1,1,30.34,8,390,398
"2012-07-02 08:00:00",3,0,1,1,31.16,20,548,568
"2012-07-02 09:00:00",3,0,1,1,31.98,56,239,295
"2012-07-02 10:00:00",3,0,1,1,32.8,70,104,174
"2012-07-02 11:00:00",3,0,1,1,34.44,67,134,201
"2012-07-02 12:00:00",3,0,1,1,34.44,74,183,257
"2012-07-02 13:00:00",3,0,1,1,35.26,74,162,236
"2012-07-02 14:00:00",3,0,1,1,35.26,79,151,230
"2012-07-02 15:00:00",3,0,1,1,34.44,59,175,234
"2012-07-02 16:00:00",3,0,1,1,34.44,61,304,365
"2012-07-02 17:00:00",3,0,1,1,34.44,82,665,747
"2012-07-02 18:00:00",3,0,1,1,34.44,72,658,730
"2012-07-02 19:00:00",3,0,1,1,31.98,71,510,581
"2012-07-02 20:00:00",3,0,1,1,31.98,38,357,395
"2012-07-02 21:00:00",3,0,1,1,31.16,17,241,258
"2012-07-02 22:00:00",3,0,1,1,30.34,19,169,188
"2012-07-02 23:00:00",3,0,1,1,30.34,12,90,102
"2012-07-03 00:00:00",3,0,1,1,29.52,9,44,53
"2012-07-03 01:00:00",3,0,1,1,29.52,5,9,14
"2012-07-03 02:00:00",3,0,1,1,29.52,2,8,10
"2012-07-03 03:00:00",3,0,1,1,28.7,0,2,2
"2012-07-03 04:00:00",3,0,1,1,27.88,0,6,6
"2012-07-03 05:00:00",3,0,1,1,28.7,2,33,35
"2012-07-03 06:00:00",3,0,1,1,28.7,5,149,154
"2012-07-03 07:00:00",3,0,1,1,30.34,21,462,483
"2012-07-03 08:00:00",3,0,1,1,30.34,42,604,646
"2012-07-03 09:00:00",3,0,1,1,32.8,46,226,272
"2012-07-03 10:00:00",3,0,1,1,33.62,56,153,209
"2012-07-03 11:00:00",3,0,1,1,35.26,66,151,217
"2012-07-03 12:00:00",3,0,1,1,36.08,74,198,272
"2012-07-03 13:00:00",3,0,1,1,36.9,80,203,283
"2012-07-03 14:00:00",3,0,1,1,36.9,69,241,310
"2012-07-03 15:00:00",3,0,1,2,36.9,71,330,401
"2012-07-03 16:00:00",3,0,1,2,36.9,90,437,527
"2012-07-03 17:00:00",3,0,1,2,35.26,102,620,722
"2012-07-03 18:00:00",3,0,1,2,35.26,85,542,627
"2012-07-03 19:00:00",3,0,1,2,34.44,66,431,497
"2012-07-03 20:00:00",3,0,1,3,31.16,80,296,376
"2012-07-03 21:00:00",3,0,1,2,28.7,36,160,196
"2012-07-03 22:00:00",3,0,1,1,27.88,26,151,177
"2012-07-03 23:00:00",3,0,1,1,27.06,19,152,171
"2012-07-04 00:00:00",3,1,0,1,27.88,19,140,159
"2012-07-04 01:00:00",3,1,0,1,27.88,27,96,123
"2012-07-04 02:00:00",3,1,0,1,27.06,27,66,93
"2012-07-04 03:00:00",3,1,0,1,27.88,9,23,32
"2012-07-04 04:00:00",3,1,0,1,27.88,5,11,16
"2012-07-04 05:00:00",3,1,0,1,27.06,5,14,19
"2012-07-04 06:00:00",3,1,0,1,27.06,9,23,32
"2012-07-04 07:00:00",3,1,0,1,27.88,10,62,72
"2012-07-04 08:00:00",3,1,0,1,28.7,43,110,153
"2012-07-04 09:00:00",3,1,0,1,31.16,90,203,293
"2012-07-04 10:00:00",3,1,0,1,32.8,143,304,447
"2012-07-04 11:00:00",3,1,0,1,33.62,164,321,485
"2012-07-04 12:00:00",3,1,0,1,35.26,164,330,494
"2012-07-04 13:00:00",3,1,0,1,36.9,177,322,499
"2012-07-04 14:00:00",3,1,0,1,36.9,190,357,547
"2012-07-04 15:00:00",3,1,0,1,37.72,155,299,454
"2012-07-04 16:00:00",3,1,0,1,37.72,163,226,389
"2012-07-04 17:00:00",3,1,0,1,37.72,161,253,414
"2012-07-04 18:00:00",3,1,0,1,36.9,159,271,430
"2012-07-04 19:00:00",3,1,0,1,35.26,177,255,432
"2012-07-04 20:00:00",3,1,0,1,35.26,237,314,551
"2012-07-04 21:00:00",3,1,0,1,34.44,222,362,584
"2012-07-04 22:00:00",3,1,0,1,33.62,175,327,502
"2012-07-04 23:00:00",3,1,0,2,31.98,31,152,183
"2012-07-05 00:00:00",3,0,1,1,30.34,17,71,88
"2012-07-05 01:00:00",3,0,1,1,30.34,6,24,30
"2012-07-05 02:00:00",3,0,1,1,30.34,4,14,18
"2012-07-05 03:00:00",3,0,1,1,29.52,2,5,7
"2012-07-05 04:00:00",3,0,1,1,29.52,0,7,7
"2012-07-05 05:00:00",3,0,1,1,29.52,1,28,29
"2012-07-05 06:00:00",3,0,1,1,29.52,3,130,133
"2012-07-05 07:00:00",3,0,1,1,31.16,27,316,343
"2012-07-05 08:00:00",3,0,1,1,32.8,36,514,550
"2012-07-05 09:00:00",3,0,1,1,34.44,47,246,293
"2012-07-05 10:00:00",3,0,1,1,35.26,69,117,186
"2012-07-05 11:00:00",3,0,1,1,36.9,107,137,244
"2012-07-05 12:00:00",3,0,1,1,36.9,88,188,276
"2012-07-05 13:00:00",3,0,1,1,37.72,129,181,310
"2012-07-05 14:00:00",3,0,1,1,37.72,87,154,241
"2012-07-05 15:00:00",3,0,1,1,37.72,71,183,254
"2012-07-05 16:00:00",3,0,1,1,37.72,109,324,433
"2012-07-05 17:00:00",3,0,1,1,37.72,114,575,689
"2012-07-05 18:00:00",3,0,1,2,36.9,96,511,607
"2012-07-05 19:00:00",3,0,1,2,36.08,128,375,503
"2012-07-05 20:00:00",3,0,1,2,35.26,78,243,321
"2012-07-05 21:00:00",3,0,1,1,34.44,91,232,323
"2012-07-05 22:00:00",3,0,1,1,33.62,63,162,225
"2012-07-05 23:00:00",3,0,1,1,32.8,32,99,131
"2012-07-06 00:00:00",3,0,1,1,31.98,39,63,102
"2012-07-06 01:00:00",3,0,1,1,31.98,7,22,29
"2012-07-06 02:00:00",3,0,1,1,31.16,4,13,17
"2012-07-06 03:00:00",3,0,1,2,30.34,1,6,7
"2012-07-06 04:00:00",3,0,1,1,30.34,2,4,6
"2012-07-06 05:00:00",3,0,1,1,30.34,4,31,35
"2012-07-06 06:00:00",3,0,1,1,30.34,4,127,131
"2012-07-06 07:00:00",3,0,1,1,31.98,20,333,353
"2012-07-06 08:00:00",3,0,1,1,32.8,28,557,585
"2012-07-06 09:00:00",3,0,1,1,33.62,55,249,304
"2012-07-06 10:00:00",3,0,1,1,35.26,80,130,210
"2012-07-06 11:00:00",3,0,1,1,34.44,92,141,233
"2012-07-06 12:00:00",3,0,1,1,36.08,111,220,331
"2012-07-06 13:00:00",3,0,1,1,36.9,99,194,293
"2012-07-06 14:00:00",3,0,1,1,36.9,91,184,275
"2012-07-06 15:00:00",3,0,1,1,37.72,79,206,285
"2012-07-06 16:00:00",3,0,1,1,37.72,69,300,369
"2012-07-06 17:00:00",3,0,1,1,37.72,90,486,576
"2012-07-06 18:00:00",3,0,1,1,36.9,106,454,560
"2012-07-06 19:00:00",3,0,1,1,36.08,112,306,418
"2012-07-06 20:00:00",3,0,1,1,35.26,91,245,336
"2012-07-06 21:00:00",3,0,1,1,33.62,77,223,300
"2012-07-06 22:00:00",3,0,1,1,32.8,78,210,288
"2012-07-06 23:00:00",3,0,1,1,32.8,27,137,164
"2012-07-07 00:00:00",3,0,0,1,31.98,35,115,150
"2012-07-07 01:00:00",3,0,0,1,31.16,16,55,71
"2012-07-07 02:00:00",3,0,0,1,31.16,11,47,58
"2012-07-07 03:00:00",3,0,0,1,30.34,12,19,31
"2012-07-07 04:00:00",3,0,0,1,30.34,3,13,16
"2012-07-07 05:00:00",3,0,0,1,30.34,2,12,14
"2012-07-07 06:00:00",3,0,0,1,30.34,4,27,31
"2012-07-07 07:00:00",3,0,0,1,31.98,8,63,71
"2012-07-07 08:00:00",3,0,0,1,33.62,32,120,152
"2012-07-07 09:00:00",3,0,0,1,34.44,69,187,256
"2012-07-07 10:00:00",3,0,0,1,37.72,100,225,325
"2012-07-07 11:00:00",3,0,0,1,38.54,122,245,367
"2012-07-07 12:00:00",3,0,0,1,39.36,124,218,342
"2012-07-07 13:00:00",3,0,0,2,39.36,116,244,360
"2012-07-07 14:00:00",3,0,0,2,39.36,105,203,308
"2012-07-07 15:00:00",3,0,0,1,39.36,113,193,306
"2012-07-07 16:00:00",3,0,0,1,41,102,192,294
"2012-07-07 17:00:00",3,0,0,1,39.36,103,176,279
"2012-07-07 18:00:00",3,0,0,1,38.54,83,194,277
"2012-07-07 19:00:00",3,0,0,1,37.72,68,219,287
"2012-07-07 20:00:00",3,0,0,1,36.9,79,197,276
"2012-07-07 21:00:00",3,0,0,1,36.08,51,150,201
"2012-07-07 22:00:00",3,0,0,1,34.44,56,164,220
"2012-07-07 23:00:00",3,0,0,1,34.44,34,114,148
"2012-07-08 00:00:00",3,0,0,1,33.62,22,125,147
"2012-07-08 01:00:00",3,0,0,1,33.62,25,99,124
"2012-07-08 02:00:00",3,0,0,1,33.62,11,59,70
"2012-07-08 03:00:00",3,0,0,1,32.8,1,34,35
"2012-07-08 04:00:00",3,0,0,1,31.98,2,11,13
"2012-07-08 05:00:00",3,0,0,1,31.98,1,5,6
"2012-07-08 06:00:00",3,0,0,1,31.98,5,16,21
"2012-07-08 07:00:00",3,0,0,1,32.8,19,33,52
"2012-07-08 08:00:00",3,0,0,1,34.44,35,95,130
"2012-07-08 09:00:00",3,0,0,1,35.26,70,172,242
"2012-07-08 10:00:00",3,0,0,1,36.9,85,234,319
"2012-07-08 11:00:00",3,0,0,1,37.72,120,269,389
"2012-07-08 12:00:00",3,0,0,1,37.72,105,271,376
"2012-07-08 13:00:00",3,0,0,1,38.54,118,219,337
"2012-07-08 14:00:00",3,0,0,1,39.36,77,235,312
"2012-07-08 15:00:00",3,0,0,3,37.72,80,218,298
"2012-07-08 16:00:00",3,0,0,2,32.8,65,226,291
"2012-07-08 17:00:00",3,0,0,1,31.98,68,202,270
"2012-07-08 18:00:00",3,0,0,1,31.98,54,199,253
"2012-07-08 19:00:00",3,0,0,1,31.98,66,184,250
"2012-07-08 20:00:00",3,0,0,1,31.16,79,206,285
"2012-07-08 21:00:00",3,0,0,1,31.16,58,149,207
"2012-07-08 22:00:00",3,0,0,3,30.34,12,110,122
"2012-07-08 23:00:00",3,0,0,3,27.88,25,98,123
"2012-07-09 00:00:00",3,0,1,2,27.88,6,33,39
"2012-07-09 01:00:00",3,0,1,3,28.7,5,13,18
"2012-07-09 02:00:00",3,0,1,3,28.7,1,4,5
"2012-07-09 03:00:00",3,0,1,3,28.7,0,5,5
"2012-07-09 04:00:00",3,0,1,3,27.06,1,1,2
"2012-07-09 05:00:00",3,0,1,2,27.06,1,27,28
"2012-07-09 06:00:00",3,0,1,3,26.24,6,86,92
"2012-07-09 07:00:00",3,0,1,3,27.06,7,223,230
"2012-07-09 08:00:00",3,0,1,2,27.06,26,429,455
"2012-07-09 09:00:00",3,0,1,2,27.06,38,325,363
"2012-07-09 10:00:00",3,0,1,2,27.06,58,117,175
"2012-07-09 11:00:00",3,0,1,2,29.52,72,144,216
"2012-07-09 12:00:00",3,0,1,2,30.34,61,205,266
"2012-07-09 13:00:00",3,0,1,2,31.16,67,188,255
"2012-07-09 14:00:00",3,0,1,2,30.34,58,184,242
"2012-07-09 15:00:00",3,0,1,2,31.16,66,214,280
"2012-07-09 16:00:00",3,0,1,1,31.98,88,325,413
"2012-07-09 17:00:00",3,0,1,1,31.98,108,741,849
"2012-07-09 18:00:00",3,0,1,1,31.16,82,790,872
"2012-07-09 19:00:00",3,0,1,1,30.34,88,543,631
"2012-07-09 20:00:00",3,0,1,2,30.34,69,378,447
"2012-07-09 21:00:00",3,0,1,2,30.34,33,298,331
"2012-07-09 22:00:00",3,0,1,2,29.52,35,189,224
"2012-07-09 23:00:00",3,0,1,2,28.7,22,109,131
"2012-07-10 00:00:00",3,0,1,1,28.7,16,53,69
"2012-07-10 01:00:00",3,0,1,1,28.7,0,15,15
"2012-07-10 02:00:00",3,0,1,1,28.7,1,15,16
"2012-07-10 03:00:00",3,0,1,1,27.88,0,3,3
"2012-07-10 04:00:00",3,0,1,1,27.88,0,4,4
"2012-07-10 05:00:00",3,0,1,1,27.06,3,39,42
"2012-07-10 06:00:00",3,0,1,2,27.88,4,183,187
"2012-07-10 07:00:00",3,0,1,2,28.7,31,489,520
"2012-07-10 08:00:00",3,0,1,1,29.52,34,615,649
"2012-07-10 09:00:00",3,0,1,1,30.34,47,284,331
"2012-07-10 10:00:00",3,0,1,1,31.16,56,134,190
"2012-07-10 11:00:00",3,0,1,1,32.8,92,157,249
"2012-07-10 12:00:00",3,0,1,1,32.8,69,203,272
"2012-07-10 13:00:00",3,0,1,1,33.62,77,203,280
"2012-07-10 14:00:00",3,0,1,1,33.62,71,171,242
"2012-07-10 15:00:00",3,0,1,1,32.8,77,188,265
"2012-07-10 16:00:00",3,0,1,1,32.8,89,346,435
"2012-07-10 17:00:00",3,0,1,1,31.98,103,769,872
"2012-07-10 18:00:00",3,0,1,3,28.7,70,749,819
"2012-07-10 19:00:00",3,0,1,3,28.7,55,359,414
"2012-07-10 20:00:00",3,0,1,3,26.24,9,75,84
"2012-07-10 21:00:00",3,0,1,3,26.24,7,83,90
"2012-07-10 22:00:00",3,0,1,2,26.24,14,125,139
"2012-07-10 23:00:00",3,0,1,2,26.24,29,74,103
"2012-07-11 00:00:00",3,0,1,2,27.06,6,38,44
"2012-07-11 01:00:00",3,0,1,1,26.24,3,11,14
"2012-07-11 02:00:00",3,0,1,1,26.24,0,5,5
"2012-07-11 03:00:00",3,0,1,1,26.24,0,5,5
"2012-07-11 04:00:00",3,0,1,1,26.24,1,6,7
"2012-07-11 05:00:00",3,0,1,1,26.24,5,36,41
"2012-07-11 06:00:00",3,0,1,1,26.24,17,168,185
"2012-07-11 07:00:00",3,0,1,2,27.06,26,471,497
"2012-07-11 08:00:00",3,0,1,2,27.88,30,644,674
"2012-07-11 09:00:00",3,0,1,2,28.7,30,298,328
"2012-07-11 10:00:00",3,0,1,2,29.52,47,148,195
"2012-07-11 11:00:00",3,0,1,2,31.16,56,173,229
"2012-07-11 12:00:00",3,0,1,2,31.98,69,223,292
"2012-07-11 13:00:00",3,0,1,2,32.8,65,208,273
"2012-07-11 14:00:00",3,0,1,1,32.8,66,175,241
"2012-07-11 15:00:00",3,0,1,1,32.8,56,220,276
"2012-07-11 16:00:00",3,0,1,1,32.8,53,358,411
"2012-07-11 17:00:00",3,0,1,1,32.8,90,740,830
"2012-07-11 18:00:00",3,0,1,1,31.98,79,735,814
"2012-07-11 19:00:00",3,0,1,1,30.34,73,560,633
"2012-07-11 20:00:00",3,0,1,1,30.34,73,410,483
"2012-07-11 21:00:00",3,0,1,1,29.52,69,322,391
"2012-07-11 22:00:00",3,0,1,1,29.52,41,203,244
"2012-07-11 23:00:00",3,0,1,2,28.7,20,132,152
"2012-07-12 00:00:00",3,0,1,2,27.88,1,55,56
"2012-07-12 01:00:00",3,0,1,2,27.06,0,21,21
"2012-07-12 02:00:00",3,0,1,2,27.06,0,9,9
"2012-07-12 03:00:00",3,0,1,1,26.24,0,10,10
"2012-07-12 04:00:00",3,0,1,1,26.24,0,5,5
"2012-07-12 05:00:00",3,0,1,1,25.42,4,40,44
"2012-07-12 06:00:00",3,0,1,1,26.24,7,171,178
"2012-07-12 07:00:00",3,0,1,1,26.24,32,480,512
"2012-07-12 08:00:00",3,0,1,1,27.88,49,653,702
"2012-07-12 09:00:00",3,0,1,1,29.52,42,285,327
"2012-07-12 10:00:00",3,0,1,1,30.34,69,145,214
"2012-07-12 11:00:00",3,0,1,1,31.16,49,166,215
"2012-07-12 12:00:00",3,0,1,1,31.98,71,221,292
"2012-07-12 13:00:00",3,0,1,1,32.8,52,225,277
"2012-07-12 14:00:00",3,0,1,1,31.98,42,167,209
"2012-07-12 15:00:00",3,0,1,1,32.8,63,208,271
"2012-07-12 16:00:00",3,0,1,1,32.8,69,370,439
"2012-07-12 17:00:00",3,0,1,1,31.16,91,704,795
"2012-07-12 18:00:00",3,0,1,1,31.16,86,739,825
"2012-07-12 19:00:00",3,0,1,1,30.34,97,532,629
"2012-07-12 20:00:00",3,0,1,1,30.34,75,439,514
"2012-07-12 21:00:00",3,0,1,1,29.52,44,329,373
"2012-07-12 22:00:00",3,0,1,1,29.52,56,262,318
"2012-07-12 23:00:00",3,0,1,2,28.7,33,178,211
"2012-07-13 00:00:00",3,0,1,2,28.7,19,76,95
"2012-07-13 01:00:00",3,0,1,2,27.88,17,42,59
"2012-07-13 02:00:00",3,0,1,2,27.06,2,15,17
"2012-07-13 03:00:00",3,0,1,2,27.88,2,7,9
"2012-07-13 04:00:00",3,0,1,2,27.06,0,11,11
"2012-07-13 05:00:00",3,0,1,2,27.06,4,30,34
"2012-07-13 06:00:00",3,0,1,2,28.7,7,120,127
"2012-07-13 07:00:00",3,0,1,2,28.7,27,353,380
"2012-07-13 08:00:00",3,0,1,2,28.7,53,660,713
"2012-07-13 09:00:00",3,0,1,2,29.52,70,344,414
"2012-07-13 10:00:00",3,0,1,2,30.34,78,190,268
"2012-07-13 11:00:00",3,0,1,2,31.16,68,220,288
"2012-07-13 12:00:00",3,0,1,2,31.16,125,254,379
"2012-07-13 13:00:00",3,0,1,2,32.8,100,274,374
"2012-07-13 14:00:00",3,0,1,2,32.8,120,249,369
"2012-07-13 15:00:00",3,0,1,2,32.8,92,261,353
"2012-07-13 16:00:00",3,0,1,2,32.8,111,381,492
"2012-07-13 17:00:00",3,0,1,2,32.8,138,697,835
"2012-07-13 18:00:00",3,0,1,1,31.98,108,523,631
"2012-07-13 19:00:00",3,0,1,1,30.34,103,385,488
"2012-07-13 20:00:00",3,0,1,1,30.34,95,294,389
"2012-07-13 21:00:00",3,0,1,1,29.52,76,223,299
"2012-07-13 22:00:00",3,0,1,1,30.34,59,204,263
"2012-07-13 23:00:00",3,0,1,2,29.52,37,175,212
"2012-07-14 00:00:00",3,0,0,2,29.52,35,156,191
"2012-07-14 01:00:00",3,0,0,2,28.7,13,105,118
"2012-07-14 02:00:00",3,0,0,2,28.7,10,91,101
"2012-07-14 03:00:00",3,0,0,2,28.7,9,31,40
"2012-07-14 04:00:00",3,0,0,3,27.06,3,6,9
"2012-07-14 05:00:00",3,0,0,2,26.24,0,5,5
"2012-07-14 06:00:00",3,0,0,2,26.24,6,29,35
"2012-07-14 07:00:00",3,0,0,1,26.24,7,41,48
"2012-07-14 08:00:00",3,0,0,1,25.42,33,118,151
"2012-07-14 09:00:00",3,0,0,1,27.06,82,200,282
"2012-07-14 10:00:00",3,0,0,2,29.52,123,278,401
"2012-07-14 11:00:00",3,0,0,2,29.52,143,296,439
"2012-07-14 12:00:00",3,0,0,2,30.34,181,318,499
"2012-07-14 13:00:00",3,0,0,2,31.16,219,372,591
"2012-07-14 14:00:00",3,0,0,1,32.8,269,363,632
"2012-07-14 15:00:00",3,0,0,1,32.8,243,317,560
"2012-07-14 16:00:00",3,0,0,2,29.52,226,340,566
"2012-07-14 17:00:00",3,0,0,3,28.7,199,259,458
"2012-07-14 18:00:00",3,0,0,1,29.52,108,243,351
"2012-07-14 19:00:00",3,0,0,1,29.52,156,275,431
"2012-07-14 20:00:00",3,0,0,1,29.52,101,255,356
"2012-07-14 21:00:00",3,0,0,1,28.7,69,200,269
"2012-07-14 22:00:00",3,0,0,1,28.7,65,160,225
"2012-07-14 23:00:00",3,0,0,2,27.88,55,156,211
"2012-07-15 00:00:00",3,0,0,1,27.88,40,147,187
"2012-07-15 01:00:00",3,0,0,2,27.88,49,119,168
"2012-07-15 02:00:00",3,0,0,2,27.88,29,86,115
"2012-07-15 03:00:00",3,0,0,2,27.88,15,42,57
"2012-07-15 04:00:00",3,0,0,2,27.88,8,11,19
"2012-07-15 05:00:00",3,0,0,1,27.88,2,7,9
"2012-07-15 06:00:00",3,0,0,1,27.88,6,9,15
"2012-07-15 07:00:00",3,0,0,1,28.7,17,30,47
"2012-07-15 08:00:00",3,0,0,2,28.7,37,96,133
"2012-07-15 09:00:00",3,0,0,2,29.52,58,163,221
"2012-07-15 10:00:00",3,0,0,1,31.16,141,241,382
"2012-07-15 11:00:00",3,0,0,1,33.62,170,281,451
"2012-07-15 12:00:00",3,0,0,1,34.44,153,336,489
"2012-07-15 13:00:00",3,0,0,1,35.26,171,309,480
"2012-07-15 14:00:00",3,0,0,1,36.9,162,314,476
"2012-07-15 15:00:00",3,0,0,1,35.26,182,307,489
"2012-07-15 16:00:00",3,0,0,1,35.26,152,343,495
"2012-07-15 17:00:00",3,0,0,1,32.8,122,314,436
"2012-07-15 18:00:00",3,0,0,3,29.52,84,228,312
"2012-07-15 19:00:00",3,0,0,1,29.52,109,203,312
"2012-07-15 20:00:00",3,0,0,1,29.52,95,199,294
"2012-07-15 21:00:00",3,0,0,1,29.52,59,164,223
"2012-07-15 22:00:00",3,0,0,1,29.52,34,96,130
"2012-07-15 23:00:00",3,0,0,1,29.52,25,66,91
"2012-07-16 00:00:00",3,0,1,3,29.52,11,32,43
"2012-07-16 01:00:00",3,0,1,2,28.7,1,10,11
"2012-07-16 02:00:00",3,0,1,1,28.7,4,11,15
"2012-07-16 03:00:00",3,0,1,1,27.88,2,4,6
"2012-07-16 04:00:00",3,0,1,1,27.88,1,11,12
"2012-07-16 05:00:00",3,0,1,1,27.06,10,40,50
"2012-07-16 06:00:00",3,0,1,1,27.88,8,132,140
"2012-07-16 07:00:00",3,0,1,1,29.52,24,459,483
"2012-07-16 08:00:00",3,0,1,1,30.34,48,619,667
"2012-07-16 09:00:00",3,0,1,1,31.16,51,297,348
"2012-07-16 10:00:00",3,0,1,1,32.8,69,117,186
"2012-07-16 11:00:00",3,0,1,1,34.44,57,125,182
"2012-07-16 12:00:00",3,0,1,1,34.44,79,158,237
"2012-07-16 13:00:00",3,0,1,1,34.44,63,176,239
"2012-07-16 14:00:00",3,0,1,1,36.08,53,159,212
"2012-07-16 15:00:00",3,0,1,1,35.26,61,176,237
"2012-07-16 16:00:00",3,0,1,3,31.16,77,309,386
"2012-07-16 17:00:00",3,0,1,3,31.16,86,669,755
"2012-07-16 18:00:00",3,0,1,1,34.44,97,697,794
"2012-07-16 19:00:00",3,0,1,1,32.8,92,503,595
"2012-07-16 20:00:00",3,0,1,1,32.8,66,388,454
"2012-07-16 21:00:00",3,0,1,1,31.16,45,283,328
"2012-07-16 22:00:00",3,0,1,1,31.16,56,228,284
"2012-07-16 23:00:00",3,0,1,1,30.34,27,139,166
"2012-07-17 00:00:00",3,0,1,1,29.52,10,43,53
"2012-07-17 01:00:00",3,0,1,1,30.34,4,21,25
"2012-07-17 02:00:00",3,0,1,1,29.52,1,6,7
"2012-07-17 03:00:00",3,0,1,1,29.52,0,3,3
"2012-07-17 04:00:00",3,0,1,1,29.52,0,7,7
"2012-07-17 05:00:00",3,0,1,1,27.88,7,31,38
"2012-07-17 06:00:00",3,0,1,1,29.52,16,197,213
"2012-07-17 07:00:00",3,0,1,2,30.34,26,500,526
"2012-07-17 08:00:00",3,0,1,2,32.8,43,618,661
"2012-07-17 09:00:00",3,0,1,2,33.62,32,288,320
"2012-07-17 10:00:00",3,0,1,2,34.44,37,122,159
"2012-07-17 11:00:00",3,0,1,2,35.26,60,146,206
"2012-07-17 12:00:00",3,0,1,2,36.9,80,174,254
"2012-07-17 13:00:00",3,0,1,1,37.72,53,168,221
"2012-07-17 14:00:00",3,0,1,1,38.54,54,160,214
"2012-07-17 15:00:00",3,0,1,1,37.72,57,187,244
"2012-07-17 16:00:00",3,0,1,1,37.72,64,317,381
"2012-07-17 17:00:00",3,0,1,1,37.72,95,675,770
"2012-07-17 18:00:00",3,0,1,1,36.9,60,712,772
"2012-07-17 19:00:00",3,0,1,1,36.08,69,478,547
"2012-07-17 20:00:00",3,0,1,1,35.26,52,375,427
"2012-07-17 21:00:00",3,0,1,1,33.62,50,283,333
"2012-07-17 22:00:00",3,0,1,1,32.8,29,215,244
"2012-07-17 23:00:00",3,0,1,1,31.98,22,139,161
"2012-07-18 00:00:00",3,0,1,1,31.16,8,45,53
"2012-07-18 01:00:00",3,0,1,1,31.16,2,14,16
"2012-07-18 02:00:00",3,0,1,1,30.34,3,5,8
"2012-07-18 03:00:00",3,0,1,1,30.34,2,2,4
"2012-07-18 04:00:00",3,0,1,1,29.52,0,6,6
"2012-07-18 05:00:00",3,0,1,1,29.52,5,41,46
"2012-07-18 06:00:00",3,0,1,1,29.52,10,152,162
"2012-07-18 07:00:00",3,0,1,1,30.34,23,472,495
"2012-07-18 08:00:00",3,0,1,1,31.98,55,624,679
"2012-07-18 09:00:00",3,0,1,1,33.62,44,253,297
"2012-07-18 10:00:00",3,0,1,1,36.9,39,99,138
"2012-07-18 11:00:00",3,0,1,1,36.9,47,136,183
"2012-07-18 12:00:00",3,0,1,1,37.72,36,166,202
"2012-07-18 13:00:00",3,0,1,1,38.54,49,154,203
"2012-07-18 14:00:00",3,0,1,1,38.54,54,116,170
"2012-07-18 15:00:00",3,0,1,3,37.72,42,152,194
"2012-07-18 16:00:00",3,0,1,1,30.34,34,190,224
"2012-07-18 17:00:00",3,0,1,1,30.34,35,335,370
"2012-07-18 18:00:00",3,0,1,2,31.16,63,580,643
"2012-07-18 19:00:00",3,0,1,2,31.16,78,438,516
"2012-07-18 20:00:00",3,0,1,1,30.34,56,310,366
"2012-07-18 21:00:00",3,0,1,1,31.16,53,266,319
"2012-07-18 22:00:00",3,0,1,1,31.16,42,246,288
"2012-07-18 23:00:00",3,0,1,1,31.16,19,112,131
"2012-07-19 00:00:00",3,0,1,1,30.34,16,50,66
"2012-07-19 01:00:00",3,0,1,1,30.34,6,19,25
"2012-07-19 02:00:00",3,0,1,1,29.52,0,7,7
"2012-07-19 03:00:00",3,0,1,1,29.52,1,4,5
"2012-07-19 04:00:00",3,0,1,1,29.52,0,8,8
"2012-07-19 05:00:00",3,0,1,2,29.52,5,35,40
"2012-07-19 06:00:00",3,0,1,1,29.52,8,144,152
"2012-07-19 07:00:00",3,0,1,1,30.34,23,450,473
"2012-07-19 08:00:00",3,0,1,1,31.16,32,625,657
"2012-07-19 09:00:00",3,0,1,2,31.16,36,282,318
"2012-07-19 10:00:00",3,0,1,1,31.16,41,157,198
"2012-07-19 11:00:00",3,0,1,1,32.8,54,162,216
"2012-07-19 12:00:00",3,0,1,1,34.44,59,215,274
"2012-07-19 13:00:00",3,0,1,1,34.44,74,180,254
"2012-07-19 14:00:00",3,0,1,1,35.26,46,151,197
"2012-07-19 15:00:00",3,0,1,1,34.44,66,226,292
"2012-07-19 16:00:00",3,0,1,1,34.44,70,288,358
"2012-07-19 17:00:00",3,0,1,1,35.26,93,678,771
"2012-07-19 18:00:00",3,0,1,1,35.26,93,684,777
"2012-07-19 19:00:00",3,0,1,1,34.44,53,480,533
"2012-07-19 20:00:00",3,0,1,1,33.62,65,440,505
"2012-07-19 21:00:00",3,0,1,3,27.06,38,294,332
"2012-07-19 22:00:00",3,0,1,3,27.06,6,62,68
"2012-07-19 23:00:00",3,0,1,3,27.06,3,62,65
"2012-08-01 00:00:00",3,0,1,1,27.88,3,44,47
"2012-08-01 01:00:00",3,0,1,1,27.06,5,28,33
"2012-08-01 02:00:00",3,0,1,1,26.24,0,13,13
"2012-08-01 03:00:00",3,0,1,1,26.24,0,7,7
"2012-08-01 04:00:00",3,0,1,2,26.24,1,3,4
"2012-08-01 05:00:00",3,0,1,2,26.24,3,46,49
"2012-08-01 06:00:00",3,0,1,1,26.24,6,179,185
"2012-08-01 07:00:00",3,0,1,2,26.24,19,468,487
"2012-08-01 08:00:00",3,0,1,2,27.06,32,649,681
"2012-08-01 09:00:00",3,0,1,2,27.88,34,316,350
"2012-08-01 10:00:00",3,0,1,1,29.52,61,175,236
"2012-08-01 11:00:00",3,0,1,1,31.16,54,180,234
"2012-08-01 12:00:00",3,0,1,1,32.8,75,209,284
"2012-08-01 13:00:00",3,0,1,1,32.8,59,221,280
"2012-08-01 14:00:00",3,0,1,1,33.62,88,175,263
"2012-08-01 15:00:00",3,0,1,1,33.62,89,206,295
"2012-08-01 16:00:00",3,0,1,1,32.8,93,386,479
"2012-08-01 17:00:00",3,0,1,1,32.8,103,734,837
"2012-08-01 18:00:00",3,0,1,3,31.16,105,786,891
"2012-08-01 19:00:00",3,0,1,1,30.34,88,564,652
"2012-08-01 20:00:00",3,0,1,1,30.34,65,448,513
"2012-08-01 21:00:00",3,0,1,1,29.52,36,284,320
"2012-08-01 22:00:00",3,0,1,1,29.52,37,251,288
"2012-08-01 23:00:00",3,0,1,1,28.7,18,134,152
"2012-08-02 00:00:00",3,0,1,1,28.7,8,55,63
"2012-08-02 01:00:00",3,0,1,1,27.88,6,36,42
"2012-08-02 02:00:00",3,0,1,1,27.06,3,8,11
"2012-08-02 03:00:00",3,0,1,1,27.06,0,6,6
"2012-08-02 04:00:00",3,0,1,1,27.06,0,9,9
"2012-08-02 05:00:00",3,0,1,1,27.06,4,37,41
"2012-08-02 06:00:00",3,0,1,1,27.06,6,177,183
"2012-08-02 07:00:00",3,0,1,1,28.7,21,452,473
"2012-08-02 08:00:00",3,0,1,1,29.52,21,718,739
"2012-08-02 09:00:00",3,0,1,1,31.16,31,312,343
"2012-08-02 10:00:00",3,0,1,1,32.8,51,130,181
"2012-08-02 11:00:00",3,0,1,1,33.62,59,167,226
"2012-08-02 12:00:00",3,0,1,1,34.44,56,230,286
"2012-08-02 13:00:00",3,0,1,1,35.26,98,212,310
"2012-08-02 14:00:00",3,0,1,1,35.26,54,171,225
"2012-08-02 15:00:00",3,0,1,1,31.98,68,202,270
"2012-08-02 16:00:00",3,0,1,1,33.62,71,335,406
"2012-08-02 17:00:00",3,0,1,1,33.62,90,775,865
"2012-08-02 18:00:00",3,0,1,1,32.8,86,681,767
"2012-08-02 19:00:00",3,0,1,1,32.8,98,509,607
"2012-08-02 20:00:00",3,0,1,1,31.98,51,376,427
"2012-08-02 21:00:00",3,0,1,1,31.16,41,301,342
"2012-08-02 22:00:00",3,0,1,1,30.34,35,227,262
"2012-08-02 23:00:00",3,0,1,1,29.52,25,152,177
"2012-08-03 00:00:00",3,0,1,1,29.52,15,56,71
"2012-08-03 01:00:00",3,0,1,1,28.7,11,32,43
"2012-08-03 02:00:00",3,0,1,1,27.88,0,14,14
"2012-08-03 03:00:00",3,0,1,1,27.88,1,5,6
"2012-08-03 04:00:00",3,0,1,1,27.06,1,11,12
"2012-08-03 05:00:00",3,0,1,1,27.06,2,35,37
"2012-08-03 06:00:00",3,0,1,1,27.06,5,158,163
"2012-08-03 07:00:00",3,0,1,1,28.7,25,396,421
"2012-08-03 08:00:00",3,0,1,1,29.52,32,636,668
"2012-08-03 09:00:00",3,0,1,2,30.34,69,327,396
"2012-08-03 10:00:00",3,0,1,2,32.8,82,167,249
"2012-08-03 11:00:00",3,0,1,2,34.44,77,186,263
"2012-08-03 12:00:00",3,0,1,2,35.26,95,243,338
"2012-08-03 13:00:00",3,0,1,2,35.26,98,247,345
"2012-08-03 14:00:00",3,0,1,2,35.26,102,229,331
"2012-08-03 15:00:00",3,0,1,1,36.08,112,268,380
"2012-08-03 16:00:00",3,0,1,2,35.26,112,380,492
"2012-08-03 17:00:00",3,0,1,2,34.44,95,646,741
"2012-08-03 18:00:00",3,0,1,2,33.62,98,573,671
"2012-08-03 19:00:00",3,0,1,2,32.8,81,388,469
"2012-08-03 20:00:00",3,0,1,2,31.98,89,300,389
"2012-08-03 21:00:00",3,0,1,2,31.16,54,224,278
"2012-08-03 22:00:00",3,0,1,1,31.16,46,156,202
"2012-08-03 23:00:00",3,0,1,1,30.34,26,170,196
"2012-08-04 00:00:00",3,0,0,1,30.34,24,137,161
"2012-08-04 01:00:00",3,0,0,1,29.52,23,99,122
"2012-08-04 02:00:00",3,0,0,1,29.52,20,64,84
"2012-08-04 03:00:00",3,0,0,1,29.52,11,19,30
"2012-08-04 04:00:00",3,0,0,1,29.52,2,11,13
"2012-08-04 05:00:00",3,0,0,1,28.7,1,16,17
"2012-08-04 06:00:00",3,0,0,1,28.7,12,37,49
"2012-08-04 07:00:00",3,0,0,1,29.52,18,49,67
"2012-08-04 08:00:00",3,0,0,1,30.34,49,132,181
"2012-08-04 09:00:00",3,0,0,1,31.98,61,217,278
"2012-08-04 10:00:00",3,0,0,1,33.62,108,288,396
"2012-08-04 11:00:00",3,0,0,1,35.26,155,315,470
"2012-08-04 12:00:00",3,0,0,1,35.26,222,325,547
"2012-08-04 13:00:00",3,0,0,1,36.08,195,332,527
"2012-08-04 14:00:00",3,0,0,1,36.08,183,289,472
"2012-08-04 15:00:00",3,0,0,1,36.08,205,284,489
"2012-08-04 16:00:00",3,0,0,1,36.9,197,253,450
"2012-08-04 17:00:00",3,0,0,1,36.08,179,313,492
"2012-08-04 18:00:00",3,0,0,1,35.26,169,321,490
"2012-08-04 19:00:00",3,0,0,1,33.62,133,264,397
"2012-08-04 20:00:00",3,0,0,1,33.62,117,195,312
"2012-08-04 21:00:00",3,0,0,1,32.8,96,193,289
"2012-08-04 22:00:00",3,0,0,1,31.16,104,165,269
"2012-08-04 23:00:00",3,0,0,1,31.16,61,161,222
"2012-08-05 00:00:00",3,0,0,1,30.34,32,121,153
"2012-08-05 01:00:00",3,0,0,1,30.34,8,79,87
"2012-08-05 02:00:00",3,0,0,1,30.34,5,68,73
"2012-08-05 03:00:00",3,0,0,1,29.52,9,32,41
"2012-08-05 04:00:00",3,0,0,1,29.52,3,11,14
"2012-08-05 05:00:00",3,0,0,1,29.52,1,18,19
"2012-08-05 06:00:00",3,0,0,1,29.52,7,12,19
"2012-08-05 07:00:00",3,0,0,1,30.34,18,50,68
"2012-08-05 08:00:00",3,0,0,1,31.16,27,81,108
"2012-08-05 09:00:00",3,0,0,1,32.8,61,168,229
"2012-08-05 10:00:00",3,0,0,1,32.8,111,253,364
"2012-08-05 11:00:00",3,0,0,1,33.62,155,282,437
"2012-08-05 12:00:00",3,0,0,1,35.26,161,330,491
"2012-08-05 13:00:00",3,0,0,1,36.08,208,315,523
"2012-08-05 14:00:00",3,0,0,1,36.9,161,365,526
"2012-08-05 15:00:00",3,0,0,1,36.9,164,286,450
"2012-08-05 16:00:00",3,0,0,1,33.62,143,278,421
"2012-08-05 17:00:00",3,0,0,1,33.62,122,260,382
"2012-08-05 18:00:00",3,0,0,3,28.7,75,154,229
"2012-08-05 19:00:00",3,0,0,1,28.7,46,139,185
"2012-08-05 20:00:00",3,0,0,1,28.7,53,140,193
"2012-08-05 21:00:00",3,0,0,1,29.52,51,157,208
"2012-08-05 22:00:00",3,0,0,1,29.52,57,100,157
"2012-08-05 23:00:00",3,0,0,2,29.52,29,58,87
"2012-08-06 00:00:00",3,0,1,2,29.52,9,24,33
"2012-08-06 01:00:00",3,0,1,1,29.52,1,10,11
"2012-08-06 02:00:00",3,0,1,2,29.52,0,5,5
"2012-08-06 03:00:00",3,0,1,3,29.52,0,5,5
"2012-08-06 04:00:00",3,0,1,2,29.52,3,8,11
"2012-08-06 05:00:00",3,0,1,1,28.7,2,23,25
"2012-08-06 06:00:00",3,0,1,2,28.7,4,137,141
"2012-08-06 07:00:00",3,0,1,3,29.52,14,393,407
"2012-08-06 08:00:00",3,0,1,2,28.7,27,578,605
"2012-08-06 09:00:00",3,0,1,3,28.7,28,248,276
"2012-08-06 10:00:00",3,0,1,1,30.34,54,159,213
"2012-08-06 11:00:00",3,0,1,1,31.16,108,152,260
"2012-08-06 12:00:00",3,0,1,2,31.98,72,213,285
"2012-08-06 13:00:00",3,0,1,1,32.8,85,204,289
"2012-08-06 14:00:00",3,0,1,1,33.62,99,188,287
"2012-08-06 15:00:00",3,0,1,1,33.62,91,183,274
"2012-08-06 16:00:00",3,0,1,1,34.44,88,363,451
"2012-08-06 17:00:00",3,0,1,1,33.62,112,746,858
"2012-08-06 18:00:00",3,0,1,1,33.62,100,743,843
"2012-08-06 19:00:00",3,0,1,1,31.98,109,531,640
"2012-08-06 20:00:00",3,0,1,1,31.16,89,368,457
"2012-08-06 21:00:00",3,0,1,1,30.34,72,245,317
"2012-08-06 22:00:00",3,0,1,1,30.34,50,157,207
"2012-08-06 23:00:00",3,0,1,1,29.52,16,97,113
"2012-08-07 00:00:00",3,0,1,1,28.7,15,32,47
"2012-08-07 01:00:00",3,0,1,1,28.7,2,16,18
"2012-08-07 02:00:00",3,0,1,1,28.7,6,7,13
"2012-08-07 03:00:00",3,0,1,1,28.7,0,6,6
"2012-08-07 04:00:00",3,0,1,1,27.88,2,7,9
"2012-08-07 05:00:00",3,0,1,1,28.7,3,33,36
"2012-08-07 06:00:00",3,0,1,2,28.7,3,176,179
"2012-08-07 07:00:00",3,0,1,2,28.7,21,481,502
"2012-08-07 08:00:00",3,0,1,2,28.7,41,664,705
"2012-08-07 09:00:00",3,0,1,2,28.7,44,283,327
"2012-08-07 10:00:00",3,0,1,2,30.34,89,161,250
"2012-08-07 11:00:00",3,0,1,2,31.16,84,130,214
"2012-08-07 12:00:00",3,0,1,2,32.8,86,197,283
"2012-08-07 13:00:00",3,0,1,2,32.8,68,185,253
"2012-08-07 14:00:00",3,0,1,2,33.62,76,185,261
"2012-08-07 15:00:00",3,0,1,1,32.8,100,206,306
"2012-08-07 16:00:00",3,0,1,3,31.16,101,344,445
"2012-08-07 17:00:00",3,0,1,2,31.98,125,743,868
"2012-08-07 18:00:00",3,0,1,2,31.16,103,711,814
"2012-08-07 19:00:00",3,0,1,2,31.16,104,506,610
"2012-08-07 20:00:00",3,0,1,2,30.34,74,374,448
"2012-08-07 21:00:00",3,0,1,2,29.52,70,247,317
"2012-08-07 22:00:00",3,0,1,1,29.52,43,181,224
"2012-08-07 23:00:00",3,0,1,1,29.52,18,120,138
"2012-08-08 00:00:00",3,0,1,1,28.7,12,46,58
"2012-08-08 01:00:00",3,0,1,1,29.52,3,20,23
"2012-08-08 02:00:00",3,0,1,1,28.7,1,5,6
"2012-08-08 03:00:00",3,0,1,1,28.7,1,6,7
"2012-08-08 04:00:00",3,0,1,1,28.7,1,6,7
"2012-08-08 05:00:00",3,0,1,2,27.88,3,40,43
"2012-08-08 06:00:00",3,0,1,2,28.7,4,169,173
"2012-08-08 07:00:00",3,0,1,2,28.7,24,458,482
"2012-08-08 08:00:00",3,0,1,2,30.34,48,689,737
"2012-08-08 09:00:00",3,0,1,2,31.16,33,308,341
"2012-08-08 10:00:00",3,0,1,2,32.8,63,151,214
"2012-08-08 11:00:00",3,0,1,2,32.8,80,159,239
"2012-08-08 12:00:00",3,0,1,2,32.8,63,217,280
"2012-08-08 13:00:00",3,0,1,2,32.8,101,212,313
"2012-08-08 14:00:00",3,0,1,2,32.8,63,173,236
"2012-08-08 15:00:00",3,0,1,2,34.44,110,168,278
"2012-08-08 16:00:00",3,0,1,2,32.8,113,328,441
"2012-08-08 17:00:00",3,0,1,2,32.8,107,751,858
"2012-08-08 18:00:00",3,0,1,2,31.98,117,745,862
"2012-08-08 19:00:00",3,0,1,1,31.16,119,567,686
"2012-08-08 20:00:00",3,0,1,1,30.34,76,424,500
"2012-08-08 21:00:00",3,0,1,1,30.34,70,311,381
"2012-08-08 22:00:00",3,0,1,1,29.52,35,198,233
"2012-08-08 23:00:00",3,0,1,1,29.52,16,120,136
"2012-08-09 00:00:00",3,0,1,1,29.52,16,51,67
"2012-08-09 01:00:00",3,0,1,1,28.7,5,23,28
"2012-08-09 02:00:00",3,0,1,1,28.7,2,12,14
"2012-08-09 03:00:00",3,0,1,1,27.88,1,5,6
"2012-08-09 04:00:00",3,0,1,2,27.88,0,10,10
"2012-08-09 05:00:00",3,0,1,2,27.06,4,37,41
"2012-08-09 06:00:00",3,0,1,1,27.06,5,162,167
"2012-08-09 07:00:00",3,0,1,2,28.7,24,451,475
"2012-08-09 08:00:00",3,0,1,1,29.52,28,670,698
"2012-08-09 09:00:00",3,0,1,1,31.16,54,299,353
"2012-08-09 10:00:00",3,0,1,1,32.8,72,133,205
"2012-08-09 11:00:00",3,0,1,1,34.44,94,166,260
"2012-08-09 12:00:00",3,0,1,1,34.44,85,192,277
"2012-08-09 13:00:00",3,0,1,1,35.26,80,201,281
"2012-08-09 14:00:00",3,0,1,1,36.08,86,161,247
"2012-08-09 15:00:00",3,0,1,1,36.08,63,204,267
"2012-08-09 16:00:00",3,0,1,1,35.26,97,320,417
"2012-08-09 17:00:00",3,0,1,1,35.26,111,699,810
"2012-08-09 18:00:00",3,0,1,2,33.62,78,733,811
"2012-08-09 19:00:00",3,0,1,1,32.8,90,533,623
"2012-08-09 20:00:00",3,0,1,1,28.7,91,387,478
"2012-08-09 21:00:00",3,0,1,2,28.7,50,286,336
"2012-08-09 22:00:00",3,0,1,2,27.06,41,218,259
"2012-08-09 23:00:00",3,0,1,1,27.06,19,137,156
"2012-08-10 00:00:00",3,0,1,1,28.7,17,68,85
"2012-08-10 01:00:00",3,0,1,1,28.7,6,35,41
"2012-08-10 02:00:00",3,0,1,1,28.7,6,14,20
"2012-08-10 03:00:00",3,0,1,2,29.52,3,6,9
"2012-08-10 04:00:00",3,0,1,3,28.7,0,7,7
"2012-08-10 05:00:00",3,0,1,3,28.7,4,29,33
"2012-08-10 06:00:00",3,0,1,3,26.24,3,41,44
"2012-08-10 07:00:00",3,0,1,3,26.24,5,128,133
"2012-08-10 08:00:00",3,0,1,3,25.42,7,112,119
"2012-08-10 09:00:00",3,0,1,2,26.24,21,199,220
"2012-08-10 10:00:00",3,0,1,1,27.06,27,166,193
"2012-08-10 11:00:00",3,0,1,3,27.88,73,178,251
"2012-08-10 12:00:00",3,0,1,2,30.34,75,240,315
"2012-08-10 13:00:00",3,0,1,2,31.16,66,224,290
"2012-08-10 14:00:00",3,0,1,1,31.16,71,236,307
"2012-08-10 15:00:00",3,0,1,1,32.8,100,224,324
"2012-08-10 16:00:00",3,0,1,1,31.98,96,371,467
"2012-08-10 17:00:00",3,0,1,1,32.8,111,619,730
"2012-08-10 18:00:00",3,0,1,1,31.16,88,552,640
"2012-08-10 19:00:00",3,0,1,1,31.16,98,394,492
"2012-08-10 20:00:00",3,0,1,1,30.34,55,315,370
"2012-08-10 21:00:00",3,0,1,1,30.34,50,236,286
"2012-08-10 22:00:00",3,0,1,1,29.52,50,168,218
"2012-08-10 23:00:00",3,0,1,1,29.52,33,159,192
"2012-08-11 00:00:00",3,0,0,1,28.7,38,142,180
"2012-08-11 01:00:00",3,0,0,1,27.06,32,84,116
"2012-08-11 02:00:00",3,0,0,3,26.24,19,66,85
"2012-08-11 03:00:00",3,0,0,3,25.42,2,19,21
"2012-08-11 04:00:00",3,0,0,1,25.42,3,7,10
"2012-08-11 05:00:00",3,0,0,1,25.42,2,9,11
"2012-08-11 06:00:00",3,0,0,2,25.42,5,18,23
"2012-08-11 07:00:00",3,0,0,1,26.24,8,54,62
"2012-08-11 08:00:00",3,0,0,1,27.06,30,132,162
"2012-08-11 09:00:00",3,0,0,1,27.88,54,217,271
"2012-08-11 10:00:00",3,0,0,1,29.52,125,282,407
"2012-08-11 11:00:00",3,0,0,1,30.34,203,296,499
"2012-08-11 12:00:00",3,0,0,1,31.16,214,332,546
"2012-08-11 13:00:00",3,0,0,1,32.8,228,341,569
"2012-08-11 14:00:00",3,0,0,1,32.8,248,290,538
"2012-08-11 15:00:00",3,0,0,1,32.8,246,316,562
"2012-08-11 16:00:00",3,0,0,1,32.8,227,304,531
"2012-08-11 17:00:00",3,0,0,3,30.34,220,292,512
"2012-08-11 18:00:00",3,0,0,2,28.7,107,193,300
"2012-08-11 19:00:00",3,0,0,2,27.06,97,178,275
"2012-08-11 20:00:00",3,0,0,3,27.06,31,129,160
"2012-08-11 21:00:00",3,0,0,2,27.06,26,102,128
"2012-08-11 22:00:00",3,0,0,2,27.06,40,128,168
"2012-08-11 23:00:00",3,0,0,3,27.06,42,121,163
"2012-08-12 00:00:00",3,0,0,2,26.24,24,96,120
"2012-08-12 01:00:00",3,0,0,1,25.42,21,92,113
"2012-08-12 02:00:00",3,0,0,1,26.24,19,67,86
"2012-08-12 03:00:00",3,0,0,1,25.42,11,37,48
"2012-08-12 04:00:00",3,0,0,1,26.24,2,8,10
"2012-08-12 05:00:00",3,0,0,1,26.24,1,9,10
"2012-08-12 06:00:00",3,0,0,1,26.24,2,14,16
"2012-08-12 07:00:00",3,0,0,1,26.24,9,30,39
"2012-08-12 08:00:00",3,0,0,1,27.06,35,84,119
"2012-08-12 09:00:00",3,0,0,1,28.7,64,153,217
"2012-08-12 10:00:00",3,0,0,1,28.7,88,240,328
"2012-08-12 11:00:00",3,0,0,1,30.34,167,282,449
"2012-08-12 12:00:00",3,0,0,1,30.34,163,342,505
"2012-08-12 13:00:00",3,0,0,1,31.98,178,365,543
"2012-08-12 14:00:00",3,0,0,1,31.16,213,366,579
"2012-08-12 15:00:00",3,0,0,1,31.16,235,342,577
"2012-08-12 16:00:00",3,0,0,1,31.16,213,300,513
"2012-08-12 17:00:00",3,0,0,1,32.8,186,319,505
"2012-08-12 18:00:00",3,0,0,1,31.98,164,327,491
"2012-08-12 19:00:00",3,0,0,1,30.34,148,317,465
"2012-08-12 20:00:00",3,0,0,1,29.52,96,204,300
"2012-08-12 21:00:00",3,0,0,1,29.52,78,142,220
"2012-08-12 22:00:00",3,0,0,1,28.7,40,141,181
"2012-08-12 23:00:00",3,0,0,1,27.88,25,85,110
"2012-08-13 00:00:00",3,0,1,1,27.06,14,33,47
"2012-08-13 01:00:00",3,0,1,1,27.06,3,11,14
"2012-08-13 02:00:00",3,0,1,1,26.24,1,8,9
"2012-08-13 03:00:00",3,0,1,1,26.24,1,5,6
"2012-08-13 04:00:00",3,0,1,1,26.24,0,11,11
"2012-08-13 05:00:00",3,0,1,1,26.24,3,33,36
"2012-08-13 06:00:00",3,0,1,1,25.42,4,155,159
"2012-08-13 07:00:00",3,0,1,1,27.06,11,425,436
"2012-08-13 08:00:00",3,0,1,2,29.52,25,648,673
"2012-08-13 09:00:00",3,0,1,2,30.34,40,265,305
"2012-08-13 10:00:00",3,0,1,2,31.16,88,111,199
"2012-08-13 11:00:00",3,0,1,1,31.16,94,151,245
"2012-08-13 12:00:00",3,0,1,1,31.98,96,180,276
"2012-08-13 13:00:00",3,0,1,1,31.98,79,175,254
"2012-08-13 14:00:00",3,0,1,1,32.8,85,163,248
"2012-08-13 15:00:00",3,0,1,1,33.62,80,194,274
"2012-08-13 16:00:00",3,0,1,1,32.8,116,348,464
"2012-08-13 17:00:00",3,0,1,1,32.8,102,716,818
"2012-08-13 18:00:00",3,0,1,1,31.16,103,709,812
"2012-08-13 19:00:00",3,0,1,1,30.34,88,467,555
"2012-08-13 20:00:00",3,0,1,1,30.34,58,374,432
"2012-08-13 21:00:00",3,0,1,1,29.52,44,246,290
"2012-08-13 22:00:00",3,0,1,1,29.52,44,148,192
"2012-08-13 23:00:00",3,0,1,1,28.7,28,100,128
"2012-08-14 00:00:00",3,0,1,1,28.7,12,48,60
"2012-08-14 01:00:00",3,0,1,1,27.88,8,19,27
"2012-08-14 02:00:00",3,0,1,2,27.88,2,9,11
"2012-08-14 03:00:00",3,0,1,2,27.88,0,3,3
"2012-08-14 04:00:00",3,0,1,2,27.88,0,5,5
"2012-08-14 05:00:00",3,0,1,2,27.88,1,35,36
"2012-08-14 06:00:00",3,0,1,3,26.24,1,63,64
"2012-08-14 07:00:00",3,0,1,2,27.06,1,178,179
"2012-08-14 08:00:00",3,0,1,2,27.06,27,591,618
"2012-08-14 09:00:00",3,0,1,2,28.7,48,354,402
"2012-08-14 10:00:00",3,0,1,1,28.7,53,155,208
"2012-08-14 11:00:00",3,0,1,1,30.34,69,127,196
"2012-08-14 12:00:00",3,0,1,1,31.98,93,207,300
"2012-08-14 13:00:00",3,0,1,1,32.8,83,203,286
"2012-08-14 14:00:00",3,0,1,1,33.62,80,175,255
"2012-08-14 15:00:00",3,0,1,1,33.62,84,199,283
"2012-08-14 16:00:00",3,0,1,1,33.62,95,363,458
"2012-08-14 17:00:00",3,0,1,3,31.16,78,734,812
"2012-08-14 18:00:00",3,0,1,1,31.16,97,757,854
"2012-08-14 19:00:00",3,0,1,1,31.16,94,533,627
"2012-08-14 20:00:00",3,0,1,1,30.34,65,371,436
"2012-08-14 21:00:00",3,0,1,1,30.34,56,252,308
"2012-08-14 22:00:00",3,0,1,1,29.52,28,161,189
"2012-08-14 23:00:00",3,0,1,1,29.52,53,114,167
"2012-08-15 00:00:00",3,0,1,1,28.7,8,52,60
"2012-08-15 01:00:00",3,0,1,1,28.7,6,31,37
"2012-08-15 02:00:00",3,0,1,1,27.88,1,7,8
"2012-08-15 03:00:00",3,0,1,1,27.06,1,10,11
"2012-08-15 04:00:00",3,0,1,1,26.24,0,4,4
"2012-08-15 05:00:00",3,0,1,1,26.24,4,35,39
"2012-08-15 06:00:00",3,0,1,1,26.24,12,160,172
"2012-08-15 07:00:00",3,0,1,2,27.06,25,467,492
"2012-08-15 08:00:00",3,0,1,2,28.7,40,642,682
"2012-08-15 09:00:00",3,0,1,2,29.52,57,310,367
"2012-08-15 10:00:00",3,0,1,2,29.52,70,163,233
"2012-08-15 11:00:00",3,0,1,2,30.34,80,155,235
"2012-08-15 12:00:00",3,0,1,1,30.34,77,230,307
"2012-08-15 13:00:00",3,0,1,2,31.98,88,206,294
"2012-08-15 14:00:00",3,0,1,2,31.16,94,161,255
"2012-08-15 15:00:00",3,0,1,1,31.16,70,196,266
"2012-08-15 16:00:00",3,0,1,1,31.16,91,340,431
"2012-08-15 17:00:00",3,0,1,1,30.34,102,749,851
"2012-08-15 18:00:00",3,0,1,1,30.34,80,768,848
"2012-08-15 19:00:00",3,0,1,1,28.7,124,525,649
"2012-08-15 20:00:00",3,0,1,1,28.7,72,355,427
"2012-08-15 21:00:00",3,0,1,1,28.7,49,266,315
"2012-08-15 22:00:00",3,0,1,1,28.7,29,197,226
"2012-08-15 23:00:00",3,0,1,1,27.88,18,120,138
"2012-08-16 00:00:00",3,0,1,1,27.06,13,63,76
"2012-08-16 01:00:00",3,0,1,1,26.24,3,18,21
"2012-08-16 02:00:00",3,0,1,1,26.24,0,15,15
"2012-08-16 03:00:00",3,0,1,1,25.42,0,4,4
"2012-08-16 04:00:00",3,0,1,1,25.42,2,3,5
"2012-08-16 05:00:00",3,0,1,1,24.6,7,30,37
"2012-08-16 06:00:00",3,0,1,1,24.6,3,162,165
"2012-08-16 07:00:00",3,0,1,1,26.24,16,448,464
"2012-08-16 08:00:00",3,0,1,1,27.88,33,649,682
"2012-08-16 09:00:00",3,0,1,1,29.52,41,296,337
"2012-08-16 10:00:00",3,0,1,1,30.34,78,121,199
"2012-08-16 11:00:00",3,0,1,1,31.16,83,191,274
"2012-08-16 12:00:00",3,0,1,1,32.8,96,247,343
"2012-08-16 13:00:00",3,0,1,1,32.8,81,219,300
"2012-08-16 14:00:00",3,0,1,1,33.62,72,176,248
"2012-08-16 15:00:00",3,0,1,1,32.8,63,197,260
"2012-08-16 16:00:00",3,0,1,1,33.62,79,340,419
"2012-08-16 17:00:00",3,0,1,1,33.62,130,767,897
"2012-08-16 18:00:00",3,0,1,1,32.8,109,723,832
"2012-08-16 19:00:00",3,0,1,1,31.16,119,558,677
"2012-08-16 20:00:00",3,0,1,1,31.16,100,414,514
"2012-08-16 21:00:00",3,0,1,1,30.34,83,273,356
"2012-08-16 22:00:00",3,0,1,1,29.52,69,185,254
"2012-08-16 23:00:00",3,0,1,1,28.7,58,168,226
"2012-08-17 00:00:00",3,0,1,1,27.88,21,67,88
"2012-08-17 01:00:00",3,0,1,1,27.06,16,38,54
"2012-08-17 02:00:00",3,0,1,1,27.06,4,15,19
"2012-08-17 03:00:00",3,0,1,1,26.24,0,6,6
"2012-08-17 04:00:00",3,0,1,1,26.24,0,9,9
"2012-08-17 05:00:00",3,0,1,1,26.24,2,34,36
"2012-08-17 06:00:00",3,0,1,1,25.42,6,151,157
"2012-08-17 07:00:00",3,0,1,1,26.24,11,368,379
"2012-08-17 08:00:00",3,0,1,1,27.88,43,625,668
"2012-08-17 09:00:00",3,0,1,1,28.7,58,320,378
"2012-08-17 10:00:00",3,0,1,1,30.34,82,149,231
"2012-08-17 11:00:00",3,0,1,1,31.16,98,205,303
"2012-08-17 12:00:00",3,0,1,1,33.62,110,255,365
"2012-08-17 13:00:00",3,0,1,1,34.44,103,254,357
"2012-08-17 14:00:00",3,0,1,1,35.26,128,200,328
"2012-08-17 15:00:00",3,0,1,1,35.26,127,256,383
"2012-08-17 16:00:00",3,0,1,2,34.44,116,372,488
"2012-08-17 17:00:00",3,0,1,1,33.62,144,647,791
"2012-08-17 18:00:00",3,0,1,2,33.62,108,561,669
"2012-08-17 19:00:00",3,0,1,2,30.34,88,403,491
"2012-08-17 20:00:00",3,0,1,2,29.52,97,262,359
"2012-08-17 21:00:00",3,0,1,2,27.88,57,198,255
"2012-08-17 22:00:00",3,0,1,3,27.06,43,170,213
"2012-08-17 23:00:00",3,0,1,3,26.24,21,100,121
"2012-08-18 00:00:00",3,0,0,2,26.24,6,99,105
"2012-08-18 01:00:00",3,0,0,3,25.42,14,78,92
"2012-08-18 02:00:00",3,0,0,3,25.42,4,39,43
"2012-08-18 03:00:00",3,0,0,1,25.42,7,23,30
"2012-08-18 04:00:00",3,0,0,1,25.42,5,8,13
"2012-08-18 05:00:00",3,0,0,1,24.6,2,7,9
"2012-08-18 06:00:00",3,0,0,1,24.6,4,23,27
"2012-08-18 07:00:00",3,0,0,1,24.6,12,52,64
"2012-08-18 08:00:00",3,0,0,1,26.24,28,161,189
"2012-08-18 09:00:00",3,0,0,1,27.06,81,211,292
"2012-08-18 10:00:00",3,0,0,1,28.7,166,314,480
"2012-08-18 11:00:00",3,0,0,1,29.52,180,356,536
"2012-08-18 12:00:00",3,0,0,1,31.16,266,388,654
"2012-08-18 13:00:00",3,0,0,1,30.34,289,355,644
"2012-08-18 14:00:00",3,0,0,1,31.16,242,356,598
"2012-08-18 15:00:00",3,0,0,1,31.16,250,346,596
"2012-08-18 16:00:00",3,0,0,1,31.16,287,354,641
"2012-08-18 17:00:00",3,0,0,1,31.16,256,379,635
"2012-08-18 18:00:00",3,0,0,1,30.34,225,329,554
"2012-08-18 19:00:00",3,0,0,1,28.7,164,324,488
"2012-08-18 20:00:00",3,0,0,1,28.7,99,242,341
"2012-08-18 21:00:00",3,0,0,1,27.06,90,248,338
"2012-08-18 22:00:00",3,0,0,1,27.06,90,171,261
"2012-08-18 23:00:00",3,0,0,1,26.24,60,175,235
"2012-08-19 00:00:00",3,0,0,1,27.06,44,143,187
"2012-08-19 01:00:00",3,0,0,1,26.24,29,102,131
"2012-08-19 02:00:00",3,0,0,2,25.42,16,103,119
"2012-08-19 03:00:00",3,0,0,2,25.42,21,34,55
"2012-08-19 04:00:00",3,0,0,2,25.42,4,22,26
"2012-08-19 05:00:00",3,0,0,2,24.6,3,8,11
"2012-08-19 06:00:00",3,0,0,2,25.42,5,15,20
"2012-08-19 07:00:00",3,0,0,2,25.42,12,29,41
"2012-08-19 08:00:00",3,0,0,2,26.24,34,90,124
"2012-08-19 09:00:00",3,0,0,2,27.06,86,184,270
"2012-08-19 10:00:00",3,0,0,2,27.88,138,287,425
"2012-08-19 11:00:00",3,0,0,3,26.24,83,189,272
"2012-08-19 12:00:00",3,0,0,3,26.24,112,186,298
"2012-08-19 13:00:00",3,0,0,3,26.24,50,112,162
"2012-08-19 14:00:00",3,0,0,3,26.24,41,108,149
"2012-08-19 15:00:00",3,0,0,2,26.24,89,187,276
"2012-08-19 16:00:00",3,0,0,2,27.06,97,259,356
"2012-08-19 17:00:00",3,0,0,2,26.24,76,267,343
"2012-08-19 18:00:00",3,0,0,2,26.24,86,291,377
"2012-08-19 19:00:00",3,0,0,2,26.24,72,269,341
"2012-08-19 20:00:00",3,0,0,2,26.24,61,213,274
"2012-08-19 21:00:00",3,0,0,3,25.42,36,154,190
"2012-08-19 22:00:00",3,0,0,2,25.42,6,50,56
"2012-08-19 23:00:00",3,0,0,2,25.42,7,39,46
"2012-09-01 00:00:00",3,0,0,1,30.34,22,146,168
"2012-09-01 01:00:00",3,0,0,1,29.52,11,68,79
"2012-09-01 02:00:00",3,0,0,1,28.7,8,61,69
"2012-09-01 03:00:00",3,0,0,1,28.7,6,29,35
"2012-09-01 04:00:00",3,0,0,1,28.7,3,9,12
"2012-09-01 05:00:00",3,0,0,1,27.88,2,20,22
"2012-09-01 06:00:00",3,0,0,1,27.88,13,23,36
"2012-09-01 07:00:00",3,0,0,2,30.34,8,58,66
"2012-09-01 08:00:00",3,0,0,2,31.16,28,134,162
"2012-09-01 09:00:00",3,0,0,2,31.16,62,175,237
"2012-09-01 10:00:00",3,0,0,2,31.98,128,289,417
"2012-09-01 11:00:00",3,0,0,2,32.8,219,273,492
"2012-09-01 12:00:00",3,0,0,2,32.8,187,284,471
"2012-09-01 13:00:00",3,0,0,2,33.62,237,267,504
"2012-09-01 14:00:00",3,0,0,2,35.26,240,274,514
"2012-09-01 15:00:00",3,0,0,2,35.26,257,306,563
"2012-09-01 16:00:00",3,0,0,2,34.44,209,253,462
"2012-09-01 17:00:00",3,0,0,2,33.62,205,258,463
"2012-09-01 18:00:00",3,0,0,2,33.62,184,258,442
"2012-09-01 19:00:00",3,0,0,3,31.98,157,235,392
"2012-09-01 20:00:00",3,0,0,3,31.16,67,140,207
"2012-09-01 21:00:00",3,0,0,3,26.24,21,83,104
"2012-09-01 22:00:00",3,0,0,2,27.06,21,57,78
"2012-09-01 23:00:00",3,0,0,1,27.06,57,88,145
"2012-09-02 00:00:00",3,0,0,2,27.06,27,72,99
"2012-09-02 01:00:00",3,0,0,1,27.06,15,58,73
"2012-09-02 02:00:00",3,0,0,1,27.06,28,56,84
"2012-09-02 03:00:00",3,0,0,1,27.06,9,33,42
"2012-09-02 04:00:00",3,0,0,1,27.06,7,15,22
"2012-09-02 05:00:00",3,0,0,1,27.06,2,10,12
"2012-09-02 06:00:00",3,0,0,2,27.06,2,13,15
"2012-09-02 07:00:00",3,0,0,1,27.06,13,29,42
"2012-09-02 08:00:00",3,0,0,1,27.88,30,99,129
"2012-09-02 09:00:00",3,0,0,2,28.7,88,144,232
"2012-09-02 10:00:00",3,0,0,2,29.52,158,230,388
"2012-09-02 11:00:00",3,0,0,2,30.34,226,263,489
"2012-09-02 12:00:00",3,0,0,3,30.34,248,297,545
"2012-09-02 13:00:00",3,0,0,3,29.52,263,230,493
"2012-09-02 14:00:00",3,0,0,3,29.52,249,208,457
"2012-09-02 15:00:00",3,0,0,3,30.34,179,176,355
"2012-09-02 16:00:00",3,0,0,1,30.34,222,252,474
"2012-09-02 17:00:00",3,0,0,1,31.16,219,284,503
"2012-09-02 18:00:00",3,0,0,1,30.34,227,273,500
"2012-09-02 19:00:00",3,0,0,2,28.7,140,152,292
"2012-09-02 20:00:00",3,0,0,2,28.7,63,41,104
"2012-09-02 21:00:00",3,0,0,1,28.7,79,92,171
"2012-09-02 22:00:00",3,0,0,3,27.88,66,100,166
"2012-09-02 23:00:00",3,0,0,3,27.06,53,70,123
"2012-09-03 00:00:00",3,1,0,2,27.06,42,62,104
"2012-09-03 01:00:00",3,1,0,2,27.88,18,37,55
"2012-09-03 02:00:00",3,1,0,1,27.06,10,30,40
"2012-09-03 03:00:00",3,1,0,1,27.06,6,22,28
"2012-09-03 04:00:00",3,1,0,1,27.06,6,5,11
"2012-09-03 05:00:00",3,1,0,1,27.06,1,3,4
"2012-09-03 06:00:00",3,1,0,1,27.06,3,12,15
"2012-09-03 07:00:00",3,1,0,1,27.88,6,37,43
"2012-09-03 08:00:00",3,1,0,2,28.7,36,91,127
"2012-09-03 09:00:00",3,1,0,2,28.7,71,158,229
"2012-09-03 10:00:00",3,1,0,2,30.34,135,224,359
"2012-09-03 11:00:00",3,1,0,2,30.34,187,272,459
"2012-09-03 12:00:00",3,1,0,2,31.16,191,352,543
"2012-09-03 13:00:00",3,1,0,2,31.16,209,357,566
"2012-09-03 14:00:00",3,1,0,1,30.34,163,349,512
"2012-09-03 15:00:00",3,1,0,1,30.34,168,281,449
"2012-09-03 16:00:00",3,1,0,1,30.34,165,335,500
"2012-09-03 17:00:00",3,1,0,1,30.34,181,317,498
"2012-09-03 18:00:00",3,1,0,1,30.34,145,337,482
"2012-09-03 19:00:00",3,1,0,1,29.52,73,301,374
"2012-09-03 20:00:00",3,1,0,1,29.52,78,183,261
"2012-09-03 21:00:00",3,1,0,1,29.52,42,142,184
"2012-09-03 22:00:00",3,1,0,2,28.7,17,104,121
"2012-09-03 23:00:00",3,1,0,2,28.7,12,58,70
"2012-09-04 00:00:00",3,0,1,2,28.7,10,19,29
"2012-09-04 01:00:00",3,0,1,1,27.88,15,9,24
"2012-09-04 02:00:00",3,0,1,1,27.88,1,4,5
"2012-09-04 03:00:00",3,0,1,2,27.06,1,9,10
"2012-09-04 04:00:00",3,0,1,2,27.06,0,8,8
"2012-09-04 05:00:00",3,0,1,2,27.06,1,37,38
"2012-09-04 06:00:00",3,0,1,2,27.88,7,165,172
"2012-09-04 07:00:00",3,0,1,2,27.88,13,480,493
"2012-09-04 08:00:00",3,0,1,1,28.7,15,617,632
"2012-09-04 09:00:00",3,0,1,2,29.52,30,293,323
"2012-09-04 10:00:00",3,0,1,2,29.52,42,130,172
"2012-09-04 11:00:00",3,0,1,2,30.34,39,159,198
"2012-09-04 12:00:00",3,0,1,1,31.16,54,233,287
"2012-09-04 13:00:00",3,0,1,1,32.8,72,203,275
"2012-09-04 14:00:00",3,0,1,1,32.8,72,202,274
"2012-09-04 15:00:00",3,0,1,1,32.8,68,224,292
"2012-09-04 16:00:00",3,0,1,1,31.16,61,397,458
"2012-09-04 17:00:00",3,0,1,1,31.16,110,746,856
"2012-09-04 18:00:00",3,0,1,1,31.16,94,745,839
"2012-09-04 19:00:00",3,0,1,1,31.16,50,502,552
"2012-09-04 20:00:00",3,0,1,1,30.34,47,338,385
"2012-09-04 21:00:00",3,0,1,1,30.34,28,240,268
"2012-09-04 22:00:00",3,0,1,1,30.34,25,154,179
"2012-09-04 23:00:00",3,0,1,1,29.52,12,83,95
"2012-09-05 00:00:00",3,0,1,1,29.52,10,27,37
"2012-09-05 01:00:00",3,0,1,1,28.7,2,11,13
"2012-09-05 02:00:00",3,0,1,1,28.7,0,9,9
"2012-09-05 03:00:00",3,0,1,1,28.7,0,4,4
"2012-09-05 04:00:00",3,0,1,1,28.7,2,3,5
"2012-09-05 05:00:00",3,0,1,2,28.7,1,39,40
"2012-09-05 06:00:00",3,0,1,1,28.7,7,203,210
"2012-09-05 07:00:00",3,0,1,2,28.7,11,489,500
"2012-09-05 08:00:00",3,0,1,1,29.52,33,692,725
"2012-09-05 09:00:00",3,0,1,1,30.34,27,263,290
"2012-09-05 10:00:00",3,0,1,2,31.16,54,181,235
"2012-09-05 11:00:00",3,0,1,2,31.98,61,156,217
"2012-09-05 12:00:00",3,0,1,1,31.98,49,217,266
"2012-09-05 13:00:00",3,0,1,1,32.8,50,184,234
"2012-09-05 14:00:00",3,0,1,1,33.62,34,177,211
"2012-09-05 15:00:00",3,0,1,1,31.98,41,204,245
"2012-09-05 16:00:00",3,0,1,1,31.16,86,344,430
"2012-09-05 17:00:00",3,0,1,1,31.16,83,780,863
"2012-09-05 18:00:00",3,0,1,1,31.16,82,757,839
"2012-09-05 19:00:00",3,0,1,1,30.34,64,598,662
"2012-09-05 20:00:00",3,0,1,1,29.52,55,357,412
"2012-09-05 21:00:00",3,0,1,1,29.52,18,278,296
"2012-09-05 22:00:00",3,0,1,1,29.52,38,181,219
"2012-09-05 23:00:00",3,0,1,1,28.7,24,126,150
"2012-09-06 00:00:00",3,0,1,2,28.7,30,35,65
"2012-09-06 01:00:00",3,0,1,2,28.7,2,16,18
"2012-09-06 02:00:00",3,0,1,1,29.52,1,7,8
"2012-09-06 03:00:00",3,0,1,1,28.7,0,9,9
"2012-09-06 04:00:00",3,0,1,2,28.7,0,8,8
"2012-09-06 05:00:00",3,0,1,2,28.7,3,35,38
"2012-09-06 06:00:00",3,0,1,2,28.7,11,189,200
"2012-09-06 07:00:00",3,0,1,2,28.7,21,461,482
"2012-09-06 08:00:00",3,0,1,3,28.7,24,622,646
"2012-09-06 09:00:00",3,0,1,3,27.06,8,115,123
"2012-09-06 10:00:00",3,0,1,3,27.06,9,40,49
"2012-09-06 11:00:00",3,0,1,3,28.7,10,52,62
"2012-09-06 12:00:00",3,0,1,2,29.52,11,126,137
"2012-09-06 13:00:00",3,0,1,2,29.52,39,152,191
"2012-09-06 14:00:00",3,0,1,1,30.34,38,178,216
"2012-09-06 15:00:00",3,0,1,1,30.34,42,228,270
"2012-09-06 16:00:00",3,0,1,1,30.34,42,374,416
"2012-09-06 17:00:00",3,0,1,1,30.34,67,741,808
"2012-09-06 18:00:00",3,0,1,1,29.52,74,761,835
"2012-09-06 19:00:00",3,0,1,1,27.88,54,504,558
"2012-09-06 20:00:00",3,0,1,1,27.06,50,356,406
"2012-09-06 21:00:00",3,0,1,1,26.24,32,240,272
"2012-09-06 22:00:00",3,0,1,1,26.24,24,193,217
"2012-09-06 23:00:00",3,0,1,1,26.24,19,150,169
"2012-09-07 00:00:00",3,0,1,1,26.24,17,79,96
"2012-09-07 01:00:00",3,0,1,1,25.42,10,19,29
"2012-09-07 02:00:00",3,0,1,1,25.42,1,10,11
"2012-09-07 03:00:00",3,0,1,1,25.42,0,9,9
"2012-09-07 04:00:00",3,0,1,1,25.42,1,7,8
"2012-09-07 05:00:00",3,0,1,1,25.42,1,39,40
"2012-09-07 06:00:00",3,0,1,1,25.42,5,135,140
"2012-09-07 07:00:00",3,0,1,1,26.24,21,465,486
"2012-09-07 08:00:00",3,0,1,1,27.06,29,690,719
"2012-09-07 09:00:00",3,0,1,1,28.7,33,311,344
"2012-09-07 10:00:00",3,0,1,1,29.52,53,171,224
"2012-09-07 11:00:00",3,0,1,1,31.16,81,215,296
"2012-09-07 12:00:00",3,0,1,1,31.98,76,247,323
"2012-09-07 13:00:00",3,0,1,1,32.8,71,283,354
"2012-09-07 14:00:00",3,0,1,1,32.8,66,187,253
"2012-09-07 15:00:00",3,0,1,1,32.8,66,265,331
"2012-09-07 16:00:00",3,0,1,1,32.8,75,395,470
"2012-09-07 17:00:00",3,0,1,1,31.98,88,684,772
"2012-09-07 18:00:00",3,0,1,1,31.16,95,697,792
"2012-09-07 19:00:00",3,0,1,1,30.34,70,498,568
"2012-09-07 20:00:00",3,0,1,1,29.52,51,340,391
"2012-09-07 21:00:00",3,0,1,1,28.7,55,246,301
"2012-09-07 22:00:00",3,0,1,1,28.7,52,247,299
"2012-09-07 23:00:00",3,0,1,1,27.06,28,220,248
"2012-09-08 00:00:00",3,0,0,1,27.06,20,130,150
"2012-09-08 01:00:00",3,0,0,2,27.06,10,107,117
"2012-09-08 02:00:00",3,0,0,1,27.06,9,68,77
"2012-09-08 03:00:00",3,0,0,2,27.06,3,40,43
"2012-09-08 04:00:00",3,0,0,2,27.06,3,8,11
"2012-09-08 05:00:00",3,0,0,2,27.06,2,13,15
"2012-09-08 06:00:00",3,0,0,2,27.06,8,26,34
"2012-09-08 07:00:00",3,0,0,1,27.06,11,71,82
"2012-09-08 08:00:00",3,0,0,1,28.7,33,197,230
"2012-09-08 09:00:00",3,0,0,1,28.7,87,261,348
"2012-09-08 10:00:00",3,0,0,1,30.34,100,322,422
"2012-09-08 11:00:00",3,0,0,1,31.16,173,405,578
"2012-09-08 12:00:00",3,0,0,1,32.8,220,474,694
"2012-09-08 13:00:00",3,0,0,1,33.62,233,435,668
"2012-09-08 14:00:00",3,0,0,1,33.62,260,366,626
"2012-09-08 15:00:00",3,0,0,3,22.96,175,337,512
"2012-09-08 16:00:00",3,0,0,3,22.96,19,95,114
"2012-09-08 17:00:00",3,0,0,3,23.78,52,119,171
"2012-09-08 18:00:00",3,0,0,3,23.78,27,140,167
"2012-09-08 19:00:00",3,0,0,3,23.78,28,187,215
"2012-09-08 20:00:00",3,0,0,2,23.78,28,166,194
"2012-09-08 21:00:00",3,0,0,2,24.6,26,155,181
"2012-09-08 22:00:00",3,0,0,2,23.78,18,176,194
"2012-09-08 23:00:00",3,0,0,2,23.78,12,121,133
"2012-09-09 00:00:00",3,0,0,2,22.96,18,106,124
"2012-09-09 01:00:00",3,0,0,1,22.96,20,104,124
"2012-09-09 02:00:00",3,0,0,1,22.14,15,81,96
"2012-09-09 03:00:00",3,0,0,1,22.14,14,32,46
"2012-09-09 04:00:00",3,0,0,1,21.32,12,16,28
"2012-09-09 05:00:00",3,0,0,1,21.32,16,39,55
"2012-09-09 06:00:00",3,0,0,1,21.32,11,24,35
"2012-09-09 07:00:00",3,0,0,1,22.14,20,50,70
"2012-09-09 08:00:00",3,0,0,1,23.78,27,143,170
"2012-09-09 09:00:00",3,0,0,1,25.42,85,214,299
"2012-09-09 10:00:00",3,0,0,1,26.24,172,323,495
"2012-09-09 11:00:00",3,0,0,1,27.06,194,391,585
"2012-09-09 12:00:00",3,0,0,1,27.06,247,510,757
"2012-09-09 13:00:00",3,0,0,1,27.88,238,491,729
"2012-09-09 14:00:00",3,0,0,1,29.52,232,415,647
"2012-09-09 15:00:00",3,0,0,1,29.52,284,412,696
"2012-09-09 16:00:00",3,0,0,1,27.88,228,473,701
"2012-09-09 17:00:00",3,0,0,1,28.7,213,458,671
"2012-09-09 18:00:00",3,0,0,1,27.06,156,404,560
"2012-09-09 19:00:00",3,0,0,1,27.06,134,362,496
"2012-09-09 20:00:00",3,0,0,1,25.42,91,265,356
"2012-09-09 21:00:00",3,0,0,1,24.6,57,149,206
"2012-09-09 22:00:00",3,0,0,1,23.78,64,125,189
"2012-09-09 23:00:00",3,0,0,1,22.96,22,70,92
"2012-09-10 00:00:00",3,0,1,1,22.96,6,35,41
"2012-09-10 01:00:00",3,0,1,1,22.14,7,11,18
"2012-09-10 02:00:00",3,0,1,1,22.14,11,6,17
"2012-09-10 03:00:00",3,0,1,1,21.32,5,7,12
"2012-09-10 04:00:00",3,0,1,1,21.32,1,4,5
"2012-09-10 05:00:00",3,0,1,1,20.5,4,36,40
"2012-09-10 06:00:00",3,0,1,1,20.5,8,172,180
"2012-09-10 07:00:00",3,0,1,1,21.32,20,427,447
"2012-09-10 08:00:00",3,0,1,1,22.96,33,697,730
"2012-09-10 09:00:00",3,0,1,1,24.6,40,321,361
"2012-09-10 10:00:00",3,0,1,1,25.42,42,168,210
"2012-09-10 11:00:00",3,0,1,1,25.42,69,167,236
"2012-09-10 12:00:00",3,0,1,1,26.24,76,256,332
"2012-09-10 13:00:00",3,0,1,1,26.24,72,251,323
"2012-09-10 14:00:00",3,0,1,1,27.06,107,233,340
"2012-09-10 15:00:00",3,0,1,1,27.06,115,231,346
"2012-09-10 16:00:00",3,0,1,1,27.06,108,380,488
"2012-09-10 17:00:00",3,0,1,1,27.06,127,744,871
"2012-09-10 18:00:00",3,0,1,1,25.42,111,857,968
"2012-09-10 19:00:00",3,0,1,1,25.42,71,562,633
"2012-09-10 20:00:00",3,0,1,1,24.6,34,356,390
"2012-09-10 21:00:00",3,0,1,1,22.96,29,256,285
"2012-09-10 22:00:00",3,0,1,1,22.14,15,144,159
"2012-09-10 23:00:00",3,0,1,1,22.14,7,86,93
"2012-09-11 00:00:00",3,0,1,1,21.32,5,27,32
"2012-09-11 01:00:00",3,0,1,1,20.5,0,10,10
"2012-09-11 02:00:00",3,0,1,1,19.68,1,5,6
"2012-09-11 03:00:00",3,0,1,1,19.68,1,7,8
"2012-09-11 04:00:00",3,0,1,1,19.68,1,8,9
"2012-09-11 05:00:00",3,0,1,1,18.86,3,41,44
"2012-09-11 06:00:00",3,0,1,1,18.86,11,200,211
"2012-09-11 07:00:00",3,0,1,1,20.5,24,572,596
"2012-09-11 08:00:00",3,0,1,1,22.14,48,702,750
"2012-09-11 09:00:00",3,0,1,1,24.6,35,323,358
"2012-09-11 10:00:00",3,0,1,1,25.42,54,142,196
"2012-09-11 11:00:00",3,0,1,1,26.24,60,187,247
"2012-09-11 12:00:00",3,0,1,1,26.24,62,254,316
"2012-09-11 13:00:00",3,0,1,1,27.06,72,256,328
"2012-09-11 14:00:00",3,0,1,1,27.88,74,181,255
"2012-09-11 15:00:00",3,0,1,1,28.7,73,253,326
"2012-09-11 16:00:00",3,0,1,1,28.7,99,437,536
"2012-09-11 17:00:00",3,0,1,1,28.7,168,802,970
"2012-09-11 18:00:00",3,0,1,1,26.24,110,767,877
"2012-09-11 19:00:00",3,0,1,1,25.42,56,540,596
"2012-09-11 20:00:00",3,0,1,1,23.78,40,421,461
"2012-09-11 21:00:00",3,0,1,1,22.96,28,282,310
"2012-09-11 22:00:00",3,0,1,1,22.96,27,189,216
"2012-09-11 23:00:00",3,0,1,1,22.14,18,91,109
"2012-09-12 00:00:00",3,0,1,1,21.32,8,41,49
"2012-09-12 01:00:00",3,0,1,1,21.32,2,19,21
"2012-09-12 02:00:00",3,0,1,1,21.32,2,9,11
"2012-09-12 03:00:00",3,0,1,1,20.5,0,7,7
"2012-09-12 04:00:00",3,0,1,1,20.5,0,5,5
"2012-09-12 05:00:00",3,0,1,1,20.5,4,44,48
"2012-09-12 06:00:00",3,0,1,1,20.5,6,199,205
"2012-09-12 07:00:00",3,0,1,1,21.32,24,533,557
"2012-09-12 08:00:00",3,0,1,1,22.96,43,727,770
"2012-09-12 09:00:00",3,0,1,1,24.6,50,278,328
"2012-09-12 10:00:00",3,0,1,1,25.42,57,148,205
"2012-09-12 11:00:00",3,0,1,1,27.06,51,181,232
"2012-09-12 12:00:00",3,0,1,1,27.88,88,264,352
"2012-09-12 13:00:00",3,0,1,1,28.7,85,238,323
"2012-09-12 14:00:00",3,0,1,1,28.7,78,200,278
"2012-09-12 15:00:00",3,0,1,1,29.52,75,243,318
"2012-09-12 16:00:00",3,0,1,1,29.52,90,419,509
"2012-09-12 17:00:00",3,0,1,1,28.7,114,811,925
"2012-09-12 18:00:00",3,0,1,1,27.06,91,886,977
"2012-09-12 19:00:00",3,0,1,1,26.24,78,557,635
"2012-09-12 20:00:00",3,0,1,1,25.42,38,432,470
"2012-09-12 21:00:00",3,0,1,1,24.6,27,279,306
"2012-09-12 22:00:00",3,0,1,1,22.96,23,189,212
"2012-09-12 23:00:00",3,0,1,1,22.96,16,111,127
"2012-09-13 00:00:00",3,0,1,1,22.96,11,46,57
"2012-09-13 01:00:00",3,0,1,1,22.14,6,22,28
"2012-09-13 02:00:00",3,0,1,1,22.14,0,9,9
"2012-09-13 03:00:00",3,0,1,1,21.32,2,9,11
"2012-09-13 04:00:00",3,0,1,1,21.32,0,6,6
"2012-09-13 05:00:00",3,0,1,1,21.32,3,54,57
"2012-09-13 06:00:00",3,0,1,1,20.5,9,186,195
"2012-09-13 07:00:00",3,0,1,1,22.14,22,549,571
"2012-09-13 08:00:00",3,0,1,1,22.96,33,725,758
"2012-09-13 09:00:00",3,0,1,1,24.6,46,292,338
"2012-09-13 10:00:00",3,0,1,1,26.24,63,149,212
"2012-09-13 11:00:00",3,0,1,1,27.06,71,183,254
"2012-09-13 12:00:00",3,0,1,1,27.88,57,240,297
"2012-09-13 13:00:00",3,0,1,1,28.7,60,223,283
"2012-09-13 14:00:00",3,0,1,1,29.52,60,214,274
"2012-09-13 15:00:00",3,0,1,1,29.52,99,253,352
"2012-09-13 16:00:00",3,0,1,1,29.52,85,406,491
"2012-09-13 17:00:00",3,0,1,1,29.52,97,787,884
"2012-09-13 18:00:00",3,0,1,1,27.88,108,744,852
"2012-09-13 19:00:00",3,0,1,1,26.24,80,594,674
"2012-09-13 20:00:00",3,0,1,1,25.42,55,408,463
"2012-09-13 21:00:00",3,0,1,1,25.42,26,291,317
"2012-09-13 22:00:00",3,0,1,1,24.6,28,223,251
"2012-09-13 23:00:00",3,0,1,1,23.78,33,137,170
"2012-09-14 00:00:00",3,0,1,1,22.96,24,63,87
"2012-09-14 01:00:00",3,0,1,1,22.96,6,35,41
"2012-09-14 02:00:00",3,0,1,1,22.96,7,23,30
"2012-09-14 03:00:00",3,0,1,1,22.14,5,9,14
"2012-09-14 04:00:00",3,0,1,1,22.14,1,11,12
"2012-09-14 05:00:00",3,0,1,1,22.14,1,40,41
"2012-09-14 06:00:00",3,0,1,1,22.14,8,144,152
"2012-09-14 07:00:00",3,0,1,2,22.96,17,437,454
"2012-09-14 08:00:00",3,0,1,2,24.6,51,715,766
"2012-09-14 09:00:00",3,0,1,2,25.42,46,301,347
"2012-09-14 10:00:00",3,0,1,2,27.88,75,171,246
"2012-09-14 11:00:00",3,0,1,2,27.88,84,196,280
"2012-09-14 12:00:00",3,0,1,2,28.7,119,290,409
"2012-09-14 13:00:00",3,0,1,2,28.7,107,301,408
"2012-09-14 14:00:00",3,0,1,2,29.52,113,258,371
"2012-09-14 15:00:00",3,0,1,2,29.52,94,273,367
"2012-09-14 16:00:00",3,0,1,2,29.52,109,454,563
"2012-09-14 17:00:00",3,0,1,1,29.52,137,757,894
"2012-09-14 18:00:00",3,0,1,1,29.52,116,692,808
"2012-09-14 19:00:00",3,0,1,1,27.88,83,496,579
"2012-09-14 20:00:00",3,0,1,1,27.06,67,337,404
"2012-09-14 21:00:00",3,0,1,1,26.24,42,270,312
"2012-09-14 22:00:00",3,0,1,1,25.42,40,189,229
"2012-09-14 23:00:00",3,0,1,1,25.42,27,168,195
"2012-09-15 00:00:00",3,0,0,1,24.6,38,169,207
"2012-09-15 01:00:00",3,0,0,1,24.6,8,101,109
"2012-09-15 02:00:00",3,0,0,1,23.78,18,75,93
"2012-09-15 03:00:00",3,0,0,1,24.6,6,31,37
"2012-09-15 04:00:00",3,0,0,2,24.6,3,3,6
"2012-09-15 05:00:00",3,0,0,1,23.78,1,15,16
"2012-09-15 06:00:00",3,0,0,1,22.14,6,27,33
"2012-09-15 07:00:00",3,0,0,1,22.14,10,63,73
"2012-09-15 08:00:00",3,0,0,1,22.96,43,169,212
"2012-09-15 09:00:00",3,0,0,1,24.6,79,263,342
"2012-09-15 10:00:00",3,0,0,1,25.42,119,323,442
"2012-09-15 11:00:00",3,0,0,1,26.24,228,399,627
"2012-09-15 12:00:00",3,0,0,1,27.06,287,419,706
"2012-09-15 13:00:00",3,0,0,1,27.88,327,377,704
"2012-09-15 14:00:00",3,0,0,1,27.88,325,390,715
"2012-09-15 15:00:00",3,0,0,2,27.88,312,342,654
"2012-09-15 16:00:00",3,0,0,2,27.06,350,433,783
"2012-09-15 17:00:00",3,0,0,2,27.06,295,434,729
"2012-09-15 18:00:00",3,0,0,2,26.24,232,382,614
"2012-09-15 19:00:00",3,0,0,1,25.42,169,309,478
"2012-09-15 20:00:00",3,0,0,1,24.6,89,241,330
"2012-09-15 21:00:00",3,0,0,1,22.96,86,210,296
"2012-09-15 22:00:00",3,0,0,1,22.96,82,197,279
"2012-09-15 23:00:00",3,0,0,1,22.14,47,182,229
"2012-09-16 00:00:00",3,0,0,1,22.14,28,123,151
"2012-09-16 01:00:00",3,0,0,1,22.14,35,82,117
"2012-09-16 02:00:00",3,0,0,1,21.32,27,62,89
"2012-09-16 03:00:00",3,0,0,1,20.5,10,38,48
"2012-09-16 04:00:00",3,0,0,1,20.5,2,6,8
"2012-09-16 05:00:00",3,0,0,1,20.5,3,10,13
"2012-09-16 06:00:00",3,0,0,1,20.5,9,26,35
"2012-09-16 07:00:00",3,0,0,1,20.5,28,43,71
"2012-09-16 08:00:00",3,0,0,1,22.14,34,94,128
"2012-09-16 09:00:00",3,0,0,1,23.78,70,226,296
"2012-09-16 10:00:00",3,0,0,1,25.42,160,330,490
"2012-09-16 11:00:00",3,0,0,1,26.24,183,376,559
"2012-09-16 12:00:00",3,0,0,1,27.06,188,468,656
"2012-09-16 13:00:00",3,0,0,1,26.24,240,454,694
"2012-09-16 14:00:00",3,0,0,1,27.06,225,410,635
"2012-09-16 15:00:00",3,0,0,1,26.24,215,342,557
"2012-09-16 16:00:00",3,0,0,1,26.24,194,402,596
"2012-09-16 17:00:00",3,0,0,1,27.06,177,393,570
"2012-09-16 18:00:00",3,0,0,1,25.42,120,361,481
"2012-09-16 19:00:00",3,0,0,1,25.42,91,312,403
"2012-09-16 20:00:00",3,0,0,1,24.6,57,267,324
"2012-09-16 21:00:00",3,0,0,1,24.6,43,148,191
"2012-09-16 22:00:00",3,0,0,1,22.96,18,109,127
"2012-09-16 23:00:00",3,0,0,1,22.14,9,85,94
"2012-09-17 00:00:00",3,0,1,1,22.14,14,31,45
"2012-09-17 01:00:00",3,0,1,1,21.32,9,12,21
"2012-09-17 02:00:00",3,0,1,1,21.32,5,8,13
"2012-09-17 03:00:00",3,0,1,1,20.5,0,7,7
"2012-09-17 04:00:00",3,0,1,1,20.5,2,9,11
"2012-09-17 05:00:00",3,0,1,1,19.68,1,44,45
"2012-09-17 06:00:00",3,0,1,1,19.68,7,157,164
"2012-09-17 07:00:00",3,0,1,1,21.32,18,474,492
"2012-09-17 08:00:00",3,0,1,1,22.14,36,647,683
"2012-09-17 09:00:00",3,0,1,1,23.78,34,265,299
"2012-09-17 10:00:00",3,0,1,2,25.42,73,129,202
"2012-09-17 11:00:00",3,0,1,2,25.42,61,191,252
"2012-09-17 12:00:00",3,0,1,2,25.42,62,233,295
"2012-09-17 13:00:00",3,0,1,1,26.24,112,231,343
"2012-09-17 14:00:00",3,0,1,2,26.24,129,203,332
"2012-09-17 15:00:00",3,0,1,2,26.24,82,256,338
"2012-09-17 16:00:00",3,0,1,2,26.24,74,379,453
"2012-09-17 17:00:00",3,0,1,2,26.24,102,740,842
"2012-09-17 18:00:00",3,0,1,2,25.42,66,708,774
"2012-09-17 19:00:00",3,0,1,2,25.42,51,435,486
"2012-09-17 20:00:00",3,0,1,2,25.42,32,308,340
"2012-09-17 21:00:00",3,0,1,3,25.42,28,205,233
"2012-09-17 22:00:00",3,0,1,3,25.42,20,109,129
"2012-09-17 23:00:00",3,0,1,3,24.6,4,66,70
"2012-09-18 00:00:00",3,0,1,3,24.6,2,11,13
"2012-09-18 01:00:00",3,0,1,3,24.6,0,5,5
"2012-09-18 02:00:00",3,0,1,3,24.6,0,4,4
"2012-09-18 03:00:00",3,0,1,2,25.42,0,6,6
"2012-09-18 04:00:00",3,0,1,2,25.42,2,5,7
"2012-09-18 05:00:00",3,0,1,2,26.24,3,45,48
"2012-09-18 06:00:00",3,0,1,2,26.24,4,163,167
"2012-09-18 07:00:00",3,0,1,2,26.24,13,343,356
"2012-09-18 08:00:00",3,0,1,2,27.06,32,640,672
"2012-09-18 09:00:00",3,0,1,2,27.06,27,266,293
"2012-09-18 10:00:00",3,0,1,3,27.88,30,130,160
"2012-09-18 11:00:00",3,0,1,2,27.88,36,115,151
"2012-09-18 12:00:00",3,0,1,3,27.88,16,72,88
"2012-09-18 13:00:00",3,0,1,2,28.7,17,97,114
"2012-09-18 14:00:00",3,0,1,3,24.6,27,116,143
"2012-09-18 15:00:00",3,0,1,3,24.6,1,35,36
"2012-09-18 16:00:00",3,0,1,3,24.6,19,122,141
"2012-09-18 17:00:00",3,0,1,3,24.6,36,302,338
"2012-09-18 18:00:00",3,0,1,2,24.6,19,262,281
"2012-09-18 19:00:00",3,0,1,2,24.6,22,302,324
"2012-09-18 20:00:00",3,0,1,2,24.6,19,271,290
"2012-09-18 21:00:00",3,0,1,2,24.6,21,186,207
"2012-09-18 22:00:00",3,0,1,3,23.78,14,137,151
"2012-09-18 23:00:00",3,0,1,2,22.96,11,67,78
"2012-09-19 00:00:00",3,0,1,2,22.96,3,23,26
"2012-09-19 01:00:00",3,0,1,2,22.14,0,12,12
"2012-09-19 02:00:00",3,0,1,2,22.14,0,3,3
"2012-09-19 03:00:00",3,0,1,2,21.32,1,4,5
"2012-09-19 04:00:00",3,0,1,2,21.32,0,10,10
"2012-09-19 05:00:00",3,0,1,2,21.32,2,54,56
"2012-09-19 06:00:00",3,0,1,1,21.32,6,166,172
"2012-09-19 07:00:00",3,0,1,1,21.32,16,529,545
"2012-09-19 08:00:00",3,0,1,1,21.32,39,758,797
"2012-09-19 09:00:00",3,0,1,1,22.14,26,336,362
"2012-09-19 10:00:00",3,0,1,1,22.96,23,169,192
"2012-09-19 11:00:00",3,0,1,1,24.6,44,203,247
"2012-09-19 12:00:00",3,0,1,1,24.6,53,260,313
"2012-09-19 13:00:00",3,0,1,1,24.6,55,234,289
"2012-09-19 14:00:00",3,0,1,1,25.42,59,227,286
"2012-09-19 15:00:00",3,0,1,1,25.42,57,254,311
"2012-09-19 16:00:00",3,0,1,1,25.42,69,397,466
"2012-09-19 17:00:00",3,0,1,1,24.6,74,812,886
"2012-09-19 18:00:00",3,0,1,1,23.78,85,807,892
"2012-09-19 19:00:00",3,0,1,1,22.96,72,539,611
"2012-09-19 20:00:00",3,0,1,1,21.32,31,378,409
"2012-09-19 21:00:00",3,0,1,1,20.5,25,324,349
"2012-09-19 22:00:00",3,0,1,1,20.5,31,198,229
"2012-09-19 23:00:00",3,0,1,1,19.68,17,106,123
"2012-10-01 00:00:00",4,0,1,1,18.86,6,39,45
"2012-10-01 01:00:00",4,0,1,1,18.04,5,13,18
"2012-10-01 02:00:00",4,0,1,1,18.86,6,6,12
"2012-10-01 03:00:00",4,0,1,1,18.04,1,6,7
"2012-10-01 04:00:00",4,0,1,1,17.22,0,10,10
"2012-10-01 05:00:00",4,0,1,1,18.04,2,34,36
"2012-10-01 06:00:00",4,0,1,1,18.04,8,147,155
"2012-10-01 07:00:00",4,0,1,1,18.04,13,470,483
"2012-10-01 08:00:00",4,0,1,2,18.86,40,744,784
"2012-10-01 09:00:00",4,0,1,2,21.32,26,314,340
"2012-10-01 10:00:00",4,0,1,1,22.14,44,135,179
"2012-10-01 11:00:00",4,0,1,1,23.78,76,196,272
"2012-10-01 12:00:00",4,0,1,2,24.6,61,262,323
"2012-10-01 13:00:00",4,0,1,2,24.6,80,225,305
"2012-10-01 14:00:00",4,0,1,2,24.6,51,193,244
"2012-10-01 15:00:00",4,0,1,2,25.42,95,234,329
"2012-10-01 16:00:00",4,0,1,2,25.42,51,408,459
"2012-10-01 17:00:00",4,0,1,3,22.96,65,791,856
"2012-10-01 18:00:00",4,0,1,3,22.96,42,571,613
"2012-10-01 19:00:00",4,0,1,2,22.14,33,483,516
"2012-10-01 20:00:00",4,0,1,3,22.14,11,251,262
"2012-10-01 21:00:00",4,0,1,2,22.14,13,205,218
"2012-10-01 22:00:00",4,0,1,3,22.14,17,190,207
"2012-10-01 23:00:00",4,0,1,3,22.14,17,88,105
"2012-10-02 00:00:00",4,0,1,2,22.96,1,30,31
"2012-10-02 01:00:00",4,0,1,2,22.14,0,11,11
"2012-10-02 02:00:00",4,0,1,2,22.14,0,2,2
"2012-10-02 03:00:00",4,0,1,2,22.14,1,4,5
"2012-10-02 04:00:00",4,0,1,2,22.96,2,8,10
"2012-10-02 05:00:00",4,0,1,2,22.96,1,42,43
"2012-10-02 06:00:00",4,0,1,3,23.78,3,176,179
"2012-10-02 07:00:00",4,0,1,3,23.78,4,256,260
"2012-10-02 08:00:00",4,0,1,3,24.6,6,128,134
"2012-10-02 09:00:00",4,0,1,3,23.78,3,83,86
"2012-10-02 10:00:00",4,0,1,3,23.78,3,42,45
"2012-10-02 11:00:00",4,0,1,3,23.78,7,92,99
"2012-10-02 12:00:00",4,0,1,2,24.6,6,98,104
"2012-10-02 13:00:00",4,0,1,2,24.6,6,148,154
"2012-10-02 14:00:00",4,0,1,3,24.6,16,147,163
"2012-10-02 15:00:00",4,0,1,3,25.42,14,195,209
"2012-10-02 16:00:00",4,0,1,3,25.42,46,328,374
"2012-10-02 17:00:00",4,0,1,3,25.42,38,677,715
"2012-10-02 18:00:00",4,0,1,3,25.42,48,639,687
"2012-10-02 19:00:00",4,0,1,3,25.42,27,368,395
"2012-10-02 20:00:00",4,0,1,3,25.42,20,286,306
"2012-10-02 21:00:00",4,0,1,3,25.42,24,265,289
"2012-10-02 22:00:00",4,0,1,2,25.42,28,212,240
"2012-10-02 23:00:00",4,0,1,2,25.42,11,87,98
"2012-10-03 00:00:00",4,0,1,3,25.42,5,47,52
"2012-10-03 01:00:00",4,0,1,2,25.42,3,16,19
"2012-10-03 02:00:00",4,0,1,2,25.42,2,7,9
"2012-10-03 03:00:00",4,0,1,2,24.6,0,7,7
"2012-10-03 04:00:00",4,0,1,2,24.6,2,9,11
"2012-10-03 05:00:00",4,0,1,2,25.42,2,32,34
"2012-10-03 06:00:00",4,0,1,2,24.6,4,173,177
"2012-10-03 07:00:00",4,0,1,2,24.6,11,504,515
"2012-10-03 08:00:00",4,0,1,2,25.42,28,781,809
"2012-10-03 09:00:00",4,0,1,2,25.42,30,332,362
"2012-10-03 10:00:00",4,0,1,1,27.06,29,146,175
"2012-10-03 11:00:00",4,0,1,1,27.06,52,178,230
"2012-10-03 12:00:00",4,0,1,2,28.7,69,289,358
"2012-10-03 13:00:00",4,0,1,2,28.7,55,224,279
"2012-10-03 14:00:00",4,0,1,2,29.52,56,195,251
"2012-10-03 15:00:00",4,0,1,2,29.52,59,260,319
"2012-10-03 16:00:00",4,0,1,2,29.52,42,436,478
"2012-10-03 17:00:00",4,0,1,1,28.7,84,833,917
"2012-10-03 18:00:00",4,0,1,1,28.7,54,756,810
"2012-10-03 19:00:00",4,0,1,1,28.7,49,544,593
"2012-10-03 20:00:00",4,0,1,1,28.7,48,449,497
"2012-10-03 21:00:00",4,0,1,2,27.06,14,195,209
"2012-10-03 22:00:00",4,0,1,1,27.06,9,232,241
"2012-10-03 23:00:00",4,0,1,2,27.06,21,199,220
"2012-10-04 00:00:00",4,0,1,3,26.24,11,65,76
"2012-10-04 01:00:00",4,0,1,2,25.42,2,23,25
"2012-10-04 02:00:00",4,0,1,1,26.24,3,10,13
"2012-10-04 03:00:00",4,0,1,2,25.42,5,6,11
"2012-10-04 04:00:00",4,0,1,2,26.24,0,10,10
"2012-10-04 05:00:00",4,0,1,3,26.24,2,37,39
"2012-10-04 06:00:00",4,0,1,3,25.42,1,132,133
"2012-10-04 07:00:00",4,0,1,2,26.24,12,379,391
"2012-10-04 08:00:00",4,0,1,1,26.24,27,711,738
"2012-10-04 09:00:00",4,0,1,2,26.24,40,319,359
"2012-10-04 10:00:00",4,0,1,2,27.06,27,150,177
"2012-10-04 11:00:00",4,0,1,2,28.7,38,176,214
"2012-10-04 12:00:00",4,0,1,2,29.52,57,231,288
"2012-10-04 13:00:00",4,0,1,2,29.52,63,231,294
"2012-10-04 14:00:00",4,0,1,1,28.7,56,211,267
"2012-10-04 15:00:00",4,0,1,1,29.52,77,248,325
"2012-10-04 16:00:00",4,0,1,1,28.7,86,411,497
"2012-10-04 17:00:00",4,0,1,1,28.7,112,789,901
"2012-10-04 18:00:00",4,0,1,1,27.06,75,812,887
"2012-10-04 19:00:00",4,0,1,1,27.06,67,467,534
"2012-10-04 20:00:00",4,0,1,1,26.24,50,391,441
"2012-10-04 21:00:00",4,0,1,1,25.42,33,288,321
"2012-10-04 22:00:00",4,0,1,1,26.24,29,203,232
"2012-10-04 23:00:00",4,0,1,1,24.6,18,137,155
"2012-10-05 00:00:00",4,0,1,1,22.96,16,86,102
"2012-10-05 01:00:00",4,0,1,1,22.14,3,43,46
"2012-10-05 02:00:00",4,0,1,1,22.14,1,10,11
"2012-10-05 03:00:00",4,0,1,1,22.14,5,11,16
"2012-10-05 04:00:00",4,0,1,1,22.14,0,11,11
"2012-10-05 05:00:00",4,0,1,1,21.32,0,41,41
"2012-10-05 06:00:00",4,0,1,1,21.32,4,133,137
"2012-10-05 07:00:00",4,0,1,1,21.32,11,417,428
"2012-10-05 08:00:00",4,0,1,1,23.78,36,749,785
"2012-10-05 09:00:00",4,0,1,1,24.6,58,326,384
"2012-10-05 10:00:00",4,0,1,1,27.06,68,192,260
"2012-10-05 11:00:00",4,0,1,1,28.7,90,214,304
"2012-10-05 12:00:00",4,0,1,1,29.52,161,307,468
"2012-10-05 13:00:00",4,0,1,1,28.7,117,307,424
"2012-10-05 14:00:00",4,0,1,1,30.34,113,287,400
"2012-10-05 15:00:00",4,0,1,1,29.52,150,320,470
"2012-10-05 16:00:00",4,0,1,1,29.52,153,481,634
"2012-10-05 17:00:00",4,0,1,1,28.7,158,742,900
"2012-10-05 18:00:00",4,0,1,1,26.24,106,655,761
"2012-10-05 19:00:00",4,0,1,1,25.42,67,433,500
"2012-10-05 20:00:00",4,0,1,1,24.6,66,306,372
"2012-10-05 21:00:00",4,0,1,1,24.6,47,220,267
"2012-10-05 22:00:00",4,0,1,1,24.6,63,201,264
"2012-10-05 23:00:00",4,0,1,1,23.78,23,148,171
"2012-10-06 00:00:00",4,0,0,1,22.96,37,154,191
"2012-10-06 01:00:00",4,0,0,1,22.96,25,116,141
"2012-10-06 02:00:00",4,0,0,1,22.96,13,62,75
"2012-10-06 03:00:00",4,0,0,1,22.14,2,54,56
"2012-10-06 04:00:00",4,0,0,1,22.14,4,7,11
"2012-10-06 05:00:00",4,0,0,1,22.14,2,8,10
"2012-10-06 06:00:00",4,0,0,1,22.14,2,28,30
"2012-10-06 07:00:00",4,0,0,1,22.14,13,71,84
"2012-10-06 08:00:00",4,0,0,1,22.96,22,184,206
"2012-10-06 09:00:00",4,0,0,1,24.6,130,265,395
"2012-10-06 10:00:00",4,0,0,1,25.42,198,341,539
"2012-10-06 11:00:00",4,0,0,1,26.24,258,389,647
"2012-10-06 12:00:00",4,0,0,1,28.7,362,381,743
"2012-10-06 13:00:00",4,0,0,2,26.24,310,400,710
"2012-10-06 14:00:00",4,0,0,2,24.6,269,307,576
"2012-10-06 15:00:00",4,0,0,1,24.6,279,341,620
"2012-10-06 16:00:00",4,0,0,1,24.6,317,342,659
"2012-10-06 17:00:00",4,0,0,1,22.14,268,342,610
"2012-10-06 18:00:00",4,0,0,1,21.32,183,312,495
"2012-10-06 19:00:00",4,0,0,1,19.68,102,239,341
"2012-10-06 20:00:00",4,0,0,1,19.68,75,172,247
"2012-10-06 21:00:00",4,0,0,1,18.86,78,137,215
"2012-10-06 22:00:00",4,0,0,1,18.04,45,140,185
"2012-10-06 23:00:00",4,0,0,1,18.04,37,142,179
"2012-10-07 00:00:00",4,0,0,1,18.04,28,99,127
"2012-10-07 01:00:00",4,0,0,1,18.04,29,80,109
"2012-10-07 02:00:00",4,0,0,1,17.22,10,64,74
"2012-10-07 03:00:00",4,0,0,2,18.04,5,17,22
"2012-10-07 04:00:00",4,0,0,2,18.04,5,6,11
"2012-10-07 05:00:00",4,0,0,2,18.04,2,8,10
"2012-10-07 06:00:00",4,0,0,2,18.04,4,19,23
"2012-10-07 07:00:00",4,0,0,3,17.22,6,29,35
"2012-10-07 08:00:00",4,0,0,3,17.22,11,51,62
"2012-10-07 09:00:00",4,0,0,3,16.4,16,70,86
"2012-10-07 10:00:00",4,0,0,2,17.22,41,144,185
"2012-10-07 11:00:00",4,0,0,2,17.22,76,260,336
"2012-10-07 12:00:00",4,0,0,2,17.22,100,292,392
"2012-10-07 13:00:00",4,0,0,2,18.04,80,240,320
"2012-10-07 14:00:00",4,0,0,2,18.04,71,243,314
"2012-10-07 15:00:00",4,0,0,3,17.22,74,232,306
"2012-10-07 16:00:00",4,0,0,3,16.4,87,246,333
"2012-10-07 17:00:00",4,0,0,3,16.4,35,122,157
"2012-10-07 18:00:00",4,0,0,3,16.4,24,82,106
"2012-10-07 19:00:00",4,0,0,2,16.4,17,97,114
"2012-10-07 20:00:00",4,0,0,1,16.4,19,97,116
"2012-10-07 21:00:00",4,0,0,1,15.58,22,91,113
"2012-10-07 22:00:00",4,0,0,1,15.58,7,72,79
"2012-10-07 23:00:00",4,0,0,1,14.76,12,68,80
"2012-10-08 00:00:00",4,1,0,1,15.58,7,44,51
"2012-10-08 01:00:00",4,1,0,1,13.94,2,35,37
"2012-10-08 02:00:00",4,1,0,1,13.94,3,12,15
"2012-10-08 03:00:00",4,1,0,1,13.94,2,8,10
"2012-10-08 04:00:00",4,1,0,1,13.12,1,6,7
"2012-10-08 05:00:00",4,1,0,1,13.94,2,17,19
"2012-10-08 06:00:00",4,1,0,1,13.94,5,54,59
"2012-10-08 07:00:00",4,1,0,2,13.94,3,151,154
"2012-10-08 08:00:00",4,1,0,2,14.76,23,374,397
"2012-10-08 09:00:00",4,1,0,2,15.58,59,273,332
"2012-10-08 10:00:00",4,1,0,2,15.58,69,229,298
"2012-10-08 11:00:00",4,1,0,2,16.4,72,236,308
"2012-10-08 12:00:00",4,1,0,2,17.22,74,267,341
"2012-10-08 13:00:00",4,1,0,2,17.22,82,323,405
"2012-10-08 14:00:00",4,1,0,2,17.22,121,299,420
"2012-10-08 15:00:00",4,1,0,3,17.22,76,294,370
"2012-10-08 16:00:00",4,1,0,3,17.22,61,316,377
"2012-10-08 17:00:00",4,1,0,2,17.22,81,416,497
"2012-10-08 18:00:00",4,1,0,2,17.22,41,415,456
"2012-10-08 19:00:00",4,1,0,2,16.4,38,333,371
"2012-10-08 20:00:00",4,1,0,3,16.4,20,207,227
"2012-10-08 21:00:00",4,1,0,2,16.4,17,134,151
"2012-10-08 22:00:00",4,1,0,3,16.4,6,101,107
"2012-10-08 23:00:00",4,1,0,2,16.4,9,60,69
"2012-10-09 00:00:00",4,0,1,2,15.58,9,22,31
"2012-10-09 01:00:00",4,0,1,3,14.76,0,13,13
"2012-10-09 02:00:00",4,0,1,3,14.76,2,5,7
"2012-10-09 03:00:00",4,0,1,3,14.76,0,3,3
"2012-10-09 04:00:00",4,0,1,3,14.76,1,6,7
"2012-10-09 05:00:00",4,0,1,2,15.58,0,19,19
"2012-10-09 06:00:00",4,0,1,2,15.58,2,141,143
"2012-10-09 07:00:00",4,0,1,1,15.58,5,357,362
"2012-10-09 08:00:00",4,0,1,2,17.22,15,698,713
"2012-10-09 09:00:00",4,0,1,2,17.22,37,345,382
"2012-10-09 10:00:00",4,0,1,2,18.04,33,131,164
"2012-10-09 11:00:00",4,0,1,2,19.68,37,156,193
"2012-10-09 12:00:00",4,0,1,2,19.68,43,217,260
"2012-10-09 13:00:00",4,0,1,2,20.5,54,184,238
"2012-10-09 14:00:00",4,0,1,2,22.14,43,201,244
"2012-10-09 15:00:00",4,0,1,2,21.32,59,195,254
"2012-10-09 16:00:00",4,0,1,2,20.5,70,354,424
"2012-10-09 17:00:00",4,0,1,2,21.32,73,733,806
"2012-10-09 18:00:00",4,0,1,2,20.5,26,758,784
"2012-10-09 19:00:00",4,0,1,2,20.5,31,483,514
"2012-10-09 20:00:00",4,0,1,2,20.5,30,330,360
"2012-10-09 21:00:00",4,0,1,2,19.68,16,209,225
"2012-10-09 22:00:00",4,0,1,2,19.68,7,155,162
"2012-10-09 23:00:00",4,0,1,2,19.68,8,76,84
"2012-10-10 00:00:00",4,0,1,2,18.86,0,33,33
"2012-10-10 01:00:00",4,0,1,2,18.86,2,6,8
"2012-10-10 02:00:00",4,0,1,2,18.86,2,6,8
"2012-10-10 03:00:00",4,0,1,2,18.86,0,6,6
"2012-10-10 04:00:00",4,0,1,2,18.86,0,6,6
"2012-10-10 05:00:00",4,0,1,2,18.86,2,38,40
"2012-10-10 06:00:00",4,0,1,2,18.86,3,172,175
"2012-10-10 07:00:00",4,0,1,1,18.86,9,498,507
"2012-10-10 08:00:00",4,0,1,1,20.5,33,806,839
"2012-10-10 09:00:00",4,0,1,1,22.14,35,331,366
"2012-10-10 10:00:00",4,0,1,1,22.96,27,190,217
"2012-10-10 11:00:00",4,0,1,1,22.14,53,238,291
"2012-10-10 12:00:00",4,0,1,1,22.14,78,312,390
"2012-10-10 13:00:00",4,0,1,1,22.96,60,237,297
"2012-10-10 14:00:00",4,0,1,1,24.6,63,208,271
"2012-10-10 15:00:00",4,0,1,1,24.6,58,261,319
"2012-10-10 16:00:00",4,0,1,1,24.6,92,474,566
"2012-10-10 17:00:00",4,0,1,1,23.78,91,857,948
"2012-10-10 18:00:00",4,0,1,2,22.96,57,787,844
"2012-10-10 19:00:00",4,0,1,2,22.96,32,534,566
"2012-10-10 20:00:00",4,0,1,1,21.32,21,371,392
"2012-10-10 21:00:00",4,0,1,1,20.5,18,251,269
"2012-10-10 22:00:00",4,0,1,1,18.86,27,170,197
"2012-10-10 23:00:00",4,0,1,1,18.04,17,119,136
"2012-10-11 00:00:00",4,0,1,1,18.04,1,41,42
"2012-10-11 01:00:00",4,0,1,1,18.04,1,10,11
"2012-10-11 02:00:00",4,0,1,1,17.22,4,7,11
"2012-10-11 03:00:00",4,0,1,1,17.22,0,3,3
"2012-10-11 04:00:00",4,0,1,1,16.4,0,10,10
"2012-10-11 05:00:00",4,0,1,1,14.76,0,42,42
"2012-10-11 06:00:00",4,0,1,1,14.76,1,158,159
"2012-10-11 07:00:00",4,0,1,1,14.76,11,467,478
"2012-10-11 08:00:00",4,0,1,1,15.58,25,773,798
"2012-10-11 09:00:00",4,0,1,1,16.4,27,328,355
"2012-10-11 10:00:00",4,0,1,1,18.04,39,165,204
"2012-10-11 11:00:00",4,0,1,1,18.86,76,175,251
"2012-10-11 12:00:00",4,0,1,1,18.86,47,279,326
"2012-10-11 13:00:00",4,0,1,1,20.5,48,243,291
"2012-10-11 14:00:00",4,0,1,1,21.32,78,270,348
"2012-10-11 15:00:00",4,0,1,1,21.32,102,358,460
"2012-10-11 16:00:00",4,0,1,1,20.5,68,413,481
"2012-10-11 17:00:00",4,0,1,1,20.5,90,737,827
"2012-10-11 18:00:00",4,0,1,1,18.86,64,628,692
"2012-10-11 19:00:00",4,0,1,1,18.04,81,662,743
"2012-10-11 20:00:00",4,0,1,1,17.22,27,388,415
"2012-10-11 21:00:00",4,0,1,1,17.22,24,236,260
"2012-10-11 22:00:00",4,0,1,1,16.4,10,167,177
"2012-10-11 23:00:00",4,0,1,1,17.22,10,176,186
"2012-10-12 00:00:00",4,0,1,1,16.4,8,60,68
"2012-10-12 01:00:00",4,0,1,1,16.4,8,29,37
"2012-10-12 02:00:00",4,0,1,1,16.4,0,16,16
"2012-10-12 03:00:00",4,0,1,1,14.76,0,6,6
"2012-10-12 04:00:00",4,0,1,1,14.76,0,8,8
"2012-10-12 05:00:00",4,0,1,1,14.76,2,33,35
"2012-10-12 06:00:00",4,0,1,1,13.94,3,140,143
"2012-10-12 07:00:00",4,0,1,1,14.76,8,384,392
"2012-10-12 08:00:00",4,0,1,1,17.22,34,711,745
"2012-10-12 09:00:00",4,0,1,1,20.5,26,374,400
"2012-10-12 10:00:00",4,0,1,1,21.32,75,200,275
"2012-10-12 11:00:00",4,0,1,1,22.14,61,252,313
"2012-10-12 12:00:00",4,0,1,1,22.14,75,312,387
"2012-10-12 13:00:00",4,0,1,1,22.96,81,300,381
"2012-10-12 14:00:00",4,0,1,1,22.96,109,262,371
"2012-10-12 15:00:00",4,0,1,1,21.32,138,317,455
"2012-10-12 16:00:00",4,0,1,1,18.86,108,412,520
"2012-10-12 17:00:00",4,0,1,1,18.86,131,706,837
"2012-10-12 18:00:00",4,0,1,1,18.04,76,566,642
"2012-10-12 19:00:00",4,0,1,1,17.22,40,453,493
"2012-10-12 20:00:00",4,0,1,1,17.22,28,280,308
"2012-10-12 21:00:00",4,0,1,1,16.4,21,169,190
"2012-10-12 22:00:00",4,0,1,1,16.4,17,143,160
"2012-10-12 23:00:00",4,0,1,1,14.76,11,89,100
"2012-10-13 00:00:00",4,0,0,1,14.76,31,218,249
"2012-10-13 01:00:00",4,0,0,1,13.94,23,123,146
"2012-10-13 02:00:00",4,0,0,1,13.94,7,60,67
"2012-10-13 03:00:00",4,0,0,1,13.12,2,13,15
"2012-10-13 04:00:00",4,0,0,1,12.3,2,9,11
"2012-10-13 05:00:00",4,0,0,1,12.3,0,11,11
"2012-10-13 06:00:00",4,0,0,1,12.3,5,23,28
"2012-10-13 07:00:00",4,0,0,1,12.3,10,60,70
"2012-10-13 08:00:00",4,0,0,1,13.94,23,151,174
"2012-10-13 09:00:00",4,0,0,1,14.76,46,220,266
"2012-10-13 10:00:00",4,0,0,1,16.4,82,265,347
"2012-10-13 11:00:00",4,0,0,1,17.22,192,335,527
"2012-10-13 12:00:00",4,0,0,1,18.04,202,371,573
"2012-10-13 13:00:00",4,0,0,1,18.86,235,435,670
"2012-10-13 14:00:00",4,0,0,1,19.68,243,354,597
"2012-10-13 15:00:00",4,0,0,1,20.5,251,364,615
"2012-10-13 16:00:00",4,0,0,1,20.5,294,343,637
"2012-10-13 17:00:00",4,0,0,1,18.86,193,335,528
"2012-10-13 18:00:00",4,0,0,1,18.86,174,299,473
"2012-10-13 19:00:00",4,0,0,1,18.04,73,259,332
"2012-10-13 20:00:00",4,0,0,1,16.4,57,198,255
"2012-10-13 21:00:00",4,0,0,1,16.4,47,157,204
"2012-10-13 22:00:00",4,0,0,1,16.4,33,156,189
"2012-10-13 23:00:00",4,0,0,1,17.22,27,98,125
"2012-10-14 00:00:00",4,0,0,1,16.4,8,103,111
"2012-10-14 01:00:00",4,0,0,1,17.22,16,96,112
"2012-10-14 02:00:00",4,0,0,1,16.4,8,58,66
"2012-10-14 03:00:00",4,0,0,1,17.22,3,25,28
"2012-10-14 04:00:00",4,0,0,1,17.22,2,10,12
"2012-10-14 05:00:00",4,0,0,1,16.4,5,6,11
"2012-10-14 06:00:00",4,0,0,1,16.4,4,20,24
"2012-10-14 07:00:00",4,0,0,1,17.22,7,44,51
"2012-10-14 08:00:00",4,0,0,1,18.04,28,104,132
"2012-10-14 09:00:00",4,0,0,2,19.68,62,161,223
"2012-10-14 10:00:00",4,0,0,1,22.14,150,278,428
"2012-10-14 11:00:00",4,0,0,1,22.96,156,338,494
"2012-10-14 12:00:00",4,0,0,1,25.42,200,362,562
"2012-10-14 13:00:00",4,0,0,1,26.24,218,401,619
"2012-10-14 14:00:00",4,0,0,1,27.06,249,368,617
"2012-10-14 15:00:00",4,0,0,1,27.06,213,355,568
"2012-10-14 16:00:00",4,0,0,1,26.24,203,378,581
"2012-10-14 17:00:00",4,0,0,1,26.24,193,346,539
"2012-10-14 18:00:00",4,0,0,1,23.78,134,319,453
"2012-10-14 19:00:00",4,0,0,1,22.96,68,268,336
"2012-10-14 20:00:00",4,0,0,1,22.14,48,198,246
"2012-10-14 21:00:00",4,0,0,1,22.96,40,156,196
"2012-10-14 22:00:00",4,0,0,1,22.96,38,87,125
"2012-10-14 23:00:00",4,0,0,2,22.96,27,78,105
"2012-10-15 00:00:00",4,0,1,2,22.96,17,31,48
"2012-10-15 01:00:00",4,0,1,2,23.78,5,24,29
"2012-10-15 02:00:00",4,0,1,2,23.78,1,5,6
"2012-10-15 03:00:00",4,0,1,2,22.96,2,2,4
"2012-10-15 04:00:00",4,0,1,2,22.96,1,9,10
"2012-10-15 05:00:00",4,0,1,2,22.96,2,38,40
"2012-10-15 06:00:00",4,0,1,2,22.96,6,141,147
"2012-10-15 07:00:00",4,0,1,2,23.78,15,461,476
"2012-10-15 08:00:00",4,0,1,2,24.6,24,713,737
"2012-10-15 09:00:00",4,0,1,3,24.6,31,328,359
"2012-10-15 10:00:00",4,0,1,2,24.6,43,125,168
"2012-10-15 11:00:00",4,0,1,2,24.6,88,175,263
"2012-10-15 12:00:00",4,0,1,3,24.6,73,211,284
"2012-10-15 13:00:00",4,0,1,2,22.96,37,109,146
"2012-10-15 14:00:00",4,0,1,2,24.6,57,128,185
"2012-10-15 15:00:00",4,0,1,1,24.6,70,190,260
"2012-10-15 16:00:00",4,0,1,1,22.96,76,371,447
"2012-10-15 17:00:00",4,0,1,1,22.96,96,670,766
"2012-10-15 18:00:00",4,0,1,3,22.14,52,540,592
"2012-10-15 19:00:00",4,0,1,3,21.32,12,227,239
"2012-10-15 20:00:00",4,0,1,2,21.32,19,237,256
"2012-10-15 21:00:00",4,0,1,1,21.32,16,190,206
"2012-10-15 22:00:00",4,0,1,1,20.5,8,118,126
"2012-10-15 23:00:00",4,0,1,1,18.86,9,72,81
"2012-10-16 00:00:00",4,0,1,1,18.86,3,45,48
"2012-10-16 01:00:00",4,0,1,1,18.04,4,9,13
"2012-10-16 02:00:00",4,0,1,1,18.04,2,1,3
"2012-10-16 03:00:00",4,0,1,1,17.22,0,2,2
"2012-10-16 04:00:00",4,0,1,1,17.22,0,7,7
"2012-10-16 05:00:00",4,0,1,1,17.22,5,47,52
"2012-10-16 06:00:00",4,0,1,1,17.22,4,168,172
"2012-10-16 07:00:00",4,0,1,1,17.22,20,505,525
"2012-10-16 08:00:00",4,0,1,1,18.04,35,800,835
"2012-10-16 09:00:00",4,0,1,1,19.68,32,323,355
"2012-10-16 10:00:00",4,0,1,1,20.5,65,157,222
"2012-10-16 11:00:00",4,0,1,1,20.5,56,172,228
"2012-10-16 12:00:00",4,0,1,2,21.32,69,256,325
"2012-10-16 13:00:00",4,0,1,1,21.32,68,260,328
"2012-10-16 14:00:00",4,0,1,1,22.14,94,214,308
"2012-10-16 15:00:00",4,0,1,1,22.14,76,270,346
"2012-10-16 16:00:00",4,0,1,1,22.14,79,367,446
"2012-10-16 17:00:00",4,0,1,1,21.32,104,839,943
"2012-10-16 18:00:00",4,0,1,1,20.5,71,767,838
"2012-10-16 19:00:00",4,0,1,1,19.68,40,491,531
"2012-10-16 20:00:00",4,0,1,1,18.86,35,397,432
"2012-10-16 21:00:00",4,0,1,1,18.86,19,176,195
"2012-10-16 22:00:00",4,0,1,1,16.4,18,163,181
"2012-10-16 23:00:00",4,0,1,1,16.4,23,176,199
"2012-10-17 00:00:00",4,0,1,1,15.58,1,48,49
"2012-10-17 01:00:00",4,0,1,1,15.58,3,14,17
"2012-10-17 02:00:00",4,0,1,1,15.58,4,12,16
"2012-10-17 03:00:00",4,0,1,1,14.76,0,7,7
"2012-10-17 04:00:00",4,0,1,1,14.76,0,4,4
"2012-10-17 05:00:00",4,0,1,2,14.76,2,39,41
"2012-10-17 06:00:00",4,0,1,1,15.58,7,171,178
"2012-10-17 07:00:00",4,0,1,1,14.76,15,449,464
"2012-10-17 08:00:00",4,0,1,2,16.4,38,779,817
"2012-10-17 09:00:00",4,0,1,2,17.22,38,344,382
"2012-10-17 10:00:00",4,0,1,2,18.86,60,168,228
"2012-10-17 11:00:00",4,0,1,2,20.5,78,156,234
"2012-10-17 12:00:00",4,0,1,2,21.32,71,261,332
"2012-10-17 13:00:00",4,0,1,2,22.14,73,237,310
"2012-10-17 14:00:00",4,0,1,2,22.96,82,188,270
"2012-10-17 15:00:00",4,0,1,2,23.78,62,239,301
"2012-10-17 16:00:00",4,0,1,1,22.96,70,396,466
"2012-10-17 17:00:00",4,0,1,1,22.14,122,766,888
"2012-10-17 18:00:00",4,0,1,1,21.32,90,794,884
"2012-10-17 19:00:00",4,0,1,1,20.5,49,467,516
"2012-10-17 20:00:00",4,0,1,1,20.5,54,360,414
"2012-10-17 21:00:00",4,0,1,1,18.86,28,301,329
"2012-10-17 22:00:00",4,0,1,1,18.86,17,198,215
"2012-10-17 23:00:00",4,0,1,1,18.86,15,84,99
"2012-10-18 00:00:00",4,0,1,1,18.86,4,53,57
"2012-10-18 01:00:00",4,0,1,1,18.86,0,14,14
"2012-10-18 02:00:00",4,0,1,1,18.86,1,13,14
"2012-10-18 03:00:00",4,0,1,1,18.04,0,5,5
"2012-10-18 04:00:00",4,0,1,1,18.04,0,5,5
"2012-10-18 05:00:00",4,0,1,1,18.04,1,41,42
"2012-10-18 06:00:00",4,0,1,1,18.04,3,150,153
"2012-10-18 07:00:00",4,0,1,1,18.04,20,488,508
"2012-10-18 08:00:00",4,0,1,1,18.86,31,803,834
"2012-10-18 09:00:00",4,0,1,2,20.5,41,346,387
"2012-10-18 10:00:00",4,0,1,2,21.32,60,158,218
"2012-10-18 11:00:00",4,0,1,2,22.96,79,189,268
"2012-10-18 12:00:00",4,0,1,2,24.6,93,284,377
"2012-10-18 13:00:00",4,0,1,1,25.42,96,236,332
"2012-10-18 14:00:00",4,0,1,2,25.42,94,191,285
"2012-10-18 15:00:00",4,0,1,2,24.6,69,284,353
"2012-10-18 16:00:00",4,0,1,1,24.6,94,356,450
"2012-10-18 17:00:00",4,0,1,2,23.78,102,788,890
"2012-10-18 18:00:00",4,0,1,2,22.96,68,720,788
"2012-10-18 19:00:00",4,0,1,2,22.96,42,471,513
"2012-10-18 20:00:00",4,0,1,2,22.96,39,348,387
"2012-10-18 21:00:00",4,0,1,2,22.14,38,245,283
"2012-10-18 22:00:00",4,0,1,2,22.14,27,202,229
"2012-10-18 23:00:00",4,0,1,2,22.14,6,111,117
"2012-10-19 00:00:00",4,0,1,2,22.96,5,51,56
"2012-10-19 01:00:00",4,0,1,3,22.14,4,12,16
"2012-10-19 02:00:00",4,0,1,2,22.14,1,9,10
"2012-10-19 03:00:00",4,0,1,2,22.96,0,5,5
"2012-10-19 04:00:00",4,0,1,2,22.96,1,5,6
"2012-10-19 05:00:00",4,0,1,2,22.14,1,35,36
"2012-10-19 06:00:00",4,0,1,3,22.14,5,126,131
"2012-10-19 07:00:00",4,0,1,3,22.14,5,149,154
"2012-10-19 08:00:00",4,0,1,2,22.14,20,447,467
"2012-10-19 09:00:00",4,0,1,2,22.14,26,363,389
"2012-10-19 10:00:00",4,0,1,2,23.78,26,198,224
"2012-10-19 11:00:00",4,0,1,1,24.6,41,211,252
"2012-10-19 12:00:00",4,0,1,1,26.24,74,258,332
"2012-10-19 13:00:00",4,0,1,1,25.42,87,288,375
"2012-10-19 14:00:00",4,0,1,1,27.06,88,277,365
"2012-10-19 15:00:00",4,0,1,1,26.24,93,302,395
"2012-10-19 16:00:00",4,0,1,3,25.42,131,434,565
"2012-10-19 17:00:00",4,0,1,3,25.42,48,377,425
"2012-10-19 18:00:00",4,0,1,1,22.96,21,212,233
"2012-10-19 19:00:00",4,0,1,1,22.14,19,213,232
"2012-10-19 20:00:00",4,0,1,1,21.32,13,216,229
"2012-10-19 21:00:00",4,0,1,1,20.5,17,189,206
"2012-10-19 22:00:00",4,0,1,1,20.5,14,176,190
"2012-10-19 23:00:00",4,0,1,1,18.86,13,118,131
"2012-11-01 00:00:00",4,0,1,1,14.76,8,52,60
"2012-11-01 01:00:00",4,0,1,1,12.3,8,22,30
"2012-11-01 02:00:00",4,0,1,1,13.12,10,10,20
"2012-11-01 03:00:00",4,0,1,1,13.94,5,10,15
"2012-11-01 04:00:00",4,0,1,2,13.94,2,8,10
"2012-11-01 05:00:00",4,0,1,1,13.94,1,39,40
"2012-11-01 06:00:00",4,0,1,1,13.94,2,146,148
"2012-11-01 07:00:00",4,0,1,2,14.76,6,414,420
"2012-11-01 08:00:00",4,0,1,2,14.76,12,668,680
"2012-11-01 09:00:00",4,0,1,3,14.76,21,310,331
"2012-11-01 10:00:00",4,0,1,3,14.76,13,133,146
"2012-11-01 11:00:00",4,0,1,3,14.76,14,156,170
"2012-11-01 12:00:00",4,0,1,3,15.58,23,198,221
"2012-11-01 13:00:00",4,0,1,2,16.4,49,199,248
"2012-11-01 14:00:00",4,0,1,2,16.4,31,154,185
"2012-11-01 15:00:00",4,0,1,2,16.4,35,179,214
"2012-11-01 16:00:00",4,0,1,2,16.4,31,313,344
"2012-11-01 17:00:00",4,0,1,3,16.4,37,652,689
"2012-11-01 18:00:00",4,0,1,2,16.4,50,628,678
"2012-11-01 19:00:00",4,0,1,2,16.4,28,424,452
"2012-11-01 20:00:00",4,0,1,2,15.58,16,280,296
"2012-11-01 21:00:00",4,0,1,2,15.58,29,238,267
"2012-11-01 22:00:00",4,0,1,1,14.76,27,175,202
"2012-11-01 23:00:00",4,0,1,1,13.94,8,112,120
"2012-11-02 00:00:00",4,0,1,1,13.94,10,40,50
"2012-11-02 01:00:00",4,0,1,1,13.12,5,19,24
"2012-11-02 02:00:00",4,0,1,1,13.12,3,7,10
"2012-11-02 03:00:00",4,0,1,1,12.3,0,3,3
"2012-11-02 04:00:00",4,0,1,1,12.3,1,6,7
"2012-11-02 05:00:00",4,0,1,2,13.12,1,25,26
"2012-11-02 06:00:00",4,0,1,1,12.3,2,120,122
"2012-11-02 07:00:00",4,0,1,2,12.3,8,349,357
"2012-11-02 08:00:00",4,0,1,1,13.12,31,656,687
"2012-11-02 09:00:00",4,0,1,1,13.94,27,355,382
"2012-11-02 10:00:00",4,0,1,1,15.58,21,183,204
"2012-11-02 11:00:00",4,0,1,1,17.22,42,179,221
"2012-11-02 12:00:00",4,0,1,1,17.22,52,240,292
"2012-11-02 13:00:00",4,0,1,1,16.4,64,230,294
"2012-11-02 14:00:00",4,0,1,2,16.4,63,199,262
"2012-11-02 15:00:00",4,0,1,2,16.4,51,255,306
"2012-11-02 16:00:00",4,0,1,1,15.58,48,373,421
"2012-11-02 17:00:00",4,0,1,1,15.58,57,581,638
"2012-11-02 18:00:00",4,0,1,2,15.58,32,490,522
"2012-11-02 19:00:00",4,0,1,2,15.58,38,336,374
"2012-11-02 20:00:00",4,0,1,2,14.76,14,207,221
"2012-11-02 21:00:00",4,0,1,2,14.76,23,133,156
"2012-11-02 22:00:00",4,0,1,1,14.76,14,135,149
"2012-11-02 23:00:00",4,0,1,1,13.94,11,108,119
"2012-11-03 00:00:00",4,0,0,1,13.94,9,99,108
"2012-11-03 01:00:00",4,0,0,2,13.94,6,83,89
"2012-11-03 02:00:00",4,0,0,2,13.94,10,36,46
"2012-11-03 03:00:00",4,0,0,2,13.94,6,22,28
"2012-11-03 04:00:00",4,0,0,2,13.12,8,8,16
"2012-11-03 05:00:00",4,0,0,2,13.12,1,8,9
"2012-11-03 06:00:00",4,0,0,2,13.12,4,17,21
"2012-11-03 07:00:00",4,0,0,2,13.12,1,58,59
"2012-11-03 08:00:00",4,0,0,2,13.94,10,132,142
"2012-11-03 09:00:00",4,0,0,2,13.94,31,188,219
"2012-11-03 10:00:00",4,0,0,1,14.76,68,260,328
"2012-11-03 11:00:00",4,0,0,2,14.76,56,284,340
"2012-11-03 12:00:00",4,0,0,2,14.76,74,320,394
"2012-11-03 13:00:00",4,0,0,2,14.76,110,339,449
"2012-11-03 14:00:00",4,0,0,2,14.76,136,319,455
"2012-11-03 15:00:00",4,0,0,2,14.76,117,331,448
"2012-11-03 16:00:00",4,0,0,2,14.76,108,292,400
"2012-11-03 17:00:00",4,0,0,2,14.76,112,298,410
"2012-11-03 18:00:00",4,0,0,2,14.76,58,239,297
"2012-11-03 19:00:00",4,0,0,1,14.76,22,217,239
"2012-11-03 20:00:00",4,0,0,1,13.94,23,158,181
"2012-11-03 21:00:00",4,0,0,1,13.94,31,135,166
"2012-11-03 22:00:00",4,0,0,1,13.12,13,133,146
"2012-11-03 23:00:00",4,0,0,1,13.12,15,133,148
"2012-11-04 00:00:00",4,0,0,1,12.3,5,97,102
"2012-11-04 01:00:00",4,0,0,1,10.66,26,139,165
"2012-11-04 02:00:00",4,0,0,1,12.3,6,31,37
"2012-11-04 03:00:00",4,0,0,1,11.48,1,10,11
"2012-11-04 04:00:00",4,0,0,1,10.66,2,7,9
"2012-11-04 05:00:00",4,0,0,1,10.66,0,5,5
"2012-11-04 06:00:00",4,0,0,1,11.48,2,14,16
"2012-11-04 07:00:00",4,0,0,1,10.66,11,39,50
"2012-11-04 08:00:00",4,0,0,1,12.3,34,115,149
"2012-11-04 09:00:00",4,0,0,1,13.12,56,161,217
"2012-11-04 10:00:00",4,0,0,1,13.94,73,287,360
"2012-11-04 11:00:00",4,0,0,1,15.58,134,311,445
"2012-11-04 12:00:00",4,0,0,1,15.58,150,354,504
"2012-11-04 13:00:00",4,0,0,1,16.4,122,371,493
"2012-11-04 14:00:00",4,0,0,1,16.4,149,360,509
"2012-11-04 15:00:00",4,0,0,1,16.4,149,300,449
"2012-11-04 16:00:00",4,0,0,1,16.4,119,316,435
"2012-11-04 17:00:00",4,0,0,1,14.76,57,270,327
"2012-11-04 18:00:00",4,0,0,1,14.76,31,206,237
"2012-11-04 19:00:00",4,0,0,1,14.76,24,203,227
"2012-11-04 20:00:00",4,0,0,1,13.12,7,134,141
"2012-11-04 21:00:00",4,0,0,1,12.3,16,71,87
"2012-11-04 22:00:00",4,0,0,1,12.3,15,64,79
"2012-11-04 23:00:00",4,0,0,2,12.3,12,41,53
"2012-11-05 00:00:00",4,0,1,2,12.3,3,20,23
"2012-11-05 01:00:00",4,0,1,2,12.3,0,8,8
"2012-11-05 02:00:00",4,0,1,2,12.3,2,4,6
"2012-11-05 03:00:00",4,0,1,2,12.3,1,3,4
"2012-11-05 04:00:00",4,0,1,2,12.3,5,11,16
"2012-11-05 05:00:00",4,0,1,2,12.3,1,38,39
"2012-11-05 06:00:00",4,0,1,2,12.3,4,135,139
"2012-11-05 07:00:00",4,0,1,2,12.3,8,453,461
"2012-11-05 08:00:00",4,0,1,2,12.3,19,629,648
"2012-11-05 09:00:00",4,0,1,2,12.3,18,239,257
"2012-11-05 10:00:00",4,0,1,1,13.12,30,112,142
"2012-11-05 11:00:00",4,0,1,1,13.94,31,119,150
"2012-11-05 12:00:00",4,0,1,1,14.76,38,206,244
"2012-11-05 13:00:00",4,0,1,1,14.76,39,183,222
"2012-11-05 14:00:00",4,0,1,1,15.58,31,165,196
"2012-11-05 15:00:00",4,0,1,1,15.58,24,207,231
"2012-11-05 16:00:00",4,0,1,1,14.76,35,325,360
"2012-11-05 17:00:00",4,0,1,1,13.94,34,604,638
"2012-11-05 18:00:00",4,0,1,1,13.94,19,523,542
"2012-11-05 19:00:00",4,0,1,1,13.12,11,361,372
"2012-11-05 20:00:00",4,0,1,1,13.12,13,228,241
"2012-11-05 21:00:00",4,0,1,1,12.3,8,144,152
"2012-11-05 22:00:00",4,0,1,1,11.48,4,111,115
"2012-11-05 23:00:00",4,0,1,1,10.66,0,53,53
"2012-11-06 00:00:00",4,0,1,1,9.84,1,18,19
"2012-11-06 01:00:00",4,0,1,1,9.84,0,8,8
"2012-11-06 02:00:00",4,0,1,1,9.84,0,2,2
"2012-11-06 03:00:00",4,0,1,1,9.02,0,4,4
"2012-11-06 04:00:00",4,0,1,1,9.02,0,7,7
"2012-11-06 05:00:00",4,0,1,2,9.02,1,40,41
"2012-11-06 06:00:00",4,0,1,1,9.02,6,143,149
"2012-11-06 07:00:00",4,0,1,1,8.2,9,378,387
"2012-11-06 08:00:00",4,0,1,1,9.02,20,568,588
"2012-11-06 09:00:00",4,0,1,1,10.66,25,338,363
"2012-11-06 10:00:00",4,0,1,1,12.3,41,189,230
"2012-11-06 11:00:00",4,0,1,1,13.12,39,177,216
"2012-11-06 12:00:00",4,0,1,1,13.12,31,217,248
"2012-11-06 13:00:00",4,0,1,1,13.94,46,232,278
"2012-11-06 14:00:00",4,0,1,1,14.76,44,196,240
"2012-11-06 15:00:00",4,0,1,1,13.94,45,227,272
"2012-11-06 16:00:00",4,0,1,1,13.94,33,369,402
"2012-11-06 17:00:00",4,0,1,1,13.12,30,597,627
"2012-11-06 18:00:00",4,0,1,1,13.12,20,477,497
"2012-11-06 19:00:00",4,0,1,1,12.3,15,356,371
"2012-11-06 20:00:00",4,0,1,1,12.3,10,218,228
"2012-11-06 21:00:00",4,0,1,2,12.3,14,137,151
"2012-11-06 22:00:00",4,0,1,2,12.3,17,136,153
"2012-11-06 23:00:00",4,0,1,1,12.3,19,186,205
"2012-11-07 00:00:00",4,0,1,2,12.3,49,234,283
"2012-11-07 01:00:00",4,0,1,2,11.48,6,86,92
"2012-11-07 02:00:00",4,0,1,2,11.48,6,68,74
"2012-11-07 03:00:00",4,0,1,2,11.48,2,9,11
"2012-11-07 04:00:00",4,0,1,2,11.48,0,9,9
"2012-11-07 05:00:00",4,0,1,2,11.48,0,27,27
"2012-11-07 06:00:00",4,0,1,2,10.66,3,115,118
"2012-11-07 07:00:00",4,0,1,2,10.66,5,314,319
"2012-11-07 08:00:00",4,0,1,2,10.66,18,583,601
"2012-11-07 09:00:00",4,0,1,2,10.66,17,351,368
"2012-11-07 10:00:00",4,0,1,2,11.48,27,151,178
"2012-11-07 11:00:00",4,0,1,2,13.12,15,132,147
"2012-11-07 12:00:00",4,0,1,2,13.12,24,188,212
"2012-11-07 13:00:00",4,0,1,2,13.12,23,158,181
"2012-11-07 14:00:00",4,0,1,2,13.12,19,142,161
"2012-11-07 15:00:00",4,0,1,2,13.12,20,178,198
"2012-11-07 16:00:00",4,0,1,2,13.12,23,250,273
"2012-11-07 17:00:00",4,0,1,2,13.12,16,501,517
"2012-11-07 18:00:00",4,0,1,2,13.12,17,448,465
"2012-11-07 19:00:00",4,0,1,2,12.3,17,302,319
"2012-11-07 20:00:00",4,0,1,2,13.12,7,249,256
"2012-11-07 21:00:00",4,0,1,2,13.12,5,121,126
"2012-11-07 22:00:00",4,0,1,3,12.3,4,56,60
"2012-11-07 23:00:00",4,0,1,3,11.48,3,37,40
"2012-11-08 00:00:00",4,0,1,3,11.48,1,14,15
"2012-11-08 01:00:00",4,0,1,3,12.3,1,11,12
"2012-11-08 02:00:00",4,0,1,2,12.3,1,5,6
"2012-11-08 04:00:00",4,0,1,2,12.3,1,9,10
"2012-11-08 05:00:00",4,0,1,2,12.3,0,35,35
"2012-11-08 06:00:00",4,0,1,1,12.3,2,122,124
"2012-11-08 07:00:00",4,0,1,1,11.48,12,411,423
"2012-11-08 08:00:00",4,0,1,1,12.3,16,652,668
"2012-11-08 09:00:00",4,0,1,1,13.12,22,253,275
"2012-11-08 10:00:00",4,0,1,1,13.12,13,148,161
"2012-11-08 11:00:00",4,0,1,1,14.76,16,155,171
"2012-11-08 12:00:00",4,0,1,1,16.4,33,202,235
"2012-11-08 13:00:00",4,0,1,1,18.04,33,195,228
"2012-11-08 14:00:00",4,0,1,1,18.04,33,149,182
"2012-11-08 15:00:00",4,0,1,1,18.04,32,201,233
"2012-11-08 16:00:00",4,0,1,1,17.22,18,321,339
"2012-11-08 17:00:00",4,0,1,1,16.4,36,556,592
"2012-11-08 18:00:00",4,0,1,1,16.4,16,491,507
"2012-11-08 19:00:00",4,0,1,1,15.58,14,359,373
"2012-11-08 20:00:00",4,0,1,1,15.58,10,235,245
"2012-11-08 21:00:00",4,0,1,1,14.76,11,222,233
"2012-11-08 22:00:00",4,0,1,1,13.94,14,147,161
"2012-11-08 23:00:00",4,0,1,1,13.94,5,82,87
"2012-11-09 00:00:00",4,0,1,1,13.94,9,46,55
"2012-11-09 01:00:00",4,0,1,1,13.12,3,17,20
"2012-11-09 02:00:00",4,0,1,1,13.12,1,11,12
"2012-11-09 03:00:00",4,0,1,1,13.12,3,6,9
"2012-11-09 04:00:00",4,0,1,1,13.12,0,14,14
"2012-11-09 05:00:00",4,0,1,1,12.3,2,25,27
"2012-11-09 06:00:00",4,0,1,1,10.66,5,126,131
"2012-11-09 07:00:00",4,0,1,1,10.66,9,332,341
"2012-11-09 08:00:00",4,0,1,1,13.12,25,668,693
"2012-11-09 09:00:00",4,0,1,1,13.94,23,304,327
"2012-11-09 10:00:00",4,0,1,1,14.76,34,163,197
"2012-11-09 11:00:00",4,0,1,1,16.4,66,185,251
"2012-11-09 12:00:00",4,0,1,1,18.04,48,214,262
"2012-11-09 13:00:00",4,0,1,1,18.86,62,237,299
"2012-11-09 14:00:00",4,0,1,1,18.86,67,207,274
"2012-11-09 15:00:00",4,0,1,1,18.86,78,278,356
"2012-11-09 16:00:00",4,0,1,1,18.86,57,377,434
"2012-11-09 17:00:00",4,0,1,1,17.22,61,593,654
"2012-11-09 18:00:00",4,0,1,1,17.22,46,450,496
"2012-11-09 19:00:00",4,0,1,1,13.94,30,331,361
"2012-11-09 20:00:00",4,0,1,1,14.76,20,235,255
"2012-11-09 21:00:00",4,0,1,1,13.94,23,176,199
"2012-11-09 22:00:00",4,0,1,1,13.94,17,146,163
"2012-11-09 23:00:00",4,0,1,1,13.12,20,142,162
"2012-11-10 00:00:00",4,0,0,1,13.12,16,106,122
"2012-11-10 01:00:00",4,0,0,1,12.3,8,68,76
"2012-11-10 02:00:00",4,0,0,1,13.12,2,42,44
"2012-11-10 03:00:00",4,0,0,1,12.3,9,11,20
"2012-11-10 04:00:00",4,0,0,1,10.66,2,4,6
"2012-11-10 05:00:00",4,0,0,1,11.48,1,9,10
"2012-11-10 06:00:00",4,0,0,1,9.84,5,11,16
"2012-11-10 07:00:00",4,0,0,1,10.66,14,57,71
"2012-11-10 08:00:00",4,0,0,1,13.12,16,130,146
"2012-11-10 09:00:00",4,0,0,1,14.76,43,216,259
"2012-11-10 10:00:00",4,0,0,1,16.4,86,264,350
"2012-11-10 11:00:00",4,0,0,1,16.4,143,323,466
"2012-11-10 12:00:00",4,0,0,1,19.68,258,348,606
"2012-11-10 13:00:00",4,0,0,1,21.32,268,383,651
"2012-11-10 14:00:00",4,0,0,1,22.14,280,347,627
"2012-11-10 15:00:00",4,0,0,1,21.32,216,351,567
"2012-11-10 16:00:00",4,0,0,1,22.14,227,378,605
"2012-11-10 17:00:00",4,0,0,1,20.5,183,318,501
"2012-11-10 18:00:00",4,0,0,1,18.04,103,256,359
"2012-11-10 19:00:00",4,0,0,1,18.86,55,228,283
"2012-11-10 20:00:00",4,0,0,1,18.04,39,153,192
"2012-11-10 21:00:00",4,0,0,1,16.4,51,169,220
"2012-11-10 22:00:00",4,0,0,1,15.58,39,154,193
"2012-11-10 23:00:00",4,0,0,1,14.76,26,120,146
"2012-11-11 00:00:00",4,0,0,1,13.94,14,110,124
"2012-11-11 01:00:00",4,0,0,1,13.94,26,82,108
"2012-11-11 02:00:00",4,0,0,1,13.12,12,58,70
"2012-11-11 03:00:00",4,0,0,1,13.94,9,39,48
"2012-11-11 04:00:00",4,0,0,1,13.12,5,6,11
"2012-11-11 05:00:00",4,0,0,1,12.3,0,12,12
"2012-11-11 06:00:00",4,0,0,1,12.3,3,16,19
"2012-11-11 07:00:00",4,0,0,1,12.3,12,56,68
"2012-11-11 08:00:00",4,0,0,1,13.12,32,87,119
"2012-11-11 09:00:00",4,0,0,1,14.76,94,179,273
"2012-11-11 10:00:00",4,0,0,1,16.4,133,272,405
"2012-11-11 11:00:00",4,0,0,1,18.86,180,324,504
"2012-11-11 12:00:00",4,0,0,1,20.5,195,390,585
"2012-11-11 13:00:00",4,0,0,1,22.14,262,424,686
"2012-11-11 14:00:00",4,0,0,1,24.6,292,362,654
"2012-11-11 15:00:00",4,0,0,1,22.96,304,420,724
"2012-11-11 16:00:00",4,0,0,1,22.14,260,393,653
"2012-11-11 17:00:00",4,0,0,1,22.14,151,342,493
"2012-11-11 18:00:00",4,0,0,1,21.32,102,303,405
"2012-11-11 19:00:00",4,0,0,1,19.68,69,208,277
"2012-11-11 20:00:00",4,0,0,1,18.04,54,146,200
"2012-11-11 21:00:00",4,0,0,1,18.04,44,127,171
"2012-11-11 22:00:00",4,0,0,1,17.22,21,113,134
"2012-11-11 23:00:00",4,0,0,1,17.22,16,93,109
"2012-11-12 00:00:00",4,1,0,1,17.22,6,43,49
"2012-11-12 01:00:00",4,1,0,1,16.4,4,26,30
"2012-11-12 02:00:00",4,1,0,1,16.4,6,14,20
"2012-11-12 03:00:00",4,1,0,1,16.4,1,3,4
"2012-11-12 04:00:00",4,1,0,1,16.4,1,3,4
"2012-11-12 05:00:00",4,1,0,1,15.58,1,23,24
"2012-11-12 06:00:00",4,1,0,1,15.58,7,64,71
"2012-11-12 07:00:00",4,1,0,1,16.4,16,248,264
"2012-11-12 08:00:00",4,1,0,1,17.22,50,490,540
"2012-11-12 09:00:00",4,1,0,1,18.04,60,337,397
"2012-11-12 10:00:00",4,1,0,1,19.68,82,184,266
"2012-11-12 11:00:00",4,1,0,1,21.32,112,255,367
"2012-11-12 12:00:00",4,1,0,1,22.96,105,314,419
"2012-11-12 13:00:00",4,1,0,1,24.6,108,312,420
"2012-11-12 14:00:00",4,1,0,1,23.78,134,310,444
"2012-11-12 15:00:00",4,1,0,1,22.96,102,280,382
"2012-11-12 16:00:00",4,1,0,1,22.96,87,347,434
"2012-11-12 17:00:00",4,1,0,1,22.96,66,530,596
"2012-11-12 18:00:00",4,1,0,1,21.32,65,486,551
"2012-11-12 19:00:00",4,1,0,1,22.14,30,323,353
"2012-11-12 20:00:00",4,1,0,2,21.32,31,273,304
"2012-11-12 21:00:00",4,1,0,3,22.14,10,145,155
"2012-11-12 22:00:00",4,1,0,1,21.32,12,100,112
"2012-11-12 23:00:00",4,1,0,2,22.14,1,62,63
"2012-11-13 00:00:00",4,0,1,2,21.32,5,18,23
"2012-11-13 01:00:00",4,0,1,3,18.04,0,5,5
"2012-11-13 02:00:00",4,0,1,3,14.76,7,4,11
"2012-11-13 03:00:00",4,0,1,3,14.76,2,3,5
"2012-11-13 04:00:00",4,0,1,2,14.76,0,9,9
"2012-11-13 05:00:00",4,0,1,2,13.94,0,18,18
"2012-11-13 06:00:00",4,0,1,3,13.12,2,48,50
"2012-11-13 07:00:00",4,0,1,3,13.12,1,106,107
"2012-11-13 08:00:00",4,0,1,3,13.12,4,207,211
"2012-11-13 09:00:00",4,0,1,3,13.12,1,109,110
"2012-11-13 10:00:00",4,0,1,3,12.3,10,84,94
"2012-11-13 11:00:00",4,0,1,1,13.12,22,133,155
"2012-11-13 12:00:00",4,0,1,1,13.94,16,180,196
"2012-11-13 13:00:00",4,0,1,1,13.94,30,188,218
"2012-11-13 14:00:00",4,0,1,1,15.58,34,169,203
"2012-11-13 15:00:00",4,0,1,1,16.4,33,184,217
"2012-11-13 16:00:00",4,0,1,1,15.58,28,282,310
"2012-11-13 17:00:00",4,0,1,1,13.94,33,575,608
"2012-11-13 18:00:00",4,0,1,1,13.94,45,514,559
"2012-11-13 19:00:00",4,0,1,1,13.12,12,344,356
"2012-11-13 20:00:00",4,0,1,1,12.3,12,211,223
"2012-11-13 21:00:00",4,0,1,1,12.3,9,178,187
"2012-11-13 22:00:00",4,0,1,1,10.66,15,120,135
"2012-11-13 23:00:00",4,0,1,1,10.66,6,78,84
"2012-11-14 00:00:00",4,0,1,1,10.66,4,20,24
"2012-11-14 01:00:00",4,0,1,1,9.84,2,10,12
"2012-11-14 02:00:00",4,0,1,1,9.84,0,1,1
"2012-11-14 03:00:00",4,0,1,1,9.84,0,5,5
"2012-11-14 04:00:00",4,0,1,1,9.02,0,6,6
"2012-11-14 05:00:00",4,0,1,1,9.02,0,39,39
"2012-11-14 06:00:00",4,0,1,1,9.84,4,142,146
"2012-11-14 07:00:00",4,0,1,1,9.84,10,405,415
"2012-11-14 08:00:00",4,0,1,1,11.48,27,664,691
"2012-11-14 09:00:00",4,0,1,1,12.3,22,310,332
"2012-11-14 10:00:00",4,0,1,1,13.12,18,153,171
"2012-11-14 11:00:00",4,0,1,1,13.12,25,126,151
"2012-11-14 12:00:00",4,0,1,1,13.94,40,200,240
"2012-11-14 13:00:00",4,0,1,1,14.76,32,182,214
"2012-11-14 14:00:00",4,0,1,1,14.76,20,161,181
"2012-11-14 15:00:00",4,0,1,1,14.76,32,228,260
"2012-11-14 16:00:00",4,0,1,1,13.94,31,290,321
"2012-11-14 17:00:00",4,0,1,1,13.12,19,564,583
"2012-11-14 18:00:00",4,0,1,1,13.12,24,543,567
"2012-11-14 19:00:00",4,0,1,1,12.3,28,368,396
"2012-11-14 20:00:00",4,0,1,1,12.3,15,252,267
"2012-11-14 21:00:00",4,0,1,1,12.3,5,208,213
"2012-11-14 22:00:00",4,0,1,1,11.48,6,167,173
"2012-11-14 23:00:00",4,0,1,1,9.84,9,78,87
"2012-11-15 00:00:00",4,0,1,2,10.66,1,33,34
"2012-11-15 01:00:00",4,0,1,2,10.66,2,14,16
"2012-11-15 02:00:00",4,0,1,2,10.66,0,7,7
"2012-11-15 03:00:00",4,0,1,2,10.66,0,2,2
"2012-11-15 04:00:00",4,0,1,2,11.48,0,5,5
"2012-11-15 05:00:00",4,0,1,2,12.3,3,34,37
"2012-11-15 06:00:00",4,0,1,2,12.3,1,146,147
"2012-11-15 07:00:00",4,0,1,2,12.3,7,403,410
"2012-11-15 08:00:00",4,0,1,2,12.3,21,625,646
"2012-11-15 09:00:00",4,0,1,2,13.12,17,306,323
"2012-11-15 10:00:00",4,0,1,2,13.12,11,142,153
"2012-11-15 11:00:00",4,0,1,2,13.94,28,138,166
"2012-11-15 12:00:00",4,0,1,2,14.76,29,184,213
"2012-11-15 13:00:00",4,0,1,2,15.58,20,197,217
"2012-11-15 14:00:00",4,0,1,2,15.58,27,174,201
"2012-11-15 15:00:00",4,0,1,2,15.58,26,191,217
"2012-11-15 16:00:00",4,0,1,2,14.76,24,318,342
"2012-11-15 17:00:00",4,0,1,2,14.76,22,541,563
"2012-11-15 18:00:00",4,0,1,2,14.76,10,563,573
"2012-11-15 19:00:00",4,0,1,2,13.94,11,375,386
"2012-11-15 20:00:00",4,0,1,1,13.94,23,262,285
"2012-11-15 21:00:00",4,0,1,2,13.12,20,204,224
"2012-11-15 22:00:00",4,0,1,2,13.12,10,143,153
"2012-11-15 23:00:00",4,0,1,2,13.12,7,118,125
"2012-11-16 00:00:00",4,0,1,2,13.12,7,58,65
"2012-11-16 01:00:00",4,0,1,2,12.3,5,16,21
"2012-11-16 02:00:00",4,0,1,2,12.3,0,9,9
"2012-11-16 03:00:00",4,0,1,2,12.3,0,6,6
"2012-11-16 04:00:00",4,0,1,2,12.3,0,5,5
"2012-11-16 05:00:00",4,0,1,2,12.3,2,34,36
"2012-11-16 06:00:00",4,0,1,2,12.3,4,126,130
"2012-11-16 07:00:00",4,0,1,2,12.3,5,362,367
"2012-11-16 08:00:00",4,0,1,2,13.12,17,694,711
"2012-11-16 09:00:00",4,0,1,1,13.94,21,330,351
"2012-11-16 10:00:00",4,0,1,1,13.94,33,165,198
"2012-11-16 11:00:00",4,0,1,1,15.58,33,185,218
"2012-11-16 12:00:00",4,0,1,1,16.4,28,262,290
"2012-11-16 13:00:00",4,0,1,1,17.22,52,226,278
"2012-11-16 14:00:00",4,0,1,1,17.22,47,204,251
"2012-11-16 15:00:00",4,0,1,1,17.22,30,237,267
"2012-11-16 16:00:00",4,0,1,1,17.22,33,350,383
"2012-11-16 17:00:00",4,0,1,1,14.76,41,539,580
"2012-11-16 18:00:00",4,0,1,1,13.94,22,483,505
"2012-11-16 19:00:00",4,0,1,1,14.76,26,306,332
"2012-11-16 20:00:00",4,0,1,1,14.76,20,207,227
"2012-11-16 21:00:00",4,0,1,1,13.94,21,157,178
"2012-11-16 22:00:00",4,0,1,1,13.12,23,139,162
"2012-11-16 23:00:00",4,0,1,1,13.12,14,114,128
"2012-11-17 00:00:00",4,0,0,1,12.3,11,95,106
"2012-11-17 01:00:00",4,0,0,1,10.66,13,74,87
"2012-11-17 02:00:00",4,0,0,1,10.66,8,41,49
"2012-11-17 03:00:00",4,0,0,1,10.66,2,19,21
"2012-11-17 04:00:00",4,0,0,1,9.84,1,6,7
"2012-11-17 05:00:00",4,0,0,1,9.84,1,10,11
"2012-11-17 06:00:00",4,0,0,1,9.84,0,21,21
"2012-11-17 07:00:00",4,0,0,1,9.84,8,70,78
"2012-11-17 08:00:00",4,0,0,1,10.66,30,138,168
"2012-11-17 09:00:00",4,0,0,1,13.94,48,200,248
"2012-11-17 10:00:00",4,0,0,1,14.76,62,258,320
"2012-11-17 11:00:00",4,0,0,1,15.58,80,343,423
"2012-11-17 12:00:00",4,0,0,1,16.4,117,359,476
"2012-11-17 13:00:00",4,0,0,1,17.22,179,346,525
"2012-11-17 14:00:00",4,0,0,1,17.22,175,380,555
"2012-11-17 15:00:00",4,0,0,1,17.22,175,374,549
"2012-11-17 16:00:00",4,0,0,1,16.4,144,325,469
"2012-11-17 17:00:00",4,0,0,1,15.58,101,302,403
"2012-11-17 18:00:00",4,0,0,1,14.76,34,237,271
"2012-11-17 19:00:00",4,0,0,1,13.94,45,208,253
"2012-11-17 20:00:00",4,0,0,2,13.94,30,142,172
"2012-11-17 21:00:00",4,0,0,2,13.12,15,124,139
"2012-11-17 22:00:00",4,0,0,2,13.12,15,130,145
"2012-11-17 23:00:00",4,0,0,2,12.3,19,114,133
"2012-11-18 00:00:00",4,0,0,2,12.3,11,118,129
"2012-11-18 01:00:00",4,0,0,1,12.3,14,81,95
"2012-11-18 02:00:00",4,0,0,1,11.48,8,65,73
"2012-11-18 03:00:00",4,0,0,2,12.3,9,37,46
"2012-11-18 04:00:00",4,0,0,2,12.3,4,8,12
"2012-11-18 05:00:00",4,0,0,1,11.48,5,7,12
"2012-11-18 06:00:00",4,0,0,1,11.48,2,13,15
"2012-11-18 07:00:00",4,0,0,1,11.48,3,39,42
"2012-11-18 08:00:00",4,0,0,1,12.3,19,100,119
"2012-11-18 09:00:00",4,0,0,1,13.12,49,155,204
"2012-11-18 10:00:00",4,0,0,1,13.94,79,250,329
"2012-11-18 11:00:00",4,0,0,1,15.58,92,267,359
"2012-11-18 12:00:00",4,0,0,1,16.4,101,341,442
"2012-11-18 13:00:00",4,0,0,1,16.4,113,334,447
"2012-11-18 14:00:00",4,0,0,1,16.4,125,303,428
"2012-11-18 15:00:00",4,0,0,1,17.22,89,318,407
"2012-11-18 16:00:00",4,0,0,2,16.4,59,313,372
"2012-11-18 17:00:00",4,0,0,2,15.58,48,232,280
"2012-11-18 18:00:00",4,0,0,1,14.76,36,240,276
"2012-11-18 19:00:00",4,0,0,1,14.76,16,194,210
"2012-11-18 20:00:00",4,0,0,1,14.76,9,120,129
"2012-11-18 21:00:00",4,0,0,1,14.76,17,93,110
"2012-11-18 22:00:00",4,0,0,2,14.76,8,66,74
"2012-11-18 23:00:00",4,0,0,1,14.76,6,53,59
"2012-11-19 00:00:00",4,0,1,1,14.76,5,22,27
"2012-11-19 01:00:00",4,0,1,2,14.76,0,19,19
"2012-11-19 02:00:00",4,0,1,2,14.76,0,5,5
"2012-11-19 03:00:00",4,0,1,2,14.76,0,2,2
"2012-11-19 04:00:00",4,0,1,2,14.76,1,11,12
"2012-11-19 05:00:00",4,0,1,2,14.76,1,38,39
"2012-11-19 06:00:00",4,0,1,2,14.76,3,128,131
"2012-11-19 07:00:00",4,0,1,2,14.76,5,381,386
"2012-11-19 08:00:00",4,0,1,2,14.76,13,650,663
"2012-11-19 09:00:00",4,0,1,2,14.76,18,260,278
"2012-11-19 10:00:00",4,0,1,2,14.76,33,106,139
"2012-11-19 11:00:00",4,0,1,2,15.58,33,164,197
"2012-11-19 12:00:00",4,0,1,2,16.4,35,207,242
"2012-11-19 13:00:00",4,0,1,1,18.04,46,205,251
"2012-11-19 14:00:00",4,0,1,1,18.04,47,170,217
"2012-11-19 15:00:00",4,0,1,1,18.04,44,213,257
"2012-11-19 16:00:00",4,0,1,1,17.22,55,325,380
"2012-11-19 17:00:00",4,0,1,2,17.22,33,586,619
"2012-11-19 18:00:00",4,0,1,2,16.4,21,559,580
"2012-11-19 19:00:00",4,0,1,2,16.4,25,381,406
"2012-11-19 20:00:00",4,0,1,2,15.58,7,252,259
"2012-11-19 21:00:00",4,0,1,2,15.58,15,188,203
"2012-11-19 22:00:00",4,0,1,1,13.94,7,106,113
"2012-11-19 23:00:00",4,0,1,1,13.94,2,72,74
"2012-12-01 00:00:00",4,0,0,1,10.66,9,99,108
"2012-12-01 01:00:00",4,0,0,1,10.66,5,64,69
"2012-12-01 02:00:00",4,0,0,2,10.66,3,47,50
"2012-12-01 03:00:00",4,0,0,2,10.66,1,14,15
"2012-12-01 04:00:00",4,0,0,1,10.66,0,5,5
"2012-12-01 05:00:00",4,0,0,1,9.84,1,12,13
"2012-12-01 06:00:00",4,0,0,1,9.84,7,20,27
"2012-12-01 07:00:00",4,0,0,2,9.84,7,56,63
"2012-12-01 08:00:00",4,0,0,2,9.84,11,133,144
"2012-12-01 09:00:00",4,0,0,2,10.66,34,159,193
"2012-12-01 10:00:00",4,0,0,2,11.48,45,211,256
"2012-12-01 11:00:00",4,0,0,2,13.12,74,318,392
"2012-12-01 12:00:00",4,0,0,2,13.12,119,327,446
"2012-12-01 13:00:00",4,0,0,2,13.94,123,386,509
"2012-12-01 14:00:00",4,0,0,2,14.76,110,369,479
"2012-12-01 15:00:00",4,0,0,2,16.4,113,371,484
"2012-12-01 16:00:00",4,0,0,2,15.58,89,354,443
"2012-12-01 17:00:00",4,0,0,2,13.94,50,270,320
"2012-12-01 18:00:00",4,0,0,2,13.94,42,255,297
"2012-12-01 19:00:00",4,0,0,2,13.12,30,219,249
"2012-12-01 20:00:00",4,0,0,1,13.12,28,170,198
"2012-12-01 21:00:00",4,0,0,2,12.3,23,135,158
"2012-12-01 22:00:00",4,0,0,2,12.3,17,130,147
"2012-12-01 23:00:00",4,0,0,2,13.12,10,116,126
"2012-12-02 00:00:00",4,0,0,2,12.3,9,108,117
"2012-12-02 01:00:00",4,0,0,2,12.3,10,84,94
"2012-12-02 02:00:00",4,0,0,2,12.3,2,72,74
"2012-12-02 03:00:00",4,0,0,2,10.66,4,21,25
"2012-12-02 04:00:00",4,0,0,2,10.66,1,6,7
"2012-12-02 05:00:00",4,0,0,2,10.66,1,7,8
"2012-12-02 06:00:00",4,0,0,2,9.84,1,15,16
"2012-12-02 07:00:00",4,0,0,2,9.84,5,26,31
"2012-12-02 08:00:00",4,0,0,2,10.66,12,81,93
"2012-12-02 09:00:00",4,0,0,2,11.48,37,135,172
"2012-12-02 10:00:00",4,0,0,2,12.3,63,230,293
"2012-12-02 11:00:00",4,0,0,2,13.12,81,274,355
"2012-12-02 12:00:00",4,0,0,2,13.94,111,409,520
"2012-12-02 13:00:00",4,0,0,1,16.4,84,347,431
"2012-12-02 14:00:00",4,0,0,1,18.04,142,331,473
"2012-12-02 15:00:00",4,0,0,1,18.04,106,311,417
"2012-12-02 16:00:00",4,0,0,2,18.04,85,358,443
"2012-12-02 17:00:00",4,0,0,3,16.4,59,244,303
"2012-12-02 18:00:00",4,0,0,2,18.04,25,178,203
"2012-12-02 19:00:00",4,0,0,2,16.4,16,158,174
"2012-12-02 20:00:00",4,0,0,2,17.22,12,142,154
"2012-12-02 21:00:00",4,0,0,2,18.04,8,91,99
"2012-12-02 22:00:00",4,0,0,2,18.04,11,85,96
"2012-12-02 23:00:00",4,0,0,2,17.22,7,44,51
"2012-12-03 00:00:00",4,0,1,2,17.22,3,18,21
"2012-12-03 01:00:00",4,0,1,1,16.4,2,11,13
"2012-12-03 02:00:00",4,0,1,1,17.22,1,9,10
"2012-12-03 03:00:00",4,0,1,1,15.58,2,6,8
"2012-12-03 04:00:00",4,0,1,1,14.76,1,4,5
"2012-12-03 05:00:00",4,0,1,1,13.94,0,38,38
"2012-12-03 06:00:00",4,0,1,1,14.76,2,136,138
"2012-12-03 07:00:00",4,0,1,2,13.94,9,387,396
"2012-12-03 08:00:00",4,0,1,1,14.76,19,712,731
"2012-12-03 09:00:00",4,0,1,1,16.4,19,289,308
"2012-12-03 10:00:00",4,0,1,1,18.04,31,105,136
"2012-12-03 11:00:00",4,0,1,1,19.68,51,182,233
"2012-12-03 12:00:00",4,0,1,1,21.32,40,228,268
"2012-12-03 13:00:00",4,0,1,1,23.78,81,240,321
"2012-12-03 14:00:00",4,0,1,1,24.6,51,209,260
"2012-12-03 15:00:00",4,0,1,1,24.6,58,210,268
"2012-12-03 16:00:00",4,0,1,1,24.6,45,397,442
"2012-12-03 17:00:00",4,0,1,1,21.32,43,665,708
"2012-12-03 18:00:00",4,0,1,1,20.5,26,666,692
"2012-12-03 19:00:00",4,0,1,1,20.5,27,444,471
"2012-12-03 20:00:00",4,0,1,2,18.86,16,284,300
"2012-12-03 21:00:00",4,0,1,1,18.04,14,207,221
"2012-12-03 22:00:00",4,0,1,1,17.22,5,139,144
"2012-12-03 23:00:00",4,0,1,1,17.22,9,93,102
"2012-12-04 00:00:00",4,0,1,1,17.22,6,49,55
"2012-12-04 01:00:00",4,0,1,1,17.22,3,22,25
"2012-12-04 02:00:00",4,0,1,1,17.22,3,5,8
"2012-12-04 03:00:00",4,0,1,2,16.4,1,3,4
"2012-12-04 04:00:00",4,0,1,2,16.4,0,7,7
"2012-12-04 05:00:00",4,0,1,2,18.04,1,45,46
"2012-12-04 06:00:00",4,0,1,2,14.76,3,150,153
"2012-12-04 07:00:00",4,0,1,1,17.22,7,495,502
"2012-12-04 08:00:00",4,0,1,2,18.04,21,700,721
"2012-12-04 09:00:00",4,0,1,1,18.86,19,317,336
"2012-12-04 10:00:00",4,0,1,1,18.86,26,130,156
"2012-12-04 11:00:00",4,0,1,1,19.68,24,183,207
"2012-12-04 12:00:00",4,0,1,1,21.32,39,273,312
"2012-12-04 13:00:00",4,0,1,2,22.14,39,233,272
"2012-12-04 14:00:00",4,0,1,2,23.78,39,231,270
"2012-12-04 15:00:00",4,0,1,2,24.6,56,244,300
"2012-12-04 16:00:00",4,0,1,1,23.78,44,391,435
"2012-12-04 17:00:00",4,0,1,1,21.32,43,700,743
"2012-12-04 18:00:00",4,0,1,1,20.5,38,693,731
"2012-12-04 19:00:00",4,0,1,1,19.68,46,414,460
"2012-12-04 20:00:00",4,0,1,2,20.5,34,272,306
"2012-12-04 21:00:00",4,0,1,2,20.5,28,252,280
"2012-12-04 22:00:00",4,0,1,2,20.5,26,155,181
"2012-12-04 23:00:00",4,0,1,1,19.68,5,91,96
"2012-12-05 00:00:00",4,0,1,1,20.5,6,31,37
"2012-12-05 01:00:00",4,0,1,1,21.32,0,11,11
"2012-12-05 02:00:00",4,0,1,1,18.86,2,7,9
"2012-12-05 03:00:00",4,0,1,1,19.68,0,7,7
"2012-12-05 04:00:00",4,0,1,1,20.5,1,9,10
"2012-12-05 05:00:00",4,0,1,1,20.5,1,48,49
"2012-12-05 06:00:00",4,0,1,3,19.68,5,119,124
"2012-12-05 07:00:00",4,0,1,3,18.86,9,389,398
"2012-12-05 08:00:00",4,0,1,2,18.04,22,737,759
"2012-12-05 09:00:00",4,0,1,2,18.04,26,362,388
"2012-12-05 10:00:00",4,0,1,2,18.04,14,127,141
"2012-12-05 11:00:00",4,0,1,1,18.04,11,161,172
"2012-12-05 12:00:00",4,0,1,1,18.04,24,208,232
"2012-12-05 13:00:00",4,0,1,1,18.86,14,200,214
"2012-12-05 14:00:00",4,0,1,1,19.68,39,179,218
"2012-12-05 15:00:00",4,0,1,1,19.68,20,265,285
"2012-12-05 16:00:00",4,0,1,1,18.86,23,354,377
"2012-12-05 17:00:00",4,0,1,1,18.04,29,576,605
"2012-12-05 18:00:00",4,0,1,1,17.22,29,580,609
"2012-12-05 19:00:00",4,0,1,1,15.58,14,400,414
"2012-12-05 20:00:00",4,0,1,1,13.94,19,274,293
"2012-12-05 21:00:00",4,0,1,1,13.94,14,184,198
"2012-12-05 22:00:00",4,0,1,1,13.12,4,101,105
"2012-12-05 23:00:00",4,0,1,1,12.3,5,69,74
"2012-12-06 00:00:00",4,0,1,1,10.66,1,43,44
"2012-12-06 01:00:00",4,0,1,1,10.66,0,16,16
"2012-12-06 02:00:00",4,0,1,1,9.84,0,9,9
"2012-12-06 03:00:00",4,0,1,1,9.02,0,2,2
"2012-12-06 04:00:00",4,0,1,1,9.02,1,8,9
"2012-12-06 05:00:00",4,0,1,1,9.02,0,32,32
"2012-12-06 06:00:00",4,0,1,1,9.02,2,122,124
"2012-12-06 07:00:00",4,0,1,1,9.02,8,381,389
"2012-12-06 08:00:00",4,0,1,1,9.02,13,646,659
"2012-12-06 09:00:00",4,0,1,1,9.84,19,257,276
"2012-12-06 10:00:00",4,0,1,1,9.84,23,122,145
"2012-12-06 11:00:00",4,0,1,1,10.66,16,162,178
"2012-12-06 12:00:00",4,0,1,1,11.48,29,206,235
"2012-12-06 13:00:00",4,0,1,1,12.3,33,212,245
"2012-12-06 14:00:00",4,0,1,1,12.3,37,175,212
"2012-12-06 15:00:00",4,0,1,1,13.12,38,232,270
"2012-12-06 16:00:00",4,0,1,1,13.12,39,292,331
"2012-12-06 17:00:00",4,0,1,1,12.3,31,586,617
"2012-12-06 18:00:00",4,0,1,1,11.48,23,542,565
"2012-12-06 19:00:00",4,0,1,1,10.66,13,360,373
"2012-12-06 20:00:00",4,0,1,2,9.84,5,222,227
"2012-12-06 21:00:00",4,0,1,2,9.84,7,184,191
"2012-12-06 22:00:00",4,0,1,1,9.84,2,131,133
"2012-12-06 23:00:00",4,0,1,1,9.84,0,93,93
"2012-12-07 00:00:00",4,0,1,1,9.84,3,45,48
"2012-12-07 01:00:00",4,0,1,2,9.84,2,26,28
"2012-12-07 02:00:00",4,0,1,2,10.66,0,11,11
"2012-12-07 03:00:00",4,0,1,2,10.66,0,5,5
"2012-12-07 04:00:00",4,0,1,1,10.66,0,10,10
"2012-12-07 05:00:00",4,0,1,2,10.66,1,25,26
"2012-12-07 06:00:00",4,0,1,2,11.48,0,84,84
"2012-12-07 07:00:00",4,0,1,3,11.48,3,212,215
"2012-12-07 08:00:00",4,0,1,2,12.3,11,430,441
"2012-12-07 09:00:00",4,0,1,2,12.3,10,291,301
"2012-12-07 10:00:00",4,0,1,2,13.12,16,150,166
"2012-12-07 11:00:00",4,0,1,2,13.12,20,183,203
"2012-12-07 12:00:00",4,0,1,2,13.94,36,204,240
"2012-12-07 13:00:00",4,0,1,2,14.76,23,197,220
"2012-12-07 14:00:00",4,0,1,2,14.76,40,175,215
"2012-12-07 15:00:00",4,0,1,2,14.76,34,269,303
"2012-12-07 16:00:00",4,0,1,1,14.76,39,336,375
"2012-12-07 17:00:00",4,0,1,2,15.58,29,539,568
"2012-12-07 18:00:00",4,0,1,2,15.58,25,473,498
"2012-12-07 19:00:00",4,0,1,2,15.58,15,337,352
"2012-12-07 20:00:00",4,0,1,3,15.58,12,229,241
"2012-12-07 21:00:00",4,0,1,2,14.76,9,162,171
"2012-12-07 22:00:00",4,0,1,2,14.76,15,150,165
"2012-12-07 23:00:00",4,0,1,2,14.76,6,116,122
"2012-12-08 00:00:00",4,0,0,2,14.76,5,98,103
"2012-12-08 01:00:00",4,0,0,2,14.76,16,84,100
"2012-12-08 02:00:00",4,0,0,2,14.76,3,67,70
"2012-12-08 03:00:00",4,0,0,2,14.76,6,23,29
"2012-12-08 04:00:00",4,0,0,2,14.76,3,9,12
"2012-12-08 05:00:00",4,0,0,2,14.76,2,4,6
"2012-12-08 06:00:00",4,0,0,2,14.76,1,19,20
"2012-12-08 07:00:00",4,0,0,2,14.76,3,36,39
"2012-12-08 08:00:00",4,0,0,2,15.58,5,106,111
"2012-12-08 09:00:00",4,0,0,2,15.58,17,153,170
"2012-12-08 10:00:00",4,0,0,2,16.4,43,244,287
"2012-12-08 11:00:00",4,0,0,2,16.4,63,341,404
"2012-12-08 12:00:00",4,0,0,2,16.4,122,364,486
"2012-12-08 13:00:00",4,0,0,2,16.4,148,399,547
"2012-12-08 14:00:00",4,0,0,2,16.4,164,378,542
"2012-12-08 15:00:00",4,0,0,1,17.22,167,374,541
"2012-12-08 16:00:00",4,0,0,1,17.22,139,368,507
"2012-12-08 17:00:00",4,0,0,1,15.58,77,268,345
"2012-12-08 18:00:00",4,0,0,1,16.4,40,264,304
"2012-12-08 19:00:00",4,0,0,1,16.4,34,212,246
"2012-12-08 20:00:00",4,0,0,2,14.76,20,162,182
"2012-12-08 21:00:00",4,0,0,2,14.76,34,175,209
"2012-12-08 22:00:00",4,0,0,2,15.58,23,137,160
"2012-12-08 23:00:00",4,0,0,2,16.4,18,144,162
"2012-12-09 00:00:00",4,0,0,2,16.4,15,103,118
"2012-12-09 01:00:00",4,0,0,2,16.4,17,85,102
"2012-12-09 02:00:00",4,0,0,2,16.4,8,70,78
"2012-12-09 03:00:00",4,0,0,2,16.4,14,34,48
"2012-12-09 04:00:00",4,0,0,2,16.4,1,11,12
"2012-12-09 05:00:00",4,0,0,2,16.4,0,8,8
"2012-12-09 06:00:00",4,0,0,3,16.4,0,6,6
"2012-12-09 07:00:00",4,0,0,3,16.4,1,22,23
"2012-12-09 08:00:00",4,0,0,3,16.4,1,68,69
"2012-12-09 09:00:00",4,0,0,2,16.4,9,94,103
"2012-12-09 10:00:00",4,0,0,2,16.4,39,180,219
"2012-12-09 11:00:00",4,0,0,2,16.4,40,210,250
"2012-12-09 12:00:00",4,0,0,2,16.4,60,255,315
"2012-12-09 13:00:00",4,0,0,2,15.58,65,220,285
"2012-12-09 14:00:00",4,0,0,2,15.58,42,190,232
"2012-12-09 15:00:00",4,0,0,3,14.76,25,200,225
"2012-12-09 16:00:00",4,0,0,3,14.76,33,220,253
"2012-12-09 17:00:00",4,0,0,3,14.76,20,209,229
"2012-12-09 18:00:00",4,0,0,3,14.76,17,181,198
"2012-12-09 19:00:00",4,0,0,3,15.58,12,110,122
"2012-12-09 20:00:00",4,0,0,3,14.76,6,102,108
"2012-12-09 21:00:00",4,0,0,2,14.76,10,86,96
"2012-12-09 22:00:00",4,0,0,3,14.76,3,75,78
"2012-12-09 23:00:00",4,0,0,3,14.76,3,48,51
"2012-12-10 00:00:00",4,0,1,3,14.76,0,20,20
"2012-12-10 01:00:00",4,0,1,2,14.76,0,4,4
"2012-12-10 02:00:00",4,0,1,2,15.58,2,3,5
"2012-12-10 03:00:00",4,0,1,2,15.58,0,4,4
"2012-12-10 04:00:00",4,0,1,2,15.58,3,9,12
"2012-12-10 05:00:00",4,0,1,2,15.58,0,27,27
"2012-12-10 06:00:00",4,0,1,2,15.58,2,121,123
"2012-12-10 07:00:00",4,0,1,2,15.58,3,291,294
"2012-12-10 08:00:00",4,0,1,2,17.22,9,575,584
"2012-12-10 09:00:00",4,0,1,2,17.22,11,273,284
"2012-12-10 10:00:00",4,0,1,2,18.04,12,121,133
"2012-12-10 11:00:00",4,0,1,3,18.86,8,126,134
"2012-12-10 12:00:00",4,0,1,3,18.04,23,150,173
"2012-12-10 13:00:00",4,0,1,3,18.04,30,190,220
"2012-12-10 14:00:00",4,0,1,2,20.5,31,179,210
"2012-12-10 15:00:00",4,0,1,2,20.5,29,207,236
"2012-12-10 16:00:00",4,0,1,2,20.5,37,308,345
"2012-12-10 17:00:00",4,0,1,2,19.68,38,578,616
"2012-12-10 18:00:00",4,0,1,2,18.86,20,544,564
"2012-12-10 19:00:00",4,0,1,1,21.32,18,409,427
"2012-12-10 20:00:00",4,0,1,1,18.86,13,287,300
"2012-12-10 21:00:00",4,0,1,2,18.86,21,224,245
"2012-12-10 22:00:00",4,0,1,2,20.5,11,115,126
"2012-12-10 23:00:00",4,0,1,1,18.86,8,76,84
"2012-12-11 00:00:00",4,0,1,3,18.86,2,29,31
"2012-12-11 01:00:00",4,0,1,1,17.22,1,7,8
"2012-12-11 02:00:00",4,0,1,2,16.4,0,1,1
"2012-12-11 03:00:00",4,0,1,3,14.76,0,3,3
"2012-12-11 04:00:00",4,0,1,2,13.94,0,8,8
"2012-12-11 05:00:00",4,0,1,3,13.94,1,40,41
"2012-12-11 06:00:00",4,0,1,2,13.94,0,118,118
"2012-12-11 07:00:00",4,0,1,1,13.94,8,372,380
"2012-12-11 08:00:00",4,0,1,2,13.94,16,708,724
"2012-12-11 09:00:00",4,0,1,1,13.94,12,322,334
"2012-12-11 10:00:00",4,0,1,1,14.76,12,142,154
"2012-12-11 11:00:00",4,0,1,2,14.76,28,145,173
"2012-12-11 12:00:00",4,0,1,2,14.76,13,213,226
"2012-12-11 13:00:00",4,0,1,2,15.58,28,226,254
"2012-12-11 14:00:00",4,0,1,2,15.58,19,185,204
"2012-12-11 15:00:00",4,0,1,2,15.58,20,250,270
"2012-12-11 16:00:00",4,0,1,2,15.58,24,334,358
"2012-12-11 17:00:00",4,0,1,1,13.12,21,580,601
"2012-12-11 18:00:00",4,0,1,1,13.12,23,523,546
"2012-12-11 19:00:00",4,0,1,1,13.12,21,412,433
"2012-12-11 20:00:00",4,0,1,1,13.12,9,248,257
"2012-12-11 21:00:00",4,0,1,1,13.12,14,193,207
"2012-12-11 22:00:00",4,0,1,1,12.3,6,100,106
"2012-12-11 23:00:00",4,0,1,1,12.3,4,60,64
"2012-12-12 00:00:00",4,0,1,1,12.3,1,33,34
"2012-12-12 01:00:00",4,0,1,1,11.48,3,18,21
"2012-12-12 02:00:00",4,0,1,1,11.48,5,4,9
"2012-12-12 03:00:00",4,0,1,1,10.66,3,7,10
"2012-12-12 04:00:00",4,0,1,1,10.66,0,4,4
"2012-12-12 05:00:00",4,0,1,1,10.66,0,37,37
"2012-12-12 06:00:00",4,0,1,2,10.66,2,126,128
"2012-12-12 07:00:00",4,0,1,2,10.66,3,366,369
"2012-12-12 08:00:00",4,0,1,2,10.66,18,670,688
"2012-12-12 09:00:00",4,0,1,2,11.48,13,272,285
"2012-12-12 10:00:00",4,0,1,2,12.3,20,116,136
"2012-12-12 11:00:00",4,0,1,2,13.12,24,148,172
"2012-12-12 12:00:00",4,0,1,2,13.94,14,218,232
"2012-12-12 13:00:00",4,0,1,2,13.94,18,220,238
"2012-12-12 14:00:00",4,0,1,2,13.94,34,191,225
"2012-12-12 15:00:00",4,0,1,2,13.94,21,207,228
"2012-12-12 16:00:00",4,0,1,2,13.94,19,310,329
"2012-12-12 17:00:00",4,0,1,2,13.12,21,540,561
"2012-12-12 18:00:00",4,0,1,2,13.12,25,515,540
"2012-12-12 19:00:00",4,0,1,2,12.3,18,384,402
"2012-12-12 20:00:00",4,0,1,1,12.3,25,243,268
"2012-12-12 21:00:00",4,0,1,2,12.3,16,186,202
"2012-12-12 22:00:00",4,0,1,2,12.3,4,118,122
"2012-12-12 23:00:00",4,0,1,2,11.48,3,76,79
"2012-12-13 00:00:00",4,0,1,2,11.48,1,31,32
"2012-12-13 01:00:00",4,0,1,2,11.48,4,19,23
"2012-12-13 02:00:00",4,0,1,2,10.66,3,5,8
"2012-12-13 03:00:00",4,0,1,2,10.66,0,2,2
"2012-12-13 04:00:00",4,0,1,2,10.66,0,8,8
"2012-12-13 05:00:00",4,0,1,2,10.66,2,31,33
"2012-12-13 06:00:00",4,0,1,1,10.66,2,112,114
"2012-12-13 07:00:00",4,0,1,1,9.84,5,380,385
"2012-12-13 08:00:00",4,0,1,1,9.84,24,655,679
"2012-12-13 09:00:00",4,0,1,1,11.48,25,300,325
"2012-12-13 10:00:00",4,0,1,1,13.12,28,139,167
"2012-12-13 11:00:00",4,0,1,1,13.94,25,164,189
"2012-12-13 12:00:00",4,0,1,1,14.76,30,252,282
"2012-12-13 13:00:00",4,0,1,1,14.76,41,230,271
"2012-12-13 14:00:00",4,0,1,1,14.76,31,211,242
"2012-12-13 15:00:00",4,0,1,1,14.76,40,240,280
"2012-12-13 16:00:00",4,0,1,1,13.94,50,356,406
"2012-12-13 17:00:00",4,0,1,1,13.12,43,507,550
"2012-12-13 18:00:00",4,0,1,1,13.12,20,446,466
"2012-12-13 19:00:00",4,0,1,1,12.3,20,328,348
"2012-12-13 20:00:00",4,0,1,1,12.3,6,235,241
"2012-12-13 21:00:00",4,0,1,1,11.48,13,200,213
"2012-12-13 22:00:00",4,0,1,1,10.66,7,141,148
"2012-12-13 23:00:00",4,0,1,1,10.66,5,115,120
"2012-12-14 00:00:00",4,0,1,1,9.02,4,43,47
"2012-12-14 01:00:00",4,0,1,1,9.02,0,26,26
"2012-12-14 02:00:00",4,0,1,1,9.02,3,6,9
"2012-12-14 03:00:00",4,0,1,1,8.2,0,12,12
"2012-12-14 04:00:00",4,0,1,1,8.2,1,9,10
"2012-12-14 05:00:00",4,0,1,1,8.2,0,34,34
"2012-12-14 06:00:00",4,0,1,1,6.56,1,112,113
"2012-12-14 07:00:00",4,0,1,1,8.2,3,305,308
"2012-12-14 08:00:00",4,0,1,1,8.2,13,623,636
"2012-12-14 09:00:00",4,0,1,1,9.84,13,330,343
"2012-12-14 10:00:00",4,0,1,1,10.66,28,162,190
"2012-12-14 11:00:00",4,0,1,1,13.12,31,180,211
"2012-12-14 12:00:00",4,0,1,1,14.76,29,244,273
"2012-12-14 13:00:00",4,0,1,1,14.76,39,274,313
"2012-12-14 14:00:00",4,0,1,1,16.4,48,251,299
"2012-12-14 15:00:00",4,0,1,1,16.4,57,252,309
"2012-12-14 16:00:00",4,0,1,1,15.58,45,372,417
"2012-12-14 17:00:00",4,0,1,1,13.94,40,582,622
"2012-12-14 18:00:00",4,0,1,1,14.76,23,432,455
"2012-12-14 19:00:00",4,0,1,1,13.94,17,302,319
"2012-12-14 20:00:00",4,0,1,1,13.12,12,209,221
"2012-12-14 21:00:00",4,0,1,1,12.3,7,165,172
"2012-12-14 22:00:00",4,0,1,1,11.48,4,134,138
"2012-12-14 23:00:00",4,0,1,1,11.48,11,123,134
"2012-12-15 00:00:00",4,0,0,1,12.3,4,90,94
"2012-12-15 01:00:00",4,0,0,2,10.66,9,86,95
"2012-12-15 02:00:00",4,0,0,1,10.66,6,63,69
"2012-12-15 03:00:00",4,0,0,2,9.84,5,18,23
"2012-12-15 04:00:00",4,0,0,2,9.84,1,5,6
"2012-12-15 05:00:00",4,0,0,2,10.66,0,3,3
"2012-12-15 06:00:00",4,0,0,2,9.84,0,11,11
"2012-12-15 07:00:00",4,0,0,2,9.84,1,47,48
"2012-12-15 08:00:00",4,0,0,2,10.66,8,111,119
"2012-12-15 09:00:00",4,0,0,1,10.66,17,203,220
"2012-12-15 10:00:00",4,0,0,1,13.12,23,250,273
"2012-12-15 11:00:00",4,0,0,1,13.94,66,327,393
"2012-12-15 12:00:00",4,0,0,1,15.58,89,364,453
"2012-12-15 13:00:00",4,0,0,1,15.58,88,368,456
"2012-12-15 14:00:00",4,0,0,1,16.4,92,334,426
"2012-12-15 15:00:00",4,0,0,1,17.22,95,352,447
"2012-12-15 16:00:00",4,0,0,1,16.4,85,328,413
"2012-12-15 17:00:00",4,0,0,1,16.4,35,274,309
"2012-12-15 18:00:00",4,0,0,1,15.58,40,232,272
"2012-12-15 19:00:00",4,0,0,1,14.76,32,225,257
"2012-12-15 20:00:00",4,0,0,2,14.76,23,178,201
"2012-12-15 21:00:00",4,0,0,1,14.76,15,169,184
"2012-12-15 22:00:00",4,0,0,1,14.76,22,134,156
"2012-12-15 23:00:00",4,0,0,2,14.76,11,108,119
"2012-12-16 00:00:00",4,0,0,2,14.76,8,102,110
"2012-12-16 01:00:00",4,0,0,3,13.94,14,82,96
"2012-12-16 02:00:00",4,0,0,2,13.94,8,79,87
"2012-12-16 03:00:00",4,0,0,2,13.94,1,37,38
"2012-12-16 04:00:00",4,0,0,2,13.94,1,10,11
"2012-12-16 05:00:00",4,0,0,2,13.94,0,9,9
"2012-12-16 06:00:00",4,0,0,2,13.94,0,6,6
"2012-12-16 07:00:00",4,0,0,2,13.94,5,22,27
"2012-12-16 08:00:00",4,0,0,2,14.76,12,76,88
"2012-12-16 09:00:00",4,0,0,2,14.76,19,113,132
"2012-12-16 10:00:00",4,0,0,2,14.76,42,215,257
"2012-12-16 11:00:00",4,0,0,2,14.76,47,248,295
"2012-12-16 12:00:00",4,0,0,2,15.58,67,350,417
"2012-12-16 13:00:00",4,0,0,2,15.58,67,289,356
"2012-12-16 14:00:00",4,0,0,2,15.58,50,260,310
"2012-12-16 15:00:00",4,0,0,2,15.58,46,292,338
"2012-12-16 16:00:00",4,0,0,2,15.58,66,334,400
"2012-12-16 17:00:00",4,0,0,2,15.58,29,214,243
"2012-12-16 18:00:00",4,0,0,3,15.58,8,99,107
"2012-12-16 19:00:00",4,0,0,1,14.76,10,99,109
"2012-12-16 20:00:00",4,0,0,2,15.58,14,108,122
"2012-12-16 21:00:00",4,0,0,2,14.76,14,92,106
"2012-12-16 22:00:00",4,0,0,2,16.4,6,83,89
"2012-12-16 23:00:00",4,0,0,2,14.76,4,29,33
"2012-12-17 00:00:00",4,0,1,2,15.58,2,26,28
"2012-12-17 01:00:00",4,0,1,2,15.58,1,14,15
"2012-12-17 02:00:00",4,0,1,2,15.58,1,4,5
"2012-12-17 03:00:00",4,0,1,2,14.76,0,3,3
"2012-12-17 04:00:00",4,0,1,3,14.76,2,3,5
"2012-12-17 05:00:00",4,0,1,2,15.58,0,24,24
"2012-12-17 06:00:00",4,0,1,2,14.76,1,107,108
"2012-12-17 07:00:00",4,0,1,2,14.76,5,314,319
"2012-12-17 08:00:00",4,0,1,2,15.58,10,582,592
"2012-12-17 09:00:00",4,0,1,2,16.4,11,271,282
"2012-12-17 10:00:00",4,0,1,2,15.58,15,120,135
"2012-12-17 11:00:00",4,0,1,2,16.4,22,148,170
"2012-12-17 12:00:00",4,0,1,2,16.4,21,211,232
"2012-12-17 13:00:00",4,0,1,2,16.4,16,194,210
"2012-12-17 14:00:00",4,0,1,2,16.4,12,169,181
"2012-12-17 15:00:00",4,0,1,2,17.22,15,196,211
"2012-12-17 16:00:00",4,0,1,3,16.4,15,287,302
"2012-12-17 17:00:00",4,0,1,2,16.4,17,478,495
"2012-12-17 18:00:00",4,0,1,2,16.4,14,493,507
"2012-12-17 19:00:00",4,0,1,2,17.22,7,333,340
"2012-12-17 20:00:00",4,0,1,2,17.22,8,192,200
"2012-12-17 21:00:00",4,0,1,2,17.22,6,114,120
"2012-12-17 22:00:00",4,0,1,2,17.22,5,49,54
"2012-12-17 23:00:00",4,0,1,3,17.22,6,41,47
"2012-12-18 00:00:00",4,0,1,2,18.04,0,18,18
"2012-12-18 01:00:00",4,0,1,2,18.04,0,15,15
"2012-12-18 02:00:00",4,0,1,2,18.04,2,5,7
"2012-12-18 03:00:00",4,0,1,1,17.22,0,5,5
"2012-12-18 04:00:00",4,0,1,1,17.22,3,5,8
"2012-12-18 05:00:00",4,0,1,1,15.58,0,36,36
"2012-12-18 06:00:00",4,0,1,1,14.76,1,117,118
"2012-12-18 07:00:00",4,0,1,1,14.76,4,351,355
"2012-12-18 08:00:00",4,0,1,1,15.58,10,652,662
"2012-12-18 09:00:00",4,0,1,1,16.4,19,307,326
"2012-12-18 10:00:00",4,0,1,1,18.04,22,162,184
"2012-12-18 11:00:00",4,0,1,1,19.68,58,211,269
"2012-12-18 12:00:00",4,0,1,3,19.68,49,264,313
"2012-12-18 13:00:00",4,0,1,1,20.5,51,235,286
"2012-12-18 14:00:00",4,0,1,1,18.86,56,191,247
"2012-12-18 15:00:00",4,0,1,1,18.86,28,218,246
"2012-12-18 16:00:00",4,0,1,1,18.04,40,323,363
"2012-12-18 17:00:00",4,0,1,1,16.4,39,533,572
"2012-12-18 18:00:00",4,0,1,1,15.58,13,512,525
"2012-12-18 19:00:00",4,0,1,1,15.58,19,334,353
"2012-12-18 20:00:00",4,0,1,1,14.76,4,264,268
"2012-12-18 21:00:00",4,0,1,1,14.76,9,159,168
"2012-12-18 22:00:00",4,0,1,1,13.94,5,127,132
"2012-12-18 23:00:00",4,0,1,1,13.94,1,80,81
"2012-12-19 00:00:00",4,0,1,1,12.3,6,35,41
"2012-12-19 01:00:00",4,0,1,1,12.3,1,14,15
"2012-12-19 02:00:00",4,0,1,1,11.48,1,2,3
"2012-12-19 03:00:00",4,0,1,1,10.66,0,5,5
"2012-12-19 04:00:00",4,0,1,1,9.84,1,6,7
"2012-12-19 05:00:00",4,0,1,1,10.66,2,29,31
"2012-12-19 06:00:00",4,0,1,1,9.84,3,109,112
"2012-12-19 07:00:00",4,0,1,1,10.66,3,360,363
"2012-12-19 08:00:00",4,0,1,1,9.84,13,665,678
"2012-12-19 09:00:00",4,0,1,1,11.48,8,309,317
"2012-12-19 10:00:00",4,0,1,1,13.12,17,147,164
"2012-12-19 11:00:00",4,0,1,1,16.4,31,169,200
"2012-12-19 12:00:00",4,0,1,1,16.4,33,203,236
"2012-12-19 13:00:00",4,0,1,1,17.22,30,183,213
"2012-12-19 14:00:00",4,0,1,1,17.22,33,185,218
"2012-12-19 15:00:00",4,0,1,1,17.22,28,209,237
"2012-12-19 16:00:00",4,0,1,1,17.22,37,297,334
"2012-12-19 17:00:00",4,0,1,1,16.4,26,536,562
"2012-12-19 18:00:00",4,0,1,1,15.58,23,546,569
"2012-12-19 19:00:00",4,0,1,1,15.58,7,329,336
"2012-12-19 20:00:00",4,0,1,1,14.76,10,231,241
"2012-12-19 21:00:00",4,0,1,1,13.94,4,164,168
"2012-12-19 22:00:00",4,0,1,1,13.94,12,117,129
"2012-12-19 23:00:00",4,0,1,1,13.12,4,84,88
