"userid","age","dob_day","dob_year","dob_month","gender","tenure","friend_count","friendships_initiated","likes","likes_received","mobile_likes","mobile_likes_received","www_likes","www_likes_received"
1000013,19,25,1994,9,"female",652,410,246,0,0,0,0,0,0
1000038,25,17,1988,1,"female",62,685,498,4293,2816,1537,548,2756,2268
1000068,28,26,1985,11,"female",464,68,43,37,39,37,25,0,14
1000103,29,24,1984,3,"female",1435,124,42,46,60,43,49,3,11
1000125,21,26,1992,10,"male",511,143,59,15,16,15,15,0,1
1000136,21,10,1992,12,"female",603,236,107,80,97,63,41,17,56
1000150,36,2,1977,7,"female",191,25,4,173,5,171,4,2,1
1000154,24,23,1989,10,"male",1440,830,591,75,640,45,239,30,401
1000173,20,11,1993,5,"male",421,553,438,8,10,1,0,7,10
1000198,46,12,1967,1,"female",75,93,69,155,232,155,38,0,194
1000288,18,21,1995,2,"male",184,174,134,2,1,2,0,0,1
1000297,71,2,1942,5,"female",218,36,34,1212,31,1212,24,0,7
1000301,23,10,1990,10,"female",206,105,58,42,31,36,17,6,14
1000315,22,2,1991,8,"male",73,100,66,3,12,0,1,3,11
1000323,19,29,1994,11,"male",81,38,17,1,0,1,0,0,0
1000341,23,28,1990,1,"male",900,224,137,1,1,0,1,1,0
1000403,48,22,1965,6,"male",318,50,38,0,1,0,1,0,0
1000406,62,11,1951,12,"male",559,97,32,103,139,63,94,40,45
1000407,23,3,1990,12,"male",374,184,169,18,8,18,5,0,3
1000440,33,27,1980,10,"male",317,46,23,61,20,61,18,0,2
1000443,17,19,1996,2,"male",195,6,3,7,22,2,21,5,1
1000454,35,13,1978,8,"female",944,112,51,13,16,13,16,0,0
1000455,14,1,1999,6,"male",237,66,27,18,4,18,4,0,0
1000489,19,15,1994,5,"female",246,3,2,87,14,10,3,77,11
1000498,17,8,1996,8,"female",603,246,77,84,115,84,104,0,11
1000510,28,17,1985,4,"female",378,14,4,0,0,0,0,0,0
1000529,28,1,1985,1,"male",130,69,63,0,0,0,0,0,0
1000530,59,15,1954,9,"female",93,101,58,208,173,208,88,0,85
1000541,20,28,1993,2,"female",636,23,9,9,1,2,1,7,0
1000602,51,9,1962,10,"female",248,19,9,28,1,28,1,0,0
1000605,19,7,1994,5,"female",277,330,87,473,388,472,247,1,141
1000620,18,1,1995,5,"female",554,413,180,269,269,233,95,36,174
1000660,49,22,1964,7,"female",1545,106,41,487,281,487,169,0,112
1000682,18,6,1995,3,"male",779,483,402,4,2,4,1,0,1
1000693,32,18,1981,3,"male",131,52,43,0,1,0,1,0,0
1000707,49,14,1964,6,"male",174,88,64,44,25,44,11,0,14
1000714,35,3,1978,7,"female",279,25,20,0,44,0,4,0,40
1000724,17,1,1996,1,"female",158,18,14,9,12,8,6,1,6
1000730,31,8,1982,1,"male",542,19,18,0,0,0,0,0,0
1000733,46,1,1967,1,"male",466,39,33,212,189,149,147,63,42
1000737,42,28,1971,6,"male",55,0,0,0,0,0,0,0,0
1000738,55,12,1958,7,"male",1313,25,17,0,1,0,1,0,0
1000756,16,1,1997,6,"male",480,421,151,0,0,0,0,0,0
1000764,41,25,1972,12,"male",278,51,37,82,41,82,37,0,4
1000768,18,24,1995,2,"male",233,1030,715,458,1914,424,1185,34,729
1000786,31,17,1982,1,"male",359,37,21,84,14,84,13,0,1
1000798,32,4,1981,12,"female",144,26,16,11,17,11,14,0,3
1000799,15,3,1998,1,"female",101,11,8,0,0,0,0,0,0
1000813,33,25,1980,10,"male",587,12,6,4,0,2,0,2,0
1000824,15,26,1998,9,"female",261,897,580,14,32,14,32,0,0
1000867,33,12,1980,3,"male",586,28,22,1,0,1,0,0,0
1000883,25,1,1988,1,"male",149,21,6,2,0,2,0,0,0
1000905,20,4,1993,3,"female",544,165,119,422,121,88,66,334,55
1000920,68,29,1945,7,"female",1869,73,20,6,8,4,2,2,6
1000922,18,21,1995,8,"male",1253,776,569,340,672,28,251,312,421
1000936,50,19,1963,2,"female",527,42,36,0,0,0,0,0,0
1000941,60,24,1953,8,"female",1729,233,180,3631,563,3501,183,130,380
1000954,18,27,1995,2,"male",365,52,38,23,2,10,0,13,2
1000957,20,16,1993,5,"female",21,69,62,139,162,137,124,2,38
1000976,19,1,1994,1,"male",253,57,19,0,7,0,7,0,0
1000985,50,19,1963,8,"male",612,73,43,41,25,41,14,0,11
1001014,27,3,1986,4,"male",249,19,2,30,22,30,22,0,0
1001050,50,22,1963,9,"female",1240,160,78,4,27,3,25,1,2
1001056,54,14,1959,2,"female",253,58,39,38,31,38,18,0,13
1001075,103,4,1910,6,"female",1681,201,76,253,185,248,122,5,63
1001085,17,16,1996,8,"male",526,265,183,0,0,0,0,0,0
1001146,58,6,1955,6,"female",1755,301,159,634,363,483,136,151,227
1001153,20,20,1993,3,"female",339,225,137,46,42,46,20,0,22
1001196,66,9,1947,6,"female",281,17,14,29,1,29,1,0,0
1001217,35,1,1978,1,"male",79,3,3,1,0,1,0,0,0
1001237,54,28,1959,12,"female",299,110,77,62,87,1,25,61,62
1001257,16,26,1997,4,"male",561,242,150,1,2,0,1,1,1
1001262,84,8,1929,12,"female",1154,129,50,97,24,0,11,97,13
1001289,23,5,1990,1,"male",142,12,8,7,59,0,16,7,43
1001311,19,30,1994,10,"female",624,88,70,324,216,176,59,148,157
1001316,31,3,1982,3,"male",444,361,214,24,34,24,23,0,11
1001346,19,12,1994,2,"male",26,25,21,1,0,1,0,0,0
1001347,32,20,1981,2,"female",308,68,37,20,5,20,5,0,0
1001355,15,1,1998,7,"male",148,276,249,1,19,1,13,0,6
1001381,30,19,1983,7,"female",327,16,13,23,18,23,18,0,0
1001421,20,11,1993,5,"female",466,1072,603,1049,706,277,189,772,517
1001431,40,30,1973,9,"female",1654,20,3,0,0,0,0,0,0
1001453,62,9,1951,6,"male",144,32,21,5,3,0,1,5,2
1001464,16,8,1997,12,"male",558,73,62,0,2,0,0,0,2
1001497,29,7,1984,9,"male",472,30,29,24,0,24,0,0,0
1001545,38,18,1975,3,"female",205,98,50,1087,861,1087,729,0,132
1001567,94,23,1919,1,"male",1257,59,19,4,3,4,3,0,0
1001572,36,30,1977,9,"male",539,150,99,53,105,37,58,16,47
1001577,38,24,1975,3,"male",763,236,197,71,134,17,23,54,111
1001584,51,20,1962,6,"female",61,68,49,468,376,468,326,0,50
1001592,18,1,1995,3,"male",320,332,107,3,6,3,4,0,2
1001608,44,29,1969,7,"male",345,201,111,32,35,32,27,0,8
1001629,55,10,1958,4,"female",662,9,5,2,3,2,3,0,0
1001639,48,22,1965,10,"female",87,19,16,13,16,13,7,0,9
1001641,18,3,1995,4,"female",279,437,200,1143,293,1143,192,0,101
1001650,57,23,1956,11,"female",34,90,69,411,60,410,39,1,21
1001696,60,5,1953,10,"male",1301,81,38,2,4,2,4,0,0
1001698,34,9,1979,9,"male",388,66,48,27,31,27,29,0,2
1001724,50,13,1963,4,"male",682,18,3,0,0,0,0,0,0
1001747,21,5,1992,11,"male",426,803,730,8,4,0,3,8,1
1001749,57,25,1956,10,"male",1387,148,98,0,0,0,0,0,0
1001755,60,31,1953,10,"female",1380,351,176,109,60,86,47,23,13
1001765,20,7,1993,7,"male",631,137,102,23,7,23,4,0,3
1001768,29,21,1984,5,"male",456,79,70,10,13,10,12,0,1
1001772,32,24,1981,9,"female",147,53,38,13,19,13,14,0,5
1001805,29,1,1984,1,"male",56,78,55,16,233,12,81,4,152
1001827,53,29,1960,9,"female",135,6,4,2,0,0,0,2,0
1001853,34,24,1979,7,"male",214,13,9,0,0,0,0,0,0
1001898,32,21,1981,7,"male",170,9,9,0,3,0,3,0,0
1001920,23,4,1990,6,"male",842,580,444,2,54,2,15,0,39
1001935,53,28,1960,2,"male",292,34,26,132,2,0,0,132,2
1001945,29,25,1984,8,"male",704,68,41,135,131,129,101,6,30
1002003,18,1,1995,9,"female",1136,1357,967,111,399,52,335,59,64
1002016,108,1,1905,10,"male",62,10,4,4,4,0,1,4,3
1002023,18,10,1995,3,"male",391,373,294,168,158,30,53,138,105
1002030,48,13,1965,1,"female",370,82,26,57,35,19,22,38,13
1002060,47,18,1966,9,"male",1354,18,6,0,1,0,0,0,1
1002074,63,21,1950,6,"male",914,25,13,0,0,0,0,0,0
1002101,93,10,1920,5,"female",1329,19,5,7,4,6,1,1,3
1002103,36,5,1977,12,"male",1660,9,2,0,0,0,0,0,0
1002127,73,5,1940,12,"male",184,657,503,545,358,545,245,0,113
1002128,21,27,1992,12,"male",177,267,163,2,0,2,0,0,0
1002142,20,5,1993,9,"male",200,31,16,0,0,0,0,0,0
1002224,22,2,1991,2,"female",629,132,87,101,112,101,110,0,2
1002225,21,2,1992,2,"male",237,42,40,1,0,1,0,0,0
1002232,37,4,1976,9,"male",182,34,22,239,326,239,283,0,43
1002235,33,2,1980,4,"male",10,5,4,38,3,18,0,20,3
1002303,23,25,1990,1,"male",370,107,56,0,4,0,1,0,3
1002305,27,12,1986,2,"female",276,34,27,0,0,0,0,0,0
1002340,24,28,1989,5,"male",1389,350,254,1,0,1,0,0,0
1002348,61,22,1952,11,"male",877,29,11,5,8,4,8,1,0
1002428,17,27,1996,7,"female",12,31,19,0,0,0,0,0,0
1002430,47,28,1966,7,"male",216,27,24,0,0,0,0,0,0
1002432,16,11,1997,10,"female",533,598,372,0,5,0,3,0,2
1002439,23,23,1990,5,"female",548,60,42,177,10,174,9,3,1
1002458,20,5,1993,1,"male",307,534,473,579,480,141,194,438,286
1002470,25,7,1988,7,"female",176,10,7,0,0,0,0,0,0
1002484,27,20,1986,2,"male",254,69,59,46,14,46,14,0,0
1002552,69,9,1944,12,"female",93,26,9,11,8,11,8,0,0
1002554,18,21,1995,7,"female",739,241,171,102,88,92,35,10,53
1002559,21,15,1992,9,"male",100,218,151,11,19,11,17,0,2
1002574,27,3,1986,4,"female",562,92,52,0,11,0,8,0,3
1002597,31,30,1982,8,"male",409,1,1,0,2,0,2,0,0
1002607,36,5,1977,7,"male",231,141,62,109,20,109,5,0,15
1002613,55,2,1958,11,"male",302,34,32,2,0,0,0,2,0
1002617,16,2,1997,2,"female",457,245,135,1,0,1,0,0,0
1002625,61,9,1952,3,"female",1138,268,133,307,271,0,45,307,226
1002634,19,12,1994,10,"male",475,10,7,0,0,0,0,0,0
1002661,26,14,1987,2,"female",368,162,104,61,8,61,3,0,5
1002666,25,8,1988,8,"male",188,17,16,849,281,848,114,1,167
1002679,47,8,1966,2,NA,219,46,29,35,9,35,9,0,0
1002681,64,26,1949,8,"male",2273,73,32,13,17,12,16,1,1
1002701,17,4,1996,1,"male",480,101,57,353,5,274,2,79,3
1002725,15,9,1998,10,"male",146,127,92,27,35,27,25,0,10
1002728,19,28,1994,7,"female",531,640,80,335,869,328,620,7,249
1002736,29,1,1984,2,"female",163,97,57,0,0,0,0,0,0
1002754,22,1,1991,1,"male",258,147,43,5,21,3,9,2,12
1002756,67,16,1946,7,"female",1883,65,17,283,75,0,7,283,68
1002786,22,22,1991,9,"female",402,0,0,0,0,0,0,0,0
1002803,32,31,1981,10,"male",83,47,44,50,0,10,0,40,0
1002840,32,13,1981,12,"female",239,3,1,123,53,96,42,27,11
1002882,20,10,1993,6,"female",218,31,14,11,51,11,33,0,18
1002891,61,17,1952,2,"male",473,82,69,6,8,0,5,6,3
1002894,15,10,1998,5,"male",210,1581,1271,2205,1700,230,623,1975,1077
1002945,36,5,1977,8,"male",202,43,25,7,2,7,1,0,1
1003011,21,21,1992,7,"male",272,84,60,7,4,7,4,0,0
1003066,78,13,1935,1,"female",710,26,15,5,2,5,2,0,0
1003085,40,1,1973,10,"male",272,52,49,0,0,0,0,0,0
1003098,23,1,1990,1,"male",328,1,1,0,0,0,0,0,0
1003116,18,4,1995,4,"male",355,297,199,435,277,333,125,102,152
1003118,108,1,1905,1,"female",1477,131,21,6,20,6,16,0,4
1003125,28,13,1985,5,"female",1560,188,30,85,169,85,124,0,45
1003143,29,14,1984,9,"male",809,35,25,9,2,0,0,9,2
1003156,37,25,1976,8,"female",255,128,75,224,14,224,11,0,3
1003165,56,4,1957,3,"female",1534,43,26,5,21,1,5,4,16
1003169,21,23,1992,7,"male",680,297,115,1,0,1,0,0,0
1003191,26,18,1987,3,"female",589,83,34,124,64,124,47,0,17
1003211,25,1,1988,3,"female",237,139,101,530,823,530,585,0,238
1003216,21,12,1992,5,"female",255,79,53,430,42,430,42,0,0
1003225,32,29,1981,4,"male",124,2,1,0,0,0,0,0,0
1003239,22,24,1991,11,"male",453,872,795,23,17,23,9,0,8
1003247,21,26,1992,8,"male",415,858,554,673,1742,44,1124,629,618
1003250,20,26,1993,12,"male",326,95,76,1447,237,93,82,1354,155
1003279,19,6,1994,12,"female",852,355,121,223,127,212,110,11,17
1003285,16,23,1997,7,"male",335,379,280,121,4,0,0,121,4
1003293,108,4,1905,4,"male",896,634,162,1196,349,2,117,1194,232
1003315,64,20,1949,6,"male",1001,30,17,26,9,1,6,25,3
1003323,38,16,1975,5,"male",768,21,5,1,2,1,2,0,0
1003335,13,4,2000,3,"male",57,65,55,0,0,0,0,0,0
1003353,18,24,1995,4,"male",310,109,68,32,59,4,10,28,49
1003456,103,17,1910,11,"female",1019,210,108,326,119,100,61,226,58
1003467,42,13,1971,4,"male",1673,14,6,7,1,7,0,0,1
1003481,24,22,1989,2,"female",635,471,88,65,223,65,183,0,40
1003485,37,3,1976,2,"male",911,88,30,43,1,41,1,2,0
1003495,42,7,1971,8,"male",50,90,66,197,175,197,53,0,122
1003514,18,23,1995,12,"female",110,594,124,5,6,5,6,0,0
1003518,23,11,1990,10,"female",876,422,239,1717,1736,258,1169,1459,567
1003532,18,26,1995,11,"female",84,319,141,421,254,0,50,421,204
1003537,19,10,1994,6,"female",490,224,123,0,0,0,0,0,0
1003603,21,2,1992,7,"male",104,115,96,1,1,1,0,0,1
1003606,20,7,1993,3,"female",103,528,129,1101,1708,0,381,1101,1327
1003633,49,28,1964,1,"female",288,5,1,85,63,85,39,0,24
1003641,36,4,1977,11,"female",514,83,40,18,9,18,7,0,2
1003646,19,19,1994,9,"male",84,120,96,17,3,4,2,13,1
1003679,23,16,1990,10,"female",490,594,399,1122,1216,1121,842,1,374
1003680,19,7,1994,12,"male",227,58,44,74,100,17,36,57,64
1003723,17,7,1996,1,"female",80,59,45,143,2,143,1,0,1
1003740,108,30,1905,6,"female",1032,356,270,11,19,11,12,0,7
1003770,23,30,1990,10,"female",1253,66,48,0,0,0,0,0,0
1003816,14,9,1999,1,"female",425,5,4,1,1,0,1,1,0
1003843,17,2,1996,11,"female",223,264,102,2,5,0,0,2,5
1003870,17,2,1996,4,"male",147,113,86,2,0,2,0,0,0
1003882,26,3,1987,11,"male",509,189,140,0,2,0,2,0,0
1003994,18,25,1995,11,"female",99,691,292,742,490,742,469,0,21
1004019,34,22,1979,10,"male",172,83,66,2,3,2,2,0,1
1004029,20,1,1993,7,"male",148,139,102,720,198,459,108,261,90
1004035,51,28,1962,11,"female",478,100,48,1748,2096,137,192,1611,1904
1004074,53,26,1960,7,"male",1157,8,4,5,6,4,6,1,0
1004076,66,31,1947,3,"female",126,40,25,3,29,3,25,0,4
1004142,21,17,1992,12,"female",713,307,207,4,6,0,1,4,5
1004153,38,3,1975,1,"male",345,101,71,38,5,26,3,12,2
1004162,24,20,1989,1,"female",159,41,23,291,128,291,22,0,106
1004174,18,8,1995,6,"male",258,36,26,0,1,0,1,0,0
1004177,42,17,1971,6,"male",133,16,13,4,2,4,2,0,0
1004178,57,20,1956,10,"female",1454,75,20,57,23,57,23,0,0
1004189,71,22,1942,10,"female",1716,43,14,15,7,15,7,0,0
1004238,70,14,1943,5,"male",1019,59,27,0,0,0,0,0,0
1004241,30,3,1983,1,"female",918,91,30,20,1,20,1,0,0
1004245,18,18,1995,7,"male",134,12,9,0,0,0,0,0,0
1004315,51,17,1962,4,"female",1941,162,68,248,202,220,174,28,28
1004345,37,26,1976,7,"female",268,5,4,10,0,10,0,0,0
1004361,108,9,1905,10,"male",1128,701,62,1,1,0,0,1,1
1004396,54,11,1959,11,"male",739,48,24,966,792,641,107,325,685
1004400,40,16,1973,12,"female",732,95,33,129,483,97,268,32,215
1004427,52,25,1961,7,"female",257,28,25,67,27,1,18,66,9
1004428,19,13,1994,12,"male",745,245,41,17,55,17,36,0,19
1004436,18,23,1995,12,"male",195,12,9,0,0,0,0,0,0
1004450,59,5,1954,8,"female",557,83,66,40,11,40,2,0,9
1004456,48,30,1965,8,"female",575,44,20,41,27,41,8,0,19
1004470,78,8,1935,12,"female",56,10,6,2,3,0,1,2,2
1004475,27,28,1986,11,"male",653,11,8,4,4,2,0,2,4
1004479,58,8,1955,8,"male",498,4,2,7,0,2,0,5,0
1004480,28,26,1985,7,"female",475,99,50,104,26,104,18,0,8
1004484,103,4,1910,11,"female",711,113,74,193,49,1,23,192,26
1004492,19,15,1994,2,"male",478,441,175,642,184,642,145,0,39
1004497,14,9,1999,8,"female",525,486,315,1528,1178,1150,368,378,810
1004502,95,9,1918,7,"male",1218,116,41,0,0,0,0,0,0
1004515,47,27,1966,2,"female",574,13,6,0,0,0,0,0,0
1004522,21,6,1992,7,"female",20,3,2,66,20,66,10,0,10
1004536,34,2,1979,6,"male",458,37,33,0,0,0,0,0,0
1004537,63,27,1950,1,"female",901,154,96,50,37,42,20,8,17
1004547,93,1,1920,6,"female",266,7,5,3,0,3,0,0,0
1004556,18,25,1995,10,"male",138,20,20,0,1,0,0,0,1
1004605,25,16,1988,12,"male",336,200,182,38,7,38,6,0,1
1004629,29,28,1984,12,"male",339,469,256,879,1828,189,505,690,1323
1004635,21,18,1992,4,"female",336,234,33,9,37,9,18,0,19
1004640,28,31,1985,1,"female",257,32,18,32,25,2,12,30,13
1004644,26,2,1987,9,"male",122,22,14,8,0,8,0,0,0
1004676,17,4,1996,7,"female",650,213,120,29,67,29,65,0,2
1004691,22,12,1991,5,"male",461,61,36,4,3,4,1,0,2
1004720,22,1,1991,5,"female",20,2,0,0,0,0,0,0,0
1004757,26,31,1987,12,"female",569,140,68,2,10,2,9,0,1
1004773,23,29,1990,10,"male",688,2,2,0,0,0,0,0,0
1004775,22,12,1991,12,"female",141,10,8,0,2,0,1,0,1
1004782,73,26,1940,10,"female",1098,24,16,23,3,23,3,0,0
1004789,19,30,1994,7,"male",31,32,14,2,0,2,0,0,0
1004793,37,10,1976,4,"male",303,16,13,103,34,0,15,103,19
1004820,34,10,1979,2,"female",1133,108,77,24,13,21,4,3,9
1004836,103,22,1910,8,"female",2029,3931,1302,794,2298,94,1357,700,941
1004848,34,31,1979,12,"female",313,28,16,2,4,2,4,0,0
1004852,108,4,1905,7,"male",194,25,11,257,92,243,74,14,18
1004880,52,23,1961,7,"female",378,79,60,23,15,20,11,3,4
1004889,63,28,1950,2,"female",1109,52,13,4,11,3,3,1,8
1004919,86,9,1927,11,"female",1594,491,207,0,0,0,0,0,0
1004925,36,3,1977,6,"female",2257,172,106,278,201,265,171,13,30
1004934,16,3,1997,11,"female",278,68,33,81,17,80,10,1,7
1004946,113,1,1900,1,"female",1279,181,42,117,72,21,23,96,49
1004950,41,15,1972,11,"male",604,15,13,879,380,879,380,0,0
1004972,54,16,1959,6,"male",654,367,219,9181,4610,9181,3455,0,1155
1004974,62,23,1951,12,"male",1278,49,25,13,10,13,10,0,0
1004977,44,13,1969,11,"female",486,7,3,9,0,9,0,0,0
1004997,56,18,1957,2,"female",1634,1,0,5,0,0,0,5,0
1005039,22,26,1991,3,"male",196,49,28,0,9,0,4,0,5
1005050,36,18,1977,2,"male",390,2,2,0,0,0,0,0,0
1005052,22,20,1991,12,"female",950,1030,343,280,232,220,151,60,81
1005070,32,6,1981,7,"male",238,71,41,1,0,1,0,0,0
1005083,18,1,1995,3,"male",518,465,416,0,0,0,0,0,0
1005088,34,2,1979,7,"male",644,2441,577,626,7297,228,3618,398,3679
1005092,50,13,1963,9,"male",398,121,81,230,53,230,13,0,40
1005096,22,6,1991,12,"male",728,1088,507,490,847,116,375,374,472
1005097,14,29,1999,11,"male",242,36,20,0,0,0,0,0,0
1005121,60,17,1953,7,"female",1818,77,16,24,3,24,2,0,1
1005129,16,15,1997,11,"male",1359,98,50,0,1,0,0,0,1
1005135,101,12,1912,12,"male",83,206,190,0,7,0,5,0,2
1005148,23,3,1990,6,"female",330,119,39,15,29,15,10,0,19
1005203,39,21,1974,2,"male",313,142,104,3,2,3,2,0,0
1005258,45,5,1968,1,"female",127,22,14,15,4,15,3,0,1
1005283,30,23,1983,1,"male",306,115,82,180,36,0,8,180,28
1005313,103,1,1910,6,"male",1652,350,292,3,0,0,0,3,0
1005341,29,16,1984,3,"female",278,11,8,4,0,4,0,0,0
1005352,21,21,1992,12,"female",1462,304,136,478,130,295,51,183,79
1005357,20,1,1993,1,"female",901,33,30,50,7,50,3,0,4
1005392,59,9,1954,12,"female",63,50,36,230,116,230,76,0,40
1005419,19,23,1994,4,"male",467,258,117,4,2,1,0,3,2
1005458,17,17,1996,10,"female",543,1183,483,5,51,4,35,1,16
1005470,74,17,1939,8,"male",1050,96,44,1,4,0,2,1,2
1005481,39,30,1974,5,"male",102,4,4,17,5,17,4,0,1
1005485,49,4,1964,12,"female",783,36,31,0,1,0,1,0,0
1005487,14,14,1999,11,"male",186,64,41,3,5,3,1,0,4
1005512,37,2,1976,12,"female",400,100,43,9,66,8,29,1,37
1005522,108,10,1905,7,"male",1102,2430,1754,26,58,26,50,0,8
1005535,18,16,1995,6,"female",32,252,227,380,210,344,102,36,108
1005580,18,31,1995,3,"female",836,27,21,189,13,105,5,84,8
1005581,16,20,1997,7,"male",409,263,97,579,915,362,339,217,576
1005598,22,31,1991,1,"male",441,142,119,0,0,0,0,0,0
1005621,17,13,1996,7,"male",366,184,88,70,0,66,0,4,0
1005624,112,11,1901,9,"male",1164,22,8,30,31,23,20,7,11
1005649,34,25,1979,1,"male",324,7,4,0,0,0,0,0,0
1005655,30,19,1983,4,"female",360,44,30,0,0,0,0,0,0
1005664,22,5,1991,5,"male",369,32,3,0,2,0,0,0,2
1005671,64,16,1949,11,"male",254,282,244,612,8,612,4,0,4
1005676,52,2,1961,2,"female",688,107,94,385,117,385,103,0,14
1005681,89,19,1924,1,"male",1814,51,4,7,6,1,6,6,0
1005710,18,18,1995,3,"male",368,1629,819,488,347,488,293,0,54
1005719,38,15,1975,12,"male",262,4,4,0,1,0,0,0,1
1005793,108,19,1905,12,"male",84,107,103,2,0,2,0,0,0
1005838,25,16,1988,3,"male",687,0,0,0,0,0,0,0,0
1005843,100,1,1913,9,"male",1495,135,92,105,50,0,28,105,22
1005882,15,22,1998,5,"male",824,208,83,0,1,0,1,0,0
1005897,24,15,1989,12,"male",377,397,296,68,21,61,10,7,11
1005908,22,1,1991,1,"female",525,34,32,0,0,0,0,0,0
1005917,25,15,1988,9,"male",242,69,62,0,1,0,1,0,0
1005926,44,30,1969,7,"male",185,147,51,3434,3539,3434,3004,0,535
1005933,23,6,1990,1,"male",190,138,115,45,54,44,20,1,34
1005958,52,25,1961,1,"male",209,8,4,5,0,5,0,0,0
1005966,16,21,1997,3,"male",431,209,49,95,257,95,246,0,11
1006011,14,22,1999,10,"male",293,134,92,45,12,43,7,2,5
1006042,52,6,1961,7,"female",1543,111,42,812,669,810,351,2,318
1006087,73,26,1940,11,"male",1798,157,50,9,43,6,20,3,23
1006116,58,2,1955,10,"male",662,34,19,181,23,0,3,181,20
1006129,21,9,1992,12,"male",497,635,491,0,0,0,0,0,0
1006132,44,19,1969,5,"male",362,12,7,0,1,0,1,0,0
1006149,34,11,1979,3,"male",331,19,9,45,24,0,6,45,18
1006168,18,5,1995,5,"male",7,0,0,0,0,0,0,0,0
1006170,45,28,1968,5,"female",1174,703,287,312,667,292,500,20,167
1006180,22,18,1991,11,"male",207,108,93,12,39,12,26,0,13
1006188,23,4,1990,5,"male",437,168,156,1,4,1,3,0,1
1006214,77,13,1936,3,"female",406,21,11,4,1,0,1,4,0
1006228,100,26,1913,8,"female",2261,375,71,537,443,537,347,0,96
1006239,18,7,1995,8,"female",544,855,467,93,194,83,113,10,81
1006255,19,26,1994,12,"male",29,88,83,0,3,0,3,0,0
1006273,21,16,1992,1,"male",499,232,142,649,159,649,133,0,26
1006313,41,29,1972,8,"male",509,1083,934,113,62,112,51,1,11
1006319,19,1,1994,1,"male",435,31,29,52,1,43,0,9,1
1006324,25,5,1988,6,"female",188,386,47,0,22,0,20,0,2
1006349,26,12,1987,12,"male",22,19,15,1,0,1,0,0,0
1006403,69,21,1944,7,"male",1326,147,44,19,16,19,8,0,8
1006429,113,1,1900,1,"female",1144,124,43,188,14,0,1,188,13
1006437,102,9,1911,8,"female",1641,961,397,157,613,147,442,10,171
1006455,28,11,1985,3,"female",345,1,0,0,0,0,0,0,0
1006476,44,18,1969,9,"female",737,482,407,96,138,37,70,59,68
1006486,29,1,1984,1,"female",324,301,191,574,487,567,296,7,191
1006507,66,25,1947,11,"male",320,58,18,0,0,0,0,0,0
1006533,33,14,1980,2,"female",544,81,2,19,23,17,9,2,14
1006587,23,20,1990,6,"male",342,83,78,0,2,0,0,0,2
1006603,60,20,1953,1,"male",1625,106,34,48,6,0,1,48,5
1006623,19,10,1994,2,"female",356,329,197,1067,342,1067,272,0,70
1006632,19,14,1994,5,"male",615,33,20,2,11,2,3,0,8
1006635,15,18,1998,5,"female",563,392,224,403,388,399,254,4,134
1006641,98,1,1915,1,"female",1493,200,144,157,126,129,41,28,85
1006722,103,3,1910,12,"male",722,16,2,7,0,7,0,0,0
1006728,16,11,1997,4,"male",571,105,55,145,5,145,4,0,1
1006731,17,13,1996,3,"female",309,206,62,26,48,17,15,9,33
1006742,28,20,1985,1,"male",581,38,14,0,9,0,6,0,3
1006768,27,15,1986,4,"female",11,40,37,33,80,30,67,3,13
1006769,14,13,1999,3,"female",50,114,54,2,8,0,5,2,3
1006797,17,16,1996,9,"male",715,560,359,0,2,0,0,0,2
1006805,20,15,1993,10,"female",695,191,65,155,16,155,14,0,2
1006833,18,16,1995,10,"female",585,1077,343,989,668,953,473,36,195
1006841,60,1,1953,12,"female",2124,639,157,139,12,100,7,39,5
1006846,29,14,1984,12,"male",16,77,43,1,5,1,5,0,0
1006854,34,15,1979,12,"male",17,1,1,0,0,0,0,0,0
1006878,67,15,1946,12,"male",414,123,84,72,159,0,11,72,148
1006906,47,14,1966,7,"female",94,89,56,16,41,16,26,0,15
1006913,20,16,1993,4,"female",624,230,85,10,7,10,3,0,4
1006923,66,10,1947,7,"male",242,8,6,10,0,10,0,0,0
1006964,113,27,1900,7,"female",1662,156,13,1,6,0,1,1,5
1006972,23,12,1990,12,"male",1109,30,11,0,0,0,0,0,0
1006996,61,10,1952,3,"female",214,34,20,5,2,5,2,0,0
1007011,73,31,1940,5,"female",1654,49,10,6,4,0,0,6,4
1007013,15,8,1998,8,"female",298,183,106,105,28,105,27,0,1
1007037,50,26,1963,1,"female",148,99,86,0,0,0,0,0,0
1007051,18,19,1995,7,"female",371,66,43,5,1,1,0,4,1
1007058,32,16,1981,3,"male",446,82,53,0,0,0,0,0,0
1007078,30,14,1983,12,"male",370,65,38,20,46,14,18,6,28
1007079,46,21,1967,10,"male",665,161,107,34,91,30,75,4,16
1007094,18,16,1995,12,"female",306,129,89,15,14,11,12,4,2
1007115,60,20,1953,2,"female",1875,89,54,150,146,142,51,8,95
1007130,59,24,1954,9,"male",149,44,20,4,62,0,34,4,28
1007149,23,19,1990,10,"male",292,237,116,1,18,0,12,1,6
1007153,28,18,1985,7,"male",471,44,13,2,7,2,4,0,3
1007185,43,4,1970,8,"female",668,4,4,1,0,0,0,1,0
1007186,21,8,1992,10,"male",219,31,22,2,4,2,4,0,0
1007202,35,11,1978,5,"female",1460,95,34,18,32,5,23,13,9
1007205,83,30,1930,1,"male",751,23,18,0,10,0,5,0,5
1007206,14,4,1999,10,"female",480,333,100,206,91,200,40,6,51
1007217,19,2,1994,6,"female",467,241,108,51,101,51,65,0,36
1007224,47,21,1966,2,"female",1763,330,159,957,620,628,135,329,485
1007233,61,15,1952,9,"female",642,54,31,106,7,106,4,0,3
1007246,41,9,1972,8,"male",281,41,34,0,0,0,0,0,0
1007250,108,24,1905,11,"female",1738,37,8,0,0,0,0,0,0
1007260,27,20,1986,4,"male",409,8,1,0,0,0,0,0,0
1007289,53,24,1960,4,"female",328,140,98,3287,510,3287,224,0,286
1007297,20,25,1993,6,"male",505,752,602,132,256,84,166,48,90
1007307,108,16,1905,12,"female",1165,525,247,12,72,12,65,0,7
1007320,18,25,1995,9,"female",370,1,1,0,0,0,0,0,0
1007325,56,22,1957,6,"female",562,67,33,186,49,0,29,186,20
1007350,40,15,1973,9,"female",482,64,27,739,686,739,596,0,90
1007362,34,26,1979,7,"male",1026,32,3,0,3,0,3,0,0
1007390,37,25,1976,1,"male",435,2,1,0,0,0,0,0,0
1007427,54,1,1959,9,"male",113,65,62,43,78,43,22,0,56
1007435,56,20,1957,5,"male",825,9,3,19,2,0,1,19,1
1007459,22,21,1991,11,"female",381,106,46,118,127,118,106,0,21
1007474,14,9,1999,7,"male",18,13,7,11,16,0,0,11,16
1007479,75,27,1938,4,"male",1684,154,82,3,40,0,26,3,14
1007483,64,18,1949,7,"female",165,74,68,12,16,12,10,0,6
1007498,30,1,1983,1,"male",161,75,71,0,1,0,1,0,0
1007503,19,7,1994,9,"female",1059,3776,1068,6912,27029,1197,12019,5715,15010
1007511,15,2,1998,1,"male",765,119,71,3,2,3,2,0,0
1007522,17,22,1996,6,"male",1384,305,221,28,12,28,12,0,0
1007525,65,17,1948,10,"male",1139,102,52,2,2,2,2,0,0
1007536,106,16,1907,4,"male",399,160,74,63,53,63,46,0,7
1007556,22,11,1991,11,"female",658,378,94,324,252,324,236,0,16
1007576,67,5,1946,9,"female",809,154,129,2,9,0,5,2,4
1007600,62,21,1951,3,"male",420,14,8,136,42,0,35,136,7
1007614,18,22,1995,3,"female",459,1265,767,791,4359,270,2826,521,1533
1007615,17,1,1996,1,"male",2,0,0,0,0,0,0,0,0
1007618,44,18,1969,12,"male",1389,1093,574,5,46,4,30,1,16
1007627,21,1,1992,1,"female",96,45,42,0,10,0,10,0,0
1007630,106,1,1907,1,"male",928,72,16,36,53,3,33,33,20
1007633,17,11,1996,11,"male",62,1,1,0,0,0,0,0,0
1007650,21,2,1992,3,"male",1504,601,340,86,83,35,49,51,34
1007669,18,2,1995,9,"male",231,398,225,243,143,228,134,15,9
1007688,50,4,1963,2,"female",575,73,41,494,209,0,26,494,183
1007699,18,11,1995,4,"male",1219,735,258,560,775,553,720,7,55
1007707,31,29,1982,7,"female",59,96,36,7,13,7,13,0,0
1007711,19,28,1994,9,"male",310,355,274,1,0,1,0,0,0
1007722,60,17,1953,8,"female",2431,512,308,744,486,354,304,390,182
1007724,32,18,1981,8,"male",52,89,72,4,1,4,0,0,1
1007742,57,10,1956,11,"female",660,93,59,152,35,74,27,78,8
1007750,15,12,1998,8,"male",663,65,17,5,0,0,0,5,0
1007751,33,20,1980,9,"male",132,0,0,0,0,0,0,0,0
1007756,35,25,1978,12,"male",59,8,7,114,14,114,10,0,4
1007777,34,18,1979,1,"female",252,135,118,59,32,47,19,12,13
1007796,45,27,1968,11,"male",808,75,53,32,260,8,97,24,163
1007800,39,23,1974,3,"female",1050,271,77,3,3,3,3,0,0
1007802,48,28,1965,11,"female",921,68,20,27,25,27,6,0,19
1007806,64,29,1949,10,"male",1665,462,250,0,0,0,0,0,0
1007808,21,6,1992,5,"male",197,90,74,6,39,6,34,0,5
1007850,20,28,1993,4,"female",128,449,92,897,560,897,470,0,90
1007900,25,16,1988,12,"male",343,81,56,117,13,117,6,0,7
1007908,17,26,1996,4,"male",313,38,31,2,2,0,0,2,2
1007921,68,17,1945,8,"male",949,298,241,3,2,3,1,0,1
1008018,53,28,1960,10,"male",573,44,31,4,8,0,2,4,6
1008030,52,5,1961,5,"male",676,22,9,0,1,0,1,0,0
1008071,16,1,1997,5,"male",165,149,123,0,8,0,0,0,8
1008072,34,21,1979,10,"male",104,36,30,191,55,191,51,0,4
1008083,49,7,1964,8,"male",201,46,32,88,34,54,28,34,6
1008103,39,7,1974,5,"male",433,16,9,0,0,0,0,0,0
1008130,33,8,1980,12,"male",250,9,6,0,0,0,0,0,0
1008138,58,13,1955,4,"male",90,18,13,9,3,9,3,0,0
1008146,45,21,1968,3,"female",113,138,108,449,116,449,83,0,33
1008163,28,1,1985,1,"male",141,28,27,10,6,10,4,0,2
1008165,22,10,1991,7,"female",34,11,10,3,3,3,3,0,0
1008166,21,30,1992,10,"female",265,345,160,123,206,64,178,59,28
1008202,46,13,1967,11,"male",750,83,65,1,1,1,1,0,0
1008220,25,1,1988,1,"male",163,1,0,0,0,0,0,0,0
1008292,29,26,1984,4,"male",688,153,69,76,57,76,47,0,10
1008298,17,24,1996,2,"male",181,151,139,75,41,45,23,30,18
1008303,108,13,1905,4,NA,2278,279,199,250,145,248,104,2,41
1008324,57,17,1956,4,"male",640,150,98,84,58,0,10,84,48
1008353,98,27,1915,7,"female",1943,163,83,9,16,3,4,6,12
1008361,49,2,1964,2,"female",482,45,41,4,0,4,0,0,0
1008388,17,22,1996,5,"male",518,472,374,0,0,0,0,0,0
1008396,52,13,1961,3,"female",601,103,55,4,13,0,2,4,11
1008412,61,17,1952,10,"male",187,14,12,1,10,0,0,1,10
1008426,25,1,1988,3,"male",857,19,8,0,0,0,0,0,0
1008438,22,15,1991,7,"male",498,231,135,0,0,0,0,0,0
1008440,17,26,1996,1,"female",1160,712,554,140,120,73,86,67,34
1008445,108,8,1905,12,"male",484,383,318,0,47,0,28,0,19
1008448,113,5,1900,9,"male",1204,88,15,55,112,1,53,54,59
1008488,64,14,1949,10,"male",1325,287,213,10,3,0,0,10,3
1008498,67,12,1946,10,"female",1077,104,54,20,72,20,68,0,4
1008503,31,10,1982,2,"male",277,30,29,0,0,0,0,0,0
1008511,55,26,1958,8,"male",1502,64,17,2,4,0,3,2,1
1008516,17,28,1996,3,"male",504,316,261,12,15,10,9,2,6
1008547,17,3,1996,5,"male",153,199,122,0,0,0,0,0,0
1008556,61,29,1952,11,"female",677,18,17,0,0,0,0,0,0
1008584,30,26,1983,2,"male",516,123,72,193,111,176,106,17,5
1008613,28,9,1985,1,"male",395,29,21,1,5,1,4,0,1
1008619,64,26,1949,10,"female",2173,45,34,74,24,11,15,63,9
1008635,50,6,1963,3,"female",929,44,29,12,4,0,4,12,0
1008639,20,7,1993,5,"male",484,1393,754,982,3473,373,2152,609,1321
1008689,113,8,1900,1,"male",1692,485,228,14,0,0,0,14,0
1008709,21,24,1992,4,"male",297,358,216,124,52,0,25,124,27
1008731,39,24,1974,4,"female",162,2,2,4,0,4,0,0,0
1008734,81,24,1932,1,"female",586,29,22,3,0,0,0,3,0
1008755,56,29,1957,9,"female",363,103,79,225,117,225,57,0,60
1008784,54,22,1959,3,"male",244,28,18,23,0,23,0,0,0
1008801,23,1,1990,10,"male",1060,402,347,2,2,2,2,0,0
1008808,25,1,1988,1,"female",137,151,96,252,43,252,33,0,10
1008817,20,30,1993,3,"female",209,458,156,226,156,117,63,109,93
1008872,31,14,1982,12,"female",628,31,9,0,0,0,0,0,0
1008880,17,5,1996,4,"female",192,38,21,184,65,15,6,169,59
1008884,62,12,1951,8,"female",991,61,44,61,74,0,2,61,72
1008891,54,29,1959,5,"male",1886,36,19,1,42,1,30,0,12
1008903,29,20,1984,11,"female",119,33,15,44,54,44,39,0,15
1008904,103,13,1910,5,"male",812,68,24,0,5,0,5,0,0
1008944,18,3,1995,11,"male",124,117,113,4,1,0,0,4,1
1008983,24,17,1989,8,"female",313,205,32,9,18,9,16,0,2
1009008,27,1,1986,1,"male",35,1,1,4,5,0,3,4,2
1009052,29,31,1984,1,"male",522,349,212,5,1,5,1,0,0
1009053,18,1,1995,1,"female",376,170,55,228,148,79,87,149,61
1009062,29,30,1984,3,"male",458,115,86,50,24,50,16,0,8
1009089,24,21,1989,5,"female",207,72,50,139,24,139,15,0,9
1009137,20,14,1993,11,"female",420,196,138,10,17,10,7,0,10
1009141,20,17,1993,10,"female",453,17,6,3,4,3,3,0,1
1009142,31,12,1982,6,"male",220,59,43,51,13,0,4,51,9
1009154,18,28,1995,12,"female",163,352,75,800,483,800,239,0,244
1009163,41,8,1972,9,"female",400,44,27,4,2,4,1,0,1
1009182,83,7,1930,12,"male",491,44,39,2,0,2,0,0,0
1009194,17,10,1996,4,"male",320,48,29,164,63,159,24,5,39
1009198,28,7,1985,7,"male",392,0,0,0,0,0,0,0,0
1009250,29,7,1984,3,"male",1901,0,0,0,0,0,0,0,0
1009273,21,22,1992,9,"male",388,254,190,12,29,6,27,6,2
1009285,51,25,1962,10,"female",410,128,88,3,5,0,2,3,3
1009300,64,19,1949,9,"male",791,286,191,2,1,2,1,0,0
1009312,18,31,1995,12,"female",62,253,82,381,749,360,300,21,449
1009324,38,26,1975,1,"female",39,12,7,16,8,16,5,0,3
1009332,17,13,1996,1,"male",81,1,0,148,8,148,6,0,2
1009370,24,27,1989,7,"female",1056,583,400,919,438,919,366,0,72
1009372,24,8,1989,12,"female",574,54,28,9,2,9,2,0,0
1009413,28,7,1985,12,"male",35,50,49,0,0,0,0,0,0
1009416,19,10,1994,10,"male",84,1123,443,1854,3320,1243,1982,611,1338
1009429,59,7,1954,12,"male",319,22,16,478,118,0,14,478,104
1009435,22,17,1991,12,"female",88,30,16,31,22,31,16,0,6
1009456,17,20,1996,11,"female",540,1955,987,249,54,229,25,20,29
1009475,72,20,1941,12,"female",1508,136,64,26,1,26,0,0,1
1009483,54,29,1959,7,"female",671,75,16,113,87,113,72,0,15
1009541,20,12,1993,7,"female",222,31,24,0,0,0,0,0,0
1009543,32,13,1981,1,"female",674,1,1,80,80,79,79,1,1
1009555,36,19,1977,4,"female",257,18,7,26,9,1,0,25,9
1009623,25,14,1988,3,"male",375,135,116,19,0,15,0,4,0
1009626,18,6,1995,6,"male",544,218,172,13,1,12,1,1,0
1009630,35,11,1978,1,"male",865,81,70,3,0,3,0,0,0
1009638,18,3,1995,1,"male",459,296,96,39,60,2,31,37,29
1009644,18,22,1995,5,"female",484,61,52,92,46,80,24,12,22
1009651,32,30,1981,5,"male",516,68,59,0,4,0,0,0,4
1009656,50,14,1963,7,"male",287,199,91,46,137,33,113,13,24
1009701,21,1,1992,1,"male",316,74,24,1,1,1,1,0,0
1009728,108,16,1905,7,"female",256,100,68,12,2,12,1,0,1
1009746,113,16,1900,12,"female",1520,74,49,105,28,0,7,105,21
1009779,63,28,1950,11,"female",1477,13,7,0,0,0,0,0,0
1009782,18,5,1995,1,"female",658,509,335,317,975,116,281,201,694
1009808,24,19,1989,2,"female",423,87,16,3,0,3,0,0,0
1009817,25,31,1988,12,"female",223,254,120,591,31,591,31,0,0
1009832,44,11,1969,6,"female",528,24,11,26,14,26,13,0,1
1009869,25,18,1988,3,"male",38,20,5,0,0,0,0,0,0
1009870,29,31,1984,12,"male",650,66,40,0,0,0,0,0,0
1009904,31,7,1982,7,"female",366,13,13,13,2,1,0,12,2
1009909,16,28,1997,1,"male",121,291,236,11,49,11,49,0,0
1009914,42,21,1971,1,"female",303,69,47,58,45,0,13,58,32
1009951,16,24,1997,3,"female",90,70,56,46,58,46,53,0,5
1009961,25,18,1988,4,"male",267,72,23,0,1,0,1,0,0
1009988,18,25,1995,6,"male",594,230,133,484,64,410,30,74,34
1010003,29,29,1984,12,"male",498,76,60,0,0,0,0,0,0
1010010,19,25,1994,12,"female",222,2,0,0,0,0,0,0,0
1010025,35,15,1978,7,"male",934,135,57,8,6,8,6,0,0
1010036,21,5,1992,9,"male",509,237,224,1,0,0,0,1,0
1010038,23,19,1990,1,"male",787,151,82,3,0,3,0,0,0
1010048,18,24,1995,3,"female",388,47,38,2,14,0,1,2,13
1010072,15,19,1998,6,"female",373,524,296,168,52,168,35,0,17
1010082,25,7,1988,6,"female",356,67,19,8,0,8,0,0,0
1010087,32,1,1981,7,"male",640,115,60,155,41,155,21,0,20
1010102,20,28,1993,8,"male",142,160,120,0,3,0,3,0,0
1010112,21,23,1992,2,"male",276,159,106,0,2,0,2,0,0
1010120,58,29,1955,7,"male",999,36,29,3,13,3,10,0,3
1010139,22,9,1991,5,"female",538,1079,657,3137,2281,2730,1467,407,814
1010145,39,20,1974,4,"female",548,243,182,178,118,178,105,0,13
1010178,113,21,1900,8,"female",2086,246,117,13,3,9,3,4,0
1010186,45,10,1968,8,"male",408,23,21,25,1,0,0,25,1
1010206,108,5,1905,2,"male",406,1066,778,224,575,224,439,0,136
1010251,26,5,1987,6,"male",218,5,4,0,0,0,0,0,0
1010254,23,1,1990,1,"male",565,2,1,0,0,0,0,0,0
1010277,23,27,1990,5,"female",470,341,57,17,53,17,28,0,25
1010297,52,5,1961,5,"female",294,55,38,14,3,14,3,0,0
1010303,19,1,1994,5,"female",1295,356,117,20,13,19,12,1,1
1010312,23,6,1990,6,"female",57,1,0,0,0,0,0,0,0
1010362,17,11,1996,12,"female",71,5,3,3,0,3,0,0,0
1010364,20,19,1993,7,"male",223,1,1,0,0,0,0,0,0
1010385,23,20,1990,1,"male",1453,136,63,0,0,0,0,0,0
1010389,52,16,1961,6,"female",271,26,20,16,4,16,2,0,2
1010406,35,13,1978,2,"female",421,37,20,2,0,2,0,0,0
1010415,16,29,1997,7,"male",24,136,130,22,29,22,20,0,9
1010430,26,1,1987,1,"male",101,33,19,103,55,102,27,1,28
1010433,41,30,1972,1,"female",499,10,8,3,6,0,0,3,6
1010458,26,4,1987,4,"male",486,252,207,13,11,13,11,0,0
1010544,31,1,1982,7,"female",711,485,188,5921,9183,5921,8709,0,474
1010584,21,23,1992,7,"female",1141,542,120,161,293,161,180,0,113
1010611,59,28,1954,5,"female",1499,62,19,14,19,1,4,13,15
1010641,38,26,1975,12,"female",447,41,20,35,22,10,12,25,10
1010656,22,28,1991,8,"male",511,10,3,0,0,0,0,0,0
1010665,18,20,1995,7,"male",417,318,295,7,12,4,7,3,5
1010682,34,3,1979,12,"male",443,32,10,56,32,56,21,0,11
1010688,18,10,1995,6,"male",111,37,30,1,9,1,9,0,0
1010723,95,20,1918,5,"female",978,128,42,27,0,27,0,0,0
1010726,20,4,1993,4,"male",516,222,116,90,30,90,12,0,18
1010734,34,8,1979,5,"female",199,17,8,218,177,85,118,133,59
1010745,17,3,1996,11,"male",190,487,392,46,165,46,64,0,101
1010754,26,1,1987,1,"female",212,54,40,3,1,3,1,0,0
1010783,23,13,1990,6,"male",369,16,15,0,0,0,0,0,0
1010792,57,16,1956,5,"female",515,40,26,6,3,6,3,0,0
1010816,46,3,1967,2,"female",450,302,172,314,337,314,127,0,210
1010832,49,11,1964,10,"male",168,47,38,4,5,4,5,0,0
1010837,45,21,1968,10,"male",616,7,5,0,0,0,0,0,0
1010890,45,12,1968,8,"male",303,208,151,16,3,16,1,0,2
1010907,36,1,1977,7,"male",264,75,50,85,60,85,35,0,25
1010956,61,14,1952,11,"male",651,133,40,6,23,6,11,0,12
1010966,37,2,1976,8,"female",249,77,37,22,32,22,13,0,19
1010975,72,17,1941,5,"female",307,28,20,1,2,1,2,0,0
1010990,26,13,1987,2,"female",118,136,116,246,256,246,234,0,22
1010994,28,5,1985,5,"male",192,69,55,0,2,0,1,0,1
1010999,23,9,1990,4,"male",353,98,71,1154,278,0,46,1154,232
1011033,27,16,1986,6,"male",597,175,146,0,0,0,0,0,0
1011035,61,5,1952,5,"male",1427,47,20,15,3,9,2,6,1
1011042,60,17,1953,3,"male",547,33,32,1,0,1,0,0,0
1011049,61,30,1952,10,"male",1565,43,19,0,1,0,1,0,0
1011053,70,22,1943,2,"male",1611,14,8,25,9,0,2,25,7
1011054,35,9,1978,7,"male",328,6,6,0,3,0,0,0,3
1011070,72,23,1941,7,"female",386,132,111,27,0,0,0,27,0
1011087,17,31,1996,7,"male",446,126,35,4,2,1,1,3,1
1011092,49,23,1964,7,"male",484,100,70,20,18,2,5,18,13
1011096,19,14,1994,8,"male",202,999,905,430,236,351,130,79,106
1011108,20,2,1993,6,"male",1190,4638,1480,80,179,1,70,79,109
1011133,22,1,1991,1,"female",77,22,15,0,0,0,0,0,0
1011134,56,6,1957,4,"male",816,16,12,6,4,6,1,0,3
1011205,24,16,1989,6,"female",687,192,107,29,47,19,31,10,16
1011235,54,24,1959,9,"male",284,89,76,1,3,1,3,0,0
1011263,47,20,1966,6,"male",807,179,74,3,4,0,4,3,0
1011326,31,2,1982,9,"female",380,34,19,6,3,6,1,0,2
1011351,29,14,1984,4,"male",112,47,39,0,0,0,0,0,0
1011412,17,7,1996,2,"male",228,129,104,0,11,0,11,0,0
1011433,74,13,1939,3,"male",1771,9,4,0,1,0,1,0,0
1011437,53,30,1960,11,"female",797,166,85,609,57,0,7,609,50
1011440,26,22,1987,11,"male",264,2025,590,18,17,18,15,0,2
1011454,43,14,1970,1,"male",533,51,11,0,4,0,1,0,3
1011459,56,5,1957,2,"female",1703,33,11,32,5,32,5,0,0
1011466,60,16,1953,4,"male",1167,55,30,17,0,17,0,0,0
1011467,33,10,1980,7,"male",640,66,48,3,1,3,1,0,0
1011479,21,10,1992,9,"female",1737,226,74,21,26,8,24,13,2
1011488,53,30,1960,3,"female",629,44,21,0,0,0,0,0,0
1011491,49,12,1964,10,"female",390,12,8,1,8,1,8,0,0
1011493,38,26,1975,9,"female",415,35,17,10,8,10,4,0,4
1011501,37,13,1976,3,"male",285,9,8,6,3,0,0,6,3
1011508,21,12,1992,5,"female",89,11,7,107,29,99,23,8,6
1011509,22,7,1991,4,"female",273,274,72,0,0,0,0,0,0
1011515,30,10,1983,3,"female",360,6,1,2,1,2,1,0,0
1011520,16,25,1997,6,"female",442,130,73,380,529,288,321,92,208
1011525,21,22,1992,9,"female",393,52,41,477,322,477,264,0,58
1011538,103,30,1910,8,"male",616,490,438,341,238,287,213,54,25
1011564,20,20,1993,9,"male",765,326,265,0,17,0,6,0,11
1011577,35,31,1978,10,"female",590,49,21,34,57,26,51,8,6
1011578,23,30,1990,10,"male",1053,763,123,0,1,0,0,0,1
1011606,35,22,1978,12,"female",472,67,23,0,6,0,6,0,0
1011611,103,11,1910,10,"male",2306,19,10,0,2,0,2,0,0
1011613,55,11,1958,5,"female",881,23,15,2,1,0,0,2,1
1011634,28,15,1985,1,"male",1376,1481,512,453,1310,204,1051,249,259
1011653,26,20,1987,10,"female",18,36,33,2,4,2,1,0,3
1011675,64,30,1949,6,"female",1385,286,169,259,156,148,63,111,93
1011699,44,6,1969,4,"male",611,1,1,0,0,0,0,0,0
1011717,40,15,1973,12,"male",467,22,16,83,82,83,39,0,43
1011726,32,18,1981,4,"male",894,203,133,6,9,5,4,1,5
1011743,37,17,1976,9,"female",522,65,29,1580,302,1580,86,0,216
1011748,67,16,1946,9,"female",684,20,13,5,0,5,0,0,0
1011753,15,2,1998,4,"female",354,393,357,29,7,29,1,0,6
1011762,72,12,1941,10,"male",979,43,23,8,5,0,3,8,2
1011793,23,28,1990,12,"female",675,130,67,3,1,0,0,3,1
1011798,34,18,1979,11,"male",358,15,13,4,1,0,1,4,0
1011821,22,11,1991,9,"male",378,24,12,5,0,5,0,0,0
1011846,45,29,1968,1,"male",271,1,1,2,0,2,0,0,0
1011856,22,17,1991,12,"male",56,3,2,0,0,0,0,0,0
1011876,57,8,1956,5,"female",140,44,30,10,7,10,6,0,1
1011880,34,1,1979,1,"male",485,78,6,1,0,1,0,0,0
1011901,43,18,1970,7,"male",135,5,5,0,0,0,0,0,0
1011929,26,7,1987,3,"male",596,22,11,0,2,0,2,0,0
1011949,32,6,1981,7,"female",294,182,95,5,13,0,1,5,12
1011982,29,4,1984,5,"female",765,79,2,0,7,0,6,0,1
1012000,24,11,1989,7,"female",204,13,11,88,242,88,144,0,98
1012007,19,30,1994,8,"male",339,97,27,3,2,3,1,0,1
1012018,26,3,1987,3,"male",24,45,31,7,2,7,2,0,0
1012020,17,21,1996,9,"male",350,210,90,39,24,11,17,28,7
1012053,26,17,1987,8,"female",249,46,26,0,0,0,0,0,0
1012108,20,6,1993,9,"male",394,92,88,0,0,0,0,0,0
1012110,22,6,1991,11,"female",250,307,49,30,15,20,13,10,2
1012134,18,12,1995,7,"female",628,294,26,44,45,44,23,0,22
1012160,58,13,1955,11,"female",744,14,11,3,0,3,0,0,0
1012171,49,25,1964,1,"female",1475,76,25,265,97,265,49,0,48
1012174,68,27,1945,4,"male",1068,264,186,2,0,2,0,0,0
1012192,23,10,1990,2,"male",384,110,67,4,0,4,0,0,0
1012205,23,22,1990,4,"female",231,104,45,11,12,11,7,0,5
1012234,16,18,1997,1,"female",430,60,47,33,20,23,13,10,7
1012235,41,10,1972,2,"male",85,48,20,0,0,0,0,0,0
1012243,66,23,1947,9,"female",1353,114,41,184,10,184,9,0,1
1012252,16,12,1997,11,"male",195,120,51,5,3,5,3,0,0
1012293,25,28,1988,12,"male",430,50,43,1,0,1,0,0,0
1012294,15,27,1998,3,"male",198,1,0,2,0,2,0,0,0
1012296,23,10,1990,11,"female",420,20,12,2,1,2,1,0,0
1012368,26,8,1987,7,"male",1040,77,22,0,0,0,0,0,0
1012406,31,22,1982,11,"female",895,93,63,74,16,74,11,0,5
1012410,26,22,1987,5,"male",387,202,162,4,8,4,6,0,2
1012443,15,20,1998,11,"female",819,1041,675,2522,1012,2207,699,315,313
1012459,19,23,1994,12,"male",590,514,464,1,13,0,3,1,10
1012510,30,15,1983,3,"male",90,17,13,285,55,285,55,0,0
1012535,59,18,1954,8,"male",322,17,12,3,1,2,1,1,0
1012555,39,2,1974,9,"male",764,9,9,3,0,2,0,1,0
1012559,27,1,1986,1,"male",753,66,11,1,0,1,0,0,0
1012560,21,30,1992,11,"female",541,38,20,131,26,131,7,0,19
1012564,33,13,1980,6,"male",655,105,95,0,0,0,0,0,0
1012569,30,13,1983,7,"male",1038,254,128,30,27,5,25,25,2
1012588,25,8,1988,4,"male",502,68,58,1,0,1,0,0,0
1012596,100,5,1913,11,"female",2227,747,397,217,416,106,141,111,275
1012605,50,16,1963,10,"female",306,60,51,113,38,113,35,0,3
1012644,49,29,1964,6,"male",413,0,0,0,0,0,0,0,0
1012657,19,6,1994,2,"female",119,48,17,185,74,75,23,110,51
1012696,23,10,1990,12,"male",1435,1570,688,2682,1099,1259,715,1423,384
1012700,19,9,1994,5,"male",544,560,329,165,656,131,535,34,121
1012739,16,24,1997,7,"male",828,174,104,613,20,612,18,1,2
1012745,68,28,1945,8,"male",492,256,155,880,559,880,487,0,72
1012752,20,22,1993,2,"female",310,40,31,0,0,0,0,0,0
1012763,28,19,1985,7,"male",11,53,51,6,9,6,9,0,0
1012766,21,14,1992,1,"female",251,144,12,35,0,35,0,0,0
1012799,52,30,1961,4,"female",211,36,30,13,9,5,1,8,8
1012824,29,23,1984,6,"female",803,9,3,0,0,0,0,0,0
1012833,49,27,1964,12,"male",611,36,8,0,24,0,9,0,15
1012839,49,14,1964,2,"male",203,48,39,32,3,2,0,30,3
1012841,52,26,1961,11,"female",565,153,96,75,42,72,9,3,33
1012903,25,17,1988,1,"female",64,11,7,261,101,261,26,0,75
1012915,29,31,1984,1,"male",278,213,129,1,6,0,4,1,2
1012947,18,19,1995,7,"male",25,25,22,0,1,0,0,0,1
1012962,32,10,1981,9,"female",364,16,14,0,0,0,0,0,0
1012998,14,8,1999,2,"female",198,279,221,995,556,995,511,0,45
1013018,25,1,1988,1,"male",116,0,0,0,0,0,0,0,0
1013020,21,28,1992,10,"female",842,1010,439,2,9,2,8,0,1
1013026,43,23,1970,11,"female",221,147,75,53,40,0,5,53,35
1013044,103,1,1910,2,"female",504,82,43,6,2,6,2,0,0
1013059,69,27,1944,3,"female",894,22,13,597,27,0,8,597,19
1013081,23,20,1990,10,"female",41,16,15,10,0,10,0,0,0
1013121,31,29,1982,9,"female",1870,401,261,1563,2004,512,740,1051,1264
1013194,18,8,1995,8,"male",103,81,68,79,19,0,0,79,19
1013202,19,20,1994,12,"male",1408,627,235,7,14,7,13,0,1
1013221,41,12,1972,6,"female",570,20,9,4,0,4,0,0,0
1013248,20,27,1993,9,"male",652,438,351,27,1,5,1,22,0
1013250,58,21,1955,10,"male",312,14,10,1,1,1,1,0,0
1013253,44,24,1969,4,"male",244,52,15,4,3,4,2,0,1
1013305,17,1,1996,2,"male",325,46,38,0,0,0,0,0,0
1013306,27,10,1986,7,"male",690,526,354,1,35,1,21,0,14
1013307,68,1,1945,11,"male",593,3628,837,1386,921,797,676,589,245
1013308,37,24,1976,2,"female",559,74,48,187,105,187,105,0,0
1013311,76,22,1937,7,"male",2266,134,45,76,28,76,22,0,6
1013337,60,2,1953,1,"male",814,9,5,2,0,2,0,0,0
1013340,62,10,1951,6,"female",1064,176,69,0,1,0,1,0,0
1013367,108,2,1905,11,"female",1921,138,70,0,5,0,5,0,0
1013378,20,17,1993,11,"male",243,32,12,0,0,0,0,0,0
1013382,20,26,1993,12,"male",32,91,87,0,0,0,0,0,0
1013385,46,1,1967,1,"female",1699,107,32,420,203,416,113,4,90
1013387,53,31,1960,12,"male",9,2,2,0,0,0,0,0,0
1013425,47,18,1966,9,"female",275,33,20,34,2,34,2,0,0
1013431,23,22,1990,12,"male",274,557,299,459,749,459,650,0,99
1013443,45,20,1968,1,"male",246,8,7,1,1,1,1,0,0
1013470,30,3,1983,1,"male",653,9,6,0,0,0,0,0,0
1013504,30,18,1983,3,"male",541,194,133,4,1,4,1,0,0
1013541,24,12,1989,12,"male",143,3,2,2,0,2,0,0,0
1013553,64,28,1949,6,"female",536,10,5,0,0,0,0,0,0
1013585,60,20,1953,5,"female",2017,357,94,329,841,328,454,1,387
1013623,44,6,1969,6,"female",284,97,52,4,67,0,29,4,38
1013629,17,30,1996,4,"male",153,189,178,20,54,20,43,0,11
1013634,49,3,1964,5,"female",1048,118,57,163,325,146,121,17,204
1013652,20,22,1993,3,"male",607,116,56,2,23,0,19,2,4
1013663,17,4,1996,7,"male",651,109,35,0,0,0,0,0,0
1013664,16,18,1997,9,"female",493,241,108,9,5,9,5,0,0
1013672,15,22,1998,7,"female",309,407,276,51,286,51,204,0,82
1013673,85,3,1928,7,"female",565,25,19,5,1,3,1,2,0
1013705,42,8,1971,8,"male",490,0,0,0,0,0,0,0,0
1013713,20,17,1993,3,"male",386,189,147,9,3,0,0,9,3
1013717,43,2,1970,8,"male",378,100,72,3,0,2,0,1,0
1013720,22,29,1991,5,"female",271,15,9,3,0,3,0,0,0
1013725,22,8,1991,8,"male",216,354,297,399,152,399,123,0,29
1013756,30,3,1983,10,"male",155,9,9,0,0,0,0,0,0
1013759,18,9,1995,3,"male",519,89,80,0,7,0,7,0,0
1013764,31,20,1982,2,"male",482,119,85,0,0,0,0,0,0
1013775,56,27,1957,2,"female",396,55,23,40,43,37,33,3,10
1013786,19,4,1994,6,"male",471,134,106,31,36,30,32,1,4
1013802,53,15,1960,5,"female",2325,353,158,682,533,191,240,491,293
1013806,25,1,1988,1,"female",212,109,42,23,2,23,2,0,0
1013843,27,1,1986,5,"male",974,6,6,0,0,0,0,0,0
1013877,108,1,1905,8,"male",268,128,86,180,128,150,73,30,55
1013909,25,18,1988,4,"male",1204,100,63,1,18,1,8,0,10
1013941,32,13,1981,7,"female",187,95,54,3,2,3,2,0,0
1013962,18,2,1995,10,"male",474,137,99,25,1,12,1,13,0
1014064,14,17,1999,8,"male",180,65,38,1,0,0,0,1,0
1014092,27,8,1986,1,"male",174,1,1,3,3,0,0,3,3
1014093,34,19,1979,2,"male",369,65,40,166,77,166,63,0,14
1014094,25,1,1988,1,"female",8,10,1,242,35,242,29,0,6
1014110,27,18,1986,4,"male",438,93,93,0,0,0,0,0,0
1014119,22,26,1991,11,"male",540,108,86,11,8,11,6,0,2
1014125,32,13,1981,5,"male",650,90,33,9,0,2,0,7,0
1014139,57,3,1956,1,"male",297,97,57,368,9,0,3,368,6
1014168,52,17,1961,7,"male",124,6,2,85,40,66,22,19,18
1014169,64,7,1949,1,"male",1564,195,63,231,59,3,29,228,30
1014180,55,7,1958,1,"male",11,1,1,0,4,0,3,0,1
1014214,23,16,1990,6,"male",384,60,51,266,1,0,0,266,1
1014223,48,27,1965,12,"male",1797,112,47,53,31,53,31,0,0
1014231,111,10,1902,12,"female",1576,259,97,482,166,482,127,0,39
1014240,72,6,1941,12,"male",442,30,25,1,5,0,4,1,1
1014241,27,26,1986,10,"female",190,651,503,66,298,66,188,0,110
1014246,23,1,1990,1,"male",337,260,142,3,8,3,3,0,5
1014272,68,20,1945,11,"female",1403,553,308,2,4,2,4,0,0
1014392,25,15,1988,10,"male",39,24,22,6,7,3,5,3,2
1014405,20,3,1993,3,"female",562,3729,1763,60,149,60,135,0,14
1014433,19,1,1994,2,"male",273,218,148,191,11,1,6,190,5
1014491,24,17,1989,1,"male",822,11,8,0,2,0,2,0,0
1014503,19,15,1994,6,"female",365,321,260,269,11,269,8,0,3
1014546,60,6,1953,1,"male",832,49,11,0,0,0,0,0,0
1014583,13,29,2000,4,"female",210,302,270,50,4,47,3,3,1
1014600,22,1,1991,1,"female",10,26,4,0,0,0,0,0,0
1014603,42,5,1971,11,"female",240,43,33,0,0,0,0,0,0
1014613,66,14,1947,10,"male",1476,27,11,0,0,0,0,0,0
1014673,19,24,1994,10,"male",573,290,233,109,78,99,47,10,31
1014712,20,24,1993,5,"male",871,269,85,836,323,836,200,0,123
1014744,28,23,1985,6,"male",483,281,162,4,14,4,10,0,4
1014755,19,13,1994,11,"male",125,1,1,3,0,0,0,3,0
1014758,48,25,1965,12,"female",143,21,17,90,14,90,2,0,12
1014764,53,29,1960,7,"female",445,34,24,86,32,0,4,86,28
1014772,27,15,1986,3,"female",231,250,50,11,2,11,2,0,0
1014814,23,15,1990,10,"male",455,232,201,3,3,0,1,3,2
1014816,60,31,1953,3,"female",892,55,17,86,3,86,2,0,1
1014843,19,5,1994,10,"male",244,35,7,0,0,0,0,0,0
1014853,23,2,1990,5,"male",531,514,402,9,2,9,2,0,0
1014886,40,14,1973,7,"male",530,190,128,154,258,152,216,2,42
1014932,17,27,1996,3,"female",455,768,342,21,2,21,1,0,1
1014945,63,28,1950,2,"female",25,40,29,4,9,4,9,0,0
1014957,79,3,1934,4,"female",467,70,36,196,23,88,12,108,11
1014993,19,20,1994,8,"male",479,36,30,0,0,0,0,0,0
1015010,16,15,1997,9,"male",658,571,447,0,30,0,17,0,13
1015035,38,18,1975,2,"male",276,28,14,0,0,0,0,0,0
1015050,57,11,1956,10,"male",405,84,69,28,14,0,8,28,6
1015051,68,11,1945,12,"male",166,47,35,15,5,15,5,0,0
1015058,16,24,1997,10,"female",410,767,356,62,38,12,13,50,25
1015061,26,5,1987,1,"male",407,118,89,12,7,12,6,0,1
1015075,25,3,1988,6,"male",261,25,17,0,0,0,0,0,0
1015115,32,7,1981,3,"male",396,86,47,12,44,11,12,1,32
1015129,100,6,1913,6,"male",405,4,3,0,0,0,0,0,0
1015153,50,3,1963,4,"female",495,117,82,158,133,1,45,157,88
1015183,28,7,1985,4,"male",539,232,130,3,0,3,0,0,0
1015187,108,22,1905,9,"male",160,217,145,879,15,842,6,37,9
1015192,58,8,1955,11,"male",442,9,3,1,7,0,2,1,5
1015194,45,9,1968,2,"female",884,37,21,108,106,108,83,0,23
1015200,54,29,1959,1,"male",21,97,75,1,6,0,5,1,1
1015205,32,17,1981,4,"female",537,200,145,168,160,162,118,6,42
1015307,25,8,1988,8,"male",202,125,106,97,144,97,115,0,29
1015317,18,8,1995,4,"male",99,49,42,14,2,14,1,0,1
1015346,33,6,1980,7,"female",518,120,44,1,5,1,4,0,1
1015347,73,6,1940,9,"male",310,144,60,14,1,0,0,14,1
1015400,113,19,1900,3,"female",1953,163,56,230,105,0,16,230,89
1015410,20,6,1993,7,"male",176,64,42,2,16,1,5,1,11
1015411,66,8,1947,9,"female",695,68,60,233,9,4,4,229,5
1015430,61,5,1952,12,"male",151,16,16,0,0,0,0,0,0
1015432,72,3,1941,6,"female",1598,67,34,38,16,1,7,37,9
1015460,16,11,1997,5,"female",1012,1065,255,785,1124,152,342,633,782
1015468,27,2,1986,6,"male",490,36,11,1,3,1,1,0,2
1015469,27,14,1986,2,"male",726,3,3,257,107,257,103,0,4
1015472,38,13,1975,7,"male",250,22,10,2,2,0,1,2,1
1015496,22,30,1991,1,"female",271,285,44,27,54,27,30,0,24
1015510,19,24,1994,3,"male",495,417,311,0,0,0,0,0,0
1015518,31,11,1982,3,"female",302,78,23,2,16,1,15,1,1
1015527,47,24,1966,12,"female",174,21,15,14,2,14,2,0,0
1015559,27,12,1986,12,"male",417,165,98,8,22,8,20,0,2
1015576,57,4,1956,3,"female",718,66,41,209,52,209,20,0,32
1015592,29,24,1984,3,"male",1066,120,52,28,16,6,3,22,13
1015608,104,11,1909,9,"male",448,170,99,1021,370,1021,251,0,119
1015626,45,21,1968,6,"male",269,65,48,0,1,0,1,0,0
1015691,29,17,1984,5,"male",175,12,10,0,1,0,0,0,1
1015693,17,1,1996,6,"male",538,134,60,0,0,0,0,0,0
1015706,19,25,1994,10,"female",837,1702,922,92,274,13,109,79,165
1015707,32,15,1981,7,"female",278,72,27,3844,227,3821,111,23,116
1015708,16,2,1997,5,"male",174,411,254,889,312,791,263,98,49
1015722,21,14,1992,4,"male",460,92,85,529,36,401,30,128,6
1015766,36,14,1977,1,"female",404,33,19,84,187,84,152,0,35
1015778,65,23,1948,1,"male",515,3,0,0,0,0,0,0,0
1015814,103,8,1910,3,"female",1948,407,221,41,8,13,5,28,3
1015851,30,18,1983,3,"male",135,15,13,1,10,0,1,1,9
1015885,27,16,1986,1,"female",663,175,50,30,65,28,20,2,45
1015907,15,21,1998,5,"female",809,170,86,160,55,159,55,1,0
1015912,19,28,1994,7,"male",28,85,72,12,14,9,9,3,5
1015943,17,21,1996,4,"male",26,163,147,1011,397,839,342,172,55
1015994,16,25,1997,6,"female",560,868,368,478,411,0,296,478,115
1016037,17,8,1996,8,"female",949,2697,700,435,3165,378,2316,57,849
1016047,18,1,1995,1,"female",365,1500,1154,2432,3482,432,1011,2000,2471
1016068,108,1,1905,1,"male",394,301,272,91,44,0,5,91,39
1016103,48,12,1965,12,"female",950,165,134,171,185,44,82,127,103
1016111,108,18,1905,2,"male",983,35,34,0,0,0,0,0,0
1016141,26,4,1987,7,"male",53,33,27,1,0,1,0,0,0
1016178,16,1,1997,1,"male",342,184,152,10,13,10,13,0,0
1016182,60,13,1953,3,"female",1570,90,25,98,196,80,90,18,106
1016187,46,11,1967,8,"male",1909,74,8,6,9,6,6,0,3
1016191,18,14,1995,6,"male",431,175,130,10,17,9,13,1,4
1016226,19,3,1994,10,"male",410,319,256,12,15,11,14,1,1
1016227,108,1,1905,1,"male",919,56,24,68,39,68,10,0,29
1016240,20,18,1993,8,"male",95,158,61,0,9,0,8,0,1
1016243,17,2,1996,3,"female",539,1234,158,287,199,22,60,265,139
1016245,28,1,1985,1,"female",520,238,43,20,56,20,44,0,12
1016258,15,8,1998,7,"female",1091,322,112,311,419,44,316,267,103
1016262,68,9,1945,7,"male",1392,517,443,0,0,0,0,0,0
1016280,77,10,1936,4,"male",20,127,110,17,188,0,139,17,49
1016288,58,13,1955,10,"male",534,32,19,1,0,0,0,1,0
1016340,21,22,1992,1,"male",810,14,10,0,5,0,5,0,0
1016342,28,24,1985,12,"male",232,31,26,0,0,0,0,0,0
1016346,35,25,1978,1,"male",416,30,18,21,13,21,12,0,1
1016360,16,1,1997,10,"male",412,135,79,1,14,1,12,0,2
1016364,43,20,1970,3,"female",1559,329,189,344,559,270,288,74,271
1016375,33,7,1980,10,"female",620,482,369,2,1,1,0,1,1
1016383,21,13,1992,5,"male",450,0,0,0,0,0,0,0,0
1016387,16,3,1997,9,"male",733,184,78,179,3,179,3,0,0
1016389,25,8,1988,8,"male",572,1238,993,65,1688,65,1488,0,200
1016402,23,4,1990,5,"female",129,106,44,83,76,83,39,0,37
1016403,53,22,1960,2,"female",336,99,76,8,24,1,13,7,11
1016409,75,8,1938,10,"female",1750,77,31,129,244,129,180,0,64
1016414,20,1,1993,10,"female",383,958,444,180,70,157,53,23,17
1016432,20,10,1993,9,"male",466,159,74,4,62,3,21,1,41
1016435,16,30,1997,3,"female",101,53,45,143,5,120,1,23,4
1016469,35,13,1978,5,"male",277,75,30,5,2,4,1,1,1
1016474,68,9,1945,9,"male",886,369,241,1446,991,253,525,1193,466
1016548,19,4,1994,4,"male",143,225,204,0,2,0,1,0,1
1016591,34,18,1979,10,"male",198,196,46,13,9,13,9,0,0
1016601,77,21,1936,5,"female",42,21,16,3,31,0,20,3,11
1016669,66,3,1947,12,"male",721,110,69,1076,78,40,31,1036,47
1016675,18,25,1995,3,"male",314,40,18,4,13,1,12,3,1
1016679,36,22,1977,4,"female",313,53,46,5,2,2,2,3,0
1016694,64,19,1949,3,"male",692,164,12,26,4,0,0,26,4
1016699,83,7,1930,9,"male",554,24,17,0,0,0,0,0,0
1016705,48,9,1965,12,"male",191,4,1,0,0,0,0,0,0
1016733,20,1,1993,1,"male",306,328,237,686,343,527,202,159,141
1016755,18,27,1995,4,"male",262,257,197,331,14,330,14,1,0
1016776,25,13,1988,12,"male",354,185,104,20,17,2,16,18,1
1016781,39,3,1974,6,"male",867,261,74,1,0,1,0,0,0
1016787,22,29,1991,11,"male",359,210,194,0,6,0,6,0,0
1016837,41,7,1972,2,"male",330,28,24,29,22,29,4,0,18
1016844,69,15,1944,3,"male",684,47,21,1,1,1,1,0,0
1016845,52,21,1961,5,"male",797,81,66,317,111,317,45,0,66
1016849,15,3,1998,6,"male",206,81,47,0,5,0,5,0,0
1016890,40,17,1973,12,"female",69,24,23,297,1,297,1,0,0
1016917,34,18,1979,7,"female",297,107,55,317,211,317,116,0,95
1016923,13,4,2000,3,"male",39,0,0,7,6,0,4,7,2
1016949,24,19,1989,4,"male",637,33,16,6,5,0,2,6,3
1016950,26,6,1987,3,"female",177,46,40,38,15,36,11,2,4
1016957,16,10,1997,10,"female",138,128,95,150,24,1,1,149,23
1016964,70,2,1943,3,"female",278,12,5,0,0,0,0,0,0
1016980,24,21,1989,9,"female",1493,229,79,15,1,5,0,10,1
1016983,33,1,1980,1,"female",388,24,12,10,9,10,1,0,8
1016999,61,11,1952,1,"female",430,61,40,3,13,0,5,3,8
1017018,41,18,1972,4,"male",754,172,120,20,0,20,0,0,0
1017057,37,9,1976,2,"male",102,220,184,0,0,0,0,0,0
1017067,105,10,1908,5,"male",234,691,601,137,71,137,49,0,22
1017079,19,22,1994,11,"male",122,199,176,0,1,0,1,0,0
1017091,55,7,1958,4,"female",542,122,49,26,20,0,3,26,17
1017105,45,10,1968,10,"male",256,0,0,0,0,0,0,0,0
1017110,17,14,1996,5,"female",266,35,7,139,179,139,129,0,50
1017119,37,6,1976,8,"male",571,151,113,2,0,2,0,0,0
1017159,25,27,1988,8,"male",235,221,148,26,66,26,39,0,27
1017178,19,21,1994,7,"male",160,14,7,0,1,0,1,0,0
1017190,28,7,1985,5,"male",1463,80,35,3,3,0,1,3,2
1017202,83,11,1930,11,"male",679,302,159,617,374,122,139,495,235
1017213,22,22,1991,1,"male",659,13,4,0,1,0,1,0,0
1017222,17,19,1996,7,"male",151,99,65,1,0,1,0,0,0
1017235,66,5,1947,8,"female",258,31,19,132,14,132,13,0,1
1017262,99,30,1914,9,"male",1470,311,157,0,11,0,4,0,7
1017269,19,17,1994,3,"male",191,80,63,179,74,179,39,0,35
1017272,28,5,1985,12,"female",112,14,6,4,0,4,0,0,0
1017281,19,2,1994,11,"female",583,87,62,64,13,64,7,0,6
1017299,23,21,1990,4,"male",95,53,41,9,25,9,14,0,11
1017325,65,7,1948,1,"female",1450,87,10,24,126,24,106,0,20
1017337,73,2,1940,4,"female",1852,489,248,110,332,0,182,110,150
1017343,50,10,1963,9,"female",1395,69,14,13,9,13,7,0,2
1017345,24,5,1989,1,"male",1059,126,66,48,38,48,25,0,13
1017349,16,25,1997,10,"male",378,225,115,47,93,0,63,47,30
1017360,21,10,1992,8,"male",135,43,27,1,0,1,0,0,0
1017369,62,6,1951,8,"female",88,3,3,0,0,0,0,0,0
1017370,33,5,1980,4,"male",936,74,62,98,67,98,43,0,24
1017372,21,12,1992,6,"male",525,195,128,1,0,1,0,0,0
1017390,49,7,1964,5,"male",484,47,23,7,22,0,8,7,14
1017399,16,22,1997,9,"male",207,184,28,196,85,134,56,62,29
1017440,26,16,1987,10,"male",156,70,51,0,0,0,0,0,0
1017489,25,23,1988,3,"male",594,451,358,15,3,15,3,0,0
1017507,68,30,1945,5,"male",1797,35,17,1,0,0,0,1,0
1017519,63,19,1950,5,"male",416,23,15,0,0,0,0,0,0
1017525,24,17,1989,8,"female",263,64,38,10,2,10,1,0,1
1017547,25,15,1988,9,"male",1019,43,4,0,1,0,1,0,0
1017572,15,10,1998,1,"female",394,110,90,0,0,0,0,0,0
1017577,71,14,1942,5,"female",1957,94,50,237,92,84,59,153,33
1017579,21,9,1992,12,"male",351,31,19,0,0,0,0,0,0
1017612,23,1,1990,1,"male",1512,66,44,22,0,0,0,22,0
1017613,31,14,1982,7,"male",75,41,38,3,8,3,8,0,0
1017625,108,28,1905,4,"female",1192,176,118,32,27,32,20,0,7
1017638,63,14,1950,6,"female",654,29,22,0,1,0,0,0,1
1017667,31,21,1982,2,"male",23,0,0,0,0,0,0,0,0
1017675,17,19,1996,7,"female",188,208,48,837,1123,673,408,164,715
1017699,23,18,1990,6,"female",378,143,122,8,5,8,5,0,0
1017725,26,10,1987,1,"male",341,51,45,5,6,5,2,0,4
1017737,26,8,1987,1,"male",581,237,196,40,19,0,18,40,1
1017756,108,21,1905,3,"male",1520,299,24,36,65,0,24,36,41
1017785,51,4,1962,1,"male",875,456,282,2550,710,1134,337,1416,373
1017813,16,11,1997,12,"male",302,109,69,0,0,0,0,0,0
1017823,20,18,1993,10,"female",328,57,40,13,29,9,9,4,20
1017826,20,12,1993,10,"female",237,76,56,17,6,17,5,0,1
1017838,53,21,1960,7,"female",1712,294,177,305,438,305,300,0,138
1017841,20,12,1993,4,"male",190,447,409,2,1,1,1,1,0
1017849,30,6,1983,9,"male",283,45,39,20,30,20,18,0,12
1017862,34,3,1979,5,"female",71,23,18,0,7,0,7,0,0
1017865,23,30,1990,11,"male",528,34,30,1,1,1,0,0,1
1017873,61,7,1952,9,"female",390,24,14,23,21,23,3,0,18
1017887,103,20,1910,5,"female",125,76,18,1,11,1,6,0,5
1017890,34,3,1979,3,"female",410,216,149,89,84,88,47,1,37
1017901,53,8,1960,5,"male",1473,61,9,236,30,236,26,0,4
1017904,23,29,1990,6,"female",165,276,59,120,119,111,52,9,67
1017910,23,14,1990,3,"female",204,19,16,3,5,3,5,0,0
1017922,17,27,1996,5,"female",629,188,86,28,9,17,4,11,5
1017932,18,5,1995,7,"female",473,177,111,2,5,1,5,1,0
1017948,37,4,1976,5,"female",532,20,13,0,3,0,3,0,0
1017977,65,30,1948,12,"male",1600,75,31,175,80,58,51,117,29
1017984,61,21,1952,9,"male",366,7,6,21,12,0,1,21,11
1018010,23,23,1990,11,"male",197,6,3,0,0,0,0,0,0
1018016,24,2,1989,5,"female",403,4,3,0,0,0,0,0,0
1018042,14,26,1999,1,"male",313,29,19,0,0,0,0,0,0
1018055,30,27,1983,12,"female",697,61,30,68,49,68,40,0,9
1018066,55,3,1958,4,"female",1534,74,27,2,2,0,0,2,2
1018071,21,11,1992,10,"male",89,64,61,5,4,5,3,0,1
1018074,22,1,1991,1,"male",1600,346,169,1,4,1,4,0,0
1018106,18,10,1995,9,"female",481,2066,550,124,313,124,263,0,50
1018107,40,16,1973,8,"male",541,86,66,6,2,0,0,6,2
1018111,17,29,1996,1,"male",742,199,157,17,5,17,4,0,1
1018113,18,28,1995,2,"female",892,133,88,44,49,44,23,0,26
1018119,21,14,1992,2,"male",765,602,403,3,2,3,0,0,2
1018143,30,5,1983,7,"female",412,71,45,724,130,724,122,0,8
1018149,15,1,1998,1,"male",22,670,611,137,98,9,47,128,51
1018205,38,24,1975,10,"male",577,63,19,70,110,70,78,0,32
1018209,18,23,1995,7,"male",452,244,165,283,126,283,120,0,6
1018211,78,21,1935,9,"male",345,10,7,5,4,0,4,5,0
1018226,108,18,1905,11,"female",408,459,178,111,128,111,82,0,46
1018228,44,17,1969,8,"male",399,51,37,18,3,18,0,0,3
1018269,28,31,1985,12,"male",356,114,63,59,1,29,0,30,1
1018306,67,13,1946,3,"male",1296,56,11,18,8,4,4,14,4
1018318,40,25,1973,9,"female",356,107,71,49,9,49,8,0,1
1018325,50,2,1963,10,"male",631,29,24,0,0,0,0,0,0
1018327,26,23,1987,11,"male",382,30,25,0,3,0,0,0,3
1018330,18,11,1995,3,"male",141,177,142,7,7,7,7,0,0
1018350,16,25,1997,2,"female",1583,347,142,74,57,74,24,0,33
1018376,16,24,1997,2,"male",481,91,36,5,0,4,0,1,0
1018377,21,8,1992,10,"female",842,752,421,1679,1252,898,492,781,760
1018397,73,7,1940,6,"male",1954,38,12,0,11,0,3,0,8
1018432,38,10,1975,4,"male",115,23,10,0,1,0,1,0,0
1018444,46,10,1967,10,"male",572,137,109,904,5,904,5,0,0
1018454,23,3,1990,1,"male",193,107,80,5,8,5,7,0,1
1018501,37,1,1976,2,"male",316,2,2,3,0,3,0,0,0
1018530,25,1,1988,1,"male",265,9,5,2,0,2,0,0,0
1018545,106,24,1907,4,"male",1010,144,79,24,14,22,11,2,3
1018553,49,6,1964,7,"female",503,144,107,321,71,307,48,14,23
1018557,102,1,1911,1,"male",1845,155,36,7,12,0,0,7,12
1018607,26,22,1987,11,"male",314,71,23,0,0,0,0,0,0
1018648,44,30,1969,3,"male",120,45,31,24,75,24,64,0,11
1018662,15,13,1998,3,"male",155,287,97,175,288,73,183,102,105
1018719,22,16,1991,12,"male",735,535,180,346,768,304,488,42,280
1018734,35,3,1978,4,"female",185,0,0,0,0,0,0,0,0
1018771,18,23,1995,1,"male",208,233,178,0,0,0,0,0,0
1018774,28,27,1985,10,"male",451,149,18,1,5,1,5,0,0
1018786,71,8,1942,3,"female",1677,114,36,773,147,516,75,257,72
1018796,103,11,1910,9,"male",1862,1045,765,112,172,55,28,57,144
1018797,41,11,1972,1,"male",25,0,0,0,0,0,0,0,0
1018834,23,6,1990,6,"male",228,288,165,0,4,0,4,0,0
1018870,55,22,1958,5,"male",256,42,32,6,3,0,0,6,3
1018897,20,1,1993,3,"female",239,39,24,317,197,317,159,0,38
1018932,22,5,1991,10,"female",400,471,386,383,286,322,130,61,156
1018940,26,1,1987,1,"male",570,10,3,2,1,2,1,0,0
1018960,24,29,1989,8,"male",548,320,286,15,24,15,21,0,3
1018964,108,20,1905,5,"female",1435,308,166,432,326,0,65,432,261
1018970,16,1,1997,1,"male",108,0,0,0,0,0,0,0,0
1018977,20,3,1993,2,"male",296,211,160,196,79,128,42,68,37
1019013,71,14,1942,8,"male",1360,49,15,97,69,97,42,0,27
1019014,23,5,1990,9,"male",573,4,4,2,9,2,5,0,4
1019024,22,14,1991,1,"female",1387,521,149,867,869,576,659,291,210
1019027,57,20,1956,3,"female",59,85,77,991,48,551,29,440,19
1019064,22,11,1991,10,"female",431,224,73,4,14,4,12,0,2
1019085,33,17,1980,3,"female",367,163,76,1,50,1,50,0,0
1019135,52,18,1961,6,"male",390,124,26,71,53,71,45,0,8
1019136,56,6,1957,5,"male",1230,116,57,0,0,0,0,0,0
1019140,57,25,1956,10,"male",238,85,50,2,1,1,0,1,1
1019155,54,24,1959,1,"male",1149,142,76,13,24,0,15,13,9
1019165,40,23,1973,3,"female",585,135,38,11,79,0,33,11,46
1019180,22,4,1991,2,"female",25,47,8,4,10,4,7,0,3
1019190,55,20,1958,2,"male",477,92,79,60,67,60,31,0,36
1019216,87,1,1926,5,"male",63,286,163,14,35,13,20,1,15
1019249,34,26,1979,12,"male",953,126,44,3,0,3,0,0,0
1019280,34,5,1979,5,"male",224,127,113,20,3,12,0,8,3
1019289,53,18,1960,2,"male",13,102,98,15,12,3,9,12,3
1019295,15,1,1998,4,"male",76,107,66,3,4,2,2,1,2
1019310,43,24,1970,7,"male",568,81,55,32,18,1,10,31,8
1019337,21,5,1992,9,"female",174,368,119,18,6,7,2,11,4
1019350,25,3,1988,3,"female",385,94,51,109,64,31,25,78,39
1019379,15,15,1998,9,"male",224,131,110,2,5,1,1,1,4
1019382,74,23,1939,3,"male",869,20,10,9,1,9,1,0,0
1019394,35,4,1978,1,"male",266,124,100,109,9,109,7,0,2
1019402,34,13,1979,2,"male",39,0,0,0,0,0,0,0,0
1019414,20,7,1993,5,"male",102,64,52,8,11,8,9,0,2
1019424,24,19,1989,10,"male",397,69,39,1,0,0,0,1,0
1019429,32,25,1981,7,"male",174,31,21,23,22,23,19,0,3
1019431,43,3,1970,4,"male",481,51,26,172,148,171,140,1,8
1019436,33,6,1980,9,"male",923,60,27,58,4,58,1,0,3
1019438,20,5,1993,3,"male",446,341,68,96,149,33,36,63,113
1019455,55,7,1958,7,"female",462,34,7,1,18,0,10,1,8
1019461,25,8,1988,10,"male",18,13,13,4,0,4,0,0,0
1019467,20,17,1993,11,"female",438,437,333,423,426,423,280,0,146
1019484,35,14,1978,8,"male",819,10,7,75,288,75,273,0,15
1019492,35,17,1978,12,"male",399,3,2,0,0,0,0,0,0
1019502,20,25,1993,7,"male",752,68,27,6,3,5,0,1,3
1019505,31,1,1982,7,"male",152,18,12,4,0,4,0,0,0
1019531,25,1,1988,1,"male",38,27,27,4,0,4,0,0,0
1019534,28,1,1985,3,"male",237,67,54,75,55,75,35,0,20
1019546,69,29,1944,11,"male",258,28,25,1,2,1,0,0,2
1019548,52,12,1961,3,"female",26,10,7,18,36,18,24,0,12
1019552,42,13,1971,10,"female",624,57,11,25,34,25,28,0,6
1019569,30,9,1983,1,"male",498,36,25,0,0,0,0,0,0
1019589,22,5,1991,5,"male",7,2,2,0,0,0,0,0,0
1019596,26,1,1987,1,"male",230,31,15,1,0,1,0,0,0
1019624,33,23,1980,6,"female",281,0,0,0,0,0,0,0,0
1019642,37,17,1976,1,"female",560,574,388,1606,2107,260,1222,1346,885
1019664,18,30,1995,11,"female",508,327,81,8,83,8,66,0,17
1019699,29,8,1984,12,"female",583,115,83,21,11,21,9,0,2
1019712,47,7,1966,11,"female",464,8,6,1,0,1,0,0,0
1019726,53,27,1960,4,"male",1009,793,419,76,14,74,13,2,1
1019731,36,25,1977,4,"male",747,199,138,38,1,38,1,0,0
1019752,113,26,1900,4,"female",1230,46,26,26,6,0,3,26,3
1019795,36,1,1977,1,"female",308,8,5,33,6,33,5,0,1
1019836,103,16,1910,1,"male",476,892,630,86,26,86,25,0,1
1019859,18,24,1995,11,"female",334,45,28,0,2,0,1,0,1
1019892,29,1,1984,2,"male",686,803,332,94,14,78,6,16,8
1019900,108,24,1905,8,"female",912,668,88,22,8,22,8,0,0
1019906,18,9,1995,3,"female",208,39,27,0,0,0,0,0,0
1019923,25,28,1988,9,"female",240,38,34,0,0,0,0,0,0
1019925,31,15,1982,11,"male",473,177,135,83,8,83,7,0,1
1019927,16,12,1997,9,"male",423,268,211,29,7,29,7,0,0
1019960,51,9,1962,1,"female",355,166,131,220,652,220,517,0,135
1019994,21,23,1992,11,"male",218,210,166,12,8,12,7,0,1
1019997,52,1,1961,5,"female",180,2,2,2,0,2,0,0,0
1020034,27,17,1986,3,"female",1105,814,375,76,710,35,666,41,44
1020038,57,24,1956,2,"female",382,2,2,0,0,0,0,0,0
1020076,21,9,1992,1,"male",629,105,67,0,0,0,0,0,0
1020084,37,12,1976,4,"male",921,68,37,1,0,1,0,0,0
1020117,41,11,1972,7,"male",347,4,4,0,0,0,0,0,0
1020125,37,9,1976,7,"male",932,161,80,8,22,8,10,0,12
1020127,14,29,1999,12,"male",306,151,98,1,0,0,0,1,0
1020133,19,2,1994,3,"male",529,127,73,11,50,11,49,0,1
1020156,15,21,1998,6,"female",419,365,92,7,32,1,15,6,17
1020165,17,26,1996,8,"female",549,185,121,0,4,0,3,0,1
1020203,39,3,1974,6,"male",51,34,34,6,0,6,0,0,0
1020211,46,11,1967,6,"male",227,91,34,9,3,9,1,0,2
1020233,52,11,1961,11,"female",514,160,87,62,28,62,22,0,6
1020251,22,12,1991,3,"male",23,71,60,32,16,22,10,10,6
1020258,20,13,1993,3,"female",426,29,10,1,0,1,0,0,0
1020260,62,19,1951,8,"female",1579,129,29,12,14,12,12,0,2
1020287,41,16,1972,6,"male",685,44,16,2,1,2,1,0,0
1020296,61,10,1952,12,"female",559,39,10,53,25,53,24,0,1
1020323,18,14,1995,7,"male",416,52,28,6,1,6,0,0,1
1020348,33,22,1980,4,"female",585,109,63,24,46,24,32,0,14
1020353,44,1,1969,2,"male",874,11,8,0,1,0,1,0,0
1020372,25,14,1988,9,"male",330,128,77,19,26,19,19,0,7
1020389,24,15,1989,8,"female",139,25,23,0,0,0,0,0,0
1020393,38,29,1975,4,"male",393,399,285,2,32,2,22,0,10
1020418,15,5,1998,8,"male",365,145,43,0,16,0,6,0,10
1020429,29,28,1984,3,"female",457,63,33,56,3,56,2,0,1
1020456,54,18,1959,6,"female",117,87,71,161,662,149,553,12,109
1020457,19,10,1994,9,"female",1684,316,129,85,73,61,38,24,35
1020465,29,30,1984,8,"male",487,17,8,0,1,0,0,0,1
1020484,45,9,1968,5,"female",411,54,33,98,53,62,40,36,13
1020498,22,27,1991,10,"male",143,17,13,0,0,0,0,0,0
1020542,64,11,1949,6,"female",1794,83,55,763,155,102,44,661,111
1020556,35,12,1978,2,"female",1046,124,41,519,589,511,460,8,129
1020616,57,17,1956,9,"female",2114,100,59,21,170,4,135,17,35
1020617,14,23,1999,4,"male",133,40,26,18,0,18,0,0,0
1020619,26,28,1987,10,"female",594,16,14,80,52,2,17,78,35
1020637,58,5,1955,6,"female",2225,15,2,0,0,0,0,0,0
1020643,54,4,1959,12,"female",592,26,24,1,5,0,4,1,1
1020654,18,11,1995,8,"female",1195,384,243,318,198,310,104,8,94
1020698,47,22,1966,5,"female",177,8,7,0,0,0,0,0,0
1020737,88,1,1925,1,"female",1822,172,99,22,5,5,3,17,2
1020749,106,25,1907,7,"male",70,39,38,29,1,25,1,4,0
1020795,37,19,1976,1,"male",1136,97,86,0,10,0,8,0,2
1020815,78,25,1935,5,"female",1596,184,167,1519,265,0,62,1519,203
1020837,28,17,1985,10,"male",964,539,312,400,275,259,132,141,143
1020864,16,5,1997,8,"female",684,850,466,445,406,366,116,79,290
1020902,20,10,1993,6,"male",681,125,65,2,6,2,6,0,0
1020917,16,17,1997,4,"male",401,9,5,1,0,1,0,0,0
1020925,46,19,1967,1,"male",442,47,38,0,1,0,0,0,1
1020945,54,8,1959,12,"male",959,141,89,0,0,0,0,0,0
1020971,40,5,1973,11,"male",592,24,5,982,118,848,100,134,18
1020981,54,21,1959,2,"female",1403,47,14,1,5,1,2,0,3
1020988,18,19,1995,2,"male",300,5,2,0,0,0,0,0,0
1020994,30,1,1983,1,"male",29,37,34,66,36,66,24,0,12
1021027,17,5,1996,10,"female",73,775,403,6976,2736,0,683,6976,2053
1021064,21,8,1992,12,"female",256,167,133,274,114,274,106,0,8
1021075,20,22,1993,4,"female",643,473,152,33,2,33,2,0,0
1021078,16,28,1997,7,"female",487,605,394,168,84,168,56,0,28
1021097,23,15,1990,10,"male",107,123,82,4,2,4,2,0,0
1021113,14,21,1999,1,"male",500,90,35,0,1,0,1,0,0
1021117,18,14,1995,6,"male",669,77,64,1,0,1,0,0,0
1021140,25,1,1988,1,"male",171,98,96,19,0,19,0,0,0
1021146,36,7,1977,7,"male",129,0,0,0,0,0,0,0,0
1021153,24,29,1989,10,"male",707,119,83,2,7,2,7,0,0
1021178,19,19,1994,4,"female",1653,39,25,177,432,148,130,29,302
1021190,30,20,1983,8,"male",435,218,171,0,21,0,21,0,0
1021196,73,7,1940,1,"female",1209,23,12,26,3,26,2,0,1
1021234,16,14,1997,3,"male",38,18,12,0,0,0,0,0,0
1021248,14,1,1999,4,"female",15,4,3,0,0,0,0,0,0
1021249,26,26,1987,2,"male",1235,372,266,113,78,113,71,0,7
1021283,19,17,1994,2,"female",91,67,38,0,0,0,0,0,0
1021287,21,19,1992,2,"male",238,16,13,0,4,0,4,0,0
1021321,19,17,1994,12,"male",390,248,168,1,25,0,11,1,14
1021334,32,30,1981,1,"female",491,129,58,19,25,19,16,0,9
1021343,18,25,1995,7,"female",492,55,30,168,50,168,37,0,13
1021360,35,12,1978,6,"male",477,202,111,0,0,0,0,0,0
1021377,43,25,1970,6,"female",403,37,13,71,8,53,8,18,0
1021388,27,21,1986,2,"male",418,1,1,0,0,0,0,0,0
1021397,23,6,1990,2,"female",381,109,78,0,10,0,10,0,0
1021402,18,9,1995,12,"male",892,230,127,422,34,31,3,391,31
1021423,56,2,1957,11,"male",937,1060,888,1,1,0,0,1,1
1021462,17,12,1996,8,"male",430,610,528,12,61,4,38,8,23
1021509,20,14,1993,7,"male",352,5,2,0,0,0,0,0,0
1021534,31,7,1982,7,"male",23,2,2,21,23,20,21,1,2
1021556,26,20,1987,6,"female",514,1,1,3,2,1,2,2,0
1021577,41,6,1972,10,"male",385,2,1,0,0,0,0,0,0
1021579,25,3,1988,10,"female",38,1,1,24,9,24,9,0,0
1021620,17,9,1996,4,"male",224,294,235,1,3,1,3,0,0
1021640,18,3,1995,10,"male",1390,540,180,0,1,0,0,0,1
1021643,72,3,1941,8,"male",1083,9,5,0,0,0,0,0,0
1021649,16,10,1997,11,"female",481,1769,947,359,1628,57,738,302,890
1021700,34,5,1979,12,"male",284,83,40,3,20,2,6,1,14
1021706,49,26,1964,9,"female",321,39,23,0,0,0,0,0,0
1021784,23,3,1990,7,"female",435,177,85,17,22,17,11,0,11
1021787,51,27,1962,10,"female",126,396,279,819,634,76,293,743,341
1021859,63,12,1950,6,"male",302,5,5,0,0,0,0,0,0
1021904,14,3,1999,12,"male",77,284,274,73,597,69,506,4,91
1021921,35,19,1978,9,"male",981,81,53,15,2,15,2,0,0
1021933,53,31,1960,8,"male",1032,195,119,13,16,13,13,0,3
1021939,27,26,1986,1,"female",866,173,83,42,11,8,1,34,10
1021946,63,27,1950,6,"female",457,13,11,27,17,27,16,0,1
1021982,76,3,1937,5,"female",1113,116,47,0,2,0,0,0,2
1021996,25,1,1988,1,"male",96,0,0,0,0,0,0,0,0
1022010,46,6,1967,9,"male",406,52,35,5,0,0,0,5,0
1022017,48,8,1965,11,"female",586,87,45,434,289,330,233,104,56
1022022,18,25,1995,12,"male",297,201,171,0,1,0,0,0,1
1022057,17,7,1996,3,"female",519,2238,1689,5591,15623,2753,11819,2838,3804
1022059,43,29,1970,9,"female",445,195,18,20,16,19,8,1,8
1022060,113,26,1900,10,"male",1830,252,100,9,8,0,7,9,1
1022065,22,1,1991,1,"male",299,250,228,555,236,555,198,0,38
1022066,23,8,1990,6,"male",506,157,93,2,5,2,0,0,5
1022077,44,20,1969,5,"male",337,9,7,0,6,0,0,0,6
1022079,23,4,1990,1,"female",24,41,31,52,2,52,2,0,0
1022086,43,31,1970,5,"male",435,32,20,27,10,4,0,23,10
1022105,19,17,1994,6,"female",305,577,177,4,2,4,1,0,1
1022110,86,21,1927,10,"male",902,602,415,92,46,19,26,73,20
1022117,23,5,1990,9,"male",315,123,85,22,2,0,1,22,1
1022130,33,28,1980,7,"male",515,29,21,3,5,3,2,0,3
1022131,25,17,1988,2,"male",1219,2,1,0,0,0,0,0,0
1022140,21,11,1992,12,"male",325,249,206,2,0,1,0,1,0
1022156,20,18,1993,8,"male",489,171,155,0,3,0,2,0,1
1022166,17,12,1996,1,"female",267,64,50,54,103,54,102,0,1
1022182,20,22,1993,8,"male",651,1633,667,293,465,277,239,16,226
1022194,60,9,1953,10,"male",1758,63,23,0,1,0,0,0,1
1022204,29,16,1984,12,"male",394,27,21,0,0,0,0,0,0
1022208,28,10,1985,10,"male",218,1,1,0,0,0,0,0,0
1022213,47,9,1966,4,"male",852,16,10,0,0,0,0,0,0
1022220,22,9,1991,5,"female",268,0,0,1,1,1,1,0,0
1022235,33,4,1980,4,"female",52,207,18,189,36,189,34,0,2
1022263,18,26,1995,2,"male",233,50,45,19,1,19,0,0,1
1022270,48,29,1965,3,"male",837,3,3,1,3,1,3,0,0
1022274,17,17,1996,8,"male",408,234,197,1,13,1,10,0,3
1022314,33,20,1980,2,"male",53,0,0,0,0,0,0,0,0
1022329,25,1,1988,1,"male",292,51,34,20,10,20,10,0,0
1022331,103,1,1910,2,"male",1563,429,41,4,29,4,18,0,11
1022361,23,1,1990,1,"male",391,56,27,0,0,0,0,0,0
1022407,30,14,1983,10,"female",542,55,28,1,2,0,2,1,0
1022444,41,8,1972,7,"female",318,50,32,935,513,935,381,0,132
1022475,25,8,1988,7,"female",36,1239,37,243,815,243,716,0,99
1022476,16,15,1997,7,"female",849,276,56,5,1,4,0,1,1
1022505,46,11,1967,5,"male",1095,51,23,0,0,0,0,0,0
1022514,53,10,1960,4,"male",1394,178,64,291,97,291,34,0,63
1022541,40,7,1973,2,"male",566,57,45,208,36,0,1,208,35
1022555,25,14,1988,1,"female",383,111,33,285,32,285,28,0,4
1022587,21,26,1992,11,"male",843,376,333,14,13,2,7,12,6
1022610,38,9,1975,5,"male",672,126,68,112,69,100,37,12,32
1022655,17,3,1996,3,"male",620,51,34,9,0,9,0,0,0
1022658,32,21,1981,10,"male",426,32,13,3,3,3,3,0,0
1022685,23,28,1990,11,"male",626,126,95,0,21,0,9,0,12
1022691,20,22,1993,7,"male",270,14,6,2,0,0,0,2,0
1022695,18,5,1995,12,"male",42,16,12,0,0,0,0,0,0
1022740,17,11,1996,3,"male",90,23,14,3,0,3,0,0,0
1022759,28,3,1985,3,"male",27,0,0,0,0,0,0,0,0
1022771,101,4,1912,5,"female",1870,64,35,12,36,11,26,1,10
1022783,41,14,1972,7,"male",193,8,4,3,0,3,0,0,0
1022799,49,12,1964,12,"male",121,28,13,68,59,68,53,0,6
1022800,15,28,1998,5,"male",149,73,59,17,11,0,1,17,10
1022825,52,24,1961,12,"female",350,343,87,297,614,297,232,0,382
1022836,21,17,1992,6,"male",295,151,68,1,3,1,0,0,3
1022845,41,16,1972,4,"male",164,40,39,8,3,0,2,8,1
1022875,18,20,1995,6,"female",560,107,34,1,13,1,4,0,9
1022892,72,2,1941,8,"female",805,43,30,11,53,0,32,11,21
1022914,76,26,1937,11,"male",549,39,27,1,2,0,2,1,0
1022930,57,20,1956,12,"male",1510,41,17,2,9,0,7,2,2
1022985,34,12,1979,1,"male",505,131,60,69,145,69,35,0,110
1022990,16,17,1997,9,"male",1169,223,112,18,0,2,0,16,0
1022992,52,12,1961,5,"female",519,20,12,12,1,12,1,0,0
1023011,19,15,1994,6,"male",685,77,31,10,2,10,2,0,0
1023012,27,17,1986,2,"female",206,22,10,22,3,22,3,0,0
1023023,13,9,2000,9,"male",45,10,5,0,0,0,0,0,0
1023064,50,6,1963,8,"male",967,574,103,133,502,26,123,107,379
1023085,13,3,2000,3,"male",21,29,26,7,19,6,11,1,8
1023086,51,10,1962,7,"female",1707,192,149,382,306,287,48,95,258
1023100,31,21,1982,2,"male",267,20,6,0,0,0,0,0,0
1023108,16,4,1997,11,"male",727,415,336,20,2,8,0,12,2
1023132,52,18,1961,5,"male",619,103,91,166,34,166,23,0,11
1023165,51,30,1962,4,"male",1283,3,3,0,0,0,0,0,0
1023169,37,10,1976,12,"male",1323,18,13,27,130,24,31,3,99
1023194,19,2,1994,4,"male",745,245,197,13,2,3,0,10,2
1023197,33,8,1980,6,"female",258,77,45,47,220,47,163,0,57
1023216,34,23,1979,11,"female",567,969,598,648,595,345,276,303,319
1023232,41,4,1972,1,"female",1278,130,88,24,11,24,5,0,6
1023238,61,16,1952,7,"female",246,7,5,0,0,0,0,0,0
1023244,22,7,1991,8,"female",706,146,79,99,141,99,79,0,62
1023266,54,16,1959,2,"female",1084,188,139,944,635,944,552,0,83
1023272,32,25,1981,8,"female",113,11,7,56,76,26,26,30,50
1023302,16,24,1997,3,"male",184,90,72,167,3,0,0,167,3
1023329,61,4,1952,1,"female",246,16,11,5,26,5,14,0,12
1023344,43,10,1970,7,"male",401,51,17,201,18,201,15,0,3
1023360,34,21,1979,5,"male",224,2,1,0,3,0,2,0,1
1023366,76,10,1937,6,"female",425,87,62,17,35,0,21,17,14
1023385,21,1,1992,9,"male",419,230,186,0,2,0,2,0,0
1023403,19,4,1994,1,"male",267,124,65,59,16,43,14,16,2
1023446,25,1,1988,1,"male",176,2,2,3,0,3,0,0,0
1023463,35,12,1978,8,"female",599,66,29,11,7,11,7,0,0
1023492,18,14,1995,6,"female",603,90,29,20,23,20,19,0,4
1023502,37,31,1976,7,"male",491,79,36,23,63,23,50,0,13
1023506,49,29,1964,9,"female",660,3,3,0,1,0,1,0,0
1023513,18,22,1995,8,"male",322,56,45,2,0,2,0,0,0
1023558,33,13,1980,11,"male",132,76,72,0,13,0,6,0,7
1023580,63,27,1950,6,"male",861,82,52,1,1,1,1,0,0
1023643,30,14,1983,6,"male",446,85,72,4,3,0,1,4,2
1023667,99,14,1914,2,"male",1163,585,368,116,103,116,84,0,19
1023673,50,6,1963,3,"female",373,53,19,156,66,156,65,0,1
1023693,29,28,1984,2,"male",579,97,60,97,0,97,0,0,0
1023709,19,4,1994,11,"female",567,1350,569,17,178,17,148,0,30
1023718,17,25,1996,9,"male",784,3,3,0,0,0,0,0,0
1023724,36,4,1977,10,"female",283,16,8,0,0,0,0,0,0
1023731,108,22,1905,7,"male",1771,350,205,12,165,12,96,0,69
1023759,18,22,1995,7,"male",182,139,110,7,30,7,30,0,0
1023761,38,12,1975,5,"male",241,0,0,0,0,0,0,0,0
1023799,18,30,1995,9,"male",120,262,249,2,0,2,0,0,0
1023817,40,24,1973,6,"male",404,112,62,0,0,0,0,0,0
1023818,24,7,1989,3,"male",496,66,13,31,11,31,10,0,1
1023826,27,27,1986,2,"female",629,100,60,77,37,67,17,10,20
1023855,18,20,1995,2,"male",323,65,29,33,1,33,1,0,0
1023861,61,28,1952,2,"female",496,33,24,0,0,0,0,0,0
1023896,80,28,1933,9,"female",532,15,8,150,5,0,1,150,4
1023905,25,1,1988,1,"male",250,30,24,0,6,0,1,0,5
1023914,22,14,1991,8,"female",233,80,29,7,16,7,16,0,0
1023945,53,29,1960,10,"male",172,32,15,1,4,1,2,0,2
1023959,56,22,1957,11,"male",466,11,6,2,3,2,3,0,0
1023992,24,18,1989,2,"female",188,117,70,252,104,227,62,25,42
1024010,23,16,1990,1,"female",138,185,153,915,866,766,518,149,348
1024022,53,28,1960,1,"female",530,120,62,62,301,62,190,0,111
1024030,21,5,1992,9,"male",1186,151,86,25,42,25,33,0,9
1024059,49,1,1964,1,"male",613,19,14,34,16,30,12,4,4
1024060,23,19,1990,12,"male",60,7,7,0,0,0,0,0,0
1024080,22,6,1991,5,"male",474,388,248,3,3,2,2,1,1
1024088,103,3,1910,11,"male",296,271,244,0,1,0,1,0,0
1024093,67,28,1946,5,"male",1885,33,6,0,0,0,0,0,0
1024095,65,8,1948,5,"male",1822,36,24,5,1,1,0,4,1
1024112,22,29,1991,5,"female",667,1842,619,730,1428,563,1081,167,347
1024133,108,1,1905,1,"male",99,2,2,6,2,0,0,6,2
1024136,20,15,1993,2,"male",332,158,106,111,205,111,100,0,105
1024186,18,2,1995,8,"male",558,105,62,9,0,9,0,0,0
1024214,32,16,1981,3,"male",703,548,378,248,325,248,295,0,30
1024264,28,1,1985,1,"male",146,10,9,12,0,4,0,8,0
1024275,23,3,1990,9,"male",944,172,70,448,25,378,14,70,11
1024282,27,3,1986,2,"female",214,366,272,189,250,189,208,0,42
1024306,25,16,1988,4,"male",468,129,106,3,53,3,26,0,27
1024341,19,26,1994,7,"male",482,158,80,0,0,0,0,0,0
1024347,28,29,1985,10,"male",1285,635,465,226,138,226,119,0,19
1024353,34,21,1979,7,"male",1322,204,104,53,12,53,7,0,5
1024390,30,1,1983,6,"male",254,111,73,297,23,297,23,0,0
1024418,25,27,1988,4,"female",190,27,13,69,4,69,4,0,0
1024476,18,30,1995,3,"male",317,313,227,109,145,109,83,0,62
1024495,29,19,1984,6,"female",344,46,28,5,37,0,3,5,34
1024515,18,27,1995,1,"male",471,210,128,89,48,89,47,0,1
1024516,50,12,1963,7,"male",1011,57,15,0,2,0,2,0,0
1024534,64,10,1949,9,"male",930,35,20,26,0,0,0,26,0
1024578,32,20,1981,12,"male",685,47,30,0,1,0,0,0,1
1024592,58,27,1955,7,"male",647,160,124,54,112,54,59,0,53
1024637,18,7,1995,3,"male",259,67,64,24,24,24,0,0,24
1024639,24,14,1989,3,"male",106,2,2,0,0,0,0,0,0
1024643,20,17,1993,8,"female",685,3,2,0,0,0,0,0,0
1024649,56,2,1957,1,"male",1250,125,33,22,25,22,7,0,18
1024654,55,1,1958,10,"female",471,13,5,0,0,0,0,0,0
1024685,61,29,1952,4,"male",1091,19,8,0,1,0,1,0,0
1024727,61,10,1952,1,"female",675,24,18,23,2,0,2,23,0
1024733,53,18,1960,10,"male",337,4,3,0,0,0,0,0,0
1024751,56,9,1957,11,"female",127,69,44,17,0,17,0,0,0
1024769,23,18,1990,8,"male",557,626,530,455,287,455,282,0,5
1024783,26,23,1987,12,"female",290,200,168,38,2,38,2,0,0
1024830,13,27,2000,4,"male",161,35,10,3,0,0,0,3,0
1024845,45,30,1968,9,"female",574,63,29,200,245,200,218,0,27
1024861,20,29,1993,10,"male",226,111,105,1,1,1,1,0,0
1024868,108,9,1905,2,"male",1019,1242,652,129,78,34,30,95,48
1024869,17,9,1996,4,"female",14,0,0,0,0,0,0,0,0
1024875,26,14,1987,12,"male",708,30,28,0,0,0,0,0,0
1024883,32,16,1981,10,"female",604,6,0,0,0,0,0,0,0
1024905,53,16,1960,1,"male",450,46,38,1,10,1,4,0,6
1024910,31,28,1982,12,"male",331,3,2,37,13,0,3,37,10
1024915,65,1,1948,6,"male",745,168,87,153,146,57,81,96,65
1024920,53,6,1960,3,"female",845,115,79,281,157,265,74,16,83
1024942,14,5,1999,2,"female",350,586,320,2190,442,2033,289,157,153
1024947,29,13,1984,6,"male",988,148,84,50,35,50,25,0,10
1024949,54,5,1959,11,"male",776,178,124,1,0,1,0,0,0
1024951,14,18,1999,2,"female",81,134,64,105,13,105,11,0,2
1024981,43,30,1970,8,"female",308,223,126,2152,969,2152,396,0,573
1025010,29,28,1984,4,"female",285,30,16,132,33,132,32,0,1
1025043,19,23,1994,4,"female",296,251,220,117,105,117,41,0,64
1025059,67,12,1946,5,"male",1477,24,4,0,0,0,0,0,0
1025097,19,22,1994,9,"female",277,328,58,85,81,50,17,35,64
1025103,18,12,1995,2,"female",222,229,181,18,36,17,31,1,5
1025117,50,30,1963,6,"female",396,74,56,0,0,0,0,0,0
1025122,41,2,1972,6,"male",544,49,15,0,3,0,1,0,2
1025123,23,11,1990,4,"female",219,25,5,8,11,8,11,0,0
1025131,19,1,1994,6,"female",726,490,71,4288,1243,2112,401,2176,842
1025133,38,2,1975,9,"male",131,67,41,1,0,1,0,0,0
1025134,19,22,1994,1,"female",286,1037,658,2106,1431,2106,1204,0,227
1025152,17,4,1996,9,"male",40,35,21,13,22,12,8,1,14
1025176,19,1,1994,7,"female",236,59,25,29,47,29,26,0,21
1025200,39,16,1974,5,"male",680,0,0,0,0,0,0,0,0
1025235,48,1,1965,2,"female",648,50,11,13,6,0,3,13,3
1025239,16,7,1997,3,"male",578,158,78,1,0,1,0,0,0
1025255,19,29,1994,4,"female",311,76,31,0,0,0,0,0,0
1025260,56,21,1957,7,"female",1324,178,68,758,622,263,423,495,199
1025277,27,10,1986,10,"female",529,28,15,844,360,844,187,0,173
1025289,29,9,1984,5,"female",1060,196,120,420,501,1,301,419,200
1025295,31,15,1982,11,"male",245,11,5,0,0,0,0,0,0
1025301,20,6,1993,11,"female",625,166,83,105,8,103,5,2,3
1025343,62,27,1951,2,"female",1471,10,5,3,4,3,4,0,0
1025347,108,1,1905,4,"male",102,403,329,1071,1467,0,210,1071,1257
1025375,39,24,1974,7,"female",826,29,20,39,15,0,11,39,4
1025390,19,13,1994,2,"female",608,4507,296,202,1185,144,702,58,483
1025393,108,19,1905,5,"female",192,94,69,432,134,254,66,178,68
1025417,13,25,2000,1,"male",87,38,38,0,0,0,0,0,0
1025428,54,12,1959,3,"male",653,0,0,0,0,0,0,0,0
1025440,34,16,1979,7,"male",125,74,29,7,13,7,10,0,3
1025462,35,24,1978,6,"male",42,2,2,0,0,0,0,0,0
1025487,49,23,1964,10,"male",1535,93,17,1,2,1,1,0,1
1025488,108,11,1905,3,"male",1445,353,77,2,18,0,11,2,7
1025535,20,18,1993,4,"female",802,924,741,9,12,2,4,7,8
1025537,18,21,1995,6,"female",664,566,412,44,17,44,12,0,5
1025552,54,17,1959,8,"female",26,98,75,14,34,0,10,14,24
1025578,30,18,1983,4,"male",276,0,0,0,0,0,0,0,0
1025611,19,2,1994,5,"male",428,1444,959,478,472,50,217,428,255
1025615,40,6,1973,8,"female",231,36,27,415,319,415,237,0,82
1025622,30,9,1983,5,"male",264,189,118,137,33,43,8,94,25
1025667,18,1,1995,7,"male",666,252,179,8,22,7,15,1,7
1025668,64,25,1949,10,"male",1817,555,341,586,654,305,496,281,158
1025693,16,25,1997,9,"female",673,574,378,104,232,54,148,50,84
1025721,28,20,1985,1,"male",1396,296,168,42,26,41,7,1,19
1025729,28,9,1985,6,"male",388,423,122,43,122,43,111,0,11
1025778,53,10,1960,9,"male",1129,70,47,0,0,0,0,0,0
1025804,51,12,1962,6,"male",682,158,103,158,89,158,76,0,13
1025836,15,22,1998,5,"male",91,7,4,0,0,0,0,0,0
1025843,29,18,1984,11,"male",505,49,38,0,2,0,2,0,0
1025852,14,1,1999,8,"male",253,452,71,56,11,56,7,0,4
1025887,28,15,1985,3,"male",612,87,45,1,0,0,0,1,0
1025905,16,20,1997,9,"female",118,114,12,56,11,51,6,5,5
1025906,29,12,1984,8,"male",588,60,53,0,0,0,0,0,0
1025914,17,31,1996,10,"male",68,218,114,21,57,0,11,21,46
1025915,56,2,1957,10,"male",296,60,43,626,179,626,149,0,30
1025938,53,8,1960,11,"female",489,39,26,5,30,0,27,5,3
1025953,44,14,1969,8,"male",1120,10,6,0,3,0,2,0,1
1025987,19,24,1994,1,"male",89,9,5,8,3,8,3,0,0
1025993,25,1,1988,1,"female",218,276,27,402,626,402,577,0,49
1026002,26,1,1987,1,"male",259,67,53,3,1,3,0,0,1
1026065,16,7,1997,5,"male",59,17,7,37,0,37,0,0,0
1026081,18,8,1995,11,"female",700,4420,1890,417,601,168,386,249,215
1026114,108,1,1905,8,"male",12,11,11,0,0,0,0,0,0
1026117,36,4,1977,11,"female",1244,488,333,2666,1334,1097,752,1569,582
1026123,24,1,1989,1,"male",500,41,34,0,1,0,1,0,0
1026126,18,15,1995,7,"male",109,20,18,0,0,0,0,0,0
1026140,27,3,1986,1,"male",385,72,56,3,1,3,1,0,0
1026143,53,6,1960,1,"male",211,9,8,1,0,1,0,0,0
1026159,72,11,1941,11,"female",1750,71,17,675,479,1,33,674,446
1026160,26,3,1987,6,"female",416,66,0,0,0,0,0,0,0
1026178,47,18,1966,5,"male",658,58,30,156,26,156,21,0,5
1026186,25,11,1988,5,"male",139,290,277,1,11,1,8,0,3
1026239,25,9,1988,5,"male",585,441,335,168,26,135,5,33,21
1026250,16,27,1997,2,"female",544,1378,535,2241,3211,581,1400,1660,1811
1026254,16,29,1997,8,"male",306,92,79,34,4,34,3,0,1
1026267,22,2,1991,4,"male",409,485,393,27,5,0,2,27,3
1026271,22,29,1991,9,"male",235,166,84,0,0,0,0,0,0
1026311,16,11,1997,2,"male",239,73,55,0,0,0,0,0,0
1026339,45,30,1968,8,"male",377,77,51,21,3,21,1,0,2
1026341,68,17,1945,11,"female",1029,26,20,0,0,0,0,0,0
1026353,13,1,2000,3,"male",282,543,391,28,27,10,11,18,16
1026392,17,22,1996,11,"male",407,34,27,2,0,0,0,2,0
1026396,20,1,1993,1,"male",288,87,14,0,0,0,0,0,0
1026441,42,9,1971,3,"male",685,114,80,0,1,0,0,0,1
1026455,24,24,1989,2,"male",689,169,112,0,1,0,0,0,1
1026464,61,21,1952,5,"female",476,75,68,26,38,0,6,26,32
1026544,20,18,1993,8,"male",295,428,340,223,327,126,276,97,51
1026563,20,7,1993,10,"male",105,276,255,99,240,91,201,8,39
1026588,20,16,1993,10,"male",406,118,81,0,1,0,1,0,0
1026621,31,18,1982,5,"female",423,147,109,492,327,492,234,0,93
1026687,41,9,1972,6,"male",660,58,26,17,9,17,9,0,0
1026705,44,24,1969,5,"female",546,14,9,0,0,0,0,0,0
1026711,20,6,1993,5,"male",74,17,13,0,1,0,1,0,0
1026723,100,1,1913,12,"male",176,45,43,9,0,9,0,0,0
1026725,35,3,1978,8,"male",457,175,142,40,15,32,11,8,4
1026732,31,2,1982,12,"male",579,35,18,0,0,0,0,0,0
1026737,20,6,1993,8,"male",576,24,22,0,0,0,0,0,0
1026743,24,31,1989,1,"female",16,15,12,24,22,16,2,8,20
1026750,30,13,1983,7,"male",628,690,429,288,144,288,137,0,7
1026757,40,8,1973,7,"female",350,305,93,38,98,38,49,0,49
1026766,23,12,1990,6,"male",383,96,88,0,0,0,0,0,0
1026768,64,25,1949,9,"male",688,10,6,0,0,0,0,0,0
1026772,46,18,1967,7,"male",387,23,15,10,7,0,0,10,7
1026790,58,9,1955,2,"female",326,480,387,59,163,13,61,46,102
1026791,24,4,1989,1,"male",705,10,8,0,0,0,0,0,0
1026796,18,25,1995,10,"female",114,17,13,11,0,11,0,0,0
1026807,47,30,1966,10,"female",639,37,22,0,0,0,0,0,0
1026810,53,28,1960,2,"male",431,28,5,0,0,0,0,0,0
1026898,68,17,1945,10,"female",1112,53,44,3,1,3,1,0,0
1026933,19,5,1994,4,"female",654,31,13,0,2,0,2,0,0
1026948,51,20,1962,1,"male",289,68,51,26,41,26,28,0,13
1026957,39,21,1974,11,"male",336,139,47,5,0,5,0,0,0
1026967,17,18,1996,12,"female",174,160,94,810,835,292,344,518,491
1026975,106,4,1907,8,"male",1132,67,51,30,5,0,5,30,0
1026993,88,7,1925,4,"female",2262,377,200,467,356,415,134,52,222
1027006,63,1,1950,6,"female",1612,75,33,70,14,70,10,0,4
1027018,38,17,1975,8,"male",965,53,30,2,7,2,4,0,3
1027030,31,1,1982,10,"male",721,11,8,0,1,0,1,0,0
1027065,65,20,1948,4,"female",117,111,72,7,41,0,20,7,21
1027069,26,1,1987,1,"female",375,71,40,6,2,6,0,0,2
1027080,30,22,1983,8,"male",306,349,242,22,80,8,53,14,27
1027111,53,1,1960,9,"male",29,45,28,33,10,33,9,0,1
1027125,52,21,1961,3,"male",343,7,5,0,0,0,0,0,0
1027133,108,30,1905,11,"male",1655,71,49,0,0,0,0,0,0
1027144,44,29,1969,10,"male",768,7,7,0,0,0,0,0,0
1027209,34,8,1979,6,"male",354,10,9,44,11,44,10,0,1
1027227,33,3,1980,8,"female",289,111,84,44,12,4,3,40,9
1027240,56,20,1957,2,"female",406,36,32,8,4,8,3,0,1
1027251,26,3,1987,6,"male",271,14,5,893,683,889,406,4,277
1027253,41,22,1972,2,"female",68,2,1,3,14,0,4,3,10
1027264,93,9,1920,1,"male",2362,923,256,151,152,146,124,5,28
1027282,20,26,1993,6,"male",517,86,31,3,0,0,0,3,0
1027292,17,29,1996,12,"male",88,87,42,1,0,1,0,0,0
1027339,20,22,1993,6,"female",1545,542,229,795,1066,742,983,53,83
1027393,23,18,1990,2,"male",461,825,746,7,82,7,56,0,26
1027406,28,20,1985,1,"male",1002,71,54,7,0,7,0,0,0
1027421,32,6,1981,8,"female",382,115,49,14,3,0,0,14,3
1027427,51,1,1962,9,"male",652,19,9,50,0,0,0,50,0
1027447,42,15,1971,4,"male",242,54,29,5,6,3,5,2,1
1027488,23,14,1990,9,"male",357,47,44,0,0,0,0,0,0
1027572,66,5,1947,10,"male",1199,23,9,2,14,0,7,2,7
1027655,18,18,1995,10,"male",363,274,94,1,2,1,2,0,0
1027683,35,16,1978,6,"male",111,14,13,0,4,0,4,0,0
1027700,33,1,1980,1,"male",325,5,5,0,0,0,0,0,0
1027714,59,25,1954,1,"female",988,519,306,3068,3002,0,153,3068,2849
1027730,67,9,1946,1,"female",261,63,41,953,5,0,0,953,5
1027734,20,1,1993,4,"male",565,84,33,22,21,22,17,0,4
1027743,27,10,1986,10,"male",636,903,623,366,405,103,233,263,172
1027747,14,12,1999,9,"male",96,109,95,0,5,0,4,0,1
1027780,34,28,1979,6,"male",504,233,47,31,3,31,3,0,0
1027814,17,24,1996,7,"female",437,550,127,59,249,59,149,0,100
1027828,15,21,1998,4,"female",95,25,6,0,0,0,0,0,0
1027840,27,6,1986,8,"male",539,67,3,0,2,0,2,0,0
1027886,44,24,1969,1,"female",468,45,11,0,0,0,0,0,0
1027903,108,11,1905,1,"female",723,84,42,753,327,385,131,368,196
1027957,18,1,1995,10,"male",34,77,41,29,35,17,18,12,17
1027999,21,19,1992,11,"male",73,44,28,0,1,0,1,0,0
1028027,15,8,1998,2,"female",449,298,93,13,84,13,40,0,44
1028041,23,13,1990,10,"female",47,149,92,278,291,277,189,1,102
1028061,15,28,1998,1,"male",119,105,100,3,5,0,3,3,2
1028147,15,15,1998,12,"female",17,18,16,0,0,0,0,0,0
1028152,65,5,1948,12,"male",1535,24,8,1,0,1,0,0,0
1028176,23,25,1990,2,"male",187,145,83,12,11,11,7,1,4
1028203,15,11,1998,1,"female",549,548,390,132,227,132,207,0,20
1028211,46,11,1967,6,"male",1051,64,12,54,47,5,28,49,19
1028227,27,22,1986,6,"male",584,5,3,2,10,2,1,0,9
1028231,55,19,1958,4,"female",357,29,24,53,36,0,3,53,33
1028269,17,5,1996,3,"male",326,120,81,332,242,225,91,107,151
1028279,42,17,1971,7,"male",535,134,119,530,180,311,149,219,31
1028287,22,21,1991,9,"female",67,41,31,5,10,5,4,0,6
1028308,29,24,1984,10,"male",631,60,40,18,8,0,2,18,6
1028309,15,8,1998,8,"female",607,0,0,4,3,0,1,4,2
1028331,113,14,1900,2,"male",1260,657,529,57,8,5,2,52,6
1028348,46,14,1967,4,"female",658,15,5,4,3,4,3,0,0
1028407,38,28,1975,12,"female",518,179,96,61,37,39,24,22,13
1028434,21,9,1992,11,"female",419,256,161,1440,819,1440,690,0,129
1028454,31,19,1982,11,"male",1106,1,0,1,0,0,0,1,0
1028464,68,29,1945,11,"female",422,892,602,60,138,60,133,0,5
1028473,16,13,1997,3,"female",91,109,90,20,60,10,38,10,22
1028479,54,3,1959,8,"female",766,165,72,796,165,0,16,796,149
1028493,56,11,1957,1,"male",606,20,5,0,0,0,0,0,0
1028543,27,23,1986,3,"male",444,40,26,55,39,55,33,0,6
1028590,33,11,1980,2,"female",402,84,65,389,183,389,169,0,14
1028624,17,11,1996,6,"male",14,0,0,0,0,0,0,0,0
1028626,31,28,1982,8,"female",395,51,35,2,0,2,0,0,0
1028630,28,16,1985,3,"female",538,1702,994,109,533,108,429,1,104
1028644,61,24,1952,12,"male",658,61,12,1,32,1,27,0,5
1028666,23,5,1990,6,"male",1680,177,86,185,231,148,185,37,46
1028667,21,2,1992,6,"male",162,17,15,3,0,3,0,0,0
1028700,25,22,1988,11,"male",204,11,7,149,10,0,0,149,10
1028701,29,18,1984,11,"female",440,31,6,1,0,1,0,0,0
1028718,60,10,1953,2,"male",1351,183,81,0,99,0,91,0,8
1028730,30,1,1983,4,"male",9,0,0,6,1,6,1,0,0
1028764,22,3,1991,4,"female",307,64,37,16,9,14,6,2,3
1028774,17,1,1996,1,"female",201,152,100,130,132,129,71,1,61
1028788,30,5,1983,9,"male",130,21,15,1,3,1,2,0,1
1028792,26,27,1987,12,"male",669,1054,931,1335,676,625,493,710,183
1028830,31,27,1982,5,"male",663,783,693,39,90,39,78,0,12
1028831,60,26,1953,8,"male",473,117,111,4,32,0,15,4,17
1028843,25,25,1988,10,"male",291,0,0,0,0,0,0,0,0
1028849,58,10,1955,8,"male",1037,85,22,0,2,0,2,0,0
1028853,108,5,1905,3,"male",2286,260,232,317,263,212,169,105,94
1028892,34,9,1979,11,"male",380,24,16,49,28,49,25,0,3
1028893,18,10,1995,11,"male",562,394,322,438,298,361,226,77,72
1028897,34,2,1979,7,"male",771,74,21,0,0,0,0,0,0
1028910,24,24,1989,4,"male",131,309,309,0,0,0,0,0,0
1028920,21,18,1992,3,"male",626,432,327,14,33,14,28,0,5
1028925,19,1,1994,6,"female",618,53,25,0,0,0,0,0,0
1028949,56,16,1957,8,"female",403,72,49,1376,1039,1376,675,0,364
1028966,47,15,1966,10,"female",305,212,153,118,72,118,43,0,29
1028984,18,15,1995,5,"male",510,32,18,3,0,0,0,3,0
1028992,15,16,1998,4,"female",512,501,323,1851,1935,1684,1050,167,885
1029004,45,27,1968,4,"male",283,5,5,0,0,0,0,0,0
1029030,27,20,1986,6,"female",361,47,27,57,10,57,10,0,0
1029052,20,20,1993,9,"female",1118,1450,710,1305,1939,1059,1376,246,563
1029054,53,25,1960,4,"male",373,56,23,8,101,0,11,8,90
1029091,28,2,1985,6,"male",483,6,5,0,0,0,0,0,0
1029098,15,16,1998,4,"male",475,288,220,29,2,0,2,29,0
1029100,16,8,1997,10,"female",743,244,132,7,4,0,0,7,4
1029155,52,9,1961,5,"female",1156,74,24,186,188,186,161,0,27
1029162,22,18,1991,11,"female",347,115,51,2,15,2,12,0,3
1029169,15,31,1998,5,"male",462,62,38,0,0,0,0,0,0
1029175,22,5,1991,8,"male",283,4,2,46,0,1,0,45,0
1029182,36,19,1977,4,"male",73,0,0,2,0,2,0,0,0
1029257,26,31,1987,7,"male",463,8,2,0,0,0,0,0,0
1029267,70,13,1943,11,"female",434,80,56,5,2,5,2,0,0
1029279,43,15,1970,3,"female",197,1,0,349,175,349,137,0,38
1029282,71,4,1942,4,"male",200,24,15,0,0,0,0,0,0
1029298,63,7,1950,8,"male",279,87,71,179,21,0,0,179,21
1029307,103,2,1910,2,"male",209,122,98,39,36,3,2,36,34
1029330,62,12,1951,3,"female",1106,185,102,3,31,1,17,2,14
1029334,17,13,1996,1,"male",1080,146,121,0,0,0,0,0,0
1029380,21,11,1992,10,"male",412,19,10,3,2,3,2,0,0
1029385,33,8,1980,7,"female",193,89,59,5,6,5,0,0,6
1029405,44,25,1969,8,"female",699,206,168,45,57,0,29,45,28
1029415,96,12,1917,4,"female",1446,2914,324,5,11,2,9,3,2
1029424,21,14,1992,3,"male",382,134,107,1,3,1,3,0,0
1029439,17,3,1996,7,"female",376,443,198,69,353,69,337,0,16
1029466,18,23,1995,9,"female",378,367,326,939,478,937,304,2,174
1029497,59,14,1954,12,"male",469,21,17,70,16,0,7,70,9
1029505,19,26,1994,6,"male",107,154,150,92,13,31,9,61,4
1029559,26,11,1987,11,"male",282,254,215,152,32,152,19,0,13
1029565,20,1,1993,1,"male",286,94,59,127,101,127,53,0,48
1029571,51,18,1962,10,"male",282,123,87,3,0,3,0,0,0
1029573,15,18,1998,10,"female",74,47,28,24,12,3,4,21,8
1029620,43,4,1970,7,"female",525,107,61,234,252,107,129,127,123
1029637,23,2,1990,6,"male",497,181,127,1,15,1,15,0,0
1029666,24,9,1989,8,"male",821,741,543,96,35,74,13,22,22
1029698,16,1,1997,1,"male",334,112,82,2,1,0,1,2,0
1029731,36,13,1977,5,"male",157,31,16,2,0,2,0,0,0
1029732,18,16,1995,12,"male",248,372,311,0,0,0,0,0,0
1029738,30,9,1983,10,"male",280,0,0,0,0,0,0,0,0
1029743,59,2,1954,1,"male",262,42,32,0,0,0,0,0,0
1029751,21,15,1992,7,"female",268,191,72,7,12,7,12,0,0
1029767,36,3,1977,6,"female",293,0,0,0,0,0,0,0,0
1029773,25,12,1988,12,"male",829,39,30,16,43,16,42,0,1
1029808,16,6,1997,4,"female",530,647,353,26,46,26,45,0,1
1029829,22,7,1991,10,"male",1222,370,291,22,15,7,12,15,3
1029896,28,29,1985,12,"male",1052,222,120,0,4,0,4,0,0
1029920,57,10,1956,1,"female",1217,72,28,8,13,0,5,8,8
1029922,19,14,1994,7,"female",414,287,148,191,85,75,39,116,46
1029942,19,11,1994,4,"female",588,870,547,270,91,270,70,0,21
1029943,52,13,1961,4,"female",368,246,204,48,273,10,154,38,119
1029946,48,18,1965,3,"male",726,84,43,7,1,0,0,7,1
1029971,13,11,2000,6,"male",115,107,77,214,99,173,47,41,52
1030022,51,28,1962,5,"male",485,37,19,65,72,65,58,0,14
1030028,38,8,1975,1,"female",1139,195,36,0,1,0,1,0,0
1030030,103,29,1910,12,"male",1725,1175,581,1037,1538,306,342,731,1196
1030045,41,24,1972,5,"male",181,15,7,2,0,0,0,2,0
1030048,23,18,1990,12,"female",213,37,31,5,23,4,5,1,18
1030061,64,23,1949,12,"male",82,67,45,236,15,216,7,20,8
1030095,17,29,1996,2,"female",313,152,90,145,92,134,86,11,6
1030102,15,5,1998,8,"male",289,257,170,6,6,3,4,3,2
1030114,31,17,1982,9,"male",687,31,21,1,12,1,9,0,3
1030138,36,12,1977,3,"male",26,6,4,1,0,1,0,0,0
1030163,13,2,2000,6,"male",99,315,255,51,38,50,19,1,19
1030167,108,1,1905,2,"male",1522,269,129,138,71,0,24,138,47
1030172,73,11,1940,6,"male",1365,91,26,89,5,89,2,0,3
1030205,13,1,2000,1,"male",10,2,2,6,3,6,1,0,2
1030228,28,26,1985,10,"male",335,768,586,59,285,59,162,0,123
1030231,56,27,1957,10,"male",167,35,29,0,0,0,0,0,0
1030242,18,10,1995,7,"female",127,306,228,2,6,2,3,0,3
1030278,17,1,1996,7,"male",133,34,33,1,0,1,0,0,0
1030294,30,26,1983,4,"male",731,83,66,0,0,0,0,0,0
1030323,101,1,1912,1,"male",830,48,35,1,3,1,3,0,0
1030328,30,1,1983,1,"male",91,4,2,0,0,0,0,0,0
1030372,98,12,1915,7,"female",20,1343,167,24,41,24,33,0,8
1030378,19,30,1994,8,"male",336,92,60,42,65,42,62,0,3
1030385,21,27,1992,7,"female",538,285,211,43,6,43,6,0,0
1030424,29,6,1984,9,"male",115,24,14,11,2,11,0,0,2
1030444,22,21,1991,1,"male",254,27,23,40,0,40,0,0,0
1030466,50,25,1963,5,"female",377,2,2,0,1,0,0,0,1
1030485,17,1,1996,9,"male",229,33,17,0,0,0,0,0,0
1030486,15,17,1998,2,"female",448,1307,855,10803,5454,40,3907,10763,1547
1030492,23,14,1990,11,"female",287,320,206,691,534,691,475,0,59
1030535,18,25,1995,7,"female",161,966,253,505,555,166,371,339,184
1030549,25,1,1988,1,"male",38,7,5,28,9,28,9,0,0
1030565,108,23,1905,4,"male",1157,21,15,5,0,5,0,0,0
1030569,33,1,1980,4,"male",819,23,14,3,2,0,0,3,2
1030588,16,6,1997,8,"male",445,114,70,10,15,10,9,0,6
1030600,67,10,1946,2,"female",606,37,16,4,11,0,1,4,10
1030633,44,11,1969,3,"male",3,43,36,24,73,2,43,22,30
1030636,54,4,1959,10,"male",644,51,40,69,179,69,157,0,22
1030660,41,25,1972,1,"female",686,221,67,110,76,94,39,16,37
1030671,37,18,1976,2,"female",782,3,2,0,0,0,0,0,0
1030673,20,12,1993,12,"male",609,240,183,0,0,0,0,0,0
1030679,53,6,1960,5,"male",360,30,14,167,28,167,16,0,12
1030695,44,23,1969,3,"male",249,10,9,0,0,0,0,0,0
1030709,66,23,1947,9,"female",633,29,20,1,1,1,1,0,0
1030733,20,7,1993,10,"male",376,215,193,24,3,24,1,0,2
1030735,20,1,1993,12,"male",489,99,56,51,0,51,0,0,0
1030768,61,9,1952,2,"female",616,15,6,84,41,0,10,84,31
1030776,62,14,1951,3,"male",297,50,43,1,0,1,0,0,0
1030785,53,1,1960,4,"female",602,90,17,45,18,0,6,45,12
1030792,31,7,1982,12,"male",381,47,19,1,0,1,0,0,0
1030810,45,10,1968,7,"male",401,23,5,0,0,0,0,0,0
1030824,30,3,1983,10,"female",373,359,251,0,2,0,2,0,0
1030833,36,19,1977,8,"male",55,10,4,1,0,1,0,0,0
1030871,48,17,1965,4,"male",471,195,89,25,34,19,14,6,20
1030910,15,12,1998,8,"female",128,486,268,404,464,334,249,70,215
1030924,29,22,1984,5,"male",583,44,35,232,17,2,5,230,12
1030943,17,25,1996,9,"male",275,628,401,396,334,396,270,0,64
1030948,54,14,1959,1,"female",598,164,73,97,36,6,22,91,14
1030958,25,3,1988,11,"male",128,54,24,3,26,3,18,0,8
1030960,91,1,1922,1,"male",41,60,48,23,66,23,16,0,50
1030973,31,29,1982,8,"female",908,196,102,292,595,291,303,1,292
1030978,22,10,1991,6,"male",515,105,84,0,0,0,0,0,0
1030998,16,3,1997,3,"female",169,655,261,432,458,432,182,0,276
1031007,34,26,1979,10,"male",15,167,162,902,230,891,175,11,55
1031023,59,17,1954,1,"female",998,191,44,157,150,4,57,153,93
1031042,32,23,1981,9,"female",367,216,150,20,8,20,0,0,8
1031045,46,7,1967,8,"female",1286,98,4,25,22,25,17,0,5
1031051,29,16,1984,10,"male",226,39,30,0,0,0,0,0,0
1031062,18,10,1995,1,"male",406,382,238,9,167,9,100,0,67
1031075,20,10,1993,12,"male",449,25,22,20,1,0,0,20,1
1031087,47,16,1966,7,"male",129,64,39,5,4,0,2,5,2
1031099,31,27,1982,1,"female",380,229,146,29,30,29,20,0,10
1031101,55,18,1958,11,"female",421,88,29,936,250,936,161,0,89
1031142,66,15,1947,8,"female",1288,41,22,53,14,50,10,3,4
1031145,56,19,1957,7,"female",362,35,20,15,9,0,0,15,9
1031160,23,4,1990,3,"female",249,29,21,21,0,0,0,21,0
1031176,31,19,1982,9,"male",611,129,60,1,0,1,0,0,0
1031182,66,14,1947,11,"female",768,57,42,49,9,0,6,49,3
1031184,25,6,1988,1,"female",307,60,30,659,182,659,174,0,8
1031196,18,3,1995,4,"male",248,31,27,2,6,1,0,1,6
1031222,63,11,1950,6,"male",636,198,81,0,0,0,0,0,0
1031237,43,27,1970,4,"male",1628,521,152,20,71,20,59,0,12
1031246,23,27,1990,8,"female",1572,629,215,784,1087,684,885,100,202
1031274,27,28,1986,8,"male",555,16,12,0,0,0,0,0,0
1031278,29,3,1984,1,"female",274,43,38,3,19,3,8,0,11
1031306,51,24,1962,9,"female",98,43,38,3,0,3,0,0,0
1031308,20,11,1993,10,"male",210,5,5,0,0,0,0,0,0
1031320,19,20,1994,12,"male",275,65,53,0,0,0,0,0,0
1031324,56,21,1957,8,"male",542,26,14,0,0,0,0,0,0
1031330,28,6,1985,6,"male",932,563,270,1,5,1,4,0,1
1031350,58,26,1955,12,"female",1384,76,43,621,282,621,206,0,76
1031395,22,22,1991,5,"male",417,0,0,0,0,0,0,0,0
1031401,57,17,1956,1,"male",576,50,24,8,2,0,0,8,2
1031405,38,18,1975,9,"male",266,25,23,1,0,0,0,1,0
1031411,42,11,1971,4,"female",615,68,49,168,42,168,40,0,2
1031420,22,16,1991,7,"male",285,1,1,0,0,0,0,0,0
1031425,74,25,1939,12,"female",202,339,171,163,79,123,36,40,43
1031434,28,28,1985,8,"male",396,114,99,328,144,20,37,308,107
1031472,13,23,2000,3,"male",153,539,430,546,186,546,158,0,28
1031480,23,16,1990,2,"male",385,126,86,0,0,0,0,0,0
1031497,28,22,1985,11,"female",476,149,107,12,2,12,0,0,2
1031498,54,23,1959,4,"female",20,62,55,38,25,38,9,0,16
1031499,68,24,1945,9,"male",165,30,11,3,1,0,1,3,0
1031580,19,25,1994,12,"male",17,29,24,69,22,63,21,6,1
1031586,66,11,1947,8,"male",1077,138,99,390,85,0,15,390,70
1031590,54,19,1959,2,"female",1174,89,44,4,56,0,14,4,42
1031614,50,5,1963,6,"female",1712,204,85,69,61,18,37,51,24
1031638,30,9,1983,9,"male",449,29,21,0,1,0,1,0,0
1031654,26,18,1987,1,"female",666,1,1,4,3,3,2,1,1
1031680,44,22,1969,9,"female",188,33,24,211,43,211,35,0,8
1031702,44,18,1969,7,"female",314,94,61,36,7,3,4,33,3
1031709,22,22,1991,4,"male",527,84,34,6,167,1,110,5,57
1031713,24,15,1989,11,"male",536,54,15,0,21,0,7,0,14
1031761,33,1,1980,8,"female",1613,154,82,297,465,297,393,0,72
1031807,43,2,1970,12,"male",277,22,12,0,0,0,0,0,0
1031832,25,14,1988,2,"male",392,131,114,11,8,11,6,0,2
1031847,66,10,1947,7,"male",1634,57,21,109,104,7,57,102,47
1031901,29,18,1984,9,"female",388,163,96,1143,1085,1143,786,0,299
1031914,32,4,1981,2,"female",327,30,23,1,3,1,3,0,0
1031922,19,3,1994,6,"female",138,844,371,605,312,397,196,208,116
1031925,24,14,1989,7,"female",94,34,19,253,51,253,20,0,31
1031946,14,10,1999,5,"male",662,1911,1475,804,1205,784,844,20,361
1031967,18,5,1995,5,"male",305,147,85,2,25,2,14,0,11
1031968,24,26,1989,5,"female",564,293,230,217,538,217,493,0,45
1031979,22,12,1991,11,"female",174,52,37,65,52,44,39,21,13
1032046,28,25,1985,4,"male",12,13,12,3,5,3,5,0,0
1032121,16,12,1997,1,"male",493,223,150,3,2,0,0,3,2
1032147,44,10,1969,2,"male",1553,331,118,49,40,42,29,7,11
1032156,98,20,1915,1,"male",2167,772,670,480,129,429,91,51,38
1032174,27,11,1986,7,"male",368,29,11,1,0,1,0,0,0
1032186,51,15,1962,2,"female",532,63,52,48,46,48,27,0,19
1032190,20,10,1993,12,"female",442,616,454,1,7,1,2,0,5
1032196,20,26,1993,11,"male",243,148,122,0,0,0,0,0,0
1032208,20,24,1993,5,"male",724,223,123,2,37,2,6,0,31
1032217,25,24,1988,2,"female",368,98,87,0,0,0,0,0,0
1032219,25,19,1988,9,"male",754,54,40,51,20,15,10,36,10
1032229,25,12,1988,9,"male",144,238,206,0,0,0,0,0,0
1032310,49,29,1964,2,"male",178,121,87,56,111,56,64,0,47
1032323,30,12,1983,12,"female",380,33,19,2,2,2,1,0,1
1032324,28,15,1985,10,"male",78,314,264,1815,767,1815,696,0,71
1032361,19,21,1994,6,"female",156,22,13,0,0,0,0,0,0
1032377,69,11,1944,1,"female",922,666,106,165,69,165,62,0,7
1032435,31,10,1982,6,"female",278,55,39,9,5,9,5,0,0
1032439,40,21,1973,4,"female",457,90,60,10,42,9,36,1,6
1032445,25,16,1988,8,"female",82,19,9,595,20,595,11,0,9
1032468,55,29,1958,9,"female",306,95,63,6,87,4,17,2,70
1032498,20,1,1993,9,"male",280,273,112,108,71,83,44,25,27
1032499,56,8,1957,1,"female",1858,306,107,48,107,16,84,32,23
1032502,60,17,1953,6,"female",621,3,2,0,0,0,0,0,0
1032521,38,2,1975,4,"male",908,71,32,2,0,2,0,0,0
1032523,29,10,1984,2,"male",518,272,169,158,18,152,3,6,15
1032527,108,5,1905,8,"male",1224,278,191,49,48,49,37,0,11
1032529,28,4,1985,4,"male",606,168,111,0,0,0,0,0,0
1032569,24,4,1989,12,"male",337,55,13,212,7,212,7,0,0
1032595,21,29,1992,4,"male",674,1291,652,528,554,206,366,322,188
1032617,25,1,1988,1,"male",252,14,6,0,0,0,0,0,0
1032627,20,22,1993,12,"male",881,227,102,1,0,1,0,0,0
1032643,24,26,1989,3,"male",960,95,40,0,0,0,0,0,0
1032648,19,28,1994,8,"male",375,411,393,11,5,11,4,0,1
1032717,14,10,1999,5,"male",250,44,34,13,78,3,7,10,71
1032725,100,16,1913,8,"female",2234,41,13,1,0,1,0,0,0
1032754,31,2,1982,3,"female",10,13,1,16,14,16,13,0,1
1032775,22,14,1991,6,"male",499,28,18,4,1,4,1,0,0
1032790,13,29,2000,2,"female",243,25,7,608,40,608,20,0,20
1032811,27,26,1986,10,"female",543,50,33,15,57,15,18,0,39
1032814,81,19,1932,8,"female",512,117,94,41,39,0,5,41,34
1032819,57,23,1956,9,"male",1497,377,197,413,204,413,197,0,7
1032852,18,22,1995,3,"female",676,109,75,3,1,3,1,0,0
1032853,27,23,1986,3,"female",404,18,6,0,0,0,0,0,0
1032875,16,18,1997,5,"male",436,241,129,11,78,2,6,9,72
1032918,31,23,1982,6,"male",279,9,5,3,13,0,0,3,13
1032934,28,14,1985,9,"female",346,30,5,75,18,75,17,0,1
1032938,38,1,1975,4,"male",184,70,25,4,10,4,8,0,2
1032940,25,26,1988,9,"female",555,500,144,655,1967,459,1454,196,513
1032975,28,10,1985,12,"female",222,83,38,34,48,34,48,0,0
1033002,21,12,1992,3,"male",359,135,120,0,0,0,0,0,0
1033021,53,7,1960,8,"female",429,36,25,50,45,0,22,50,23
1033027,45,10,1968,8,"female",527,169,84,430,578,89,406,341,172
1033038,20,5,1993,8,"female",263,443,307,48,24,48,21,0,3
1033045,56,6,1957,2,"male",345,25,19,0,0,0,0,0,0
1033046,34,1,1979,1,"male",120,33,27,45,136,45,57,0,79
1033085,55,8,1958,3,"female",290,3,2,24,2,24,1,0,1
1033088,30,22,1983,3,"male",322,66,37,1,0,0,0,1,0
1033100,34,15,1979,9,"male",437,136,50,37,14,13,12,24,2
1033101,29,26,1984,10,"female",267,12,8,638,7,638,4,0,3
1033109,20,30,1993,8,"male",537,343,130,1651,751,1643,530,8,221
1033164,26,15,1987,9,"male",207,47,40,1,0,1,0,0,0
1033213,58,29,1955,12,"male",351,123,101,65,64,0,48,65,16
1033217,20,10,1993,7,"male",677,49,39,52,18,36,11,16,7
1033249,19,7,1994,12,"male",651,99,14,122,54,116,48,6,6
1033297,23,23,1990,10,"female",392,21,18,0,0,0,0,0,0
1033303,22,25,1991,3,"male",303,72,38,120,18,120,14,0,4
1033318,67,18,1946,10,"male",202,35,14,36,34,0,18,36,16
1033324,36,13,1977,7,"female",142,90,51,9,66,0,3,9,63
1033329,18,21,1995,5,"female",253,450,167,305,160,97,73,208,87
1033330,19,8,1994,5,"male",253,82,57,15,43,15,32,0,11
1033385,50,22,1963,9,"female",297,141,88,0,3,0,2,0,1
1033411,107,1,1906,1,"male",949,4,2,133,85,0,3,133,82
1033413,69,28,1944,6,"female",1043,39,28,32,13,32,13,0,0
1033428,29,29,1984,10,"female",969,121,54,3,6,3,4,0,2
1033429,26,14,1987,1,"female",533,734,525,343,997,343,878,0,119
1033442,65,6,1948,4,"male",1197,19,11,3,13,0,9,3,4
1033449,24,9,1989,12,"male",254,41,17,2,8,2,7,0,1
1033453,21,11,1992,6,"male",377,149,86,0,23,0,12,0,11
1033492,34,13,1979,11,"male",544,98,73,21,1,21,0,0,1
1033495,27,4,1986,1,"female",524,5,4,11,0,11,0,0,0
1033515,63,4,1950,11,"female",692,73,30,26,56,26,26,0,30
1033518,38,7,1975,12,"male",265,100,75,4,22,4,20,0,2
1033539,18,4,1995,3,"male",96,27,25,0,0,0,0,0,0
1033594,68,16,1945,3,"female",89,27,21,80,17,80,14,0,3
1033632,45,1,1968,10,"female",294,222,125,1,224,0,155,1,69
1033636,16,13,1997,3,"female",452,74,38,6,0,6,0,0,0
1033666,58,11,1955,4,"female",47,15,15,250,2,250,2,0,0
1033689,55,28,1958,5,"female",1562,56,37,67,54,67,29,0,25
1033690,108,29,1905,4,"male",1097,284,159,30,29,7,6,23,23
1033715,18,23,1995,11,"male",81,40,36,9,2,0,2,9,0
1033725,28,10,1985,6,"male",180,43,30,5,22,5,21,0,1
1033745,19,2,1994,12,"male",369,291,158,113,97,9,17,104,80
1033753,18,6,1995,9,"female",193,192,135,13,8,1,3,12,5
1033792,29,20,1984,12,"female",301,0,0,0,0,0,0,0,0
1033795,38,23,1975,4,"female",637,258,194,144,101,55,73,89,28
1033845,46,30,1967,10,"male",472,514,478,97,21,13,17,84,4
1033851,21,21,1992,8,"male",131,5,5,4,0,3,0,1,0
1033852,22,27,1991,8,"female",59,281,198,470,361,459,103,11,258
1033857,32,16,1981,5,"female",318,2,2,0,0,0,0,0,0
1033859,47,23,1966,3,"female",59,9,8,73,15,0,10,73,5
1033872,48,25,1965,5,"male",112,14,4,0,1,0,0,0,1
1033873,24,17,1989,9,"female",416,188,150,53,38,51,11,2,27
1033885,23,5,1990,1,"male",259,10,8,1,1,1,1,0,0
1033902,31,2,1982,2,"male",201,22,20,0,13,0,5,0,8
1033903,103,13,1910,4,"male",1215,208,65,28,287,5,126,23,161
1033915,82,8,1931,8,"female",1201,32,17,1,1,0,1,1,0
1033916,28,25,1985,9,"female",282,6,6,0,1,0,1,0,0
1033919,17,1,1996,11,"male",713,71,37,8,1,6,1,2,0
1033966,57,12,1956,11,"male",1404,47,20,3,2,0,2,3,0
1033971,20,10,1993,1,"female",540,540,227,47,78,47,50,0,28
1033972,63,29,1950,1,"male",878,89,24,115,23,0,18,115,5
1033991,16,11,1997,1,"female",335,198,44,40,10,0,4,40,6
1033997,59,10,1954,9,"female",329,25,25,0,0,0,0,0,0
1034002,14,27,1999,7,"female",459,536,302,285,324,285,195,0,129
1034022,38,24,1975,8,"female",521,11,8,0,0,0,0,0,0
1034026,28,2,1985,7,"male",278,91,76,90,28,89,14,1,14
1034056,75,11,1938,8,"male",500,60,30,1,6,0,5,1,1
1034082,42,30,1971,8,"female",832,98,68,121,64,55,35,66,29
1034116,30,2,1983,5,"male",433,92,36,0,0,0,0,0,0
1034131,23,27,1990,11,"male",801,236,147,0,1,0,1,0,0
1034138,16,12,1997,3,"male",345,86,72,2,0,0,0,2,0
1034139,17,22,1996,12,"female",120,3504,782,147,373,144,307,3,66
1034144,22,15,1991,7,"male",334,29,4,0,1,0,0,0,1
1034148,18,1,1995,4,"male",502,610,544,60,31,60,24,0,7
1034159,24,26,1989,2,"female",690,91,57,2,0,2,0,0,0
1034181,81,25,1932,12,"male",709,134,56,13,16,13,11,0,5
1034192,39,26,1974,3,"female",685,104,75,394,165,188,102,206,63
1034203,55,1,1958,6,"female",217,34,14,9,0,0,0,9,0
1034248,27,8,1986,9,"male",281,48,25,15,2,15,1,0,1
1034257,22,1,1991,1,"male",669,93,73,2,0,2,0,0,0
1034271,100,7,1913,8,"female",1059,1014,374,180,56,117,17,63,39
1034272,22,10,1991,10,"female",739,592,335,318,733,50,140,268,593
1034281,21,13,1992,4,"male",466,21,19,1,2,0,1,1,1
1034283,19,18,1994,10,"female",938,94,54,4,4,4,4,0,0
1034324,27,14,1986,12,"male",540,153,147,36,3,28,0,8,3
1034327,36,10,1977,6,"male",370,10,6,14,5,14,4,0,1
1034331,66,27,1947,4,"female",916,28,18,0,0,0,0,0,0
1034385,50,26,1963,12,"male",620,3681,1900,463,3801,463,3438,0,363
1034391,30,24,1983,3,"female",37,15,11,65,71,65,64,0,7
1034404,111,10,1902,12,"male",1309,199,122,11,26,9,10,2,16
1034409,47,26,1966,3,"female",610,13,4,0,0,0,0,0,0
1034411,55,25,1958,1,"male",229,9,4,0,0,0,0,0,0
1034418,37,18,1976,2,"male",622,23,13,0,1,0,1,0,0
1034458,21,30,1992,7,"female",664,123,72,2,12,1,7,1,5
1034481,63,27,1950,1,"female",228,26,10,95,96,0,13,95,83
1034486,49,22,1964,2,"female",187,33,24,2,5,0,2,2,3
1034502,18,21,1995,1,"female",411,703,276,770,564,583,220,187,344
1034515,19,11,1994,2,"male",124,9,7,31,11,31,2,0,9
1034534,21,17,1992,7,"male",526,106,81,2,0,2,0,0,0
1034537,15,17,1998,7,"female",275,147,80,25,21,25,15,0,6
1034538,26,10,1987,9,"male",203,17,16,102,56,37,30,65,26
1034591,19,23,1994,11,"male",247,106,84,9,4,0,2,9,2
1034620,27,1,1986,2,"male",123,89,58,5,4,5,4,0,0
1034629,16,26,1997,3,"male",663,590,482,18,11,6,5,12,6
1034660,48,6,1965,6,"female",1652,211,140,369,1246,274,670,95,576
1034703,59,11,1954,11,"female",4,7,6,16,34,0,20,16,14
1034716,29,30,1984,10,"female",269,34,21,291,109,291,82,0,27
1034728,28,12,1985,5,"female",313,24,15,2,2,2,1,0,1
1034737,18,27,1995,5,"male",455,407,352,164,24,152,19,12,5
1034745,37,23,1976,11,"male",780,65,20,0,0,0,0,0,0
1034764,20,9,1993,12,"male",326,183,150,1,30,1,6,0,24
1034792,18,7,1995,4,"female",299,766,269,355,478,287,239,68,239
1034801,108,1,1905,1,"female",1465,62,19,6,1,3,1,3,0
1034804,108,22,1905,5,"male",947,586,421,42,89,42,57,0,32
1034805,83,30,1930,8,"female",1731,239,128,73,423,73,273,0,150
1034818,22,26,1991,3,"male",1675,604,383,110,363,69,315,41,48
1034822,21,16,1992,9,"male",800,117,48,0,2,0,0,0,2
1034829,113,14,1900,1,"female",1969,233,87,249,496,249,397,0,99
1034836,30,25,1983,6,"male",459,68,32,0,1,0,1,0,0
1034846,62,18,1951,3,"female",652,29,24,6,11,1,10,5,1
1034859,29,19,1984,1,"male",662,160,71,1,4,0,3,1,1
1034904,53,6,1960,9,"female",879,104,56,166,18,0,11,166,7
1034913,63,21,1950,8,"female",767,189,48,338,32,338,18,0,14
1034921,28,28,1985,8,"male",332,240,209,5,0,5,0,0,0
1034947,67,24,1946,7,"male",1353,200,125,1444,583,0,87,1444,496
1034972,87,12,1926,9,"female",285,9,9,14,2,0,1,14,1
1034994,24,15,1989,8,"male",350,28,12,10,8,10,2,0,6
1035024,52,14,1961,1,"male",84,112,77,8,63,8,34,0,29
1035041,68,27,1945,8,"female",1042,259,143,561,96,0,19,561,77
1035089,21,21,1992,1,"male",389,137,65,0,0,0,0,0,0
1035092,16,3,1997,3,"female",318,143,14,45,11,45,11,0,0
1035107,19,21,1994,10,"male",188,61,56,2,0,1,0,1,0
1035116,24,4,1989,12,"male",463,255,212,140,30,140,15,0,15
1035118,32,8,1981,8,"female",310,36,0,33,52,33,46,0,6
1035172,18,26,1995,8,"male",453,145,116,10,12,6,2,4,10
1035176,55,29,1958,10,"male",237,22,19,4,7,4,4,0,3
1035200,49,20,1964,2,"male",1825,93,32,0,1,0,1,0,0
1035209,45,3,1968,10,"male",664,156,107,18,6,17,6,1,0
1035246,20,19,1993,8,"female",429,77,43,162,80,162,28,0,52
1035283,24,11,1989,8,"male",312,167,93,60,103,42,45,18,58
1035290,37,15,1976,4,"male",127,63,55,93,153,93,73,0,80
1035309,26,10,1987,5,"male",699,179,156,0,0,0,0,0,0
1035351,47,19,1966,6,"female",375,39,31,98,0,98,0,0,0
1035378,44,21,1969,1,"male",1011,137,117,0,6,0,2,0,4
1035403,14,9,1999,3,"female",290,642,273,69,137,52,76,17,61
1035414,20,16,1993,11,"female",246,64,31,1,7,0,1,1,6
1035437,19,5,1994,11,"female",34,215,83,34,31,34,24,0,7
1035448,19,20,1994,5,"male",206,56,44,1,3,0,1,1,2
1035460,24,28,1989,10,"male",93,67,61,0,4,0,1,0,3
1035469,18,18,1995,3,"female",277,59,28,4,5,4,4,0,1
1035510,103,8,1910,7,"female",70,122,43,12,15,12,8,0,7
1035523,48,11,1965,8,"female",839,82,52,771,217,712,153,59,64
1035532,69,19,1944,5,"female",479,35,21,57,35,1,1,56,34
1035533,25,21,1988,4,"male",98,2,2,1,0,1,0,0,0
1035538,16,12,1997,12,"male",348,266,214,9,0,0,0,9,0
1035546,54,12,1959,10,"female",1190,239,97,24,48,7,29,17,19
1035559,28,19,1985,11,"male",478,478,439,7,79,7,39,0,40
1035589,46,8,1967,1,"male",1656,86,65,27,33,27,28,0,5
1035623,17,1,1996,7,"male",351,97,85,4,5,4,4,0,1
1035656,64,29,1949,12,"female",1371,29,11,11,3,11,3,0,0
1035688,24,28,1989,10,"male",342,361,216,850,204,850,151,0,53
1035694,107,24,1906,12,"female",795,169,30,91,75,91,40,0,35
1035695,34,20,1979,7,"female",180,23,16,0,0,0,0,0,0
1035719,70,16,1943,9,"male",347,0,0,0,0,0,0,0,0
1035739,54,24,1959,1,"male",1343,41,39,1,0,1,0,0,0
1035744,53,19,1960,2,"female",614,13,8,2,1,0,1,2,0
1035749,23,15,1990,4,"male",285,1556,255,14,80,14,55,0,25
1035760,33,16,1980,4,"male",615,453,246,95,85,94,52,1,33
1035786,22,3,1991,6,"male",320,358,231,1,16,1,11,0,5
1035794,14,1,1999,1,"male",208,125,75,4,35,3,14,1,21
1035796,18,11,1995,7,"female",410,1367,86,284,536,210,349,74,187
1035817,23,21,1990,5,"male",12,3,0,0,0,0,0,0,0
1035823,23,29,1990,5,"male",278,39,37,0,8,0,5,0,3
1035845,23,11,1990,12,"male",777,164,56,161,151,150,85,11,66
1035869,16,22,1997,5,"male",213,264,253,10,7,0,7,10,0
1035890,19,20,1994,6,"male",981,211,101,103,3,98,0,5,3
1035891,31,28,1982,11,"female",573,299,180,86,77,64,51,22,26
1035900,17,14,1996,11,"male",505,46,41,0,0,0,0,0,0
1035906,82,31,1931,5,"male",1164,924,534,45,64,33,18,12,46
1035950,32,23,1981,2,"male",1855,235,107,5,3,5,3,0,0
1035964,16,11,1997,3,"female",315,115,56,18,4,18,1,0,3
1035990,22,1,1991,7,"female",115,252,216,48,237,47,136,1,101
1036010,26,15,1987,5,"male",222,149,133,0,0,0,0,0,0
1036015,27,8,1986,6,"male",242,207,48,1,4,1,3,0,1
1036031,19,20,1994,7,"male",839,163,65,4,2,4,2,0,0
1036053,55,17,1958,2,"female",597,42,6,5,7,0,7,5,0
1036069,60,4,1953,1,"male",653,12,3,10,2,0,1,10,1
1036073,25,15,1988,11,"male",163,144,135,0,43,0,25,0,18
1036096,24,10,1989,10,"female",382,2,1,0,0,0,0,0,0
1036120,25,12,1988,6,"female",388,34,19,0,0,0,0,0,0
1036195,25,20,1988,1,"female",279,234,181,0,0,0,0,0,0
1036199,27,9,1986,5,"male",303,4,2,1,1,0,0,1,1
1036241,31,9,1982,6,"female",324,84,33,0,0,0,0,0,0
1036245,63,17,1950,12,"female",2000,222,125,633,289,625,191,8,98
1036246,103,19,1910,3,"male",1755,51,25,15,8,0,7,15,1
1036248,30,18,1983,4,"male",324,17,7,0,2,0,2,0,0
1036253,17,28,1996,3,"female",445,167,113,0,9,0,9,0,0
1036256,18,21,1995,4,"female",364,126,84,269,84,268,81,1,3
1036282,34,21,1979,8,"male",349,51,46,8,1,0,1,8,0
1036305,29,10,1984,12,"female",446,155,130,5,1,5,1,0,0
1036312,68,19,1945,5,"male",571,43,12,2,11,2,6,0,5
1036323,41,15,1972,2,"female",693,567,301,423,803,420,387,3,416
1036330,101,12,1912,12,"male",236,194,111,54,21,54,16,0,5
1036336,88,20,1925,6,"male",1443,209,134,62,48,2,11,60,37
1036338,22,2,1991,9,"female",510,128,105,326,427,101,128,225,299
1036355,14,23,1999,8,"male",196,76,45,1,0,0,0,1,0
1036364,48,15,1965,3,"female",181,123,95,195,174,147,128,48,46
1036374,67,21,1946,6,"female",952,33,24,13,4,13,4,0,0
1036376,60,13,1953,1,"female",1314,102,40,64,19,17,3,47,16
1036416,51,9,1962,3,"male",385,77,34,69,86,56,69,13,17
1036417,57,28,1956,9,"male",453,10,6,0,0,0,0,0,0
1036424,18,1,1995,1,"female",498,1670,537,62,129,62,85,0,44
1036436,49,26,1964,8,"male",417,1,0,0,3,0,2,0,1
1036439,19,4,1994,3,"female",389,3003,398,1176,2256,632,1709,544,547
1036467,32,2,1981,9,"female",260,81,68,100,94,100,43,0,51
1036473,98,5,1915,3,"male",660,753,479,16,55,16,44,0,11
1036530,34,15,1979,1,"female",213,127,45,2,5,0,2,2,3
1036550,34,6,1979,3,"female",331,105,82,42,70,42,63,0,7
1036579,26,19,1987,12,"male",451,768,533,913,304,864,208,49,96
1036598,19,30,1994,10,"female",429,108,65,35,125,33,37,2,88
1036601,23,8,1990,7,"male",195,11,6,0,0,0,0,0,0
1036606,22,20,1991,11,"female",350,31,19,0,0,0,0,0,0
1036611,32,2,1981,6,"female",421,207,154,633,178,572,78,61,100
1036644,27,2,1986,10,"female",193,14,6,20,0,20,0,0,0
1036658,53,23,1960,6,"male",171,8,4,1,0,1,0,0,0
1036662,31,5,1982,6,"male",10,2,1,0,0,0,0,0,0
1036679,103,26,1910,5,"male",826,251,155,4,4,4,4,0,0
1036684,43,6,1970,7,"female",1804,309,139,529,918,511,490,18,428
1036729,67,27,1946,11,"female",780,126,49,92,75,92,47,0,28
1036768,68,3,1945,7,"male",619,2,2,0,0,0,0,0,0
1036772,25,25,1988,2,"female",621,51,19,22,8,22,7,0,1
1036774,16,10,1997,12,"male",318,21,17,0,0,0,0,0,0
1036789,56,24,1957,11,"male",250,134,106,250,225,250,173,0,52
1036815,21,1,1992,1,"male",102,31,29,35,2,35,2,0,0
1036825,26,1,1987,1,"male",301,42,23,0,0,0,0,0,0
1036832,23,29,1990,1,"male",219,0,0,0,0,0,0,0,0
1036837,32,31,1981,10,"male",552,86,56,12,7,12,7,0,0
1036868,24,29,1989,12,"male",238,30,20,0,0,0,0,0,0
1036873,33,1,1980,6,"male",415,1053,573,1066,1542,285,317,781,1225
1036876,103,15,1910,6,"female",1403,2153,794,25,97,25,78,0,19
1036908,29,26,1984,11,"male",493,146,65,18,39,15,16,3,23
1036910,26,4,1987,11,"female",438,43,32,664,0,664,0,0,0
1036953,43,1,1970,1,"male",793,3797,1034,5926,12642,3975,8460,1951,4182
1036955,44,25,1969,5,"male",162,10,7,16,22,8,10,8,12
1036968,108,22,1905,2,"female",13,248,240,6,30,0,14,6,16
1036971,31,1,1982,12,"female",371,799,155,0,3,0,3,0,0
1036984,28,22,1985,6,"female",126,10,3,14,1,14,1,0,0
1036994,15,29,1998,8,"male",432,367,284,99,42,82,23,17,19
1037020,17,31,1996,8,"male",25,8,4,1,0,1,0,0,0
1037030,26,16,1987,3,"female",411,85,52,239,13,239,10,0,3
1037040,30,1,1983,6,"male",382,71,55,14,5,14,5,0,0
1037094,90,1,1923,5,"male",986,158,36,3,0,3,0,0,0
1037110,28,27,1985,2,"female",225,62,46,47,0,47,0,0,0
1037139,49,19,1964,1,"female",330,28,14,217,16,6,3,211,13
1037176,14,6,1999,5,"male",11,3,3,6,0,6,0,0,0
1037185,69,31,1944,7,"male",1537,220,115,404,174,390,98,14,76
1037189,33,3,1980,10,"male",227,1,1,0,0,0,0,0,0
1037223,30,2,1983,6,"male",319,51,37,0,6,0,0,0,6
1037228,50,1,1963,7,"female",1360,319,168,603,405,226,139,377,266
1037255,22,8,1991,5,"male",422,132,85,2,10,2,3,0,7
1037258,25,20,1988,2,"female",91,306,267,129,156,71,101,58,55
1037270,25,29,1988,7,"male",419,18,10,0,1,0,0,0,1
1037293,25,16,1988,12,"male",234,399,394,4,0,4,0,0,0
1037382,68,19,1945,7,"female",1742,159,79,106,67,0,26,106,41
1037405,27,1,1986,1,"female",719,31,9,0,0,0,0,0,0
1037407,29,8,1984,8,"male",97,91,86,6,8,6,6,0,2
1037425,23,6,1990,7,"female",572,538,400,154,2,58,0,96,2
1037484,16,10,1997,5,"male",399,212,188,107,13,32,9,75,4
1037491,14,28,1999,3,"female",211,786,244,1441,650,970,445,471,205
1037493,69,5,1944,11,"female",390,64,45,144,18,135,8,9,10
1037520,72,11,1941,10,"female",508,16,12,5,9,0,2,5,7
1037541,28,1,1985,3,"male",42,6,5,0,0,0,0,0,0
1037574,18,25,1995,9,"male",853,307,174,1,0,0,0,1,0
1037587,37,14,1976,11,"male",203,25,13,0,1,0,1,0,0
1037588,100,15,1913,6,"female",1047,348,233,151,126,115,61,36,65
1037591,52,19,1961,7,"female",124,20,12,18,24,0,14,18,10
1037601,29,4,1984,1,"male",220,222,36,70,24,70,12,0,12
1037606,39,15,1974,4,"female",369,40,22,2,6,0,0,2,6
1037610,75,31,1938,8,"female",1808,83,26,0,1,0,1,0,0
1037611,14,10,1999,1,"female",505,520,254,2,2,2,2,0,0
1037613,23,4,1990,11,"male",717,97,62,0,21,0,21,0,0
1037629,22,1,1991,7,"male",439,83,57,0,6,0,6,0,0
1037652,27,15,1986,5,"female",481,43,25,308,17,282,17,26,0
1037656,30,22,1983,6,"male",458,71,31,92,28,0,5,92,23
1037685,50,17,1963,1,"female",605,31,14,63,25,63,20,0,5
1037691,25,2,1988,2,"male",221,103,47,12,0,12,0,0,0
1037707,65,7,1948,2,"male",1006,87,24,22,36,18,21,4,15
1037708,15,20,1998,6,"female",421,318,166,451,45,295,22,156,23
1037733,24,10,1989,12,"male",132,9,4,20,9,20,9,0,0
1037736,15,7,1998,6,"male",408,218,123,31,8,30,4,1,4
1037737,22,1,1991,10,"male",217,89,71,8,0,8,0,0,0
1037789,33,1,1980,1,"male",570,557,295,55,270,55,199,0,71
1037793,78,10,1935,3,"male",1388,43,16,186,23,0,20,186,3
1037825,72,14,1941,1,"male",270,32,8,1,0,1,0,0,0
1037837,31,18,1982,6,"male",454,2,2,0,1,0,1,0,0
1037860,54,4,1959,8,"female",741,28,9,0,0,0,0,0,0
1037925,60,3,1953,8,"female",566,36,18,9,5,9,2,0,3
1037929,38,14,1975,1,"female",1050,117,87,122,96,120,67,2,29
1037937,103,17,1910,9,"female",1037,634,246,33,17,0,9,33,8
1037943,63,30,1950,6,"female",697,22,9,17,13,0,5,17,8
1037948,26,17,1987,11,"male",238,282,144,47,140,47,75,0,65
1037962,23,8,1990,7,"male",47,70,53,15,8,15,2,0,6
1037975,20,30,1993,5,"male",713,653,399,15,1,15,1,0,0
1037984,18,21,1995,9,"male",1024,366,291,62,16,62,8,0,8
1038018,20,3,1993,10,"male",36,126,11,12,1,0,0,12,1
1038027,15,17,1998,6,"male",123,62,31,0,5,0,1,0,4
1038038,47,10,1966,5,"male",1818,48,38,28,23,26,22,2,1
1038054,50,28,1963,7,"female",1280,82,35,90,93,90,46,0,47
1038091,21,25,1992,5,"female",459,198,90,75,61,69,39,6,22
1038109,18,5,1995,6,"male",113,48,37,0,0,0,0,0,0
1038115,23,1,1990,1,"male",34,0,0,0,0,0,0,0,0
1038116,13,7,2000,3,"female",65,1045,244,224,201,224,140,0,61
1038151,56,2,1957,4,"female",410,3,3,0,0,0,0,0,0
1038167,30,21,1983,8,"male",591,134,74,19,13,19,4,0,9
1038189,35,25,1978,2,"female",217,38,23,1,4,0,4,1,0
1038193,23,30,1990,1,"female",260,46,21,16,66,11,35,5,31
1038204,55,1,1958,2,"male",1737,12,9,0,0,0,0,0,0
1038211,108,7,1905,11,"male",2485,37,8,52,47,0,32,52,15
1038220,19,12,1994,12,"male",718,105,80,1,0,1,0,0,0
1038253,31,19,1982,9,"female",456,76,40,181,84,181,32,0,52
1038257,37,23,1976,3,"female",2238,81,59,160,364,142,317,18,47
1038290,44,12,1969,11,"male",408,48,30,3,4,0,2,3,2
1038308,51,22,1962,1,"female",1821,206,53,1729,1713,1729,1624,0,89
1038313,36,17,1977,11,"male",1271,169,21,7,1,7,0,0,1
1038318,28,16,1985,6,"female",818,136,73,78,26,78,18,0,8
1038334,97,1,1916,3,"male",685,89,51,67,588,1,66,66,522
1038340,61,17,1952,1,"male",866,6,4,0,4,0,3,0,1
1038342,49,27,1964,5,"male",512,11,8,8,12,0,2,8,10
1038348,28,15,1985,9,"male",658,186,119,0,0,0,0,0,0
1038362,50,3,1963,9,"female",64,36,34,14,23,0,1,14,22
1038372,20,13,1993,3,"male",329,60,34,2,19,2,17,0,2
1038387,31,8,1982,7,"male",107,18,13,235,75,212,66,23,9
1038391,25,25,1988,12,"female",403,46,30,0,0,0,0,0,0
1038419,20,1,1993,10,"female",371,113,92,0,34,0,15,0,19
1038423,18,9,1995,5,"male",287,162,148,5,0,5,0,0,0
1038437,21,21,1992,9,"male",1077,274,146,26,68,26,11,0,57
1038445,39,24,1974,6,"male",680,88,72,35,21,35,7,0,14
1038480,37,13,1976,6,"male",174,20,15,12,0,12,0,0,0
1038494,19,14,1994,7,"male",1291,149,103,8,6,8,5,0,1
1038512,42,24,1971,1,"female",1038,241,136,136,378,1,306,135,72
1038531,62,5,1951,7,"female",405,28,18,13,51,0,11,13,40
1038541,16,1,1997,4,"male",467,16,13,0,0,0,0,0,0
1038549,63,29,1950,5,"male",1539,429,298,0,0,0,0,0,0
1038610,18,14,1995,1,"female",143,2,0,0,0,0,0,0,0
1038631,42,30,1971,8,"male",1035,609,363,20,34,20,24,0,10
1038663,17,9,1996,3,"male",475,220,103,64,1,0,1,64,0
1038694,49,13,1964,5,"male",496,23,17,14,2,14,1,0,1
1038712,32,19,1981,7,"female",224,5,2,5,0,5,0,0,0
1038733,50,17,1963,7,"male",261,23,18,1,1,1,1,0,0
1038751,53,28,1960,12,"female",1700,537,293,11,58,11,25,0,33
1038755,100,10,1913,10,"female",1729,39,19,703,163,703,111,0,52
1038756,22,8,1991,3,"female",141,252,111,163,118,15,52,148,66
1038772,21,9,1992,6,"female",243,277,156,316,419,177,200,139,219
1038791,27,4,1986,3,"female",284,39,24,22,3,22,0,0,3
1038792,18,19,1995,4,"male",67,177,134,2636,2433,1840,1430,796,1003
1038795,94,19,1919,9,"male",263,860,748,3078,4159,3078,3200,0,959
1038806,18,10,1995,9,"male",618,194,54,11,0,11,0,0,0
1038817,28,17,1985,3,"female",47,1,0,2,7,1,4,1,3
1038852,31,1,1982,11,"male",121,4,3,1,0,1,0,0,0
1038862,57,26,1956,3,"male",130,34,21,3,26,0,23,3,3
1038896,29,13,1984,3,"male",266,36,27,0,0,0,0,0,0
1038929,20,11,1993,11,"male",412,1059,653,30,10,30,10,0,0
1038932,25,20,1988,8,"male",536,61,54,3,1,0,0,3,1
1038967,20,11,1993,5,"male",430,23,18,4,2,2,0,2,2
1038976,35,11,1978,5,"male",849,611,525,7,9,0,4,7,5
1039024,21,3,1992,3,"male",2,85,84,1,2,1,2,0,0
1039040,26,1,1987,1,"female",13,1,1,1,0,1,0,0,0
1039050,14,10,1999,12,"male",176,74,64,3,0,0,0,3,0
1039052,19,26,1994,12,"male",1034,379,197,15,4,15,1,0,3
1039060,77,17,1936,9,"female",884,38,15,0,12,0,0,0,12
1039066,20,2,1993,6,"female",502,401,233,1197,657,856,263,341,394
1039090,69,6,1944,12,"male",1287,18,8,39,10,39,10,0,0
1039104,69,8,1944,9,"male",429,13,8,0,1,0,0,0,1
1039105,14,30,1999,6,"female",481,352,284,205,17,205,14,0,3
1039115,39,1,1974,2,"male",147,101,81,0,0,0,0,0,0
1039145,95,1,1918,9,"female",2335,109,44,2,17,0,6,2,11
1039152,65,24,1948,6,"male",32,40,39,1,9,0,3,1,6
1039156,25,7,1988,9,"male",448,26,11,1048,121,1048,70,0,51
1039159,51,29,1962,3,"female",711,292,209,503,141,4,51,499,90
1039168,31,10,1982,10,"male",494,5,4,1,0,0,0,1,0
1039187,16,3,1997,4,"female",707,795,332,56,76,24,35,32,41
1039197,48,6,1965,2,"female",1200,158,63,2314,1105,2173,870,141,235
1039248,18,15,1995,1,"male",216,15,11,0,0,0,0,0,0
1039288,31,25,1982,7,"female",148,39,28,109,129,103,61,6,68
1039293,23,10,1990,11,"male",160,1,1,1,0,1,0,0,0
1039304,23,10,1990,12,"male",277,33,14,1,5,1,4,0,1
1039318,49,2,1964,2,"female",496,175,99,20,175,20,170,0,5
1039327,23,20,1990,9,"male",221,100,70,0,1,0,1,0,0
1039332,60,26,1953,8,"male",603,57,8,1,3,0,2,1,1
1039337,34,8,1979,2,"female",277,142,84,0,0,0,0,0,0
1039342,21,8,1992,10,"female",658,8,7,26,25,0,10,26,15
1039379,16,18,1997,1,"male",52,265,137,177,315,177,278,0,37
1039404,42,18,1971,8,"female",498,1,0,2,0,2,0,0,0
1039407,55,14,1958,11,"male",997,25,1,0,0,0,0,0,0
1039412,53,4,1960,3,"female",16,67,57,434,148,0,22,434,126
1039452,17,24,1996,12,"male",527,90,74,0,0,0,0,0,0
1039460,73,16,1940,9,"female",1539,310,177,133,90,0,65,133,25
1039501,30,31,1983,8,"female",554,45,14,19,11,13,5,6,6
1039509,33,10,1980,9,"female",454,158,64,189,105,189,62,0,43
1039511,45,18,1968,7,"female",238,3,2,20,1,7,0,13,1
1039517,74,21,1939,7,"female",1688,115,38,107,33,107,26,0,7
1039519,64,21,1949,5,"male",271,123,23,71,677,71,521,0,156
1039539,33,7,1980,10,"female",838,112,20,35,211,35,157,0,54
1039573,31,5,1982,4,"female",544,162,98,16,5,6,4,10,1
1039575,20,24,1993,7,"female",123,367,161,4,50,0,39,4,11
1039591,24,2,1989,11,"male",368,425,286,2911,1534,2911,1422,0,112
1039613,56,19,1957,1,"male",85,93,77,57,103,30,79,27,24
1039619,16,18,1997,3,"female",335,411,103,2215,4014,1727,1948,488,2066
1039645,34,15,1979,6,"male",775,318,94,75,211,59,40,16,171
1039659,27,23,1986,8,"male",534,22,12,0,0,0,0,0,0
1039712,23,1,1990,1,"male",425,21,19,116,45,116,33,0,12
1039717,54,5,1959,4,"female",418,113,43,2,12,2,12,0,0
1039722,59,14,1954,10,"male",721,6,5,4,1,4,0,0,1
1039729,23,5,1990,12,"male",389,39,19,5,5,5,5,0,0
1039734,19,3,1994,8,"female",523,252,166,2,9,2,3,0,6
1039751,15,21,1998,4,"male",608,1349,965,9,9,2,1,7,8
1039752,37,22,1976,3,"male",347,26,20,1,0,1,0,0,0
1039791,55,17,1958,2,"female",870,97,32,0,0,0,0,0,0
1039806,22,1,1991,9,"male",433,59,42,1,0,1,0,0,0
1039810,36,7,1977,4,"male",786,119,71,13,4,12,1,1,3
1039889,32,25,1981,11,"male",200,30,17,12,34,12,21,0,13
1039898,16,17,1997,7,"male",307,172,95,4,0,4,0,0,0
1039903,65,11,1948,9,"female",377,49,39,145,2,145,1,0,1
1039909,58,13,1955,3,"female",978,182,107,1,9,1,9,0,0
1039920,17,29,1996,7,"female",611,63,16,1773,1286,1768,565,5,721
1039935,33,18,1980,12,"male",1293,401,117,32,25,7,10,25,15
1039951,108,30,1905,10,"male",1342,49,26,206,142,206,93,0,49
1039955,24,5,1989,7,"female",433,323,259,0,0,0,0,0,0
1040011,102,1,1911,1,"female",1597,170,104,155,81,2,19,153,62
1040036,47,15,1966,9,"female",425,452,263,5510,6389,4725,1279,785,5110
1040041,44,20,1969,8,"female",506,30,16,29,35,29,35,0,0
1040057,19,22,1994,4,"male",276,229,157,167,83,167,30,0,53
1040064,33,24,1980,9,"male",108,156,92,8,58,8,29,0,29
1040179,21,14,1992,3,"male",194,25,16,23,12,23,1,0,11
1040194,65,3,1948,11,"male",571,5,3,34,8,0,3,34,5
1040220,36,29,1977,9,"male",567,2,1,0,0,0,0,0,0
1040249,16,12,1997,7,"male",770,278,103,46,18,2,3,44,15
1040267,19,25,1994,2,"male",304,103,82,13,5,13,5,0,0
1040272,35,15,1978,4,"male",710,11,8,0,0,0,0,0,0
1040281,28,5,1985,7,"male",410,20,19,0,0,0,0,0,0
1040285,28,13,1985,8,"male",88,63,46,1,0,1,0,0,0
1040300,18,28,1995,7,"female",611,92,52,0,0,0,0,0,0
1040339,54,9,1959,8,"male",673,398,322,338,365,316,225,22,140
1040369,84,12,1929,6,"male",316,4,2,0,0,0,0,0,0
1040374,20,29,1993,8,"male",580,313,229,232,292,171,97,61,195
1040384,43,15,1970,6,"male",980,54,39,0,0,0,0,0,0
1040386,33,11,1980,4,"male",501,57,22,0,0,0,0,0,0
1040399,50,1,1963,4,"male",108,68,45,2,1,2,1,0,0
1040404,22,19,1991,3,"male",629,169,130,12,17,12,15,0,2
1040419,23,5,1990,5,"male",693,785,133,23,1,18,1,5,0
1040445,18,13,1995,4,"female",518,1819,1264,43,148,43,131,0,17
1040448,61,22,1952,4,"female",341,46,21,94,13,0,5,94,8
1040453,26,1,1987,1,"female",1827,193,25,87,159,48,72,39,87
1040455,24,17,1989,8,"male",707,80,60,52,1,52,1,0,0
1040481,35,5,1978,11,"female",173,48,27,8,20,8,19,0,1
1040517,22,25,1991,9,"male",31,11,11,11,0,11,0,0,0
1040581,20,17,1993,4,"female",105,7,1,102,0,0,0,102,0
1040608,37,7,1976,1,"male",90,32,28,1,5,1,4,0,1
1040653,23,1,1990,1,"male",360,202,135,25,16,13,10,12,6
1040715,17,10,1996,6,"female",152,43,36,200,108,0,43,200,65
1040718,34,7,1979,12,"male",663,7,2,0,0,0,0,0,0
1040725,66,5,1947,3,"female",1572,66,32,366,252,314,156,52,96
1040758,15,11,1998,5,"male",902,192,95,3,2,3,2,0,0
1040767,20,2,1993,12,"male",205,1950,98,19,52,19,46,0,6
1040783,56,2,1957,9,"female",174,156,140,451,77,1,47,450,30
1040807,63,25,1950,4,"female",633,49,22,4,16,0,11,4,5
1040847,33,26,1980,1,"female",154,31,19,1,5,1,4,0,1
1040858,33,6,1980,4,"male",54,18,13,0,0,0,0,0,0
1040866,30,29,1983,8,"female",576,115,30,103,125,100,69,3,56
1040883,48,1,1965,1,"male",1453,13,8,0,0,0,0,0,0
1040884,20,22,1993,8,"female",330,271,169,87,182,87,102,0,80
1040899,22,15,1991,10,"female",87,1,1,1,3,1,2,0,1
1040909,21,22,1992,11,"male",47,72,68,0,0,0,0,0,0
1040921,52,9,1961,11,"female",224,79,50,113,61,0,12,113,49
1040925,16,29,1997,11,"male",555,983,340,1965,782,1900,643,65,139
1040946,22,25,1991,9,"male",6,8,5,4,11,4,3,0,8
1040963,20,25,1993,10,"male",336,97,64,0,0,0,0,0,0
1041017,80,8,1933,5,"female",1704,501,221,138,65,99,55,39,9
1041071,30,25,1983,6,"female",505,30,7,0,0,0,0,0,0
1041081,100,2,1913,11,"female",1199,61,42,25,23,25,9,0,14
1041153,51,4,1962,11,"male",649,40,18,0,0,0,0,0,0
1041169,85,7,1928,8,NA,2222,9,1,1,1,0,0,1,1
1041220,55,19,1958,6,"female",1932,17,5,5,24,5,22,0,2
1041221,18,25,1995,9,"male",97,319,318,8,4,8,4,0,0
1041225,45,19,1968,10,"male",379,66,49,1,1,1,1,0,0
1041231,54,24,1959,9,"female",903,171,89,2055,141,0,18,2055,123
1041253,27,24,1986,6,"female",496,9,8,71,19,0,7,71,12
1041263,21,15,1992,3,"male",380,163,82,2,25,0,7,2,18
1041274,23,15,1990,4,"male",243,22,9,5,0,5,0,0,0
1041285,19,31,1994,10,"male",687,235,154,4,93,4,72,0,21
1041308,18,14,1995,12,"male",10,6,6,5,1,5,1,0,0
1041310,20,1,1993,3,"male",233,78,71,0,1,0,1,0,0
1041321,24,14,1989,6,"male",362,490,449,24,340,24,298,0,42
1041375,99,11,1914,5,"female",1125,243,113,309,102,29,21,280,81
1041376,19,9,1994,5,"male",335,3,3,0,0,0,0,0,0
1041392,18,24,1995,12,"female",254,123,25,0,19,0,8,0,11
1041398,86,19,1927,1,"male",1252,222,116,1165,288,54,90,1111,198
1041425,69,23,1944,4,"female",716,40,12,0,0,0,0,0,0
1041427,19,28,1994,12,"male",201,4,2,0,2,0,2,0,0
1041453,100,1,1913,1,"male",816,3,3,0,0,0,0,0,0
1041458,24,21,1989,5,"male",285,3,0,0,0,0,0,0,0
1041487,39,2,1974,11,"female",187,72,65,17,9,0,6,17,3
1041553,39,4,1974,10,"female",433,53,13,14,56,9,52,5,4
1041555,24,18,1989,5,"male",436,301,271,7,0,0,0,7,0
1041558,106,28,1907,2,"female",1229,158,91,37,52,0,34,37,18
1041599,22,2,1991,1,"male",483,156,86,124,166,124,141,0,25
1041605,20,22,1993,8,"male",421,475,96,15,95,15,93,0,2
1041612,44,16,1969,7,"male",1281,118,32,0,36,0,30,0,6
1041659,35,21,1978,3,"female",511,147,73,115,62,115,18,0,44
1041672,16,18,1997,12,"male",700,37,11,0,0,0,0,0,0
1041679,27,19,1986,6,"male",176,68,49,31,9,31,7,0,2
1041737,58,27,1955,7,"female",1267,75,15,132,44,56,26,76,18
1041744,32,23,1981,12,"male",149,29,14,0,1,0,1,0,0
1041757,30,9,1983,12,"male",1103,94,45,45,3,45,3,0,0
1041761,26,24,1987,10,"male",633,187,144,190,0,42,0,148,0
1041770,16,10,1997,3,"female",143,336,259,43,20,40,8,3,12
1041771,18,10,1995,8,"male",340,215,91,6,3,0,0,6,3
1041792,23,21,1990,6,"male",363,179,81,3,0,3,0,0,0
1041800,74,9,1939,2,"female",1679,54,30,27,9,27,8,0,1
1041807,34,13,1979,3,"female",2251,220,152,589,2595,574,2150,15,445
1041848,113,31,1900,12,"female",1302,76,28,151,58,0,12,151,46
1041886,35,1,1978,1,"male",493,103,19,11,1,11,1,0,0
1041888,54,2,1959,10,"female",313,8,6,0,0,0,0,0,0
1041894,51,26,1962,7,"female",1183,183,74,2,7,2,5,0,2
1041924,56,26,1957,4,"female",921,25,16,52,48,0,28,52,20
1041953,19,16,1994,2,"male",784,276,231,5,7,3,3,2,4
1041964,24,17,1989,8,"female",801,67,33,11,2,11,2,0,0
1041971,15,3,1998,4,"male",699,725,612,130,133,16,64,114,69
1041981,22,19,1991,6,"female",128,49,20,188,145,188,145,0,0
1041996,68,25,1945,3,"male",443,0,0,0,0,0,0,0,0
1042032,17,5,1996,2,"male",269,245,171,15,8,15,7,0,1
1042036,28,10,1985,10,"female",248,836,411,5445,1910,5445,1335,0,575
1042077,20,14,1993,6,"female",118,669,37,87,365,87,325,0,40
1042094,37,3,1976,8,"male",189,8,3,4,0,4,0,0,0
1042095,21,16,1992,6,"male",1170,2,2,0,0,0,0,0,0
1042096,42,29,1971,3,"male",283,232,214,8,2,0,0,8,2
1042098,56,12,1957,1,"female",638,20,9,179,38,0,30,179,8
1042103,20,6,1993,6,"male",224,104,40,184,4,174,3,10,1
1042105,15,20,1998,3,"male",78,75,56,11,4,2,0,9,4
1042114,25,2,1988,11,"female",325,252,219,3,106,3,83,0,23
1042120,64,10,1949,10,"male",1332,40,25,0,0,0,0,0,0
1042121,29,1,1984,3,"female",315,185,151,211,106,211,57,0,49
1042126,27,19,1986,5,"male",540,66,32,6,0,6,0,0,0
1042145,67,20,1946,4,"female",352,27,16,0,0,0,0,0,0
1042165,49,20,1964,12,"male",663,29,19,24,0,24,0,0,0
1042192,52,23,1961,12,"female",314,219,187,527,288,504,197,23,91
1042205,17,2,1996,5,"male",777,466,359,34,0,4,0,30,0
1042216,21,5,1992,2,"male",63,4,2,0,0,0,0,0,0
1042219,21,13,1992,4,"male",844,504,82,3,1,2,0,1,1
1042239,47,3,1966,6,"male",1020,50,27,26,8,0,5,26,3
1042243,19,30,1994,3,"male",658,41,22,0,0,0,0,0,0
1042265,27,1,1986,1,"female",1540,1770,888,318,834,274,597,44,237
1042283,20,3,1993,9,"male",565,1927,1556,12,1,0,0,12,1
1042317,19,28,1994,5,"male",502,615,434,529,946,529,834,0,112
1042357,18,27,1995,3,"female",1117,797,211,1246,278,1224,175,22,103
1042368,85,3,1928,7,"female",1195,75,37,565,142,495,17,70,125
1042385,19,28,1994,2,"male",798,202,152,0,1,0,0,0,1
1042399,55,27,1958,10,"female",383,23,12,90,20,90,9,0,11
1042424,25,3,1988,3,"female",157,68,39,731,653,107,197,624,456
1042425,23,15,1990,6,"male",267,29,17,36,22,35,22,1,0
1042427,29,10,1984,3,"male",385,86,50,18,134,16,83,2,51
1042443,46,6,1967,5,"male",60,1,1,0,0,0,0,0,0
1042460,50,15,1963,10,"female",1748,50,32,158,158,33,59,125,99
1042476,25,23,1988,8,"male",196,19,13,5,0,5,0,0,0
1042512,25,14,1988,3,"female",139,43,30,10,13,10,11,0,2
1042514,24,11,1989,1,"male",272,162,134,6,168,1,29,5,139
1042515,28,4,1985,2,"male",198,27,24,1,1,0,0,1,1
1042517,23,4,1990,10,"male",337,1572,943,399,1147,399,858,0,289
1042543,30,9,1983,3,"male",273,76,67,18,0,18,0,0,0
1042558,16,21,1997,4,"male",320,236,131,21,60,21,34,0,26
1042577,14,24,1999,2,"male",173,52,46,0,0,0,0,0,0
1042606,20,23,1993,10,"male",372,129,95,1,0,1,0,0,0
1042607,18,5,1995,3,"female",223,138,111,581,58,581,43,0,15
1042663,25,17,1988,4,"male",295,149,117,56,7,56,6,0,1
1042700,53,1,1960,7,"male",80,5,4,0,0,0,0,0,0
1042746,28,17,1985,4,"male",635,179,86,6,9,4,5,2,4
1042775,41,20,1972,2,"male",1702,101,44,332,541,332,113,0,428
1042783,21,18,1992,6,"female",1471,217,68,28,33,0,17,28,16
1042790,26,5,1987,3,"male",395,349,204,10,12,10,11,0,1
1042845,68,8,1945,8,"male",1491,384,192,37,16,37,9,0,7
1042868,19,1,1994,1,"male",299,61,48,2,12,2,3,0,9
1042887,15,10,1998,5,"female",34,566,533,639,157,174,51,465,106
1042907,14,20,1999,3,"male",116,3,3,0,0,0,0,0,0
1042935,26,6,1987,1,"male",1465,120,43,198,17,143,9,55,8
1042940,58,17,1955,9,"female",1455,75,19,36,37,36,31,0,6
1042980,32,25,1981,6,"male",477,117,98,32,22,32,17,0,5
1042995,19,7,1994,5,"female",568,1095,494,6980,10690,1298,5713,5682,4977
1043024,38,23,1975,1,"female",239,11,11,1,0,1,0,0,0
1043045,20,19,1993,3,"female",425,182,61,8,74,8,33,0,41
1043067,37,18,1976,4,"male",1263,117,54,24,47,24,43,0,4
1043069,50,17,1963,7,"male",68,8,8,15,8,11,2,4,6
1043079,21,23,1992,12,"male",219,834,680,1347,3020,1161,1850,186,1170
1043105,36,25,1977,9,"female",413,1,1,0,0,0,0,0,0
1043114,24,25,1989,9,"male",218,90,70,1,7,1,4,0,3
1043128,28,18,1985,6,"female",442,605,469,108,131,108,126,0,5
1043164,19,17,1994,8,"male",940,329,309,10,0,9,0,1,0
1043187,18,15,1995,5,"male",228,74,62,143,0,143,0,0,0
1043233,40,18,1973,9,"female",421,16,15,73,2,45,2,28,0
1043238,18,31,1995,10,"female",268,326,91,48,248,43,111,5,137
1043259,21,11,1992,9,"male",391,341,278,1,0,1,0,0,0
1043264,33,13,1980,5,"male",607,23,18,0,5,0,0,0,5
1043265,74,1,1939,1,"female",559,35,27,61,32,0,24,61,8
1043271,35,5,1978,11,"female",262,70,41,0,0,0,0,0,0
1043291,29,30,1984,10,"female",278,71,29,14,29,14,2,0,27
1043313,67,22,1946,5,"female",995,54,28,935,124,935,61,0,63
1043383,24,10,1989,11,"male",190,661,92,8,14,8,4,0,10
1043435,49,21,1964,4,"female",38,114,61,343,118,343,73,0,45
1043436,20,14,1993,11,"male",808,362,139,0,0,0,0,0,0
1043448,28,1,1985,8,"male",806,71,26,146,51,8,42,138,9
1043457,13,10,2000,3,"female",128,36,28,71,40,62,30,9,10
1043466,23,10,1990,9,"female",402,32,25,3,0,0,0,3,0
1043472,24,9,1989,7,"male",37,13,13,3,5,0,1,3,4
1043480,103,31,1910,12,"male",230,17,15,134,11,134,11,0,0
1043481,16,1,1997,11,"female",559,36,14,7,2,7,2,0,0
1043491,33,28,1980,10,"male",92,55,20,7,4,7,1,0,3
1043538,53,24,1960,9,"male",831,19,12,0,0,0,0,0,0
1043556,25,1,1988,1,"male",267,28,14,0,8,0,6,0,2
1043578,21,12,1992,11,"male",88,150,145,1439,200,1439,147,0,53
1043596,25,1,1988,1,"male",40,16,14,33,2,33,0,0,2
1043603,25,1,1988,1,"female",287,72,43,38,20,38,20,0,0
1043647,25,1,1988,1,"male",264,24,6,8,2,8,1,0,1
1043648,25,7,1988,8,"female",239,50,32,3,0,3,0,0,0
1043652,42,27,1971,9,"female",221,9,3,5,0,5,0,0,0
1043700,27,17,1986,2,"female",590,71,42,195,23,157,16,38,7
1043720,22,24,1991,9,"male",209,12,6,0,0,0,0,0,0
1043745,36,20,1977,2,"female",166,261,202,1027,522,1027,247,0,275
1043771,14,6,1999,10,"female",62,408,87,111,169,109,154,2,15
1043777,23,6,1990,1,"male",495,67,31,0,0,0,0,0,0
1043795,24,4,1989,2,"female",325,60,52,0,0,0,0,0,0
1043797,16,2,1997,3,"female",540,558,95,50,158,49,108,1,50
1043807,49,17,1964,7,"male",2229,131,76,7,27,2,2,5,25
1043822,36,6,1977,9,"male",472,135,78,48,23,12,9,36,14
1043901,28,9,1985,2,"female",519,45,28,0,0,0,0,0,0
1043967,20,30,1993,11,"male",246,40,14,5,49,4,40,1,9
1043989,25,15,1988,4,"female",591,120,50,441,464,441,443,0,21
1043991,57,8,1956,8,"male",1085,24,18,0,0,0,0,0,0
1044008,108,1,1905,1,"male",1576,227,181,172,68,172,48,0,20
1044010,24,22,1989,3,"male",95,105,84,4,64,4,38,0,26
1044060,16,19,1997,5,"male",80,29,18,24,6,24,6,0,0
1044068,36,15,1977,3,"female",448,58,30,167,235,99,131,68,104
1044069,17,7,1996,11,"female",448,950,377,112,103,112,86,0,17
1044096,28,5,1985,5,"female",636,198,131,9,16,9,4,0,12
1044099,19,14,1994,9,"male",346,52,34,0,1,0,1,0,0
1044140,60,20,1953,7,"female",1162,14,8,14,3,0,0,14,3
1044148,41,10,1972,3,"male",234,21,18,0,0,0,0,0,0
1044173,28,30,1985,4,"female",193,77,63,1,0,1,0,0,0
1044176,40,6,1973,6,"male",382,25,10,0,0,0,0,0,0
1044181,50,1,1963,1,"male",483,39,37,25,4,15,0,10,4
1044212,18,10,1995,9,"male",279,459,377,0,7,0,2,0,5
1044217,23,9,1990,10,"male",541,48,21,0,0,0,0,0,0
1044256,26,12,1987,2,"male",240,21,19,0,0,0,0,0,0
1044283,106,22,1907,3,"male",1563,589,276,281,309,3,94,278,215
1044286,29,27,1984,7,"male",241,20,9,0,0,0,0,0,0
1044295,97,4,1916,6,"male",1355,4112,2868,16,63,16,52,0,11
1044304,57,16,1956,6,"male",1456,344,213,86,76,86,58,0,18
1044306,67,9,1946,6,"female",474,546,366,9,0,8,0,1,0
1044326,31,5,1982,10,"female",306,220,41,116,115,98,63,18,52
1044369,85,3,1928,3,"female",1592,29,19,25,9,0,5,25,4
1044385,57,11,1956,10,"female",1558,147,67,305,20,305,12,0,8
1044386,41,20,1972,2,"female",273,18,13,0,0,0,0,0,0
1044397,53,22,1960,5,"male",633,319,262,14,26,1,17,13,9
1044417,14,18,1999,1,"female",422,139,53,63,6,63,6,0,0
1044422,27,18,1986,2,"male",696,346,163,48,91,48,62,0,29
1044440,25,10,1988,8,"male",389,73,61,142,2,142,2,0,0
1044459,100,21,1913,1,"female",1568,913,427,2,1,2,1,0,0
1044466,25,30,1988,7,"female",465,222,115,516,567,36,144,480,423
1044487,81,7,1932,4,"female",1952,67,32,3,4,0,3,3,1
1044498,36,7,1977,1,"female",340,265,116,2690,5290,2690,5045,0,245
1044519,16,30,1997,12,"male",248,23,18,3,1,2,1,1,0
1044520,21,13,1992,5,"female",320,4,3,0,0,0,0,0,0
1044539,61,16,1952,4,"male",698,25,17,0,0,0,0,0,0
1044545,20,26,1993,11,"male",871,755,373,2826,2478,2430,1675,396,803
1044554,63,22,1950,6,"male",1933,16,7,0,0,0,0,0,0
1044583,52,15,1961,3,"male",2229,497,177,57,149,57,85,0,64
1044592,22,10,1991,1,"male",244,182,145,0,3,0,1,0,2
1044617,52,1,1961,12,"male",268,17,14,4,1,4,1,0,0
1044657,20,16,1993,12,"male",425,25,13,1,1,1,0,0,1
1044664,50,21,1963,7,"female",241,22,19,22,2,22,2,0,0
1044668,62,1,1951,11,"female",239,84,51,279,63,279,53,0,10
1044682,14,31,1999,8,"female",268,662,315,222,47,48,20,174,27
1044687,22,16,1991,12,"male",745,174,76,457,120,59,22,398,98
1044710,18,12,1995,4,"female",199,157,90,95,73,95,70,0,3
1044711,33,1,1980,1,"female",379,24,10,0,0,0,0,0,0
1044714,43,5,1970,10,"male",94,3,1,0,0,0,0,0,0
1044717,55,15,1958,11,"male",992,66,15,6,27,6,12,0,15
1044742,15,27,1998,9,"male",303,36,27,0,0,0,0,0,0
1044746,26,8,1987,6,"female",188,195,71,531,889,531,565,0,324
1044748,20,19,1993,5,"male",704,741,464,56,771,56,668,0,103
1044764,45,23,1968,10,"male",360,26,20,96,33,96,30,0,3
1044782,25,15,1988,4,"male",631,121,34,0,2,0,1,0,1
1044820,93,17,1920,4,"female",1703,60,26,257,3,0,3,257,0
1044825,15,2,1998,4,"female",574,845,255,55,190,2,108,53,82
1044873,88,6,1925,10,"female",1724,59,30,3,8,0,2,3,6
1044898,27,18,1986,6,"male",545,174,110,6,20,6,13,0,7
1044922,18,18,1995,7,"female",47,53,33,141,69,141,60,0,9
1044927,48,22,1965,12,"female",215,64,54,17,13,17,8,0,5
1044948,25,23,1988,1,"male",76,68,56,21,6,21,5,0,1
1044950,63,8,1950,4,"male",466,65,52,2,0,2,0,0,0
1044962,38,31,1975,1,"female",1017,49,21,37,49,6,16,31,33
1045011,63,4,1950,12,"female",68,10,7,64,33,0,16,64,17
1045038,55,31,1958,12,"male",639,193,88,0,1,0,0,0,1
1045043,26,10,1987,11,"male",352,164,114,0,0,0,0,0,0
1045051,18,19,1995,10,"male",483,163,103,3,10,0,1,3,9
1045080,51,7,1962,10,"male",392,20,17,0,0,0,0,0,0
1045089,16,12,1997,2,"male",262,195,165,1,2,0,0,1,2
1045092,52,25,1961,4,"male",184,10,9,10,10,1,8,9,2
1045094,66,2,1947,10,"female",1795,39,14,4,5,4,5,0,0
1045098,14,26,1999,5,"male",339,35,26,4,3,0,3,4,0
1045146,18,13,1995,1,"female",469,3,3,0,0,0,0,0,0
1045150,18,31,1995,8,"female",796,1201,184,511,1694,502,1583,9,111
1045186,40,22,1973,2,"female",872,49,8,1,3,1,3,0,0
1045188,54,1,1959,11,"male",350,67,42,1,4,1,4,0,0
1045198,113,7,1900,4,"female",1497,479,267,152,188,85,102,67,86
1045206,99,14,1914,4,"female",637,122,88,1,11,0,8,1,3
1045208,43,20,1970,10,"male",367,64,48,6,62,6,52,0,10
1045212,48,6,1965,2,"female",492,116,85,230,52,230,47,0,5
1045240,18,14,1995,12,"male",478,342,152,62,66,7,35,55,31
1045252,20,9,1993,7,"male",926,269,160,108,100,43,30,65,70
1045261,52,9,1961,7,"female",244,16,10,3,15,0,8,3,7
1045296,30,14,1983,1,"male",176,22,20,0,0,0,0,0,0
1045309,22,30,1991,8,"female",683,177,37,82,174,0,33,82,141
1045330,18,3,1995,1,"male",22,7,6,3,1,0,0,3,1
1045340,32,30,1981,4,"male",97,74,39,0,0,0,0,0,0
1045374,17,24,1996,4,"female",606,909,358,393,1030,302,633,91,397
1045380,55,4,1958,4,"female",1262,223,89,299,262,296,65,3,197
1045391,49,13,1964,4,"male",330,12,4,0,0,0,0,0,0
1045401,14,1,1999,3,"male",40,117,77,533,30,533,28,0,2
1045408,53,3,1960,9,"female",1606,65,26,68,22,68,20,0,2
1045417,18,23,1995,11,"female",715,650,511,6,50,3,22,3,28
1045426,60,16,1953,4,"female",635,212,93,1,52,0,12,1,40
1045429,25,14,1988,2,"male",232,25,18,4,0,4,0,0,0
1045456,20,7,1993,11,"female",567,207,116,0,0,0,0,0,0
1045473,63,5,1950,10,"female",858,71,48,206,76,206,57,0,19
1045487,51,14,1962,2,"male",675,23,5,0,0,0,0,0,0
1045490,18,5,1995,8,"female",1100,1134,616,4583,2737,2626,1550,1957,1187
1045499,14,4,1999,1,"male",487,178,48,0,0,0,0,0,0
1045528,16,11,1997,3,"male",265,127,38,0,12,0,11,0,1
1045530,25,3,1988,2,"female",282,156,108,3,3,3,2,0,1
1045563,41,16,1972,9,"male",241,10,4,48,0,48,0,0,0
1045565,49,1,1964,9,"male",1156,868,623,37,7,37,5,0,2
1045581,22,18,1991,8,"male",18,20,14,10,12,9,8,1,4
1045590,29,11,1984,1,"male",91,50,47,1,4,1,4,0,0
1045603,68,7,1945,8,"female",1842,93,35,43,57,38,44,5,13
1045607,101,1,1912,9,"male",1946,217,156,81,79,0,46,81,33
1045639,55,28,1958,5,"male",534,11,2,0,0,0,0,0,0
1045658,17,14,1996,8,"female",623,190,66,1041,117,175,64,866,53
1045666,43,13,1970,10,"male",396,5,3,0,0,0,0,0,0
1045695,37,6,1976,7,"male",22,0,0,0,0,0,0,0,0
1045726,29,17,1984,3,"male",34,29,23,6,18,6,10,0,8
1045727,43,10,1970,7,"male",864,23,14,0,3,0,0,0,3
1045739,108,9,1905,9,"female",1487,120,48,39,119,35,100,4,19
1045752,61,6,1952,6,"male",1711,108,46,41,1,41,1,0,0
1045753,56,18,1957,8,"female",375,76,37,15,3,15,3,0,0
1045754,18,20,1995,8,"female",737,224,133,276,44,3,2,273,42
1045765,45,29,1968,6,"female",401,119,76,217,139,0,68,217,71
1045768,18,18,1995,8,"male",539,105,54,45,29,0,29,45,0
1045783,20,11,1993,11,"male",872,1454,590,1061,870,181,630,880,240
1045786,16,8,1997,9,"female",43,141,117,232,514,224,331,8,183
1045859,24,5,1989,6,"male",176,2,1,0,0,0,0,0,0
1045870,17,26,1996,12,"female",700,463,122,38,62,27,11,11,51
1045881,17,21,1996,11,"female",191,54,28,0,2,0,0,0,2
1045893,23,23,1990,11,"female",423,281,104,1121,390,1121,292,0,98
1045908,26,12,1987,8,"female",282,112,57,41,102,40,61,1,41
1045914,80,24,1933,12,"male",1562,152,76,0,1,0,0,0,1
1045917,53,12,1960,2,"male",417,39,19,3,5,1,2,2,3
1045974,27,30,1986,9,"female",45,159,120,1627,1052,1627,783,0,269
1045983,19,17,1994,7,"female",87,468,278,89,95,13,33,76,62
1046017,78,12,1935,12,"female",464,45,23,2,3,0,3,2,0
1046041,21,2,1992,2,"female",518,1,1,0,0,0,0,0,0
1046055,44,9,1969,7,"male",520,231,173,8,17,8,8,0,9
1046059,26,5,1987,6,"male",276,201,84,13,8,10,1,3,7
1046062,23,8,1990,7,"male",383,60,50,16,0,16,0,0,0
1046065,39,6,1974,1,"female",258,126,56,1057,497,1057,257,0,240
1046097,27,15,1986,12,"female",789,14,6,0,0,0,0,0,0
1046102,27,5,1986,9,"female",724,149,35,6,18,6,16,0,2
1046109,29,1,1984,1,"male",212,2,2,0,0,0,0,0,0
1046112,48,3,1965,3,"female",708,99,42,103,193,23,34,80,159
1046127,61,11,1952,12,"male",355,29,23,0,0,0,0,0,0
1046137,54,22,1959,9,"female",756,119,36,145,96,0,28,145,68
1046138,23,1,1990,11,"male",454,135,56,1,3,1,2,0,1
1046185,56,2,1957,4,"male",60,3,3,0,0,0,0,0,0
1046190,24,28,1989,3,"male",437,467,362,17,107,17,80,0,27
1046204,21,27,1992,5,"male",1117,968,555,151,414,146,310,5,104
1046207,15,28,1998,3,"male",426,247,174,1,8,0,3,1,5
1046212,15,23,1998,9,"female",717,323,131,2591,1322,686,709,1905,613
1046288,20,4,1993,2,"male",670,311,255,4,4,4,4,0,0
1046311,108,12,1905,8,"male",1227,715,455,105,56,48,31,57,25
1046334,78,20,1935,4,"female",1077,246,71,211,95,26,48,185,47
1046340,20,21,1993,5,"female",257,126,21,7,12,7,10,0,2
1046367,68,1,1945,1,"male",368,17,8,0,0,0,0,0,0
1046373,17,5,1996,8,"female",558,197,77,25,53,8,33,17,20
1046374,22,5,1991,4,"male",367,305,247,111,8,34,0,77,8
1046413,20,24,1993,1,"male",335,94,54,7,13,7,3,0,10
1046418,55,12,1958,3,"male",1416,1,1,121,112,45,62,76,50
1046455,60,3,1953,1,"female",798,30,7,15,1,15,1,0,0
1046464,26,1,1987,12,"male",20,114,105,2,3,1,1,1,2
1046504,23,3,1990,1,"female",309,82,52,3,1,3,1,0,0
1046547,23,11,1990,9,"female",376,85,31,63,52,63,20,0,32
1046560,23,20,1990,4,"female",266,99,56,165,58,165,50,0,8
1046574,29,1,1984,2,"female",229,291,187,98,96,93,42,5,54
1046590,14,26,1999,1,"female",297,206,140,56,140,26,84,30,56
1046613,26,5,1987,2,"male",180,11,8,1,1,1,1,0,0
1046623,66,2,1947,1,"female",2,9,8,1,17,1,14,0,3
1046641,15,10,1998,6,"male",493,40,24,4,0,4,0,0,0
1046652,26,12,1987,2,"male",89,8,8,2,7,0,2,2,5
1046659,19,4,1994,11,"male",715,356,115,285,65,28,36,257,29
1046668,65,24,1948,3,"female",726,26,16,4,0,0,0,4,0
1046691,28,15,1985,4,"male",296,65,55,23,9,23,7,0,2
1046705,49,26,1964,1,"male",635,69,13,0,3,0,0,0,3
1046707,74,7,1939,6,"male",1388,99,23,4,1,0,1,4,0
1046741,31,18,1982,12,"male",410,153,140,36,32,36,9,0,23
1046766,31,18,1982,5,"female",79,72,60,2,1,2,1,0,0
1046783,35,2,1978,9,"male",694,23,7,0,2,0,2,0,0
1046796,21,16,1992,5,"female",399,291,176,246,311,188,112,58,199
1046854,51,30,1962,9,"female",1541,178,80,155,138,154,94,1,44
1046861,23,31,1990,1,"male",434,194,150,0,0,0,0,0,0
1046871,30,8,1983,4,"male",753,45,29,3,1,1,0,2,1
1046882,18,6,1995,6,"male",92,31,20,0,1,0,0,0,1
1046916,31,1,1982,10,"female",133,582,133,14039,3274,14039,3077,0,197
1046943,42,2,1971,10,"female",105,124,80,23,24,23,17,0,7
1046945,62,27,1951,1,"male",199,14,10,3,9,0,5,3,4
1046949,21,27,1992,4,"female",1318,427,207,70,71,28,11,42,60
1046954,28,22,1985,3,"female",33,22,17,978,2465,26,679,952,1786
1046965,27,27,1986,5,"male",41,31,23,0,0,0,0,0,0
1046969,30,13,1983,3,"female",323,97,64,21,11,21,10,0,1
1046980,54,16,1959,11,"male",1836,139,32,14,19,14,16,0,3
1046992,19,20,1994,8,"female",397,3055,2199,8305,6801,1287,4027,7018,2774
1046996,18,25,1995,7,"female",603,23,5,1,1,1,1,0,0
1047011,18,5,1995,6,"male",367,364,330,13,0,0,0,13,0
1047020,15,3,1998,9,"female",23,212,164,13,20,2,2,11,18
1047021,69,11,1944,5,"male",866,65,19,27,122,0,62,27,60
1047027,18,1,1995,1,"male",67,53,44,0,0,0,0,0,0
1047028,23,1,1990,1,"male",407,74,60,0,7,0,3,0,4
1047048,19,19,1994,1,"male",394,20,11,7,15,7,7,0,8
1047054,19,1,1994,1,"male",575,376,360,156,85,156,80,0,5
1047058,26,1,1987,1,"male",75,26,12,0,0,0,0,0,0
1047105,29,1,1984,2,"male",199,37,18,0,0,0,0,0,0
1047132,32,15,1981,9,"male",735,0,0,0,0,0,0,0,0
1047153,18,5,1995,9,"male",98,267,51,16,47,15,30,1,17
1047159,58,7,1955,6,"female",1046,65,33,5,0,5,0,0,0
1047185,19,24,1994,5,"male",935,1385,738,712,649,167,105,545,544
1047270,75,17,1938,6,"female",1490,79,41,1,17,0,11,1,6
1047322,22,28,1991,12,"female",1056,754,298,384,485,342,292,42,193
1047323,22,24,1991,10,"female",982,186,103,2,0,0,0,2,0
1047351,42,27,1971,3,"female",1100,237,156,688,739,113,284,575,455
1047397,55,14,1958,5,"female",194,65,37,58,91,58,90,0,1
1047429,58,7,1955,3,"female",1719,162,121,1349,506,1338,133,11,373
1047446,42,3,1971,4,"male",428,35,18,23,1,23,1,0,0
1047465,108,16,1905,3,"male",79,88,73,30,0,0,0,30,0
1047469,22,16,1991,10,"male",539,71,47,2,13,0,7,2,6
1047501,37,15,1976,7,"male",381,140,22,0,0,0,0,0,0
1047520,30,6,1983,10,"male",33,0,0,0,0,0,0,0,0
1047530,29,11,1984,10,"male",361,46,38,1,6,1,5,0,1
1047538,53,8,1960,3,"female",266,43,30,160,0,160,0,0,0
1047543,38,13,1975,8,"male",612,9,5,0,0,0,0,0,0
1047576,22,20,1991,11,"male",453,207,181,2,2,2,2,0,0
1047580,26,1,1987,1,"female",273,10,10,0,0,0,0,0,0
1047582,24,27,1989,1,"male",377,108,91,5,29,2,15,3,14
1047585,19,9,1994,10,"male",172,101,70,26,39,26,36,0,3
1047592,21,16,1992,12,"male",11,4,2,30,6,0,1,30,5
1047595,61,13,1952,5,"male",1860,50,31,4,2,1,2,3,0
1047626,69,24,1944,10,"male",834,49,27,32,17,32,16,0,1
1047664,26,6,1987,2,"male",23,3,0,0,1,0,1,0,0
1047685,20,22,1993,11,"female",326,100,73,0,4,0,2,0,2
1047690,102,10,1911,8,"female",2293,1314,607,355,729,354,347,1,382
1047702,16,1,1997,1,"male",275,6,6,0,0,0,0,0,0
1047720,38,10,1975,10,"female",714,289,226,88,63,86,35,2,28
1047735,24,1,1989,1,"male",59,39,31,4,10,4,6,0,4
1047742,20,1,1993,6,"male",249,218,143,58,70,58,43,0,27
1047746,25,28,1988,3,"female",484,232,121,322,146,322,143,0,3
1047748,17,18,1996,9,"male",52,19,16,1,2,1,0,0,2
1047758,20,22,1993,1,"female",255,303,179,218,162,188,84,30,78
1047759,48,5,1965,12,"male",509,82,13,0,12,0,5,0,7
1047767,21,8,1992,9,"female",907,121,79,1,1,1,1,0,0
1047774,29,15,1984,11,"male",376,27,22,16,2,16,2,0,0
1047820,29,25,1984,2,"male",805,117,92,2,6,2,4,0,2
1047833,21,9,1992,7,"male",147,512,468,1,0,1,0,0,0
1047846,21,12,1992,10,"male",170,78,26,13,8,13,8,0,0
1047891,18,27,1995,3,"male",354,138,62,4,0,4,0,0,0
1047901,19,10,1994,10,"female",217,469,105,186,240,186,140,0,100
1047902,80,2,1933,10,"female",330,200,193,7395,361,7395,170,0,191
1047903,66,3,1947,2,"male",217,29,14,7,160,6,75,1,85
1047911,103,24,1910,11,"male",1304,254,180,1,1,0,1,1,0
1047942,50,15,1963,10,"male",237,0,0,0,0,0,0,0,0
1047957,20,18,1993,8,"female",281,236,99,54,43,54,38,0,5
1048010,16,8,1997,12,"male",85,40,26,4,3,4,2,0,1
1048045,62,24,1951,8,"female",794,42,37,21,18,21,5,0,13
1048048,23,22,1990,10,"male",648,108,96,2,1,2,0,0,1
1048055,54,29,1959,1,"female",374,33,24,1027,105,0,17,1027,88
1048076,41,20,1972,5,"female",211,77,3,0,2,0,1,0,1
1048088,29,13,1984,3,"male",18,4,4,8,0,8,0,0,0
1048113,48,25,1965,7,"female",820,42,24,1,1,0,1,1,0
1048122,18,24,1995,9,"female",269,61,28,40,13,0,2,40,11
1048129,18,25,1995,2,"male",279,180,93,1236,192,306,75,930,117
1048132,25,13,1988,12,"female",302,214,61,3,18,3,8,0,10
1048142,23,5,1990,10,"male",422,96,55,1,0,1,0,0,0
1048278,31,18,1982,11,"female",460,33,11,23,10,23,3,0,7
1048383,16,23,1997,11,"female",518,177,110,301,275,50,88,251,187
1048385,19,15,1994,3,"male",333,31,19,81,1,0,1,81,0
1048393,32,6,1981,9,"female",1023,169,102,917,922,813,192,104,730
1048406,28,17,1985,6,"female",532,236,62,1165,523,1165,504,0,19
1048409,28,3,1985,3,"male",652,0,0,0,0,0,0,0,0
1048416,30,25,1983,2,"female",475,178,89,45,0,45,0,0,0
1048477,37,1,1976,1,"male",638,6,5,78,16,74,16,4,0
1048500,34,27,1979,2,"female",49,8,7,7601,161,7601,106,0,55
1048511,73,6,1940,1,"female",1022,13,5,13,10,3,5,10,5
1048543,29,15,1984,10,"male",120,3,1,0,0,0,0,0,0
1048557,35,11,1978,10,"male",465,45,7,0,0,0,0,0,0
1048566,86,20,1927,3,"female",1642,134,69,94,34,46,12,48,22
1048577,103,9,1910,2,"male",1564,730,377,2,0,2,0,0,0
1048581,36,7,1977,6,"female",542,140,124,149,21,0,6,149,15
1048588,18,22,1995,8,"female",269,74,44,763,305,3,96,760,209
1048671,20,23,1993,1,"male",235,107,98,1,1,0,0,1,1
1048675,36,26,1977,1,"male",673,710,577,0,7,0,2,0,5
1048683,21,30,1992,1,"female",500,93,34,59,116,35,87,24,29
1048699,29,25,1984,5,"male",358,101,53,0,0,0,0,0,0
1048716,27,1,1986,2,"female",19,1,1,0,0,0,0,0,0
1048729,33,1,1980,1,"female",39,37,26,811,1626,709,828,102,798
1048740,32,1,1981,1,"male",12,0,0,0,0,0,0,0,0
1048752,29,15,1984,8,"female",424,130,115,94,46,94,34,0,12
1048776,21,30,1992,10,"male",249,24,19,3,4,3,4,0,0
1048824,100,7,1913,5,"male",1444,608,101,49,10,49,9,0,1
1048848,15,25,1998,5,"male",127,41,28,14,4,14,0,0,4
1048884,32,4,1981,8,"female",188,145,53,180,62,148,14,32,48
1048899,68,15,1945,7,"female",499,37,26,9,0,1,0,8,0
1048926,73,4,1940,12,"female",1088,20,12,0,0,0,0,0,0
1048935,23,14,1990,2,"female",382,21,12,32,4,32,4,0,0
1048995,25,7,1988,5,"female",440,42,34,1,0,0,0,1,0
1048996,18,18,1995,7,"male",218,132,108,0,9,0,8,0,1
1049031,24,23,1989,10,"male",29,10,2,4,6,4,3,0,3
1049032,26,18,1987,8,"male",429,90,50,32,53,0,44,32,9
1049062,19,19,1994,1,"male",513,43,9,39,22,39,4,0,18
1049074,29,2,1984,2,"male",359,56,31,41,24,41,24,0,0
1049096,16,6,1997,4,"male",335,90,46,4,3,4,2,0,1
1049097,48,11,1965,2,"male",296,46,29,263,335,253,218,10,117
1049101,25,27,1988,8,"male",483,19,14,0,3,0,1,0,2
1049162,33,23,1980,5,"male",1109,238,171,74,1,0,1,74,0
1049167,82,1,1931,11,"male",460,204,136,309,110,0,49,309,61
1049170,42,10,1971,9,"female",425,172,81,11,18,0,3,11,15
1049185,38,25,1975,5,"female",729,134,114,44,44,44,42,0,2
1049191,34,8,1979,1,"male",167,114,103,135,82,74,75,61,7
1049228,27,9,1986,6,"female",150,11,8,9,5,2,1,7,4
1049232,27,10,1986,5,"female",327,255,43,446,338,428,263,18,75
1049254,45,30,1968,6,"male",839,370,222,0,1,0,1,0,0
1049264,30,18,1983,4,"male",54,0,0,0,0,0,0,0,0
1049280,20,14,1993,7,"female",307,4,1,2,1,2,1,0,0
1049291,15,9,1998,3,"female",680,53,51,0,1,0,0,0,1
1049321,31,5,1982,9,"female",1036,200,140,916,1004,804,471,112,533
1049331,57,13,1956,10,"female",220,61,49,6,4,1,0,5,4
1049349,23,21,1990,7,"male",133,41,17,201,238,168,88,33,150
1049385,26,1,1987,12,"female",152,228,32,133,1,133,1,0,0
1049387,62,2,1951,4,"male",1818,28,6,0,3,0,1,0,2
1049396,22,22,1991,6,"female",236,16,10,10,10,5,5,5,5
1049400,69,29,1944,11,"male",1620,7,3,0,0,0,0,0,0
1049405,38,17,1975,2,"male",514,1026,190,822,3476,768,1003,54,2473
1049406,44,17,1969,8,"male",495,271,220,5,5,0,3,5,2
1049410,34,22,1979,9,"male",172,158,121,2,4,2,1,0,3
1049443,55,30,1958,4,"male",1850,123,73,41,65,41,64,0,1
1049519,18,19,1995,5,"female",209,338,175,18,63,18,56,0,7
1049523,63,30,1950,5,"male",1189,91,30,74,33,62,17,12,16
1049537,108,26,1905,4,"female",20,205,196,20,16,0,5,20,11
1049539,22,12,1991,2,"female",379,17,13,315,98,208,56,107,42
1049545,23,19,1990,9,"female",227,85,63,0,0,0,0,0,0
1049593,51,7,1962,4,"male",986,67,41,248,2,0,2,248,0
1049595,20,14,1993,2,"female",297,222,146,66,56,20,18,46,38
1049625,13,26,2000,7,"female",96,310,212,329,244,324,149,5,95
1049628,46,2,1967,9,"male",159,86,80,12,0,12,0,0,0
1049632,63,14,1950,2,"male",808,392,211,12,12,1,7,11,5
1049638,17,12,1996,9,"female",342,378,189,32,80,32,76,0,4
1049674,35,3,1978,12,"female",27,25,20,4,12,4,12,0,0
1049677,28,5,1985,1,"female",258,370,268,403,72,331,18,72,54
1049682,24,1,1989,10,"male",191,67,53,58,11,2,3,56,8
1049736,18,23,1995,5,"female",265,261,219,942,1154,942,617,0,537
1049741,24,23,1989,9,"male",191,18,14,2,9,1,3,1,6
1049752,65,9,1948,6,"male",232,41,24,1363,815,0,121,1363,694
1049779,57,17,1956,11,"male",1700,45,29,9,2,9,1,0,1
1049782,19,21,1994,3,"male",96,59,52,31,42,30,37,1,5
1049800,21,3,1992,1,"female",724,236,158,169,149,169,59,0,90
1049811,18,18,1995,9,"male",26,1,1,25,6,21,6,4,0
1049821,19,23,1994,9,"male",538,666,454,0,1,0,0,0,1
1049823,23,1,1990,1,"male",948,42,32,16,9,12,5,4,4
1049861,37,28,1976,11,"male",111,0,0,0,0,0,0,0,0
1049893,20,6,1993,6,"female",848,357,151,386,377,327,174,59,203
1049937,22,11,1991,11,"female",187,224,38,1917,781,1917,721,0,60
1049986,16,20,1997,11,"male",551,194,134,23,43,8,6,15,37
1050005,18,20,1995,2,"male",1166,156,53,14,16,14,13,0,3
1050008,25,15,1988,12,"female",157,35,23,0,1,0,1,0,0
1050023,52,10,1961,3,"female",1087,161,98,1387,612,1380,324,7,288
1050029,63,8,1950,2,"female",874,86,27,1,4,1,4,0,0
1050035,27,6,1986,12,"male",162,12,12,10,2,10,0,0,2
1050090,13,10,2000,2,"male",1150,271,160,0,0,0,0,0,0
1050115,35,6,1978,4,"female",209,2,1,0,0,0,0,0,0
1050127,15,14,1998,6,"female",511,309,173,7,1,7,1,0,0
1050163,24,14,1989,9,"male",315,118,88,152,102,152,42,0,60
1050173,32,8,1981,9,"male",945,150,30,104,0,104,0,0,0
1050227,54,1,1959,1,"male",79,3,3,1,0,0,0,1,0
1050243,26,30,1987,9,"male",309,70,63,3,2,0,1,3,1
1050291,15,30,1998,4,"female",96,157,123,31,1,31,1,0,0
1050295,39,22,1974,3,"female",164,45,39,245,235,242,48,3,187
1050317,16,10,1997,9,"male",10,53,48,6,20,6,9,0,11
1050319,108,26,1905,8,"male",1752,308,212,114,24,10,9,104,15
1050339,18,15,1995,5,"male",396,671,374,7,26,7,17,0,9
1050385,58,27,1955,9,"male",1367,693,452,4,1,4,0,0,1
1050402,25,7,1988,2,"female",648,3,2,8,1,0,1,8,0
1050435,46,15,1967,8,"female",34,49,28,7,22,1,8,6,14
1050470,32,2,1981,4,"male",92,48,33,11,33,11,25,0,8
1050481,27,25,1986,6,"male",528,184,134,0,0,0,0,0,0
1050488,34,28,1979,7,"male",696,56,51,13,2,13,2,0,0
1050498,19,7,1994,11,"male",430,118,57,0,1,0,1,0,0
1050549,25,8,1988,6,"male",128,65,43,27,8,27,6,0,2
1050550,22,1,1991,1,"male",152,10,6,0,0,0,0,0,0
1050551,36,19,1977,8,"male",625,38,32,60,5,60,5,0,0
1050552,18,27,1995,6,"male",288,290,265,65,4,65,2,0,2
1050563,27,16,1986,12,"female",79,0,0,0,0,0,0,0,0
1050603,27,18,1986,12,"female",1263,342,174,153,141,152,110,1,31
1050613,18,4,1995,3,"female",271,124,13,17,2,17,1,0,1
1050640,36,8,1977,7,"male",817,61,28,14,41,14,14,0,27
1050650,73,7,1940,5,"female",12,16,11,17,4,9,4,8,0
1050658,39,20,1974,1,"male",151,49,40,1,2,1,1,0,1
1050665,15,6,1998,10,"female",26,7,6,0,0,0,0,0,0
1050760,59,22,1954,7,"male",210,46,31,167,70,167,57,0,13
1050785,27,1,1986,11,"female",1213,0,0,0,0,0,0,0,0
1050830,30,31,1983,12,"male",394,93,59,49,102,49,86,0,16
1050838,47,21,1966,7,"female",499,122,48,101,166,8,26,93,140
1050848,31,16,1982,8,"male",308,37,12,14,68,14,45,0,23
1050858,32,18,1981,6,"male",964,133,98,69,0,69,0,0,0
1050871,27,8,1986,3,"female",402,54,3,188,223,188,222,0,1
1050886,103,10,1910,11,"male",1638,255,172,68,57,12,20,56,37
1050890,37,5,1976,10,"male",374,197,187,0,0,0,0,0,0
1050946,38,11,1975,3,"female",389,91,57,1053,89,1048,37,5,52
1050967,63,18,1950,3,"female",146,6,4,8,0,8,0,0,0
1050997,36,8,1977,7,"female",625,410,164,59,113,0,94,59,19
1051040,62,7,1951,4,"male",280,18,14,0,0,0,0,0,0
1051052,64,23,1949,8,"female",203,58,33,150,10,146,8,4,2
1051054,18,5,1995,6,"male",451,1652,1253,30,11,19,4,11,7
1051068,16,1,1997,2,"female",791,340,151,50,161,47,84,3,77
1051098,25,1,1988,1,"male",241,62,20,0,1,0,1,0,0
1051109,24,14,1989,7,"male",203,4,3,4,1,0,0,4,1
1051111,55,12,1958,8,"female",1513,51,26,225,84,0,55,225,29
1051118,66,21,1947,4,"female",89,57,49,437,79,0,34,437,45
1051119,29,13,1984,4,"male",648,109,44,12,30,9,27,3,3
1051124,48,6,1965,1,"male",49,6,5,28,0,28,0,0,0
1051178,54,1,1959,1,"male",178,18,16,4,6,0,2,4,4
1051286,39,4,1974,9,"male",423,8,4,5,1,5,1,0,0
1051308,17,4,1996,2,"male",270,1,1,1,1,1,1,0,0
1051320,28,5,1985,5,"male",561,47,40,2,0,2,0,0,0
1051362,17,3,1996,1,"male",623,107,69,0,0,0,0,0,0
1051385,66,26,1947,10,"male",667,99,82,2,6,0,2,2,4
1051390,56,28,1957,3,"male",702,31,26,18,11,18,8,0,3
1051398,21,13,1992,3,"female",1501,3353,1561,1346,2034,825,591,521,1443
1051447,53,14,1960,7,"male",535,24,14,1,14,0,1,1,13
1051454,17,28,1996,9,"male",334,3767,2168,766,1036,25,433,741,603
1051466,27,1,1986,8,"male",755,537,340,1182,351,1153,94,29,257
1051514,28,4,1985,5,"male",274,62,54,0,0,0,0,0,0
1051541,17,19,1996,4,"male",546,62,37,0,0,0,0,0,0
1051558,98,7,1915,1,"male",1169,718,371,791,1171,0,216,791,955
1051594,15,23,1998,9,"female",518,238,89,91,23,66,13,25,10
1051600,18,1,1995,2,"male",307,61,45,7,1,7,1,0,0
1051630,58,19,1955,6,"female",122,229,40,208,102,208,74,0,28
1051632,94,5,1919,2,"female",2144,178,76,171,81,171,79,0,2
1051638,26,7,1987,3,"male",564,276,177,175,38,175,21,0,17
1051645,27,3,1986,1,"male",403,246,175,112,119,112,70,0,49
1051646,28,4,1985,4,"male",364,7,5,1,0,1,0,0,0
1051669,19,20,1994,1,"female",27,12,6,15,2,15,2,0,0
1051675,15,20,1998,3,"male",681,342,119,5,1,1,0,4,1
1051682,19,19,1994,1,"male",394,51,28,9,1,0,1,9,0
1051689,54,14,1959,10,"male",1714,160,39,0,0,0,0,0,0
1051714,47,8,1966,12,"female",1361,50,24,270,470,135,359,135,111
1051759,24,27,1989,4,"male",427,90,69,8,5,7,1,1,4
1051770,43,19,1970,5,"female",444,34,12,0,0,0,0,0,0
1051771,23,4,1990,8,"female",476,175,105,8,2,0,0,8,2
1051831,25,26,1988,6,"male",267,106,87,69,44,69,40,0,4
1051861,18,22,1995,2,"male",513,248,159,287,72,21,22,266,50
1051863,34,18,1979,6,"male",1115,167,116,0,6,0,6,0,0
1051869,18,10,1995,11,"female",449,576,304,1816,1955,1722,1815,94,140
1051874,21,3,1992,2,"male",928,13,13,24,3,6,1,18,2
1051889,24,21,1989,3,"female",565,74,43,137,42,137,32,0,10
1051893,26,5,1987,5,"male",466,64,59,19,23,19,21,0,2
1051907,29,5,1984,6,"male",112,4,4,0,0,0,0,0,0
1051919,15,27,1998,3,"male",333,7,3,8,0,7,0,1,0
1052013,43,1,1970,8,"male",456,65,44,2,0,1,0,1,0
1052017,35,25,1978,7,"female",130,0,0,0,0,0,0,0,0
1052049,54,22,1959,7,"female",896,53,27,0,2,0,1,0,1
1052059,20,18,1993,9,"female",156,376,345,582,438,457,212,125,226
1052070,83,4,1930,2,"male",1077,40,27,2,8,2,8,0,0
1052073,55,14,1958,10,"female",1669,693,426,779,778,779,531,0,247
1052091,29,29,1984,4,"female",28,61,59,259,404,122,205,137,199
1052107,29,10,1984,2,"female",427,2,2,0,0,0,0,0,0
1052153,30,9,1983,5,"female",426,33,18,1,0,1,0,0,0
1052176,41,26,1972,10,"female",444,55,18,5615,5600,5615,3457,0,2143
1052178,25,1,1988,1,"male",46,26,26,94,48,94,44,0,4
1052204,68,23,1945,12,"male",741,202,166,110,51,105,43,5,8
1052206,83,30,1930,11,"male",674,277,112,97,84,8,25,89,59
1052318,23,6,1990,6,"female",2029,239,159,36,39,36,19,0,20
1052347,16,2,1997,7,"female",781,3876,2012,1,76,1,39,0,37
1052350,25,15,1988,1,"male",270,8,8,0,0,0,0,0,0
1052387,16,20,1997,7,"male",381,140,112,139,186,57,101,82,85
1052390,66,16,1947,10,"male",1460,16,3,0,0,0,0,0,0
1052404,52,13,1961,3,"male",1115,215,128,112,7,112,4,0,3
1052467,25,15,1988,10,"male",274,206,79,164,49,157,26,7,23
1052471,100,21,1913,1,"male",1657,29,9,1,2,1,2,0,0
1052479,44,7,1969,10,"female",267,10,2,1,1,1,0,0,1
1052493,31,1,1982,6,"male",218,84,31,0,0,0,0,0,0
1052549,38,28,1975,6,"male",626,5,3,2,0,2,0,0,0
1052557,16,3,1997,2,"female",356,356,165,797,271,689,174,108,97
1052559,21,12,1992,8,"male",46,38,36,14,3,14,2,0,1
1052565,21,20,1992,4,"male",225,342,82,517,106,377,89,140,17
1052567,19,18,1994,2,"female",678,462,210,2993,1212,2991,1167,2,45
1052598,53,28,1960,8,"female",576,44,34,2,0,2,0,0,0
1052607,56,19,1957,10,"male",458,5,4,0,0,0,0,0,0
1052608,42,12,1971,10,"female",510,91,37,67,98,66,54,1,44
1052609,30,3,1983,8,"male",546,24,15,0,0,0,0,0,0
1052614,108,25,1905,8,"male",1918,31,14,59,45,10,15,49,30
1052624,37,14,1976,1,"male",224,180,100,188,392,11,311,177,81
1052637,27,10,1986,11,"male",1019,308,174,13,28,4,24,9,4
1052660,108,1,1905,1,"male",1513,67,29,8,0,8,0,0,0
1052675,28,9,1985,11,"male",663,5,2,0,0,0,0,0,0
1052694,25,14,1988,12,"male",40,0,0,1,0,1,0,0,0
1052695,25,1,1988,1,"male",130,59,12,0,0,0,0,0,0
1052705,18,28,1995,7,"male",315,374,311,147,0,147,0,0,0
1052747,26,1,1987,1,"male",601,81,69,2,0,2,0,0,0
1052760,16,7,1997,2,"female",418,2970,415,7,39,6,30,1,9
1052782,33,24,1980,11,"female",631,219,112,10,11,10,7,0,4
1052791,24,11,1989,6,"male",280,132,63,12,0,12,0,0,0
1052792,39,1,1974,1,"female",98,0,0,0,0,0,0,0,0
1052819,40,7,1973,11,"male",334,25,10,24,0,24,0,0,0
1052827,35,5,1978,5,"female",82,115,108,271,337,271,254,0,83
1052837,63,30,1950,8,"female",510,78,11,0,39,0,27,0,12
1052873,21,11,1992,7,"female",567,852,457,8,11,8,5,0,6
1052880,32,11,1981,10,"female",630,316,76,375,587,183,227,192,360
1052936,14,26,1999,3,"female",496,200,146,90,0,90,0,0,0
1052953,23,3,1990,3,"male",69,20,19,17,5,17,4,0,1
1052972,31,14,1982,6,"male",102,0,0,0,0,0,0,0,0
1052982,15,26,1998,11,"female",576,362,237,100,11,8,0,92,11
1052986,19,10,1994,8,"male",428,254,176,0,36,0,30,0,6
1053008,24,12,1989,2,"male",762,308,248,307,213,307,167,0,46
1053023,34,27,1979,11,"male",227,53,18,14,4,14,3,0,1
1053032,20,16,1993,4,"male",591,76,50,0,7,0,7,0,0
1053033,95,15,1918,3,"female",1352,372,142,3,1,0,0,3,1
1053054,17,16,1996,7,"female",602,22,17,16,1,16,1,0,0
1053082,21,8,1992,8,"male",182,78,48,38,3,0,0,38,3
1053083,26,3,1987,10,"male",1396,98,37,356,40,324,35,32,5
1053086,57,10,1956,7,"female",307,150,131,175,70,175,30,0,40
1053087,55,14,1958,2,"female",656,112,56,71,73,71,51,0,22
1053088,46,3,1967,7,"female",245,76,51,6,0,6,0,0,0
1053097,24,10,1989,4,"male",347,36,27,7,25,6,1,1,24
1053103,66,30,1947,5,"female",1688,241,123,114,129,29,94,85,35
1053125,16,21,1997,6,"male",743,286,217,46,0,23,0,23,0
1053143,16,10,1997,5,"female",271,723,164,278,562,278,483,0,79
1053175,68,3,1945,3,"female",1802,148,94,39,15,1,2,38,13
1053189,55,4,1958,4,"female",428,29,21,0,0,0,0,0,0
1053200,23,25,1990,12,"male",363,140,111,2,10,2,5,0,5
1053207,18,9,1995,12,"female",131,130,98,177,34,177,20,0,14
1053268,45,31,1968,8,"male",258,86,8,0,0,0,0,0,0
1053280,63,23,1950,12,"male",847,197,138,0,7,0,5,0,2
1053301,42,10,1971,10,"male",126,5,3,0,0,0,0,0,0
1053318,63,2,1950,11,"female",1071,41,11,118,16,118,11,0,5
1053329,18,22,1995,2,"male",58,55,50,8,0,8,0,0,0
1053352,20,16,1993,12,"female",952,766,276,209,1162,3,555,206,607
1053372,22,14,1991,12,"female",389,294,110,1447,351,762,197,685,154
1053403,21,19,1992,8,"male",73,65,60,44,30,20,17,24,13
1053411,13,2,2000,1,"male",76,70,59,0,0,0,0,0,0
1053414,21,23,1992,12,"male",444,49,36,6,15,6,9,0,6
1053443,28,16,1985,9,"male",460,0,0,0,0,0,0,0,0
1053464,25,28,1988,2,"male",635,15,7,0,0,0,0,0,0
1053479,20,11,1993,6,"female",224,206,168,0,0,0,0,0,0
1053493,47,16,1966,6,"female",219,44,30,188,102,0,52,188,50
1053503,16,19,1997,10,"male",119,10,4,0,0,0,0,0,0
1053505,20,27,1993,12,"male",92,3,1,19,26,6,23,13,3
1053507,19,10,1994,9,"male",452,60,46,5,18,5,14,0,4
1053529,46,19,1967,2,"male",102,197,110,104,11,104,7,0,4
1053589,17,18,1996,4,"male",56,67,63,125,4,125,3,0,1
1053602,33,13,1980,8,"female",343,17,9,171,7,171,4,0,3
1053611,28,12,1985,9,"female",677,0,0,0,0,0,0,0,0
1053639,26,6,1987,11,"male",326,51,48,11,5,11,5,0,0
1053651,58,9,1955,12,"male",748,99,75,3,55,3,33,0,22
1053684,29,9,1984,6,"female",856,12,10,6,16,6,1,0,15
1053687,22,10,1991,9,"female",217,0,0,0,0,0,0,0,0
1053688,35,8,1978,1,"male",296,36,18,0,1,0,1,0,0
1053704,23,28,1990,11,"female",427,243,189,3,44,3,32,0,12
1053727,108,14,1905,12,"male",2368,574,242,206,324,196,264,10,60
1053733,16,1,1997,1,"female",464,91,30,0,0,0,0,0,0
1053743,33,3,1980,9,"male",29,2,2,0,0,0,0,0,0
1053752,21,5,1992,11,"female",629,870,567,404,475,357,319,47,156
1053762,50,22,1963,1,"male",418,18,14,0,0,0,0,0,0
1053776,30,3,1983,3,"female",283,9,1,0,0,0,0,0,0
1053781,18,15,1995,2,"female",398,336,251,34,17,0,1,34,16
1053791,71,9,1942,5,"female",316,61,21,77,8,0,1,77,7
1053808,20,27,1993,9,"male",1164,318,160,3,37,3,29,0,8
1053836,55,13,1958,1,"male",286,5,1,2,1,0,1,2,0
1053851,29,22,1984,9,"female",341,255,89,27,90,27,67,0,23
1053867,28,6,1985,11,"female",36,16,15,284,54,277,54,7,0
1053868,22,18,1991,3,"female",644,0,0,0,0,0,0,0,0
1053870,19,10,1994,4,"female",7,2,2,0,0,0,0,0,0
1053898,18,29,1995,4,"female",95,43,36,600,95,600,42,0,53
1053902,60,24,1953,2,"female",7,2,2,4,8,1,6,3,2
1053920,28,7,1985,1,"female",135,146,48,243,361,243,293,0,68
1053941,19,24,1994,12,"female",426,953,788,9,31,9,19,0,12
1053946,108,8,1905,4,"male",771,7,2,3,0,0,0,3,0
1053958,33,1,1980,8,"male",260,9,7,56,43,56,22,0,21
1053970,19,1,1994,1,"male",562,2,0,0,0,0,0,0,0
1053972,68,2,1945,1,"male",1078,20,13,0,0,0,0,0,0
1053994,18,4,1995,6,"male",510,648,548,0,0,0,0,0,0
1054000,15,1,1998,1,"male",294,97,72,74,23,56,21,18,2
1054033,27,5,1986,4,"male",50,12,10,2,2,0,2,2,0
1054036,14,6,1999,12,"male",146,60,47,0,2,0,2,0,0
1054038,33,22,1980,2,"male",490,41,14,5,7,5,7,0,0
1054075,33,26,1980,1,"male",21,5,5,5,5,5,5,0,0
1054083,19,28,1994,12,"male",493,220,165,30,2,30,2,0,0
1054107,29,25,1984,5,"male",380,32,11,0,0,0,0,0,0
1054110,27,23,1986,9,"female",480,256,169,62,898,62,761,0,137
1054135,28,4,1985,5,"female",185,52,39,7,1,7,0,0,1
1054139,18,10,1995,5,"female",409,44,40,0,0,0,0,0,0
1054143,59,17,1954,12,"male",1211,15,7,0,1,0,1,0,0
1054157,108,29,1905,10,"male",230,136,46,46,2,43,0,3,2
1054169,21,25,1992,3,"female",311,446,272,114,195,55,45,59,150
1054180,43,3,1970,4,"male",473,28,20,12,3,4,0,8,3
1054190,21,30,1992,7,"female",741,180,88,10,2,10,1,0,1
1054267,31,8,1982,3,"male",422,213,93,0,1,0,1,0,0
1054272,39,1,1974,4,"male",202,28,23,76,38,76,28,0,10
1054327,17,2,1996,1,"male",281,49,6,2,39,2,13,0,26
1054365,20,7,1993,7,"male",5,1,1,0,0,0,0,0,0
1054372,15,5,1998,7,"male",10,14,14,6,8,6,2,0,6
1054389,18,1,1995,1,"male",11,51,46,6,21,3,18,3,3
1054392,25,10,1988,4,"male",66,3,3,0,0,0,0,0,0
1054409,15,14,1998,7,"female",225,875,428,639,341,637,232,2,109
1054410,23,21,1990,6,"male",335,108,58,3,25,3,19,0,6
1054412,19,9,1994,1,"male",749,87,82,3,5,3,5,0,0
1054433,24,25,1989,11,"male",995,195,129,2,2,2,1,0,1
1054434,16,8,1997,7,"male",19,2,1,7,9,7,9,0,0
1054456,22,1,1991,3,"male",486,18,12,111,23,111,19,0,4
1054473,108,21,1905,2,"male",175,67,48,5,0,0,0,5,0
1054509,19,10,1994,8,"female",622,2560,925,3585,773,31,596,3554,177
1054559,103,10,1910,8,"male",1129,156,112,0,0,0,0,0,0
1054561,21,2,1992,7,"male",188,109,107,6,3,6,0,0,3
1054593,43,26,1970,10,"male",368,7,5,0,2,0,2,0,0
1054598,30,22,1983,2,"female",81,3,3,0,0,0,0,0,0
1054620,28,28,1985,9,"male",446,352,311,0,0,0,0,0,0
1054621,18,14,1995,5,"female",574,146,83,42,8,23,3,19,5
1054634,28,1,1985,3,"female",33,30,16,14,142,14,104,0,38
1054642,38,1,1975,11,"male",0,0,0,0,0,0,0,0,0
1054710,22,1,1991,1,"male",243,23,18,17,17,17,8,0,9
1054713,22,14,1991,4,"male",579,142,111,0,2,0,1,0,1
1054724,39,23,1974,6,"female",1268,428,240,180,318,180,238,0,80
1054739,24,2,1989,5,"female",67,314,290,107,457,107,431,0,26
1054759,21,22,1992,1,"male",502,30,20,28,20,13,5,15,15
1054760,31,20,1982,11,"male",690,3,2,0,0,0,0,0,0
1054768,108,20,1905,10,"male",842,22,8,1,2,0,0,1,2
1054805,22,14,1991,2,"male",35,41,40,19,0,19,0,0,0
1054829,38,20,1975,6,"male",482,24,11,6,5,0,4,6,1
1054830,21,13,1992,2,"male",182,29,20,0,0,0,0,0,0
1054831,39,5,1974,6,"female",241,40,25,38,1,38,1,0,0
1054849,14,4,1999,3,"female",70,16,11,0,0,0,0,0,0
1054860,16,15,1997,1,"female",392,455,213,1080,2012,1077,982,3,1030
1054872,19,10,1994,2,"male",8,37,29,0,7,0,1,0,6
1054873,18,20,1995,10,"female",424,1596,1264,735,1379,411,1169,324,210
1054891,65,19,1948,1,"female",460,25,21,6,0,6,0,0,0
1054930,66,4,1947,7,"female",1865,51,24,7,0,0,0,7,0
1054944,108,30,1905,9,"male",1261,92,64,0,0,0,0,0,0
1054952,23,26,1990,11,"male",435,118,72,0,0,0,0,0,0
1054975,65,15,1948,1,"female",1416,25,10,0,0,0,0,0,0
1054991,47,23,1966,1,"male",522,0,0,0,0,0,0,0,0
1054999,18,13,1995,1,"female",418,435,219,6,13,6,12,0,1
1055021,21,3,1992,10,"male",587,93,65,12,27,12,27,0,0
1055062,66,17,1947,3,"female",215,49,32,211,183,0,31,211,152
1055071,66,1,1947,7,"female",670,240,161,754,932,260,604,494,328
1055072,15,26,1998,6,"male",144,99,64,11,1,11,1,0,0
1055094,31,14,1982,7,"male",1380,140,36,0,1,0,0,0,1
1055108,23,11,1990,3,"female",138,51,21,171,980,170,238,1,742
1055112,26,26,1987,10,"male",623,24,7,0,0,0,0,0,0
1055131,19,10,1994,9,"male",598,927,797,175,26,12,15,163,11
1055136,15,5,1998,4,"male",314,61,32,13,0,0,0,13,0
1055156,94,30,1919,5,"female",234,314,92,4,6,4,4,0,2
1055165,23,8,1990,9,"female",265,122,79,80,36,80,35,0,1
1055176,31,12,1982,12,"female",75,218,46,239,77,239,55,0,22
1055206,14,2,1999,5,"male",405,13,11,0,0,0,0,0,0
1055231,56,5,1957,9,"female",697,31,16,20,7,18,5,2,2
1055241,70,18,1943,12,"female",508,34,26,29,31,22,20,7,11
1055298,62,12,1951,5,"female",1365,28,18,1,0,0,0,1,0
1055338,73,6,1940,5,"female",311,188,163,34,13,34,9,0,4
1055360,51,11,1962,11,"male",376,2,0,0,0,0,0,0,0
1055379,23,2,1990,5,"male",128,9,8,0,0,0,0,0,0
1055381,76,27,1937,7,"female",131,12,10,1,3,0,0,1,3
1055387,21,5,1992,8,"female",381,6,2,1,0,1,0,0,0
1055389,61,2,1952,1,"male",357,11,6,0,0,0,0,0,0
1055406,49,1,1964,2,"male",257,12,7,1195,87,1195,73,0,14
1055439,109,29,1904,2,"male",1272,54,20,3,1,3,1,0,0
1055450,67,23,1946,7,"female",1831,61,21,33,14,30,6,3,8
1055469,16,18,1997,2,"male",313,416,347,2,65,2,58,0,7
1055477,59,19,1954,6,"female",163,56,19,15,1,15,1,0,0
1055499,25,9,1988,4,"male",631,192,99,1,4,1,4,0,0
1055504,33,5,1980,3,"female",798,1,1,3,1,3,1,0,0
1055510,35,3,1978,12,"male",738,65,20,0,1,0,1,0,0
1055519,108,1,1905,1,"male",1124,152,96,579,485,0,133,579,352
1055531,22,15,1991,6,"male",32,24,23,0,0,0,0,0,0
1055537,25,28,1988,4,"female",461,14,10,98,50,94,48,4,2
1055539,34,10,1979,11,"female",260,48,21,0,0,0,0,0,0
1055553,17,2,1996,1,"female",364,271,27,0,10,0,2,0,8
1055608,14,10,1999,5,"female",321,1019,811,148,156,24,54,124,102
1055613,51,11,1962,8,"female",1487,276,158,255,206,236,71,19,135
1055615,32,10,1981,8,"male",406,89,68,0,1,0,1,0,0
1055632,46,27,1967,4,"male",541,0,0,0,0,0,0,0,0
1055658,17,7,1996,7,"male",225,166,113,0,0,0,0,0,0
1055673,18,4,1995,6,"female",17,1,1,0,0,0,0,0,0
1055674,22,10,1991,4,"male",359,17,15,0,7,0,7,0,0
1055691,28,27,1985,10,"male",325,16,8,0,0,0,0,0,0
1055695,14,21,1999,12,"male",297,173,62,1,24,0,22,1,2
1055706,19,15,1994,7,"female",183,118,76,61,5,3,4,58,1
1055740,18,24,1995,9,"female",560,173,38,18,28,18,26,0,2
1055744,50,18,1963,2,"male",421,28,12,31,0,0,0,31,0
1055775,38,5,1975,10,"male",756,94,69,8,10,8,8,0,2
1055776,36,1,1977,6,"male",574,100,61,0,5,0,3,0,2
1055793,36,24,1977,3,"female",624,61,42,2,0,0,0,2,0
1055801,28,21,1985,10,"female",339,113,91,0,3,0,0,0,3
1055804,67,20,1946,6,"female",1459,111,65,1813,156,1721,100,92,56
1055811,58,12,1955,8,"female",949,60,24,908,190,403,98,505,92
1055817,18,21,1995,7,"male",461,52,36,3,0,3,0,0,0
1055829,108,1,1905,1,"female",76,28,21,102,6,0,2,102,4
1055853,35,23,1978,11,"female",282,106,63,74,37,31,33,43,4
1055878,18,17,1995,10,"female",445,1921,858,8719,584,8142,251,577,333
1055920,25,16,1988,11,"female",149,38,30,10,27,10,19,0,8
1055925,56,6,1957,3,"female",55,52,35,35,103,35,44,0,59
1055974,14,14,1999,6,"female",92,698,81,1,5,0,0,1,5
1055993,31,27,1982,10,"female",442,162,73,378,308,378,97,0,211
1056013,21,17,1992,11,"female",375,143,100,898,441,898,428,0,13
1056016,26,5,1987,3,"male",61,66,22,3,5,0,1,3,4
1056044,108,1,1905,6,"male",1042,3,3,0,0,0,0,0,0
1056065,23,4,1990,3,"male",393,471,342,152,54,147,46,5,8
1056066,75,7,1938,6,"male",723,22,11,0,0,0,0,0,0
1056113,32,25,1981,4,"male",569,45,0,0,0,0,0,0,0
1056238,18,28,1995,1,"male",437,1206,1067,857,960,232,585,625,375
1056274,70,20,1943,7,"female",370,11,7,3,1,3,1,0,0
1056280,24,19,1989,1,"female",756,183,65,0,12,0,2,0,10
1056291,24,21,1989,11,"male",45,45,44,1,5,1,5,0,0
1056292,15,6,1998,7,"female",182,142,12,0,0,0,0,0,0
1056305,42,15,1971,9,"male",227,24,22,0,7,0,3,0,4
1056321,15,4,1998,6,"female",517,278,150,27,3,9,1,18,2
1056327,55,16,1958,3,"female",415,70,45,1345,125,1337,68,8,57
1056376,20,27,1993,10,"female",716,67,37,2,20,2,19,0,1
1056377,26,1,1987,1,"male",515,14,11,0,0,0,0,0,0
1056379,69,13,1944,9,"female",1403,77,9,640,122,166,63,474,59
1056414,38,5,1975,2,"male",165,74,55,0,0,0,0,0,0
1056469,68,2,1945,11,"male",622,21,19,26,1,0,0,26,1
1056503,26,18,1987,11,"male",575,8,5,0,0,0,0,0,0
1056505,25,27,1988,4,"female",932,121,91,1768,332,1768,301,0,31
1056529,28,15,1985,8,"male",71,5,1,0,0,0,0,0,0
1056532,27,1,1986,2,"female",305,10,5,59,147,0,0,59,147
1056536,60,22,1953,10,"male",323,130,93,4,13,4,12,0,1
1056588,16,16,1997,12,"male",318,454,317,2,5,2,5,0,0
1056606,46,13,1967,5,"female",779,50,41,27,5,27,2,0,3
1056608,25,4,1988,1,"male",189,20,7,0,0,0,0,0,0
1056617,51,3,1962,12,"male",585,95,56,275,233,78,148,197,85
1056622,27,12,1986,10,"male",13,1,1,8,8,0,0,8,8
1056633,52,12,1961,5,"male",330,67,49,101,72,101,35,0,37
1056659,63,22,1950,2,"female",37,7,5,0,0,0,0,0,0
1056661,21,6,1992,9,"male",493,1038,709,578,721,578,612,0,109
1056664,103,7,1910,8,"male",1664,287,173,146,17,99,14,47,3
1056672,39,1,1974,9,"female",292,23,17,4,12,4,9,0,3
1056698,75,4,1938,4,"male",295,241,37,2,2,0,1,2,1
1056722,17,30,1996,3,"female",290,465,259,130,29,1,9,129,20
1056744,59,9,1954,4,"male",782,25,11,36,17,36,14,0,3
1056758,16,17,1997,1,"male",0,0,0,0,0,0,0,0,0
1056775,93,15,1920,6,"female",897,131,51,79,28,41,19,38,9
1056801,18,20,1995,8,"male",158,31,19,0,1,0,1,0,0
1056817,58,29,1955,4,"male",413,93,42,0,0,0,0,0,0
1056829,42,28,1971,8,"female",507,77,37,16,3,0,3,16,0
1056851,45,8,1968,10,"female",1756,117,58,572,401,114,176,458,225
1056858,62,5,1951,2,"female",773,355,49,1319,414,9,78,1310,336
1056872,57,26,1956,10,"male",299,170,14,1,3,0,0,1,3
1056895,23,10,1990,12,"female",464,101,55,21,6,20,6,1,0
1056903,17,20,1996,5,"female",1151,2184,1584,3156,9863,610,3244,2546,6619
1056906,63,17,1950,7,"male",1729,42,32,2,1,1,0,1,1
1056949,22,5,1991,11,"male",487,375,249,82,230,61,48,21,182
1056961,23,15,1990,4,"male",560,65,41,8,38,8,28,0,10
1056975,23,11,1990,1,"male",688,282,143,0,2,0,2,0,0
1057003,103,24,1910,4,"female",937,609,203,0,0,0,0,0,0
1057005,57,1,1956,12,"male",1374,419,211,36,2,34,0,2,2
1057013,26,5,1987,1,"male",254,35,29,182,76,182,45,0,31
1057071,21,15,1992,6,"male",438,170,113,87,69,63,31,24,38
1057077,34,24,1979,9,"female",212,5,5,0,0,0,0,0,0
1057129,17,8,1996,7,"female",296,296,95,844,12,844,6,0,6
1057170,62,18,1951,5,"female",103,46,44,43,16,37,3,6,13
1057185,103,1,1910,1,"female",996,123,45,1213,373,715,232,498,141
1057216,18,29,1995,7,"male",123,313,224,31,117,31,92,0,25
1057271,33,27,1980,6,"female",50,112,87,277,128,277,108,0,20
1057294,15,15,1998,5,"female",493,14,10,20,0,20,0,0,0
1057331,24,19,1989,7,"male",465,211,155,8,9,8,5,0,4
1057340,20,10,1993,10,"male",76,151,81,2,39,2,35,0,4
1057341,22,26,1991,2,"male",1234,99,71,4,1,4,0,0,1
1057366,23,28,1990,2,"male",396,38,32,0,0,0,0,0,0
1057367,28,23,1985,10,"male",27,38,10,3,3,3,2,0,1
1057375,17,1,1996,1,"male",415,126,88,0,0,0,0,0,0
1057377,35,4,1978,7,"female",135,279,36,83,22,83,13,0,9
1057390,113,27,1900,10,"male",1680,162,105,1,3,1,0,0,3
1057408,38,3,1975,6,"male",496,25,11,44,0,35,0,9,0
1057421,19,7,1994,11,"female",100,123,107,11,10,11,10,0,0
1057425,53,19,1960,8,"female",1158,127,28,457,142,457,76,0,66
1057431,26,11,1987,7,"female",291,171,129,178,132,145,130,33,2
1057476,14,22,1999,11,"male",165,176,102,2,25,2,12,0,13
1057484,39,28,1974,1,"male",157,215,63,19,12,19,12,0,0
1057521,67,9,1946,12,"female",1277,132,49,96,19,20,17,76,2
1057536,25,13,1988,12,"male",374,218,187,187,310,173,287,14,23
1057539,41,7,1972,11,"female",360,159,125,165,140,165,109,0,31
1057545,66,4,1947,1,"male",704,18,12,0,0,0,0,0,0
1057548,59,24,1954,10,"male",343,78,61,51,2,51,2,0,0
1057564,18,6,1995,7,"male",256,82,46,0,14,0,11,0,3
1057593,18,3,1995,1,"female",520,450,215,749,794,89,217,660,577
1057596,33,6,1980,5,"male",446,74,41,5,9,5,7,0,2
1057605,23,27,1990,2,"male",25,91,90,0,0,0,0,0,0
1057626,15,12,1998,10,"male",18,0,0,0,0,0,0,0,0
1057628,25,12,1988,1,"male",444,31,19,16,3,0,2,16,1
1057633,62,10,1951,3,"female",450,300,228,0,0,0,0,0,0
1057676,27,19,1986,9,"male",219,62,55,31,22,31,19,0,3
1057708,53,6,1960,10,"male",228,12,11,0,0,0,0,0,0
1057731,20,12,1993,9,"female",262,1552,636,1032,1761,1022,1132,10,629
1057739,16,5,1997,1,"male",314,80,50,0,0,0,0,0,0
1057796,50,5,1963,3,"female",336,68,37,38,1,28,0,10,1
1057806,16,5,1997,11,"male",322,34,23,3,2,3,2,0,0
1057866,75,2,1938,7,"female",581,21,17,23,10,23,9,0,1
1057867,108,7,1905,3,"male",983,307,175,27,15,27,11,0,4
1057889,14,21,1999,11,"female",444,591,402,525,841,507,462,18,379
1057922,22,1,1991,3,"male",232,44,37,4,5,0,3,4,2
1057938,17,14,1996,12,"male",312,80,69,4,13,4,13,0,0
1057953,20,13,1993,7,"male",756,298,112,40,166,40,136,0,30
1057960,57,20,1956,6,"male",733,73,53,110,17,0,8,110,9
1057988,25,6,1988,4,"male",404,0,0,1,0,1,0,0,0
1057993,53,18,1960,2,"female",1476,245,60,1191,1618,1089,1268,102,350
1058009,21,15,1992,8,"female",1744,412,173,5544,3201,3193,1595,2351,1606
1058034,25,1,1988,1,"male",659,110,47,0,0,0,0,0,0
1058038,105,30,1908,4,"male",360,65,38,4,3,4,1,0,2
1058054,23,8,1990,4,"male",470,247,100,16,42,16,5,0,37
1058059,32,24,1981,10,"female",592,692,400,1630,1003,1189,574,441,429
1058067,20,3,1993,3,"male",76,18,12,11,16,11,12,0,4
1058069,24,12,1989,2,"male",487,437,339,0,4,0,4,0,0
1058093,46,6,1967,9,"female",93,187,143,791,361,528,178,263,183
1058107,19,25,1994,10,"male",683,78,52,1,0,1,0,0,0
1058110,72,30,1941,5,"male",935,3,1,0,0,0,0,0,0
1058134,65,11,1948,2,"female",567,70,22,15,48,15,22,0,26
1058152,24,26,1989,4,"male",217,53,37,2,7,2,4,0,3
1058171,24,28,1989,8,"female",211,540,436,490,555,468,388,22,167
1058213,42,15,1971,12,"male",399,4,2,0,2,0,2,0,0
1058228,53,12,1960,8,"female",722,870,222,14,70,14,54,0,16
1058230,18,28,1995,12,"male",107,51,48,165,151,138,57,27,94
1058247,24,1,1989,6,"male",229,125,107,1,0,0,0,1,0
1058285,18,25,1995,10,"male",696,35,19,0,0,0,0,0,0
1058304,19,19,1994,4,"male",359,71,44,343,70,9,40,334,30
1058331,33,31,1980,1,"female",244,151,65,30,76,22,30,8,46
1058333,28,19,1985,3,"female",170,79,67,15,7,12,7,3,0
1058345,34,3,1979,4,"male",207,28,8,0,1,0,0,0,1
1058347,23,1,1990,1,"male",263,1,0,0,0,0,0,0,0
1058355,46,30,1967,5,"male",1171,7,4,1,1,0,1,1,0
1058358,67,7,1946,9,"female",177,20,14,0,1,0,1,0,0
1058361,37,1,1976,7,"male",164,88,46,15,26,13,16,2,10
1058367,46,20,1967,10,"female",664,8,8,0,0,0,0,0,0
1058384,25,14,1988,7,"female",429,27,10,5,5,3,3,2,2
1058405,15,25,1998,11,"male",108,92,90,0,4,0,0,0,4
1058428,39,18,1974,1,"male",969,12,9,0,0,0,0,0,0
1058475,23,15,1990,2,"male",378,496,400,1524,466,1524,274,0,192
1058477,29,11,1984,11,"male",437,99,78,0,10,0,10,0,0
1058510,19,5,1994,8,"male",57,170,137,42,54,3,7,39,47
1058531,14,1,1999,1,"male",397,127,93,6,8,0,0,6,8
1058533,16,10,1997,8,"female",617,1094,262,61,111,61,24,0,87
1058569,21,17,1992,9,"female",294,158,136,0,0,0,0,0,0
1058583,18,29,1995,8,"male",95,71,47,21,0,21,0,0,0
1058590,24,9,1989,5,"male",356,127,58,0,2,0,1,0,1
1058605,23,25,1990,5,"male",1481,383,108,10,23,10,10,0,13
1058630,43,1,1970,1,"male",68,3,1,18,1,18,1,0,0
1058654,20,23,1993,3,"female",379,22,15,5,8,5,3,0,5
1058660,14,18,1999,12,"male",146,371,280,43,118,43,117,0,1
1058684,16,2,1997,2,"male",47,35,31,41,15,41,15,0,0
1058691,17,5,1996,3,"male",604,536,378,479,305,250,129,229,176
1058695,51,27,1962,2,"female",665,415,239,957,844,4,318,953,526
1058717,15,11,1998,11,"male",36,17,14,0,0,0,0,0,0
1058723,97,27,1916,8,"male",1612,770,403,272,288,75,112,197,176
1058740,22,27,1991,1,"male",173,140,44,2,1,2,0,0,1
1058743,36,25,1977,11,"female",289,53,36,485,321,480,119,5,202
1058764,61,10,1952,3,"female",396,4,2,0,0,0,0,0,0
1058817,39,16,1974,7,"male",246,29,15,3,0,0,0,3,0
1058850,14,29,1999,5,"female",380,346,267,81,36,81,35,0,1
1058881,86,24,1927,4,"female",1646,132,47,9,6,0,6,9,0
1058901,29,20,1984,2,"male",871,124,90,0,0,0,0,0,0
1058925,16,11,1997,7,"male",643,47,27,2,4,0,2,2,2
1058928,27,15,1986,5,"male",161,72,56,3,4,3,4,0,0
1058959,108,5,1905,3,"female",1267,21,16,1,4,0,0,1,4
1058967,31,19,1982,11,"male",592,55,27,21,3,21,3,0,0
1058978,51,25,1962,11,"female",53,110,103,203,24,203,23,0,1
1059025,19,13,1994,1,"male",297,48,35,67,32,67,30,0,2
1059026,28,12,1985,3,"male",533,337,309,1,3,1,2,0,1
1059054,26,5,1987,6,"male",465,57,26,0,0,0,0,0,0
1059062,33,16,1980,11,"male",144,154,118,0,0,0,0,0,0
1059113,26,4,1987,5,"male",116,1,1,16,0,7,0,9,0
1059143,31,15,1982,2,"female",1321,64,52,59,20,56,16,3,4
1059172,24,19,1989,10,"male",787,292,215,27,2,11,1,16,1
1059179,28,14,1985,4,"male",127,0,0,0,0,0,0,0,0
1059208,39,1,1974,6,"male",477,73,41,3,76,3,47,0,29
1059225,103,31,1910,5,"female",1759,404,186,137,55,81,31,56,24
1059234,31,5,1982,4,"male",299,83,76,2,0,2,0,0,0
1059237,32,15,1981,5,"female",455,129,91,84,24,84,23,0,1
1059278,68,17,1945,8,"male",100,602,572,946,104,946,98,0,6
1059301,22,6,1991,7,"male",38,85,81,19,0,0,0,19,0
1059303,50,29,1963,6,"male",512,73,35,0,0,0,0,0,0
1059313,25,1,1988,1,"male",2,0,0,0,0,0,0,0,0
1059349,20,23,1993,11,"female",399,184,58,54,93,44,80,10,13
1059360,27,15,1986,3,"male",660,37,14,0,1,0,0,0,1
1059361,55,28,1958,3,"male",108,16,11,1,0,0,0,1,0
1059375,47,5,1966,9,"male",209,66,35,9,21,4,18,5,3
1059376,68,14,1945,1,"male",981,809,593,4,1,4,1,0,0
1059381,28,25,1985,3,"female",449,57,24,0,2,0,1,0,1
1059424,103,14,1910,10,"male",842,230,191,7,2,0,1,7,1
1059496,22,6,1991,8,"male",10,3,2,9,6,9,4,0,2
1059565,46,22,1967,11,"female",288,32,15,112,20,112,7,0,13
1059579,19,15,1994,10,"male",232,117,27,65,131,51,68,14,63
1059580,108,1,1905,1,"male",861,5,2,6,4,0,0,6,4
1059643,17,3,1996,1,"male",403,54,33,387,110,352,55,35,55
1059672,23,7,1990,5,"male",1343,220,172,145,38,137,32,8,6
1059673,20,10,1993,12,"male",527,26,14,6,0,6,0,0,0
1059684,15,14,1998,7,"male",133,81,78,0,4,0,2,0,2
1059710,51,24,1962,3,"male",475,140,106,49,23,49,3,0,20
1059715,18,7,1995,1,"male",277,87,81,20,114,20,52,0,62
1059722,20,2,1993,7,"female",33,53,51,61,0,61,0,0,0
1059774,14,21,1999,2,"male",243,473,343,3,24,0,0,3,24
1059777,17,27,1996,11,"male",55,68,64,0,0,0,0,0,0
1059840,100,14,1913,10,"female",1832,475,215,103,40,88,30,15,10
1059848,101,28,1912,12,"male",1876,348,152,193,85,145,62,48,23
1059856,53,10,1960,1,"female",773,25,16,0,0,0,0,0,0
1059867,21,13,1992,4,"male",7,0,0,0,0,0,0,0,0
1059872,56,3,1957,9,"female",469,11,4,0,1,0,0,0,1
1059873,34,21,1979,1,"male",1112,110,56,10,5,10,4,0,1
1059898,18,24,1995,8,"female",311,187,132,50,24,42,6,8,18
1059918,36,18,1977,1,"female",295,28,23,136,22,77,11,59,11
1059966,18,22,1995,5,"male",441,579,494,13,34,4,14,9,20
1060000,55,16,1958,7,"male",924,13,8,34,19,0,2,34,17
1060002,20,26,1993,3,"male",1476,380,268,1,0,1,0,0,0
1060021,68,4,1945,6,"male",320,125,64,1,1,0,0,1,1
1060052,19,24,1994,8,"male",487,139,99,0,0,0,0,0,0
1060069,100,1,1913,10,"male",165,86,73,47,27,43,14,4,13
1060075,25,1,1988,1,"male",161,3,1,0,0,0,0,0,0
1060077,24,19,1989,6,"female",1360,854,417,1271,1520,1038,1004,233,516
1060094,16,2,1997,12,"female",256,0,0,0,0,0,0,0,0
1060096,38,27,1975,10,"male",50,17,12,0,8,0,7,0,1
1060120,82,28,1931,6,"male",228,219,154,84,112,0,20,84,92
1060136,30,1,1983,1,"male",406,166,136,26,3,26,3,0,0
1060155,51,4,1962,4,"female",48,67,60,51,16,1,4,50,12
1060219,18,1,1995,6,"male",22,9,9,0,2,0,1,0,1
1060230,24,14,1989,4,"male",140,22,17,1,10,1,10,0,0
1060233,17,17,1996,6,"male",52,480,447,7587,1246,799,723,6788,523
1060243,25,25,1988,12,"female",63,36,13,0,0,0,0,0,0
1060247,74,29,1939,11,"male",378,2,2,30,2,30,2,0,0
1060251,21,14,1992,5,"female",276,261,110,30,53,22,36,8,17
1060262,19,18,1994,9,"male",699,250,191,10,16,10,16,0,0
1060268,27,25,1986,4,"female",522,148,90,2,6,2,2,0,4
1060272,22,15,1991,9,"male",405,366,213,62,125,25,66,37,59
1060306,30,15,1983,6,"female",838,401,198,268,400,232,186,36,214
1060321,19,17,1994,5,"male",554,36,27,0,0,0,0,0,0
1060324,77,31,1936,1,"male",1493,39,14,10,0,10,0,0,0
1060332,22,26,1991,11,"female",788,40,6,68,13,68,8,0,5
1060338,49,28,1964,1,"male",483,90,33,232,12,232,8,0,4
1060393,15,17,1998,6,"female",268,913,408,186,657,163,519,23,138
1060399,33,10,1980,10,"female",408,0,0,0,0,0,0,0,0
1060409,54,29,1959,10,"male",1577,33,21,66,48,26,5,40,43
1060413,22,13,1991,12,"male",747,238,151,2,0,0,0,2,0
1060431,15,28,1998,5,"female",671,202,69,119,0,118,0,1,0
1060441,40,23,1973,6,"female",464,12,8,34,43,34,29,0,14
1060489,53,4,1960,6,"male",1705,124,73,1,0,1,0,0,0
1060512,18,5,1995,6,"male",722,473,299,67,92,46,75,21,17
1060534,21,1,1992,1,"female",1159,995,209,66,153,66,116,0,37
1060546,21,27,1992,5,"female",1457,836,367,1050,486,845,305,205,181
1060551,56,23,1957,2,"male",402,33,19,2,4,2,3,0,1
1060600,103,9,1910,6,"male",1363,276,172,42,3,3,1,39,2
1060617,19,11,1994,3,"male",109,938,778,2094,2379,1156,1179,938,1200
1060630,44,9,1969,10,"female",151,32,30,11,14,11,3,0,11
1060646,94,19,1919,3,"male",1184,1464,443,201,654,7,215,194,439
1060665,49,30,1964,10,"female",395,97,73,1,2,1,1,0,1
1060687,69,20,1944,10,"female",453,103,50,3,38,0,25,3,13
1060701,103,1,1910,1,"male",545,232,155,10,7,10,6,0,1
1060703,18,3,1995,12,"female",1007,1143,648,2895,1791,2430,1154,465,637
1060707,55,13,1958,3,"female",1030,191,89,406,446,336,297,70,149
1060726,19,6,1994,7,"male",751,262,207,0,1,0,1,0,0
1060741,73,3,1940,3,"female",614,17,10,13,0,13,0,0,0
1060744,35,1,1978,1,"female",239,47,36,8,4,7,3,1,1
1060746,29,1,1984,2,"female",208,55,35,65,30,56,21,9,9
1060748,33,27,1980,10,"male",604,86,53,20,27,14,13,6,14
1060754,22,12,1991,1,"female",702,246,60,34,14,33,9,1,5
1060759,50,2,1963,5,"male",173,155,96,53,43,0,10,53,33
1060768,14,8,1999,2,"female",355,263,217,8,0,0,0,8,0
1060806,23,7,1990,2,"female",361,34,29,2,6,0,4,2,2
1060827,33,19,1980,7,"male",232,51,16,0,1,0,1,0,0
1060846,19,16,1994,4,"male",206,118,91,3,3,3,3,0,0
1060860,27,14,1986,9,"female",409,2,1,0,0,0,0,0,0
1060864,35,29,1978,6,"female",263,283,180,666,51,666,19,0,32
1060879,21,11,1992,1,"female",471,531,54,246,323,246,178,0,145
1060881,32,16,1981,11,"male",1179,415,373,0,12,0,9,0,3
1060885,52,14,1961,7,"male",107,45,33,58,7,58,3,0,4
1060890,41,2,1972,1,"female",527,272,78,57,96,42,72,15,24
1060903,25,1,1988,1,"female",91,3,2,1,0,0,0,1,0
1060916,21,15,1992,4,"male",525,43,27,0,2,0,2,0,0
1060946,23,25,1990,11,"male",401,125,96,1109,28,1009,8,100,20
1060959,35,10,1978,8,"male",30,54,43,2,1,2,0,0,1
1060970,15,12,1998,12,"male",130,47,34,0,4,0,3,0,1
1060973,61,1,1952,1,"male",534,8,2,0,0,0,0,0,0
1060994,90,25,1923,3,"female",1688,163,76,1296,826,1051,290,245,536
1060999,15,14,1998,6,"female",184,63,35,52,2,45,0,7,2
1061019,41,9,1972,1,"male",443,0,0,0,0,0,0,0,0
1061025,35,28,1978,4,"male",79,237,157,315,105,315,99,0,6
1061057,26,1,1987,7,"male",402,112,67,9,1,8,0,1,1
1061064,25,8,1988,8,"male",122,137,112,339,75,337,62,2,13
1061072,23,21,1990,8,"male",27,0,0,0,0,0,0,0,0
1061073,15,5,1998,5,"male",287,65,63,2,1,0,0,2,1
1061101,31,16,1982,4,"male",309,54,36,3,5,3,1,0,4
1061104,21,18,1992,9,"female",56,9,8,4,10,4,9,0,1
1061154,22,19,1991,11,"male",973,456,305,5,0,0,0,5,0
1061159,18,16,1995,2,"female",1000,2493,888,511,1804,511,1635,0,169
1061164,23,10,1990,6,"female",437,66,16,0,0,0,0,0,0
1061208,33,13,1980,1,"male",931,144,84,20,135,20,97,0,38
1061215,15,13,1998,4,"male",237,415,311,395,197,321,165,74,32
1061225,18,3,1995,10,"male",454,207,152,196,40,74,15,122,25
1061227,14,4,1999,12,"male",100,24,14,0,0,0,0,0,0
1061243,21,8,1992,4,"female",533,30,7,31,9,31,8,0,1
1061248,23,11,1990,12,"male",233,15,9,1,0,1,0,0,0
1061290,38,5,1975,4,"female",1645,181,95,2488,1373,336,196,2152,1177
1061300,23,1,1990,8,"male",412,65,55,9,0,9,0,0,0
1061301,30,27,1983,5,"female",98,146,92,15,0,15,0,0,0
1061305,17,27,1996,1,"male",266,171,91,1,1,1,0,0,1
1061313,59,14,1954,1,"male",297,13,8,25,1,25,1,0,0
1061330,15,16,1998,6,"male",50,17,13,154,114,151,22,3,92
1061337,28,24,1985,2,"female",558,113,53,138,11,138,9,0,2
1061350,18,1,1995,2,"male",222,73,68,50,5,50,4,0,1
1061381,64,13,1949,11,"male",1551,29,8,62,68,0,43,62,25
1061391,19,11,1994,2,"male",580,20,15,48,35,41,22,7,13
1061472,15,1,1998,1,"male",45,9,6,0,0,0,0,0,0
1061494,40,28,1973,3,"male",770,7,6,0,0,0,0,0,0
1061499,25,4,1988,10,"male",479,119,52,10,13,6,6,4,7
1061589,106,20,1907,5,"female",1387,235,72,22,16,22,10,0,6
1061609,23,31,1990,10,"male",762,25,5,0,0,0,0,0,0
1061621,60,21,1953,1,"female",89,58,43,2,14,0,10,2,4
1061623,76,26,1937,4,"female",537,20,17,0,1,0,1,0,0
1061635,68,16,1945,2,"male",14,33,27,15,1,0,0,15,1
1061646,24,4,1989,5,"male",395,2,0,0,0,0,0,0,0
1061665,48,10,1965,2,"male",126,2,2,1,0,0,0,1,0
1061669,37,11,1976,9,"male",236,0,0,4,0,0,0,4,0
1061682,35,20,1978,3,"female",235,157,147,1,1,1,1,0,0
1061703,33,16,1980,8,"male",333,36,13,7,2,2,2,5,0
1061706,32,4,1981,7,"female",397,2,1,0,0,0,0,0,0
1061709,51,8,1962,1,"male",452,61,46,112,78,60,67,52,11
1061724,29,6,1984,4,"male",215,1,0,0,0,0,0,0,0
1061730,50,15,1963,4,"male",501,49,23,52,53,52,34,0,19
1061734,22,1,1991,1,"female",410,31,20,204,12,139,11,65,1
1061810,81,21,1932,10,"female",1240,22,21,4,1,0,0,4,1
1061860,51,7,1962,2,"male",620,757,402,8,114,0,30,8,84
1061868,15,15,1998,6,"female",514,49,29,161,233,161,109,0,124
1061942,24,18,1989,2,"male",833,339,151,126,48,126,31,0,17
1061963,38,3,1975,10,"male",575,62,48,50,17,50,10,0,7
1061993,48,3,1965,1,"male",260,0,0,0,0,0,0,0,0
1061999,30,19,1983,12,"male",608,124,99,0,1,0,1,0,0
1062006,55,11,1958,1,"male",735,48,21,9,1,0,0,9,1
1062050,62,4,1951,11,"male",1078,122,81,0,0,0,0,0,0
1062057,68,14,1945,3,"male",323,51,41,54,1,52,1,2,0
1062060,20,20,1993,4,"female",564,172,88,350,272,67,218,283,54
1062088,14,8,1999,8,"male",244,401,158,325,6,106,1,219,5
1062132,44,30,1969,5,"male",302,53,29,952,828,952,632,0,196
1062133,63,11,1950,10,"male",612,2630,1655,1031,753,1031,638,0,115
1062149,18,8,1995,9,"female",471,98,39,0,0,0,0,0,0
1062157,20,27,1993,12,"female",69,399,47,2,2,2,1,0,1
1062158,35,3,1978,3,"male",400,13,13,0,2,0,2,0,0
1062162,69,26,1944,10,"female",991,59,32,147,74,147,42,0,32
1062185,35,18,1978,9,"male",1239,156,89,10,19,7,16,3,3
1062200,17,15,1996,4,"male",325,142,51,451,2,451,2,0,0
1062240,19,5,1994,8,"male",216,45,32,40,13,40,13,0,0
1062248,14,25,1999,11,"male",382,181,37,28,13,28,12,0,1
1062275,108,12,1905,5,"male",920,460,225,50,38,0,10,50,28
1062326,57,27,1956,9,"male",1005,38,19,1,6,0,6,1,0
1062351,25,1,1988,1,"male",403,4,4,11,3,2,1,9,2
1062366,23,25,1990,10,"male",777,110,54,9,5,9,5,0,0
1062368,38,17,1975,7,"male",341,70,50,3,0,3,0,0,0
1062416,20,3,1993,11,"male",179,210,68,91,492,6,271,85,221
1062437,18,30,1995,11,"female",630,540,395,154,430,154,363,0,67
1062552,39,29,1974,10,"female",748,176,124,0,0,0,0,0,0
1062603,35,10,1978,4,"male",55,145,125,789,438,789,261,0,177
1062640,15,3,1998,2,"female",672,164,68,80,108,76,94,4,14
1062663,19,2,1994,9,"female",438,54,14,0,0,0,0,0,0
1062666,24,16,1989,2,"male",529,446,212,549,342,542,165,7,177
1062680,19,22,1994,8,"male",252,76,68,1,4,1,3,0,1
1062683,23,5,1990,2,"male",352,79,45,1,1,1,1,0,0
1062726,13,2,2000,1,"male",80,133,112,15,2,0,0,15,2
1062729,28,26,1985,11,"female",141,1,0,7,0,7,0,0,0
1062739,64,20,1949,11,"male",469,0,0,0,0,0,0,0,0
1062743,15,27,1998,12,"male",309,219,81,8,1,8,0,0,1
1062753,21,10,1992,4,"male",275,456,319,372,306,364,211,8,95
1062769,22,10,1991,6,"male",200,189,182,18,1,18,1,0,0
1062843,26,24,1987,7,"male",269,53,30,0,0,0,0,0,0
1062850,33,28,1980,10,"male",389,16,6,0,0,0,0,0,0
1062877,18,1,1995,1,"male",46,50,39,89,53,25,7,64,46
1062885,16,11,1997,9,"male",603,146,113,4,3,4,2,0,1
1062940,19,17,1994,2,"male",279,48,15,31,148,28,103,3,45
1062965,16,12,1997,10,"female",396,129,46,73,53,0,0,73,53
1062979,22,9,1991,6,"female",394,15,5,0,0,0,0,0,0
1062984,42,13,1971,6,"male",472,54,25,0,2,0,1,0,1
1062999,19,5,1994,8,"male",502,60,54,0,0,0,0,0,0
1063026,25,1,1988,1,"male",2,11,9,12,6,12,6,0,0
1063041,19,28,1994,10,"male",150,19,19,0,2,0,0,0,2
1063084,103,28,1910,4,"female",1139,298,178,413,218,413,177,0,41
1063091,23,2,1990,5,"female",882,259,71,162,403,3,115,159,288
1063153,58,21,1955,6,"female",1621,75,19,20,11,0,9,20,2
1063181,39,5,1974,9,"female",497,67,37,271,57,250,45,21,12
1063194,71,18,1942,12,"female",616,27,20,0,0,0,0,0,0
1063197,20,12,1993,4,"female",498,130,45,0,0,0,0,0,0
1063240,108,11,1905,4,"female",1029,702,209,30,344,10,206,20,138
1063247,64,27,1949,11,"male",1125,821,430,47,295,47,160,0,135
1063258,25,11,1988,1,"female",958,428,153,194,75,194,61,0,14
1063277,70,4,1943,10,"male",929,58,27,96,3,96,2,0,1
1063311,25,1,1988,1,"male",218,113,51,2,0,2,0,0,0
1063318,21,12,1992,10,"male",12,0,0,0,0,0,0,0,0
1063366,28,2,1985,9,"male",556,179,150,83,52,60,22,23,30
1063381,17,11,1996,9,"male",351,94,68,2,1,2,1,0,0
1063395,35,10,1978,1,"male",420,101,37,14,97,6,56,8,41
1063409,45,24,1968,6,"female",491,74,41,72,9,72,8,0,1
1063446,40,23,1973,11,"male",816,2,2,0,0,0,0,0,0
1063447,20,1,1993,9,"male",849,41,16,33,15,12,8,21,7
1063470,17,10,1996,10,"female",666,483,56,5,245,5,172,0,73
1063507,37,2,1976,6,"male",482,19,9,3,1,3,1,0,0
1063544,17,4,1996,5,"female",439,18,9,0,10,0,4,0,6
1063547,18,5,1995,4,"male",480,101,40,48,62,48,58,0,4
1063548,16,30,1997,3,"female",121,413,235,418,412,155,133,263,279
1063574,14,1,1999,1,"female",184,550,141,126,284,126,212,0,72
1063583,28,9,1985,11,"female",641,335,260,836,868,836,743,0,125
1063605,19,3,1994,7,"male",48,23,17,0,0,0,0,0,0
1063611,66,19,1947,2,"male",611,256,209,338,128,13,20,325,108
1063645,38,16,1975,9,"male",216,30,27,0,1,0,0,0,1
1063647,63,30,1950,12,"male",308,25,18,28,10,28,9,0,1
1063652,20,6,1993,12,"male",180,36,25,16,7,16,7,0,0
1063657,20,22,1993,11,"male",24,0,0,0,0,0,0,0,0
1063658,30,19,1983,4,"male",330,204,51,2,13,2,13,0,0
1063703,18,19,1995,10,"male",82,204,183,8,0,8,0,0,0
1063716,25,10,1988,6,"female",175,111,71,88,93,88,43,0,50
1063746,103,23,1910,11,"male",1228,357,218,27,23,4,17,23,6
1063764,46,25,1967,9,"male",1234,40,22,99,6,77,3,22,3
1063771,60,9,1953,12,"female",1743,38,31,1,1,0,0,1,1
1063782,21,22,1992,8,"female",649,207,145,37,5,6,1,31,4
1063794,62,2,1951,7,"male",946,23,11,0,1,0,0,0,1
1063799,22,19,1991,5,"male",195,72,30,3,0,3,0,0,0
1063815,112,1,1901,1,"male",1494,48,23,0,0,0,0,0,0
1063830,21,27,1992,1,"male",240,52,28,6,14,0,6,6,8
1063832,20,3,1993,1,"female",508,150,110,290,204,235,89,55,115
1063836,51,29,1962,4,"male",331,44,27,4,11,4,9,0,2
1063864,21,15,1992,3,"female",475,386,251,2763,704,1327,318,1436,386
1063865,24,30,1989,12,"male",461,343,316,198,132,198,97,0,35
1063907,37,29,1976,12,"male",180,29,25,570,51,570,16,0,35
1063914,15,30,1998,10,"male",410,58,51,0,0,0,0,0,0
1063941,103,6,1910,11,"female",1001,564,184,2,2,2,2,0,0
1063957,22,12,1991,7,"female",214,48,40,165,126,165,80,0,46
1063970,16,10,1997,7,"male",210,94,38,0,2,0,2,0,0
1063988,18,11,1995,7,"female",589,631,206,755,2405,755,2403,0,2
1064053,98,31,1915,12,"female",743,318,208,24,7,24,6,0,1
1064067,62,20,1951,7,"male",1044,44,34,4,6,2,1,2,5
1064102,20,26,1993,3,"male",142,2,2,10,0,10,0,0,0
1064110,65,13,1948,3,"female",1416,57,26,248,44,241,32,7,12
1064112,15,2,1998,4,"female",109,3584,132,1966,7444,1870,5679,96,1765
1064129,36,7,1977,8,"male",480,235,178,24,106,24,100,0,6
1064133,67,27,1946,8,"female",48,77,58,15,18,15,15,0,3
1064134,49,1,1964,11,"female",408,20,17,25,3,25,2,0,1
1064148,51,12,1962,9,"male",210,27,17,23,13,0,3,23,10
1064165,50,26,1963,6,"male",1309,46,38,37,9,37,9,0,0
1064208,19,3,1994,2,"female",442,1,1,1,0,0,0,1,0
1064215,25,1,1988,1,"female",43,14,12,33,30,33,12,0,18
1064221,27,1,1986,4,"male",379,72,50,19,16,11,2,8,14
1064241,25,5,1988,6,"female",398,56,42,14,0,14,0,0,0
1064242,18,8,1995,6,"female",469,538,419,2023,2629,637,1834,1386,795
1064270,17,14,1996,7,"female",353,511,467,71,76,71,68,0,8
1064300,24,18,1989,1,"male",211,154,152,6,4,2,3,4,1
1064330,48,9,1965,3,"male",523,126,81,10,55,9,38,1,17
1064342,19,13,1994,9,"male",432,2764,2018,637,352,375,299,262,53
1064345,36,26,1977,6,"female",702,35,14,9,62,9,36,0,26
1064347,52,4,1961,6,"male",237,0,0,0,0,0,0,0,0
1064365,85,29,1928,2,"female",1117,25,15,8,1,0,1,8,0
1064371,30,18,1983,8,"male",544,16,9,2,1,0,0,2,1
1064392,25,2,1988,1,"male",330,23,7,0,0,0,0,0,0
1064399,47,1,1966,5,"female",1673,86,28,118,70,97,58,21,12
1064405,50,10,1963,2,"male",349,5,3,8,9,6,9,2,0
1064407,57,15,1956,7,"female",594,23,7,1,1,0,0,1,1
1064412,26,1,1987,1,"male",529,29,17,0,1,0,0,0,1
1064417,23,24,1990,10,"male",580,78,49,0,13,0,2,0,11
1064441,38,5,1975,5,"male",744,19,18,13,1,3,1,10,0
1064480,16,8,1997,6,"male",386,606,445,219,92,155,42,64,50
1064490,22,4,1991,5,"male",305,32,16,9,8,0,4,9,4
1064522,54,17,1959,8,"female",1781,583,121,18,464,11,124,7,340
1064534,16,10,1997,10,"male",564,172,149,71,10,16,0,55,10
1064540,30,29,1983,6,"male",514,8,4,137,5,0,5,137,0
1064543,73,18,1940,1,"male",1230,19,13,0,0,0,0,0,0
1064576,107,8,1906,6,"male",235,98,62,1,8,1,6,0,2
1064602,20,11,1993,5,"male",765,91,18,0,3,0,3,0,0
1064610,38,8,1975,8,"male",297,49,40,0,8,0,2,0,6
1064618,22,9,1991,7,"male",473,519,339,189,281,108,180,81,101
1064620,25,25,1988,8,"male",204,104,82,64,21,64,10,0,11
1064642,19,8,1994,9,"male",316,453,281,2,11,2,10,0,1
1064651,55,18,1958,8,"male",921,56,22,28,27,28,15,0,12
1064666,77,22,1936,12,"male",793,41,24,10,0,0,0,10,0
1064670,38,28,1975,2,"female",371,0,0,0,0,0,0,0,0
1064677,103,3,1910,12,"male",15,3,3,0,0,0,0,0,0
1064683,25,9,1988,4,"male",604,226,168,1,6,1,4,0,2
1064695,103,15,1910,10,"female",809,410,209,273,192,50,13,223,179
1064757,44,22,1969,2,"male",709,25,11,4,0,4,0,0,0
1064766,26,9,1987,7,"female",280,63,43,12,252,12,195,0,57
1064775,28,13,1985,1,"male",248,240,198,95,98,84,50,11,48
1064789,42,1,1971,6,"female",581,46,35,392,57,392,31,0,26
1064803,59,20,1954,2,"female",1128,85,54,53,7,32,4,21,3
1064814,55,24,1958,8,"female",601,19,18,22,5,0,5,22,0
1064846,54,13,1959,5,"female",1260,96,32,210,90,26,48,184,42
1064848,26,24,1987,10,"male",374,12,8,0,0,0,0,0,0
1064854,39,9,1974,3,"male",454,8,3,8,2,8,2,0,0
1064883,23,1,1990,1,"male",403,14,12,3,8,0,0,3,8
1064907,62,29,1951,10,"male",932,223,106,372,538,39,296,333,242
1064934,18,23,1995,2,"male",587,164,35,1661,14,1661,14,0,0
1064941,21,8,1992,4,"female",451,88,14,24,36,24,33,0,3
1064946,30,3,1983,3,"male",143,2,0,0,0,0,0,0,0
1064955,17,31,1996,8,"male",731,1681,1083,0,20,0,14,0,6
1064962,50,27,1963,1,"male",1738,124,45,76,80,65,71,11,9
1064971,52,12,1961,7,"male",528,5,4,0,0,0,0,0,0
1064999,41,12,1972,3,"female",516,37,23,63,14,63,14,0,0
1065078,58,15,1955,10,"female",516,19,14,7,37,7,29,0,8
1065083,26,11,1987,2,"male",356,100,87,5,23,5,23,0,0
1065086,45,10,1968,4,"male",1702,150,33,4,4,4,4,0,0
1065087,40,21,1973,5,"female",362,137,32,6,1,0,0,6,1
1065132,42,6,1971,6,"male",297,87,76,0,0,0,0,0,0
1065214,23,10,1990,1,"male",504,142,105,0,0,0,0,0,0
1065236,45,8,1968,6,"male",2136,103,16,4,1,2,1,2,0
1065242,45,30,1968,9,"female",143,43,36,9,14,9,12,0,2
1065255,25,25,1988,6,"male",545,105,37,1,0,1,0,0,0
1065259,17,28,1996,8,"male",192,98,68,58,5,58,5,0,0
1065284,40,8,1973,5,"female",1706,517,413,279,390,254,95,25,295
1065301,20,18,1993,8,"female",1486,4132,1780,3781,22633,2514,12404,1267,10229
1065317,65,21,1948,12,"male",1393,1134,817,134,77,12,13,122,64
1065332,49,1,1964,9,"female",629,119,69,320,361,320,323,0,38
1065342,37,22,1976,10,"male",344,29,6,3,7,3,1,0,6
1065366,34,9,1979,8,"female",592,47,29,3,2,3,1,0,1
1065423,23,4,1990,2,"female",151,72,40,8,17,8,14,0,3
1065425,30,28,1983,2,"female",436,878,372,2468,4084,2468,3458,0,626
1065431,13,22,2000,2,"female",14,47,46,4,3,4,1,0,2
1065449,25,18,1988,12,"female",638,382,162,20,61,20,57,0,4
1065470,66,19,1947,8,"male",97,22,11,8,55,8,31,0,24
1065502,20,6,1993,1,"male",176,2,2,1,0,1,0,0,0
1065512,26,4,1987,5,"male",550,33,15,18,9,18,8,0,1
1065519,23,23,1990,4,"male",276,71,58,0,0,0,0,0,0
1065525,101,29,1912,9,"female",509,163,23,4,4,4,3,0,1
1065534,33,4,1980,12,"female",248,34,30,36,8,15,3,21,5
1065610,18,20,1995,4,"male",180,68,49,41,0,41,0,0,0
1065692,106,26,1907,2,"female",1541,410,166,1323,173,0,57,1323,116
1065740,24,8,1989,9,"male",70,165,153,1,1,1,1,0,0
1065818,16,14,1997,1,"female",1144,737,447,36,175,5,128,31,47
1065842,18,30,1995,1,"male",302,359,277,7,5,7,3,0,2
1065861,55,21,1958,9,"male",1423,147,83,251,256,251,203,0,53
1065889,27,11,1986,10,"male",395,294,256,34,18,34,16,0,2
1065891,45,7,1968,6,"male",267,30,17,0,0,0,0,0,0
1065898,35,8,1978,4,"male",80,4,4,8,0,8,0,0,0
1065899,21,22,1992,12,"female",268,7,6,2,0,2,0,0,0
1065922,52,29,1961,8,"female",101,0,0,0,0,0,0,0,0
1065930,58,17,1955,2,"female",1362,82,45,470,93,470,44,0,49
1065935,103,11,1910,5,"female",729,188,71,20,9,20,7,0,2
1065982,25,14,1988,8,"female",93,399,259,611,527,611,457,0,70
1065996,49,26,1964,3,"male",1203,37,18,1,6,1,6,0,0
1066005,46,16,1967,8,"male",496,16,8,0,0,0,0,0,0
1066009,38,16,1975,11,"female",967,198,96,7,2,0,0,7,2
1066015,19,19,1994,5,"male",395,443,197,26,20,15,2,11,18
1066025,13,8,2000,2,"female",318,475,308,618,457,342,86,276,371
1066055,33,6,1980,1,"female",479,23,10,19,2,19,2,0,0
1066075,63,14,1950,7,"female",369,83,70,143,66,143,51,0,15
1066077,31,14,1982,8,"female",30,22,17,11,13,11,12,0,1
1066079,20,10,1993,11,"male",317,276,136,248,91,29,33,219,58
1066118,17,22,1996,6,"male",247,129,61,4,2,4,2,0,0
1066150,51,3,1962,6,"female",574,19,12,1,2,1,2,0,0
1066185,79,19,1934,9,"female",612,6,5,0,1,0,1,0,0
1066197,108,16,1905,2,"female",1875,367,65,34,34,9,15,25,19
1066217,23,1,1990,1,"female",337,22,17,3,5,3,5,0,0
1066223,108,2,1905,4,"male",100,73,41,1,2,1,0,0,2
1066241,17,22,1996,4,"male",498,236,201,0,0,0,0,0,0
1066247,23,11,1990,2,"female",6,8,4,6,12,6,12,0,0
1066269,19,6,1994,3,"male",323,6,6,48,16,46,16,2,0
1066271,41,15,1972,2,"male",1258,158,47,57,0,57,0,0,0
1066296,60,18,1953,9,"female",312,71,66,3,2,0,0,3,2
1066305,20,25,1993,12,"male",475,578,520,4,47,3,34,1,13
1066332,18,6,1995,9,"male",673,372,144,2,1,2,1,0,0
1066364,22,8,1991,4,"female",465,7,3,0,0,0,0,0,0
1066392,18,6,1995,2,"female",477,358,137,40,36,40,26,0,10
1066430,18,11,1995,2,"male",639,3,3,0,0,0,0,0,0
1066447,17,5,1996,6,"male",1082,848,682,276,202,107,89,169,113
1066452,54,12,1959,2,"male",211,3,1,0,0,0,0,0,0
1066459,18,19,1995,2,"male",455,146,91,25,10,0,2,25,8
1066474,52,14,1961,3,"male",214,89,48,9,10,0,4,9,6
1066477,33,10,1980,12,"male",246,51,51,0,0,0,0,0,0
1066481,14,16,1999,4,"female",142,319,193,9,20,0,1,9,19
1066488,31,1,1982,1,"male",110,1,1,0,0,0,0,0,0
1066497,18,13,1995,5,"male",390,186,155,2,1,2,1,0,0
1066501,23,1,1990,1,"male",22,7,7,4,1,0,0,4,1
1066514,61,21,1952,7,"female",1545,178,75,101,47,47,28,54,19
1066541,32,5,1981,7,"female",327,23,17,18,1,18,1,0,0
1066576,22,29,1991,7,"female",680,216,128,2,4,2,4,0,0
1066579,25,13,1988,1,"male",774,603,468,712,947,708,810,4,137
1066613,21,14,1992,7,"female",411,296,201,294,250,293,181,1,69
1066614,26,18,1987,10,"female",730,2,2,0,0,0,0,0,0
1066621,64,18,1949,2,"male",538,13,8,0,0,0,0,0,0
1066626,27,28,1986,4,"male",474,100,78,13,5,1,5,12,0
1066630,29,10,1984,1,"male",495,5,4,2,0,2,0,0,0
1066632,25,6,1988,6,"female",563,17,15,6,10,5,6,1,4
1066640,14,8,1999,5,"female",287,129,91,2,1,2,0,0,1
1066679,25,4,1988,12,"male",96,10,6,17,6,17,2,0,4
1066691,29,22,1984,1,"female",228,66,44,11,9,11,6,0,3
1066700,16,20,1997,11,"male",424,182,91,22,2,22,2,0,0
1066703,36,5,1977,5,"male",87,819,797,186,263,172,244,14,19
1066708,47,6,1966,6,"male",662,67,26,13,49,13,27,0,22
1066727,76,11,1937,7,"female",1355,87,43,57,15,0,7,57,8
1066758,26,26,1987,7,"male",355,466,389,109,317,102,66,7,251
1066787,84,1,1929,1,"female",1713,35,21,6,9,6,4,0,5
1066791,94,1,1919,1,"male",1210,2352,1329,45,188,45,163,0,25
1066813,19,20,1994,7,"male",217,200,152,14,7,14,4,0,3
1066823,20,20,1993,4,"male",1062,126,89,11,6,0,6,11,0
1066845,45,23,1968,9,"male",233,61,48,0,0,0,0,0,0
1066852,63,11,1950,10,"male",232,17,15,1,8,1,3,0,5
1066859,21,16,1992,4,"male",98,2,2,1,0,1,0,0,0
1066886,56,27,1957,11,"female",726,143,69,584,135,92,28,492,107
1066895,36,16,1977,5,"male",1264,508,372,7,51,3,23,4,28
1066944,46,18,1967,8,"male",915,125,76,98,37,37,20,61,17
1066949,19,6,1994,3,"female",744,1197,371,333,440,333,279,0,161
1066951,21,4,1992,4,"male",613,519,415,13,4,13,3,0,1
1066966,26,2,1987,5,"male",409,185,133,221,378,119,214,102,164
1066975,18,1,1995,1,"male",45,15,15,11,5,11,4,0,1
1066979,14,28,1999,5,"male",326,36,19,0,5,0,5,0,0
1066983,58,15,1955,10,"male",255,50,41,9,139,0,10,9,129
1066990,35,5,1978,12,"female",544,257,173,364,123,364,62,0,61
1066996,18,14,1995,11,"female",341,2050,467,0,0,0,0,0,0
1067008,20,22,1993,8,"male",5,0,0,0,0,0,0,0,0
1067012,20,13,1993,8,"male",625,306,246,2,1,2,1,0,0
1067015,59,8,1954,9,"female",365,172,129,146,40,2,5,144,35
1067019,15,25,1998,4,"male",501,256,161,9,3,9,2,0,1
1067022,71,11,1942,6,"female",360,79,65,0,1,0,0,0,1
1067049,16,20,1997,3,"male",91,79,63,8,5,8,5,0,0
1067050,23,26,1990,3,"male",40,0,0,0,0,0,0,0,0
1067064,22,9,1991,6,"female",210,22,4,0,0,0,0,0,0
1067102,81,5,1932,9,"male",817,156,49,100,14,100,10,0,4
1067114,24,23,1989,12,"female",243,58,32,580,71,580,64,0,7
1067130,39,3,1974,4,"male",492,133,58,0,0,0,0,0,0
1067133,103,29,1910,12,"female",891,529,279,1,6,1,3,0,3
1067134,40,6,1973,3,"male",1025,15,13,0,5,0,5,0,0
1067151,24,14,1989,3,"female",605,4,1,0,1,0,1,0,0
1067191,31,4,1982,2,"male",345,193,104,13,32,13,14,0,18
1067234,47,29,1966,7,"female",308,130,102,212,84,212,54,0,30
1067238,29,30,1984,12,"male",356,97,83,0,0,0,0,0,0
1067289,46,20,1967,2,"female",242,6,3,3,1,3,1,0,0
1067304,67,3,1946,7,"male",1334,101,41,6,6,0,3,6,3
1067313,17,10,1996,10,"male",51,0,0,0,0,0,0,0,0
1067337,48,18,1965,11,"male",350,387,44,785,100,0,10,785,90
1067343,108,1,1905,1,"male",1487,473,197,244,439,0,354,244,85
1067422,59,30,1954,6,"female",736,72,44,93,1,0,1,93,0
1067425,24,30,1989,11,"female",556,2044,847,1963,1809,1681,1176,282,633
1067459,60,16,1953,10,"male",764,48,32,0,7,0,3,0,4
1067467,47,29,1966,7,"male",671,61,27,89,143,39,120,50,23
1067513,49,25,1964,8,"male",465,40,19,138,31,138,13,0,18
1067533,23,11,1990,12,"female",431,38,5,0,0,0,0,0,0
1067535,22,11,1991,9,"female",51,380,202,5277,5284,59,613,5218,4671
1067561,69,19,1944,1,"male",1353,98,36,15,28,9,12,6,16
1067584,51,28,1962,2,"female",1765,584,272,1738,2443,1738,2026,0,417
1067608,19,15,1994,4,"female",529,147,108,0,0,0,0,0,0
1067625,23,27,1990,6,"female",485,278,157,351,313,346,255,5,58
1067641,54,4,1959,6,"male",1365,6,4,0,0,0,0,0,0
1067655,71,14,1942,12,"male",3,26,9,14,20,14,11,0,9
1067682,54,5,1959,6,"female",340,12,5,1473,72,0,3,1473,69
1067683,22,17,1991,6,"male",1559,1055,696,77,26,77,23,0,3
1067691,108,8,1905,9,"female",1740,292,234,7,5,0,3,7,2
1067710,22,1,1991,10,"male",682,1291,917,192,436,82,237,110,199
1067738,52,27,1961,9,"male",34,32,29,32,8,32,6,0,2
1067744,16,20,1997,12,"female",343,1225,106,24,21,19,14,5,7
1067769,22,17,1991,11,"male",182,20,9,7,0,7,0,0,0
1067788,38,6,1975,3,"male",222,403,23,0,0,0,0,0,0
1067791,19,7,1994,8,"male",806,553,286,6,2,6,2,0,0
1067792,17,2,1996,4,"male",437,110,98,0,0,0,0,0,0
1067801,34,27,1979,3,"female",712,158,89,81,83,81,65,0,18
1067849,33,1,1980,2,"male",450,59,27,0,1,0,1,0,0
1067853,57,12,1956,10,"male",1963,70,17,0,0,0,0,0,0
1067887,30,10,1983,2,"male",362,26,13,0,0,0,0,0,0
1067892,23,3,1990,2,"female",494,66,38,3,10,3,9,0,1
1067897,27,10,1986,10,"female",253,302,288,7,12,7,8,0,4
1067915,18,16,1995,7,"male",174,151,97,175,37,175,25,0,12
1067921,17,21,1996,5,"male",335,86,60,235,0,235,0,0,0
1067925,67,20,1946,6,"female",670,83,53,15,46,15,29,0,17
1067947,39,17,1974,12,"male",456,102,82,14,0,6,0,8,0
1067948,61,20,1952,5,"female",607,43,32,0,0,0,0,0,0
1067956,22,27,1991,11,"male",146,118,20,11,15,0,2,11,13
1067978,30,13,1983,12,"male",785,0,0,0,0,0,0,0,0
1068009,48,10,1965,8,"female",1959,55,44,37,377,8,193,29,184
1068026,21,14,1992,12,"female",438,138,73,0,1,0,1,0,0
1068117,22,1,1991,8,"female",239,8,4,8,1,8,0,0,1
1068128,31,20,1982,6,"female",1813,495,255,125,519,93,267,32,252
1068131,35,21,1978,4,"male",483,1,1,66,20,66,8,0,12
1068158,63,4,1950,2,"male",685,21,17,8,6,0,2,8,4
1068201,21,24,1992,4,"male",228,194,169,60,70,60,58,0,12
1068231,89,1,1924,4,"male",1898,563,297,194,558,92,207,102,351
1068267,15,31,1998,5,"male",571,341,231,156,63,3,16,153,47
1068277,23,4,1990,10,"male",71,0,0,0,0,0,0,0,0
1068287,26,1,1987,1,"male",384,126,93,1,0,1,0,0,0
1068302,20,20,1993,6,"female",616,393,199,450,127,450,122,0,5
1068310,14,16,1999,8,"male",152,108,106,13,0,7,0,6,0
1068330,21,18,1992,4,"male",491,184,163,6,69,6,57,0,12
1068331,60,17,1953,11,"female",650,74,25,200,58,199,35,1,23
1068369,46,11,1967,11,"male",447,38,29,31,3,31,3,0,0
1068458,27,17,1986,8,"male",791,366,326,4,21,4,21,0,0
1068465,57,28,1956,12,"male",826,64,6,16,96,16,78,0,18
1068470,109,16,1904,10,"male",1666,35,16,6,23,1,8,5,15
1068473,59,24,1954,10,"female",113,41,23,70,15,70,8,0,7
1068497,40,5,1973,3,"male",419,22,12,1,5,0,2,1,3
1068519,48,26,1965,10,"female",613,29,8,24,18,0,9,24,9
1068541,21,26,1992,3,"male",144,148,120,9,48,9,34,0,14
1068552,24,16,1989,10,"male",23,1,1,0,0,0,0,0,0
1068578,23,11,1990,5,"male",637,19,12,1,0,0,0,1,0
1068580,18,15,1995,2,"female",426,337,100,157,72,157,59,0,13
1068586,88,25,1925,12,"female",960,569,417,100,98,96,27,4,71
1068589,108,1,1905,3,"female",1324,979,328,3,12,3,10,0,2
1068611,21,19,1992,11,"male",87,121,20,42,144,34,51,8,93
1068637,15,15,1998,5,"female",351,252,150,41,6,23,3,18,3
1068640,26,4,1987,1,"male",98,52,45,4,5,4,4,0,1
1068656,25,8,1988,10,"female",147,27,14,1,2,1,2,0,0
1068661,23,3,1990,7,"female",1421,643,243,200,156,169,64,31,92
1068673,33,18,1980,11,"female",695,42,25,32,11,0,3,32,8
1068684,24,10,1989,3,"male",314,57,50,31,12,0,3,31,9
1068745,108,31,1905,8,"male",1515,304,132,11,35,5,24,6,11
1068780,24,12,1989,1,"male",564,454,182,0,0,0,0,0,0
1068806,62,12,1951,11,"male",256,165,97,395,223,306,167,89,56
1068837,19,17,1994,4,"male",395,4,0,0,0,0,0,0,0
1068839,25,1,1988,1,"male",53,0,0,3,0,3,0,0,0
1068855,30,16,1983,10,"male",44,0,0,0,0,0,0,0,0
1068891,59,5,1954,12,"male",287,99,84,9,0,9,0,0,0
1068903,49,3,1964,8,"female",841,200,109,140,335,53,88,87,247
1068905,19,25,1994,8,"female",458,57,32,49,8,49,2,0,6
1068914,21,4,1992,1,"female",464,328,226,157,656,148,436,9,220
1068916,46,13,1967,11,"male",349,18,6,1,3,1,1,0,2
1068976,108,14,1905,10,"female",1199,59,38,47,54,12,34,35,20
1068979,62,10,1951,8,"female",469,14,12,27,4,0,0,27,4
1069017,44,9,1969,5,"female",250,10,7,98,23,86,21,12,2
1069024,94,10,1919,1,"female",689,199,73,11,21,11,18,0,3
1069036,37,22,1976,5,"female",240,107,68,50,66,50,66,0,0
1069052,35,22,1978,12,"male",674,141,54,9,1,0,1,9,0
1069066,29,3,1984,2,"female",217,147,97,0,3,0,2,0,1
1069071,38,2,1975,3,"male",640,65,46,6,2,6,2,0,0
1069077,17,8,1996,1,"male",201,343,330,0,38,0,13,0,25
1069141,20,25,1993,11,"male",360,1,1,0,0,0,0,0,0
1069144,21,21,1992,12,"female",259,129,38,308,508,308,289,0,219
1069162,50,9,1963,1,"female",296,192,136,75,22,75,12,0,10
1069177,65,29,1948,2,"male",312,78,41,14,13,2,5,12,8
1069179,32,9,1981,7,"female",471,39,23,0,1,0,1,0,0
1069206,54,14,1959,10,"female",282,88,41,541,313,541,170,0,143
1069208,21,1,1992,1,"male",322,198,155,1,0,1,0,0,0
1069226,65,6,1948,12,"male",425,32,10,0,0,0,0,0,0
1069256,49,29,1964,5,"female",166,11,6,3,2,0,0,3,2
1069259,27,25,1986,11,"male",267,9,3,21,10,17,5,4,5
1069264,15,21,1998,11,"male",377,67,42,43,4,43,3,0,1
1069288,82,22,1931,7,"male",1418,38,8,2,1,2,1,0,0
1069316,25,1,1988,1,"male",285,15,11,0,0,0,0,0,0
1069343,56,2,1957,7,"female",80,46,44,301,81,1,54,300,27
1069352,24,15,1989,5,"male",202,79,67,33,34,33,29,0,5
1069400,22,19,1991,9,"male",472,68,34,0,3,0,3,0,0
1069402,23,31,1990,3,"female",960,1197,1035,0,9,0,0,0,9
1069407,17,15,1996,7,"male",789,304,196,71,3,41,1,30,2
1069419,25,4,1988,11,"male",279,59,55,1,1,1,1,0,0
1069420,17,3,1996,3,"male",315,64,45,1,0,1,0,0,0
1069434,44,5,1969,1,"male",317,33,10,0,4,0,2,0,2
1069435,17,12,1996,2,"female",452,117,76,1,3,1,2,0,1
1069436,32,1,1981,1,"male",377,10,10,3,0,0,0,3,0
1069452,37,15,1976,5,"male",571,33,20,7,1,0,0,7,1
1069463,50,5,1963,12,"male",320,2,2,0,0,0,0,0,0
1069512,54,9,1959,11,"female",801,107,66,72,110,1,63,71,47
1069527,18,11,1995,6,"female",187,192,48,1,20,1,7,0,13
1069571,38,20,1975,2,"female",175,37,27,10,4,10,4,0,0
1069601,31,22,1982,11,"male",457,297,268,0,0,0,0,0,0
1069616,47,22,1966,7,"male",232,24,20,0,0,0,0,0,0
1069631,68,24,1945,9,"female",1360,55,19,27,17,27,11,0,6
1069669,20,16,1993,6,"female",1067,4607,1336,128,467,6,168,122,299
1069673,21,26,1992,7,"male",210,69,66,0,0,0,0,0,0
1069686,17,1,1996,5,"male",234,50,42,1,2,1,1,0,1
1069706,16,10,1997,5,"male",306,367,236,23,21,0,10,23,11
1069714,48,28,1965,5,"male",61,45,25,5,1,5,1,0,0
1069723,60,1,1953,10,"female",1727,65,32,0,9,0,3,0,6
1069730,39,3,1974,10,"male",683,8,3,0,0,0,0,0,0
1069734,29,7,1984,8,"male",205,20,18,0,0,0,0,0,0
1069747,23,19,1990,6,"male",587,443,335,105,43,105,35,0,8
1069771,66,12,1947,6,"male",659,39,29,10,0,10,0,0,0
1069794,42,1,1971,1,"male",55,17,15,129,7,0,1,129,6
1069811,53,4,1960,6,"female",257,59,31,241,61,241,52,0,9
1069878,39,15,1974,2,"female",528,14,7,351,308,178,204,173,104
1069881,16,25,1997,7,"female",52,0,0,0,0,0,0,0,0
1069922,108,6,1905,1,"male",852,410,315,43,59,43,38,0,21
1069957,21,5,1992,9,"male",591,144,85,0,0,0,0,0,0
1070033,20,19,1993,12,"female",911,8,1,0,0,0,0,0,0
1070037,37,14,1976,3,"male",201,92,57,12,61,12,54,0,7
1070044,32,29,1981,9,"male",542,102,59,5,15,5,10,0,5
1070046,21,3,1992,5,"female",361,39,31,12,10,5,2,7,8
1070056,70,28,1943,9,"female",905,34,21,42,24,0,11,42,13
1070060,72,28,1941,7,"female",621,23,14,1,17,1,17,0,0
1070064,30,8,1983,5,"female",117,5,5,0,0,0,0,0,0
1070092,51,26,1962,11,"male",1066,85,29,2,4,2,3,0,1
1070115,24,26,1989,7,"female",359,43,32,1,0,1,0,0,0
1070124,21,13,1992,7,"male",548,113,24,420,222,216,138,204,84
1070133,67,14,1946,8,"male",961,25,9,10,3,9,0,1,3
1070139,33,1,1980,1,"female",492,250,31,155,49,155,26,0,23
1070140,23,15,1990,4,"male",41,77,60,543,136,4,34,539,102
1070142,18,11,1995,7,"female",545,5,3,20,1,2,0,18,1
1070149,76,1,1937,5,"male",2276,65,6,21,37,0,18,21,19
1070180,39,27,1974,12,"male",275,22,15,0,0,0,0,0,0
1070182,65,24,1948,10,"male",1473,4,3,0,1,0,0,0,1
1070193,51,13,1962,7,"female",1195,40,16,36,1,36,1,0,0
1070206,61,8,1952,6,"female",309,145,97,376,118,14,52,362,66
1070209,24,29,1989,10,"male",1147,259,120,33,24,27,9,6,15
1070228,50,14,1963,11,"female",271,85,73,79,12,76,7,3,5
1070238,18,6,1995,5,"male",137,85,50,8,1,8,1,0,0
1070251,14,8,1999,1,"male",393,299,199,107,41,35,20,72,21
1070254,84,23,1929,8,"male",1462,33,14,6,24,5,12,1,12
1070255,21,23,1992,1,"female",316,5,1,20,23,20,22,0,1
1070259,18,13,1995,12,"female",1556,3158,299,467,1702,409,932,58,770
1070317,21,16,1992,12,"female",563,436,107,79,279,79,266,0,13
1070331,56,2,1957,10,"male",421,17,12,2,1,2,0,0,1
1070353,20,19,1993,6,"female",531,158,84,24,41,24,19,0,22
1070368,64,25,1949,7,"male",431,22,12,76,84,0,12,76,72
1070380,16,12,1997,3,"female",544,92,60,8,11,0,5,8,6
1070384,69,25,1944,2,"female",1565,58,46,0,17,0,9,0,8
1070396,25,1,1988,6,"male",135,376,348,102,368,102,326,0,42
1070432,17,21,1996,12,"female",358,337,211,230,11,229,11,1,0
1070449,14,18,1999,10,"male",140,34,20,4,1,4,1,0,0
1070469,18,7,1995,5,"female",166,93,58,0,0,0,0,0,0
1070474,20,10,1993,2,"male",345,254,215,303,133,166,120,137,13
1070484,25,5,1988,2,"male",364,225,154,232,33,232,28,0,5
1070495,26,13,1987,2,"male",216,0,0,0,0,0,0,0,0
1070531,32,30,1981,5,"male",495,14,6,0,0,0,0,0,0
1070551,62,24,1951,10,"male",347,71,28,442,65,48,52,394,13
1070587,20,12,1993,12,"female",121,90,58,1,1,1,1,0,0
1070592,20,18,1993,12,"female",299,130,122,0,2,0,0,0,2
1070603,66,24,1947,11,"female",1821,1079,449,135,144,120,76,15,68
1070655,25,25,1988,4,"male",474,71,8,0,1,0,1,0,0
1070693,106,10,1907,6,"female",1912,1486,501,159,249,144,130,15,119
1070732,21,9,1992,6,"female",200,192,112,138,54,138,21,0,33
1070744,21,18,1992,9,"female",491,383,230,5185,1257,5052,935,133,322
1070759,17,3,1996,6,"female",106,381,356,267,507,158,195,109,312
1070774,69,15,1944,10,"male",489,10,6,1,0,1,0,0,0
1070792,16,16,1997,5,"male",317,71,41,12,3,3,2,9,1
1070805,103,4,1910,3,"female",636,2129,640,0,2,0,2,0,0
1070820,26,1,1987,1,"male",636,266,107,31,83,31,41,0,42
1070829,20,2,1993,9,"female",1009,57,33,0,0,0,0,0,0
1070849,13,1,2000,1,"female",229,295,110,14,18,14,18,0,0
1070851,17,13,1996,6,"female",996,141,70,1749,1056,1645,329,104,727
1070854,19,16,1994,5,"male",284,189,138,37,42,25,15,12,27
1070902,82,13,1931,3,"female",521,33,28,65,20,0,16,65,4
1070904,20,19,1993,9,"male",1168,336,203,0,102,0,15,0,87
1070951,25,10,1988,8,"male",364,199,133,374,68,349,32,25,36
1071019,51,10,1962,6,"male",660,27,8,14,0,14,0,0,0
1071079,48,20,1965,12,"male",313,373,267,267,279,266,135,1,144
1071088,14,25,1999,11,"male",266,606,517,7,2,0,0,7,2
1071095,30,23,1983,3,"female",516,140,70,14,18,5,9,9,9
1071099,48,9,1965,11,"male",1177,158,84,1,18,0,4,1,14
1071116,56,27,1957,9,"male",1475,304,229,340,201,171,115,169,86
1071142,61,3,1952,12,"male",1144,86,37,0,19,0,10,0,9
1071149,25,14,1988,11,"male",460,396,319,7,57,6,14,1,43
1071160,19,12,1994,6,"male",224,1587,177,802,3164,0,470,802,2694
1071163,108,1,1905,1,"male",52,11,10,8,2,8,2,0,0
1071175,65,25,1948,11,"male",1673,262,161,3,7,0,0,3,7
1071178,28,8,1985,10,"female",445,41,32,30,53,30,35,0,18
1071211,104,3,1909,2,"male",746,183,127,3,20,3,20,0,0
1071236,30,12,1983,12,"male",444,37,30,1,5,1,5,0,0
1071270,26,9,1987,5,"male",1546,1525,1040,536,477,531,282,5,195
1071278,103,11,1910,1,"female",1927,67,35,30,1,21,1,9,0
1071337,22,12,1991,9,"male",197,9,7,6,1,6,1,0,0
1071338,18,14,1995,2,"female",671,607,249,71,981,69,475,2,506
1071341,63,1,1950,6,"male",1236,95,60,330,109,276,81,54,28
1071358,13,1,2000,1,"male",101,84,53,1,1,1,1,0,0
1071386,68,11,1945,11,"male",1442,193,73,11,1,0,1,11,0
1071388,103,9,1910,7,"male",938,549,451,9,10,9,8,0,2
1071400,60,9,1953,7,"male",340,2,1,0,0,0,0,0,0
1071412,15,3,1998,11,"male",100,0,0,0,0,0,0,0,0
1071441,48,21,1965,12,"female",92,4,4,0,1,0,1,0,0
1071447,15,25,1998,1,"female",569,1450,589,614,2925,364,1375,250,1550
1071458,25,6,1988,8,"male",352,14,2,0,0,0,0,0,0
1071469,16,17,1997,11,"female",361,390,140,26,2,26,2,0,0
1071480,14,19,1999,1,"male",153,236,183,0,1,0,1,0,0
1071516,42,13,1971,10,"male",706,111,17,0,1,0,1,0,0
1071547,70,20,1943,6,"female",1061,66,43,0,0,0,0,0,0
1071552,23,3,1990,12,"male",559,238,88,5,7,5,5,0,2
1071553,60,19,1953,5,"male",404,249,72,86,94,0,54,86,40
1071600,36,19,1977,1,"male",464,42,28,18,5,18,3,0,2
1071603,63,28,1950,1,"male",191,0,0,0,0,0,0,0,0
1071636,35,13,1978,4,"male",195,84,64,9,5,9,1,0,4
1071657,22,15,1991,9,"male",222,69,50,2,71,2,49,0,22
1071670,26,6,1987,4,"male",202,96,89,104,107,104,103,0,4
1071710,53,21,1960,7,"female",982,24,9,1,0,1,0,0,0
1071719,55,17,1958,4,"male",1178,355,147,167,28,167,27,0,1
1071756,15,5,1998,8,"male",434,7,7,1,0,1,0,0,0
1071763,17,15,1996,10,"female",424,37,26,20,5,0,3,20,2
1071766,19,17,1994,8,"male",4,190,138,97,77,78,55,19,22
1071771,23,4,1990,9,"male",308,12,3,0,0,0,0,0,0
1071808,22,1,1991,8,"male",66,121,92,29,48,29,27,0,21
1071832,15,12,1998,8,"female",83,3,1,0,0,0,0,0,0
1071833,26,9,1987,9,"female",482,99,46,4,1,4,0,0,1
1071836,16,7,1997,2,"male",537,665,560,0,1,0,1,0,0
1071837,17,6,1996,10,"male",699,110,84,1,1,1,1,0,0
1071848,25,2,1988,12,"female",363,586,488,191,147,131,63,60,84
1071853,21,19,1992,6,"female",370,306,129,128,264,90,129,38,135
1071901,51,13,1962,3,"female",251,119,100,432,211,432,168,0,43
1071928,68,10,1945,12,"male",364,596,285,645,669,6,612,639,57
1071965,24,23,1989,11,"male",475,197,160,936,26,936,20,0,6
1071977,54,10,1959,4,"female",286,22,19,8,2,0,0,8,2
1072001,59,3,1954,8,"male",110,46,14,3,0,3,0,0,0
1072030,65,27,1948,8,"female",131,33,28,24,22,24,18,0,4
1072047,14,5,1999,6,"male",289,15,11,0,0,0,0,0,0
1072049,42,20,1971,3,"female",655,28,15,870,208,870,183,0,25
1072072,16,16,1997,6,"female",1565,467,196,1657,1011,1629,388,28,623
1072088,16,24,1997,8,"female",162,261,81,29,13,29,11,0,2
1072097,24,5,1989,1,"female",584,659,521,666,535,287,240,379,295
1072102,27,22,1986,3,"male",337,20,10,1,3,1,2,0,1
1072118,18,4,1995,11,"male",292,9,6,39,7,39,7,0,0
1072122,15,19,1998,6,"male",17,16,8,5,0,5,0,0,0
1072135,18,5,1995,6,"female",253,29,21,6,0,6,0,0,0
1072154,18,7,1995,10,"male",458,162,102,1,0,1,0,0,0
1072158,17,25,1996,6,"male",28,121,115,37,44,37,24,0,20
1072174,29,27,1984,3,"male",173,75,35,0,0,0,0,0,0
1072177,13,3,2000,5,"male",57,68,49,1,36,1,18,0,18
1072181,51,19,1962,3,"male",715,7,4,0,0,0,0,0,0
1072202,18,9,1995,9,"female",553,44,32,686,49,622,48,64,1
1072214,29,18,1984,12,"female",164,254,221,6,60,5,31,1,29
1072227,18,22,1995,8,"male",406,234,76,27,2,4,2,23,0
1072273,62,24,1951,9,"male",1136,48,15,343,22,197,12,146,10
1072283,19,18,1994,10,"male",220,304,240,0,0,0,0,0,0
1072313,23,25,1990,9,"male",26,63,50,38,31,38,22,0,9
1072317,48,18,1965,1,"male",607,22,5,0,0,0,0,0,0
1072344,65,29,1948,8,"female",363,23,19,15,13,15,9,0,4
1072349,17,26,1996,1,"female",31,275,204,1,34,1,31,0,3
1072365,19,27,1994,6,"female",692,243,204,1,0,0,0,1,0
1072367,18,2,1995,1,"male",446,119,73,0,33,0,19,0,14
1072406,25,23,1988,4,"male",66,126,111,6,3,6,2,0,1
1072433,32,15,1981,11,"male",678,10,7,0,0,0,0,0,0
1072434,93,25,1920,1,"male",1277,64,32,87,22,87,14,0,8
1072452,29,11,1984,7,"male",190,40,38,0,0,0,0,0,0
1072464,63,8,1950,5,"female",310,38,34,11,11,0,2,11,9
1072502,58,9,1955,12,"female",814,51,32,242,278,219,215,23,63
1072552,18,22,1995,6,"male",146,2,2,0,0,0,0,0,0
1072591,19,13,1994,12,"male",317,65,44,3,1,3,0,0,1
1072594,39,13,1974,8,"male",610,64,28,125,18,118,16,7,2
1072603,42,27,1971,4,"female",909,191,34,0,4,0,4,0,0
1072604,31,22,1982,5,"female",1888,158,94,1756,1524,1443,571,313,953
1072605,20,1,1993,3,"male",291,95,68,9,7,9,5,0,2
1072613,21,12,1992,9,"male",235,340,137,0,0,0,0,0,0
1072648,56,27,1957,8,"female",564,65,42,4,30,3,22,1,8
1072663,18,8,1995,11,"female",304,139,95,18,5,18,4,0,1
1072674,67,17,1946,7,"female",86,46,36,3,3,0,0,3,3
1072708,53,26,1960,6,"female",1203,91,20,317,11,317,6,0,5
1072714,23,4,1990,9,"female",705,4077,793,1877,152014,80,89911,1797,62103
1072750,25,15,1988,5,"male",434,29,16,0,1,0,1,0,0
1072775,51,30,1962,1,"female",550,45,17,11,24,5,11,6,13
1072789,47,17,1966,10,"male",15,9,9,0,0,0,0,0,0
1072816,18,17,1995,8,"male",764,1239,703,0,1,0,1,0,0
1072823,76,29,1937,3,"male",1107,132,52,87,114,87,105,0,9
1072830,50,24,1963,8,"male",610,56,2,0,0,0,0,0,0
1072840,79,15,1934,1,"male",1811,20,6,1,6,0,1,1,5
1072847,15,30,1998,9,"male",112,8,5,0,0,0,0,0,0
1072858,28,14,1985,6,"male",436,122,80,4,1,0,0,4,1
1072860,56,22,1957,1,"female",395,33,24,72,94,72,51,0,43
1072891,21,3,1992,5,"female",721,318,238,484,234,476,176,8,58
1072924,20,18,1993,9,"female",677,283,185,193,130,189,80,4,50
1072942,22,21,1991,9,"female",205,151,140,358,140,307,50,51,90
1072943,24,1,1989,7,"female",701,474,287,1,0,0,0,1,0
1072946,45,21,1968,1,"female",744,36,8,48,84,48,71,0,13
1072962,65,4,1948,7,"female",1443,166,126,408,1290,0,467,408,823
1073005,18,30,1995,9,"male",460,486,130,1474,2148,1352,1206,122,942
1073026,18,2,1995,8,"male",281,973,461,295,157,177,105,118,52
1073030,54,28,1959,5,"male",1510,44,8,0,0,0,0,0,0
1073033,19,17,1994,3,"male",337,100,87,14,5,14,5,0,0
1073045,39,28,1974,10,"male",232,36,22,2,32,0,4,2,28
1073050,18,16,1995,12,"male",35,108,33,5,45,0,9,5,36
1073061,18,17,1995,2,"female",210,1,1,0,0,0,0,0,0
1073074,21,31,1992,12,"male",833,21,19,0,1,0,1,0,0
1073090,52,12,1961,7,"male",1393,60,38,0,2,0,2,0,0
1073097,23,9,1990,8,"male",472,294,257,0,0,0,0,0,0
1073114,53,30,1960,3,"male",385,96,55,5,25,5,9,0,16
1073115,23,7,1990,7,"male",524,8,3,0,0,0,0,0,0
1073121,46,1,1967,3,"male",572,19,11,1,0,1,0,0,0
1073144,60,14,1953,3,"female",872,229,169,11,1,11,0,0,1
1073197,28,22,1985,9,"male",448,6,5,0,0,0,0,0,0
1073213,25,18,1988,1,"male",331,337,268,128,75,117,29,11,46
1073229,22,1,1991,11,"female",385,145,119,1069,548,176,204,893,344
1073241,18,5,1995,12,"female",121,1712,1086,777,999,530,615,247,384
1073274,58,24,1955,7,"female",1846,171,139,353,332,344,241,9,91
1073279,50,22,1963,6,"male",774,16,8,0,0,0,0,0,0
1073307,22,23,1991,5,"male",69,32,11,1,0,1,0,0,0
1073308,27,7,1986,8,"male",536,1,1,0,0,0,0,0,0
1073384,40,13,1973,3,"male",18,0,0,0,0,0,0,0,0
1073396,26,27,1987,5,"male",771,16,3,0,0,0,0,0,0
1073417,23,26,1990,7,"male",536,91,49,23,17,23,11,0,6
1073471,24,17,1989,10,"male",608,386,264,0,1,0,1,0,0
1073473,74,1,1939,7,"male",20,56,56,47,2,44,1,3,1
1073490,27,11,1986,11,"male",318,13,10,26,0,26,0,0,0
1073511,27,21,1986,4,"male",456,79,62,1,0,0,0,1,0
1073514,21,31,1992,12,"male",876,148,59,54,24,54,19,0,5
1073588,14,22,1999,1,"male",563,51,35,0,1,0,1,0,0
1073600,49,12,1964,5,"female",551,76,21,744,25,668,22,76,3
1073622,103,5,1910,9,"male",481,455,335,6,66,6,64,0,2
1073631,18,10,1995,6,"male",161,67,34,1,26,1,21,0,5
1073638,21,4,1992,3,"male",655,117,17,1079,1181,760,596,319,585
1073664,19,8,1994,10,"male",340,49,38,0,1,0,1,0,0
1073667,56,2,1957,6,"female",61,50,44,189,140,189,74,0,66
1073670,19,13,1994,3,"male",373,568,452,89,93,33,67,56,26
1073682,25,11,1988,12,"male",485,63,51,59,8,58,1,1,7
1073710,19,13,1994,3,"male",501,84,59,2,0,2,0,0,0
1073719,55,25,1958,8,"male",620,17,8,0,0,0,0,0,0
1073760,26,1,1987,1,"male",72,263,244,2,4,2,2,0,2
1073762,16,18,1997,9,"female",1006,1123,300,1213,1599,760,924,453,675
1073783,31,17,1982,9,"male",172,168,119,2,23,2,19,0,4
1073788,64,19,1949,11,"male",1856,52,4,0,1,0,0,0,1
1073794,43,30,1970,9,"male",239,148,32,5,2,5,2,0,0
1073835,63,23,1950,12,"male",544,130,114,2,1,0,0,2,1
1073855,25,1,1988,1,"male",303,77,43,0,0,0,0,0,0
1073879,34,3,1979,6,"female",869,123,96,56,58,47,36,9,22
1073887,24,13,1989,2,"female",59,173,97,57,97,16,44,41,53
1073944,18,12,1995,11,"female",491,138,96,51,7,48,6,3,1
1073948,35,20,1978,1,"female",248,0,0,0,0,0,0,0,0
1073963,22,11,1991,9,"male",103,146,45,0,0,0,0,0,0
1073987,21,27,1992,3,"male",4,25,24,23,2,0,1,23,1
1074049,47,23,1966,2,"female",292,32,28,35,1,35,1,0,0
1074062,23,12,1990,12,"female",81,627,514,781,3050,781,2743,0,307
1074066,24,15,1989,3,"male",968,178,109,30,5,18,0,12,5
1074074,44,4,1969,10,"male",764,231,123,19,73,19,50,0,23
1074148,15,15,1998,4,"female",19,20,10,1,0,0,0,1,0
1074154,15,1,1998,6,"male",272,162,96,1,4,1,3,0,1
1074199,18,10,1995,5,"female",231,423,353,8,6,4,6,4,0
1074204,33,15,1980,11,"female",431,199,122,17,17,17,16,0,1
1074222,22,1,1991,1,"male",1303,8,7,1,0,0,0,1,0
1074239,17,15,1996,5,"male",574,134,97,88,13,22,6,66,7
1074242,66,4,1947,6,"female",2110,51,29,336,87,0,23,336,64
1074243,25,5,1988,7,"female",423,174,151,254,179,235,156,19,23
1074256,61,27,1952,10,"male",259,2,2,8,0,8,0,0,0
1074272,56,16,1957,7,"male",193,23,17,1,12,1,6,0,6
1074297,30,13,1983,5,"male",60,21,17,13,2,13,1,0,1
1074314,18,17,1995,8,"male",613,158,85,4,8,4,7,0,1
1074318,33,5,1980,12,"female",408,17,3,0,0,0,0,0,0
1074326,84,4,1929,3,"male",1200,4637,434,3,85,0,38,3,47
1074351,15,22,1998,2,"female",566,254,189,67,4,44,3,23,1
1074354,47,30,1966,10,"male",271,5,4,7,3,7,2,0,1
1074359,32,21,1981,12,"male",347,80,62,1,0,1,0,0,0
1074361,21,19,1992,12,"female",726,180,132,170,131,82,86,88,45
1074424,108,20,1905,2,"female",1335,474,164,0,0,0,0,0,0
1074444,27,29,1986,5,"male",496,110,89,14,3,0,0,14,3
1074445,29,28,1984,9,"female",350,89,69,403,164,28,57,375,107
1074446,46,29,1967,3,"male",631,51,37,2,7,0,4,2,3
1074450,24,12,1989,5,"male",226,60,40,12,23,12,13,0,10
1074454,23,12,1990,9,"female",355,41,13,0,0,0,0,0,0
1074482,17,14,1996,8,"male",42,60,55,5,26,1,18,4,8
1074495,14,19,1999,9,"male",124,132,114,0,0,0,0,0,0
1074508,22,7,1991,5,"male",276,47,44,1,0,1,0,0,0
1074590,108,13,1905,9,"female",137,109,86,124,35,124,25,0,10
1074592,77,14,1936,6,"female",594,32,18,0,0,0,0,0,0
1074619,23,15,1990,6,"male",558,124,92,36,188,14,40,22,148
1074622,52,11,1961,5,"male",974,204,50,1,1,0,0,1,1
1074623,21,16,1992,8,"male",594,78,48,0,3,0,2,0,1
1074644,49,21,1964,1,"male",357,20,4,0,0,0,0,0,0
1074678,71,24,1942,1,"female",1000,45,23,0,0,0,0,0,0
1074688,36,16,1977,11,"female",583,123,111,255,143,255,114,0,29
1074691,64,1,1949,3,"male",756,121,87,44,13,0,7,44,6
1074693,17,29,1996,4,"female",219,119,65,13,0,13,0,0,0
1074697,15,30,1998,4,"female",499,26,6,0,0,0,0,0,0
1074709,21,28,1992,1,"male",325,13,12,0,0,0,0,0,0
1074715,54,17,1959,8,"female",1459,157,90,522,210,522,135,0,75
1074725,21,25,1992,6,"male",484,432,318,688,123,688,99,0,24
1074766,16,15,1997,2,"female",320,35,11,1,0,1,0,0,0
1074788,25,15,1988,4,"male",38,8,6,17,7,17,7,0,0
1074820,15,14,1998,5,"male",555,174,135,0,0,0,0,0,0
1074825,16,12,1997,1,"female",455,325,77,63,50,47,20,16,30
1074827,18,12,1995,1,"male",112,18,16,1,0,1,0,0,0
1074828,57,12,1956,2,"male",1544,163,47,3,56,3,26,0,30
1074838,108,1,1905,1,"female",2222,243,69,46,116,41,42,5,74
1074847,41,27,1972,6,"male",517,28,11,3,0,3,0,0,0
1074852,57,21,1956,3,"female",369,116,91,0,0,0,0,0,0
1074872,24,7,1989,9,"male",68,37,30,0,0,0,0,0,0
1074912,44,13,1969,6,"female",1654,1112,456,839,2044,815,1374,24,670
1074944,60,1,1953,6,"female",630,1549,151,134,638,131,328,3,310
1074945,19,5,1994,10,"male",671,195,113,14,4,12,2,2,2
1074957,55,7,1958,9,"female",420,81,48,192,50,192,28,0,22
1074986,15,13,1998,7,"male",238,106,65,7,28,7,28,0,0
1075001,45,7,1968,2,"male",338,8,3,1,0,1,0,0,0
1075008,68,28,1945,5,"female",430,923,321,37,45,37,39,0,6
1075009,56,24,1957,8,"male",1053,198,82,0,1,0,1,0,0
1075014,46,5,1967,3,"male",153,3,2,0,0,0,0,0,0
1075040,55,22,1958,3,"female",777,19,12,14,3,0,3,14,0
1075098,25,20,1988,12,"female",572,188,168,6,5,4,2,2,3
1075119,18,27,1995,6,"male",739,382,341,353,510,259,378,94,132
1075124,23,10,1990,9,"female",270,51,35,7,1,0,1,7,0
1075155,66,11,1947,7,"female",506,19,12,74,0,74,0,0,0
1075182,23,3,1990,3,"male",691,152,59,12,7,0,2,12,5
1075203,23,7,1990,3,"male",22,2,2,0,0,0,0,0,0
1075236,20,20,1993,7,"female",271,330,154,7,0,7,0,0,0
1075246,52,12,1961,12,"male",434,3,3,24,12,0,1,24,11
1075251,14,13,1999,2,"female",129,129,40,303,59,164,42,139,17
1075274,26,1,1987,7,"female",515,3898,592,27,579,27,454,0,125
1075289,25,3,1988,10,"male",443,59,38,5,52,4,32,1,20
1075307,23,12,1990,12,"male",826,2245,1299,285,149,285,139,0,10
1075338,17,5,1996,10,"female",603,1407,566,736,2348,390,1685,346,663
1075355,21,5,1992,11,"male",100,148,142,37,10,34,7,3,3
1075394,40,25,1973,4,"male",697,111,44,4,22,0,8,4,14
1075407,99,2,1914,3,"male",2316,182,132,65,58,31,40,34,18
1075422,31,13,1982,1,"female",688,0,0,0,0,0,0,0,0
1075434,79,10,1934,4,NA,2066,19,5,0,1,0,0,0,1
1075438,18,8,1995,8,"male",29,11,8,7,0,7,0,0,0
1075448,103,27,1910,8,"female",829,68,36,3,29,3,16,0,13
1075480,63,1,1950,5,"male",301,29,22,0,0,0,0,0,0
1075505,25,14,1988,2,"male",39,31,22,7,15,7,14,0,1
1075524,27,17,1986,3,"male",223,205,192,1,5,1,5,0,0
1075530,19,5,1994,4,"female",506,512,139,233,73,233,73,0,0
1075555,68,29,1945,12,"male",400,25,3,0,0,0,0,0,0
1075568,61,26,1952,6,"female",1697,88,34,35,150,35,121,0,29
1075586,21,23,1992,3,"female",1020,127,79,111,117,90,67,21,50
1075593,93,10,1920,6,"male",1087,82,45,0,0,0,0,0,0
1075644,21,21,1992,8,"male",71,46,32,13,0,13,0,0,0
1075646,53,6,1960,1,"male",699,7,7,0,0,0,0,0,0
1075660,48,2,1965,8,"female",1115,113,71,254,133,137,86,117,47
1075664,17,10,1996,1,"male",558,109,90,1,0,1,0,0,0
1075667,16,7,1997,6,"male",131,14,7,0,3,0,2,0,1
1075669,50,13,1963,4,"female",107,23,5,87,69,87,61,0,8
1075688,26,18,1987,3,"female",276,3,1,0,0,0,0,0,0
1075689,21,27,1992,4,"female",481,93,60,9,2,9,1,0,1
1075697,91,9,1922,10,"female",365,85,46,1,1,1,1,0,0
1075707,41,1,1972,1,"male",271,57,39,22,12,22,9,0,3
1075730,33,11,1980,9,"male",254,39,28,84,29,0,12,84,17
1075752,23,27,1990,11,"male",499,367,225,4,7,4,7,0,0
1075758,68,1,1945,3,"male",1095,135,41,4,8,4,8,0,0
1075766,63,10,1950,6,"female",192,105,71,0,1,0,1,0,0
1075786,19,10,1994,10,"male",33,10,8,0,0,0,0,0,0
1075803,25,10,1988,8,"male",190,92,88,1,0,1,0,0,0
1075815,35,1,1978,2,"male",33,13,7,12,28,12,27,0,1
1075818,14,13,1999,5,"male",172,35,7,0,0,0,0,0,0
1075838,17,17,1996,6,"female",227,454,177,32,13,32,6,0,7
1075872,28,27,1985,1,"male",605,21,13,0,0,0,0,0,0
1075903,62,25,1951,5,"male",502,5,5,100,34,100,24,0,10
1075936,25,1,1988,4,"male",190,3,2,0,0,0,0,0,0
1075948,21,10,1992,2,"male",581,206,93,3,0,3,0,0,0
1075957,34,20,1979,4,"female",42,18,7,71,17,71,5,0,12
1075963,25,27,1988,7,"male",450,70,45,22,12,19,7,3,5
1075973,58,27,1955,1,"male",1687,30,12,0,0,0,0,0,0
1076000,53,5,1960,5,"female",408,222,102,304,79,20,37,284,42
1076021,62,10,1951,10,"male",714,127,58,0,20,0,8,0,12
1076027,108,1,1905,1,"female",214,9,7,1,3,1,3,0,0
1076053,23,11,1990,2,"male",91,5,4,0,0,0,0,0,0
1076069,19,7,1994,3,"female",360,66,48,33,40,32,29,1,11
1076071,20,8,1993,7,"female",1092,1282,936,11130,8704,591,4419,10539,4285
1076076,59,30,1954,1,"female",1080,53,48,628,690,0,30,628,660
1076142,42,5,1971,3,"female",123,29,21,8,7,8,5,0,2
1076152,25,1,1988,1,"male",147,39,29,3,51,3,8,0,43
1076162,48,16,1965,2,"male",1272,81,19,10,40,10,33,0,7
1076188,23,6,1990,6,"male",426,141,79,17,0,17,0,0,0
1076204,64,8,1949,6,NA,1074,111,53,100,12,0,11,100,1
1076229,22,7,1991,3,"male",564,84,44,0,0,0,0,0,0
1076243,52,16,1961,3,"male",261,26,13,0,0,0,0,0,0
1076245,19,21,1994,1,"male",817,139,79,22,0,14,0,8,0
1076258,16,18,1997,11,"male",375,100,47,3,15,3,9,0,6
1076260,108,18,1905,9,"male",1562,575,279,705,264,0,71,705,193
1076276,16,29,1997,11,"male",448,530,120,0,1,0,0,0,1
1076314,21,12,1992,12,"male",10,18,16,1,1,1,1,0,0
1076324,38,5,1975,12,"male",636,582,474,3,0,0,0,3,0
1076326,13,20,2000,3,"female",413,235,182,23,15,23,4,0,11
1076331,18,14,1995,7,"male",300,512,478,0,1,0,1,0,0
1076343,45,24,1968,10,"male",543,34,22,55,12,51,12,4,0
1076359,22,1,1991,1,"female",495,642,108,49,852,49,557,0,295
1076379,20,4,1993,1,"female",446,420,198,163,150,112,24,51,126
1076423,13,5,2000,1,"male",284,103,86,1,0,0,0,1,0
1076425,93,30,1920,8,"female",1347,102,36,15,5,6,1,9,4
1076438,40,15,1973,6,"male",324,3,1,0,0,0,0,0,0
1076463,31,3,1982,3,"female",192,158,93,231,237,231,181,0,56
1076475,23,19,1990,7,"male",1395,983,854,1,0,1,0,0,0
1076499,17,28,1996,5,"male",126,149,79,277,151,0,40,277,111
1076510,21,31,1992,1,"female",638,441,204,393,303,314,162,79,141
1076517,56,11,1957,2,"female",89,68,38,4,9,0,7,4,2
1076518,18,11,1995,3,"male",963,729,419,485,328,485,309,0,19
1076536,58,27,1955,4,"male",2162,218,106,1,15,1,8,0,7
1076554,56,8,1957,1,"male",301,0,0,0,0,0,0,0,0
1076560,38,24,1975,5,"male",84,14,6,0,0,0,0,0,0
1076573,30,23,1983,10,"female",1321,158,62,2129,1553,1467,1238,662,315
1076588,29,14,1984,6,"female",244,33,23,0,27,0,10,0,17
1076599,13,3,2000,3,"female",507,294,203,239,309,172,160,67,149
1076693,19,31,1994,10,"female",1528,4320,737,903,1136,743,283,160,853
1076734,47,19,1966,2,"female",434,33,27,113,23,113,10,0,13
1076736,19,14,1994,7,"female",1409,3441,2075,128,389,38,196,90,193
1076760,64,21,1949,6,"male",123,11,8,0,0,0,0,0,0
1076788,79,3,1934,2,"male",919,76,60,234,41,0,0,234,41
1076812,50,19,1963,10,"female",2122,201,63,335,252,335,147,0,105
1076838,21,13,1992,9,"female",421,24,12,56,25,50,13,6,12
1076844,15,14,1998,5,"male",816,474,268,23,83,23,63,0,20
1076901,23,1,1990,1,"male",622,46,38,0,0,0,0,0,0
1076907,18,1,1995,1,"male",292,57,26,1,11,1,9,0,2
1076931,31,14,1982,3,"male",171,44,33,2,4,1,2,1,2
1076975,30,24,1983,7,"male",342,32,31,54,235,0,107,54,128
1076978,81,25,1932,12,"male",1542,71,36,1,11,0,6,1,5
1077030,14,1,1999,1,"male",200,312,224,0,10,0,6,0,4
1077043,33,17,1980,9,"male",452,192,104,35,87,35,68,0,19
1077052,22,17,1991,6,"male",313,4,2,0,0,0,0,0,0
1077096,54,4,1959,6,"female",1335,189,60,128,53,11,33,117,20
1077097,33,14,1980,3,"male",95,11,6,3,33,3,15,0,18
1077124,38,2,1975,3,"male",338,7,7,0,9,0,5,0,4
1077144,26,1,1987,1,"male",49,92,82,11,44,10,24,1,20
1077150,53,18,1960,6,"female",286,70,59,20,23,20,16,0,7
1077171,14,24,1999,5,"female",425,710,200,316,86,316,64,0,22
1077175,68,16,1945,11,"female",1052,39,18,126,8,126,4,0,4
1077187,43,1,1970,1,"female",121,2,0,0,0,0,0,0,0
1077203,19,1,1994,3,"female",451,198,148,71,251,71,119,0,132
1077249,51,15,1962,2,"male",739,17,9,5,0,5,0,0,0
1077263,28,15,1985,5,"female",60,42,19,112,41,112,21,0,20
1077274,28,19,1985,8,"male",192,63,51,2,14,2,9,0,5
1077282,103,7,1910,6,"male",916,129,64,31,29,26,20,5,9
1077299,17,24,1996,7,"male",204,44,30,0,0,0,0,0,0
1077302,15,21,1998,11,"female",363,72,43,49,10,49,9,0,1
1077322,66,12,1947,10,"female",1745,161,88,679,1008,474,807,205,201
1077334,23,10,1990,10,"female",315,116,33,0,1,0,1,0,0
1077347,22,28,1991,9,"male",39,70,68,12,6,6,4,6,2
1077356,27,15,1986,9,"male",7,3,2,4,3,4,3,0,0
1077369,23,13,1990,6,"female",452,78,22,351,81,351,65,0,16
1077370,24,1,1989,2,"female",571,218,157,2846,3865,1626,1401,1220,2464
1077414,23,21,1990,2,"female",523,75,43,38,17,21,5,17,12
1077415,23,29,1990,8,"male",438,11,8,9,8,9,7,0,1
1077423,18,8,1995,3,"female",330,6,4,0,0,0,0,0,0
1077426,18,1,1995,1,"male",367,7,6,12,8,12,8,0,0
1077464,84,15,1929,12,"male",1355,245,174,57,23,55,13,2,10
1077472,53,19,1960,5,"female",129,46,40,42,160,0,70,42,90
1077474,15,19,1998,1,"female",1168,300,160,23,37,23,10,0,27
1077493,58,31,1955,7,"male",1034,17,12,1,0,0,0,1,0
1077520,29,14,1984,4,"male",206,63,45,1,2,1,2,0,0
1077535,16,24,1997,6,"male",1436,302,46,19,18,3,9,16,9
1077551,16,26,1997,3,"female",54,166,125,1076,386,203,301,873,85
1077619,17,15,1996,4,"female",523,677,494,100,18,100,11,0,7
1077646,26,23,1987,12,"male",77,10,8,34,21,34,17,0,4
1077660,30,29,1983,7,"male",344,9,6,1,0,1,0,0,0
1077677,21,10,1992,7,"female",233,340,242,14,38,14,37,0,1
1077686,49,13,1964,9,"female",953,45,27,78,39,78,32,0,7
1077711,23,8,1990,7,"male",556,11,7,2,0,2,0,0,0
1077717,24,26,1989,12,"female",556,31,14,906,74,906,73,0,1
1077718,34,1,1979,1,"female",958,200,72,95,347,72,125,23,222
1077732,28,22,1985,7,"male",310,1,0,0,3,0,0,0,3
1077741,17,30,1996,1,"female",482,480,286,1247,957,1079,846,168,111
1077751,24,19,1989,5,"male",243,525,333,1,4,0,3,1,1
1077760,16,9,1997,3,"female",174,733,140,1583,1076,1196,464,387,612
1077794,14,10,1999,3,"female",14,15,15,0,0,0,0,0,0
1077851,21,6,1992,1,"male",449,53,25,1,0,1,0,0,0
1077855,58,15,1955,9,"female",799,33,15,669,4,669,1,0,3
1077875,41,11,1972,12,"male",414,0,0,0,0,0,0,0,0
1077920,54,19,1959,3,"female",335,304,111,389,6,389,3,0,3
1077923,27,4,1986,12,"female",333,553,285,7,99,7,49,0,50
1077932,20,1,1993,1,"male",26,21,18,1,0,0,0,1,0
1077935,29,20,1984,9,"male",459,77,40,29,4,28,3,1,1
1077945,21,1,1992,4,"male",532,10,2,0,1,0,0,0,1
1077983,39,15,1974,1,"male",684,77,20,3,6,3,4,0,2
1078008,18,9,1995,4,"female",99,20,18,31,2,0,1,31,1
1078011,31,16,1982,11,"male",204,4,2,0,0,0,0,0,0
1078013,19,30,1994,10,"male",450,209,84,109,64,109,48,0,16
1078015,16,12,1997,5,"male",594,140,93,0,0,0,0,0,0
1078044,55,10,1958,4,"female",1433,101,63,68,128,68,31,0,97
1078046,26,17,1987,11,"female",362,140,76,102,221,102,92,0,129
1078047,15,28,1998,1,"male",12,23,22,11,2,0,0,11,2
1078077,43,16,1970,4,"female",649,50,27,280,482,280,401,0,81
1078089,18,10,1995,8,"male",260,17,4,0,0,0,0,0,0
1078092,35,7,1978,8,"male",795,27,4,0,2,0,0,0,2
1078099,39,1,1974,2,"male",645,8,0,0,0,0,0,0,0
1078115,32,30,1981,4,"female",409,136,62,29,12,16,8,13,4
1078119,40,11,1973,8,"male",57,1,1,0,0,0,0,0,0
1078147,28,3,1985,11,"male",347,144,131,3,0,0,0,3,0
1078149,55,21,1958,6,"female",747,163,83,379,332,0,92,379,240
1078159,17,16,1996,10,"male",191,19,14,0,4,0,3,0,1
1078173,48,10,1965,8,"female",493,76,50,0,4,0,4,0,0
1078193,44,29,1969,12,"male",424,1,1,5,1,1,0,4,1
1078200,68,13,1945,11,"male",1031,557,361,192,443,192,365,0,78
1078201,19,14,1994,10,"male",677,17,4,6,31,5,3,1,28
1078221,36,6,1977,1,"male",428,113,66,8,3,8,2,0,1
1078223,26,18,1987,5,"female",538,34,22,0,0,0,0,0,0
1078261,39,1,1974,1,"male",1799,8,7,0,0,0,0,0,0
1078274,18,1,1995,10,"male",306,112,40,8,0,0,0,8,0
1078279,19,12,1994,5,"male",1023,754,191,50,42,46,28,4,14
1078289,35,13,1978,8,"male",400,67,48,0,8,0,0,0,8
1078291,57,19,1956,10,"male",195,0,0,0,0,0,0,0,0
1078302,51,23,1962,5,"female",1094,60,45,98,59,52,45,46,14
1078304,25,14,1988,2,"female",1380,8,7,6,6,6,6,0,0
1078319,46,27,1967,5,"male",1144,24,17,52,47,49,36,3,11
1078320,36,4,1977,4,"female",281,192,126,120,55,120,53,0,2
1078334,65,18,1948,11,"female",1362,6,3,0,0,0,0,0,0
1078338,93,6,1920,9,"female",809,197,67,40,39,0,27,40,12
1078350,47,17,1966,3,"male",424,24,10,96,7,0,1,96,6
1078364,25,5,1988,3,"female",782,173,70,2174,485,2174,275,0,210
1078379,69,24,1944,11,"female",537,135,104,1,27,0,9,1,18
1078387,18,26,1995,1,"male",822,1024,843,828,1231,454,746,374,485
1078409,69,24,1944,12,"male",2285,91,21,6,28,0,5,6,23
1078417,24,1,1989,5,"male",15,20,17,2,0,2,0,0,0
1078419,28,15,1985,3,"male",93,17,5,0,0,0,0,0,0
1078439,15,22,1998,4,"male",110,130,107,147,68,19,31,128,37
1078442,30,6,1983,5,"male",924,1,1,1,0,1,0,0,0
1078470,25,8,1988,2,"male",380,26,22,19,14,18,13,1,1
1078502,18,5,1995,4,"female",245,500,336,127,137,111,75,16,62
1078553,18,15,1995,12,"male",544,104,79,88,8,88,6,0,2
1078581,56,3,1957,3,"female",1273,185,98,12,29,12,23,0,6
1078593,27,4,1986,6,"male",834,385,219,41,9,0,0,41,9
1078596,26,1,1987,1,"male",287,62,58,27,6,0,2,27,4
1078644,16,25,1997,7,"female",804,1987,1113,101,660,31,478,70,182
1078670,64,3,1949,4,"female",551,892,578,153,26,0,2,153,24
1078683,51,12,1962,9,"male",789,131,76,4,33,3,19,1,14
1078711,28,29,1985,8,"female",324,7,2,2,0,2,0,0,0
1078718,22,26,1991,1,"female",710,182,79,334,401,334,292,0,109
1078727,19,25,1994,6,"female",867,196,56,6,23,6,8,0,15
1078735,63,11,1950,1,"male",751,18,5,3,6,0,6,3,0
1078738,23,30,1990,6,"female",238,330,220,181,207,181,130,0,77
1078745,25,16,1988,7,"male",123,0,0,0,0,0,0,0,0
1078753,20,7,1993,5,"male",1451,584,298,92,192,89,86,3,106
1078767,31,19,1982,8,"male",355,2,0,0,0,0,0,0,0
1078795,17,4,1996,7,"male",77,61,40,24,4,24,4,0,0
1078798,48,3,1965,6,"male",407,4,2,4,3,1,0,3,3
1078806,44,15,1969,7,"female",447,80,54,30,4,2,2,28,2
1078808,13,28,2000,6,"female",738,93,78,68,2,68,1,0,1
1078842,27,6,1986,2,"male",237,2,1,0,0,0,0,0,0
1078844,33,20,1980,9,"male",214,124,107,4,32,4,10,0,22
1078851,56,14,1957,6,"female",1,7,7,1,0,1,0,0,0
1078859,69,23,1944,6,"female",1417,203,53,188,11,11,4,177,7
1078872,56,2,1957,3,"male",1318,32,16,3,27,3,26,0,1
1078980,64,10,1949,1,"female",1501,71,45,1,11,0,9,1,2
1078999,44,20,1969,11,"male",663,48,37,116,293,110,276,6,17
1079009,80,6,1933,9,"male",1372,762,438,421,223,374,182,47,41
1079032,25,21,1988,8,"male",692,230,205,1,0,1,0,0,0
1079050,44,19,1969,5,"male",406,66,25,1,19,1,3,0,16
1079052,27,26,1986,3,"male",290,41,22,0,0,0,0,0,0
1079087,23,23,1990,5,"male",33,99,82,37,76,31,60,6,16
1079109,20,22,1993,8,"female",205,33,18,70,27,70,12,0,15
1079114,108,13,1905,12,"female",2006,369,235,14,17,0,7,14,10
1079128,57,28,1956,2,"female",2124,46,10,97,7,97,4,0,3
1079169,16,11,1997,7,"male",487,150,78,29,2,29,2,0,0
1079230,55,1,1958,1,"male",1587,359,179,210,285,86,87,124,198
1079236,39,17,1974,4,"female",242,24,9,0,1,0,1,0,0
1079257,20,25,1993,8,"male",311,5,0,0,0,0,0,0,0
1079258,22,18,1991,6,"male",553,1365,793,5561,4742,5267,2195,294,2547
1079307,49,3,1964,4,"male",1103,21,11,4,4,4,2,0,2
1079316,18,20,1995,11,"male",1479,126,66,28,34,12,18,16,16
1079321,19,17,1994,5,"male",43,124,120,0,0,0,0,0,0
1079325,37,15,1976,6,"male",540,483,388,19,34,19,26,0,8
1079328,19,20,1994,11,"female",274,88,58,6,3,1,3,5,0
1079347,20,13,1993,1,"male",266,379,151,3,3,3,2,0,1
1079352,23,26,1990,1,"female",563,225,174,134,92,128,68,6,24
1079357,53,12,1960,7,"male",794,95,44,3,4,3,3,0,1
1079365,16,13,1997,5,"female",482,383,262,1513,316,1513,154,0,162
1079368,34,3,1979,2,"male",370,9,5,2,3,2,3,0,0
1079382,36,17,1977,6,"female",425,17,15,12,2,12,0,0,2
1079397,68,20,1945,12,"male",1570,98,39,2,88,0,41,2,47
1079402,74,16,1939,7,"female",836,396,158,103,40,103,34,0,6
1079406,63,27,1950,7,"female",1539,51,35,0,1,0,0,0,1
1079424,40,2,1973,7,"female",585,36,24,87,13,5,8,82,5
1079433,49,29,1964,12,"male",717,131,55,0,20,0,17,0,3
1079472,31,29,1982,9,"female",98,41,19,107,171,107,134,0,37
1079481,62,7,1951,3,"female",377,100,48,2,3,1,0,1,3
1079491,27,3,1986,10,"female",376,0,0,0,0,0,0,0,0
1079516,18,25,1995,5,"male",760,71,20,46,25,0,4,46,21
1079530,35,23,1978,5,"female",184,118,96,547,308,547,245,0,63
1079549,35,24,1978,5,"male",879,375,247,12,3,12,3,0,0
1079563,59,17,1954,1,"male",307,21,15,0,1,0,1,0,0
1079574,24,31,1989,12,"male",587,102,78,0,0,0,0,0,0
1079584,22,14,1991,9,"male",127,156,122,0,0,0,0,0,0
1079606,39,1,1974,2,"male",509,29,17,0,1,0,0,0,1
1079610,18,17,1995,6,"male",377,224,81,7,274,7,232,0,42
1079626,27,1,1986,6,"female",809,0,0,0,0,0,0,0,0
1079637,32,12,1981,3,"male",83,4,4,1,2,1,1,0,1
1079642,14,18,1999,2,"male",338,163,111,58,6,57,5,1,1
1079699,23,23,1990,4,"male",498,80,66,0,0,0,0,0,0
1079713,18,5,1995,3,"male",475,418,376,0,0,0,0,0,0
1079773,103,20,1910,11,"male",1503,190,95,110,30,1,5,109,25
1079777,58,6,1955,4,"female",739,260,194,302,374,284,216,18,158
1079778,18,29,1995,3,"female",6,1,1,0,0,0,0,0,0
1079817,37,18,1976,5,"male",572,139,112,4,1,4,1,0,0
1079847,16,27,1997,2,"female",11,47,40,6,9,6,9,0,0
1079853,19,22,1994,3,"male",10,0,0,0,0,0,0,0,0
1079854,58,26,1955,10,"female",1592,40,10,24,67,14,39,10,28
1079890,28,30,1985,11,"female",404,86,60,163,95,111,13,52,82
1079920,17,23,1996,5,"male",149,122,113,47,58,47,49,0,9
1079937,25,28,1988,4,"female",478,263,93,991,305,491,223,500,82
1079946,94,29,1919,3,"female",834,558,222,938,372,448,160,490,212
1079951,16,12,1997,2,"male",293,177,102,4,0,4,0,0,0
1079958,28,19,1985,4,"male",303,3,1,0,0,0,0,0,0
1079968,15,10,1998,1,"male",669,48,43,1,0,0,0,1,0
1079996,24,12,1989,6,"male",35,12,9,5,3,5,0,0,3
1080000,26,12,1987,6,"male",471,61,56,7,0,0,0,7,0
1080014,20,30,1993,8,"male",420,348,250,394,144,90,119,304,25
1080026,23,7,1990,10,"male",311,159,79,0,0,0,0,0,0
1080033,28,1,1985,1,"male",183,38,32,320,271,305,72,15,199
1080053,20,16,1993,5,"female",273,264,89,42,66,41,51,1,15
1080057,46,6,1967,12,"female",1968,1174,962,2404,2003,2315,1331,89,672
1080099,19,28,1994,8,"male",1376,1148,606,340,1236,279,958,61,278
1080100,103,29,1910,4,"male",976,929,647,10,28,10,24,0,4
1080102,32,15,1981,1,"male",103,40,34,0,0,0,0,0,0
1080112,30,27,1983,11,"male",590,176,24,0,7,0,6,0,1
1080113,29,10,1984,3,"male",430,104,100,2,0,2,0,0,0
1080114,28,9,1985,1,"male",90,211,163,20,14,2,5,18,9
1080116,23,16,1990,8,"male",349,211,147,102,63,102,31,0,32
1080121,28,29,1985,12,"male",556,64,41,0,0,0,0,0,0
1080149,27,2,1986,9,"female",528,159,47,213,17,213,8,0,9
1080158,72,17,1941,6,"female",289,19,7,0,1,0,0,0,1
1080180,16,20,1997,2,"male",419,74,41,22,16,22,15,0,1
1080184,15,2,1998,3,"female",449,2113,442,328,720,319,459,9,261
1080218,17,30,1996,12,"male",524,27,15,0,0,0,0,0,0
1080227,36,3,1977,6,"female",168,163,146,189,178,189,151,0,27
1080304,23,18,1990,5,"male",158,13,10,0,0,0,0,0,0
1080339,42,4,1971,5,"female",468,3,2,7,0,7,0,0,0
1080363,43,1,1970,3,"male",326,19,16,2,4,2,2,0,2
1080381,16,16,1997,1,"male",465,999,658,1102,1087,699,471,403,616
1080415,18,1,1995,7,"male",136,40,37,0,8,0,7,0,1
1080457,37,10,1976,9,"female",409,206,188,124,127,119,77,5,50
1080464,21,31,1992,8,"female",900,41,23,478,156,363,69,115,87
1080477,94,6,1919,8,"male",674,14,3,0,0,0,0,0,0
1080514,48,29,1965,1,"female",503,33,27,14,5,14,2,0,3
1080515,19,18,1994,11,"female",415,9,4,0,0,0,0,0,0
1080518,27,3,1986,1,"male",602,330,242,3,0,3,0,0,0
1080547,22,1,1991,1,"male",355,0,0,0,0,0,0,0,0
1080562,108,7,1905,3,"male",1615,82,60,17,58,0,10,17,48
1080581,108,5,1905,9,"male",961,147,109,23,52,0,19,23,33
1080605,18,1,1995,10,"male",111,16,8,0,0,0,0,0,0
1080627,73,11,1940,6,"male",1230,171,94,207,39,157,19,50,20
1080655,53,13,1960,10,"male",517,6,5,0,0,0,0,0,0
1080665,22,10,1991,10,"female",349,121,64,11,32,11,20,0,12
1080670,57,19,1956,2,"female",2150,44,13,337,99,319,65,18,34
1080675,24,5,1989,12,"female",306,463,243,7,4,0,0,7,4
1080685,15,17,1998,8,"female",472,613,284,2,0,2,0,0,0
1080691,103,10,1910,10,"male",1765,461,339,60,132,1,58,59,74
1080726,20,30,1993,1,"female",123,15,10,0,3,0,3,0,0
1080741,38,31,1975,1,"male",417,50,17,36,4,36,2,0,2
1080747,18,14,1995,11,"male",377,245,137,821,604,734,476,87,128
1080753,44,4,1969,6,"male",393,18,7,0,19,0,19,0,0
1080776,85,6,1928,10,"female",2057,493,183,85,124,73,69,12,55
1080827,29,20,1984,10,"female",88,6,5,1,0,1,0,0,0
1080855,55,14,1958,4,"male",1015,39,33,0,1,0,1,0,0
1080890,41,10,1972,9,"female",692,307,256,456,270,456,81,0,189
1080891,14,2,1999,1,"female",311,230,167,24,4,15,4,9,0
1080947,54,24,1959,12,"male",1369,124,88,3,21,3,1,0,20
1080951,18,17,1995,3,"male",69,94,83,2,12,2,6,0,6
1080971,18,8,1995,7,"male",318,105,69,0,4,0,3,0,1
1081006,49,26,1964,12,"female",1794,50,19,25,170,25,66,0,104
1081011,15,7,1998,5,"male",34,283,74,41,81,40,39,1,42
1081045,31,15,1982,6,"male",460,2,1,0,0,0,0,0,0
1081051,61,1,1952,7,"female",225,18,13,0,5,0,0,0,5
1081100,27,9,1986,7,"female",206,38,27,3,22,3,18,0,4
1081103,28,6,1985,2,"female",492,39,2,19,0,19,0,0,0
1081130,108,1,1905,1,"female",112,203,167,29,6,0,5,29,1
1081132,30,4,1983,4,"male",124,39,16,0,0,0,0,0,0
1081133,17,1,1996,5,"female",136,117,85,146,145,145,90,1,55
1081146,51,15,1962,6,"female",34,27,17,118,158,118,123,0,35
1081149,26,10,1987,6,"male",423,148,30,14,18,14,13,0,5
1081176,20,27,1993,12,"female",259,113,15,1,16,1,14,0,2
1081206,68,27,1945,3,"female",1717,294,202,387,627,1,209,386,418
1081209,27,28,1986,6,"male",90,65,55,6,0,6,0,0,0
1081218,54,13,1959,7,"male",1426,190,51,6,9,6,5,0,4
1081221,64,4,1949,11,"female",401,38,18,10,6,0,4,10,2
1081253,52,30,1961,6,"female",129,2,1,0,0,0,0,0,0
1081255,22,6,1991,10,"male",449,34,13,0,1,0,0,0,1
1081264,14,27,1999,1,"female",374,232,160,7,1,7,1,0,0
1081270,24,9,1989,10,"male",285,170,155,187,86,187,63,0,23
1081287,61,21,1952,7,"female",112,120,77,5,11,0,4,5,7
1081289,21,14,1992,4,"female",146,356,38,42,205,38,199,4,6
1081293,108,19,1905,10,"male",1861,2234,680,44,166,2,45,42,121
1081299,18,12,1995,11,"male",180,194,161,175,37,164,20,11,17
1081336,40,24,1973,10,"female",108,1,0,7,3,4,2,3,1
1081377,33,23,1980,1,"female",1070,128,75,209,399,88,125,121,274
1081398,18,1,1995,1,"male",280,226,219,0,11,0,3,0,8
1081401,29,20,1984,4,"female",1342,357,200,114,359,99,49,15,310
1081408,44,25,1969,5,"male",183,1,1,0,0,0,0,0,0
1081418,14,17,1999,3,"male",432,242,170,3,1,3,0,0,1
1081460,108,21,1905,5,"male",243,116,91,1,1,1,1,0,0
1081463,14,20,1999,8,"female",392,527,105,1005,543,904,388,101,155
1081489,33,21,1980,8,"female",37,2,2,21,4,6,2,15,2
1081499,18,23,1995,5,"male",160,24,9,0,0,0,0,0,0
1081511,59,23,1954,11,"male",192,19,3,9,17,9,5,0,12
1081531,33,16,1980,8,"male",330,65,35,6,28,6,14,0,14
1081533,49,8,1964,7,"female",195,158,65,179,35,153,11,26,24
1081539,108,26,1905,4,"male",82,71,38,1,0,1,0,0,0
1081551,33,28,1980,5,"male",878,39,13,0,0,0,0,0,0
1081554,18,2,1995,4,"male",825,620,478,807,401,751,304,56,97
1081556,35,5,1978,5,"male",19,22,10,6,4,5,1,1,3
1081567,50,8,1963,4,"female",776,68,33,74,161,74,83,0,78
1081568,25,17,1988,8,"male",387,134,37,0,1,0,0,0,1
1081576,43,29,1970,3,"female",755,66,52,95,89,94,85,1,4
1081578,35,17,1978,5,"male",433,24,6,0,0,0,0,0,0
1081597,31,1,1982,5,"male",249,20,20,0,0,0,0,0,0
1081640,35,7,1978,2,"female",206,2,0,0,0,0,0,0,0
1081690,34,1,1979,1,"male",20,4,4,0,0,0,0,0,0
1081721,63,13,1950,10,"male",269,56,32,43,66,0,32,43,34
1081765,31,5,1982,11,"male",116,37,30,8,1,8,0,0,1
1081768,29,10,1984,12,"female",386,109,83,2,0,2,0,0,0
1081775,41,29,1972,9,"female",184,50,27,2,2,0,2,2,0
1081788,19,19,1994,12,"male",399,29,9,46,20,46,11,0,9
1081835,18,15,1995,9,"female",268,185,143,9,3,9,3,0,0
1081836,69,15,1944,3,"female",1456,106,24,14,26,0,12,14,14
1081837,49,22,1964,1,"male",378,1,0,0,0,0,0,0,0
1081856,15,27,1998,12,"male",561,202,88,0,13,0,8,0,5
1081861,46,20,1967,9,"male",2202,101,38,9,30,9,30,0,0
1081868,68,17,1945,8,"male",561,841,555,75,50,75,34,0,16
1081870,20,25,1993,9,"female",78,72,29,0,0,0,0,0,0
1081899,14,14,1999,9,"male",217,37,27,0,5,0,5,0,0
1081904,48,25,1965,3,"male",461,244,180,0,0,0,0,0,0
1081907,20,22,1993,7,"male",459,90,34,46,142,0,122,46,20
1081918,39,12,1974,10,"male",381,42,39,19,2,19,2,0,0
1081952,64,28,1949,6,"female",89,34,12,85,49,29,31,56,18
1081981,13,13,2000,2,"male",136,135,93,0,1,0,1,0,0
1082026,60,7,1953,7,"male",1433,1259,647,28,1121,28,481,0,640
1082037,72,15,1941,3,"female",1499,55,45,283,21,0,8,283,13
1082040,58,14,1955,7,"male",1277,47,19,1,1,1,1,0,0
1082056,16,26,1997,2,"male",285,440,314,3,5,3,4,0,1
1082070,70,29,1943,10,"male",1349,68,39,0,0,0,0,0,0
1082123,18,31,1995,12,"male",64,27,22,0,0,0,0,0,0
1082133,23,24,1990,3,"female",746,86,59,0,1,0,1,0,0
1082134,23,15,1990,11,"female",324,7,7,0,0,0,0,0,0
1082152,70,9,1943,11,"female",450,25,15,0,8,0,5,0,3
1082171,16,8,1997,3,"female",823,190,101,42,3,42,3,0,0
1082174,17,5,1996,8,"male",343,694,414,9,26,4,11,5,15
1082210,49,23,1964,2,"female",245,84,26,144,26,144,25,0,1
1082252,19,26,1994,3,"male",347,153,139,10,0,0,0,10,0
1082263,37,24,1976,10,"female",432,109,59,1816,922,1816,636,0,286
1082268,24,11,1989,5,"male",283,148,61,0,0,0,0,0,0
1082274,20,2,1993,7,"female",504,682,552,3038,169,2921,61,117,108
1082302,16,1,1997,3,"female",93,429,190,215,340,215,271,0,69
1082314,27,1,1986,1,"female",244,25,14,3,0,0,0,3,0
1082316,43,20,1970,9,"male",233,14,3,0,1,0,0,0,1
1082320,18,23,1995,10,"male",10,51,43,28,21,0,9,28,12
1082330,46,27,1967,2,"male",681,29,17,7,13,5,8,2,5
1082336,67,26,1946,12,"female",1712,130,66,166,91,125,55,41,36
1082351,31,29,1982,6,"male",405,38,33,0,0,0,0,0,0
1082380,57,21,1956,5,"male",677,139,77,711,233,48,101,663,132
1082452,69,11,1944,6,"male",1597,839,465,5,14,0,3,5,11
1082489,31,22,1982,6,"male",460,137,133,0,0,0,0,0,0
1082495,44,15,1969,12,"male",397,23,14,0,4,0,2,0,2
1082510,46,10,1967,3,"male",682,32,12,9,9,9,9,0,0
1082531,43,7,1970,2,"male",453,16,8,1,0,1,0,0,0
1082562,16,1,1997,8,"female",41,82,78,8,6,8,6,0,0
1082618,76,27,1937,10,"female",227,14,12,40,4,0,0,40,4
1082623,54,24,1959,7,"male",1565,32,10,45,10,42,9,3,1
1082634,57,26,1956,11,"male",1374,132,103,0,0,0,0,0,0
1082686,32,10,1981,2,"male",1106,275,185,0,3,0,2,0,1
1082716,38,2,1975,1,"male",44,0,0,2,0,0,0,2,0
1082720,37,25,1976,3,"female",992,62,38,110,346,110,256,0,90
1082721,113,1,1900,1,"male",1664,221,60,4,18,4,13,0,5
1082746,25,19,1988,11,"male",184,33,16,44,20,44,14,0,6
1082752,57,21,1956,9,"male",580,921,674,11,40,2,11,9,29
1082756,18,8,1995,8,"female",463,4380,426,0,138,0,103,0,35
1082775,22,5,1991,6,"male",798,567,460,537,349,537,316,0,33
1082782,41,12,1972,12,"female",276,59,35,225,105,225,72,0,33
1082801,29,2,1984,8,"male",222,13,10,1,2,1,2,0,0
1082829,102,11,1911,9,"male",1064,64,57,0,1,0,0,0,1
1082832,19,15,1994,4,"male",1078,35,18,105,11,82,3,23,8
1082871,22,26,1991,4,"female",495,316,204,40,71,40,28,0,43
1082873,88,12,1925,5,"male",1722,417,206,6,38,6,23,0,15
1082875,21,15,1992,10,"male",772,416,304,135,40,96,38,39,2
1082904,83,14,1930,8,"female",1456,218,66,41,138,41,110,0,28
1082911,23,12,1990,7,"female",166,32,24,0,1,0,1,0,0
1082976,23,5,1990,12,"male",647,38,28,8,5,8,3,0,2
1083000,21,2,1992,1,"male",353,113,50,2,0,2,0,0,0
1083007,29,10,1984,7,"male",104,85,45,6,1,6,1,0,0
1083024,35,25,1978,9,"male",226,8,3,20,3,0,1,20,2
1083026,34,1,1979,1,"male",362,174,144,13,4,13,4,0,0
1083074,30,16,1983,6,"male",340,136,120,86,43,86,39,0,4
1083091,67,28,1946,7,"female",756,7,6,0,0,0,0,0,0
1083105,25,8,1988,12,"female",376,197,131,68,64,68,64,0,0
1083107,14,18,1999,5,"female",156,156,98,11,15,4,5,7,10
1083111,46,11,1967,3,"female",1764,294,107,1586,610,374,224,1212,386
1083118,36,28,1977,6,"female",2157,65,50,73,91,40,70,33,21
1083137,43,24,1970,8,"male",635,36,21,0,0,0,0,0,0
1083138,65,3,1948,2,"male",443,57,25,11,11,11,2,0,9
1083147,48,16,1965,7,"female",437,3,2,1,3,0,0,1,3
1083173,45,10,1968,11,"male",173,0,0,7,6,7,6,0,0
1083182,57,12,1956,2,"male",1063,123,69,57,94,36,68,21,26
1083187,32,20,1981,11,"male",1385,175,118,3,2,3,2,0,0
1083201,21,3,1992,1,"male",633,522,274,90,708,86,500,4,208
1083208,57,19,1956,2,"male",304,58,24,121,18,0,15,121,3
1083223,30,31,1983,7,"male",247,295,238,1459,207,1459,164,0,43
1083247,21,28,1992,12,"female",354,43,4,0,0,0,0,0,0
1083250,101,29,1912,4,"male",548,37,28,4,0,4,0,0,0
1083277,19,16,1994,7,"female",232,232,180,1,4,1,3,0,1
1083289,21,9,1992,3,"female",336,133,108,716,49,454,20,262,29
1083294,38,15,1975,12,"female",332,102,95,14,9,0,0,14,9
1083324,53,1,1960,6,"male",1336,185,53,11,14,0,8,11,6
1083338,69,13,1944,6,"female",1555,195,129,2583,834,2583,615,0,219
1083379,20,7,1993,5,"male",475,249,140,174,251,174,78,0,173
1083386,44,10,1969,1,"male",616,34,21,0,2,0,2,0,0
1083460,51,4,1962,4,"male",640,25,4,18,21,1,8,17,13
1083483,33,8,1980,10,"female",139,11,8,0,0,0,0,0,0
1083486,108,6,1905,10,"male",2332,574,232,200,252,139,178,61,74
1083487,35,6,1978,9,"male",329,54,23,0,0,0,0,0,0
1083519,26,4,1987,2,"male",1654,221,93,128,107,20,38,108,69
1083557,18,19,1995,12,"male",372,80,52,18,13,17,3,1,10
1083587,24,23,1989,12,"female",322,2,2,0,0,0,0,0,0
1083594,19,30,1994,5,"male",375,3,3,0,0,0,0,0,0
1083626,36,14,1977,5,"male",222,133,118,4,4,4,4,0,0
1083634,53,26,1960,5,"female",1802,115,71,154,181,13,126,141,55
1083644,20,7,1993,7,"male",407,422,303,22,176,22,153,0,23
1083677,21,19,1992,11,"male",293,29,6,38,0,0,0,38,0
1083684,64,11,1949,3,"male",938,139,96,0,0,0,0,0,0
1083686,45,13,1968,11,"male",315,108,96,29,5,28,2,1,3
1083725,26,3,1987,9,"female",457,77,52,501,361,145,253,356,108
1083768,25,1,1988,1,"female",182,101,47,6,16,6,9,0,7
1083779,17,13,1996,6,"male",420,92,80,11,1,11,1,0,0
1083787,26,25,1987,2,"male",110,28,19,0,0,0,0,0,0
1083795,61,17,1952,4,"male",756,36,21,2,14,2,11,0,3
1083817,15,2,1998,3,"male",337,7,7,0,0,0,0,0,0
1083836,43,20,1970,8,"male",361,21,6,2,0,2,0,0,0
1083838,66,29,1947,12,"male",511,291,266,1046,473,9,67,1037,406
1083846,113,3,1900,8,"female",1311,20,7,14,1,0,0,14,1
1083911,44,21,1969,7,"female",91,59,44,34,25,31,14,3,11
1083943,32,1,1981,11,"female",1357,225,107,267,492,142,264,125,228
1083945,23,4,1990,5,"female",316,69,37,2,25,2,21,0,4
1083967,50,26,1963,7,"female",581,107,77,3,1,3,1,0,0
1083984,71,6,1942,4,"male",1253,24,18,4,5,4,4,0,1
1084003,29,17,1984,3,"male",233,33,31,0,2,0,2,0,0
1084007,22,27,1991,6,"female",561,284,51,154,256,138,81,16,175
1084045,58,16,1955,1,"female",420,38,24,0,0,0,0,0,0
1084070,64,2,1949,10,"male",27,19,14,0,0,0,0,0,0
1084077,87,5,1926,11,"male",1405,3850,551,125,626,8,490,117,136
1084086,19,12,1994,2,"male",227,221,182,1,1,0,0,1,1
1084100,38,13,1975,3,"female",230,66,39,73,3,59,0,14,3
1084117,80,22,1933,1,"female",1048,42,32,176,127,158,51,18,76
1084128,60,25,1953,8,"female",374,581,426,0,0,0,0,0,0
1084141,23,11,1990,10,"male",462,405,254,52,51,36,18,16,33
1084149,55,23,1958,12,"female",634,29,17,343,158,343,158,0,0
1084210,44,5,1969,7,"male",476,423,136,69,120,69,54,0,66
1084211,24,31,1989,12,"male",214,127,107,12,0,12,0,0,0
1084227,24,1,1989,1,"male",152,26,25,1,0,0,0,1,0
1084235,61,1,1952,5,"female",684,15,9,1,2,1,1,0,1
1084246,44,15,1969,5,"female",58,0,0,0,0,0,0,0,0
1084291,28,25,1985,11,"female",375,169,151,64,16,46,5,18,11
1084306,30,17,1983,3,"male",662,532,255,46,60,44,42,2,18
1084311,18,19,1995,4,"male",640,62,19,0,0,0,0,0,0
1084319,53,4,1960,3,"male",185,67,54,0,0,0,0,0,0
1084322,27,19,1986,8,"male",490,122,23,9,0,9,0,0,0
1084342,55,17,1958,5,"female",297,32,25,26,5,26,4,0,1
1084346,23,6,1990,6,"male",539,1311,1051,74,69,74,61,0,8
1084348,22,18,1991,10,"female",499,158,73,14,19,3,7,11,12
1084377,49,5,1964,8,"female",1515,153,33,301,1047,0,129,301,918
1084392,103,25,1910,11,"male",1304,305,90,7,6,7,4,0,2
1084400,31,11,1982,12,"male",561,23,20,0,3,0,3,0,0
1084412,24,7,1989,4,"male",777,918,726,63,18,63,18,0,0
1084416,20,5,1993,6,"male",367,125,86,0,3,0,3,0,0
1084487,21,5,1992,8,"male",906,620,170,1,0,1,0,0,0
1084513,14,26,1999,5,"female",346,463,360,0,0,0,0,0,0
1084518,52,7,1961,10,"male",333,155,70,14,15,0,0,14,15
1084532,63,2,1950,4,"male",552,146,113,44,28,0,4,44,24
1084563,62,16,1951,10,"female",440,62,25,40,15,40,10,0,5
1084568,18,1,1995,12,"female",138,23,14,118,145,118,51,0,94
1084577,35,17,1978,3,"male",490,31,22,0,3,0,3,0,0
1084590,23,3,1990,3,"female",1204,387,153,0,6,0,5,0,1
1084592,67,22,1946,2,"male",1750,63,18,9,2,0,1,9,1
1084620,21,21,1992,11,"female",906,46,21,1156,1194,900,465,256,729
1084656,25,3,1988,3,"female",243,14,9,12,2,12,1,0,1
1084676,62,19,1951,2,"female",801,43,24,1,3,0,1,1,2
1084688,30,24,1983,5,"male",288,34,22,0,0,0,0,0,0
1084735,25,1,1988,1,"female",31,3,3,0,0,0,0,0,0
1084766,43,14,1970,8,"female",863,299,203,514,435,372,237,142,198
1084771,29,30,1984,8,"male",702,41,26,2,0,2,0,0,0
1084781,13,2,2000,2,"male",63,98,67,5,1,5,1,0,0
1084793,20,4,1993,10,"male",311,127,93,33,60,9,16,24,44
1084816,88,29,1925,1,"male",1299,489,259,73,25,72,24,1,1
1084888,16,15,1997,3,"male",302,68,45,4,0,0,0,4,0
1084898,17,3,1996,3,"male",229,170,145,2,117,2,33,0,84
1084899,14,14,1999,1,"male",252,115,111,1,0,1,0,0,0
1084934,42,9,1971,4,"female",257,5,3,0,0,0,0,0,0
1085025,44,8,1969,1,"male",413,6,6,0,2,0,2,0,0
1085052,44,6,1969,2,"male",1640,1,0,1,0,0,0,1,0
1085063,15,3,1998,10,"male",292,125,73,0,3,0,2,0,1
1085083,51,16,1962,4,"female",1838,105,56,163,158,161,109,2,49
1085101,47,22,1966,6,"male",254,40,30,16,9,16,6,0,3
1085112,26,7,1987,12,"male",501,97,61,0,3,0,2,0,1
1085145,31,27,1982,1,"male",265,80,72,2,23,2,4,0,19
1085159,30,27,1983,9,"male",961,175,101,564,118,495,50,69,68
1085213,27,21,1986,10,"female",441,633,524,500,346,500,202,0,144
1085224,41,18,1972,12,"male",109,14,13,1,0,1,0,0,0
1085272,33,16,1980,12,"male",223,75,62,67,35,4,7,63,28
1085322,108,28,1905,2,"male",718,439,348,6,37,6,28,0,9
1085362,16,30,1997,4,"female",327,302,181,10,41,0,30,10,11
1085363,31,19,1982,9,"male",336,53,47,2,6,2,6,0,0
1085380,28,26,1985,11,"male",342,179,111,0,1,0,1,0,0
1085390,29,4,1984,1,"male",121,19,19,7,5,7,5,0,0
1085416,43,13,1970,10,"male",563,3,1,70,57,2,16,68,41
1085424,80,23,1933,3,"female",477,78,47,42,91,0,19,42,72
1085444,21,29,1992,5,"male",90,23,13,0,1,0,1,0,0
1085450,50,20,1963,10,"female",91,59,47,8,48,7,36,1,12
1085458,26,12,1987,4,"male",476,110,68,3,4,3,2,0,2
1085462,15,14,1998,7,"female",564,4227,1739,73,118,19,9,54,109
1085478,40,28,1973,3,"male",347,20,13,2,2,2,2,0,0
1085534,18,28,1995,5,"male",50,6,6,0,0,0,0,0,0
1085540,19,7,1994,8,"male",612,254,222,31,17,31,15,0,2
1085566,65,26,1948,4,"male",1094,49,36,71,57,0,3,71,54
1085580,14,23,1999,7,"male",39,60,49,0,0,0,0,0,0
1085588,17,20,1996,3,"male",480,122,101,105,24,76,23,29,1
1085611,19,1,1994,1,"male",29,96,76,7,8,7,8,0,0
1085620,15,27,1998,11,"female",301,341,153,0,10,0,10,0,0
1085700,17,31,1996,3,"female",570,364,143,23,113,22,56,1,57
1085720,17,8,1996,4,"female",60,41,28,0,0,0,0,0,0
1085752,27,17,1986,11,"male",625,1,1,0,0,0,0,0,0
1085766,68,15,1945,10,"male",228,1,1,13,0,13,0,0,0
1085775,15,5,1998,5,"female",24,38,32,322,144,322,63,0,81
1085784,54,15,1959,4,"male",468,48,7,1,9,1,8,0,1
1085808,38,7,1975,12,"female",328,97,68,10,58,7,5,3,53
1085842,18,16,1995,1,"male",137,17,12,0,0,0,0,0,0
1085856,62,31,1951,8,"female",1724,142,101,1005,602,1004,294,1,308
1085876,23,19,1990,9,"male",245,15,11,0,0,0,0,0,0
1085885,48,30,1965,10,"female",215,67,45,261,107,261,67,0,40
1085907,31,30,1982,7,"female",494,82,35,947,274,947,217,0,57
1085929,85,23,1928,4,"female",863,3932,2499,721,2326,686,1747,35,579
1085962,108,13,1905,11,"female",110,554,310,2356,352,0,92,2356,260
1085984,33,10,1980,10,"male",264,37,17,0,0,0,0,0,0
1085992,48,14,1965,11,"female",1609,75,40,23,26,23,23,0,3
1086008,25,2,1988,7,"male",451,26,18,21,1,21,1,0,0
1086027,19,12,1994,6,"female",527,743,378,217,255,134,98,83,157
1086066,39,5,1974,4,"male",90,30,14,0,0,0,0,0,0
1086073,18,25,1995,11,"male",10,4,3,1,0,1,0,0,0
1086076,66,26,1947,8,"female",1696,233,158,280,95,280,79,0,16
1086082,37,18,1976,3,"male",538,14,12,72,24,24,4,48,20
1086114,63,10,1950,7,"female",983,216,112,250,875,0,123,250,752
1086146,58,23,1955,9,"female",460,31,13,9,21,9,18,0,3
1086150,17,6,1996,6,"male",419,312,151,31,18,31,15,0,3
1086155,17,6,1996,9,"male",260,102,89,0,2,0,0,0,2
1086182,28,17,1985,10,"male",265,82,54,7,15,7,7,0,8
1086226,53,25,1960,9,"female",286,86,31,43,34,0,12,43,22
1086227,60,8,1953,10,"female",139,55,36,948,807,15,172,933,635
1086253,19,7,1994,3,"male",99,45,36,64,16,6,3,58,13
1086258,18,26,1995,12,"male",46,11,9,1,1,0,0,1,1
1086292,57,31,1956,5,"female",820,64,37,298,38,2,16,296,22
1086304,14,9,1999,9,"male",178,0,0,0,0,0,0,0,0
1086315,57,17,1956,1,"female",381,1,1,0,0,0,0,0,0
1086321,23,31,1990,12,"male",160,62,59,1,0,1,0,0,0
1086332,25,17,1988,3,"male",657,1,0,0,0,0,0,0,0
1086347,14,1,1999,2,"male",77,59,56,0,28,0,13,0,15
1086410,22,20,1991,12,"female",307,49,29,174,394,159,141,15,253
1086430,15,3,1998,4,"female",656,93,71,50,13,30,6,20,7
1086451,14,4,1999,8,"female",866,569,409,1395,318,1215,233,180,85
1086463,24,17,1989,12,"male",153,296,187,8,38,8,3,0,35
1086468,66,16,1947,4,"female",77,23,8,5,3,5,2,0,1
1086478,31,25,1982,2,"female",336,27,26,140,18,140,18,0,0
1086558,31,17,1982,10,"male",1165,133,52,2,7,0,1,2,6
1086571,95,26,1918,12,"female",1926,829,260,33,45,0,19,33,26
1086600,48,16,1965,10,"female",3,1,0,0,0,0,0,0,0
1086607,51,24,1962,12,"female",603,105,42,27,12,19,10,8,2
1086672,24,26,1989,4,"male",960,264,125,145,151,145,134,0,17
1086694,56,14,1957,8,"male",33,8,2,0,0,0,0,0,0
1086715,23,3,1990,2,"male",683,548,312,24,2,24,2,0,0
1086771,66,13,1947,12,"female",642,23,10,3,0,0,0,3,0
1086782,108,15,1905,5,"male",1734,314,70,31,0,29,0,2,0
1086799,34,11,1979,6,"female",633,742,557,247,137,176,34,71,103
1086831,27,27,1986,5,"female",273,64,45,0,0,0,0,0,0
1086847,15,19,1998,10,"female",365,315,211,992,128,87,56,905,72
1086856,18,18,1995,4,"male",541,105,85,0,0,0,0,0,0
1086895,17,16,1996,1,"female",157,454,328,193,67,193,42,0,25
1086901,58,16,1955,11,"male",139,70,34,4280,558,4280,391,0,167
1086906,32,8,1981,5,"male",368,284,184,451,75,451,59,0,16
1086946,62,18,1951,9,"female",1807,24,10,469,52,0,9,469,43
1086959,46,9,1967,6,"female",199,115,110,4,0,4,0,0,0
1087009,20,31,1993,12,"male",468,95,49,0,1,0,1,0,0
1087050,33,17,1980,7,"female",502,34,22,31,47,31,10,0,37
1087056,19,9,1994,12,"female",403,5,4,1,2,1,2,0,0
1087059,17,4,1996,4,"male",221,99,52,7,83,7,59,0,24
1087063,61,8,1952,1,"female",1338,101,58,196,159,163,86,33,73
1087084,26,1,1987,2,"male",760,349,151,0,0,0,0,0,0
1087093,64,21,1949,11,"female",600,149,97,11,28,0,5,11,23
1087134,18,12,1995,8,"male",70,226,200,15,51,15,46,0,5
1087151,48,2,1965,2,"male",220,73,54,0,0,0,0,0,0
1087175,65,11,1948,1,"female",751,92,81,459,172,0,109,459,63
1087188,42,23,1971,4,"male",557,11,10,1,0,0,0,1,0
1087201,22,22,1991,1,"male",359,43,33,0,0,0,0,0,0
1087214,16,3,1997,7,"male",508,1209,733,7,113,7,72,0,41
1087215,23,3,1990,12,"male",468,385,282,809,165,572,121,237,44
1087231,21,3,1992,9,"male",844,1693,777,31,102,31,81,0,21
1087235,45,16,1968,6,"male",540,0,0,0,0,0,0,0,0
1087244,18,6,1995,4,"female",423,94,49,104,43,104,41,0,2
1087298,31,6,1982,8,"female",302,32,23,6,0,0,0,6,0
1087300,23,4,1990,4,"female",279,211,112,2407,1582,487,215,1920,1367
1087334,18,13,1995,8,"male",408,17,11,3,0,3,0,0,0
1087382,23,1,1990,1,"male",260,0,0,0,0,0,0,0,0
1087402,28,4,1985,3,"male",852,107,73,51,48,41,17,10,31
1087410,19,1,1994,1,"male",814,119,82,1,0,1,0,0,0
1087412,18,2,1995,3,"male",160,10,7,0,0,0,0,0,0
1087417,18,1,1995,2,"male",47,31,22,5,0,5,0,0,0
1087437,32,28,1981,8,"female",409,126,55,232,123,232,115,0,8
1087471,24,17,1989,2,"male",339,491,382,16,11,16,11,0,0
1087511,23,9,1990,9,"male",762,1070,503,196,271,196,249,0,22
1087513,23,23,1990,3,"male",276,98,72,4,13,4,3,0,10
1087528,42,8,1971,8,"male",236,33,23,2,1,2,1,0,0
1087548,25,6,1988,2,"female",480,270,119,17,73,17,39,0,34
1087559,27,26,1986,3,"male",337,111,17,25,0,25,0,0,0
1087562,16,17,1997,9,"male",71,182,124,3,1,2,1,1,0
1087575,16,16,1997,12,"male",174,87,68,3,1,3,0,0,1
1087594,25,7,1988,7,"male",35,9,5,0,0,0,0,0,0
1087598,30,19,1983,5,"female",663,195,71,31,17,19,3,12,14
1087602,14,7,1999,6,"female",3,3,0,0,0,0,0,0,0
1087611,20,6,1993,5,"male",350,56,45,2,0,2,0,0,0
1087617,22,21,1991,8,"male",681,146,69,1,2,1,1,0,1
1087621,38,9,1975,5,"male",470,295,177,4932,1,4920,1,12,0
1087623,19,20,1994,1,"male",469,84,66,30,1,0,1,30,0
1087643,50,11,1963,8,"female",1460,31,14,60,0,54,0,6,0
1087672,19,19,1994,12,"male",466,1,1,0,0,0,0,0,0
1087675,38,9,1975,12,"male",263,47,16,2,6,0,1,2,5
1087699,19,5,1994,9,"male",653,3623,856,215,6699,162,5111,53,1588
1087706,41,25,1972,10,"female",208,76,35,1,14,1,12,0,2
1087709,18,23,1995,12,"male",249,584,310,58,23,58,15,0,8
1087716,14,13,1999,3,"female",79,407,138,404,214,379,165,25,49
1087731,21,17,1992,7,"male",1475,240,120,0,2,0,2,0,0
1087749,19,13,1994,7,"female",278,16,8,32,8,32,6,0,2
1087752,17,6,1996,10,"male",391,198,42,9,11,8,9,1,2
1087753,29,18,1984,6,"male",540,33,15,41,13,41,12,0,1
1087766,15,31,1998,10,"male",193,120,109,0,1,0,0,0,1
1087795,26,11,1987,2,"male",170,34,33,5,0,5,0,0,0
1087803,22,18,1991,7,"male",183,14,12,8,2,7,2,1,0
1087818,103,6,1910,9,"male",449,61,38,3,2,1,0,2,2
1087819,69,18,1944,8,"male",1209,45,18,2,3,2,0,0,3
1087829,14,9,1999,1,"male",299,122,101,0,0,0,0,0,0
1087844,28,1,1985,1,"male",333,18,13,2,1,2,1,0,0
1087865,18,9,1995,6,"male",267,1037,639,4,4,0,0,4,4
1087874,61,6,1952,6,"female",144,17,9,6,58,6,55,0,3
1087884,13,10,2000,1,"female",440,330,168,1770,652,1770,374,0,278
1087896,20,29,1993,11,"male",441,43,30,2,1,2,1,0,0
1087919,22,13,1991,9,"male",419,57,17,22,10,2,7,20,3
1087953,50,26,1963,5,"female",771,40,20,53,41,0,28,53,13
1087976,103,7,1910,10,"male",782,66,33,8,17,8,11,0,6
1087991,19,5,1994,1,"female",63,497,324,5768,6467,219,2188,5549,4279
1087997,17,1,1996,4,"male",36,0,0,0,0,0,0,0,0
1088008,38,20,1975,1,"male",478,0,0,0,0,0,0,0,0
1088032,20,1,1993,1,"male",646,545,427,9,6,9,4,0,2
1088044,27,8,1986,5,"male",29,12,12,0,0,0,0,0,0
1088062,21,1,1992,1,"male",363,77,34,21,34,3,22,18,12
1088082,14,11,1999,2,"female",165,467,243,1244,1124,709,821,535,303
1088110,58,5,1955,2,"female",653,26,17,4,1,4,1,0,0
1088141,50,21,1963,6,"female",1134,208,70,16,31,16,11,0,20
1088184,24,4,1989,4,"female",549,42,35,0,0,0,0,0,0
1088205,68,1,1945,5,"female",682,49,17,15,119,0,20,15,99
1088212,57,11,1956,2,"male",1706,13,6,1,0,0,0,1,0
1088217,58,23,1955,9,"male",787,101,47,43,59,0,9,43,50
1088242,22,9,1991,5,"male",434,146,121,0,0,0,0,0,0
1088245,68,10,1945,6,"male",503,97,50,112,32,0,10,112,22
1088273,21,4,1992,6,"male",453,97,64,32,13,6,4,26,9
1088297,19,12,1994,7,"female",644,335,81,7,14,7,5,0,9
1088343,63,11,1950,7,"female",530,48,33,12,1,0,0,12,1
1088353,13,16,2000,8,"male",74,66,55,1,10,0,5,1,5
1088357,28,1,1985,8,"female",598,5,4,130,28,130,27,0,1
1088361,18,10,1995,9,"female",565,1042,466,337,129,12,63,325,66
1088371,48,24,1965,5,"female",6,48,42,3,8,0,1,3,7
1088391,18,26,1995,7,"female",20,218,131,1038,674,308,188,730,486
1088408,31,6,1982,8,"male",394,93,77,2,7,2,4,0,3
1088412,17,16,1996,11,"female",164,189,121,180,281,100,121,80,160
1088420,24,26,1989,7,"female",525,138,127,238,236,176,141,62,95
1088439,48,15,1965,7,"male",530,93,83,203,61,148,13,55,48
1088445,83,1,1930,3,"male",1303,230,68,285,72,0,21,285,51
1088456,108,27,1905,7,"male",1131,406,204,95,166,48,116,47,50
1088475,18,15,1995,9,"female",822,215,96,45,138,21,74,24,64
1088482,22,7,1991,5,"male",178,61,38,30,57,30,55,0,2
1088540,100,9,1913,11,"female",2144,1690,1315,1225,555,578,329,647,226
1088566,15,15,1998,1,"male",40,33,22,17,4,10,0,7,4
1088569,20,1,1993,1,"male",163,25,17,0,0,0,0,0,0
1088579,83,25,1930,7,"male",1277,42,26,1,1,0,0,1,1
1088603,27,18,1986,9,"male",209,36,30,0,0,0,0,0,0
1088607,44,3,1969,3,"male",217,164,85,37,69,37,26,0,43
1088668,66,16,1947,9,"female",1254,23,15,98,12,97,12,1,0
1088676,44,16,1969,1,"male",1176,96,36,15,235,15,206,0,29
1088685,22,1,1991,1,"male",542,0,0,0,0,0,0,0,0
1088736,27,20,1986,7,"female",668,125,88,0,0,0,0,0,0
1088739,15,25,1998,7,"female",354,750,244,211,214,157,156,54,58
1088743,31,6,1982,8,"male",244,205,181,0,0,0,0,0,0
1088763,16,15,1997,12,"male",361,203,154,234,62,234,30,0,32
1088770,44,24,1969,9,"male",229,60,53,3,2,0,2,3,0
1088786,48,21,1965,12,"male",880,48,24,18,0,18,0,0,0
1088791,26,26,1987,10,"male",587,207,41,1,1,1,1,0,0
1088796,33,9,1980,4,"male",1053,17,9,3,1,3,1,0,0
1088827,108,29,1905,3,"female",112,93,84,122,66,87,23,35,43
1088847,29,1,1984,1,"male",385,138,131,0,0,0,0,0,0
1088850,55,2,1958,6,"female",941,187,122,99,1,98,0,1,1
1088892,22,26,1991,5,"female",938,11,9,3,0,0,0,3,0
1088941,21,10,1992,6,"female",658,62,24,0,0,0,0,0,0
1088961,42,18,1971,12,"female",659,110,59,107,95,80,78,27,17
1088970,21,26,1992,2,"female",57,59,54,332,1454,202,996,130,458
1088981,21,23,1992,12,"female",427,124,72,484,81,474,56,10,25
1088999,108,28,1905,2,"female",950,252,194,21,44,14,34,7,10
1089010,103,25,1910,8,"male",637,204,142,15,75,15,33,0,42
1089013,25,1,1988,2,"male",62,40,27,519,353,519,190,0,163
1089042,76,25,1937,1,"female",983,36,25,14,8,0,5,14,3
1089067,103,18,1910,6,"female",593,682,82,62,72,21,39,41,33
1089072,26,17,1987,2,"female",671,155,65,26,43,25,34,1,9
1089104,50,17,1963,7,"male",473,37,18,0,0,0,0,0,0
1089112,41,23,1972,2,"female",365,309,202,260,168,260,166,0,2
1089122,26,7,1987,5,"male",2081,21,6,1,0,0,0,1,0
1089127,20,12,1993,4,"female",661,530,251,51,35,48,23,3,12
1089129,28,23,1985,12,"female",742,180,54,14,85,11,20,3,65
1089135,54,29,1959,8,"male",1575,52,17,88,108,45,76,43,32
1089143,23,12,1990,12,"male",465,682,555,20,89,20,54,0,35
1089220,53,18,1960,3,"female",273,57,51,257,25,257,24,0,1
1089223,48,6,1965,4,"female",1762,234,131,3050,3128,1536,1395,1514,1733
1089237,22,23,1991,11,"male",962,330,230,0,0,0,0,0,0
1089252,20,23,1993,6,"male",409,60,23,6,26,0,25,6,1
1089256,31,2,1982,2,"male",283,0,0,0,0,0,0,0,0
1089258,20,20,1993,3,"male",804,367,217,5,3,5,3,0,0
1089270,41,6,1972,1,"male",333,85,58,16,0,3,0,13,0
1089273,22,16,1991,4,"female",243,0,0,0,0,0,0,0,0
1089286,24,19,1989,10,"male",293,133,112,17,2,17,2,0,0
1089289,38,1,1975,1,"female",2105,172,95,55,43,54,38,1,5
1089298,21,3,1992,5,"male",341,612,542,20,14,20,12,0,2
1089316,24,5,1989,2,"male",144,26,23,7,13,7,9,0,4
1089359,55,20,1958,9,"female",297,165,149,16,52,6,36,10,16
1089360,53,27,1960,9,"male",1587,90,33,5,36,5,27,0,9
1089384,29,5,1984,3,"male",181,65,62,0,0,0,0,0,0
1089393,36,3,1977,12,"male",392,44,41,9,0,0,0,9,0
1089398,32,20,1981,1,"male",596,35,24,0,0,0,0,0,0
1089447,20,26,1993,12,"male",415,178,146,0,0,0,0,0,0
1089460,68,25,1945,2,"male",1159,840,805,2,1,2,0,0,1
1089462,38,26,1975,10,"female",260,74,35,738,430,738,294,0,136
1089468,103,20,1910,11,"male",1540,458,251,208,346,57,207,151,139
1089471,22,17,1991,11,"female",430,185,104,115,57,21,19,94,38
1089499,19,1,1994,7,"male",25,38,36,23,5,12,4,11,1
1089511,75,9,1938,9,"female",1580,641,221,32,11,4,5,28,6
1089582,33,23,1980,8,"female",59,83,38,54,3,54,1,0,2
1089611,47,5,1966,11,"female",311,51,18,1323,163,0,11,1323,152
1089641,20,21,1993,5,"female",761,909,110,6170,5862,1007,4783,5163,1079
1089655,54,21,1959,8,"male",713,163,9,6,5,3,3,3,2
1089677,27,1,1986,7,"male",1144,43,26,27,0,27,0,0,0
1089708,33,5,1980,10,"male",610,20,6,200,72,200,54,0,18
1089758,14,26,1999,8,"male",567,510,154,26,23,0,13,26,10
1089760,21,25,1992,10,"female",675,236,94,29,13,29,7,0,6
1089763,58,26,1955,9,"male",212,41,20,601,71,601,42,0,29
1089782,39,19,1974,11,"female",464,589,282,221,533,221,482,0,51
1089792,39,1,1974,1,"male",475,82,57,24,8,24,8,0,0
1089805,22,6,1991,10,"female",1344,4306,983,1970,7907,652,3868,1318,4039
1089828,15,8,1998,5,"female",280,79,37,79,20,79,16,0,4
1089847,18,12,1995,6,"male",405,573,481,38,0,33,0,5,0
1089864,20,30,1993,6,"male",220,93,35,0,0,0,0,0,0
1089884,95,5,1918,1,"male",2506,616,149,26,10,2,4,24,6
1089887,38,5,1975,5,"female",277,75,24,745,523,5,20,740,503
1089897,18,16,1995,8,"female",276,44,33,0,2,0,1,0,1
1089947,53,20,1960,5,"male",256,17,9,79,8,78,4,1,4
1089973,23,8,1990,6,"male",294,80,17,18,5,17,4,1,1
1089974,29,31,1984,3,"female",700,235,142,240,411,162,129,78,282
1089991,62,3,1951,6,"female",1150,141,102,743,939,0,126,743,813
1090010,45,20,1968,1,"female",554,20,16,319,1,319,1,0,0
1090047,23,2,1990,3,"male",615,576,495,6,30,4,24,2,6
1090084,26,29,1987,11,"male",302,415,387,0,19,0,17,0,2
1090091,49,28,1964,7,"female",1402,82,62,599,206,599,85,0,121
1090098,45,3,1968,5,"female",376,104,82,117,35,107,24,10,11
1090100,23,30,1990,9,"female",700,678,425,765,1040,216,679,549,361
1090114,65,11,1948,8,"female",1906,20,10,2,5,2,3,0,2
1090119,18,26,1995,9,"male",337,16,16,5,2,5,2,0,0
1090120,16,3,1997,4,"female",327,464,199,2349,491,2338,319,11,172
1090121,20,2,1993,7,"male",407,6,5,0,0,0,0,0,0
1090134,16,14,1997,5,"male",170,24,6,3,0,3,0,0,0
1090157,21,5,1992,5,"male",540,48,40,1,0,0,0,1,0
1090165,25,23,1988,7,"male",648,126,70,0,3,0,2,0,1
1090168,19,1,1994,4,"male",293,34,24,33,9,33,7,0,2
1090177,29,16,1984,12,"male",295,91,78,75,74,75,64,0,10
1090189,22,2,1991,3,"male",281,184,54,2,3,2,2,0,1
1090213,23,29,1990,1,"male",208,58,43,228,256,228,189,0,67
1090218,17,26,1996,10,"male",991,571,266,96,293,96,255,0,38
1090226,29,21,1984,4,"female",665,137,97,6,7,6,6,0,1
1090267,18,24,1995,8,"female",572,156,40,24,11,24,9,0,2
1090279,26,12,1987,7,"female",109,14,6,1914,2669,1914,1225,0,1444
1090297,59,26,1954,6,"female",267,27,16,35,14,35,12,0,2
1090308,36,7,1977,8,"male",45,73,64,28,0,28,0,0,0
1090321,16,7,1997,10,"female",24,0,0,0,0,0,0,0,0
1090342,32,19,1981,4,"female",859,340,199,21,31,21,22,0,9
1090349,26,1,1987,1,"male",95,58,58,0,0,0,0,0,0
1090396,22,26,1991,11,"female",102,103,63,293,57,293,39,0,18
1090398,54,10,1959,4,"male",516,6,4,0,0,0,0,0,0
1090403,54,4,1959,12,"female",242,61,37,19,26,19,21,0,5
1090429,58,2,1955,11,"male",716,142,88,298,51,0,20,298,31
1090451,100,25,1913,5,"female",1479,879,173,49,221,49,194,0,27
1090460,51,9,1962,8,"male",487,88,33,7,1,0,0,7,1
1090475,23,7,1990,5,"male",672,431,384,1,12,1,9,0,3
1090478,18,7,1995,5,"male",181,391,354,42,1,0,1,42,0
1090482,54,12,1959,6,"female",568,64,38,83,18,83,12,0,6
1090485,23,3,1990,1,"male",453,24,21,0,0,0,0,0,0
1090500,62,20,1951,4,"male",1109,86,62,1,56,0,38,1,18
1090505,100,1,1913,1,"male",1335,81,48,22,23,22,18,0,5
1090519,59,24,1954,3,"female",1789,128,99,285,178,205,112,80,66
1090534,27,17,1986,6,"male",314,21,12,0,2,0,1,0,1
1090554,27,25,1986,2,"female",69,25,22,0,1,0,1,0,0
1090566,54,1,1959,12,"female",1538,78,13,233,331,108,275,125,56
1090592,28,1,1985,1,"male",295,45,42,2,0,2,0,0,0
1090604,18,12,1995,12,"female",575,646,444,1014,660,1014,489,0,171
1090606,16,5,1997,4,"male",12,9,6,0,0,0,0,0,0
1090615,19,27,1994,9,"male",569,216,169,0,0,0,0,0,0
1090633,22,12,1991,4,"male",607,113,84,4,13,4,9,0,4
1090654,27,16,1986,9,"female",229,37,6,19,0,19,0,0,0
1090679,33,22,1980,12,"male",245,1,0,0,0,0,0,0,0
1090706,16,2,1997,12,"male",132,21,18,0,5,0,3,0,2
1090717,25,26,1988,7,"male",699,330,279,4,30,4,27,0,3
1090723,108,18,1905,12,"male",2399,134,92,3,0,0,0,3,0
1090755,55,20,1958,9,"female",614,34,18,108,74,108,52,0,22
1090833,33,23,1980,8,"female",416,201,120,4,7,4,6,0,1
1090834,15,3,1998,11,"male",592,34,27,3,0,0,0,3,0
1090854,65,23,1948,5,"male",339,16,13,2,1,2,1,0,0
1090880,19,19,1994,9,"male",594,256,77,30,15,30,13,0,2
1090882,43,12,1970,2,"male",492,3,3,0,2,0,2,0,0
1090884,49,10,1964,5,"female",251,46,36,1,14,0,2,1,12
1090895,19,25,1994,8,"male",432,89,60,4,2,3,2,1,0
1090918,39,4,1974,7,"male",377,24,14,0,10,0,6,0,4
1090922,19,16,1994,5,"male",321,142,117,0,0,0,0,0,0
1090943,66,14,1947,1,"female",379,33,29,30,4,2,1,28,3
1090949,29,10,1984,10,"male",539,131,70,43,75,19,41,24,34
1090997,14,24,1999,12,"female",302,209,145,757,514,757,424,0,90
1091012,26,20,1987,3,"male",468,483,394,311,183,311,150,0,33
1091059,25,1,1988,1,"male",181,262,242,1,4,0,0,1,4
1091105,16,15,1997,10,"female",498,0,0,0,0,0,0,0,0
1091112,41,24,1972,11,"female",799,66,26,6,0,6,0,0,0
1091115,32,16,1981,7,"female",482,55,27,52,54,52,44,0,10
1091167,27,12,1986,5,"female",482,44,13,0,1,0,0,0,1
1091171,59,15,1954,3,"male",845,39,18,2,0,2,0,0,0
1091179,21,5,1992,6,"male",458,104,22,0,2,0,0,0,2
1091199,16,24,1997,6,"male",761,1374,960,581,1199,562,803,19,396
1091201,28,19,1985,12,"male",957,248,217,142,106,89,81,53,25
1091225,44,18,1969,8,"male",442,85,2,134,0,134,0,0,0
1091227,14,16,1999,9,"female",300,547,350,42,272,42,218,0,54
1091235,103,24,1910,1,"male",1132,639,243,26,37,14,22,12,15
1091248,21,22,1992,4,"male",664,1238,990,495,1466,105,485,390,981
1091252,94,18,1919,9,"female",726,1246,285,37,28,20,17,17,11
1091254,24,1,1989,10,"male",226,58,36,15,1,4,1,11,0
1091261,64,27,1949,1,"male",316,185,121,84,149,50,82,34,67
1091271,71,11,1942,3,"female",354,29,13,56,30,44,22,12,8
1091276,20,30,1993,4,"male",370,10,9,19,7,0,0,19,7
1091289,31,5,1982,5,"female",260,11,5,0,0,0,0,0,0
1091304,40,20,1973,12,"female",752,108,33,387,103,387,62,0,41
1091317,17,16,1996,10,"female",51,46,36,108,14,108,14,0,0
1091347,16,9,1997,9,"male",602,42,30,39,0,39,0,0,0
1091408,63,17,1950,7,"female",2333,623,192,744,1318,578,696,166,622
1091414,32,28,1981,8,"male",773,62,12,4,0,4,0,0,0
1091551,23,6,1990,9,"male",246,162,78,0,2,0,2,0,0
1091556,46,22,1967,12,"female",1266,217,159,445,358,247,231,198,127
1091557,26,7,1987,5,"male",237,35,29,2,18,2,17,0,1
1091597,37,26,1976,9,"female",1369,151,90,201,41,201,41,0,0
1091623,38,11,1975,6,"male",255,18,13,2,0,2,0,0,0
1091678,18,7,1995,6,"female",849,236,180,5,0,0,0,5,0
1091682,15,14,1998,4,"female",387,2434,1025,2158,17066,1606,11772,552,5294
1091683,33,25,1980,5,"male",18,0,0,1,1,1,1,0,0
1091709,16,23,1997,6,"male",389,137,84,0,0,0,0,0,0
1091710,16,26,1997,12,"male",801,75,53,0,0,0,0,0,0
1091713,31,8,1982,1,"male",81,24,22,87,64,6,25,81,39
1091714,54,15,1959,1,"female",344,28,19,12,6,12,3,0,3
1091755,19,16,1994,5,"female",881,2969,353,0,2,0,0,0,2
1091761,19,14,1994,12,"male",364,13,11,0,0,0,0,0,0
1091848,78,24,1935,11,"male",1380,47,19,526,66,32,24,494,42
1091862,60,17,1953,10,"female",314,31,28,48,0,48,0,0,0
1091921,73,2,1940,2,"female",216,2,0,26,4,26,4,0,0
1092014,25,1,1988,8,"female",370,228,153,374,149,374,78,0,71
1092025,25,15,1988,2,"female",576,44,27,296,113,296,107,0,6
1092031,23,21,1990,12,"female",353,157,53,1636,2252,1049,1319,587,933
1092047,32,14,1981,8,"male",432,58,30,0,0,0,0,0,0
1092083,19,6,1994,6,"female",65,122,71,1603,266,1226,115,377,151
1092135,52,2,1961,1,"male",227,13,8,36,23,36,22,0,1
1092148,43,13,1970,12,"female",387,104,38,8,4,0,0,8,4
1092159,62,23,1951,11,"female",699,99,36,2,9,0,6,2,3
1092232,20,15,1993,10,"female",535,20,10,0,0,0,0,0,0
1092233,62,10,1951,4,"male",1051,29,9,13,0,0,0,13,0
1092244,15,14,1998,4,"female",196,336,238,3055,451,3011,325,44,126
1092252,21,15,1992,9,"male",308,108,84,14,0,14,0,0,0
1092262,19,12,1994,4,"male",157,10,2,1,0,1,0,0,0
1092269,31,6,1982,3,"male",1271,96,80,0,1,0,0,0,1
1092280,51,23,1962,4,"male",735,201,104,15,59,1,22,14,37
1092282,72,3,1941,1,"female",636,36,7,76,13,76,11,0,2
1092289,58,27,1955,7,"male",228,27,14,13,3,0,0,13,3
1092298,25,1,1988,12,"male",1457,738,289,13,102,13,50,0,52
1092307,14,3,1999,1,"female",284,105,85,21,0,0,0,21,0
1092311,24,12,1989,10,"female",974,59,31,4,28,4,15,0,13
1092322,17,24,1996,4,"male",241,114,61,21,11,2,5,19,6
1092328,36,17,1977,11,"male",184,103,81,2,78,2,32,0,46
1092391,25,30,1988,3,"male",133,21,16,10,7,8,6,2,1
1092400,55,10,1958,3,"female",349,15,5,8,1,8,1,0,0
1092412,75,9,1938,9,"female",1117,122,21,8,7,0,0,8,7
1092421,106,7,1907,8,"male",1380,2160,806,87,7,4,1,83,6
1092436,69,1,1944,1,"male",277,42,35,3,6,0,3,3,3
1092447,43,29,1970,7,"female",153,208,178,828,166,90,75,738,91
1092466,42,1,1971,12,"male",243,67,55,0,6,0,3,0,3
1092473,17,6,1996,1,"male",595,534,94,157,537,19,210,138,327
1092475,48,21,1965,10,"female",166,74,46,108,17,107,12,1,5
1092506,20,16,1993,7,"female",58,0,0,0,0,0,0,0,0
1092522,108,1,1905,1,NA,2039,15,13,0,0,0,0,0,0
1092535,33,11,1980,10,"female",372,10,10,0,0,0,0,0,0
1092567,27,15,1986,7,"male",197,6,1,0,0,0,0,0,0
1092646,69,31,1944,1,"female",428,20,18,0,0,0,0,0,0
1092657,14,24,1999,4,"male",15,5,5,0,0,0,0,0,0
1092658,18,9,1995,12,"male",407,298,155,626,378,0,56,626,322
1092662,107,10,1906,10,"female",22,32,28,21,128,3,14,18,114
1092682,16,11,1997,9,"male",43,102,82,147,13,146,13,1,0
1092697,25,24,1988,2,"male",353,49,38,7,0,6,0,1,0
1092702,67,30,1946,8,"male",1414,296,192,250,204,97,112,153,92
1092705,27,14,1986,2,"male",283,159,24,17,128,0,12,17,116
1092706,23,16,1990,6,"female",157,58,34,29,16,29,14,0,2
1092712,108,25,1905,2,"female",1661,377,141,43,8,1,4,42,4
1092718,27,15,1986,3,"female",145,357,292,221,496,221,337,0,159
1092750,49,23,1964,3,"male",294,248,37,0,7,0,3,0,4
1092787,20,23,1993,6,"female",895,564,209,20,40,11,16,9,24
1092806,41,26,1972,10,"male",523,44,13,1,1,1,1,0,0
1092819,44,17,1969,8,"female",271,14,13,251,26,251,14,0,12
1092825,16,6,1997,9,"female",189,11,5,14,15,14,13,0,2
1092843,18,19,1995,2,"female",1762,462,245,129,334,117,196,12,138
1092870,20,19,1993,4,"female",311,72,64,131,6,131,5,0,1
1092905,20,21,1993,8,"male",625,71,35,16,2,16,2,0,0
1092910,24,22,1989,8,"female",1085,107,101,37,0,37,0,0,0
1092949,33,1,1980,3,"male",164,65,32,84,90,84,79,0,11
1092976,49,23,1964,1,"female",537,113,10,7,0,0,0,7,0
1093000,18,10,1995,9,"male",632,10,8,0,0,0,0,0,0
1093053,25,25,1988,12,"male",701,347,259,0,0,0,0,0,0
1093060,70,20,1943,11,"female",211,56,27,9,3,9,1,0,2
1093081,71,30,1942,7,"male",469,30,15,22,8,0,2,22,6
1093085,44,12,1969,10,"female",511,41,20,46,12,43,8,3,4
1093096,25,31,1988,3,"female",564,130,92,1202,649,1100,618,102,31
1093097,26,15,1987,10,"male",331,249,225,161,11,161,3,0,8
1093132,17,13,1996,10,"male",305,31,11,5,11,5,10,0,1
1093135,70,13,1943,9,"male",2189,74,13,0,0,0,0,0,0
1093143,17,28,1996,4,"female",462,722,187,3,16,3,12,0,4
1093148,45,30,1968,11,"male",234,66,35,39,24,39,18,0,6
1093196,35,5,1978,12,"male",191,46,40,28,8,28,7,0,1
1093218,19,2,1994,11,"male",473,480,377,78,30,0,2,78,28
1093226,20,18,1993,2,"male",612,499,339,77,187,77,101,0,86
1093228,15,4,1998,7,"female",307,42,28,0,0,0,0,0,0
1093255,29,29,1984,1,"male",761,68,37,0,0,0,0,0,0
1093263,19,3,1994,8,"male",329,89,45,5,0,5,0,0,0
1093267,26,15,1987,8,"male",1120,299,244,1,1,1,1,0,0
1093305,26,18,1987,7,"female",208,3,1,0,0,0,0,0,0
1093306,106,7,1907,7,"male",640,595,470,798,408,798,327,0,81
1093332,20,2,1993,9,"male",13,29,27,1,1,1,1,0,0
1093340,108,29,1905,7,"female",326,196,125,93,103,93,99,0,4
1093368,18,8,1995,5,"male",39,33,29,461,21,443,7,18,14
1093421,18,4,1995,6,"female",80,193,92,640,456,193,96,447,360
1093428,14,3,1999,7,"female",93,6,5,236,27,116,8,120,19
1093447,23,1,1990,1,"male",310,1,1,37,0,37,0,0,0
1093455,34,26,1979,5,"male",502,193,90,24,9,11,5,13,4
1093476,43,4,1970,7,"male",76,19,13,2,5,2,5,0,0
1093484,33,20,1980,6,"male",69,81,79,0,7,0,4,0,3
1093500,27,7,1986,7,"female",609,151,93,158,89,158,87,0,2
1093517,20,2,1993,2,"female",70,123,109,15,97,15,66,0,31
1093547,18,10,1995,9,"male",195,43,37,1,0,0,0,1,0
1093590,22,12,1991,1,"male",155,64,40,301,44,283,15,18,29
1093608,21,31,1992,5,"female",778,128,69,45,105,35,95,10,10
1093617,25,1,1988,2,"male",84,11,7,0,0,0,0,0,0
1093634,16,14,1997,6,"female",934,858,142,87,195,70,175,17,20
1093651,46,12,1967,4,"male",2139,22,11,4,2,4,1,0,1
1093652,17,2,1996,10,"male",236,91,47,21,14,21,8,0,6
1093656,23,26,1990,2,"female",1091,648,240,878,1591,303,912,575,679
1093661,26,1,1987,1,"male",525,22,15,14,0,0,0,14,0
1093706,79,4,1934,3,"female",806,13,4,3,0,0,0,3,0
1093714,69,16,1944,10,"male",1081,37,21,15,9,15,7,0,2
1093724,21,31,1992,5,"male",421,315,289,2,4,2,4,0,0
1093732,35,21,1978,12,"male",527,313,217,312,18,100,11,212,7
1093749,15,20,1998,5,"male",304,306,110,842,130,842,88,0,42
1093760,19,5,1994,10,"male",296,64,57,1,0,1,0,0,0
1093794,62,20,1951,12,"male",2315,87,21,42,9,0,5,42,4
1093803,25,12,1988,9,"male",577,677,486,146,158,136,107,10,51
1093820,36,2,1977,4,"male",262,49,35,185,1,169,1,16,0
1093827,42,9,1971,7,"male",647,51,40,40,30,15,24,25,6
1093847,56,28,1957,5,"female",1178,74,43,80,54,29,52,51,2
1093883,50,24,1963,4,"female",363,18,15,16,49,0,39,16,10
1093887,14,16,1999,8,"male",155,13,11,14,3,0,0,14,3
1093891,18,1,1995,8,"female",183,26,18,7,14,7,9,0,5
1093960,42,10,1971,4,"female",40,4,2,7,15,7,12,0,3
1093968,93,20,1920,7,"female",693,854,634,1,15,1,13,0,2
1093986,35,9,1978,12,"male",567,57,19,0,1,0,1,0,0
1093992,40,23,1973,7,"female",238,231,156,70,41,70,28,0,13
1093999,33,2,1980,1,"female",897,175,136,64,68,42,44,22,24
1094014,69,25,1944,5,"female",1764,71,34,45,14,0,1,45,13
1094027,18,8,1995,12,"female",584,587,350,15,183,15,66,0,117
1094028,97,9,1916,6,"female",370,51,43,0,0,0,0,0,0
1094033,30,10,1983,11,"male",169,20,3,1,0,1,0,0,0
1094063,43,25,1970,3,"male",230,198,104,16,9,16,7,0,2
1094069,42,7,1971,1,"female",470,31,10,35,17,35,13,0,4
1094071,51,4,1962,9,"female",317,91,66,180,133,0,60,180,73
1094080,18,17,1995,8,"female",516,540,353,647,1062,446,529,201,533
1094094,47,19,1966,9,"female",974,72,48,3,0,3,0,0,0
1094101,14,17,1999,5,"male",254,183,139,37,10,0,2,37,8
1094113,41,12,1972,1,"male",326,5,5,11,2,8,2,3,0
1094132,53,6,1960,5,"male",532,2,2,0,0,0,0,0,0
1094145,51,26,1962,4,"female",373,237,128,523,77,1,16,522,61
1094203,68,4,1945,5,"male",1060,1404,650,27,100,27,72,0,28
1094247,56,27,1957,11,"female",997,286,200,330,83,220,70,110,13
1094256,29,7,1984,4,"male",396,112,65,2190,380,2046,224,144,156
1094273,57,17,1956,2,"male",452,52,18,33,111,0,64,33,47
1094317,38,12,1975,9,"male",401,401,304,150,408,150,252,0,156
1094329,24,26,1989,5,"male",745,275,191,36,69,36,56,0,13
1094352,27,10,1986,6,"male",592,15,6,9,4,2,4,7,0
1094369,113,21,1900,4,NA,1198,101,45,1,1,1,0,0,1
1094381,19,20,1994,9,"male",463,674,202,4,11,4,11,0,0
1094383,48,15,1965,2,"male",172,9,4,7,19,0,2,7,17
1094388,28,6,1985,11,"male",309,65,46,1,0,1,0,0,0
1094396,51,9,1962,11,"female",446,0,0,0,0,0,0,0,0
1094397,36,4,1977,1,"female",366,135,65,81,59,78,37,3,22
1094402,43,22,1970,9,"male",799,18,12,11,4,11,4,0,0
1094413,18,11,1995,10,"male",106,734,133,14,53,14,51,0,2
1094466,54,21,1959,9,"female",1945,63,48,469,243,359,73,110,170
1094476,48,26,1965,6,"female",219,97,82,472,22,0,12,472,10
1094499,103,10,1910,10,"male",1323,750,489,607,15,0,3,607,12
1094514,18,17,1995,1,"male",419,486,359,1,2,1,0,0,2
1094519,50,8,1963,4,"male",462,84,45,104,10,1,2,103,8
1094556,108,21,1905,7,"male",128,23,20,2,4,2,4,0,0
1094558,43,12,1970,2,"male",238,63,28,13,9,13,7,0,2
1094607,25,28,1988,9,"male",248,194,163,15,20,15,20,0,0
1094627,18,20,1995,1,"male",698,250,140,1,2,0,0,1,2
1094646,26,9,1987,5,"male",122,42,27,0,0,0,0,0,0
1094684,29,2,1984,1,"male",381,34,25,59,106,8,18,51,88
1094688,26,1,1987,11,"female",254,6,4,423,790,0,205,423,585
1094697,14,6,1999,4,"female",306,3,1,22,4,0,0,22,4
1094709,24,1,1989,1,"male",325,0,0,0,0,0,0,0,0
1094713,84,30,1929,12,"male",1905,448,221,234,509,80,369,154,140
1094716,20,12,1993,10,"male",255,109,25,4,8,3,0,1,8
1094721,16,3,1997,11,"male",629,165,100,0,5,0,5,0,0
1094727,54,5,1959,5,"male",169,4,3,2,0,2,0,0,0
1094732,18,9,1995,6,"male",183,71,53,61,30,54,13,7,17
1094734,37,18,1976,5,"female",657,153,78,76,89,76,62,0,27
1094739,30,19,1983,4,"female",618,94,52,47,97,47,74,0,23
1094762,61,26,1952,2,"male",1222,45,22,0,0,0,0,0,0
1094763,23,23,1990,3,"female",285,38,29,11,3,11,0,0,3
1094767,26,12,1987,2,"male",714,86,47,23,12,23,12,0,0
1094773,18,6,1995,4,"male",135,48,37,4,8,3,8,1,0
1094774,42,10,1971,12,"male",1011,157,53,0,1,0,1,0,0
1094786,50,28,1963,5,"male",706,202,136,207,146,92,66,115,80
1094788,25,13,1988,11,"male",1054,1784,1160,2641,1909,2641,1759,0,150
1094810,34,7,1979,9,"male",43,32,26,0,0,0,0,0,0
1094817,57,17,1956,11,"female",953,80,44,38,54,32,42,6,12
1094818,35,29,1978,8,"female",388,54,28,170,29,170,27,0,2
1094826,16,14,1997,12,"female",213,38,23,0,4,0,3,0,1
1094834,41,29,1972,12,"male",1043,1098,747,525,767,410,550,115,217
1094904,31,11,1982,3,"female",1039,407,259,238,614,64,313,174,301
1094926,23,13,1990,1,"male",469,97,38,3,0,0,0,3,0
1094949,48,21,1965,10,"male",521,42,10,11,45,11,22,0,23
1094988,59,6,1954,5,"female",195,32,30,18,19,8,12,10,7
1094990,35,16,1978,2,"female",652,97,65,299,202,299,189,0,13
1095046,24,30,1989,11,"male",451,4653,512,406,797,125,521,281,276
1095059,25,25,1988,10,"female",378,24,10,2,19,2,12,0,7
1095077,19,7,1994,10,"female",298,447,100,100,163,100,147,0,16
1095085,24,4,1989,1,"male",494,105,71,0,0,0,0,0,0
1095095,35,31,1978,8,"male",111,160,139,39,74,39,61,0,13
1095115,21,30,1992,12,"male",736,197,63,111,57,111,41,0,16
1095117,32,4,1981,12,"female",372,34,21,0,0,0,0,0,0
1095132,28,25,1985,1,"female",331,89,70,3,0,2,0,1,0
1095198,57,27,1956,7,"female",1545,28,4,110,58,98,23,12,35
1095215,53,2,1960,7,"female",328,3,1,0,0,0,0,0,0
1095238,20,16,1993,9,"female",170,140,33,2,3,2,3,0,0
1095247,29,20,1984,8,"male",489,87,52,9,8,9,6,0,2
1095267,58,11,1955,7,"female",195,54,33,289,55,0,27,289,28
1095284,37,28,1976,8,"male",485,24,8,0,0,0,0,0,0
1095300,24,15,1989,4,"male",274,56,31,1,8,1,6,0,2
1095318,18,3,1995,1,"male",625,191,107,10,3,10,3,0,0
1095322,18,31,1995,8,"female",388,1761,513,234,243,234,230,0,13
1095345,61,18,1952,1,"female",828,452,75,72,8,72,4,0,4
1095380,24,5,1989,6,"male",119,82,82,71,7,71,6,0,1
1095393,23,27,1990,11,"female",797,177,98,37,9,37,7,0,2
1095403,23,19,1990,10,"male",11,40,37,21,6,21,2,0,4
1095445,30,4,1983,4,"male",223,352,281,2,7,2,7,0,0
1095504,21,17,1992,2,"female",461,238,96,103,95,1,34,102,61
1095521,19,13,1994,12,"female",151,226,114,978,2049,942,1814,36,235
1095533,49,28,1964,3,"female",910,241,120,318,105,318,54,0,51
1095552,49,24,1964,11,"male",307,8,4,0,0,0,0,0,0
1095562,55,27,1958,5,"female",682,176,104,175,41,0,1,175,40
1095566,42,28,1971,8,"male",256,19,8,0,0,0,0,0,0
1095605,71,22,1942,11,"female",1675,111,65,6,34,2,22,4,12
1095611,50,5,1963,7,"female",694,204,67,162,97,162,29,0,68
1095618,86,6,1927,9,"female",1472,245,130,1004,501,3,147,1001,354
1095645,23,14,1990,9,"male",384,186,109,2,13,0,5,2,8
1095650,25,1,1988,3,"female",376,28,12,33,248,32,120,1,128
1095666,15,3,1998,8,"female",295,96,22,36,23,36,23,0,0
1095672,83,1,1930,12,"male",1206,819,158,165,180,116,101,49,79
1095683,96,12,1917,4,"male",14,51,48,40,14,40,11,0,3
1095689,29,30,1984,4,"male",1083,557,86,0,0,0,0,0,0
1095700,28,12,1985,11,"male",407,85,62,182,10,176,4,6,6
1095755,26,9,1987,1,"male",237,37,32,0,0,0,0,0,0
1095765,28,29,1985,11,"female",224,190,142,838,233,628,101,210,132
1095769,35,23,1978,7,"male",302,0,0,0,0,0,0,0,0
1095798,70,1,1943,1,"female",26,79,10,14,29,8,10,6,19
1095802,30,1,1983,7,"female",501,3,2,0,0,0,0,0,0
1095809,18,19,1995,12,"male",455,171,146,65,1,65,1,0,0
1095812,52,19,1961,9,"female",174,62,35,15,30,15,28,0,2
1095832,108,22,1905,9,"female",2050,383,135,256,223,21,131,235,92
1095870,53,19,1960,5,"female",1099,64,28,253,126,0,3,253,123
1095871,21,3,1992,3,"female",283,299,256,454,264,358,168,96,96
1095883,46,20,1967,4,"male",287,60,40,0,0,0,0,0,0
1095916,20,30,1993,6,"female",460,54,8,0,1,0,1,0,0
1095927,19,2,1994,4,"male",542,898,747,42,8,42,8,0,0
1095950,23,5,1990,11,"female",1013,80,20,63,96,30,88,33,8
1095963,62,11,1951,7,"male",797,68,28,19,3,19,1,0,2
1095964,28,1,1985,3,"male",332,38,21,48,22,48,16,0,6
1095976,26,13,1987,4,"male",239,39,30,0,0,0,0,0,0
1095981,33,1,1980,1,"male",993,229,137,72,80,72,78,0,2
1095991,25,1,1988,1,"female",137,0,0,0,0,0,0,0,0
1095998,66,2,1947,11,"male",275,114,77,30,17,30,14,0,3
1096009,21,21,1992,1,"male",920,227,72,0,1,0,1,0,0
1096032,108,1,1905,4,"female",1761,228,140,1579,430,1579,248,0,182
1096066,34,1,1979,1,"male",38,69,58,45,21,45,16,0,5
1096081,64,10,1949,2,"female",1355,75,38,0,7,0,3,0,4
1096123,27,6,1986,10,"male",356,32,19,5,1,0,0,5,1
1096138,67,18,1946,6,"female",1207,233,33,231,134,4,24,227,110
1096164,21,29,1992,12,"male",1723,364,304,11,6,2,3,9,3
1096169,17,9,1996,7,"male",506,193,145,0,3,0,1,0,2
1096171,18,24,1995,1,"male",478,375,336,0,1,0,1,0,0
1096187,56,24,1957,9,"male",792,56,46,26,23,0,8,26,15
1096208,21,14,1992,2,"male",249,31,23,3,0,0,0,3,0
1096245,22,10,1991,11,"male",451,8,7,1,0,1,0,0,0
1096265,19,20,1994,12,"female",25,71,26,1209,318,1209,297,0,21
1096295,68,2,1945,4,"male",201,439,249,36,175,31,136,5,39
1096298,14,25,1999,7,"male",61,97,92,5,0,5,0,0,0
1096366,46,5,1967,9,"female",342,32,10,8,16,8,12,0,4
1096370,18,4,1995,3,"male",410,203,139,13,13,13,7,0,6
1096389,19,16,1994,2,"male",408,105,59,0,0,0,0,0,0
1096390,26,1,1987,1,"male",382,14,14,0,0,0,0,0,0
1096408,18,4,1995,6,"female",293,781,60,0,4,0,3,0,1
1096423,108,5,1905,7,"male",2127,59,28,0,1,0,1,0,0
1096458,63,21,1950,5,"female",1158,61,37,5,3,0,0,5,3
1096462,30,3,1983,3,"male",928,1,1,0,0,0,0,0,0
1096468,19,9,1994,9,"male",183,19,19,0,0,0,0,0,0
1096508,16,14,1997,10,"male",187,2,1,0,0,0,0,0,0
1096517,80,24,1933,3,"male",1985,162,83,21,6,6,1,15,5
1096528,20,15,1993,9,"male",9,13,9,98,23,98,23,0,0
1096529,25,10,1988,2,"female",533,107,67,50,48,0,4,50,44
1096545,39,3,1974,3,"male",218,17,12,10,2,2,1,8,1
1096555,18,8,1995,4,"male",358,512,278,7,41,7,38,0,3
1096581,60,17,1953,7,"male",1193,27,13,2,4,0,3,2,1
1096583,19,5,1994,1,"male",404,165,125,14,28,13,15,1,13
1096591,35,1,1978,9,"male",248,30,14,0,8,0,8,0,0
1096601,43,1,1970,8,"male",444,97,92,3,0,3,0,0,0
1096609,29,17,1984,4,"male",491,17,10,0,0,0,0,0,0
1096612,86,4,1927,5,"male",953,53,35,72,5,2,1,70,4
1096636,20,12,1993,6,"female",719,753,559,447,431,332,248,115,183
1096653,21,18,1992,12,"male",184,696,650,247,63,0,13,247,50
1096670,32,3,1981,8,"male",431,111,81,2,1,2,0,0,1
1096726,43,26,1970,5,"male",682,131,44,6,0,6,0,0,0
1096768,39,23,1974,7,"male",1298,2,1,0,0,0,0,0,0
1096782,35,16,1978,11,"female",84,229,159,2960,1177,2960,1127,0,50
1096783,15,8,1998,5,"male",140,116,82,0,0,0,0,0,0
1096786,101,11,1912,5,"female",719,152,78,72,30,71,23,1,7
1096828,16,1,1997,9,"male",18,25,25,0,4,0,0,0,4
1096845,35,5,1978,5,"male",394,70,69,11,2,11,2,0,0
1096852,58,5,1955,2,"female",2120,190,122,638,291,368,154,270,137
1096866,16,13,1997,12,"male",471,15,6,1,0,0,0,1,0
1096874,88,12,1925,5,"male",1898,536,357,6,3,0,0,6,3
1096887,19,28,1994,6,"male",611,69,62,1,0,1,0,0,0
1096896,26,5,1987,3,"male",286,88,50,137,147,133,121,4,26
1096916,28,5,1985,8,"male",726,141,38,62,95,57,77,5,18
1096951,26,19,1987,6,"male",11,28,21,2,2,2,1,0,1
1096993,28,27,1985,6,"male",323,118,67,91,220,91,138,0,82
1097037,55,24,1958,5,"female",561,15,10,3,0,3,0,0,0
1097050,26,10,1987,8,"male",13,16,11,1,1,1,1,0,0
1097072,39,13,1974,1,"male",13,3,2,129,52,0,7,129,45
1097099,22,11,1991,9,"male",277,151,71,0,1,0,0,0,1
1097111,14,16,1999,8,"female",105,4,3,0,0,0,0,0,0
1097121,17,31,1996,7,"male",632,296,138,6,158,6,121,0,37
1097123,33,20,1980,8,"male",367,20,9,26,16,0,3,26,13
1097125,19,12,1994,1,"male",688,56,45,0,1,0,1,0,0
1097136,59,4,1954,3,"male",566,61,23,30,19,30,12,0,7
1097149,65,9,1948,7,"male",291,33,24,51,37,0,17,51,20
1097195,40,13,1973,10,"male",229,15,13,0,0,0,0,0,0
1097238,32,15,1981,10,"female",660,160,94,216,66,213,41,3,25
1097247,34,20,1979,9,"male",319,1,0,0,0,0,0,0,0
1097259,66,26,1947,11,"male",220,12,5,2,2,0,0,2,2
1097287,52,8,1961,2,"male",448,418,242,127,193,0,19,127,174
1097312,19,29,1994,11,"male",269,212,142,22,29,18,26,4,3
1097319,18,26,1995,1,"male",292,78,69,1,1,0,0,1,1
1097338,90,15,1923,9,"male",1930,221,107,60,22,21,6,39,16
1097370,69,15,1944,10,"male",1743,38,14,8,0,0,0,8,0
1097371,19,18,1994,6,"female",464,332,303,14,2,14,1,0,1
1097392,91,29,1922,12,"male",115,345,139,124,379,124,373,0,6
1097393,29,5,1984,6,"male",284,20,19,11,1,0,0,11,1
1097401,51,22,1962,9,"female",286,89,21,745,451,0,283,745,168
1097455,55,14,1958,2,"female",738,165,102,71,8,0,3,71,5
1097460,42,15,1971,3,"female",283,89,56,126,10,126,4,0,6
1097511,18,28,1995,4,"female",620,1486,391,3,27,3,20,0,7
1097515,22,23,1991,5,"female",433,141,69,5,14,5,13,0,1
1097543,33,2,1980,6,"male",529,70,54,112,32,107,21,5,11
1097600,57,11,1956,2,"male",411,43,31,0,0,0,0,0,0
1097602,14,18,1999,4,"male",279,298,145,66,39,66,22,0,17
1097645,23,7,1990,4,"male",118,235,131,16,83,6,53,10,30
1097652,56,22,1957,10,"female",287,127,92,26,38,1,10,25,28
1097668,49,19,1964,2,"male",696,16,12,8,0,8,0,0,0
1097705,25,22,1988,3,"male",198,110,77,4,7,4,4,0,3
1097709,21,9,1992,2,"female",608,24,12,0,7,0,7,0,0
1097710,26,9,1987,5,"male",189,40,21,24,32,24,17,0,15
1097716,18,8,1995,4,"female",230,200,147,357,73,310,33,47,40
1097725,23,9,1990,2,"female",227,107,71,7,69,2,37,5,32
1097753,26,1,1987,1,"male",450,193,147,0,0,0,0,0,0
1097774,28,10,1985,1,"male",1332,78,29,0,0,0,0,0,0
1097791,16,4,1997,2,"female",211,46,41,0,1,0,1,0,0
1097823,14,7,1999,12,"male",310,145,85,100,26,68,15,32,11
1097827,58,14,1955,6,"female",1762,99,55,130,47,130,23,0,24
1097862,16,13,1997,8,"male",319,78,61,0,0,0,0,0,0
1097874,16,24,1997,8,"male",501,139,102,3,4,0,0,3,4
1097882,44,18,1969,3,"female",188,55,22,31,8,31,3,0,5
1097883,21,20,1992,8,"female",372,88,68,233,111,233,70,0,41
1097912,21,13,1992,6,"male",689,428,168,12,45,6,19,6,26
1097939,31,5,1982,6,"male",562,200,169,143,14,143,14,0,0
1097951,30,8,1983,4,"male",480,57,44,42,2,42,2,0,0
1097967,33,1,1980,1,"female",606,1909,118,956,4027,956,3550,0,477
1097974,38,11,1975,9,"female",1856,119,65,162,42,114,11,48,31
1097977,21,16,1992,12,"male",57,41,34,0,0,0,0,0,0
1098001,34,21,1979,6,"female",683,32,17,98,7,98,4,0,3
1098016,17,25,1996,8,"male",280,166,124,26,0,26,0,0,0
1098035,16,19,1997,5,"male",390,91,70,10,5,10,3,0,2
1098061,23,24,1990,7,"male",393,23,17,3,6,3,5,0,1
1098085,98,15,1915,12,"female",351,397,189,1,3,1,1,0,2
1098095,74,13,1939,11,"female",360,29,22,71,58,71,24,0,34
1098103,59,22,1954,3,"female",145,23,18,0,5,0,5,0,0
1098112,20,29,1993,3,"female",860,304,104,1,25,1,15,0,10
1098125,18,25,1995,10,"male",238,12,9,0,0,0,0,0,0
1098141,108,31,1905,12,"male",1628,484,131,4,1,4,1,0,0
1098160,23,3,1990,1,"female",521,241,172,7,7,7,4,0,3
1098179,32,27,1981,8,"male",152,60,38,241,161,241,42,0,119
1098207,68,1,1945,2,"male",642,89,73,160,22,160,14,0,8
1098211,33,9,1980,1,"female",97,20,15,5,59,3,59,2,0
1098219,52,15,1961,9,"male",1521,61,4,0,0,0,0,0,0
1098233,35,7,1978,1,"male",360,15,10,1,1,1,1,0,0
1098254,54,20,1959,1,"female",270,63,29,23,35,23,34,0,1
1098258,18,1,1995,6,"male",336,135,54,138,76,133,59,5,17
1098304,21,24,1992,4,"male",140,11,7,1,3,0,2,1,1
1098305,40,25,1973,10,"male",612,134,50,518,268,420,201,98,67
1098324,23,21,1990,9,"female",513,108,64,0,0,0,0,0,0
1098334,74,4,1939,3,"male",1033,21,7,0,4,0,1,0,3
1098348,21,1,1992,10,"male",472,529,437,31,25,31,14,0,11
1098375,33,4,1980,3,"male",359,27,12,87,19,28,3,59,16
1098383,39,1,1974,4,"female",503,362,329,87,85,68,37,19,48
1098409,19,12,1994,9,"male",780,332,196,3,11,3,6,0,5
1098494,57,17,1956,3,"male",533,73,32,0,0,0,0,0,0
1098498,17,30,1996,10,"male",442,183,109,121,95,11,4,110,91
1098532,21,3,1992,1,"male",306,8,3,0,0,0,0,0,0
1098536,23,19,1990,8,"male",219,27,21,1,12,1,5,0,7
1098559,32,19,1981,2,"male",520,45,41,0,0,0,0,0,0
1098561,17,18,1996,12,"male",462,22,11,0,0,0,0,0,0
1098583,23,5,1990,8,"male",158,35,16,0,0,0,0,0,0
1098591,21,30,1992,8,"female",346,30,19,319,149,316,114,3,35
1098597,25,18,1988,12,"female",294,77,45,164,32,164,25,0,7
1098625,15,2,1998,5,"female",1188,1937,624,1513,6434,477,4362,1036,2072
1098630,16,12,1997,5,"female",582,215,85,211,80,122,33,89,47
1098638,30,13,1983,5,"male",673,1,1,0,0,0,0,0,0
1098642,22,5,1991,4,"male",127,188,146,1,1,1,1,0,0
1098676,24,9,1989,3,"male",1207,528,338,99,216,52,54,47,162
1098681,26,20,1987,9,"male",476,124,91,1,2,1,1,0,1
1098690,52,22,1961,4,"female",304,7,7,6,5,0,0,6,5
1098693,58,19,1955,12,"male",898,78,10,0,1,0,1,0,0
1098737,21,12,1992,9,"male",518,396,295,10,15,7,14,3,1
1098741,19,19,1994,8,"female",260,168,151,30,1,30,1,0,0
1098745,70,2,1943,12,"female",292,25,15,0,5,0,4,0,1
1098750,22,15,1991,10,"male",360,4,4,26,1,0,0,26,1
1098755,41,5,1972,8,"male",784,22,11,2,2,0,0,2,2
1098793,47,5,1966,2,"male",1957,43,20,11,2,11,2,0,0
1098795,54,7,1959,11,"female",356,68,47,0,0,0,0,0,0
1098799,19,3,1994,4,"male",188,80,31,9,6,9,2,0,4
1098821,13,27,2000,3,"male",50,15,13,1,1,1,1,0,0
1098826,28,28,1985,11,"female",40,6,6,0,0,0,0,0,0
1098833,57,6,1956,6,"female",677,108,78,1,4,1,4,0,0
1098868,32,30,1981,7,"male",25,0,0,0,0,0,0,0,0
1098912,28,24,1985,7,"male",64,16,16,2,1,2,1,0,0
1098928,26,21,1987,12,"female",312,1,0,34,1,0,0,34,1
1098944,63,25,1950,8,"female",18,52,50,0,2,0,2,0,0
1098988,48,25,1965,3,"male",404,125,47,27,75,0,22,27,53
1099006,25,12,1988,6,"female",214,39,21,1,0,1,0,0,0
1099010,23,11,1990,4,"female",416,2560,185,4506,6516,4506,5760,0,756
1099031,43,5,1970,5,"female",125,60,48,185,6,185,6,0,0
1099038,48,1,1965,10,"female",268,5,4,2,0,2,0,0,0
1099040,59,2,1954,7,"male",173,8,3,0,1,0,1,0,0
1099073,46,21,1967,1,"female",81,859,793,2094,2602,2059,2208,35,394
1099075,35,18,1978,3,"male",318,1,0,0,0,0,0,0,0
1099088,40,30,1973,4,"female",109,52,30,68,36,68,26,0,10
1099094,20,26,1993,6,"male",568,245,131,341,251,341,148,0,103
1099116,89,25,1924,1,"female",1042,105,54,42,10,4,0,38,10
1099127,17,3,1996,6,"male",830,139,86,0,0,0,0,0,0
1099146,64,2,1949,1,"female",1175,20,12,13,0,13,0,0,0
1099165,16,17,1997,6,"female",580,725,623,106,106,20,73,86,33
1099173,29,22,1984,2,"female",327,89,40,119,257,119,236,0,21
1099185,36,25,1977,7,"male",410,151,86,167,49,112,11,55,38
1099187,45,12,1968,3,"female",1137,242,121,434,317,213,77,221,240
1099198,111,4,1902,7,"male",1320,259,132,0,0,0,0,0,0
1099267,56,28,1957,4,"female",814,33,25,15,9,10,8,5,1
1099271,23,2,1990,10,"female",562,201,51,25,69,1,33,24,36
1099282,31,11,1982,6,"female",655,283,137,650,185,431,65,219,120
1099350,91,6,1922,8,"male",405,151,70,5,9,5,3,0,6
1099367,25,13,1988,7,"male",212,115,13,3,13,3,5,0,8
1099396,57,10,1956,3,"male",434,279,270,12,3,12,3,0,0
1099407,23,9,1990,7,"male",93,19,12,7,0,0,0,7,0
1099410,23,14,1990,8,"male",749,237,193,0,0,0,0,0,0
1099427,23,27,1990,8,"female",327,254,192,202,137,13,38,189,99
1099429,22,6,1991,4,"male",283,52,14,2,1,2,1,0,0
1099437,64,2,1949,1,"male",618,62,31,38,14,8,7,30,7
1099442,58,25,1955,6,"male",733,42,40,139,208,0,61,139,147
1099503,18,1,1995,1,"male",428,48,38,0,0,0,0,0,0
1099505,17,18,1996,9,"male",339,24,17,2,0,0,0,2,0
1099509,24,24,1989,7,"male",163,4,4,0,0,0,0,0,0
1099522,23,25,1990,1,"female",509,151,75,43,107,43,99,0,8
1099551,43,15,1970,5,"female",346,96,76,17,0,17,0,0,0
1099552,26,10,1987,10,"female",544,164,118,3,36,2,18,1,18
1099563,62,14,1951,9,"female",1817,304,91,609,98,154,39,455,59
1099575,57,9,1956,4,"female",1766,114,73,70,32,4,12,66,20
1099582,72,8,1941,9,"female",523,137,109,68,62,0,38,68,24
1099589,41,13,1972,3,"female",338,173,40,6,11,6,10,0,1
1099602,29,19,1984,10,"female",308,7,7,0,0,0,0,0,0
1099608,26,18,1987,6,"male",231,239,112,61,116,8,70,53,46
1099613,17,13,1996,8,"male",645,179,94,21,38,18,13,3,25
1099614,27,20,1986,11,"female",533,226,158,127,32,127,31,0,1
1099652,99,12,1914,7,"male",364,28,18,33,4,2,1,31,3
1099681,17,18,1996,12,"male",230,352,212,24,135,0,25,24,110
1099761,33,9,1980,11,"male",5,45,40,4,5,4,5,0,0
1099827,60,23,1953,3,"male",369,74,63,41,3,0,1,41,2
1099857,47,26,1966,2,"female",344,148,101,1076,42,831,25,245,17
1099881,21,1,1992,4,"male",425,286,171,2,0,0,0,2,0
1099892,51,23,1962,12,"female",186,6,1,3,1,0,1,3,0
1099927,25,1,1988,6,"female",326,40,23,81,40,81,30,0,10
1099936,20,19,1993,4,"female",210,8,6,97,28,97,26,0,2
1099970,25,1,1988,8,"male",459,1,1,15,9,10,6,5,3
1099973,61,15,1952,10,"male",1686,5,2,0,0,0,0,0,0
1099992,47,28,1966,4,"female",326,96,32,13,35,13,31,0,4
1100031,106,7,1907,7,"male",1465,31,28,0,0,0,0,0,0
1100095,38,9,1975,1,"male",381,56,37,5,0,5,0,0,0
1100109,17,9,1996,8,"male",786,4,4,0,0,0,0,0,0
1100129,30,4,1983,9,"male",237,28,7,0,0,0,0,0,0
1100148,31,15,1982,8,"female",2027,131,57,285,259,283,168,2,91
1100152,40,4,1973,12,"female",120,70,65,17,23,16,17,1,6
1100159,23,28,1990,11,"male",308,14,13,2,1,2,1,0,0
1100214,16,22,1997,2,"male",579,157,93,54,24,0,6,54,18
1100239,30,16,1983,9,"female",676,68,58,16,12,16,2,0,10
1100249,22,23,1991,11,"female",152,4696,231,2724,6012,2150,3207,574,2805
1100291,44,17,1969,9,"female",447,76,56,0,7,0,4,0,3
1100299,53,17,1960,12,"female",132,62,32,284,74,284,27,0,47
1100312,60,7,1953,8,"female",1017,132,100,372,50,1,3,371,47
1100316,51,7,1962,5,"male",842,20,12,4,140,4,88,0,52
1100335,24,8,1989,12,"female",552,509,175,395,68,395,56,0,12
1100401,77,23,1936,1,"male",370,22,16,1,12,0,7,1,5
1100407,27,22,1986,9,"male",344,335,293,25,11,24,3,1,8
1100415,30,2,1983,5,"male",66,6,5,7,1,7,1,0,0
1100461,26,24,1987,9,"female",209,10,6,22,3,0,1,22,2
1100467,18,15,1995,10,"male",237,116,45,0,0,0,0,0,0
1100483,28,28,1985,12,"female",857,1,0,1,10,0,0,1,10
1100497,41,21,1972,2,"male",587,34,25,1,54,1,32,0,22
1100499,65,22,1948,5,"female",949,25,11,2,0,1,0,1,0
1100501,23,19,1990,9,"male",814,153,58,68,89,62,31,6,58
1100503,42,22,1971,4,"male",992,11,8,0,1,0,0,0,1
1100510,65,26,1948,7,"male",429,1,1,0,0,0,0,0,0
1100533,20,3,1993,4,"male",271,6,2,0,6,0,4,0,2
1100544,15,1,1998,6,"female",500,3478,902,2318,1703,244,710,2074,993
1100550,19,12,1994,6,"male",1688,235,109,227,222,99,135,128,87
1100564,15,8,1998,12,"female",593,3459,1068,166,836,56,533,110,303
1100566,108,9,1905,6,"female",902,161,54,39,34,26,20,13,14
1100569,23,23,1990,4,"male",381,140,120,33,0,33,0,0,0
1100599,16,30,1997,3,"female",334,89,53,0,0,0,0,0,0
1100603,15,14,1998,8,"female",48,286,179,4060,4109,3402,2990,658,1119
1100608,47,22,1966,5,"male",407,364,336,76,145,60,88,16,57
1100626,34,2,1979,4,"male",149,65,27,3,3,0,2,3,1
1100631,19,2,1994,1,"female",496,1,0,0,0,0,0,0,0
1100658,63,6,1950,9,"male",269,6,5,0,0,0,0,0,0
1100672,19,23,1994,12,"female",524,1044,189,183,458,183,349,0,109
1100695,93,12,1920,7,"female",1453,113,51,54,150,42,96,12,54
1100719,20,9,1993,8,"female",1066,333,116,41,178,0,42,41,136
1100730,68,31,1945,1,"female",123,468,282,5233,6266,5231,5729,2,537
1100740,35,23,1978,8,"male",49,5,5,0,0,0,0,0,0
1100745,52,17,1961,5,"male",1592,42,29,2,29,1,11,1,18
1100753,32,2,1981,8,"male",267,7,3,106,1,0,0,106,1
1100765,13,25,2000,1,"female",664,1832,705,1595,2458,1356,1824,239,634
1100775,68,10,1945,10,"male",991,441,359,166,36,166,32,0,4
1100781,41,28,1972,1,"male",216,25,13,79,77,78,71,1,6
1100803,63,10,1950,1,"female",608,72,35,0,0,0,0,0,0
1100808,67,9,1946,7,"male",495,2,0,0,0,0,0,0,0
1100812,16,12,1997,2,"male",629,1463,664,6,19,1,10,5,9
1100814,58,12,1955,6,"male",1722,31,7,28,3,28,3,0,0
1100816,29,25,1984,9,"female",452,82,57,17,7,17,6,0,1
1100836,16,6,1997,11,"male",435,218,110,6,26,3,15,3,11
1100917,19,10,1994,12,"female",234,65,45,563,654,563,266,0,388
1100947,84,19,1929,6,"male",144,296,221,34,16,31,3,3,13
1100950,26,29,1987,12,"female",88,5,4,0,0,0,0,0,0
1100960,108,12,1905,11,"male",1441,228,70,0,0,0,0,0,0
1100976,33,23,1980,7,"female",370,55,21,19,89,19,79,0,10
1100989,23,22,1990,5,"male",21,15,13,11,1,11,1,0,0
1100993,26,26,1987,4,"male",261,46,42,35,10,35,9,0,1
1100996,61,20,1952,9,"female",1074,53,15,65,0,65,0,0,0
1100999,27,22,1986,4,"female",607,163,82,39,86,3,42,36,44
1101002,22,25,1991,4,"female",1157,490,147,220,94,203,28,17,66
1101030,14,30,1999,7,"female",319,115,75,518,30,516,21,2,9
1101041,58,15,1955,3,"male",227,88,66,49,1,0,1,49,0
1101044,54,14,1959,7,"female",1020,140,12,3,9,3,8,0,1
1101046,23,2,1990,5,"male",697,886,625,2,35,2,31,0,4
1101061,71,28,1942,2,"female",739,181,65,0,0,0,0,0,0
1101071,14,11,1999,11,"male",194,81,54,10,4,10,4,0,0
1101094,103,18,1910,3,"female",560,3018,547,5595,1926,586,810,5009,1116
1101103,68,10,1945,5,"male",1173,612,429,282,165,282,147,0,18
1101133,23,19,1990,5,"male",127,43,38,281,147,281,135,0,12
1101182,75,29,1938,4,"male",90,67,61,48,1,0,0,48,1
1101207,50,29,1963,5,"male",522,12,8,0,2,0,0,0,2
1101215,22,27,1991,2,"male",155,26,24,2,1,2,1,0,0
1101233,40,16,1973,8,"male",363,35,27,2,3,0,1,2,2
1101264,55,26,1958,9,"female",1248,197,67,298,316,258,244,40,72
1101287,18,7,1995,9,"female",110,917,720,109,223,109,156,0,67
1101298,28,17,1985,6,"female",231,23,12,116,5,0,0,116,5
1101307,19,17,1994,10,"male",3,1,1,0,0,0,0,0,0
1101315,59,10,1954,10,"female",655,150,37,1,2,1,2,0,0
1101339,39,28,1974,12,"male",704,103,76,5,4,5,4,0,0
1101365,17,31,1996,7,"female",284,31,29,447,158,444,101,3,57
1101371,32,28,1981,5,"male",381,292,270,35,53,35,37,0,16
1101382,31,17,1982,4,"male",776,94,64,11,1,9,1,2,0
1101416,23,20,1990,1,"female",1046,1062,555,1949,727,608,199,1341,528
1101420,15,14,1998,10,"male",18,101,89,1,0,1,0,0,0
1101464,64,18,1949,9,"female",752,248,65,366,167,76,37,290,130
1101465,36,21,1977,6,"male",936,29,13,5,5,2,0,3,5
1101476,23,10,1990,10,"female",405,270,178,1,140,1,112,0,28
1101492,15,27,1998,9,"male",183,60,44,0,9,0,7,0,2
1101509,36,3,1977,7,"male",151,30,19,9,24,5,20,4,4
1101511,23,21,1990,9,"male",675,41,29,29,2,28,1,1,1
1101532,71,20,1942,5,"female",1454,410,245,539,852,14,342,525,510
1101550,39,14,1974,1,"female",534,28,3,0,8,0,8,0,0
1101553,63,30,1950,7,"male",852,70,35,17,29,17,26,0,3
1101588,101,26,1912,5,"female",132,39,18,19,4,0,1,19,3
1101636,21,5,1992,10,"male",971,48,23,2,1,2,1,0,0
1101649,23,18,1990,3,"female",64,247,215,14,39,14,18,0,21
1101661,66,17,1947,7,"male",346,36,22,12,1,0,0,12,1
1101691,15,14,1998,5,"male",302,99,72,1,9,1,2,0,7
1101734,54,4,1959,1,"female",490,21,12,7,6,7,6,0,0
1101738,19,19,1994,12,"female",519,295,120,243,127,205,122,38,5
1101748,15,11,1998,12,"male",225,92,75,0,2,0,2,0,0
1101755,35,4,1978,2,"male",595,67,48,0,0,0,0,0,0
1101773,26,18,1987,1,"male",274,9,4,0,0,0,0,0,0
1101842,23,20,1990,8,"female",1350,31,28,297,206,297,118,0,88
1101847,108,17,1905,9,"male",19,78,78,0,0,0,0,0,0
1101857,49,14,1964,7,"male",181,65,49,8,20,4,11,4,9
1101882,33,22,1980,11,"male",727,76,44,0,7,0,4,0,3
1101896,57,27,1956,4,"male",13,6,6,0,5,0,0,0,5
1101901,16,16,1997,6,"male",237,628,472,157,64,157,41,0,23
1101905,25,15,1988,7,"male",422,70,53,0,2,0,2,0,0
1101918,16,15,1997,6,"male",170,287,192,1,3,0,1,1,2
1101938,22,9,1991,2,"female",561,33,22,6,19,6,19,0,0
1101955,23,1,1990,1,"male",342,22,8,0,0,0,0,0,0
1101982,58,19,1955,3,"male",1080,313,195,233,209,89,126,144,83
1102016,18,13,1995,5,"male",273,117,95,56,94,56,49,0,45
1102074,20,10,1993,1,"male",104,108,100,370,1,370,0,0,1
1102083,16,2,1997,4,"female",32,31,25,7,0,7,0,0,0
1102099,19,28,1994,8,"male",417,169,86,63,62,63,34,0,28
1102116,24,5,1989,9,"male",603,109,71,0,0,0,0,0,0
1102124,18,4,1995,11,"male",385,405,232,23,9,14,7,9,2
1102171,63,9,1950,3,"male",614,14,7,0,0,0,0,0,0
1102172,20,7,1993,7,"male",116,32,15,5,0,5,0,0,0
1102179,21,19,1992,11,"male",391,70,67,4,0,4,0,0,0
1102182,52,25,1961,6,"male",336,105,92,19,22,0,20,19,2
1102186,36,3,1977,8,"male",61,20,8,49,74,38,61,11,13
1102201,18,5,1995,5,"male",592,499,323,12,40,12,17,0,23
1102213,22,22,1991,8,"male",285,69,44,35,5,30,3,5,2
1102233,21,18,1992,2,"female",1251,3494,1369,2430,4857,278,1340,2152,3517
1102250,37,8,1976,11,"female",335,183,56,190,146,166,128,24,18
1102252,33,10,1980,4,"male",952,106,44,8,1,8,1,0,0
1102253,21,3,1992,11,"male",296,177,86,33,3,13,2,20,1
1102284,34,1,1979,2,"female",471,92,40,1250,179,1250,114,0,65
1102292,108,3,1905,12,"male",1053,274,109,82,68,66,60,16,8
1102297,19,10,1994,3,"male",495,37,26,2,3,2,1,0,2
1102311,24,19,1989,12,"male",1029,21,18,7,2,7,1,0,1
1102313,18,2,1995,5,"male",222,134,87,17,61,17,57,0,4
1102322,37,7,1976,3,"female",479,1091,947,1156,443,953,344,203,99
1102351,36,18,1977,4,"female",148,140,98,42,44,42,28,0,16
1102363,28,12,1985,11,"male",131,138,54,0,0,0,0,0,0
1102368,19,5,1994,12,"female",661,1134,295,547,2792,204,1581,343,1211
1102374,37,19,1976,8,"female",776,98,80,28,2,22,0,6,2
1102398,18,30,1995,7,"female",129,45,19,0,0,0,0,0,0
1102433,26,3,1987,11,"female",1540,1031,527,59,54,5,27,54,27
1102442,25,25,1988,8,"male",425,240,231,1,15,1,14,0,1
1102461,23,4,1990,4,"male",131,66,36,126,72,126,14,0,58
1102465,18,22,1995,12,"female",336,559,465,4,0,4,0,0,0
1102483,22,18,1991,12,"male",1018,692,537,25,34,25,26,0,8
1102500,14,23,1999,9,"female",122,346,287,304,41,304,27,0,14
1102519,18,15,1995,11,"female",153,42,29,16,24,16,14,0,10
1102531,20,4,1993,9,"male",658,240,178,439,83,439,76,0,7
1102536,35,14,1978,2,"male",467,0,0,0,3,0,3,0,0
1102540,24,1,1989,7,"female",269,302,83,131,379,20,145,111,234
1102565,17,26,1996,2,"female",938,87,33,0,0,0,0,0,0
1102567,26,3,1987,3,"female",443,5,3,0,0,0,0,0,0
1102580,19,5,1994,9,"male",438,48,30,4,1,0,1,4,0
1102583,28,31,1985,1,"female",232,93,57,359,78,146,49,213,29
1102594,18,10,1995,7,"female",607,162,59,64,72,7,15,57,57
1102634,28,22,1985,12,"male",696,991,639,2,25,2,18,0,7
1102650,80,27,1933,8,"female",1793,156,80,90,12,0,7,90,5
1102651,26,1,1987,1,"male",330,98,67,6,3,6,2,0,1
1102699,21,3,1992,7,"male",383,66,17,9,2,0,2,9,0
1102706,56,9,1957,6,"female",1266,33,23,23,4,22,4,1,0
1102719,30,21,1983,11,"male",403,874,691,1482,115,1482,98,0,17
1102724,17,15,1996,11,"male",190,58,52,4,0,4,0,0,0
1102730,21,2,1992,1,"male",166,359,345,42,47,42,35,0,12
1102743,49,1,1964,12,"female",189,88,57,21,88,21,64,0,24
1102764,14,5,1999,7,"male",484,259,117,17,11,17,10,0,1
1102786,23,8,1990,5,"male",236,2,2,12,0,12,0,0,0
1102796,18,19,1995,10,"male",594,24,21,281,42,277,39,4,3
1102831,61,2,1952,1,"male",375,6,6,0,0,0,0,0,0
1102838,16,7,1997,6,"male",436,585,432,367,185,367,164,0,21
1102868,38,16,1975,2,"male",659,62,9,0,0,0,0,0,0
1102886,22,31,1991,7,"male",1004,273,189,8,8,8,4,0,4
1102900,43,4,1970,9,"female",247,214,182,46,52,26,29,20,23
1102916,77,15,1936,10,"male",1807,44,40,0,0,0,0,0,0
1102922,24,8,1989,10,"male",43,19,17,4,0,4,0,0,0
1102930,67,31,1946,1,"male",585,353,300,0,5,0,1,0,4
1102950,27,5,1986,4,"female",306,178,50,125,164,125,98,0,66
1102951,68,12,1945,11,"female",1403,498,120,0,1,0,1,0,0
1102957,54,10,1959,1,"male",127,25,19,1,1,0,1,1,0
1102975,26,27,1987,6,"male",386,92,64,35,4,35,4,0,0
1102991,17,20,1996,6,"female",172,0,0,0,0,0,0,0,0
1102994,65,24,1948,5,"female",11,9,2,33,5,0,3,33,2
1103000,29,28,1984,5,"male",631,200,167,0,0,0,0,0,0
1103054,33,31,1980,5,"female",524,157,40,72,51,72,46,0,5
1103056,25,29,1988,7,"female",234,88,64,70,21,68,16,2,5
1103061,26,25,1987,3,"female",411,85,64,18,34,18,32,0,2
1103065,18,6,1995,11,"male",174,86,59,6,33,6,30,0,3
1103068,24,16,1989,5,"female",410,1,1,1,0,0,0,1,0
1103085,23,17,1990,6,"female",226,33,16,11,19,11,19,0,0
1103098,17,3,1996,11,"male",500,207,186,0,0,0,0,0,0
1103102,51,20,1962,12,"female",2094,64,12,15,8,1,4,14,4
1103110,21,25,1992,9,"male",478,51,25,129,29,0,1,129,28
1103111,54,3,1959,4,"male",696,124,91,0,9,0,9,0,0
1103114,24,7,1989,12,"female",420,159,82,74,84,74,78,0,6
1103133,34,29,1979,9,"female",782,70,27,97,30,97,21,0,9
1103135,26,12,1987,5,"female",550,196,137,25,14,25,10,0,4
1103153,20,6,1993,11,"male",277,242,166,27,67,27,64,0,3
1103156,23,16,1990,3,"male",485,103,70,16,21,16,14,0,7
1103168,23,23,1990,11,"female",594,245,98,1,0,0,0,1,0
1103179,15,6,1998,7,"female",1,6,6,24,3,0,0,24,3
1103186,18,10,1995,6,"male",134,53,37,1,11,1,9,0,2
1103188,31,30,1982,11,"female",914,22,19,34,32,34,27,0,5
1103191,60,13,1953,7,"male",304,95,73,5,37,5,4,0,33
1103216,16,10,1997,6,"male",301,16,14,1,0,1,0,0,0
1103220,39,17,1974,9,"male",463,60,42,0,0,0,0,0,0
1103232,16,28,1997,4,"female",240,429,350,40,37,8,15,32,22
1103236,69,19,1944,8,"female",1492,57,28,0,0,0,0,0,0
1103303,30,27,1983,7,"male",59,116,102,11,26,11,18,0,8
1103337,16,19,1997,9,"female",383,577,188,1006,1287,994,1270,12,17
1103340,49,16,1964,10,"male",440,197,176,55,46,18,27,37,19
1103372,18,11,1995,6,"male",89,22,17,0,0,0,0,0,0
1103387,51,16,1962,11,"male",1517,75,23,0,0,0,0,0,0
1103394,46,24,1967,9,"male",211,8,6,0,0,0,0,0,0
1103410,20,19,1993,5,"female",431,172,116,113,2,113,2,0,0
1103428,51,21,1962,11,"male",2008,127,72,5,367,5,236,0,131
1103453,39,1,1974,1,"male",217,265,246,2,85,2,81,0,4
1103471,25,10,1988,9,"male",632,87,44,8,1,8,0,0,1
1103481,19,22,1994,6,"male",208,43,38,27,35,27,22,0,13
1103482,24,10,1989,8,"male",317,134,42,24,35,24,29,0,6
1103509,34,17,1979,9,"male",350,148,47,6,11,6,6,0,5
1103510,24,22,1989,11,"female",771,603,393,205,430,203,303,2,127
1103534,29,2,1984,1,"male",39,31,28,0,1,0,0,0,1
1103544,34,6,1979,1,"female",291,22,15,26,22,26,15,0,7
1103553,19,1,1994,1,"male",49,13,13,0,1,0,1,0,0
1103576,36,30,1977,3,"male",75,125,113,66,18,65,15,1,3
1103582,51,1,1962,9,"female",204,171,104,205,77,11,42,194,35
1103587,20,1,1993,1,"male",231,54,32,0,18,0,16,0,2
1103601,42,25,1971,8,"female",1461,620,220,184,336,184,200,0,136
1103608,26,21,1987,8,"female",77,9,3,1,1,1,1,0,0
1103614,30,24,1983,4,"female",166,133,116,301,172,301,151,0,21
1103656,20,17,1993,8,"male",560,337,264,8,0,8,0,0,0
1103660,23,22,1990,9,"male",400,88,51,1,23,1,11,0,12
1103662,43,17,1970,5,"male",49,1,1,0,0,0,0,0,0
1103697,24,7,1989,5,"female",433,65,44,44,61,44,42,0,19
1103704,27,3,1986,3,"female",410,246,156,170,32,170,29,0,3
1103708,23,15,1990,12,"male",630,110,70,0,1,0,1,0,0
1103710,59,27,1954,8,"female",294,38,37,17,0,0,0,17,0
1103728,80,2,1933,2,"male",474,413,305,876,145,876,138,0,7
1103752,16,21,1997,4,"female",227,309,189,66,57,65,40,1,17
1103758,54,6,1959,6,"female",310,172,137,490,92,490,78,0,14
1103775,15,5,1998,2,"female",36,269,179,68,59,68,40,0,19
1103789,18,19,1995,12,"female",27,3,3,3,0,3,0,0,0
1103793,21,19,1992,5,"female",387,159,67,59,57,59,43,0,14
1103804,54,18,1959,2,"male",1664,182,89,0,0,0,0,0,0
1103812,65,30,1948,6,"female",566,21,6,16,3,0,1,16,2
1103817,73,21,1940,12,"female",97,474,428,30,252,9,154,21,98
1103842,29,28,1984,11,"male",604,43,23,36,0,23,0,13,0
1103864,19,1,1994,1,"male",251,35,17,1,0,0,0,1,0
1103865,16,19,1997,12,"female",677,169,77,13,31,10,11,3,20
1103869,20,4,1993,9,"male",345,87,79,0,0,0,0,0,0
1103875,46,20,1967,10,"female",341,57,36,85,24,85,22,0,2
1103885,29,8,1984,2,"male",696,94,52,0,5,0,0,0,5
1103895,27,27,1986,2,"male",11,0,0,0,0,0,0,0,0
1103899,31,24,1982,12,"male",1837,1025,314,5,13,5,7,0,6
1103901,23,29,1990,1,"male",175,45,35,41,1,41,1,0,0
1103953,46,10,1967,8,"male",371,43,32,22,81,22,38,0,43
1103969,64,15,1949,10,"male",194,16,9,0,0,0,0,0,0
1103971,15,25,1998,7,"male",509,32,27,0,1,0,1,0,0
1103977,21,26,1992,6,"male",155,72,68,160,69,160,45,0,24
1103997,24,13,1989,3,"female",107,185,117,50,75,50,38,0,37
1104004,69,21,1944,10,"male",652,8,2,1,1,0,0,1,1
1104005,25,27,1988,9,"male",373,339,255,0,0,0,0,0,0
1104006,26,1,1987,1,"male",305,85,48,2,6,0,3,2,3
1104008,18,3,1995,5,"female",257,817,433,2,95,2,67,0,28
1104016,18,28,1995,11,"female",580,174,44,44,1,44,1,0,0
1104023,23,20,1990,8,"male",428,15,11,9,4,9,4,0,0
1104037,17,19,1996,8,"male",476,127,87,5,1,1,0,4,1
1104044,31,17,1982,1,"male",387,3,0,0,0,0,0,0,0
1104047,28,1,1985,10,"male",351,65,31,62,25,62,8,0,17
1104059,108,10,1905,5,"female",538,990,127,9,20,4,13,5,7
1104091,97,6,1916,2,"male",1477,413,236,226,30,114,17,112,13
1104105,14,24,1999,7,"male",605,490,235,760,179,624,100,136,79
1104115,25,23,1988,12,"male",154,1,0,0,0,0,0,0,0
1104133,18,21,1995,1,"male",629,644,527,155,63,133,44,22,19
1104146,22,25,1991,6,"male",319,391,302,265,497,197,228,68,269
1104162,18,29,1995,8,"female",319,40,29,1917,97,1911,62,6,35
1104188,24,16,1989,8,"female",631,295,149,7,17,2,7,5,10
1104227,24,14,1989,2,"female",577,24,19,18,2,11,0,7,2
1104232,28,22,1985,4,"female",407,145,137,87,71,87,58,0,13
1104234,28,24,1985,4,"male",171,137,122,0,6,0,5,0,1
1104248,21,28,1992,10,"female",543,389,228,563,3679,444,2780,119,899
1104249,31,15,1982,4,"female",739,48,16,296,153,296,35,0,118
1104250,23,2,1990,5,"male",854,377,240,8,7,0,1,8,6
1104259,25,5,1988,1,"female",266,167,110,15,38,4,5,11,33
1104289,37,28,1976,1,"male",236,1,1,0,0,0,0,0,0
1104305,13,29,2000,4,"male",33,38,32,336,50,0,26,336,24
1104306,34,24,1979,1,"male",255,52,40,12,29,12,28,0,1
1104310,16,25,1997,3,"male",514,1,0,0,0,0,0,0,0
1104315,22,3,1991,7,"female",154,1,0,2,0,2,0,0,0
1104316,18,1,1995,2,"female",153,25,22,113,0,113,0,0,0
1104319,19,11,1994,2,"male",265,455,311,180,81,159,64,21,17
1104332,21,7,1992,3,"male",128,107,69,0,0,0,0,0,0
1104346,85,19,1928,10,"female",116,22,20,1,1,0,0,1,1
1104347,53,14,1960,1,"male",512,215,85,1,2,0,2,1,0
1104353,19,31,1994,3,"male",1425,255,109,521,188,509,156,12,32
1104393,17,26,1996,9,"female",183,66,17,4,5,4,0,0,5
1104401,37,9,1976,10,"female",934,145,67,261,384,261,265,0,119
1104411,33,5,1980,5,"female",535,2,1,0,0,0,0,0,0
1104422,51,9,1962,3,"female",311,66,41,189,80,189,42,0,38
1104426,67,10,1946,6,"male",300,247,113,1,0,0,0,1,0
1104432,20,16,1993,9,"male",255,124,82,45,12,5,4,40,8
1104434,59,13,1954,6,"female",83,54,49,3,2,0,0,3,2
1104436,25,1,1988,1,"female",147,1,1,0,0,0,0,0,0
1104501,21,19,1992,10,"male",419,43,34,4,0,0,0,4,0
1104510,30,1,1983,2,"female",416,126,83,17,4,17,1,0,3
1104538,18,14,1995,1,"female",232,450,101,297,71,297,66,0,5
1104545,29,6,1984,4,"female",496,81,53,10,3,10,0,0,3
1104547,42,14,1971,8,"female",1491,238,105,4873,3450,4000,3037,873,413
1104555,56,2,1957,6,"female",1306,148,71,201,140,201,86,0,54
1104575,33,11,1980,11,"male",116,54,44,6,7,6,7,0,0
1104584,24,3,1989,8,"male",68,50,46,4,0,4,0,0,0
1104589,29,18,1984,2,"male",168,1,1,1,1,1,1,0,0
1104616,38,13,1975,12,"male",1341,202,111,0,0,0,0,0,0
1104630,14,6,1999,5,"female",276,46,36,11,40,11,26,0,14
1104634,28,6,1985,7,"female",151,27,8,2,0,2,0,0,0
1104638,100,13,1913,12,"female",985,127,81,248,313,248,266,0,47
1104646,111,1,1902,1,"female",1602,30,14,4,0,0,0,4,0
1104657,66,30,1947,6,"female",1239,542,359,189,207,17,49,172,158
1104681,47,21,1966,7,"male",1714,20,9,5,3,5,0,0,3
1104686,108,31,1905,10,"male",943,346,300,16,3,1,1,15,2
1104703,25,1,1988,1,"male",90,97,77,10,2,10,1,0,1
1104754,24,1,1989,1,"male",667,102,88,95,97,95,52,0,45
1104789,35,18,1978,5,"female",275,67,34,41,25,40,12,1,13
1104799,56,29,1957,10,"female",404,31,12,1,3,0,1,1,2
1104833,23,15,1990,8,"male",622,14,6,0,2,0,0,0,2
1104840,63,16,1950,12,"male",711,10,6,0,1,0,1,0,0
1104876,17,1,1996,1,"male",458,116,58,0,2,0,1,0,1
1104891,52,18,1961,10,"female",29,96,74,167,49,167,27,0,22
1104919,59,18,1954,2,NA,2076,4,0,23,5,23,4,0,1
1104984,17,24,1996,8,"male",67,96,81,0,0,0,0,0,0
1105005,59,29,1954,8,"female",1259,76,41,2822,368,2822,235,0,133
1105008,29,8,1984,12,"female",486,183,131,583,294,583,174,0,120
1105013,32,20,1981,5,"male",249,79,67,33,28,32,24,1,4
1105033,21,23,1992,5,"female",88,89,25,29,86,11,38,18,48
1105052,52,7,1961,6,"male",182,48,35,2,104,0,45,2,59
1105098,15,24,1998,10,"male",138,232,181,4,1,3,1,1,0
1105114,46,6,1967,8,"male",343,261,227,589,184,0,43,589,141
1105124,20,6,1993,5,"female",333,15,8,1,0,1,0,0,0
1105149,108,4,1905,1,"male",1032,177,102,128,272,9,81,119,191
1105174,53,4,1960,8,"female",1123,108,52,316,10,316,9,0,1
1105226,36,15,1977,11,"male",275,294,151,5,4,5,3,0,1
1105238,60,14,1953,6,"female",1515,339,59,1018,182,926,174,92,8
1105248,64,25,1949,6,"male",208,1,1,0,0,0,0,0,0
1105251,108,22,1905,4,"male",1743,165,100,4,11,0,2,4,9
1105264,25,5,1988,5,"male",501,80,68,6,0,0,0,6,0
1105284,54,10,1959,12,"female",2138,185,78,980,556,506,263,474,293
1105299,53,7,1960,2,"female",405,73,55,37,10,10,2,27,8
1105307,44,19,1969,5,"male",289,46,20,11,12,11,12,0,0
1105337,26,1,1987,1,"male",139,41,33,4,2,4,2,0,0
1105341,23,14,1990,3,"male",599,168,95,19,0,19,0,0,0
1105384,48,25,1965,12,"male",306,3,0,0,0,0,0,0,0
1105414,68,17,1945,10,"male",560,21,9,6,8,6,7,0,1
1105417,55,9,1958,7,"female",721,104,53,51,122,51,46,0,76
1105422,43,20,1970,12,"male",408,74,60,1,0,1,0,0,0
1105436,20,6,1993,3,"male",224,217,173,1,3,0,1,1,2
1105437,43,19,1970,4,"female",479,6,3,47,13,47,13,0,0
1105462,45,8,1968,1,"female",382,1,0,16,9,2,2,14,7
1105473,18,12,1995,12,"male",812,372,241,0,0,0,0,0,0
1105482,63,21,1950,12,"female",1925,330,232,74,265,73,147,1,118
1105499,41,30,1972,5,"female",637,61,39,138,83,138,67,0,16
1105520,32,30,1981,4,"female",559,16,12,0,2,0,0,0,2
1105530,74,7,1939,8,"female",124,78,60,100,4,0,2,100,2
1105560,46,11,1967,3,"male",707,209,88,84,9,76,7,8,2
1105567,20,22,1993,11,"male",452,216,46,554,220,536,147,18,73
1105579,46,18,1967,6,"female",97,198,168,179,240,38,124,141,116
1105585,17,21,1996,11,"male",906,590,442,46,34,46,23,0,11
1105621,15,9,1998,1,"male",353,2,1,0,0,0,0,0,0
1105630,25,6,1988,10,"male",347,8,3,0,0,0,0,0,0
1105659,14,8,1999,9,"male",315,179,142,9,8,8,7,1,1
1105668,77,31,1936,7,"female",909,95,66,1,1,1,0,0,1
1105678,21,2,1992,6,"male",49,21,20,1,0,1,0,0,0
1105715,52,14,1961,11,"male",1096,39,15,0,2,0,2,0,0
1105728,54,19,1959,10,"female",1198,91,48,34,172,25,84,9,88
1105731,19,17,1994,3,"male",545,7,2,0,0,0,0,0,0
1105755,108,11,1905,3,"male",1541,96,37,22,7,22,7,0,0
1105763,44,3,1969,9,"female",308,64,28,34,53,8,22,26,31
1105772,24,31,1989,3,"male",430,268,137,476,982,278,605,198,377
1105779,21,27,1992,7,"male",1135,34,22,0,0,0,0,0,0
1105789,35,10,1978,11,"female",417,237,106,348,232,251,140,97,92
1105790,27,21,1986,11,"male",297,8,5,0,0,0,0,0,0
1105797,22,9,1991,8,"male",153,56,37,12,18,12,13,0,5
1105851,16,18,1997,3,"male",301,305,279,8,7,8,2,0,5
1105874,18,6,1995,3,"female",671,75,62,47,35,47,30,0,5
1105886,25,5,1988,6,"female",406,106,43,4,6,4,6,0,0
1105891,32,5,1981,11,"female",220,359,11,30,91,30,87,0,4
1105905,53,1,1960,11,"male",219,104,43,4,14,4,10,0,4
1105907,26,11,1987,11,"female",237,42,32,546,737,487,691,59,46
1105912,18,9,1995,5,"male",162,66,58,36,36,36,23,0,13
1105935,74,14,1939,4,"female",907,209,166,12,2,0,2,12,0
1105948,73,1,1940,1,"female",257,18,7,873,49,873,30,0,19
1105960,21,20,1992,3,"male",36,20,16,10,5,0,1,10,4
1105961,19,17,1994,7,"male",157,16,13,0,0,0,0,0,0
1105965,24,3,1989,5,"female",66,0,0,0,0,0,0,0,0
1105972,60,5,1953,1,"male",447,1,0,0,0,0,0,0,0
1105973,63,23,1950,11,"male",1370,54,41,0,0,0,0,0,0
1105983,17,31,1996,5,"male",469,1505,1009,60,68,58,48,2,20
1105987,16,20,1997,5,"female",166,58,16,3,4,3,2,0,2
1105990,37,20,1976,4,"male",809,6,5,7,0,7,0,0,0
1105998,50,27,1963,12,"male",371,34,29,0,1,0,0,0,1
1106005,42,30,1971,6,"male",174,34,31,2,0,2,0,0,0
1106006,37,25,1976,12,"male",80,12,12,0,0,0,0,0,0
1106040,44,8,1969,6,"female",129,109,99,84,19,0,9,84,10
1106047,15,6,1998,3,"male",156,77,51,36,9,0,1,36,8
1106065,20,8,1993,10,"male",1362,538,292,524,350,231,266,293,84
1106095,71,1,1942,5,"female",1778,188,74,7,51,3,20,4,31
1106147,29,4,1984,7,"male",449,33,14,3,0,0,0,3,0
1106191,17,9,1996,10,"male",379,266,141,103,118,103,87,0,31
1106213,24,24,1989,2,"male",167,86,54,0,24,0,24,0,0
1106265,25,5,1988,10,"male",634,84,61,8,19,8,19,0,0
1106283,28,1,1985,3,"female",608,222,76,894,663,894,578,0,85
1106284,47,10,1966,5,"female",2222,147,57,43,257,43,173,0,84
1106306,54,3,1959,7,"male",2012,99,9,16,57,16,46,0,11
1106337,68,20,1945,9,"female",886,77,39,10,26,0,5,10,21
1106341,15,1,1998,1,"male",701,76,61,1,0,1,0,0,0
1106378,18,13,1995,4,"male",920,173,66,4,5,4,3,0,2
1106393,36,19,1977,2,"female",196,72,48,0,0,0,0,0,0
1106401,113,20,1900,9,"female",1270,85,49,3,10,3,4,0,6
1106419,18,16,1995,9,"female",193,363,77,0,0,0,0,0,0
1106435,25,18,1988,7,"female",394,46,18,91,67,0,7,91,60
1106463,40,16,1973,10,"female",379,202,131,30,75,0,28,30,47
1106470,20,21,1993,9,"male",499,112,61,1,0,1,0,0,0
1106493,56,4,1957,6,"male",950,29,6,9,0,0,0,9,0
1106500,23,11,1990,9,"male",132,10,10,0,10,0,5,0,5
1106539,32,24,1981,11,"male",458,0,0,0,0,0,0,0,0
1106554,26,2,1987,3,"female",255,52,42,0,0,0,0,0,0
1106599,63,27,1950,7,"male",291,69,43,87,14,0,5,87,9
1106602,58,6,1955,11,"female",854,50,29,8,0,8,0,0,0
1106622,33,2,1980,5,"female",455,105,76,278,7,10,1,268,6
1106662,28,1,1985,1,"male",573,368,346,15,8,0,5,15,3
1106665,27,5,1986,2,"male",301,233,171,103,130,94,93,9,37
1106679,18,1,1995,10,"female",626,387,263,516,160,506,138,10,22
1106680,40,25,1973,4,"female",1300,107,47,23,70,23,47,0,23
1106694,53,9,1960,10,"male",891,59,37,2,6,2,6,0,0
1106707,22,29,1991,5,"male",1492,663,466,21,45,21,34,0,11
1106723,56,3,1957,6,"female",214,20,5,191,102,191,30,0,72
1106742,15,26,1998,6,"male",121,64,35,23,3,23,3,0,0
1106765,51,4,1962,2,"male",522,66,55,42,7,0,0,42,7
1106780,19,15,1994,2,"female",690,225,133,1289,66,1279,62,10,4
1106807,73,26,1940,6,"female",553,64,45,5,1,1,0,4,1
1106824,49,18,1964,7,"male",177,11,5,2,2,2,2,0,0
1106825,40,27,1973,3,"female",39,63,46,961,1074,961,482,0,592
1106828,14,28,1999,3,"female",252,418,273,6,2,6,2,0,0
1106833,46,25,1967,5,"female",590,489,295,674,716,674,416,0,300
1106878,26,1,1987,1,"male",444,99,68,0,1,0,1,0,0
1106879,27,3,1986,5,"male",345,77,44,1,21,1,21,0,0
1106904,25,29,1988,4,"male",482,317,250,486,219,486,186,0,33
1106978,20,4,1993,11,"female",661,148,111,101,295,82,189,19,106
1106989,23,7,1990,6,"male",459,17,8,1,2,0,2,1,0
1107036,38,24,1975,7,"male",208,80,25,1,0,1,0,0,0
1107076,18,11,1995,8,"female",549,374,241,75,83,73,44,2,39
1107088,18,16,1995,1,"female",532,661,340,231,111,226,78,5,33
1107094,34,13,1979,10,"male",308,75,60,0,2,0,1,0,1
1107117,27,28,1986,6,"female",934,254,179,12,58,12,45,0,13
1107140,49,1,1964,12,"male",223,8,8,1,0,1,0,0,0
1107145,27,20,1986,11,"female",493,1,0,0,0,0,0,0,0
1107168,17,30,1996,3,"male",58,0,0,1,1,1,1,0,0
1107172,58,19,1955,11,"male",1329,140,69,2,2,0,1,2,1
1107192,102,21,1911,8,"male",2341,224,109,6,16,0,1,6,15
1107195,33,16,1980,3,"female",343,106,7,0,0,0,0,0,0
1107246,34,23,1979,11,"male",207,1,1,0,0,0,0,0,0
1107251,19,1,1994,3,"male",213,31,14,0,2,0,2,0,0
1107269,25,3,1988,9,"male",257,198,144,43,0,0,0,43,0
1107270,19,17,1994,10,"male",1323,556,384,0,4,0,3,0,1
1107299,83,8,1930,3,"male",1614,534,155,26,305,26,293,0,12
1107305,21,1,1992,10,"female",462,549,238,22,27,11,20,11,7
1107333,50,5,1963,6,"male",1268,31,17,3,1,0,0,3,1
1107357,25,1,1988,1,"male",139,24,18,1,0,1,0,0,0
1107363,17,28,1996,11,"male",578,671,408,106,527,52,286,54,241
1107385,37,16,1976,8,"female",195,72,55,225,116,171,80,54,36
1107487,18,13,1995,6,"female",132,456,161,330,623,330,380,0,243
1107503,55,19,1958,10,"male",1890,160,79,180,152,180,109,0,43
1107557,45,5,1968,7,"female",686,225,119,83,210,82,194,1,16
1107572,28,5,1985,5,"male",186,16,14,2,0,2,0,0,0
1107589,65,1,1948,4,"female",732,25,18,40,27,0,11,40,16
1107612,15,4,1998,2,"male",589,281,232,54,137,22,114,32,23
1107620,37,15,1976,8,"male",721,31,19,56,16,51,11,5,5
1107685,64,9,1949,2,"male",419,25,10,3,0,3,0,0,0
1107702,23,4,1990,4,"male",765,146,112,1,0,1,0,0,0
1107745,40,6,1973,6,"female",1492,88,27,244,202,235,151,9,51
1107761,20,12,1993,8,"male",227,107,96,17,11,17,10,0,1
1107802,97,20,1916,10,"male",1461,1936,953,724,1337,459,506,265,831
1107806,83,4,1930,6,"female",477,15,11,0,0,0,0,0,0
1107814,55,4,1958,5,"female",102,16,10,34,1,10,0,24,1
1107815,100,7,1913,2,"male",923,34,11,0,0,0,0,0,0
1107832,21,1,1992,1,"male",19,22,20,6,0,6,0,0,0
1107833,68,5,1945,6,"male",123,86,52,10,4,10,4,0,0
1107851,17,16,1996,6,"male",283,69,62,0,0,0,0,0,0
1107874,54,4,1959,7,"male",679,66,38,100,14,0,5,100,9
1107877,25,26,1988,4,"male",348,62,59,150,31,108,20,42,11
1107883,21,30,1992,9,"female",512,292,195,89,131,44,58,45,73
1107902,20,20,1993,5,"male",353,258,169,8,8,0,3,8,5
1107915,65,15,1948,4,"female",321,4,4,3,0,0,0,3,0
1107942,18,11,1995,1,"female",314,84,45,2,17,2,7,0,10
1107956,20,13,1993,12,"male",328,244,225,10,2,9,1,1,1
1107967,28,25,1985,10,"female",395,21,10,4,5,4,4,0,1
1107970,27,16,1986,3,"male",804,91,55,0,39,0,17,0,22
1107983,22,21,1991,2,"male",80,91,86,0,2,0,1,0,1
1107996,16,9,1997,12,"male",282,46,34,104,0,104,0,0,0
1108056,46,15,1967,2,"female",451,68,31,54,20,54,14,0,6
1108072,17,27,1996,3,"male",458,165,18,155,104,154,94,1,10
1108093,34,7,1979,9,"male",471,29,4,0,0,0,0,0,0
1108134,64,22,1949,4,"female",1705,114,64,48,33,36,11,12,22
1108147,61,15,1952,9,"female",247,91,78,137,10,137,5,0,5
1108162,108,26,1905,5,"female",2197,616,438,255,129,13,38,242,91
1108163,19,7,1994,9,"male",174,5,3,1,1,1,1,0,0
1108175,108,25,1905,4,"female",1136,273,148,17,52,0,31,17,21
1108182,103,12,1910,3,"female",965,140,36,9,43,9,42,0,1
1108236,52,3,1961,7,"female",676,270,238,8,5,2,1,6,4
1108272,79,29,1934,12,"male",20,15,14,6,11,6,5,0,6
1108283,54,11,1959,8,"male",2190,110,76,43,118,16,62,27,56
1108285,17,17,1996,6,"male",119,16,4,2,0,2,0,0,0
1108297,16,20,1997,11,"male",171,383,73,68,69,68,35,0,34
1108320,18,11,1995,1,"male",217,128,81,5,0,5,0,0,0
1108322,55,30,1958,11,"male",1152,289,233,19,6,8,3,11,3
1108323,24,9,1989,1,"male",231,28,13,1,0,0,0,1,0
1108341,21,27,1992,8,"female",180,31,29,2,1,2,1,0,0
1108371,46,6,1967,7,"male",289,66,30,6,0,5,0,1,0
1108432,27,15,1986,4,"male",236,85,24,32,34,32,28,0,6
1108456,67,2,1946,1,"male",1518,58,31,255,58,11,37,244,21
1108462,16,27,1997,5,"male",253,585,509,2945,460,2945,395,0,65
1108465,21,20,1992,5,"male",362,106,64,4,11,4,7,0,4
1108477,48,30,1965,11,"male",1161,1,0,0,0,0,0,0,0
1108494,68,4,1945,10,"female",296,54,32,4,2,0,1,4,1
1108504,20,5,1993,7,"male",783,370,272,197,226,196,99,1,127
1108524,63,5,1950,3,NA,1401,19,3,3,1,2,1,1,0
1108532,108,4,1905,2,"male",1566,376,257,4,1,0,1,4,0
1108549,18,17,1995,10,"male",316,130,112,99,19,52,8,47,11
1108554,91,30,1922,9,"male",104,11,0,2,0,0,0,2,0
1108562,24,3,1989,10,"male",351,81,70,6,5,6,5,0,0
1108578,103,31,1910,12,"male",1529,641,477,0,0,0,0,0,0
1108604,30,15,1983,11,"female",1893,226,142,81,48,33,34,48,14
1108613,24,18,1989,8,"male",321,88,32,13,28,13,16,0,12
1108621,60,10,1953,7,"male",323,63,47,31,51,0,32,31,19
1108637,95,21,1918,5,"male",2215,140,50,33,27,33,20,0,7
1108640,25,1,1988,1,"male",201,36,36,2,0,2,0,0,0
1108652,22,13,1991,3,"male",164,89,76,49,13,49,9,0,4
1108657,17,3,1996,5,"male",667,333,167,36,13,31,5,5,8
1108689,42,5,1971,5,"female",326,11,9,0,0,0,0,0,0
1108701,21,26,1992,1,"male",525,160,129,0,0,0,0,0,0
1108744,108,12,1905,3,"male",1139,315,86,64,9,0,4,64,5
1108745,28,5,1985,5,"male",300,54,46,4,1,4,0,0,1
1108752,57,15,1956,9,"male",1693,138,81,5,69,5,50,0,19
1108787,35,30,1978,10,"female",57,86,69,202,388,202,279,0,109
1108801,103,30,1910,3,"female",534,513,155,408,431,408,407,0,24
1108802,26,18,1987,8,"male",333,97,86,216,271,216,248,0,23
1108814,33,29,1980,12,"male",566,13,2,0,1,0,1,0,0
1108874,54,11,1959,11,"female",1734,193,108,85,78,85,57,0,21
1108894,23,23,1990,10,"male",112,65,65,0,12,0,10,0,2
1108918,19,9,1994,10,"female",497,262,145,202,143,105,47,97,96
1108943,27,13,1986,6,"male",513,31,16,0,0,0,0,0,0
1108964,18,12,1995,12,"male",627,82,54,22,26,22,3,0,23
1108973,44,16,1969,9,"female",278,66,32,13,30,13,30,0,0
1108977,64,20,1949,8,"female",1478,119,43,7,20,1,9,6,11
1108978,16,5,1997,1,"female",692,147,30,3,11,3,11,0,0
1108982,21,21,1992,7,"female",662,391,278,1054,276,191,98,863,178
1109008,18,7,1995,2,"female",608,225,95,71,39,71,31,0,8
1109056,18,12,1995,5,"male",559,159,124,0,1,0,1,0,0
1109074,25,6,1988,2,"male",149,2,1,7,1,0,1,7,0
1109083,33,22,1980,5,"female",63,35,24,69,11,68,7,1,4
1109093,18,6,1995,7,"male",496,153,105,102,102,102,90,0,12
1109102,65,30,1948,6,"male",649,50,34,14,6,14,5,0,1
1109116,14,13,1999,5,"male",369,269,205,0,1,0,0,0,1
1109123,102,11,1911,9,"female",272,37,19,1,16,1,6,0,10
1109126,54,29,1959,5,"male",356,118,74,86,15,34,7,52,8
1109195,13,28,2000,9,"female",40,41,30,488,105,488,90,0,15
1109197,13,9,2000,5,"female",411,266,125,378,192,156,48,222,144
1109223,108,9,1905,4,"female",2007,172,56,48,69,19,34,29,35
1109232,20,1,1993,10,"male",149,176,123,173,21,173,15,0,6
1109239,64,27,1949,6,"female",891,53,37,247,72,87,30,160,42
1109296,32,10,1981,8,"female",522,219,128,244,88,0,34,244,54
1109301,59,22,1954,10,"male",708,51,19,1,2,0,2,1,0
1109319,32,13,1981,11,"female",71,138,46,314,117,314,112,0,5
1109323,25,1,1988,1,"male",287,16,9,0,6,0,6,0,0
1109341,16,8,1997,6,"female",217,657,55,7,7,7,5,0,2
1109367,62,26,1951,7,"female",1861,87,49,6,32,1,6,5,26
1109371,20,2,1993,12,"male",647,47,3,17,0,17,0,0,0
1109381,16,22,1997,12,"female",243,393,252,233,327,217,207,16,120
1109407,60,9,1953,3,"male",1383,30,15,5,18,4,10,1,8
1109413,67,19,1946,11,"male",1466,59,18,0,1,0,0,0,1
1109442,71,12,1942,9,"female",1773,58,40,32,38,0,10,32,28
1109449,40,31,1973,8,"male",588,24,18,0,0,0,0,0,0
1109471,18,21,1995,3,"female",627,221,62,11,36,10,26,1,10
1109492,19,12,1994,4,"female",521,2186,143,823,3934,380,1148,443,2786
1109501,14,28,1999,2,"female",504,767,328,193,65,167,40,26,25
1109512,26,1,1987,1,"male",315,54,44,16,16,16,8,0,8
1109543,108,18,1905,9,"male",1304,111,58,21,19,6,16,15,3
1109595,18,16,1995,9,"male",455,252,95,13,33,13,21,0,12
1109605,16,8,1997,10,"male",240,1,0,0,0,0,0,0,0
1109613,32,20,1981,2,"female",295,69,37,2,8,2,6,0,2
1109625,53,15,1960,10,"male",579,7,1,0,0,0,0,0,0
1109667,25,7,1988,9,"female",534,361,218,88,15,88,5,0,10
1109671,14,9,1999,1,"male",133,3,0,0,0,0,0,0,0
1109683,29,16,1984,2,"female",499,53,17,2,73,1,30,1,43
1109684,18,21,1995,4,"male",457,91,25,3,5,3,1,0,4
1109689,18,27,1995,9,"female",273,286,109,275,93,275,93,0,0
1109691,24,17,1989,7,"male",319,130,80,5,5,5,4,0,1
1109704,30,5,1983,8,"male",176,31,14,0,0,0,0,0,0
1109706,48,11,1965,11,"male",325,84,57,53,7,53,4,0,3
1109723,28,4,1985,10,"male",512,152,102,89,44,88,43,1,1
1109726,33,18,1980,1,"male",266,42,32,3,0,3,0,0,0
1109728,25,6,1988,6,"female",672,56,40,0,1,0,1,0,0
1109735,20,15,1993,9,"male",301,86,60,13,2,13,2,0,0
1109775,18,25,1995,9,"female",528,842,580,19,44,19,43,0,1
1109798,23,19,1990,12,"male",882,0,0,0,0,0,0,0,0
1109799,21,21,1992,7,"male",623,646,527,10,32,10,21,0,11
1109804,69,3,1944,2,"female",620,27,1,1,1,0,0,1,1
1109860,20,1,1993,1,"male",157,1,1,0,0,0,0,0,0
1109883,15,22,1998,11,"female",369,29,7,2,0,2,0,0,0
1109892,24,19,1989,3,"female",108,329,149,88,90,85,57,3,33
1109898,20,30,1993,8,"male",594,180,134,3,4,0,0,3,4
1109914,28,1,1985,3,"male",680,210,206,0,6,0,3,0,3
1109920,27,11,1986,11,"male",680,191,46,123,90,123,74,0,16
1109928,51,16,1962,10,"female",436,422,156,1722,574,1568,252,154,322
1109947,20,15,1993,11,"female",226,114,78,141,108,138,56,3,52
1109950,39,22,1974,5,"male",775,50,24,11,2,11,2,0,0
1109953,29,23,1984,2,"male",582,67,60,158,239,158,183,0,56
1109960,19,20,1994,11,"female",484,52,32,10,1,10,1,0,0
1109984,67,28,1946,7,"male",433,34,29,1,0,1,0,0,0
1109992,56,28,1957,1,"female",645,47,28,1042,185,174,92,868,93
1110013,14,15,1999,3,"female",331,71,35,9,8,9,6,0,2
1110035,21,30,1992,11,"male",316,725,639,199,87,199,84,0,3
1110056,27,2,1986,8,"female",545,125,83,84,134,84,79,0,55
1110072,21,22,1992,10,"male",398,114,91,97,68,95,19,2,49
1110073,39,23,1974,7,"female",346,6,5,1,0,0,0,1,0
1110109,20,9,1993,7,"female",206,1170,799,2240,754,2239,430,1,324
1110111,35,4,1978,8,"female",273,113,101,427,399,4,115,423,284
1110122,29,8,1984,11,"female",403,53,26,34,2,34,2,0,0
1110142,19,30,1994,4,"male",508,117,64,6,5,6,4,0,1
1110149,23,20,1990,6,"female",306,425,385,33,33,33,33,0,0
1110164,21,11,1992,11,"male",1070,60,41,0,0,0,0,0,0
1110194,100,4,1913,9,"male",848,31,17,0,3,0,3,0,0
1110215,21,9,1992,8,"male",221,122,76,11,12,0,7,11,5
1110224,19,30,1994,3,"female",268,420,194,90,63,84,33,6,30
1110236,23,24,1990,10,"male",102,19,17,27,21,9,7,18,14
1110283,62,26,1951,8,"male",1246,46,29,0,0,0,0,0,0
1110322,41,10,1972,4,"male",946,126,51,2,0,2,0,0,0
1110336,21,6,1992,10,"female",527,316,177,156,285,156,269,0,16
1110352,75,20,1938,6,"female",1035,142,99,42,43,0,15,42,28
1110372,33,1,1980,12,"male",70,156,132,42,69,42,53,0,16
1110376,37,25,1976,7,"female",989,106,45,104,74,104,40,0,34
1110385,106,12,1907,6,"male",1782,84,62,10,0,10,0,0,0
1110392,29,4,1984,5,"female",657,3,1,0,0,0,0,0,0
1110424,21,17,1992,8,"female",245,468,29,7,198,7,125,0,73
1110458,15,5,1998,2,"male",512,689,630,264,103,217,84,47,19
1110460,47,27,1966,8,"female",364,45,21,84,63,84,54,0,9
1110477,27,10,1986,7,"male",609,366,241,413,248,413,139,0,109
1110488,66,2,1947,1,"male",1475,76,34,3,1,3,1,0,0
1110516,14,23,1999,10,"female",88,17,11,78,40,0,2,78,38
1110524,103,21,1910,9,"female",678,593,315,13,7,13,5,0,2
1110532,103,9,1910,10,"male",1057,169,123,0,19,0,14,0,5
1110537,16,4,1997,12,"male",423,1200,283,23,114,17,92,6,22
1110565,103,12,1910,7,"female",626,90,33,0,1,0,0,0,1
1110567,30,9,1983,6,"female",272,1,0,0,0,0,0,0,0
1110575,23,26,1990,5,"female",482,706,442,1273,1903,106,346,1167,1557
1110598,23,27,1990,10,"male",363,0,0,0,0,0,0,0,0
1110615,25,3,1988,2,"male",26,0,0,0,0,0,0,0,0
1110622,67,23,1946,12,"male",644,130,75,1068,400,474,229,594,171
1110655,77,20,1936,5,"female",102,1,1,0,0,0,0,0,0
1110678,18,17,1995,2,"female",293,163,117,20,3,20,3,0,0
1110711,46,16,1967,2,"male",341,62,42,18,19,0,7,18,12
1110727,38,9,1975,9,"male",52,0,0,0,0,0,0,0,0
1110756,17,22,1996,2,"female",309,4540,454,290,2047,4,1279,286,768
1110766,31,19,1982,12,"male",716,168,87,10,22,9,3,1,19
1110779,73,24,1940,2,"female",817,35,11,0,4,0,4,0,0
1110794,41,7,1972,1,"male",71,21,14,32,34,29,29,3,5
1110822,71,14,1942,12,"male",638,61,43,14,6,0,2,14,4
1110836,17,26,1996,6,"male",146,7,6,0,0,0,0,0,0
1110845,33,17,1980,6,"female",137,1,0,0,0,0,0,0,0
1110877,20,15,1993,4,"male",321,11,10,1,0,0,0,1,0
1110891,33,12,1980,1,"male",108,33,29,13,5,13,5,0,0
1110892,45,3,1968,8,"female",63,1,1,14,9,14,9,0,0
1110937,17,27,1996,4,"female",39,725,483,525,1638,113,840,412,798
1110950,42,1,1971,5,"female",178,4,2,0,0,0,0,0,0
1111018,51,28,1962,6,"female",566,33,9,12,11,12,3,0,8
1111076,18,9,1995,8,"female",412,16,11,1,0,0,0,1,0
1111086,57,28,1956,11,"female",434,28,19,60,23,0,5,60,18
1111102,15,2,1998,4,"male",301,21,12,0,0,0,0,0,0
1111155,29,2,1984,3,"female",423,235,164,40,44,40,42,0,2
1111165,70,2,1943,1,"male",1433,71,45,0,3,0,0,0,3
1111168,25,20,1988,3,"male",1639,116,60,41,63,32,49,9,14
1111178,25,8,1988,10,"male",22,33,23,13,12,13,8,0,4
1111183,21,8,1992,9,"male",58,4,0,1,0,1,0,0,0
1111184,57,5,1956,3,"female",130,126,97,451,150,451,127,0,23
1111204,19,22,1994,3,"female",122,348,216,209,325,209,284,0,41
1111209,59,2,1954,8,"female",99,24,18,5,9,5,5,0,4
1111235,54,4,1959,10,"male",505,132,72,13,40,0,19,13,21
1111237,66,2,1947,9,"female",573,142,56,0,16,0,10,0,6
1111249,60,21,1953,12,"female",1764,216,168,407,213,407,123,0,90
1111263,69,20,1944,8,"male",247,16,11,3,11,0,9,3,2
1111273,20,7,1993,12,"male",317,57,20,3,2,3,2,0,0
1111287,53,23,1960,2,"male",1174,19,8,4,1,0,0,4,1
1111309,18,6,1995,7,"male",207,422,356,81,40,81,37,0,3
1111332,19,16,1994,7,"male",516,936,847,0,1,0,1,0,0
1111339,32,12,1981,7,"female",552,27,14,0,1,0,1,0,0
1111378,52,18,1961,12,"male",1354,262,187,2276,34,1598,20,678,14
1111435,19,25,1994,11,"female",323,562,229,4,123,4,88,0,35
1111457,21,14,1992,9,"female",22,39,22,7,14,5,4,2,10
1111463,67,23,1946,6,"female",1387,72,19,33,4,25,4,8,0
1111465,48,23,1965,7,"male",420,100,89,61,54,0,15,61,39
1111475,108,15,1905,5,"male",1686,496,400,12,23,8,17,4,6
1111516,23,5,1990,5,"male",88,44,41,3,1,3,1,0,0
1111531,18,2,1995,1,"male",217,232,207,3,24,3,22,0,2
1111573,69,7,1944,11,"female",859,104,26,50,19,6,11,44,8
1111577,23,16,1990,8,"male",391,136,107,9,25,9,19,0,6
1111583,103,16,1910,4,"male",547,312,269,3,12,3,10,0,2
1111598,22,1,1991,2,"female",25,255,60,92,91,92,31,0,60
1111600,23,4,1990,5,"male",600,207,80,3,35,3,18,0,17
1111655,80,10,1933,11,"male",648,20,10,0,12,0,3,0,9
1111663,25,12,1988,1,"male",891,69,56,0,0,0,0,0,0
1111697,68,1,1945,3,"male",35,22,21,4,2,0,1,4,1
1111762,17,16,1996,2,"male",793,336,137,47,9,45,3,2,6
1111771,28,1,1985,1,"male",481,994,797,414,187,414,155,0,32
1111780,24,22,1989,6,"female",305,107,32,0,0,0,0,0,0
1111782,50,7,1963,4,"female",610,32,21,13,0,13,0,0,0
1111783,30,28,1983,9,"male",208,80,61,82,32,42,10,40,22
1111784,57,10,1956,9,"female",432,186,131,1025,253,0,49,1025,204
1111795,30,2,1983,2,"female",163,88,67,24,28,24,28,0,0
1111813,35,10,1978,5,"male",218,64,15,35,45,35,42,0,3
1111829,65,2,1948,10,"female",508,59,37,428,258,0,217,428,41
1111919,49,20,1964,5,"female",364,85,43,0,0,0,0,0,0
1111923,25,26,1988,8,"female",349,169,69,449,290,447,173,2,117
1111933,19,6,1994,6,"male",666,114,84,484,27,331,20,153,7
1111983,45,5,1968,12,"male",378,175,125,43,176,43,122,0,54
1111991,47,17,1966,5,"female",302,120,44,159,145,159,92,0,53
1111996,28,4,1985,2,"male",305,41,28,0,0,0,0,0,0
1112008,15,25,1998,8,"male",72,36,19,1,3,1,0,0,3
1112012,44,12,1969,12,"female",517,216,99,4,0,4,0,0,0
1112016,54,10,1959,12,"female",1649,175,99,644,566,74,371,570,195
1112027,40,2,1973,7,"male",494,146,83,2,2,0,0,2,2
1112056,43,17,1970,12,"male",301,1891,61,3,35,3,16,0,19
1112066,28,7,1985,8,"female",444,3,2,0,0,0,0,0,0
1112072,51,28,1962,4,"female",451,97,82,186,150,186,99,0,51
1112116,80,15,1933,6,"female",937,18,11,2,2,2,1,0,1
1112122,48,27,1965,9,"female",496,138,43,416,328,0,119,416,209
1112155,108,1,1905,1,"male",240,84,58,33,37,24,19,9,18
1112169,32,16,1981,10,"female",239,56,31,356,176,356,61,0,115
1112189,55,20,1958,3,"male",1815,231,63,130,68,129,18,1,50
1112190,68,17,1945,8,"male",1080,562,457,5159,2751,5159,2728,0,23
1112202,19,28,1994,7,"female",225,260,130,44,76,44,47,0,29
1112214,16,9,1997,8,"female",563,239,135,170,28,170,14,0,14
1112226,73,16,1940,4,"male",992,60,38,0,0,0,0,0,0
1112235,19,30,1994,7,"male",196,68,18,5,6,5,6,0,0
1112250,20,11,1993,6,"male",105,0,0,0,0,0,0,0,0
1112262,18,10,1995,5,"male",80,14,13,12,0,0,0,12,0
1112282,36,1,1977,9,"male",767,97,55,2,0,2,0,0,0
1112299,59,30,1954,1,"female",1318,158,71,214,134,177,18,37,116
1112302,32,1,1981,7,"male",134,29,18,0,0,0,0,0,0
1112326,22,12,1991,3,"male",411,5,3,0,0,0,0,0,0
1112331,47,12,1966,3,"male",742,17,9,72,10,2,0,70,10
1112364,17,17,1996,4,"female",54,307,114,144,258,82,209,62,49
1112371,14,8,1999,5,"female",405,886,578,9,0,9,0,0,0
1112401,26,3,1987,1,"female",334,175,69,39,556,39,546,0,10
1112417,18,14,1995,12,"female",92,24,22,0,0,0,0,0,0
1112430,21,26,1992,5,"female",281,289,140,2,25,2,21,0,4
1112433,24,1,1989,1,"female",460,1,1,0,0,0,0,0,0
1112447,50,6,1963,7,"female",1535,42,29,1,1,1,1,0,0
1112469,54,9,1959,6,"male",139,414,128,13,26,11,11,2,15
1112502,14,27,1999,1,"female",265,29,4,21,0,21,0,0,0
1112513,23,1,1990,1,"male",212,0,0,0,0,0,0,0,0
1112528,20,29,1993,6,"female",568,370,159,680,678,680,580,0,98
1112537,18,9,1995,8,"male",54,162,156,10,9,10,6,0,3
1112548,41,17,1972,8,"male",1368,0,0,0,0,0,0,0,0
1112555,25,14,1988,4,"male",610,184,123,350,166,350,162,0,4
1112584,18,15,1995,9,"female",208,393,165,60,202,60,91,0,111
1112605,47,3,1966,6,"male",162,20,16,29,15,29,15,0,0
1112648,61,11,1952,12,"male",1163,178,47,340,146,340,79,0,67
1112660,19,1,1994,1,"female",384,511,161,6,7,6,6,0,1
1112661,29,3,1984,10,"female",142,8,8,0,0,0,0,0,0
1112676,44,3,1969,7,"male",1656,32,21,33,7,11,6,22,1
1112697,25,28,1988,12,"male",398,147,83,188,226,67,61,121,165
1112722,34,16,1979,9,"female",124,95,75,9,98,6,28,3,70
1112735,33,3,1980,4,"female",988,103,63,17,4,17,2,0,2
1112751,32,21,1981,11,"male",134,26,23,1,1,1,0,0,1
1112756,23,11,1990,4,"female",479,159,123,386,103,342,65,44,38
1112776,49,24,1964,8,"male",303,39,37,3,0,3,0,0,0
1112782,23,4,1990,7,"male",883,442,299,0,8,0,5,0,3
1112795,50,1,1963,3,"female",62,10,8,1,1,1,1,0,0
1112807,31,29,1982,5,"male",386,48,33,7,5,7,2,0,3
1112814,17,18,1996,12,"male",441,269,208,0,0,0,0,0,0
1112844,63,27,1950,1,"female",1707,109,39,651,224,35,66,616,158
1112875,24,24,1989,10,"male",316,1,1,422,458,422,397,0,61
1112947,15,16,1998,1,"female",783,813,293,129,565,92,398,37,167
1112977,21,9,1992,10,"male",467,31,21,2,4,2,2,0,2
1112984,16,29,1997,10,"male",558,225,49,158,414,48,249,110,165
1112997,20,3,1993,12,"female",961,384,132,39,59,39,26,0,33
1112998,23,29,1990,9,"male",426,848,723,148,382,148,284,0,98
1113009,20,7,1993,5,"female",426,493,232,481,516,449,117,32,399
1113028,110,1,1903,3,"male",1345,339,26,2,4,1,2,1,2
1113037,27,22,1986,8,"male",103,6,4,0,0,0,0,0,0
1113043,76,11,1937,12,"female",48,12,9,36,37,36,10,0,27
1113088,21,11,1992,6,"female",386,40,3,4,0,0,0,4,0
1113149,19,6,1994,9,"female",873,808,510,1160,179,1153,110,7,69
1113155,28,4,1985,10,"female",123,43,38,28,37,28,37,0,0
1113193,24,20,1989,12,"male",396,759,737,121,6,119,5,2,1
1113241,22,12,1991,4,"male",274,156,115,2,8,2,7,0,1
1113251,43,30,1970,8,"male",178,74,66,18,0,18,0,0,0
1113273,24,7,1989,11,"male",664,1201,1071,0,63,0,60,0,3
1113303,53,1,1960,12,"male",476,1,1,0,0,0,0,0,0
1113315,106,7,1907,8,"female",286,86,44,11,12,11,5,0,7
1113326,63,13,1950,4,"male",558,61,37,1,0,0,0,1,0
1113331,22,16,1991,3,"male",471,87,44,0,0,0,0,0,0
1113339,53,25,1960,4,"male",215,44,15,3,15,1,7,2,8
1113344,69,5,1944,3,"female",433,121,59,51,72,0,42,51,30
1113350,68,23,1945,9,"male",1578,161,66,2,11,1,9,1,2
1113383,43,27,1970,12,"male",84,3,3,0,0,0,0,0,0
1113437,41,22,1972,6,"male",418,3835,18,28,111,28,48,0,63
1113454,29,10,1984,4,"male",231,32,24,7,5,7,5,0,0
1113470,75,15,1938,10,"male",1205,53,31,0,0,0,0,0,0
1113495,54,17,1959,9,"male",281,160,59,10,0,10,0,0,0
1113528,27,6,1986,5,"male",176,58,49,0,28,0,25,0,3
1113549,49,12,1964,3,"female",1618,261,104,215,154,18,34,197,120
1113565,19,1,1994,9,"male",458,57,33,53,33,51,12,2,21
1113578,19,18,1994,11,"male",440,90,78,0,2,0,2,0,0
1113597,18,2,1995,12,"female",675,252,173,83,109,81,43,2,66
1113599,26,1,1987,12,"female",267,54,49,0,0,0,0,0,0
1113606,35,15,1978,7,"female",380,49,23,42,6,0,1,42,5
1113615,23,21,1990,3,"female",1283,518,165,30,55,30,46,0,9
1113623,53,4,1960,10,"male",457,19,13,51,68,42,18,9,50
1113641,48,1,1965,5,"female",638,27,10,8,1,8,1,0,0
1113682,59,23,1954,1,"female",1176,41,26,2,1,2,1,0,0
1113686,20,1,1993,7,"male",307,37,33,13569,37,666,15,12903,22
1113690,24,19,1989,1,"male",555,352,244,3,2,2,1,1,1
1113701,38,9,1975,6,"female",1157,87,49,371,275,289,179,82,96
1113732,43,11,1970,9,"male",165,34,29,2,3,2,3,0,0
1113782,17,30,1996,9,"male",374,714,623,2,5,2,2,0,3
1113785,52,1,1961,3,"male",470,28,24,45,0,45,0,0,0
1113815,18,9,1995,1,"male",694,218,79,7,1,7,0,0,1
1113871,108,5,1905,10,"male",2309,91,62,28,38,28,20,0,18
1113881,61,12,1952,9,"male",1777,13,6,15,2,15,2,0,0
1113912,30,19,1983,9,"female",96,55,49,6,23,6,23,0,0
1113920,88,25,1925,4,"female",1365,245,94,12,19,0,12,12,7
1113955,45,27,1968,3,"female",492,37,27,212,192,212,145,0,47
1113982,34,15,1979,10,"male",337,204,194,2,0,2,0,0,0
1114020,15,27,1998,5,"female",446,193,81,69,61,39,34,30,27
1114025,52,18,1961,2,"female",1898,182,117,234,41,176,23,58,18
1114040,17,9,1996,12,"female",35,205,30,136,123,99,39,37,84
1114062,17,1,1996,10,"female",518,20,12,0,0,0,0,0,0
1114079,21,4,1992,11,"female",88,348,58,12,26,8,8,4,18
1114082,25,20,1988,5,"male",205,84,73,5,13,4,10,1,3
1114089,55,27,1958,7,"female",12,1,1,0,0,0,0,0,0
1114092,69,20,1944,6,"female",141,51,34,14,99,0,24,14,75
1114102,32,6,1981,9,"male",1595,75,51,2,0,0,0,2,0
1114119,35,6,1978,5,"male",530,106,73,4,12,4,0,0,12
1114127,28,12,1985,8,"male",174,34,26,1,0,1,0,0,0
1114137,58,29,1955,9,"male",385,5,4,0,0,0,0,0,0
1114150,15,17,1998,11,"male",320,17,4,0,0,0,0,0,0
1114177,23,9,1990,3,"male",438,146,74,45,25,45,17,0,8
1114196,56,16,1957,9,"female",851,50,26,94,39,78,33,16,6
1114210,60,26,1953,3,"female",592,63,35,5,13,5,4,0,9
1114214,31,8,1982,11,"male",372,75,47,24,5,24,5,0,0
1114221,34,8,1979,8,"female",340,725,519,1240,1927,1005,1438,235,489
1114246,21,1,1992,9,"female",73,264,70,16,72,16,65,0,7
1114252,16,1,1997,7,"male",310,64,48,0,4,0,3,0,1
1114255,15,25,1998,3,"male",704,316,227,88,22,28,3,60,19
1114312,27,2,1986,11,"male",426,97,78,42,4,42,4,0,0
1114332,18,28,1995,6,"male",37,83,68,207,53,207,16,0,37
1114335,45,11,1968,4,"male",419,318,251,62,50,62,35,0,15
1114362,26,17,1987,8,"male",723,158,34,10,19,10,14,0,5
1114371,14,8,1999,4,"female",131,310,212,572,386,392,174,180,212
1114387,21,5,1992,10,"female",270,254,81,99,35,99,17,0,18
1114391,97,24,1916,12,"female",363,640,566,129,138,0,37,129,101
1114401,22,15,1991,4,"male",543,135,77,62,34,62,29,0,5
1114415,20,19,1993,3,"female",746,4483,863,998,3379,905,1887,93,1492
1114427,19,1,1994,1,"male",516,426,405,17,0,17,0,0,0
1114428,16,11,1997,8,"male",560,206,90,2,4,2,4,0,0
1114450,46,5,1967,4,"female",431,2,1,0,0,0,0,0,0
1114451,15,21,1998,8,"male",309,441,178,11,7,0,1,11,6
1114485,51,27,1962,10,"female",251,45,22,21,79,21,69,0,10
1114505,19,19,1994,8,"male",415,2054,1060,2403,8753,1957,5739,446,3014
1114524,26,5,1987,5,"male",332,44,20,0,0,0,0,0,0
1114537,54,28,1959,2,"male",410,174,96,52,17,52,10,0,7
1114549,16,6,1997,1,"male",402,107,71,6,7,6,6,0,1
1114577,53,21,1960,5,"male",119,57,55,3,0,3,0,0,0
1114595,25,8,1988,11,"male",480,44,17,5,100,5,18,0,82
1114599,64,16,1949,12,"female",1704,44,19,7,15,7,8,0,7
1114624,27,7,1986,5,"male",792,166,145,2,1,0,0,2,1
1114646,31,3,1982,12,"female",675,100,79,278,83,272,82,6,1
1114667,47,3,1966,6,"male",177,67,16,35,54,30,34,5,20
1114671,20,15,1993,5,"female",444,504,386,994,782,99,134,895,648
1114674,26,23,1987,3,"female",83,87,69,0,2,0,0,0,2
1114675,30,4,1983,6,"male",703,345,236,11,0,11,0,0,0
1114677,53,28,1960,2,"female",567,108,83,230,68,0,13,230,55
1114685,52,9,1961,10,"male",1465,152,88,160,23,160,23,0,0
1114691,23,7,1990,5,"male",172,41,33,0,0,0,0,0,0
1114698,14,9,1999,3,"female",634,269,164,48,26,1,20,47,6
1114706,29,2,1984,11,"female",436,65,34,6,24,6,15,0,9
1114714,61,25,1952,9,"female",235,102,51,172,252,0,30,172,222
1114743,22,1,1991,1,"male",500,41,15,0,1,0,1,0,0
1114754,31,10,1982,4,"male",717,137,133,2,20,0,9,2,11
1114760,52,24,1961,12,"female",513,549,122,727,1847,39,509,688,1338
1114821,35,10,1978,6,"male",322,141,86,0,1,0,1,0,0
1114860,26,21,1987,8,"male",1472,536,220,78,124,73,76,5,48
1114864,17,1,1996,9,"male",470,69,56,12,0,0,0,12,0
1114907,62,23,1951,9,"female",1081,102,37,80,93,80,70,0,23
1114933,33,15,1980,11,"female",529,1644,992,1396,1970,1255,1539,141,431
1114947,41,1,1972,10,"male",423,159,64,99,108,99,75,0,33
1115008,20,7,1993,1,"female",386,918,456,865,2072,856,1602,9,470
1115011,18,14,1995,6,"male",432,5,5,0,0,0,0,0,0
1115016,24,17,1989,1,"female",656,446,221,0,8,0,5,0,3
1115019,18,10,1995,2,"male",212,14,11,0,0,0,0,0,0
1115034,20,25,1993,11,"male",11,10,8,8,1,0,0,8,1
1115040,23,27,1990,3,"male",122,47,37,16,18,1,6,15,12
1115043,13,24,2000,5,"male",236,247,82,17,1,0,1,17,0
1115056,47,10,1966,9,"male",927,26,19,4,18,4,17,0,1
1115086,28,10,1985,3,"male",21,151,146,11,13,11,10,0,3
1115129,25,1,1988,1,"male",184,2,1,1,1,1,1,0,0
1115137,56,11,1957,7,"female",1856,160,65,680,519,0,273,680,246
1115151,22,3,1991,2,"male",279,84,56,0,0,0,0,0,0
1115170,29,18,1984,2,"male",640,2,2,0,0,0,0,0,0
1115176,108,23,1905,2,"female",1204,368,249,328,274,328,189,0,85
1115216,43,13,1970,3,"female",1244,428,304,1129,814,372,267,757,547
1115230,64,16,1949,12,"male",572,10,3,46,32,0,19,46,13
1115234,15,23,1998,3,"male",36,129,124,24,12,24,7,0,5
1115239,26,1,1987,1,"male",341,3,2,0,0,0,0,0,0
1115245,14,15,1999,4,"male",202,338,284,0,1,0,0,0,1
1115266,19,12,1994,9,"female",193,650,352,715,1678,642,1008,73,670
1115270,16,10,1997,2,"female",177,36,34,1,0,1,0,0,0
1115273,24,12,1989,4,"female",282,1,1,0,0,0,0,0,0
1115275,19,14,1994,2,"male",1014,32,29,0,0,0,0,0,0
1115293,52,6,1961,2,"female",586,20,17,0,0,0,0,0,0
1115347,53,30,1960,3,"male",291,175,97,153,43,153,16,0,27
1115358,69,17,1944,8,"female",1574,241,104,9,24,0,9,9,15
1115371,20,15,1993,9,"female",620,372,181,222,110,49,60,173,50
1115385,23,13,1990,12,"female",894,488,198,3,0,3,0,0,0
1115453,26,10,1987,11,"female",885,75,21,1,0,1,0,0,0
1115464,108,12,1905,7,"male",361,792,723,20,83,18,68,2,15
1115474,65,8,1948,2,NA,2018,32,6,1,0,1,0,0,0
1115475,20,28,1993,5,"female",422,232,159,55,6,55,5,0,1
1115479,32,20,1981,10,"male",98,7,6,6,2,6,2,0,0
1115486,14,26,1999,11,"male",242,238,108,53,17,53,8,0,9
1115523,25,8,1988,4,"male",1654,911,684,1,3,0,2,1,1
1115539,51,21,1962,5,"male",1735,154,73,88,8,88,3,0,5
1115557,57,27,1956,7,"male",1141,135,54,189,119,108,68,81,51
1115569,49,5,1964,5,"female",164,59,49,6,5,1,4,5,1
1115576,13,19,2000,2,"male",224,121,100,6,2,6,1,0,1
1115582,28,1,1985,9,"male",588,2,2,0,0,0,0,0,0
1115585,17,5,1996,1,"male",245,190,172,0,2,0,2,0,0
1115603,34,24,1979,9,"male",522,13,7,17,2,17,2,0,0
1115632,25,13,1988,9,"male",100,87,64,69,87,69,50,0,37
1115635,43,4,1970,9,"female",227,0,0,0,0,0,0,0,0
1115648,19,2,1994,9,"male",272,67,39,2,76,0,10,2,66
1115666,95,29,1918,3,"female",1760,208,94,59,19,21,13,38,6
1115667,14,9,1999,4,"male",193,50,37,28,24,22,5,6,19
1115676,27,8,1986,4,"male",51,6,4,3,0,3,0,0,0
1115690,74,25,1939,6,"female",1655,48,28,92,278,0,13,92,265
1115724,31,13,1982,7,"male",85,8,3,0,1,0,1,0,0
1115742,23,1,1990,8,"male",144,27,25,0,3,0,3,0,0
1115757,24,19,1989,9,"female",680,209,176,289,279,177,212,112,67
1115763,19,3,1994,8,"male",634,89,45,60,5,60,4,0,1
1115778,22,12,1991,8,"female",456,77,37,7,10,7,3,0,7
1115811,38,16,1975,8,"male",506,1,0,0,0,0,0,0,0
1115812,27,8,1986,2,"male",145,12,7,327,14,327,4,0,10
1115847,103,23,1910,1,"male",726,60,32,1,0,1,0,0,0
1115903,42,25,1971,4,"male",768,216,144,4,2,4,0,0,2
1115934,15,1,1998,1,"male",537,104,75,14,3,14,3,0,0
1115978,43,14,1970,7,"male",91,19,18,8,0,8,0,0,0
1115980,26,27,1987,5,"female",492,360,235,136,225,18,92,118,133
1115983,15,13,1998,4,"male",515,108,78,2,0,0,0,2,0
1115984,15,19,1998,7,"male",49,1,1,1,1,1,1,0,0
1115997,68,11,1945,3,"female",1495,94,62,108,80,0,27,108,53
1116028,83,8,1930,1,"male",363,2,2,0,0,0,0,0,0
1116034,63,18,1950,2,"female",1327,182,109,252,263,252,135,0,128
1116046,14,7,1999,1,"male",264,147,92,0,0,0,0,0,0
1116089,27,14,1986,7,"male",278,57,39,22,3,10,3,12,0
1116101,104,2,1909,1,"male",1757,678,189,101,32,101,17,0,15
1116106,38,22,1975,1,"female",344,69,49,112,53,112,53,0,0
1116126,21,11,1992,9,"male",376,126,54,0,0,0,0,0,0
1116140,108,10,1905,8,"male",1604,161,103,9,4,9,4,0,0
1116167,35,21,1978,11,"female",193,1,1,0,0,0,0,0,0
1116169,50,4,1963,8,"female",1502,108,15,90,7,90,3,0,4
1116192,16,17,1997,1,"male",584,35,16,7,39,0,12,7,27
1116208,48,1,1965,3,"male",767,1,1,0,0,0,0,0,0
1116226,19,7,1994,2,"female",418,1872,831,218,815,99,538,119,277
1116232,35,1,1978,10,"male",108,521,438,1545,1203,1400,664,145,539
1116252,43,15,1970,3,"male",650,68,38,78,42,38,30,40,12
1116278,69,26,1944,11,"female",1754,101,43,67,40,67,25,0,15
1116332,26,28,1987,8,"male",161,106,93,29,3,29,3,0,0
1116336,34,2,1979,1,"male",430,173,97,9,9,9,6,0,3
1116339,21,19,1992,3,"female",636,97,66,219,410,214,278,5,132
1116419,103,11,1910,8,"female",727,191,86,0,2,0,0,0,2
1116427,24,10,1989,4,"male",849,178,61,17,22,5,6,12,16
1116429,89,7,1924,6,"female",1558,81,45,2,2,0,0,2,2
1116440,51,22,1962,7,"male",656,11,7,33,19,0,8,33,11
1116472,30,21,1983,2,"male",214,52,49,0,0,0,0,0,0
1116481,19,5,1994,3,"male",11,59,55,1,2,1,0,0,2
1116495,27,8,1986,11,"male",315,114,80,0,0,0,0,0,0
1116506,13,7,2000,3,"male",174,77,71,70,0,6,0,64,0
1116522,17,22,1996,12,"male",349,4,3,50,15,46,5,4,10
1116528,25,18,1988,3,"female",523,281,187,179,594,49,142,130,452
1116531,18,12,1995,10,"female",319,147,103,133,17,133,16,0,1
1116534,49,3,1964,9,"male",525,67,46,325,188,4,48,321,140
1116538,19,21,1994,10,"female",434,68,54,26,21,25,12,1,9
1116542,108,5,1905,1,"female",692,89,33,9,3,9,3,0,0
1116556,25,22,1988,3,"male",256,197,178,1,3,1,3,0,0
1116597,26,3,1987,1,"male",400,45,24,5,5,5,5,0,0
1116600,31,16,1982,7,"male",281,95,30,2,14,2,6,0,8
1116605,26,17,1987,8,"female",499,1092,396,33,139,15,25,18,114
1116636,36,30,1977,5,"female",142,106,24,100,51,100,32,0,19
1116639,17,14,1996,11,"male",812,177,45,0,0,0,0,0,0
1116666,26,12,1987,12,"male",295,89,84,68,15,68,10,0,5
1116687,93,23,1920,11,"female",1321,344,149,837,652,835,387,2,265
1116714,21,16,1992,2,"male",544,302,241,52,49,7,20,45,29
1116720,13,1,2000,1,"female",196,48,19,0,0,0,0,0,0
1116742,20,13,1993,4,"male",30,132,130,25,14,9,11,16,3
1116749,28,18,1985,5,"male",987,39,12,0,0,0,0,0,0
1116757,16,17,1997,11,"male",83,2,2,0,0,0,0,0,0
1116762,17,13,1996,6,"female",1181,323,73,19,8,3,0,16,8
1116772,27,26,1986,9,"male",49,17,13,3,12,3,8,0,4
1116812,26,19,1987,7,"male",21,5,5,0,0,0,0,0,0
1116820,65,5,1948,2,"female",1461,10,5,0,0,0,0,0,0
1116856,65,29,1948,2,"female",1568,33,9,7,4,7,4,0,0
1116881,16,31,1997,12,"male",461,177,117,43,0,27,0,16,0
1116883,25,15,1988,9,"male",260,133,60,0,9,0,6,0,3
1116893,24,1,1989,1,"male",43,91,88,33,7,33,6,0,1
1116902,108,14,1905,11,"male",904,432,252,5,3,5,3,0,0
1116921,15,10,1998,10,"male",334,586,435,212,158,197,86,15,72
1116934,28,11,1985,6,"male",121,0,0,0,0,0,0,0,0
1116937,15,21,1998,8,"female",152,106,81,1,0,1,0,0,0
1116950,45,11,1968,6,"male",571,21,6,96,49,34,27,62,22
1116991,71,11,1942,4,"female",1145,68,30,66,30,65,15,1,15
1116995,23,22,1990,5,"male",542,477,327,76,4,76,4,0,0
1117010,25,15,1988,8,"male",78,26,11,4,0,4,0,0,0
1117038,13,9,2000,6,"female",47,17,14,83,8,83,8,0,0
1117048,45,4,1968,8,"female",216,87,51,1532,164,1532,116,0,48
1117053,69,28,1944,3,"female",260,5,4,1,3,0,2,1,1
1117069,29,22,1984,4,"female",535,123,87,0,1,0,1,0,0
1117075,17,7,1996,1,"male",134,63,60,0,0,0,0,0,0
1117090,32,10,1981,12,"male",1580,473,305,2,0,2,0,0,0
1117102,27,22,1986,4,"male",461,15,7,0,0,0,0,0,0
1117103,23,29,1990,1,"female",272,164,40,22,1,22,1,0,0
1117157,23,21,1990,8,"male",130,50,23,3,3,3,3,0,0
1117158,53,7,1960,2,"male",305,28,23,27,5,4,0,23,5
1117183,23,11,1990,3,"male",242,58,40,3,28,3,11,0,17
1117187,15,29,1998,11,"female",638,133,77,262,208,255,189,7,19
1117216,21,14,1992,7,"male",430,282,239,29,4,29,4,0,0
1117231,27,10,1986,7,"male",362,33,31,2,36,1,27,1,9
1117233,14,11,1999,1,"male",167,27,17,0,1,0,0,0,1
1117242,46,17,1967,7,"female",416,27,18,224,10,224,10,0,0
1117253,84,1,1929,5,"female",58,16,7,0,0,0,0,0,0
1117273,29,6,1984,1,"female",259,61,45,371,329,51,60,320,269
1117284,27,1,1986,1,"male",795,33,14,0,8,0,2,0,6
1117286,19,20,1994,12,"male",213,23,16,0,0,0,0,0,0
1117328,60,18,1953,11,"female",1508,142,91,654,391,654,346,0,45
1117340,34,15,1979,6,"female",503,74,40,9,0,9,0,0,0
1117343,32,21,1981,10,"male",649,28,14,15,11,15,4,0,7
1117388,19,11,1994,5,"female",147,1,1,43,156,0,13,43,143
1117404,64,23,1949,12,"male",65,45,26,6,9,0,4,6,5
1117405,100,25,1913,3,"male",216,336,247,1,3,1,3,0,0
1117413,36,6,1977,7,"male",137,6,5,0,0,0,0,0,0
1117415,108,26,1905,3,"male",319,258,200,23,85,23,61,0,24
1117433,90,9,1923,10,"male",53,51,51,75,5,0,3,75,2
1117499,28,6,1985,2,"male",854,88,57,29,61,29,54,0,7
1117501,14,13,1999,1,"male",425,245,177,5,0,5,0,0,0
1117520,21,15,1992,1,"female",597,315,30,52,60,52,54,0,6
1117556,45,28,1968,5,"male",160,22,17,0,0,0,0,0,0
1117558,19,2,1994,9,"male",156,298,278,138,28,138,27,0,1
1117567,28,3,1985,11,"male",421,540,338,4,95,4,50,0,45
1117571,16,23,1997,6,"female",170,44,13,383,78,29,28,354,50
1117580,23,29,1990,1,"male",454,370,87,619,1,619,1,0,0
1117587,51,28,1962,5,"female",996,143,59,28,12,11,1,17,11
1117604,19,21,1994,2,"male",385,75,49,7,3,0,1,7,2
1117607,40,3,1973,1,"male",1741,53,12,6,6,5,4,1,2
1117614,15,27,1998,3,"female",358,214,79,3,10,0,0,3,10
1117628,23,23,1990,1,"male",377,17,16,2,3,0,0,2,3
1117639,26,18,1987,4,"male",71,0,0,0,0,0,0,0,0
1117645,63,5,1950,3,"female",1235,57,27,51,0,51,0,0,0
1117657,24,2,1989,7,"male",526,362,306,0,4,0,0,0,4
1117660,27,5,1986,10,"male",33,70,42,8,74,2,32,6,42
1117710,41,6,1972,10,"male",266,100,84,220,12,220,10,0,2
1117713,25,23,1988,3,"male",147,132,60,51,181,51,177,0,4
1117735,22,3,1991,2,"male",167,14,8,0,0,0,0,0,0
1117739,41,27,1972,3,"male",143,40,7,0,0,0,0,0,0
1117742,25,12,1988,5,"female",105,11,5,3,2,3,2,0,0
1117743,33,28,1980,10,"male",38,13,13,0,0,0,0,0,0
1117776,52,24,1961,7,"male",957,99,33,1,22,1,21,0,1
1117780,28,7,1985,1,"male",53,8,5,1,19,1,9,0,10
1117819,14,26,1999,9,"male",89,60,35,11,2,11,2,0,0
1117830,42,22,1971,11,NA,1059,19,10,402,45,402,13,0,32
1117841,22,7,1991,4,"male",37,22,12,2,2,2,2,0,0
1117883,39,20,1974,5,"male",476,15,5,25,0,22,0,3,0
1117905,23,2,1990,2,"male",364,89,62,1,15,1,9,0,6
1117910,24,12,1989,12,"female",151,149,123,73,87,73,76,0,11
1117961,18,6,1995,12,"male",456,183,124,9,0,9,0,0,0
1117993,25,26,1988,2,"male",707,521,405,69,232,69,163,0,69
1117998,19,23,1994,11,"male",445,111,54,26,3,3,2,23,1
1118007,83,6,1930,6,"male",488,58,32,5,12,4,5,1,7
1118053,18,6,1995,7,"female",437,380,262,1207,413,1071,224,136,189
1118060,35,3,1978,7,"female",1579,186,114,149,94,149,48,0,46
1118099,68,4,1945,11,"female",1744,523,269,53,54,49,12,4,42
1118110,19,17,1994,8,"female",236,62,46,3,2,0,2,3,0
1118121,22,16,1991,8,"male",534,401,196,24,3,0,2,24,1
1118140,35,9,1978,10,"female",271,27,16,0,0,0,0,0,0
1118148,72,28,1941,2,"female",1690,33,18,1971,32,1971,23,0,9
1118160,38,3,1975,9,"female",87,47,37,150,53,147,29,3,24
1118183,20,10,1993,8,"female",519,546,180,1056,633,1056,404,0,229
1118186,58,3,1955,1,"male",1548,44,16,0,8,0,1,0,7
1118199,56,19,1957,4,"female",1231,274,114,728,791,723,516,5,275
1118204,27,14,1986,3,"male",623,143,54,0,0,0,0,0,0
1118215,51,28,1962,3,"female",527,196,145,1138,653,1138,615,0,38
1118257,88,1,1925,8,"male",295,352,310,1,0,0,0,1,0
1118259,21,14,1992,2,"female",177,456,344,678,768,678,563,0,205
1118297,51,11,1962,7,"male",254,440,199,620,1289,620,863,0,426
1118320,20,25,1993,10,"female",243,9,4,0,0,0,0,0,0
1118329,18,14,1995,7,"male",226,230,164,25,0,0,0,25,0
1118338,59,22,1954,10,"male",248,138,55,97,74,3,22,94,52
1118341,17,17,1996,5,"male",279,153,118,6,9,2,1,4,8
1118344,37,9,1976,10,"male",729,26,14,239,3,239,2,0,1
1118346,101,21,1912,11,"male",1,20,19,0,0,0,0,0,0
1118382,28,28,1985,11,"female",445,14,2,7,0,7,0,0,0
1118383,25,9,1988,2,"female",481,54,30,143,58,0,21,143,37
1118386,14,24,1999,4,"male",432,121,96,15,6,0,0,15,6
1118408,21,2,1992,10,"male",332,138,68,2,1,2,1,0,0
1118423,44,12,1969,1,"male",173,40,31,7,0,7,0,0,0
1118432,101,29,1912,1,"male",1400,197,58,91,197,17,117,74,80
1118457,19,19,1994,7,"female",347,113,85,12,40,0,8,12,32
1118462,24,4,1989,8,"male",529,266,164,2,14,2,11,0,3
1118487,18,22,1995,9,"female",380,607,198,437,838,419,404,18,434
1118510,57,24,1956,6,"female",248,91,36,7,14,0,2,7,12
1118555,66,14,1947,10,"female",1581,69,39,14,4,1,1,13,3
1118560,21,5,1992,10,"male",403,96,63,0,1,0,0,0,1
1118574,15,4,1998,9,"male",268,637,245,35,4,3,0,32,4
1118598,15,14,1998,2,"female",647,373,157,23,32,5,7,18,25
1118615,27,4,1986,8,"female",337,118,107,14,1,14,1,0,0
1118635,56,6,1957,7,"male",248,100,88,28,21,0,5,28,16
1118727,26,4,1987,7,"male",440,49,11,0,0,0,0,0,0
1118740,16,5,1997,1,"female",612,727,379,148,753,148,662,0,91
1118743,19,4,1994,3,"male",610,1192,911,11,37,9,27,2,10
1118802,32,25,1981,6,"female",135,88,49,84,50,84,36,0,14
1118808,31,6,1982,1,"male",50,10,9,0,0,0,0,0,0
1118830,15,12,1998,2,"female",280,306,113,0,0,0,0,0,0
1118841,63,25,1950,8,"female",1759,44,15,13,38,13,19,0,19
1118847,15,10,1998,2,"male",209,5,2,1,0,0,0,1,0
1118858,23,21,1990,1,"female",151,138,92,102,78,102,53,0,25
1118915,48,6,1965,8,"male",937,27,15,5,5,0,4,5,1
1118926,18,12,1995,9,"female",501,202,79,3172,809,394,267,2778,542
1118931,20,1,1993,11,"male",515,27,18,28,6,0,1,28,5
1118933,20,12,1993,10,"male",291,43,35,0,1,0,1,0,0
1118954,16,25,1997,10,"male",216,229,114,113,63,10,11,103,52
1119005,45,10,1968,8,"male",27,0,0,4,0,3,0,1,0
1119008,34,6,1979,6,"female",87,23,13,18,0,18,0,0,0
1119036,34,19,1979,9,"female",193,28,22,8,5,0,3,8,2
1119040,66,31,1947,10,"male",650,10,5,0,1,0,0,0,1
1119055,26,15,1987,8,"female",566,678,501,56,100,56,80,0,20
1119099,48,24,1965,7,"female",1319,160,118,99,72,89,64,10,8
1119104,25,4,1988,12,"female",292,91,73,8,1,8,1,0,0
1119113,19,2,1994,11,"female",321,342,260,0,9,0,1,0,8
1119119,20,30,1993,5,"female",557,101,28,4,0,4,0,0,0
1119149,17,25,1996,10,"male",505,50,25,0,6,0,5,0,1
1119152,33,24,1980,9,"female",282,153,84,16,30,0,5,16,25
1119180,49,12,1964,2,"male",1252,85,39,0,0,0,0,0,0
1119248,18,28,1995,2,"female",316,256,194,0,22,0,14,0,8
1119253,16,9,1997,12,"female",773,688,615,97,108,10,30,87,78
1119262,23,2,1990,8,"male",187,126,118,5,11,5,7,0,4
1119263,21,30,1992,12,"male",259,88,72,6,1,5,1,1,0
1119299,59,9,1954,4,"female",933,63,38,0,7,0,7,0,0
1119319,27,13,1986,11,"male",350,3,3,4,0,4,0,0,0
1119325,16,16,1997,10,"male",220,4,0,0,0,0,0,0,0
1119343,57,13,1956,3,"female",1553,427,272,357,935,172,519,185,416
1119398,28,1,1985,1,"male",307,162,116,67,89,67,66,0,23
1119409,18,3,1995,10,"female",282,43,22,1524,1284,0,81,1524,1203
1119474,54,30,1959,10,"male",1843,104,46,15,43,15,31,0,12
1119486,19,18,1994,6,"male",295,368,93,88,5,0,0,88,5
1119525,20,1,1993,9,"male",132,125,102,23,33,16,16,7,17
1119539,28,7,1985,9,"female",203,7,6,24,5,0,1,24,4
1119563,27,2,1986,7,"male",74,107,27,41,36,41,20,0,16
1119588,51,8,1962,10,"male",453,125,86,0,0,0,0,0,0
1119595,17,18,1996,9,"female",568,1037,270,80,74,80,54,0,20
1119611,28,10,1985,12,"male",251,309,287,21,41,21,27,0,14
1119612,54,16,1959,8,"male",502,2,2,0,0,0,0,0,0
1119618,20,2,1993,2,"male",401,70,47,1,0,0,0,1,0
1119644,51,17,1962,10,"male",83,238,178,8,78,2,36,6,42
1119690,23,4,1990,3,"male",553,78,57,0,0,0,0,0,0
1119691,29,12,1984,3,"male",552,67,22,5,2,5,1,0,1
1119781,17,10,1996,10,"male",609,318,237,25,10,25,3,0,7
1119805,49,11,1964,8,"male",1944,124,44,7,30,7,15,0,15
1119837,25,22,1988,11,"female",257,215,151,396,856,396,719,0,137
1119866,21,1,1992,2,"male",123,108,31,1,14,1,9,0,5
1119877,15,7,1998,7,"male",27,47,15,10,9,0,3,10,6
1119895,47,22,1966,9,"female",405,79,43,255,17,255,11,0,6
1119906,15,21,1998,1,"male",384,9,3,0,0,0,0,0,0
1119911,21,18,1992,3,"female",440,1244,421,40,736,24,97,16,639
1119920,19,10,1994,10,"male",250,1418,1002,948,625,803,366,145,259
1119921,25,1,1988,1,"female",222,8,6,0,0,0,0,0,0
1119925,21,30,1992,8,"female",232,46,43,112,13,112,4,0,9
1119928,28,20,1985,5,"female",379,2,2,3,0,3,0,0,0
1119971,19,24,1994,10,"male",630,110,86,0,0,0,0,0,0
1119986,66,10,1947,2,"female",1565,94,25,0,3,0,3,0,0
1120087,59,5,1954,6,"female",238,54,30,3,19,0,10,3,9
1120096,16,12,1997,5,"male",10,14,11,0,1,0,1,0,0
1120119,19,2,1994,11,"female",842,102,41,65,32,9,17,56,15
1120123,28,30,1985,9,"male",346,99,70,3,26,3,10,0,16
1120146,29,6,1984,6,"female",496,77,33,12,6,12,6,0,0
1120157,17,26,1996,9,"male",347,233,95,5,3,5,3,0,0
1120173,44,26,1969,12,"female",1730,337,103,145,26,145,17,0,9
1120181,20,21,1993,2,"female",480,104,67,96,111,96,93,0,18
1120205,45,9,1968,7,"male",559,0,0,0,0,0,0,0,0
1120246,26,16,1987,7,"male",612,392,208,6,557,6,447,0,110
1120261,96,18,1917,10,"female",1567,71,14,0,4,0,4,0,0
1120290,20,1,1993,7,"male",504,105,44,13,5,13,4,0,1
1120310,27,2,1986,12,"female",468,32,29,2,7,2,4,0,3
1120338,65,18,1948,6,"female",1397,31,14,3,1,3,1,0,0
1120341,84,17,1929,6,"male",1920,76,21,15,12,10,9,5,3
1120365,71,14,1942,7,"male",1057,8,4,0,0,0,0,0,0
1120368,28,24,1985,8,"male",187,90,54,4,13,4,10,0,3
1120395,17,29,1996,9,"female",325,25,14,0,0,0,0,0,0
1120412,49,9,1964,12,"male",813,6,4,0,0,0,0,0,0
1120443,59,28,1954,5,"female",2305,135,65,253,421,190,185,63,236
1120465,28,23,1985,2,"female",798,77,37,8,23,7,2,1,21
1120466,68,20,1945,4,"female",1107,18,9,2,4,2,1,0,3
1120469,51,27,1962,2,"female",680,151,120,305,161,253,47,52,114
1120480,18,24,1995,1,"male",722,616,555,5,9,2,7,3,2
1120483,63,19,1950,11,"male",674,201,126,155,159,0,97,155,62
1120500,15,17,1998,3,"male",701,239,200,3,1,0,0,3,1
1120509,49,10,1964,2,"female",298,2,1,61,0,0,0,61,0
1120517,21,11,1992,11,"male",168,122,77,107,117,33,64,74,53
1120528,16,17,1997,8,"female",647,174,75,2,0,2,0,0,0
1120547,57,9,1956,11,"male",1167,1126,948,163,11,151,6,12,5
1120548,28,21,1985,7,"male",206,151,143,395,28,113,7,282,21
1120558,21,18,1992,9,"male",379,85,28,0,0,0,0,0,0
1120592,61,26,1952,9,"male",1713,84,29,104,26,25,21,79,5
1120603,31,25,1982,1,"male",401,64,47,17,0,17,0,0,0
1120606,19,29,1994,9,"male",589,113,40,6,8,5,4,1,4
1120613,19,12,1994,1,"female",188,1,1,1427,25,1426,5,1,20
1120619,19,31,1994,7,"male",316,143,55,0,0,0,0,0,0
1120627,25,21,1988,9,"male",577,624,459,1438,1344,797,776,641,568
1120637,37,3,1976,9,"female",26,1,0,94,26,0,0,94,26
1120647,16,13,1997,1,"male",389,281,210,12,9,12,6,0,3
1120665,58,13,1955,12,"male",1559,286,167,3,18,3,18,0,0
1120690,16,2,1997,12,"male",313,102,49,558,22,558,17,0,5
1120698,108,24,1905,6,"female",1844,295,159,117,54,6,13,111,41
1120708,50,26,1963,12,"male",599,109,40,11,1,0,0,11,1
1120713,40,12,1973,9,"male",616,2,2,24,0,2,0,22,0
1120727,67,15,1946,8,"female",285,3,1,0,0,0,0,0,0
1120736,18,4,1995,6,"female",127,153,90,61,42,61,24,0,18
1120768,20,15,1993,3,"male",493,60,52,70,28,62,16,8,12
1120774,28,14,1985,8,"male",1193,2416,745,1425,10257,723,4306,702,5951
1120805,37,1,1976,9,"female",162,9,8,1016,18,1016,13,0,5
1120829,30,3,1983,12,"male",536,24,8,11,6,11,3,0,3
1120830,23,25,1990,9,"female",155,135,117,13,0,13,0,0,0
1120838,22,10,1991,12,"male",50,35,25,13,45,13,42,0,3
1120846,111,1,1902,2,"male",3139,372,40,11,21,2,13,9,8
1120937,23,12,1990,2,"male",351,29,28,1,0,0,0,1,0
1120948,55,30,1958,8,"female",1539,92,31,113,26,0,6,113,20
1120963,50,17,1963,1,"male",76,76,36,8,8,0,4,8,4
1120981,46,4,1967,4,"male",358,86,17,1,2,1,2,0,0
1120987,28,16,1985,9,"female",607,10,6,0,0,0,0,0,0
1120994,59,24,1954,2,"female",1083,138,107,245,230,0,47,245,183
1121006,23,24,1990,7,"female",368,22,13,0,0,0,0,0,0
1121042,27,1,1986,7,"male",269,241,149,97,60,97,34,0,26
1121063,19,16,1994,1,"male",617,120,95,7,0,0,0,7,0
1121072,31,18,1982,9,"male",135,113,62,3,8,3,8,0,0
1121075,18,4,1995,11,"male",472,203,78,12,13,12,9,0,4
1121078,66,1,1947,11,"male",978,13,9,2,2,0,1,2,1
1121087,20,22,1993,12,"male",659,307,133,0,2,0,0,0,2
1121106,28,25,1985,10,"male",568,255,238,11,8,11,7,0,1
1121123,35,21,1978,3,"male",1148,317,121,2,3,2,3,0,0
1121152,59,4,1954,4,"female",744,236,56,91,136,82,102,9,34
1121159,20,29,1993,7,"female",1089,2392,1408,5339,4964,4119,2366,1220,2598
1121180,14,8,1999,6,"female",360,445,146,141,273,69,141,72,132
1121196,56,25,1957,10,"female",1422,284,198,307,223,294,166,13,57
1121198,14,28,1999,8,"male",249,447,276,233,71,2,21,231,50
1121199,15,16,1998,5,"female",354,118,87,0,13,0,9,0,4
1121216,18,5,1995,5,"female",373,2302,510,398,403,398,324,0,79
1121256,53,16,1960,3,"male",475,87,42,88,125,88,78,0,47
1121296,14,11,1999,11,"male",24,73,71,28,23,28,15,0,8
1121309,103,3,1910,8,"male",1282,312,125,2,2,2,2,0,0
1121344,23,17,1990,8,"male",359,1,0,0,0,0,0,0,0
1121357,35,29,1978,11,"male",231,177,121,415,178,355,127,60,51
1121396,18,8,1995,3,"male",369,238,50,2,8,2,5,0,3
1121397,19,7,1994,9,"female",332,135,89,51,34,33,16,18,18
1121432,51,16,1962,4,"female",1604,103,31,38,20,0,7,38,13
1121475,22,23,1991,10,"male",13,39,33,129,4,59,0,70,4
1121482,17,20,1996,6,"male",303,171,124,12,1,12,0,0,1
1121500,28,23,1985,5,"male",645,958,630,568,423,74,405,494,18
1121503,16,5,1997,9,"male",215,341,237,2,9,2,4,0,5
1121515,57,13,1956,9,"female",1730,135,31,266,100,231,59,35,41
1121518,33,22,1980,1,"female",918,58,18,117,107,83,51,34,56
1121526,49,2,1964,2,"male",339,111,89,8,14,8,8,0,6
1121564,46,9,1967,8,"male",135,24,18,10,27,10,13,0,14
1121598,25,11,1988,5,"female",143,50,46,175,213,175,166,0,47
1121609,18,27,1995,6,"male",370,225,162,125,116,125,99,0,17
1121640,15,1,1998,1,"male",426,171,123,16,10,0,1,16,9
1121655,54,5,1959,3,"female",1519,192,158,86,366,9,92,77,274
1121688,63,24,1950,10,"female",252,1,1,1,0,0,0,1,0
1121691,53,23,1960,1,"female",590,339,280,1,11,0,3,1,8
1121708,16,2,1997,5,"male",85,127,72,22,0,22,0,0,0
1121772,25,21,1988,9,"female",15,15,7,22,20,22,20,0,0
1121790,45,18,1968,8,"female",554,248,149,82,45,40,17,42,28
1121808,66,31,1947,3,"female",62,58,56,25,8,25,8,0,0
1121810,37,4,1976,3,"female",353,6,6,0,0,0,0,0,0
1121820,71,11,1942,2,"female",1364,903,25,20,2,16,1,4,1
1121825,17,14,1996,6,"female",797,161,80,29,47,0,20,29,27
1121838,57,1,1956,12,"female",235,169,84,108,61,108,39,0,22
1121851,31,12,1982,5,"male",604,97,58,36,6,36,6,0,0
1121878,14,20,1999,6,"male",496,474,325,39,36,39,34,0,2
1121884,35,27,1978,5,"female",968,98,65,157,124,153,87,4,37
1121890,33,16,1980,11,"male",739,54,12,141,69,140,64,1,5
1121892,18,4,1995,7,"female",74,39,14,6,0,6,0,0,0
1121913,18,8,1995,8,"male",3,5,5,0,0,0,0,0,0
1121921,17,16,1996,9,"female",278,1915,839,346,4788,195,3351,151,1437
1121925,23,10,1990,1,"male",790,143,44,1,0,0,0,1,0
1121953,49,28,1964,1,"female",523,27,18,8,0,8,0,0,0
1121992,18,20,1995,5,"male",524,146,120,114,5,5,3,109,2
1121993,32,22,1981,10,"female",339,7,5,0,0,0,0,0,0
1121994,17,19,1996,8,"female",358,55,37,97,0,97,0,0,0
1122008,36,15,1977,2,"female",550,27,7,91,19,47,7,44,12
1122078,19,17,1994,10,"female",1174,931,463,303,360,279,306,24,54
1122121,20,6,1993,6,"female",251,506,116,7,42,7,41,0,1
1122135,31,15,1982,4,"female",15,13,5,5,0,5,0,0,0
1122145,25,15,1988,2,"male",403,95,57,0,0,0,0,0,0
1122149,17,1,1996,4,"female",294,408,109,3750,2938,3106,2003,644,935
1122183,30,21,1983,9,"male",498,8,5,0,0,0,0,0,0
1122186,42,6,1971,3,"female",573,353,211,26,13,0,3,26,10
1122190,25,6,1988,4,"male",133,42,41,7,0,7,0,0,0
1122202,38,24,1975,5,"female",413,234,130,86,40,74,18,12,22
1122213,24,18,1989,1,"male",342,83,27,161,55,159,27,2,28
1122225,16,2,1997,1,"male",53,3,3,0,0,0,0,0,0
1122265,27,17,1986,11,"male",224,3,1,0,0,0,0,0,0
1122271,18,10,1995,12,"male",281,104,95,3,42,3,39,0,3
1122353,88,7,1925,4,"female",2077,209,67,106,11,0,6,106,5
1122361,17,14,1996,9,"male",27,127,78,12,20,12,18,0,2
1122391,20,23,1993,7,"male",706,814,694,74,33,74,26,0,7
1122412,16,22,1997,9,"female",43,850,479,2215,7040,1961,4295,254,2745
1122413,24,12,1989,3,"male",191,11,8,7,5,4,3,3,2
1122415,20,14,1993,6,"male",378,388,302,86,47,86,42,0,5
1122444,24,16,1989,12,"male",409,198,113,18,14,18,6,0,8
1122458,24,2,1989,7,"male",315,124,114,2,0,2,0,0,0
1122467,70,1,1943,6,"female",1764,38,10,11,9,11,7,0,2
1122492,29,25,1984,5,"male",299,25,18,0,1,0,0,0,1
1122523,15,29,1998,7,"male",377,359,322,27,68,7,54,20,14
1122577,26,4,1987,2,"female",489,71,55,0,0,0,0,0,0
1122592,72,17,1941,3,"male",968,280,203,2,9,2,9,0,0
1122598,65,17,1948,6,"female",1139,21,15,3,8,2,6,1,2
1122621,21,13,1992,9,"female",156,154,88,1,3,1,1,0,2
1122643,29,3,1984,10,"male",701,19,6,8,29,3,24,5,5
1122644,21,15,1992,2,"male",322,132,79,372,257,229,56,143,201
1122645,45,24,1968,6,"female",346,37,25,0,0,0,0,0,0
1122673,36,6,1977,10,"male",726,70,54,7,26,7,13,0,13
1122704,31,10,1982,12,"female",464,65,54,19,15,19,14,0,1
1122721,16,17,1997,8,"male",455,328,248,0,2,0,0,0,2
1122751,53,13,1960,5,"female",265,94,68,574,334,0,21,574,313
1122752,14,9,1999,9,"female",58,24,8,0,0,0,0,0,0
1122778,14,20,1999,9,"female",187,58,49,0,5,0,0,0,5
1122797,56,2,1957,11,"female",1161,22,15,95,35,0,10,95,25
1122815,24,9,1989,3,"female",726,14,6,68,30,0,15,68,15
1122834,25,1,1988,1,"male",195,74,52,21,0,21,0,0,0
1122897,23,5,1990,11,"male",456,100,37,0,0,0,0,0,0
1122944,73,24,1940,11,"male",1751,53,9,0,3,0,2,0,1
1122991,32,27,1981,9,"male",528,85,36,41,154,41,137,0,17
1123042,26,20,1987,6,"male",417,179,103,1115,168,1115,141,0,27
1123044,55,26,1958,8,"male",101,38,34,7,4,7,0,0,4
1123046,25,12,1988,9,"male",1442,49,15,16,29,6,18,10,11
1123052,15,28,1998,9,"female",220,181,66,2241,398,1547,125,694,273
1123059,21,4,1992,5,"female",409,64,53,35,20,0,4,35,16
1123088,51,16,1962,8,"male",1446,49,25,39,49,0,24,39,25
1123097,30,27,1983,9,"female",775,649,362,687,557,676,422,11,135
1123130,41,22,1972,9,"male",466,311,303,41,8,11,5,30,3
1123141,72,20,1941,1,"male",593,63,34,18,87,0,41,18,46
1123152,26,28,1987,5,"female",291,80,42,693,1021,693,581,0,440
1123156,37,5,1976,10,"male",141,24,17,5,1,5,1,0,0
1123167,15,29,1998,10,"male",174,324,290,0,19,0,15,0,4
1123175,15,12,1998,10,"male",487,60,47,3,2,3,1,0,1
1123182,61,17,1952,2,"female",1474,121,57,161,225,119,84,42,141
1123184,66,27,1947,12,"female",79,28,9,18,8,18,6,0,2
1123200,16,13,1997,1,"female",468,683,585,0,0,0,0,0,0
1123219,18,24,1995,7,"male",101,32,12,4,0,4,0,0,0
1123240,29,26,1984,1,"female",366,105,37,8,1,0,1,8,0
1123263,47,16,1966,5,"male",420,42,9,11,0,11,0,0,0
1123271,51,30,1962,6,"female",355,45,29,94,36,94,32,0,4
1123274,64,1,1949,1,"female",1569,579,324,1214,1427,226,558,988,869
1123335,35,18,1978,10,"male",557,77,55,136,185,136,61,0,124
1123347,27,6,1986,4,"female",485,102,82,4,11,4,7,0,4
1123361,18,19,1995,7,"male",384,66,40,0,1,0,1,0,0
1123399,45,20,1968,11,"male",233,25,18,173,18,121,14,52,4
1123415,20,17,1993,11,"male",336,68,47,6,25,6,17,0,8
1123441,28,28,1985,7,"male",505,151,109,43,79,34,62,9,17
1123472,16,25,1997,3,"male",368,144,52,64,6,64,4,0,2
1123476,19,28,1994,1,"male",383,84,48,3,15,3,6,0,9
1123485,17,1,1996,1,"female",480,33,24,106,242,0,63,106,179
1123499,25,6,1988,4,"male",372,694,282,191,292,191,230,0,62
1123532,28,16,1985,3,"male",394,29,8,0,0,0,0,0,0
1123611,28,10,1985,5,"male",213,1,1,0,0,0,0,0,0
1123633,20,17,1993,1,"male",15,94,59,70,38,35,8,35,30
1123663,24,28,1989,8,"male",173,57,44,25,25,25,14,0,11
1123686,23,19,1990,12,"male",565,180,113,1,0,1,0,0,0
1123689,20,27,1993,12,"male",87,36,24,0,0,0,0,0,0
1123706,61,16,1952,7,"male",1671,19,6,0,0,0,0,0,0
1123719,21,30,1992,1,"female",489,200,23,17,5,17,3,0,2
1123732,108,13,1905,8,"male",530,1105,924,31,13,28,10,3,3
1123739,25,1,1988,2,"male",42,36,33,6,2,6,2,0,0
1123763,43,18,1970,10,"male",550,7,4,0,0,0,0,0,0
1123772,49,8,1964,6,"female",380,22,12,2,0,2,0,0,0
1123778,26,26,1987,12,"male",889,205,140,0,1,0,1,0,0
1123797,55,1,1958,5,"female",278,123,113,91,66,74,34,17,32
1123806,102,11,1911,11,"male",497,116,92,13,1,0,1,13,0
1123815,40,5,1973,1,"male",242,51,34,0,0,0,0,0,0
1123824,108,7,1905,7,"male",1630,327,262,22,11,22,9,0,2
1123827,48,24,1965,1,"male",825,88,44,28,13,11,2,17,11
1123861,55,20,1958,1,"female",890,28,15,158,11,81,2,77,9
1123862,23,5,1990,4,"male",390,198,136,5,17,3,2,2,15
1123901,25,1,1988,1,"male",250,12,10,41,2,41,2,0,0
1123902,22,20,1991,8,"female",614,621,207,27,85,27,82,0,3
1123911,20,1,1993,12,"male",368,108,89,4,3,4,1,0,2
1123961,108,15,1905,4,"male",800,2555,1042,2416,3468,1196,1632,1220,1836
1124035,25,19,1988,11,"male",134,76,72,10,36,10,19,0,17
1124048,36,12,1977,11,"female",999,198,114,15,78,13,63,2,15
1124058,19,5,1994,2,"male",101,35,28,0,0,0,0,0,0
1124078,36,11,1977,2,"male",474,109,88,4,0,0,0,4,0
1124142,26,6,1987,2,"female",1201,1071,547,246,141,246,69,0,72
1124158,65,24,1948,4,"female",209,7,7,0,0,0,0,0,0
1124160,16,10,1997,3,"female",214,71,49,97,1,97,1,0,0
1124165,32,8,1981,11,"female",194,50,33,55,2,55,2,0,0
1124186,28,31,1985,12,"female",331,134,105,0,1,0,0,0,1
1124200,16,17,1997,7,"female",682,3647,1168,355,539,355,419,0,120
1124244,66,27,1947,9,"female",102,5,4,2,1,0,0,2,1
1124248,31,14,1982,10,"male",453,4,4,16,10,16,10,0,0
1124252,102,4,1911,5,"male",845,74,25,14,2,14,2,0,0
1124259,19,8,1994,11,"female",130,800,175,189,332,189,307,0,25
1124265,25,11,1988,7,"female",65,18,13,47,17,47,7,0,10
1124289,37,12,1976,9,"male",243,202,94,2,0,2,0,0,0
1124307,30,27,1983,1,"male",34,10,5,2,0,2,0,0,0
1124345,23,25,1990,11,"female",788,119,38,22,5,22,4,0,1
1124349,58,20,1955,5,"male",553,28,9,2,0,0,0,2,0
1124351,16,19,1997,9,"male",255,173,135,0,10,0,10,0,0
1124355,36,11,1977,9,"female",376,73,51,40,15,40,13,0,2
1124357,44,20,1969,7,"male",368,44,35,0,0,0,0,0,0
1124364,42,15,1971,9,"female",308,29,21,7,4,0,0,7,4
1124373,58,30,1955,6,"female",1366,100,33,50,132,0,78,50,54
1124376,56,2,1957,1,"female",489,28,21,19,0,19,0,0,0
1124390,96,17,1917,9,"male",876,132,62,224,165,168,109,56,56
1124401,25,1,1988,1,"female",120,109,75,22,26,22,23,0,3
1124435,28,6,1985,6,"male",36,85,82,13,7,13,7,0,0
1124459,16,22,1997,4,"male",268,177,126,4,4,4,2,0,2
1124461,26,1,1987,1,"female",281,127,90,25,83,25,50,0,33
1124495,100,1,1913,1,"male",653,343,172,100,171,55,51,45,120
1124518,78,8,1935,1,"male",1449,130,61,0,0,0,0,0,0
1124611,38,14,1975,5,"male",618,52,32,10,10,7,8,3,2
1124623,23,30,1990,4,"male",394,45,18,0,1,0,1,0,0
1124626,55,9,1958,10,"female",527,73,45,0,0,0,0,0,0
1124635,23,1,1990,1,"male",543,1,0,0,0,0,0,0,0
1124640,32,20,1981,7,"male",38,61,55,71,101,67,98,4,3
1124679,42,5,1971,2,"male",337,3,2,41,8,37,2,4,6
1124737,63,30,1950,1,"male",635,10,8,1,2,1,0,0,2
1124768,23,19,1990,3,"male",127,39,38,2,0,2,0,0,0
1124774,62,2,1951,12,"female",255,55,44,513,52,4,5,509,47
1124812,27,9,1986,4,"male",733,280,204,66,41,64,35,2,6
1124823,29,24,1984,7,"female",300,76,41,173,44,51,23,122,21
1124853,48,10,1965,7,"male",1351,42,15,4,0,2,0,2,0
1124862,25,24,1988,2,"male",443,310,265,0,1,0,1,0,0
1124885,24,13,1989,9,"male",439,3,2,0,0,0,0,0,0
1124888,26,22,1987,4,"male",125,31,8,20,8,20,7,0,1
1124903,59,29,1954,6,"female",517,948,838,3833,533,205,296,3628,237
1124920,19,19,1994,3,"male",457,70,57,0,0,0,0,0,0
1124942,20,9,1993,3,"female",601,508,298,168,392,132,201,36,191
1124944,27,18,1986,7,"male",675,117,55,0,0,0,0,0,0
1124988,18,11,1995,8,"male",494,237,34,28,57,28,56,0,1
1125020,27,13,1986,9,"male",563,170,155,229,226,229,115,0,111
1125031,103,19,1910,2,"female",1610,238,106,46,23,46,23,0,0
1125032,103,27,1910,9,"female",735,41,36,0,0,0,0,0,0
1125041,18,6,1995,1,"male",20,38,34,21,15,2,1,19,14
1125052,85,9,1928,4,"male",1508,79,45,5,17,0,11,5,6
1125081,51,11,1962,3,"male",1184,122,33,3,10,2,4,1,6
1125136,16,13,1997,1,"female",3,2,1,11,5,0,1,11,4
1125143,31,7,1982,3,"male",240,25,18,2,0,1,0,1,0
1125176,113,25,1900,5,"female",1503,2830,735,224,256,224,234,0,22
1125184,73,10,1940,8,"male",1847,66,43,0,0,0,0,0,0
1125186,36,23,1977,3,"female",172,639,555,34,98,7,32,27,66
1125195,48,25,1965,4,"male",59,0,0,0,0,0,0,0,0
1125204,17,18,1996,4,"male",801,982,726,43,30,42,20,1,10
1125210,49,30,1964,8,"male",429,2,1,0,0,0,0,0,0
1125211,81,29,1932,3,"female",1232,71,18,307,77,300,46,7,31
1125220,25,1,1988,1,"male",177,105,80,26,11,26,11,0,0
1125225,38,1,1975,12,"male",164,103,83,0,1,0,1,0,0
1125232,19,7,1994,10,"female",321,773,617,3114,439,1004,284,2110,155
1125254,56,8,1957,4,"male",570,1600,1562,1,151,1,87,0,64
1125288,26,9,1987,4,"male",408,90,30,1,120,0,17,1,103
1125297,59,8,1954,6,"male",651,30,16,49,2,0,1,49,1
1125320,35,29,1978,5,"male",120,3,3,0,0,0,0,0,0
1125342,18,17,1995,9,"female",38,63,57,232,560,179,151,53,409
1125351,27,27,1986,11,"male",75,0,0,0,0,0,0,0,0
1125378,17,30,1996,11,"female",364,27,12,0,3,0,1,0,2
1125409,20,9,1993,2,"male",342,71,60,0,0,0,0,0,0
1125419,16,5,1997,12,"female",111,24,18,0,0,0,0,0,0
1125422,75,13,1938,5,"female",102,18,13,33,13,32,4,1,9
1125464,17,6,1996,6,"male",322,12,11,4,0,4,0,0,0
1125470,93,21,1920,6,"male",535,245,154,62,53,62,42,0,11
1125472,51,25,1962,3,"male",1079,897,633,423,160,118,34,305,126
1125501,23,10,1990,10,"male",1237,240,125,24,7,10,4,14,3
1125512,37,26,1976,6,"female",363,0,0,0,0,0,0,0,0
1125524,17,28,1996,8,"female",98,176,123,1141,75,247,66,894,9
1125532,19,21,1994,11,"male",768,8,5,0,0,0,0,0,0
1125585,16,15,1997,2,"male",506,220,179,128,36,128,7,0,29
1125595,51,2,1962,2,"male",1315,0,0,1,1,0,0,1,1
1125596,27,16,1986,11,"female",178,58,27,24,22,12,7,12,15
1125599,15,14,1998,3,"female",291,904,446,618,828,589,706,29,122
1125616,17,15,1996,1,"male",111,10,7,22,8,22,8,0,0
1125749,36,9,1977,8,"male",383,99,61,0,9,0,2,0,7
1125766,56,22,1957,12,"female",782,78,41,1051,228,0,34,1051,194
1125773,26,1,1987,1,"male",111,78,58,0,2,0,1,0,1
1125849,40,21,1973,2,"male",242,75,60,1,32,1,15,0,17
1125863,36,12,1977,4,"male",566,10,8,0,0,0,0,0,0
1125872,43,16,1970,8,"male",181,38,13,10,4,10,4,0,0
1125883,42,31,1971,7,"female",383,15,3,19,0,2,0,17,0
1125884,36,16,1977,9,"male",315,710,205,3741,1885,3741,1528,0,357
1125897,113,18,1900,7,"female",1549,106,67,22,26,0,9,22,17
1125956,20,22,1993,2,"female",188,233,131,1,15,1,9,0,6
1125991,61,30,1952,10,"male",439,13,12,0,0,0,0,0,0
1126012,23,19,1990,8,"female",1567,2082,644,377,1512,102,1033,275,479
1126046,88,8,1925,9,"male",2285,303,181,0,0,0,0,0,0
1126051,17,16,1996,3,"male",390,65,33,13,47,13,21,0,26
1126053,29,8,1984,9,"female",615,503,355,484,553,424,395,60,158
1126060,45,25,1968,1,"male",117,8,8,0,0,0,0,0,0
1126108,18,28,1995,1,"male",121,21,17,0,0,0,0,0,0
1126153,31,10,1982,12,"female",576,16,11,4,0,4,0,0,0
1126162,18,17,1995,4,"female",1153,936,351,739,533,675,512,64,21
1126179,19,17,1994,8,"female",505,518,158,0,0,0,0,0,0
1126195,45,22,1968,5,"female",365,46,28,6,10,6,8,0,2
1126200,57,18,1956,4,"male",349,64,50,2,0,2,0,0,0
1126219,24,7,1989,8,"male",446,245,182,0,0,0,0,0,0
1126258,26,1,1987,1,"female",437,39,19,21,9,0,3,21,6
1126282,18,8,1995,1,"male",951,140,82,2,0,0,0,2,0
1126294,18,14,1995,12,"male",39,74,69,133,31,133,27,0,4
1126298,90,8,1923,3,"female",727,1524,651,8,20,8,13,0,7
1126304,61,7,1952,9,"female",1652,171,42,89,70,89,51,0,19
1126312,20,24,1993,12,"female",419,151,104,46,25,0,4,46,21
1126318,82,15,1931,7,"female",2170,48,13,63,30,0,6,63,24
1126326,64,15,1949,10,"female",1690,82,33,85,96,39,34,46,62
1126332,50,20,1963,7,"female",647,75,46,370,124,370,101,0,23
1126358,28,1,1985,11,"female",425,298,148,49,143,39,117,10,26
1126382,43,7,1970,1,"male",140,137,111,0,10,0,0,0,10
1126452,25,18,1988,3,"male",417,51,15,1,0,1,0,0,0
1126496,31,16,1982,2,"female",884,80,51,42,48,25,21,17,27
1126541,32,28,1981,7,"male",657,440,94,111,301,106,158,5,143
1126545,19,20,1994,12,"male",655,478,255,22,36,0,9,22,27
1126550,17,20,1996,5,"female",408,420,280,1753,1846,1753,1402,0,444
1126555,29,8,1984,8,"male",1087,241,217,1,23,1,11,0,12
1126558,23,18,1990,9,"male",518,511,295,460,294,207,160,253,134
1126571,25,5,1988,5,"male",681,53,32,2,2,2,0,0,2
1126639,45,31,1968,1,"male",222,4,3,0,2,0,1,0,1
1126654,33,31,1980,12,"male",721,132,94,42,14,42,14,0,0
1126667,30,11,1983,1,"male",95,80,34,0,2,0,2,0,0
1126668,21,19,1992,3,"male",168,468,430,23,97,4,72,19,25
1126688,33,7,1980,7,"male",17,5,3,2,0,2,0,0,0
1126689,27,1,1986,10,"male",630,32,26,0,0,0,0,0,0
1126707,44,2,1969,8,"male",1781,43,15,8,3,0,2,8,1
1126730,24,20,1989,2,"male",388,22,11,1,0,1,0,0,0
1126755,14,27,1999,3,"male",362,275,198,1,6,0,3,1,3
1126767,24,10,1989,10,"female",1617,352,44,455,676,455,544,0,132
1126784,22,30,1991,11,"male",571,124,62,0,0,0,0,0,0
1126796,20,20,1993,10,"female",355,5,2,3,1,3,1,0,0
1126811,51,13,1962,11,"male",375,289,217,24,18,0,8,24,10
1126843,19,19,1994,7,"female",384,17,11,0,0,0,0,0,0
1126869,35,20,1978,4,"female",93,79,71,399,157,363,132,36,25
1126898,32,20,1981,9,"female",412,85,56,155,198,149,170,6,28
1126901,64,20,1949,3,"female",1508,52,20,7,17,7,11,0,6
1126930,24,28,1989,11,"male",33,1,1,0,1,0,1,0,0
1126983,18,13,1995,6,"male",384,104,98,3,1,3,1,0,0
1127004,22,19,1991,4,"male",150,126,89,0,55,0,48,0,7
1127007,26,1,1987,1,"male",100,14,9,0,0,0,0,0,0
1127019,23,19,1990,7,"male",544,275,243,18,31,18,30,0,1
1127038,24,17,1989,6,"male",89,13,10,0,0,0,0,0,0
1127040,26,9,1987,4,"male",908,66,47,0,0,0,0,0,0
1127051,37,20,1976,5,"male",652,212,121,5,5,5,5,0,0
1127061,45,8,1968,5,"male",121,39,22,0,0,0,0,0,0
1127070,23,5,1990,12,"male",155,163,118,12,0,12,0,0,0
1127074,17,26,1996,8,"male",292,22,14,3,1,1,1,2,0
1127111,58,15,1955,8,"female",1347,36,10,4,2,4,2,0,0
1127127,14,3,1999,10,"female",316,196,103,66,23,34,14,32,9
1127128,70,17,1943,5,"male",119,30,30,0,0,0,0,0,0
1127152,51,8,1962,3,"male",306,0,0,0,0,0,0,0,0
1127173,25,18,1988,1,"female",158,26,16,3,0,3,0,0,0
1127193,23,21,1990,9,"male",288,407,308,38,123,38,96,0,27
1127205,20,26,1993,5,"female",128,48,28,0,2,0,2,0,0
1127251,45,9,1968,12,"male",118,3,2,3,0,3,0,0,0
1127266,33,6,1980,4,"female",29,55,17,196,168,196,91,0,77
1127274,39,21,1974,6,"female",166,16,14,6,12,6,11,0,1
1127275,31,7,1982,7,"female",1732,126,56,502,308,294,208,208,100
1127288,25,7,1988,7,"male",593,56,36,23,6,23,6,0,0
1127341,108,21,1905,10,"male",1936,168,92,15,89,15,62,0,27
1127356,21,21,1992,8,"female",74,610,351,1353,1399,1317,1280,36,119
1127366,56,3,1957,1,"female",691,76,36,256,45,178,19,78,26
1127378,13,9,2000,5,"male",40,0,0,1,0,1,0,0,0
1127413,48,29,1965,6,"female",726,22,11,1210,65,170,50,1040,15
1127421,54,1,1959,2,"male",1319,194,135,74,73,74,26,0,47
1127431,16,28,1997,4,"male",414,36,32,3,2,0,1,3,1
1127453,19,25,1994,5,"male",12,2,1,10,0,0,0,10,0
1127462,37,14,1976,9,"male",768,149,118,51,4,41,4,10,0
1127471,18,24,1995,6,"male",196,1060,991,35,25,30,17,5,8
1127493,26,7,1987,7,"female",149,342,158,307,617,307,457,0,160
1127506,73,16,1940,12,"male",1147,45,34,20,3,0,1,20,2
1127510,25,16,1988,5,"female",77,509,54,10674,4440,10674,4280,0,160
1127544,59,23,1954,4,"female",1338,180,133,309,255,60,86,249,169
1127552,33,6,1980,12,"female",821,72,32,29,98,29,79,0,19
1127556,34,9,1979,1,"male",607,105,32,2,0,2,0,0,0
1127563,33,3,1980,9,"female",110,62,33,72,30,65,19,7,11
1127599,26,13,1987,6,"male",376,105,79,1,42,1,33,0,9
1127605,108,27,1905,7,"male",46,61,57,347,59,201,40,146,19
1127624,27,2,1986,2,"female",20,70,32,80,180,80,47,0,133
1127629,23,22,1990,6,"male",22,31,11,9,13,2,8,7,5
1127631,24,31,1989,7,"female",290,211,179,73,21,2,2,71,19
1127653,14,17,1999,11,"female",189,211,105,87,378,68,283,19,95
1127666,27,16,1986,3,"male",767,391,299,306,324,266,301,40,23
1127676,57,15,1956,12,"female",1663,73,28,94,71,94,30,0,41
1127687,18,1,1995,1,"male",532,0,0,0,0,0,0,0,0
1127708,38,14,1975,8,"female",394,38,30,52,13,52,4,0,9
1127722,61,18,1952,12,"female",1668,92,26,5,9,0,0,5,9
1127728,38,5,1975,4,"male",1562,42,17,0,0,0,0,0,0
1127779,18,18,1995,3,"male",91,343,26,5,50,5,46,0,4
1127797,61,5,1952,11,"male",1089,84,46,0,0,0,0,0,0
1127803,37,8,1976,11,"female",1065,53,16,160,10,0,0,160,10
1127828,63,13,1950,4,"female",1087,37,13,62,57,62,51,0,6
1127829,18,10,1995,5,"female",534,127,43,81,68,77,33,4,35
1127838,103,15,1910,7,"male",868,1056,871,2,0,2,0,0,0
1127846,27,24,1986,6,"male",324,120,67,1,9,1,9,0,0
1127850,23,1,1990,1,"male",47,10,9,0,0,0,0,0,0
1127854,33,15,1980,4,"male",320,8,7,75,16,0,9,75,7
1127863,25,14,1988,2,"male",192,75,71,26,2,26,2,0,0
1127905,19,28,1994,12,"female",360,320,246,1,0,1,0,0,0
1127910,37,30,1976,12,"female",294,22,17,407,204,25,95,382,109
1127938,34,17,1979,2,"female",1264,628,293,103,268,101,197,2,71
1127947,53,1,1960,9,"male",139,5,3,9,1,9,1,0,0
1127949,93,13,1920,11,"female",254,314,87,67,51,67,49,0,2
1128006,21,2,1992,1,"male",232,78,69,0,5,0,3,0,2
1128010,25,1,1988,1,"female",87,43,13,0,1,0,1,0,0
1128013,54,14,1959,10,"male",278,80,63,25,7,0,4,25,3
1128015,23,10,1990,2,"female",432,50,36,0,4,0,0,0,4
1128034,62,1,1951,7,"male",287,15,13,0,0,0,0,0,0
1128041,59,21,1954,8,"female",1398,180,51,7,20,7,9,0,11
1128043,24,23,1989,7,"male",815,856,306,38,71,13,60,25,11
1128060,27,29,1986,8,"male",306,189,54,169,118,169,61,0,57
1128072,21,5,1992,12,"male",576,240,39,0,9,0,2,0,7
1128100,56,24,1957,8,"female",378,16,13,30,12,30,12,0,0
1128109,32,7,1981,3,"male",809,817,705,31,10,31,10,0,0
1128114,23,10,1990,10,"male",141,58,57,81,4,81,4,0,0
1128129,21,2,1992,10,"male",606,627,514,1,1,1,1,0,0
1128173,44,7,1969,4,"male",738,56,36,0,1,0,0,0,1
1128174,30,3,1983,7,"female",472,117,41,5,1,5,0,0,1
1128177,30,15,1983,2,"female",859,49,9,59,8,58,6,1,2
1128189,16,21,1997,7,"male",321,133,82,0,0,0,0,0,0
1128196,45,31,1968,3,"male",274,16,14,113,1,105,0,8,1
1128267,62,1,1951,10,"male",1683,46,21,0,1,0,0,0,1
1128283,18,20,1995,1,"male",92,9,7,0,0,0,0,0,0
1128285,18,4,1995,7,"male",17,14,14,0,0,0,0,0,0
1128289,36,15,1977,1,"female",105,1,1,0,0,0,0,0,0
1128340,24,7,1989,6,"male",1092,453,164,41,10,0,8,41,2
1128357,37,7,1976,11,"male",473,21,10,0,1,0,1,0,0
1128362,23,17,1990,2,"female",361,137,63,76,13,73,6,3,7
1128378,14,18,1999,11,"female",198,235,152,729,29,729,21,0,8
1128387,22,15,1991,9,"female",356,133,44,0,0,0,0,0,0
1128391,22,18,1991,5,"male",532,572,476,2,7,2,6,0,1
1128408,60,14,1953,10,"female",1718,115,58,161,199,141,158,20,41
1128432,27,17,1986,12,"female",762,202,58,0,9,0,6,0,3
1128438,103,19,1910,10,"female",1292,110,94,14,10,13,10,1,0
1128463,25,1,1988,1,"male",160,27,24,11,1,9,0,2,1
1128510,20,28,1993,12,"female",370,355,46,5545,2318,5537,1583,8,735
1128545,100,23,1913,8,"male",1189,4632,2548,1064,1908,783,1074,281,834
1128565,53,7,1960,9,"female",760,157,136,328,152,23,98,305,54
1128595,37,30,1976,11,"male",524,122,88,12,10,12,10,0,0
1128597,28,9,1985,3,"male",427,104,40,153,97,153,68,0,29
1128610,17,17,1996,3,"male",377,87,76,1,0,1,0,0,0
1128619,99,25,1914,6,"male",1288,251,28,4,4,0,1,4,3
1128622,25,6,1988,5,"male",156,22,10,0,1,0,0,0,1
1128625,46,15,1967,4,"male",130,27,14,541,9,541,8,0,1
1128635,21,28,1992,8,"female",316,7,7,24,16,17,14,7,2
1128687,33,12,1980,2,"male",354,110,107,16,8,0,1,16,7
1128695,27,13,1986,9,"male",726,117,70,15,1,15,0,0,1
1128702,25,1,1988,1,"male",46,79,58,4,10,4,8,0,2
1128707,35,5,1978,1,"female",151,21,8,64,50,64,44,0,6
1128711,68,14,1945,3,"female",1546,843,483,150,126,117,57,33,69
1128736,103,16,1910,3,"female",753,228,155,27,108,26,57,1,51
1128739,31,1,1982,12,"male",442,54,42,43,51,43,46,0,5
1128774,28,11,1985,2,"female",378,1,0,0,0,0,0,0,0
1128777,15,23,1998,11,"male",61,19,17,41,2,0,1,41,1
1128790,41,14,1972,8,"male",644,1,0,0,0,0,0,0,0
1128801,29,18,1984,2,"male",365,1,1,0,0,0,0,0,0
1128825,108,5,1905,11,"male",13,86,49,12,4,11,3,1,1
1128855,27,2,1986,8,"male",847,22,13,17,15,12,8,5,7
1128858,50,13,1963,9,"female",1727,442,253,484,484,439,296,45,188
1128880,34,12,1979,5,"male",482,96,80,91,21,91,19,0,2
1128883,65,29,1948,3,"female",1405,67,27,3,1,0,0,3,1
1128896,20,10,1993,8,"female",210,2,2,0,0,0,0,0,0
1128969,52,21,1961,11,"male",46,11,8,2,4,2,3,0,1
1129026,66,27,1947,1,"male",415,109,48,448,82,448,71,0,11
1129043,29,7,1984,1,"male",346,29,23,0,0,0,0,0,0
1129077,28,4,1985,2,"male",212,67,37,62,7,62,5,0,2
1129091,28,1,1985,4,"female",421,14,11,0,0,0,0,0,0
1129135,38,1,1975,7,"female",411,81,65,0,0,0,0,0,0
1129142,46,5,1967,1,"female",287,124,82,520,486,520,323,0,163
1129143,27,10,1986,12,"male",310,2,1,0,1,0,0,0,1
1129165,64,11,1949,9,"male",1532,38,18,34,33,14,13,20,20
1129190,19,29,1994,9,"male",247,104,62,0,1,0,1,0,0
1129195,57,18,1956,10,"male",236,23,16,0,0,0,0,0,0
1129205,26,25,1987,6,"female",468,196,154,102,125,1,82,101,43
1129206,46,19,1967,10,"female",640,198,132,119,170,73,133,46,37
1129208,58,27,1955,6,"male",54,163,88,6,0,6,0,0,0
1129213,103,20,1910,2,"male",817,48,35,5,0,5,0,0,0
1129308,27,5,1986,12,"male",696,229,111,5,49,5,28,0,21
1129322,18,20,1995,10,"male",353,21,17,1,0,0,0,1,0
1129324,17,20,1996,11,"male",189,201,112,149,64,86,41,63,23
1129329,68,19,1945,12,"male",369,81,38,8,2,8,1,0,1
1129338,25,1,1988,1,"male",4,5,5,0,0,0,0,0,0
1129344,15,6,1998,3,"female",640,155,106,178,65,165,46,13,19
1129361,22,15,1991,4,"female",665,472,350,346,194,226,64,120,130
1129391,56,3,1957,5,"male",1355,127,31,202,279,202,201,0,78
1129403,17,19,1996,1,"male",234,111,97,0,0,0,0,0,0
1129417,21,2,1992,2,"male",541,311,288,4,0,0,0,4,0
1129458,62,3,1951,4,"male",983,36,19,1,2,1,0,0,2
1129482,18,18,1995,12,"male",573,389,223,125,131,45,61,80,70
1129526,18,12,1995,9,"male",57,50,46,5,0,5,0,0,0
1129555,31,19,1982,9,"female",224,55,30,19,20,19,20,0,0
1129590,25,14,1988,5,"male",462,284,247,0,0,0,0,0,0
1129604,24,16,1989,1,"female",1365,943,132,5,118,5,78,0,40
1129609,28,20,1985,2,"male",327,18,14,0,4,0,4,0,0
1129619,64,7,1949,1,"female",122,17,7,12,10,2,4,10,6
1129658,35,29,1978,4,"male",39,17,12,5,14,5,13,0,1
1129664,22,10,1991,6,"male",1422,846,434,24,40,24,34,0,6
1129678,56,30,1957,6,"male",230,28,11,0,0,0,0,0,0
1129690,17,2,1996,6,"male",269,118,81,0,0,0,0,0,0
1129731,66,10,1947,4,"female",986,292,57,36,45,28,24,8,21
1129740,17,20,1996,7,"male",508,166,115,45,35,28,10,17,25
1129747,61,23,1952,3,"female",657,797,229,42,91,42,70,0,21
1129761,24,6,1989,2,"female",310,69,34,0,6,0,2,0,4
1129814,22,1,1991,1,"male",105,29,26,58,6,58,5,0,1
1129826,57,14,1956,12,"female",1077,29,15,4,2,0,0,4,2
1129869,22,14,1991,8,"male",506,89,66,32,1,32,1,0,0
1129908,17,27,1996,9,"male",48,78,50,48,39,46,36,2,3
1129909,15,15,1998,4,"male",3,0,0,0,0,0,0,0,0
1129993,49,15,1964,2,"male",743,70,29,9,96,9,88,0,8
1130010,25,1,1988,1,"male",685,43,31,1,6,1,6,0,0
1130022,19,30,1994,4,"male",124,25,19,32,32,0,0,32,32
1130034,31,21,1982,7,"male",313,21,16,14,15,14,13,0,2
1130055,27,18,1986,9,"male",311,67,64,3,0,2,0,1,0
1130072,19,12,1994,2,"male",498,245,85,172,105,172,60,0,45
1130075,22,21,1991,5,"male",454,225,174,1,1,1,0,0,1
1130096,106,12,1907,11,"male",179,203,179,35,14,35,9,0,5
1130103,22,9,1991,3,"male",45,4,3,49,18,49,14,0,4
1130104,90,9,1923,8,"male",1622,32,9,88,13,1,1,87,12
1130105,24,8,1989,1,"female",3,5,5,0,0,0,0,0,0
1130112,17,14,1996,6,"male",359,48,24,0,34,0,18,0,16
1130127,55,1,1958,1,"male",278,0,0,0,0,0,0,0,0
1130137,19,31,1994,1,"female",464,172,61,54,27,54,24,0,3
1130141,25,1,1988,12,"female",691,74,29,0,2,0,2,0,0
1130147,23,1,1990,10,"male",438,241,208,1,0,1,0,0,0
1130157,36,9,1977,3,"female",134,0,0,6,0,6,0,0,0
1130182,24,1,1989,1,"male",270,41,25,0,2,0,1,0,1
1130226,50,2,1963,9,"male",1692,190,57,868,150,806,67,62,83
1130269,27,25,1986,11,"female",454,276,180,0,0,0,0,0,0
1130346,25,6,1988,2,"male",17,2,1,0,0,0,0,0,0
1130367,57,10,1956,10,"female",1083,84,18,31,178,31,41,0,137
1130376,18,29,1995,8,"male",133,22,12,0,0,0,0,0,0
1130410,50,17,1963,12,"male",247,45,21,21,5,0,0,21,5
1130411,21,10,1992,5,"female",765,241,205,46,13,46,13,0,0
1130417,22,23,1991,8,"female",147,61,30,83,66,83,57,0,9
1130439,29,19,1984,3,"female",525,196,86,198,337,192,266,6,71
1130465,43,22,1970,12,"male",251,38,15,159,136,132,129,27,7
1130472,30,21,1983,12,"male",193,0,0,0,0,0,0,0,0
1130474,20,12,1993,10,"female",1619,1781,694,1047,7615,600,4545,447,3070
1130495,17,10,1996,8,"female",186,752,533,375,372,375,229,0,143
1130498,26,2,1987,1,"female",162,52,34,1,0,1,0,0,0
1130499,60,5,1953,6,"male",865,240,176,41,15,41,11,0,4
1130565,28,6,1985,3,"female",95,46,40,118,128,118,82,0,46
1130602,21,10,1992,10,"male",334,13,6,5,0,5,0,0,0
1130618,21,15,1992,5,"male",1080,142,91,101,33,19,16,82,17
1130619,24,16,1989,8,"male",71,47,43,0,0,0,0,0,0
1130653,17,18,1996,9,"male",691,64,57,681,25,681,16,0,9
1130675,47,7,1966,9,"female",326,45,33,1,6,0,3,1,3
1130677,22,1,1991,8,"male",423,6,4,0,0,0,0,0,0
1130684,18,23,1995,11,"male",377,81,77,0,15,0,15,0,0
1130687,37,13,1976,3,"male",362,522,449,144,51,23,33,121,18
1130694,23,18,1990,7,"female",512,107,79,9,31,9,19,0,12
1130696,42,28,1971,8,"male",79,10,5,25,1,0,0,25,1
1130711,34,8,1979,2,"male",621,68,42,0,0,0,0,0,0
1130714,16,18,1997,8,"female",748,1288,601,1227,1214,768,660,459,554
1130770,57,20,1956,8,"female",415,202,100,110,49,0,12,110,37
1130789,23,8,1990,12,"female",405,157,99,4,7,0,3,4,4
1130791,108,20,1905,10,"male",2101,763,318,39,35,0,24,39,11
1130822,30,6,1983,9,"male",305,27,24,34,29,19,25,15,4
1130878,50,7,1963,2,"male",789,49,14,20,7,0,4,20,3
1130880,20,14,1993,2,"male",434,96,26,88,83,87,63,1,20
1130895,57,29,1956,8,"male",218,108,105,0,0,0,0,0,0
1130927,41,27,1972,1,"male",711,41,14,13,3,13,3,0,0
1130941,57,29,1956,3,"male",437,43,33,21,10,0,1,21,9
1131000,36,30,1977,5,"male",387,210,111,76,57,73,16,3,41
1131001,47,20,1966,6,"male",272,8,8,4,12,4,10,0,2
1131003,20,20,1993,8,"male",193,71,17,566,673,566,643,0,30
1131008,65,19,1948,10,"female",1877,108,43,295,346,243,250,52,96
1131015,32,26,1981,9,"male",373,85,70,20,4,20,4,0,0
1131029,24,25,1989,9,"female",334,236,143,113,91,6,32,107,59
1131049,57,23,1956,9,"male",1359,15,9,2,3,2,3,0,0
1131080,30,21,1983,11,"male",902,182,86,243,327,49,59,194,268
1131112,18,16,1995,9,"male",534,807,653,0,0,0,0,0,0
1131152,21,11,1992,1,"female",392,509,215,13,39,13,22,0,17
1131177,66,7,1947,3,"female",1371,15,7,1,2,0,0,1,2
1131240,81,15,1932,4,"female",1014,121,50,2,37,2,37,0,0
1131255,103,19,1910,10,"female",827,1260,711,888,949,888,770,0,179
1131278,69,21,1944,9,"female",274,36,22,0,3,0,3,0,0
1131314,47,19,1966,3,"female",1271,65,17,28,26,0,11,28,15
1131317,18,18,1995,4,"male",412,258,183,7,10,7,3,0,7
1131328,25,1,1988,9,"female",252,427,372,496,567,431,216,65,351
1131364,68,22,1945,1,"female",28,31,17,5,9,5,5,0,4
1131365,18,1,1995,8,"male",391,475,436,26,2,26,2,0,0
1131374,23,6,1990,1,"male",82,122,112,11,4,0,0,11,4
1131419,20,19,1993,4,"male",229,46,38,2,0,0,0,2,0
1131424,44,28,1969,9,"male",93,118,56,0,0,0,0,0,0
1131431,20,13,1993,2,"male",97,97,73,416,81,413,49,3,32
1131468,33,18,1980,11,"female",476,159,94,1,1,1,1,0,0
1131475,41,30,1972,6,"male",167,69,52,19,42,19,28,0,14
1131489,23,12,1990,8,"male",155,325,283,181,154,157,73,24,81
1131493,37,4,1976,6,"male",670,86,20,18,1,18,1,0,0
1131537,69,19,1944,9,"female",730,200,168,191,0,189,0,2,0
1131544,31,12,1982,3,"female",470,57,37,9,50,9,44,0,6
1131586,93,24,1920,4,"male",628,376,308,2,38,2,35,0,3
1131602,27,22,1986,6,"female",259,649,209,92,109,91,60,1,49
1131606,63,22,1950,3,"male",606,126,84,1,9,0,6,1,3
1131626,57,25,1956,8,"female",273,12,6,21,20,21,15,0,5
1131642,21,25,1992,3,"male",637,63,37,27,18,27,6,0,12
1131647,35,22,1978,11,"female",298,118,52,14,81,14,65,0,16
1131656,36,12,1977,12,"male",442,19,8,0,3,0,2,0,1
1131672,32,8,1981,7,"female",1025,265,176,4,43,4,39,0,4
1131733,21,8,1992,7,"female",134,961,455,106,701,88,556,18,145
1131756,50,21,1963,3,"female",192,21,13,32,58,32,56,0,2
1131777,49,21,1964,11,"female",512,488,364,445,478,14,138,431,340
1131782,23,21,1990,9,"male",348,40,26,15,5,15,4,0,1
1131812,25,24,1988,12,"male",927,760,542,5,3,5,2,0,1
1131819,26,28,1987,4,"female",462,44,21,0,3,0,3,0,0
1131827,19,7,1994,2,"female",268,265,153,4,4,0,3,4,1
1131830,28,11,1985,3,"male",343,1,1,0,0,0,0,0,0
1131834,19,19,1994,6,"male",278,2931,725,165,470,48,267,117,203
1131850,47,31,1966,10,"female",248,79,46,22,159,22,159,0,0
1131857,68,13,1945,9,"male",861,31,20,0,0,0,0,0,0
1131859,108,13,1905,7,"male",1114,338,229,83,11,0,8,83,3
1131888,26,21,1987,11,"male",436,35,15,5,2,5,2,0,0
1131896,44,1,1969,5,"male",612,318,10,2,7,2,4,0,3
1131918,18,13,1995,3,"male",299,112,71,54,49,45,28,9,21
1131937,22,12,1991,10,"female",66,0,0,0,0,0,0,0,0
1131941,29,1,1984,1,"male",379,15,8,0,0,0,0,0,0
1131947,36,14,1977,1,"male",158,3,2,0,0,0,0,0,0
1131951,16,2,1997,5,"male",130,216,153,10,0,0,0,10,0
1131969,24,17,1989,3,"male",658,249,103,0,1,0,1,0,0
1131979,22,1,1991,7,"male",593,109,81,2,4,2,3,0,1
1131999,102,24,1911,6,"male",2330,1062,605,47,63,26,43,21,20
1132000,25,19,1988,2,"female",101,5,5,55,0,55,0,0,0
1132026,103,23,1910,2,"female",1071,212,99,7,7,7,6,0,1
1132062,31,30,1982,5,"male",604,6,0,0,1,0,0,0,1
1132069,88,7,1925,1,"female",1686,59,39,0,3,0,1,0,2
1132121,44,16,1969,11,"female",503,11,3,3,3,0,3,3,0
1132136,18,22,1995,10,"male",71,42,21,0,0,0,0,0,0
1132142,70,10,1943,6,"female",808,74,33,33,28,0,8,33,20
1132164,13,1,2000,1,"male",459,405,280,51,201,47,153,4,48
1132175,37,19,1976,7,"female",480,19,13,14,0,0,0,14,0
1132185,24,14,1989,2,"male",332,50,47,11,1,1,1,10,0
1132190,62,23,1951,6,"female",636,26,13,43,75,16,33,27,42
1132288,44,1,1969,6,"female",83,31,14,192,37,192,31,0,6
1132306,23,28,1990,5,"male",332,44,40,2,0,0,0,2,0
1132366,70,23,1943,12,"female",1797,178,91,77,104,77,29,0,75
1132404,19,6,1994,10,"male",495,347,315,0,9,0,7,0,2
1132475,25,23,1988,2,"female",216,24,12,44,2,43,1,1,1
1132479,108,15,1905,12,"female",77,77,66,39,21,17,11,22,10
1132486,18,2,1995,3,"female",391,162,26,11,9,11,2,0,7
1132520,17,8,1996,6,"female",407,165,43,161,2,20,2,141,0
1132524,17,6,1996,3,"male",229,78,58,8,9,8,9,0,0
1132541,56,24,1957,1,"female",1258,301,153,39,15,39,5,0,10
1132549,23,12,1990,12,"male",136,7,3,0,0,0,0,0,0
1132553,16,6,1997,9,"male",621,677,294,1,2,1,2,0,0
1132575,19,5,1994,8,"male",197,1010,683,168,1377,168,810,0,567
1132662,17,10,1996,8,"male",380,1,0,0,0,0,0,0,0
1132696,26,11,1987,12,"male",217,119,93,28,40,28,40,0,0
1132707,58,9,1955,10,"male",764,172,139,330,12,4,5,326,7
1132731,17,30,1996,11,"male",33,144,110,10,92,10,86,0,6
1132738,20,11,1993,11,"male",34,148,147,194,162,194,145,0,17
1132770,21,14,1992,1,"male",523,0,0,0,0,0,0,0,0
1132776,20,2,1993,11,"female",207,30,17,2,10,1,8,1,2
1132777,31,2,1982,12,"male",885,45,29,0,0,0,0,0,0
1132779,16,29,1997,7,"male",141,65,39,13,0,13,0,0,0
1132817,49,5,1964,8,"female",1547,108,57,117,103,69,63,48,40
1132829,41,2,1972,10,"male",565,81,55,214,30,48,24,166,6
1132832,47,28,1966,4,"male",767,223,137,0,19,0,4,0,15
1132885,39,16,1974,11,"male",250,74,60,0,0,0,0,0,0
1132906,28,4,1985,1,"male",101,17,13,3,3,3,1,0,2
1132920,38,10,1975,12,"female",431,6,5,0,0,0,0,0,0
1132966,49,14,1964,9,"female",778,166,48,796,462,505,313,291,149
1132970,58,21,1955,8,"female",307,104,58,254,461,254,307,0,154
1133011,19,20,1994,1,"female",214,597,69,23,930,22,478,1,452
1133024,19,18,1994,3,"male",569,1319,721,2323,5662,959,2292,1364,3370
1133068,14,15,1999,6,"male",436,107,79,8,4,3,4,5,0
1133081,40,4,1973,6,"female",727,126,82,285,81,285,21,0,60
1133086,42,5,1971,10,"male",370,77,28,94,70,19,41,75,29
1133115,16,14,1997,8,"female",365,435,219,142,144,66,43,76,101
1133136,23,15,1990,1,"female",734,5,3,2,1,2,1,0,0
1133153,22,4,1991,10,"male",751,130,112,0,12,0,0,0,12
1133157,34,12,1979,5,"female",23,15,15,130,71,0,44,130,27
1133167,16,18,1997,7,"male",414,5,5,154,2,1,1,153,1
1133169,15,6,1998,12,"male",132,124,95,3,7,3,3,0,4
1133200,26,25,1987,11,"male",1612,167,91,123,62,103,33,20,29
1133208,23,9,1990,11,"male",171,25,17,78,0,0,0,78,0
1133232,18,11,1995,1,"male",427,1761,1375,312,658,220,307,92,351
1133263,20,11,1993,5,"female",273,867,186,1,16,1,12,0,4
1133288,16,31,1997,12,"male",450,24,6,0,1,0,1,0,0
1133333,18,4,1995,6,"male",213,30,1,3,0,3,0,0,0
1133353,17,4,1996,3,"female",249,198,142,1,16,1,11,0,5
1133360,33,27,1980,7,"male",280,6,5,6,0,0,0,6,0
1133369,15,3,1998,11,"male",498,48,21,61,15,60,12,1,3
1133398,18,1,1995,1,"male",331,182,172,0,0,0,0,0,0
1133400,28,25,1985,3,"female",232,16,7,0,0,0,0,0,0
1133421,51,12,1962,3,"male",599,92,79,61,17,57,8,4,9
1133425,30,22,1983,4,"male",144,28,24,149,15,149,15,0,0
1133440,35,16,1978,4,"male",314,49,46,0,0,0,0,0,0
1133481,56,12,1957,10,"female",1757,69,21,2,38,0,22,2,16
1133511,25,1,1988,1,"male",23,5,2,3,0,3,0,0,0
1133527,30,28,1983,4,"female",91,19,14,0,0,0,0,0,0
1133530,29,14,1984,8,"female",194,229,152,276,264,200,73,76,191
1133536,26,1,1987,2,"female",692,268,150,2,6,2,5,0,1
1133539,26,30,1987,3,"male",381,69,61,0,0,0,0,0,0
1133544,31,23,1982,11,"male",394,136,86,1,0,1,0,0,0
1133550,35,17,1978,11,"female",594,471,425,965,387,965,312,0,75
1133556,22,7,1991,3,"male",326,479,431,14,14,0,4,14,10
1133557,74,12,1939,1,"female",1088,185,103,324,29,0,13,324,16
1133578,22,28,1991,4,"female",389,152,107,40,91,16,44,24,47
1133582,18,25,1995,12,"male",6,127,121,3,3,0,0,3,3
1133587,24,29,1989,9,"male",290,27,13,0,0,0,0,0,0
1133601,54,4,1959,7,"male",462,397,329,326,236,326,135,0,101
1133616,48,1,1965,11,"female",724,232,145,187,154,140,54,47,100
1133620,88,16,1925,12,"male",1472,545,247,22,17,22,9,0,8
1133627,58,2,1955,12,"female",617,14,7,9,1,9,0,0,1
1133637,23,2,1990,12,"male",433,56,52,0,0,0,0,0,0
1133641,26,5,1987,12,"male",65,55,44,1,1,1,1,0,0
1133658,66,24,1947,7,"male",1103,76,46,0,2,0,1,0,1
1133663,18,26,1995,9,"female",449,37,22,18,35,7,17,11,18
1133675,37,14,1976,12,"male",59,161,31,247,332,240,225,7,107
1133684,17,21,1996,4,"male",482,451,252,62,18,2,6,60,12
1133691,18,25,1995,7,"female",79,90,86,38,9,38,9,0,0
1133713,21,15,1992,2,"male",186,35,26,0,0,0,0,0,0
1133721,36,10,1977,9,"male",282,0,0,1,1,1,1,0,0
1133740,64,5,1949,10,"female",784,11,10,1,1,1,1,0,0
1133757,18,18,1995,8,"male",326,44,19,2,1,2,0,0,1
1133763,42,28,1971,1,"female",914,21,11,17,6,17,3,0,3
1133782,20,26,1993,2,"male",840,870,626,32,6,26,4,6,2
1133792,60,13,1953,8,"female",1723,218,86,99,130,0,70,99,60
1133797,19,19,1994,5,"male",207,85,59,0,8,0,0,0,8
1133801,63,22,1950,5,"female",362,869,409,1601,837,1520,625,81,212
1133804,32,2,1981,8,"female",329,10,10,6,0,6,0,0,0
1133870,67,18,1946,5,"male",1555,430,380,288,89,0,31,288,58
1133883,21,30,1992,7,"male",111,16,11,0,0,0,0,0,0
1133930,20,11,1993,11,"male",515,20,4,0,0,0,0,0,0
1133947,28,11,1985,4,"male",12,10,7,2,0,2,0,0,0
1133957,93,8,1920,7,"male",901,421,295,101,28,101,23,0,5
1133967,102,11,1911,11,"male",554,41,26,57,27,0,11,57,16
1133978,29,1,1984,5,"female",356,19,0,0,0,0,0,0,0
1134015,62,11,1951,6,"male",274,22,12,1,0,0,0,1,0
1134034,51,30,1962,8,"female",94,33,4,3,4,3,3,0,1
1134064,18,20,1995,9,"female",258,737,132,576,1362,382,990,194,372
1134073,26,1,1987,1,"male",338,34,26,7,0,7,0,0,0
1134075,24,7,1989,3,"male",173,0,0,0,0,0,0,0,0
1134094,57,10,1956,9,"female",2135,47,14,75,19,47,14,28,5
1134095,23,10,1990,3,"male",529,111,75,0,8,0,8,0,0
1134102,43,6,1970,9,"male",340,23,20,3,4,1,2,2,2
1134111,46,10,1967,8,"female",718,152,66,491,561,311,419,180,142
1134247,32,20,1981,5,"male",185,121,49,33,210,12,137,21,73
1134250,61,21,1952,2,"male",1735,27,10,3,0,3,0,0,0
1134261,19,3,1994,10,"female",323,563,277,816,3137,466,819,350,2318
1134298,38,26,1975,1,"male",207,16,7,24,7,24,4,0,3
1134320,19,5,1994,10,"female",545,1236,508,256,478,22,302,234,176
1134328,103,28,1910,6,"male",1426,861,333,117,137,115,123,2,14
1134343,25,13,1988,7,"female",40,279,32,1823,678,1823,587,0,91
1134354,20,23,1993,1,"female",120,35,11,713,2333,713,1724,0,609
1134396,66,25,1947,8,"female",501,413,76,21,175,21,160,0,15
1134398,34,1,1979,1,"male",325,12,1,3,1,3,1,0,0
1134408,18,17,1995,11,"male",281,35,22,0,0,0,0,0,0
1134433,68,14,1945,5,"male",557,23,19,0,0,0,0,0,0
1134449,46,1,1967,10,"male",965,616,369,11,2,11,2,0,0
1134461,14,15,1999,8,"female",319,218,44,229,375,111,49,118,326
1134467,57,18,1956,5,"female",158,573,507,914,682,911,297,3,385
1134469,45,15,1968,8,"female",238,38,21,144,115,18,102,126,13
1134481,18,18,1995,11,"male",201,8,5,0,0,0,0,0,0
1134507,20,22,1993,7,"male",525,39,36,3,1,0,0,3,1
1134544,23,29,1990,11,"male",616,339,274,24,23,24,19,0,4
1134553,23,17,1990,9,"female",610,203,88,2,41,2,28,0,13
1134559,61,14,1952,4,"female",714,96,53,121,52,0,24,121,28
1134595,30,11,1983,9,"male",224,18,16,0,0,0,0,0,0
1134597,44,1,1969,6,"male",128,9,4,0,0,0,0,0,0
1134604,68,7,1945,3,"male",862,126,53,2,0,0,0,2,0
1134615,56,15,1957,1,"male",1019,34,22,7,13,7,11,0,2
1134618,30,2,1983,5,"male",266,1,0,0,0,0,0,0,0
1134619,74,1,1939,11,"male",1325,38,13,176,79,0,14,176,65
1134639,28,1,1985,6,"female",418,125,57,2,23,2,15,0,8
1134652,16,22,1997,1,"female",566,505,232,271,177,70,33,201,144
1134658,73,1,1940,1,"female",533,231,78,57,535,0,40,57,495
1134717,21,3,1992,12,"female",504,40,29,0,4,0,4,0,0
1134741,57,2,1956,10,"male",327,29,21,0,2,0,1,0,1
1134773,55,16,1958,11,"female",1961,351,214,161,201,27,159,134,42
1134795,20,17,1993,8,"male",872,95,54,0,0,0,0,0,0
1134802,98,3,1915,8,"male",1196,654,170,6,1,3,1,3,0
1134805,31,3,1982,3,"male",85,33,30,65,3,65,1,0,2
1134815,21,15,1992,8,"male",1145,54,36,56,62,56,42,0,20
1134851,25,5,1988,3,"male",551,154,130,4,0,0,0,4,0
1134859,60,3,1953,9,"female",925,86,36,0,0,0,0,0,0
1134913,56,7,1957,6,"female",405,21,8,8,3,8,2,0,1
1134940,14,8,1999,1,"female",513,1384,830,3,51,3,34,0,17
1134943,20,30,1993,3,"male",287,96,61,1,21,1,16,0,5
1134949,28,12,1985,6,"male",934,56,49,0,0,0,0,0,0
1134950,16,1,1997,1,"male",467,62,41,19,10,19,2,0,8
1134957,59,11,1954,11,"female",256,105,82,142,14,0,8,142,6
1134972,47,2,1966,10,"male",251,9,9,0,0,0,0,0,0
1134990,34,17,1979,11,"male",220,78,62,46,2,46,1,0,1
1134999,24,17,1989,10,"male",16,21,10,20,2,20,2,0,0
1135008,21,22,1992,7,"female",8,0,0,0,0,0,0,0,0
1135009,58,12,1955,9,"male",274,39,29,2,21,2,12,0,9
1135014,30,3,1983,10,"male",510,136,100,0,4,0,0,0,4
1135027,29,12,1984,12,"male",167,61,58,0,0,0,0,0,0
1135035,34,13,1979,10,"male",488,19,14,29,2,29,1,0,1
1135044,14,19,1999,3,"male",182,69,36,4,0,4,0,0,0
1135069,40,4,1973,12,"female",470,111,88,2,1,2,1,0,0
1135070,63,29,1950,4,"female",383,1,0,0,0,0,0,0,0
1135071,23,26,1990,3,"male",86,49,15,0,0,0,0,0,0
1135091,81,5,1932,10,"male",1131,204,121,11,17,11,8,0,9
1135106,22,8,1991,7,"male",717,44,14,101,50,101,27,0,23
1135116,18,11,1995,9,"female",182,175,40,51,89,51,81,0,8
1135122,28,23,1985,1,"male",290,104,69,20,37,20,23,0,14
1135123,69,1,1944,5,"male",613,15,5,3,0,0,0,3,0
1135142,26,1,1987,8,"male",323,31,18,1,3,1,3,0,0
1135159,19,1,1994,3,"female",332,204,4,0,23,0,13,0,10
1135173,103,5,1910,6,"male",481,1218,667,16,8,16,8,0,0
1135186,48,8,1965,9,"female",475,54,34,144,12,144,5,0,7
1135231,15,8,1998,10,"female",163,271,217,14,2,14,2,0,0
1135246,17,15,1996,1,"male",159,11,7,7,2,7,1,0,1
1135249,27,23,1986,2,"male",680,222,139,22,34,18,10,4,24
1135266,58,10,1955,1,"male",1668,77,6,0,6,0,4,0,2
1135277,55,6,1958,2,"male",463,115,82,2,4,0,4,2,0
1135326,46,2,1967,2,"male",488,14,9,2,1,2,1,0,0
1135328,49,21,1964,5,"female",379,90,42,22,5,17,5,5,0
1135329,20,4,1993,10,"male",568,193,128,16,5,0,1,16,4
1135352,51,22,1962,1,"female",1005,55,34,163,99,163,80,0,19
1135361,77,7,1936,6,"female",974,98,44,3,27,3,12,0,15
1135362,58,14,1955,7,"female",360,69,29,97,134,0,31,97,103
1135364,28,26,1985,5,"male",520,110,88,22,0,22,0,0,0
1135396,21,8,1992,10,"male",744,473,240,13,10,13,8,0,2
1135398,66,13,1947,12,"female",1671,77,36,14,15,0,8,14,7
1135403,100,17,1913,11,"female",1229,75,18,311,14,311,10,0,4
1135465,30,26,1983,1,"male",576,413,345,1,13,1,10,0,3
1135497,23,10,1990,12,"female",35,227,50,95,135,95,102,0,33
1135548,19,21,1994,4,"male",254,140,70,12,6,12,1,0,5
1135560,20,10,1993,10,"female",610,694,243,163,317,163,247,0,70
1135570,28,3,1985,5,"male",323,87,77,2,19,2,12,0,7
1135571,19,17,1994,2,"male",406,994,730,86,129,51,90,35,39
1135583,32,21,1981,2,"male",247,31,10,133,23,103,4,30,19
1135585,22,20,1991,12,"female",191,61,52,264,75,258,57,6,18
1135669,17,20,1996,4,"male",491,405,335,50,10,0,8,50,2
1135682,32,16,1981,7,"male",192,108,61,443,35,9,15,434,20
1135718,34,7,1979,4,"female",251,255,166,890,2115,715,1572,175,543
1135730,17,25,1996,3,"female",199,293,237,147,97,124,53,23,44
1135775,45,16,1968,3,"male",164,24,7,8,9,4,5,4,4
1135797,20,3,1993,7,"male",460,70,52,0,0,0,0,0,0
1135815,20,17,1993,7,"female",483,4,1,7,1,0,0,7,1
1135835,29,18,1984,9,"female",708,814,77,498,1101,414,341,84,760
1135867,26,1,1987,1,"male",403,20,15,13,10,13,10,0,0
1135893,16,13,1997,8,"female",10,145,142,14,16,14,12,0,4
1135897,48,4,1965,4,"male",49,227,78,280,1039,24,394,256,645
1135965,25,16,1988,7,"female",468,43,18,13,2,13,2,0,0
1136003,40,1,1973,11,"male",388,138,88,0,0,0,0,0,0
1136020,20,13,1993,3,"male",558,88,36,2,22,2,7,0,15
1136023,64,15,1949,5,"male",514,3,0,0,0,0,0,0,0
1136059,16,5,1997,7,"male",235,26,25,0,0,0,0,0,0
1136121,33,4,1980,1,"male",205,14,8,0,2,0,1,0,1
1136131,29,4,1984,12,"female",244,66,8,40,38,2,11,38,27
1136133,62,31,1951,3,"female",1619,154,22,55,69,55,53,0,16
1136159,22,4,1991,2,"male",898,224,65,18,2,18,2,0,0
1136186,57,14,1956,12,"female",2489,179,66,96,24,2,10,94,14
1136189,56,15,1957,10,"male",1676,79,28,15,44,15,15,0,29
1136236,68,10,1945,12,"male",1347,62,25,142,156,0,8,142,148
1136241,37,24,1976,5,"male",477,5,2,0,0,0,0,0,0
1136252,23,27,1990,8,"male",322,200,112,24,18,7,4,17,14
1136265,108,5,1905,6,"female",1598,288,112,13,43,0,18,13,25
1136266,22,22,1991,7,"male",612,114,85,3,2,3,2,0,0
1136269,54,13,1959,1,"female",1734,121,40,84,70,31,48,53,22
1136291,25,1,1988,1,"male",8,0,0,0,0,0,0,0,0
1136297,19,25,1994,5,"male",580,1058,926,88,34,88,33,0,1
1136298,26,14,1987,4,"female",325,139,82,722,775,692,658,30,117
1136316,65,28,1948,7,"male",541,7,7,0,3,0,1,0,2
1136372,35,10,1978,7,"female",0,0,0,0,0,0,0,0,0
1136384,31,24,1982,2,"male",75,37,35,18,1,16,1,2,0
1136402,61,15,1952,8,"male",814,125,119,93,4,1,3,92,1
1136424,37,28,1976,9,"female",445,180,79,16,0,3,0,13,0
1136446,34,11,1979,4,"male",422,0,0,0,0,0,0,0,0
1136462,23,14,1990,2,"male",298,131,92,5,3,0,0,5,3
1136472,19,2,1994,11,"male",160,12,7,0,0,0,0,0,0
1136473,21,22,1992,3,"male",668,9,5,0,2,0,2,0,0
1136483,57,28,1956,8,"female",207,29,19,74,31,74,29,0,2
1136500,47,28,1966,9,"female",1911,23,10,99,124,18,50,81,74
1136512,57,10,1956,11,"female",1446,96,44,27,21,6,4,21,17
1136575,94,8,1919,4,"male",308,110,87,22,14,22,10,0,4
1136608,20,1,1993,8,"female",225,234,19,1,13,1,2,0,11
1136619,23,13,1990,2,"female",526,355,208,39,76,20,40,19,36
1136636,60,7,1953,11,"female",2075,203,134,433,325,432,185,1,140
1136676,20,18,1993,4,"male",635,271,166,0,10,0,3,0,7
1136699,18,19,1995,5,"male",676,827,664,0,2,0,2,0,0
1136707,38,14,1975,9,"male",353,129,26,40,26,32,13,8,13
1136745,23,10,1990,8,"female",1427,359,86,0,8,0,8,0,0
1136807,101,10,1912,4,"male",472,260,93,0,0,0,0,0,0
1136809,22,16,1991,12,"male",1042,70,32,2,57,0,14,2,43
1136815,30,21,1983,7,"female",42,153,37,48,25,48,21,0,4
1136818,31,22,1982,9,"female",1496,107,59,212,438,212,183,0,255
1136858,22,1,1991,1,"male",13,11,8,0,0,0,0,0,0
1136908,24,13,1989,6,"male",934,320,115,4,24,4,15,0,9
1136925,19,16,1994,4,"male",541,393,330,0,6,0,2,0,4
1136942,34,10,1979,1,"male",244,1,0,0,0,0,0,0,0
1136965,51,2,1962,8,"male",881,80,41,0,0,0,0,0,0
1136975,26,5,1987,5,"male",259,58,46,111,9,97,6,14,3
1137016,27,3,1986,4,"female",536,669,441,203,83,203,37,0,46
1137035,39,27,1974,8,"female",1495,120,87,197,223,189,155,8,68
1137054,22,9,1991,10,"female",426,314,238,343,259,105,189,238,70
1137075,29,21,1984,7,"male",450,36,13,6,11,6,10,0,1
1137093,45,29,1968,5,"male",39,16,15,18,4,18,4,0,0
1137097,18,12,1995,3,"male",253,57,22,0,0,0,0,0,0
1137105,23,1,1990,1,"male",37,16,13,6,1,6,1,0,0
1137159,47,19,1966,8,"female",1325,332,220,3776,1966,3471,1728,305,238
1137164,22,6,1991,8,"male",333,29,13,1,20,0,4,1,16
1137165,28,7,1985,9,"male",268,44,18,3,1,3,1,0,0
1137199,50,15,1963,4,"female",406,17,10,52,11,0,3,52,8
1137218,57,16,1956,4,"female",645,58,30,78,33,0,2,78,31
1137233,74,7,1939,8,"male",1103,38,12,0,2,0,0,0,2
1137256,57,19,1956,5,"male",322,29,26,1,2,1,2,0,0
1137324,19,5,1994,1,"male",213,203,73,2,10,2,10,0,0
1137347,22,25,1991,2,"male",515,24,10,688,41,8,14,680,27
1137455,21,1,1992,1,"male",13,7,3,0,0,0,0,0,0
1137473,66,8,1947,2,"female",745,133,74,53,72,1,17,52,55
1137495,62,27,1951,1,"male",1498,305,172,694,557,407,336,287,221
1137497,55,29,1958,6,"female",420,51,0,1,0,0,0,1,0
1137511,23,10,1990,10,"female",914,221,79,23,132,9,67,14,65
1137536,16,25,1997,6,"female",215,204,87,17,3,17,2,0,1
1137542,54,3,1959,7,"male",835,108,44,96,6,73,4,23,2
1137546,103,6,1910,11,"female",1520,320,57,33,18,33,14,0,4
1137555,37,20,1976,4,"female",120,0,0,0,0,0,0,0,0
1137574,69,23,1944,8,"male",1213,64,25,1,1,1,1,0,0
1137577,22,17,1991,7,"male",629,520,452,2,0,2,0,0,0
1137626,38,28,1975,5,"male",769,78,35,0,0,0,0,0,0
1137627,19,2,1994,8,"female",123,79,27,13,69,13,57,0,12
1137639,16,22,1997,11,"male",370,97,55,16,0,16,0,0,0
1137645,20,21,1993,4,"female",204,305,43,176,195,176,151,0,44
1137683,53,15,1960,8,"female",227,41,30,9,19,0,12,9,7
1137688,108,4,1905,6,"female",1676,442,379,148,33,137,30,11,3
1137719,41,16,1972,8,"male",55,15,11,152,108,152,105,0,3
1137806,52,8,1961,12,"female",1254,132,52,10,14,10,10,0,4
1137837,33,26,1980,11,"male",542,79,56,15,2,15,2,0,0
1137841,54,22,1959,2,"female",529,76,31,1,6,0,3,1,3
1137853,28,1,1985,1,"male",41,13,12,0,0,0,0,0,0
1137855,33,24,1980,4,"male",548,77,21,3,1,0,1,3,0
1137862,27,11,1986,5,"male",970,76,47,8,1,8,1,0,0
1137877,26,5,1987,12,"male",75,27,7,1,4,1,4,0,0
1137948,55,1,1958,1,"male",220,38,31,2,2,2,2,0,0
1137949,42,23,1971,3,"female",1377,328,241,93,53,53,24,40,29
1137961,18,4,1995,12,"male",213,91,75,33,2,33,2,0,0
1137969,50,9,1963,9,"male",957,13,3,2,0,2,0,0,0
1138000,46,27,1967,5,"female",2312,262,162,223,261,214,160,9,101
1138007,33,5,1980,1,"male",563,64,58,100,4,87,3,13,1
1138024,19,26,1994,10,"male",701,338,209,315,447,312,401,3,46
1138046,20,3,1993,2,"male",329,204,162,43,1,0,0,43,1
1138057,50,11,1963,5,"male",418,3,2,0,0,0,0,0,0
1138062,35,3,1978,8,"male",802,71,34,0,0,0,0,0,0
1138098,17,5,1996,2,"female",433,241,204,34,32,12,27,22,5
1138099,17,1,1996,2,"male",207,43,31,2,8,2,4,0,4
1138160,26,22,1987,9,"male",286,138,122,62,9,0,1,62,8
1138170,38,10,1975,1,"male",474,109,106,57,1,57,1,0,0
1138217,43,4,1970,7,"male",149,21,17,0,0,0,0,0,0
1138232,69,15,1944,3,"male",1152,39,19,79,85,0,41,79,44
1138252,27,3,1986,4,"male",418,178,124,23,5,23,4,0,1
1138266,108,23,1905,9,"male",917,55,20,29,181,1,51,28,130
1138287,25,1,1988,1,"male",141,3,2,0,0,0,0,0,0
1138292,42,5,1971,12,"male",481,47,30,22,0,0,0,22,0
1138311,17,11,1996,5,"female",156,25,20,0,4,0,1,0,3
1138366,15,7,1998,9,"male",394,61,54,8,2,8,2,0,0
1138373,18,27,1995,1,"male",340,607,557,88,4,0,0,88,4
1138378,53,30,1960,11,"female",1127,450,272,2253,1344,323,736,1930,608
1138379,31,1,1982,8,"female",591,200,135,114,30,114,17,0,13
1138386,14,18,1999,10,"female",365,146,90,349,268,22,106,327,162
1138415,19,10,1994,4,"male",420,38,26,10,0,0,0,10,0
1138544,74,2,1939,4,"female",924,22,14,256,4,245,3,11,1
1138547,65,14,1948,1,"female",301,11,4,0,0,0,0,0,0
1138553,29,28,1984,3,"male",28,32,26,2,2,2,0,0,2
1138557,18,30,1995,12,"male",674,324,273,2,2,2,2,0,0
1138568,56,27,1957,5,"female",875,48,21,9,3,6,3,3,0
1138589,25,12,1988,3,"female",467,12,4,1,1,0,1,1,0
1138597,22,2,1991,10,"female",395,303,159,94,166,94,137,0,29
1138621,34,17,1979,6,"male",571,34,31,0,0,0,0,0,0
1138639,24,27,1989,9,"female",639,2,1,1,0,1,0,0,0
1138641,65,24,1948,5,"male",1459,60,20,2,35,0,15,2,20
1138647,23,15,1990,11,"female",358,35,14,3,6,3,4,0,2
1138655,33,23,1980,11,"female",397,31,20,0,23,0,10,0,13
1138706,50,19,1963,10,"female",176,49,27,36,44,0,15,36,29
1138708,32,20,1981,2,"female",657,46,35,19,15,11,10,8,5
1138719,33,26,1980,8,"female",418,245,148,817,487,35,80,782,407
1138741,25,7,1988,10,"male",324,107,85,1,1,1,1,0,0
1138743,37,4,1976,10,"male",236,7,1,3,0,3,0,0,0
1138762,42,1,1971,6,"male",635,9,5,0,0,0,0,0,0
1138773,88,1,1925,1,"female",1831,113,85,231,12,203,10,28,2
1138775,18,15,1995,10,"female",685,207,69,0,3,0,3,0,0
1138783,50,9,1963,12,"male",357,281,234,694,58,694,33,0,25
1138785,53,8,1960,9,"male",191,57,45,0,0,0,0,0,0
1138789,59,17,1954,7,"male",336,71,14,36,141,30,81,6,60
1138805,38,4,1975,5,"male",253,24,20,0,0,0,0,0,0
1138817,16,15,1997,7,"male",164,178,153,8,3,1,2,7,1
1138823,23,22,1990,5,"male",1194,395,312,6,25,6,17,0,8
1138829,21,2,1992,1,"female",430,349,317,497,168,159,139,338,29
1138856,103,16,1910,8,"male",429,135,118,6,4,6,4,0,0
1138883,21,8,1992,8,"male",939,208,156,3,19,3,19,0,0
1138929,22,24,1991,1,"male",420,228,177,8,18,8,15,0,3
1138931,20,17,1993,10,"female",359,52,2,0,0,0,0,0,0
1138938,106,7,1907,3,"male",1339,599,357,32,23,0,8,32,15
1138950,21,29,1992,5,"male",152,25,11,0,0,0,0,0,0
1138961,105,29,1908,2,"female",1658,46,30,8,7,0,5,8,2
1139009,15,2,1998,7,"female",277,249,104,6,3,1,3,5,0
1139015,49,25,1964,4,"female",331,172,128,5,4,1,0,4,4
1139040,19,5,1994,11,"male",177,30,22,1,0,1,0,0,0
1139054,98,18,1915,3,"female",836,90,39,107,59,0,20,107,39
1139076,49,14,1964,12,"male",185,10,7,0,0,0,0,0,0
1139097,16,29,1997,11,"female",300,694,305,438,569,374,284,64,285
1139107,43,2,1970,3,"female",1134,168,38,6,11,6,7,0,4
1139163,18,5,1995,10,"male",227,150,52,94,102,78,55,16,47
1139183,13,27,2000,5,"male",129,43,25,1,2,1,1,0,1
1139184,16,15,1997,5,"female",305,119,62,20,1,0,1,20,0
1139186,50,22,1963,1,"female",270,76,12,1,2,1,2,0,0
1139206,24,26,1989,10,"male",600,223,137,3,2,0,0,3,2
1139210,46,2,1967,1,"female",709,49,28,42,103,26,59,16,44
1139212,31,13,1982,8,"male",278,58,37,8,9,8,3,0,6
1139216,45,11,1968,12,"female",533,37,26,2,0,0,0,2,0
1139237,21,1,1992,11,"male",552,154,107,13,0,13,0,0,0
1139238,50,27,1963,4,"female",278,102,71,11,150,11,144,0,6
1139242,55,30,1958,11,"female",232,527,456,118,308,0,30,118,278
1139245,26,26,1987,8,"female",355,76,61,280,160,280,138,0,22
1139275,24,1,1989,8,"male",16,23,22,0,0,0,0,0,0
1139293,18,1,1995,1,"male",141,44,42,16,26,0,13,16,13
1139347,44,3,1969,2,"male",997,79,26,18,5,17,2,1,3
1139351,24,14,1989,10,"male",369,200,143,270,86,270,37,0,49
1139388,79,19,1934,3,"female",1528,79,38,39,20,0,1,39,19
1139418,48,26,1965,4,"female",356,60,29,54,54,54,13,0,41
1139474,25,12,1988,2,"male",701,170,146,14,13,14,11,0,2
1139487,34,28,1979,1,"male",654,11,9,0,0,0,0,0,0
1139493,39,1,1974,1,"male",383,15,12,9,3,9,3,0,0
1139498,18,14,1995,1,"female",425,2966,448,662,65,662,61,0,4
1139499,19,1,1994,3,"female",661,147,65,35,4,35,4,0,0
1139520,18,13,1995,2,"male",943,546,358,5,5,5,4,0,1
1139578,18,16,1995,11,"female",502,262,226,59,47,59,46,0,1
1139579,16,28,1997,10,"female",433,3617,927,338,9852,307,4830,31,5022
1139585,22,24,1991,10,"male",226,41,27,23,32,0,13,23,19
1139595,104,1,1909,10,"female",13,35,15,9,2,9,2,0,0
1139607,18,1,1995,10,"male",136,369,321,261,73,222,66,39,7
1139649,78,5,1935,12,"female",1515,73,38,44,122,1,81,43,41
1139688,55,28,1958,8,"male",414,1,0,0,0,0,0,0,0
1139702,103,4,1910,11,"male",2106,119,56,4,132,2,56,2,76
1139711,20,4,1993,3,"female",590,116,33,65,14,65,11,0,3
1139740,56,16,1957,10,"female",432,65,35,2,5,2,5,0,0
1139757,14,5,1999,2,"male",313,587,531,162,593,148,539,14,54
1139764,31,1,1982,1,"male",91,65,14,0,0,0,0,0,0
1139771,100,30,1913,3,"female",606,37,24,0,0,0,0,0,0
1139805,44,30,1969,8,"male",741,66,50,3,2,3,2,0,0
1139851,19,9,1994,12,"male",317,302,237,214,407,105,334,109,73
1139856,75,7,1938,11,"male",380,75,38,1,20,1,16,0,4
1139873,47,5,1966,3,"female",210,95,49,427,427,427,391,0,36
1139931,28,28,1985,12,"male",157,8,7,0,0,0,0,0,0
1139964,70,5,1943,9,"female",77,5,4,14,10,13,10,1,0
1139979,44,24,1969,4,"female",1299,101,46,204,28,204,16,0,12
1140004,80,8,1933,1,"male",1588,37,15,2,4,0,3,2,1
1140025,49,9,1964,11,"female",334,30,25,25,5,7,4,18,1
1140026,42,26,1971,3,"male",1700,52,12,0,0,0,0,0,0
1140049,25,1,1988,1,"male",280,1,1,0,0,0,0,0,0
1140058,45,12,1968,3,"male",237,15,13,0,1,0,0,0,1
1140091,60,30,1953,9,"female",1714,12,11,22,35,0,18,22,17
1140115,59,11,1954,3,"female",1586,22,10,1,1,1,1,0,0
1140127,22,3,1991,12,"male",400,43,19,4,20,0,12,4,8
1140140,29,1,1984,1,"male",624,125,84,0,1,0,0,0,1
1140144,18,22,1995,6,"male",69,17,16,3,0,3,0,0,0
1140155,14,25,1999,2,"female",279,316,180,783,284,754,129,29,155
1140194,61,1,1952,3,"female",283,454,332,319,174,114,127,205,47
1140219,17,3,1996,1,"male",496,208,123,334,17,334,17,0,0
1140237,66,2,1947,6,"male",178,12,12,3,0,3,0,0,0
1140246,27,15,1986,11,"male",394,30,25,10,0,10,0,0,0
1140257,23,13,1990,1,"male",435,662,555,130,97,130,87,0,10
1140259,27,8,1986,7,"female",443,50,4,0,0,0,0,0,0
1140274,59,23,1954,8,"female",285,158,147,6,17,4,7,2,10
1140328,24,22,1989,3,"female",844,65,35,124,154,11,25,113,129
1140330,20,3,1993,11,"female",495,362,43,172,653,172,516,0,137
1140354,18,8,1995,2,"male",615,29,8,4,4,4,2,0,2
1140360,23,5,1990,5,"male",66,800,221,38,40,38,35,0,5
1140371,20,14,1993,2,"male",547,56,39,7,3,7,3,0,0
1140372,24,24,1989,5,"male",183,33,17,50,25,50,25,0,0
1140382,65,11,1948,1,"male",1347,145,63,24,70,0,19,24,51
1140388,23,15,1990,10,"male",462,34,19,0,2,0,0,0,2
1140397,58,9,1955,1,"male",12,0,0,0,0,0,0,0,0
1140407,18,2,1995,2,"male",318,257,220,5,0,0,0,5,0
1140430,19,10,1994,8,"female",22,203,66,265,473,242,224,23,249
1140445,23,23,1990,8,"male",440,139,109,145,32,145,28,0,4
1140449,56,24,1957,10,"female",512,146,64,176,305,23,50,153,255
1140450,24,25,1989,12,"male",209,129,82,0,0,0,0,0,0
1140498,68,10,1945,3,"male",309,299,202,30,7,0,2,30,5
1140519,31,12,1982,5,"male",256,1,1,15,2,0,1,15,1
1140533,43,2,1970,2,"male",25,0,0,0,0,0,0,0,0
1140536,22,23,1991,10,"male",403,561,496,303,192,303,144,0,48
1140605,23,3,1990,12,"male",193,312,161,186,145,186,70,0,75
1140608,37,29,1976,11,"male",388,3,2,0,0,0,0,0,0
1140637,29,7,1984,3,"female",1304,281,73,668,543,578,281,90,262
1140668,47,12,1966,5,"female",669,29,8,0,0,0,0,0,0
1140670,26,1,1987,1,"female",338,105,56,10,11,10,11,0,0
1140675,33,9,1980,2,"female",1410,865,215,224,270,224,183,0,87
1140701,17,5,1996,5,"male",52,47,42,28,1,0,0,28,1
1140714,22,31,1991,7,"female",469,105,56,63,66,59,26,4,40
1140724,67,19,1946,8,"female",1028,34,13,79,22,0,13,79,9
1140781,22,18,1991,6,"male",65,2685,1832,507,3508,494,2994,13,514
1140783,17,17,1996,3,"male",132,1,0,0,0,0,0,0,0
1140787,36,12,1977,5,"male",302,89,75,0,2,0,2,0,0
1140804,13,15,2000,1,"female",175,402,239,241,61,241,60,0,1
1140861,16,1,1997,1,"male",57,32,20,8,3,8,3,0,0
1140897,18,1,1995,7,"female",621,202,70,11,11,11,8,0,3
1140908,27,12,1986,9,"female",1974,199,63,318,166,318,131,0,35
1140911,34,19,1979,1,"male",136,14,6,101,18,101,17,0,1
1140912,37,5,1976,2,"male",219,42,32,39,1,39,1,0,0
1140923,51,20,1962,2,"male",413,422,243,190,13,33,5,157,8
1140936,53,18,1960,3,"female",369,249,159,39,13,39,8,0,5
1140945,25,21,1988,5,"male",17,2,0,0,0,0,0,0,0
1140963,24,4,1989,8,"female",444,5,5,0,3,0,0,0,3
1140996,66,25,1947,3,NA,1622,50,26,20,26,19,19,1,7
1141034,20,13,1993,4,"male",277,5,4,2,0,0,0,2,0
1141064,16,31,1997,1,"male",95,205,186,16,13,15,12,1,1
1141068,100,26,1913,10,"male",287,151,74,612,1336,0,379,612,957
1141103,46,27,1967,12,"male",791,6,4,1,0,0,0,1,0
1141119,16,13,1997,5,"female",911,1442,907,225,513,98,213,127,300
1141125,28,7,1985,6,"male",484,47,28,71,43,71,34,0,9
1141138,19,1,1994,1,"male",260,112,88,7,5,0,1,7,4
1141139,19,27,1994,10,"male",221,50,37,1,9,1,5,0,4
1141147,22,13,1991,3,"male",309,151,84,8,4,0,0,8,4
1141171,14,10,1999,2,"male",517,16,13,115,37,99,36,16,1
1141183,51,27,1962,4,"female",371,66,26,83,125,83,28,0,97
1141185,25,17,1988,11,"male",214,149,97,3,11,3,7,0,4
1141216,33,1,1980,5,"female",727,10,2,56,5,56,5,0,0
1141239,14,18,1999,6,"male",0,0,0,8,4,0,0,8,4
1141258,17,14,1996,12,"male",631,316,168,134,131,133,51,1,80
1141289,25,10,1988,12,"female",485,145,91,1,1,1,0,0,1
1141301,58,21,1955,2,"female",864,44,19,1,8,0,6,1,2
1141305,27,31,1986,12,"male",93,132,114,6,65,6,18,0,47
1141321,31,2,1982,5,"male",424,374,288,89,68,83,50,6,18
1141326,51,22,1962,9,"female",1084,75,27,7,14,3,7,4,7
1141334,23,22,1990,10,"female",58,76,63,26,42,26,22,0,20
1141350,33,1,1980,1,"male",352,27,25,14,0,9,0,5,0
1141366,26,8,1987,2,"female",119,67,20,36,44,33,21,3,23
1141378,19,12,1994,10,"female",376,461,262,116,249,116,207,0,42
1141402,25,4,1988,8,"male",593,111,87,8,24,8,10,0,14
1141412,40,17,1973,4,"male",59,2,2,65,0,57,0,8,0
1141444,17,9,1996,10,"male",635,300,190,8,0,8,0,0,0
1141456,44,24,1969,4,"male",32,29,12,0,0,0,0,0,0
1141466,22,29,1991,7,"male",371,2,2,4,2,0,0,4,2
1141476,33,30,1980,4,"male",1167,122,78,2,1,0,1,2,0
1141479,53,5,1960,3,"male",902,19,9,0,0,0,0,0,0
1141484,28,16,1985,3,"male",1102,212,98,26,58,26,53,0,5
1141505,43,2,1970,2,"female",604,23,10,28,47,28,37,0,10
1141528,31,23,1982,8,"male",543,96,18,11,0,11,0,0,0
1141529,23,9,1990,2,"male",33,13,13,1,1,1,1,0,0
1141543,38,2,1975,8,"male",291,24,19,41,12,23,11,18,1
1141545,18,21,1995,1,"female",531,1075,506,156,289,156,259,0,30
1141576,15,19,1998,4,"male",554,210,86,0,0,0,0,0,0
1141592,14,13,1999,4,"male",328,266,185,1,0,1,0,0,0
1141611,94,14,1919,2,"male",2105,199,44,10,52,8,16,2,36
1141616,35,2,1978,10,"male",20,0,0,0,0,0,0,0,0
1141624,56,5,1957,9,"female",602,494,133,1,3,0,2,1,1
1141629,20,20,1993,9,"female",44,166,152,41,176,37,100,4,76
1141631,20,31,1993,3,"male",210,48,41,2,4,2,4,0,0
1141652,108,19,1905,4,"female",141,20,11,336,2,300,0,36,2
1141657,39,9,1974,11,"female",382,62,44,362,20,362,17,0,3
1141676,58,18,1955,12,"male",198,3,3,0,0,0,0,0,0
1141686,25,5,1988,4,"female",2050,498,292,161,145,161,126,0,19
1141693,47,11,1966,1,"male",592,491,393,2872,1135,2463,626,409,509
1141704,22,15,1991,4,"female",323,35,33,3,2,3,1,0,1
1141708,46,9,1967,5,"male",1130,101,44,3,8,3,7,0,1
1141710,14,2,1999,5,"male",337,298,215,381,4,20,0,361,4
1141742,25,12,1988,11,"male",699,64,23,6,8,6,2,0,6
1141792,28,30,1985,9,"female",652,36,19,8,30,4,11,4,19
1141803,23,8,1990,7,"female",267,230,119,347,479,236,69,111,410
1141807,67,23,1946,10,"female",1714,162,115,83,151,83,142,0,9
1141821,36,8,1977,1,"female",809,33,13,15,17,15,14,0,3
1141829,24,17,1989,8,"male",306,31,27,0,0,0,0,0,0
1141832,25,9,1988,5,"male",1166,287,170,597,95,592,53,5,42
1141870,22,4,1991,3,"male",362,215,85,0,0,0,0,0,0
1141875,24,5,1989,12,"female",505,147,38,38,66,38,66,0,0
1141889,103,14,1910,7,"male",575,338,281,100,34,100,34,0,0
1141897,39,10,1974,2,"male",237,89,75,1,70,0,33,1,37
1141972,18,13,1995,3,"male",183,26,11,54,4,54,4,0,0
1141979,28,1,1985,1,"male",749,93,74,0,0,0,0,0,0
1141988,15,20,1998,6,"female",409,1697,454,410,651,286,244,124,407
1142008,48,21,1965,6,"female",757,47,27,4,1,4,1,0,0
1142010,24,21,1989,5,"male",498,60,25,46,13,45,3,1,10
1142015,34,7,1979,3,"female",20,0,0,0,0,0,0,0,0
1142026,58,10,1955,5,"female",592,55,31,11,14,11,9,0,5
1142036,18,2,1995,12,"male",275,1,1,0,0,0,0,0,0
1142044,67,15,1946,10,"male",475,84,54,18,12,0,2,18,10
1142047,19,14,1994,6,"female",197,61,27,1,0,0,0,1,0
1142056,25,28,1988,5,"female",248,135,39,4,6,4,5,0,1
1142082,19,24,1994,3,"male",418,34,13,0,5,0,0,0,5
1142115,27,12,1986,2,"male",67,3,1,0,0,0,0,0,0
1142119,27,29,1986,12,"male",47,39,36,18,12,18,7,0,5
1142126,64,17,1949,7,"female",815,7,4,0,2,0,1,0,1
1142139,23,20,1990,3,"female",296,17,11,25,5,4,0,21,5
1142162,72,11,1941,10,"male",1484,21,2,0,1,0,1,0,0
1142180,18,20,1995,2,"female",1469,684,340,214,348,210,278,4,70
1142204,48,3,1965,11,"male",653,0,0,0,0,0,0,0,0
1142233,16,15,1997,3,"female",214,1782,453,638,1109,638,824,0,285
1142245,19,31,1994,10,"female",240,109,41,1,0,1,0,0,0
1142251,64,4,1949,6,"female",684,52,48,65,0,8,0,57,0
1142270,69,21,1944,7,"female",482,16,7,10,5,10,4,0,1
1142280,26,23,1987,2,"male",1131,538,279,132,13,130,9,2,4
1142302,23,1,1990,1,"male",502,2,2,1,0,0,0,1,0
1142303,39,14,1974,10,"male",278,113,55,10,19,0,5,10,14
1142314,28,27,1985,6,"male",933,43,28,331,335,329,273,2,62
1142324,33,29,1980,3,"female",336,0,0,0,2,0,0,0,2
1142339,74,29,1939,5,"female",798,42,18,0,2,0,2,0,0
1142355,14,25,1999,11,"female",340,297,108,282,95,282,81,0,14
1142413,94,9,1919,9,"male",676,244,190,7,55,7,51,0,4
1142426,55,20,1958,10,"male",702,34,11,0,0,0,0,0,0
1142429,28,11,1985,7,"female",296,269,69,69,220,69,189,0,31
1142450,18,1,1995,2,"male",171,75,50,6,14,6,14,0,0
1142451,68,15,1945,7,"female",1370,545,70,7,165,7,92,0,73
1142462,108,5,1905,5,"male",1734,454,284,146,94,146,73,0,21
1142468,47,3,1966,4,"male",1454,125,73,393,380,393,315,0,65
1142469,63,12,1950,3,"female",1751,63,29,429,170,128,48,301,122
1142494,42,9,1971,6,"male",133,5,3,0,1,0,1,0,0
1142503,27,21,1986,10,"male",239,363,350,9,177,9,145,0,32
1142505,16,10,1997,7,"male",395,436,313,0,36,0,2,0,34
1142515,30,18,1983,2,"female",719,144,70,35,145,11,69,24,76
1142530,33,13,1980,7,"male",207,7,4,0,0,0,0,0,0
1142563,50,23,1963,10,"female",1161,57,28,148,58,45,28,103,30
1142566,33,22,1980,8,"male",100,26,1,0,0,0,0,0,0
1142569,39,5,1974,5,"male",516,146,111,7,3,2,3,5,0
1142589,51,29,1962,6,"female",1265,3,2,0,0,0,0,0,0
1142604,41,5,1972,5,"male",14,10,7,0,0,0,0,0,0
1142630,32,15,1981,9,"female",174,214,175,381,182,381,174,0,8
1142635,19,31,1994,5,"male",545,1197,1037,41,59,37,43,4,16
1142647,44,5,1969,1,"male",330,11,0,5,21,0,14,5,7
1142659,29,27,1984,3,"male",398,16,10,2,0,2,0,0,0
1142672,48,24,1965,9,"female",420,113,80,53,89,53,20,0,69
1142685,65,6,1948,9,"female",886,34,14,3697,108,3515,65,182,43
1142718,16,30,1997,8,"male",223,27,16,1,3,0,0,1,3
1142737,53,2,1960,3,"male",477,163,112,9,9,9,2,0,7
1142741,16,2,1997,5,"male",205,91,68,0,0,0,0,0,0
1142748,50,30,1963,10,"female",465,327,284,21,20,21,17,0,3
1142761,31,2,1982,2,"female",281,168,133,283,159,283,92,0,67
1142768,13,26,2000,6,"female",125,74,52,43,152,34,92,9,60
1142776,31,13,1982,3,"male",581,57,32,7,0,7,0,0,0
1142830,54,7,1959,4,"female",607,13,8,26,6,11,2,15,4
1142834,21,10,1992,2,"female",31,4,4,17,8,17,8,0,0
1142861,15,15,1998,11,"male",0,0,0,0,0,0,0,0,0
1142895,21,4,1992,9,"female",1514,54,29,17,30,6,13,11,17
1142948,31,19,1982,3,"female",2023,456,129,237,854,204,717,33,137
1142982,27,29,1986,5,"male",340,50,41,0,0,0,0,0,0
1143010,41,22,1972,12,"male",387,102,85,11,15,11,9,0,6
1143012,27,6,1986,4,"male",195,265,229,36,21,36,19,0,2
1143020,16,29,1997,8,"male",78,49,44,9,5,9,5,0,0
1143040,16,24,1997,7,"male",831,1004,634,3,4,3,4,0,0
1143056,33,10,1980,9,"male",724,51,24,0,0,0,0,0,0
1143089,17,19,1996,1,"male",80,77,62,4,2,4,1,0,1
1143112,17,6,1996,5,"male",229,342,85,23,9,23,5,0,4
1143135,26,23,1987,4,"male",235,10,5,2,3,2,2,0,1
1143190,22,2,1991,5,"male",364,187,130,15,11,0,7,15,4
1143267,47,19,1966,4,"male",372,20,19,2,0,2,0,0,0
1143292,34,14,1979,7,"female",505,162,99,133,426,129,168,4,258
1143315,70,1,1943,3,"female",1130,24,7,1,0,0,0,1,0
1143318,14,19,1999,2,"male",473,285,161,186,69,186,18,0,51
1143366,17,29,1996,8,"male",608,215,182,0,0,0,0,0,0
1143403,49,14,1964,7,"male",305,82,39,1050,89,1050,60,0,29
1143405,56,2,1957,8,"female",1447,461,176,697,221,54,93,643,128
1143407,44,14,1969,10,"male",69,24,16,28,7,28,6,0,1
1143449,35,27,1978,8,"male",949,18,6,1,2,0,0,1,2
1143460,33,20,1980,3,"male",294,23,20,0,0,0,0,0,0
1143488,50,1,1963,10,"male",167,89,84,0,0,0,0,0,0
1143544,19,14,1994,2,"female",391,13,7,49,5,49,4,0,1
1143549,28,15,1985,5,"male",395,68,66,0,0,0,0,0,0
1143562,25,2,1988,2,"male",114,16,15,0,0,0,0,0,0
1143603,28,5,1985,2,"male",148,45,44,22,1,22,1,0,0
1143661,14,2,1999,12,"male",494,324,228,2,2,2,2,0,0
1143665,40,30,1973,9,"male",247,18,14,13,14,13,10,0,4
1143671,39,29,1974,10,"female",185,134,106,157,64,157,50,0,14
1143715,58,16,1955,11,"female",375,38,22,1,0,0,0,1,0
1143740,21,16,1992,9,"male",1226,333,176,0,1,0,1,0,0
1143757,19,21,1994,6,"female",188,17,11,0,0,0,0,0,0
1143763,42,27,1971,3,"male",286,20,15,2,0,0,0,2,0
1143777,61,19,1952,8,"female",472,34,28,4,2,0,1,4,1
1143780,24,24,1989,6,"female",567,23,15,1154,183,709,11,445,172
1143783,46,15,1967,6,"female",308,79,63,1,15,0,9,1,6
1143789,30,8,1983,1,"male",1922,351,222,1,13,1,10,0,3
1143814,30,8,1983,11,"male",308,647,603,0,0,0,0,0,0
1143836,35,2,1978,5,"male",41,0,0,0,0,0,0,0,0
1143853,23,1,1990,1,"female",119,14,14,7,1,7,1,0,0
1143862,54,3,1959,5,"male",137,10,7,1,0,1,0,0,0
1143874,28,17,1985,7,"female",948,28,19,0,0,0,0,0,0
1143889,32,28,1981,8,"male",642,118,61,337,354,337,278,0,76
1143931,61,16,1952,1,"female",22,30,17,17,28,17,11,0,17
1143965,18,15,1995,6,"male",728,2609,2085,251,283,248,246,3,37
1143993,103,1,1910,12,"male",2328,531,459,210,299,0,249,210,50
1144000,24,17,1989,12,"male",505,125,82,46,8,46,7,0,1
1144010,13,26,2000,8,"male",54,44,34,0,0,0,0,0,0
1144025,20,28,1993,8,"male",371,176,156,0,1,0,0,0,1
1144037,23,9,1990,10,"female",294,243,225,6,14,6,5,0,9
1144044,24,6,1989,5,"male",480,13,13,0,0,0,0,0,0
1144085,21,1,1992,9,"male",98,42,41,30,11,30,11,0,0
1144101,31,14,1982,10,"female",380,118,59,141,268,10,76,131,192
1144112,19,14,1994,4,"male",517,110,97,0,2,0,0,0,2
1144123,26,15,1987,2,"male",363,100,93,55,0,55,0,0,0
1144145,86,16,1927,12,"male",2241,327,160,390,201,88,86,302,115
1144167,29,24,1984,8,"female",230,35,27,442,121,417,50,25,71
1144173,42,1,1971,9,"male",924,18,9,0,0,0,0,0,0
1144183,52,1,1961,9,"female",371,116,42,25,6,0,3,25,3
1144187,18,1,1995,2,"female",369,509,320,1305,1435,1144,1039,161,396
1144203,16,4,1997,4,"male",354,174,148,0,1,0,0,0,1
1144224,40,26,1973,5,"male",331,0,0,0,0,0,0,0,0
1144234,70,26,1943,2,"female",1082,505,289,114,121,106,74,8,47
1144238,20,19,1993,12,"female",570,157,114,4,10,4,10,0,0
1144249,39,1,1974,11,"female",279,64,38,175,153,175,116,0,37
1144287,22,26,1991,3,"female",508,1,0,0,0,0,0,0,0
1144294,28,17,1985,10,"male",1079,287,126,37,55,15,24,22,31
1144314,17,5,1996,1,"female",159,2003,173,49,946,34,863,15,83
1144344,58,8,1955,1,"male",1794,82,10,2,1,2,0,0,1
1144355,27,28,1986,12,"male",171,75,74,5,4,5,2,0,2
1144391,52,27,1961,3,"female",488,82,51,71,103,71,94,0,9
1144392,27,20,1986,9,"male",1112,64,49,0,0,0,0,0,0
1144400,23,10,1990,10,"female",632,281,163,131,124,127,112,4,12
1144405,14,17,1999,4,"female",371,361,173,116,145,61,62,55,83
1144408,16,5,1997,12,"male",472,25,10,1,0,1,0,0,0
1144431,25,7,1988,8,"male",272,42,36,561,34,561,26,0,8
1144475,54,5,1959,2,"female",1227,32,11,351,311,100,129,251,182
1144479,103,12,1910,10,"female",920,4119,36,41,505,0,247,41,258
1144529,23,5,1990,6,"male",214,12,12,9,110,0,37,9,73
1144533,30,17,1983,10,"female",466,29,6,8,1,8,1,0,0
1144612,15,3,1998,11,"male",318,51,20,0,0,0,0,0,0
1144625,28,10,1985,11,"male",779,34,23,53,52,53,45,0,7
1144635,37,20,1976,10,"male",52,63,57,61,68,61,56,0,12
1144638,36,3,1977,5,"male",344,35,24,1,54,1,49,0,5
1144646,55,16,1958,9,"male",1361,242,144,7,8,7,5,0,3
1144673,18,28,1995,12,"male",424,116,73,4,1,4,1,0,0
1144724,17,9,1996,5,"female",246,475,75,9,91,9,55,0,36
1144761,20,10,1993,11,"male",9,3,3,0,0,0,0,0,0
1144775,24,20,1989,10,"male",519,5,3,6,0,0,0,6,0
1144804,113,19,1900,10,"male",2268,377,169,338,181,229,164,109,17
1144806,20,15,1993,7,"male",1254,251,122,68,51,68,38,0,13
1144812,57,9,1956,8,"female",1424,92,38,120,120,50,34,70,86
1144820,52,28,1961,1,"female",1244,409,94,450,387,439,249,11,138
1144825,19,28,1994,4,"female",47,115,66,8,23,8,21,0,2
1144852,46,2,1967,11,"male",331,3,2,1,0,0,0,1,0
1144908,21,5,1992,5,"male",246,59,50,4,9,4,2,0,7
1144920,48,15,1965,11,"male",464,12,9,1,0,0,0,1,0
1144921,39,1,1974,6,"male",218,4,2,1,0,0,0,1,0
1144932,16,27,1997,11,"male",165,263,252,0,2,0,0,0,2
1144956,103,7,1910,2,"female",475,62,20,0,0,0,0,0,0
1144970,55,22,1958,12,"male",1091,65,56,28,38,24,14,4,24
1144985,33,15,1980,10,"female",905,213,127,117,230,48,121,69,109
1144987,47,16,1966,10,"male",814,31,8,10,44,0,9,10,35
1144997,42,15,1971,6,"female",468,0,0,0,0,0,0,0,0
1145002,56,1,1957,12,"female",732,89,27,582,163,0,59,582,104
1145013,57,29,1956,1,"female",295,10,8,784,235,0,4,784,231
1145076,22,19,1991,11,"male",317,82,55,19,9,19,9,0,0
1145091,102,1,1911,4,"male",1847,552,342,33,5,11,2,22,3
1145092,23,1,1990,1,"male",52,19,18,6,4,6,2,0,2
1145097,59,20,1954,10,"male",311,0,0,0,0,0,0,0,0
1145115,70,7,1943,6,"male",1258,39,14,37,2,37,1,0,1
1145162,67,5,1946,10,"female",1178,21,12,5,0,5,0,0,0
1145181,28,16,1985,5,"male",8,9,3,0,0,0,0,0,0
1145213,18,3,1995,7,"male",310,461,353,378,364,378,309,0,55
1145224,23,5,1990,3,"male",184,7,6,0,4,0,3,0,1
1145244,32,31,1981,3,"male",904,150,50,5,8,5,8,0,0
1145284,19,23,1994,6,"male",532,218,191,6,13,6,8,0,5
1145309,52,11,1961,12,"female",534,237,168,98,436,0,119,98,317
1145317,30,20,1983,9,"male",244,44,18,18,27,18,22,0,5
1145332,44,24,1969,9,"female",887,29,21,0,3,0,1,0,2
1145373,57,6,1956,3,"female",546,29,19,7,0,7,0,0,0
1145390,17,27,1996,1,"male",153,152,68,3,6,0,3,3,3
1145396,54,5,1959,9,"male",726,9,4,1,2,0,0,1,2
1145411,37,17,1976,6,"male",455,35,16,0,23,0,12,0,11
1145425,20,5,1993,3,"male",191,7,5,0,0,0,0,0,0
1145427,21,10,1992,4,"female",471,227,154,9,20,0,6,9,14
1145431,19,16,1994,9,"male",383,25,23,0,0,0,0,0,0
1145441,56,1,1957,4,"female",745,124,63,0,1,0,1,0,0
1145504,20,2,1993,7,"male",1200,65,55,91,76,65,58,26,18
1145506,34,22,1979,2,"male",201,71,43,13,1,13,1,0,0
1145540,22,1,1991,1,"female",233,131,58,0,0,0,0,0,0
1145545,67,11,1946,11,"male",934,71,42,5,0,5,0,0,0
1145546,32,11,1981,11,"female",749,696,453,1578,893,0,333,1578,560
1145561,58,10,1955,1,"female",352,150,91,101,79,95,35,6,44
1145580,28,23,1985,11,"male",347,27,14,0,0,0,0,0,0
1145588,26,28,1987,11,"female",551,56,21,20,38,0,6,20,32
1145596,30,9,1983,12,"male",547,1351,671,427,1504,204,551,223,953
1145616,20,29,1993,7,"male",835,652,360,2,5,2,3,0,2
1145691,20,12,1993,1,"male",245,79,50,477,53534,78,30387,399,23147
1145693,41,1,1972,4,"male",118,1,0,0,0,0,0,0,0
1145709,22,17,1991,8,"male",190,363,331,8,221,8,199,0,22
1145751,80,27,1933,3,"male",291,167,20,0,10,0,0,0,10
1145837,16,30,1997,4,"male",302,63,49,3,0,0,0,3,0
1145866,29,10,1984,2,"male",466,17,11,2,0,0,0,2,0
1145873,43,16,1970,3,"male",458,2,0,0,0,0,0,0,0
1145882,24,24,1989,6,"male",245,6,4,2,1,2,0,0,1
1145927,103,26,1910,4,"female",813,377,285,9,32,9,27,0,5
1145978,38,4,1975,3,"male",514,43,35,254,41,254,37,0,4
1146012,57,13,1956,1,"female",1403,76,39,203,135,203,75,0,60
1146020,49,12,1964,1,"male",1551,45,17,1,1,0,1,1,0
1146107,33,16,1980,10,"male",763,22,14,22,4,0,0,22,4
1146117,23,3,1990,12,"female",210,95,67,24,50,24,10,0,40
1146133,79,17,1934,6,"male",226,3,3,0,0,0,0,0,0
1146165,52,29,1961,4,"female",746,23,10,28,25,28,16,0,9
1146204,18,26,1995,8,"male",225,121,59,142,6,60,4,82,2
1146228,23,10,1990,10,"male",171,68,59,10,0,10,0,0,0
1146254,26,1,1987,5,"male",27,26,23,5,1,5,1,0,0
1146257,73,16,1940,9,"male",1299,71,38,0,0,0,0,0,0
1146278,21,26,1992,12,"male",455,348,259,124,134,92,76,32,58
1146294,25,1,1988,1,"female",62,4,1,15,8,15,8,0,0
1146299,21,29,1992,5,"male",626,74,31,2,0,2,0,0,0
1146305,20,5,1993,3,"male",39,12,11,2,0,1,0,1,0
1146317,23,13,1990,9,"male",232,73,39,0,0,0,0,0,0
1146318,51,12,1962,12,"female",174,11,3,5,1,5,1,0,0
1146342,22,20,1991,12,"female",501,30,28,11,0,11,0,0,0
1146372,30,9,1983,11,"female",421,72,43,0,0,0,0,0,0
1146390,57,10,1956,6,"female",294,11,5,21,1,21,1,0,0
1146412,31,18,1982,8,"male",752,149,103,74,145,74,108,0,37
1146414,53,21,1960,8,"male",474,119,101,27,314,27,67,0,247
1146451,71,23,1942,12,"male",1474,73,10,12,4,0,1,12,3
1146457,16,12,1997,1,"male",164,647,591,2,3,0,1,2,2
1146505,55,1,1958,1,"female",15,22,13,7,8,7,7,0,1
1146508,24,24,1989,4,"female",263,10,9,0,0,0,0,0,0
1146566,29,15,1984,2,"male",3,2,2,1,2,0,0,1,2
1146591,44,6,1969,4,"male",97,42,27,4,3,4,1,0,2
1146597,73,3,1940,7,"male",542,160,95,1776,337,100,133,1676,204
1146626,37,15,1976,1,"male",153,50,49,21,6,21,5,0,1
1146632,108,14,1905,11,"male",1580,941,399,641,88,492,16,149,72
1146640,19,28,1994,10,"female",522,75,47,0,0,0,0,0,0
1146645,46,16,1967,6,"female",688,85,36,11,3,11,2,0,1
1146663,22,8,1991,12,"female",342,38,3,0,0,0,0,0,0
1146688,18,11,1995,4,"male",198,236,41,57,181,57,76,0,105
1146707,44,17,1969,7,"male",56,3,1,0,0,0,0,0,0
1146715,19,24,1994,11,"male",32,28,9,37,5,37,4,0,1
1146735,28,13,1985,8,"male",979,288,15,0,3,0,1,0,2
1146740,33,5,1980,7,"male",459,69,52,7,7,0,0,7,7
1146761,20,3,1993,3,"male",400,94,64,5,4,0,0,5,4
1146781,26,15,1987,7,"male",447,57,3,0,0,0,0,0,0
1146791,19,15,1994,7,"female",193,338,164,1,24,1,16,0,8
1146804,68,14,1945,5,"male",55,43,28,3,1,3,0,0,1
1146819,25,21,1988,2,"female",520,204,62,54,94,54,79,0,15
1146828,52,24,1961,9,"female",1466,32,24,3,0,3,0,0,0
1146835,22,13,1991,7,"female",143,174,117,289,597,12,44,277,553
1146847,63,20,1950,6,"male",436,109,38,18,6,18,6,0,0
1146888,13,5,2000,2,"male",265,100,47,10,16,0,3,10,13
1146917,17,10,1996,9,"female",357,4654,141,1608,9592,1608,7068,0,2524
1146956,42,10,1971,1,"male",106,6,3,1,0,0,0,1,0
1146987,18,1,1995,7,"male",472,5,3,9,0,9,0,0,0
1146991,19,7,1994,8,"male",105,339,291,3103,377,3103,323,0,54
1147012,28,1,1985,1,"male",247,206,93,3,5,3,3,0,2
1147023,62,8,1951,12,"male",217,47,29,14,1,14,1,0,0
1147040,52,26,1961,2,"male",298,202,156,198,211,1,79,197,132
1147053,20,27,1993,7,"male",141,124,108,5,2,5,1,0,1
1147056,18,30,1995,4,"male",197,9,5,0,0,0,0,0,0
1147065,26,8,1987,12,"male",251,278,121,6,0,3,0,3,0
1147089,25,17,1988,8,"male",492,80,44,4,41,4,27,0,14
1147105,18,6,1995,12,"male",261,371,336,1,0,0,0,1,0
1147123,90,27,1923,7,"female",1691,516,365,111,6,107,6,4,0
1147148,62,16,1951,5,"female",1711,1012,475,525,79,0,17,525,62
1147159,103,10,1910,10,"male",622,39,34,24,6,24,6,0,0
1147169,38,25,1975,3,"female",868,105,49,54,115,54,101,0,14
1147187,59,19,1954,12,"female",342,20,12,0,0,0,0,0,0
1147197,36,7,1977,7,"male",61,12,10,4,5,4,4,0,1
1147232,22,10,1991,9,"male",425,198,111,10,2,10,1,0,1
1147238,28,21,1985,6,"male",565,799,739,10,6,10,2,0,4
1147254,94,1,1919,1,"male",1793,122,82,57,40,31,21,26,19
1147255,27,30,1986,10,"female",199,189,137,102,182,102,92,0,90
1147287,14,18,1999,5,"female",498,139,61,78,96,76,76,2,20
1147325,43,27,1970,8,"female",143,37,14,163,38,51,29,112,9
1147381,22,11,1991,12,"male",420,31,27,4,5,4,4,0,1
1147424,20,28,1993,1,"male",755,174,90,27,2,8,0,19,2
1147445,22,30,1991,4,"male",621,55,43,6,1,0,0,6,1
1147454,61,26,1952,7,"female",881,391,82,0,3,0,3,0,0
1147468,57,24,1956,5,"female",894,83,13,49,5,5,4,44,1
1147491,108,9,1905,7,"male",315,675,505,14,5,0,2,14,3
1147504,21,20,1992,4,"male",415,119,76,4,0,4,0,0,0
1147518,25,11,1988,2,"male",138,14,6,5,8,0,1,5,7
1147531,33,3,1980,7,"female",268,211,141,135,107,135,85,0,22
1147539,25,27,1988,1,"female",62,5,5,0,0,0,0,0,0
1147562,51,29,1962,3,"male",481,46,24,2,6,0,0,2,6
1147563,48,14,1965,2,"male",666,16,6,0,0,0,0,0,0
1147577,17,6,1996,2,"male",487,349,284,11,22,11,2,0,20
1147582,21,4,1992,3,"male",247,95,80,4,5,4,3,0,2
1147593,50,18,1963,11,"female",317,45,33,28,4,28,3,0,1
1147600,14,16,1999,4,"male",440,133,27,39,0,31,0,8,0
1147603,57,5,1956,6,"male",849,74,38,28,85,14,47,14,38
1147677,17,17,1996,12,"male",928,1385,193,8,22,0,21,8,1
1147692,76,3,1937,9,"female",1104,36,23,5,8,5,6,0,2
1147708,20,2,1993,5,"male",312,6,6,1,0,1,0,0,0
1147747,20,2,1993,9,"male",186,4,3,0,0,0,0,0,0
1147750,67,21,1946,1,"male",510,110,68,4,12,0,9,4,3
1147751,32,10,1981,4,"male",230,45,39,4,38,4,36,0,2
1147753,25,1,1988,1,"male",233,34,32,1,0,1,0,0,0
1147791,39,19,1974,2,"male",308,94,37,0,1,0,1,0,0
1147809,23,29,1990,1,"male",465,69,45,0,0,0,0,0,0
1147821,41,9,1972,3,"female",153,1,0,0,0,0,0,0,0
1147837,19,18,1994,10,"male",311,33,24,0,24,0,13,0,11
1147850,108,3,1905,6,"female",1788,70,14,6,1,4,0,2,1
1147856,30,24,1983,7,"female",381,127,98,24,0,24,0,0,0
1147880,67,24,1946,7,"female",1304,137,53,0,1,0,0,0,1
1147881,26,26,1987,2,"female",961,35,20,7,6,0,3,7,3
1147885,74,3,1939,6,"male",2257,172,84,45,48,26,28,19,20
1147910,25,4,1988,7,"male",130,105,86,4,0,4,0,0,0
1147932,18,1,1995,1,"male",620,1206,1002,2,2,2,2,0,0
1147983,17,7,1996,6,"male",249,334,206,0,2,0,0,0,2
1147997,39,1,1974,1,"male",161,2,1,0,0,0,0,0,0
1147998,58,29,1955,5,"male",1769,414,291,512,98,417,62,95,36
1148013,103,18,1910,10,"male",817,205,110,1,8,1,0,0,8
1148020,101,18,1912,9,"female",2061,4529,400,35,56,35,35,0,21
1148033,17,6,1996,11,"female",356,196,72,72,20,7,8,65,12
1148037,31,30,1982,6,"male",450,185,62,27,58,27,51,0,7
1148050,27,2,1986,2,"female",385,33,29,0,0,0,0,0,0
1148053,25,1,1988,9,"male",476,71,47,39,18,15,2,24,16
1148060,63,5,1950,5,"male",285,81,56,171,108,171,45,0,63
1148074,25,9,1988,5,"male",121,170,166,0,0,0,0,0,0
1148087,39,29,1974,11,"male",947,1729,589,10115,18110,9961,10735,154,7375
1148091,18,23,1995,5,"male",295,119,97,1,0,1,0,0,0
1148095,63,28,1950,1,"female",626,58,26,0,0,0,0,0,0
1148096,29,6,1984,6,"male",509,283,181,12,8,12,4,0,4
1148121,19,14,1994,6,"male",151,39,38,5,0,5,0,0,0
1148127,58,23,1955,2,"male",848,69,42,10,1,10,1,0,0
1148136,25,17,1988,11,"male",26,39,38,4,10,4,9,0,1
1148138,36,29,1977,11,"male",17,0,0,0,0,0,0,0,0
1148188,65,20,1948,6,"female",1215,96,21,14,52,14,42,0,10
1148194,60,16,1953,12,"female",1498,61,20,231,136,200,55,31,81
1148218,26,9,1987,12,"male",70,26,18,0,1,0,1,0,0
1148252,14,11,1999,8,"male",306,496,355,373,198,373,110,0,88
1148263,30,1,1983,7,"male",655,49,40,0,9,0,4,0,5
1148266,57,24,1956,1,"female",180,13,8,4,0,0,0,4,0
1148294,103,10,1910,11,"female",1339,522,88,252,364,252,127,0,237
1148315,64,3,1949,9,"female",1218,25,15,11,8,11,7,0,1
1148353,21,3,1992,10,"male",713,211,165,689,153,689,150,0,3
1148354,21,24,1992,2,"male",798,170,130,0,6,0,3,0,3
1148368,48,2,1965,4,"female",1820,45,22,348,133,338,69,10,64
1148371,17,1,1996,9,"male",30,21,15,34,19,27,15,7,4
1148377,13,30,2000,1,"male",131,39,28,0,0,0,0,0,0
1148386,18,23,1995,6,"male",254,191,146,338,271,338,233,0,38
1148439,66,22,1947,5,"female",1254,215,157,63,145,45,82,18,63
1148440,18,21,1995,10,"female",517,430,322,101,204,96,152,5,52
1148445,37,20,1976,7,"female",625,193,139,7,3,0,2,7,1
1148460,23,7,1990,10,"male",1029,42,27,0,2,0,2,0,0
1148483,17,25,1996,8,"female",748,103,57,0,3,0,2,0,1
1148492,33,15,1980,9,"female",334,341,16,0,2,0,0,0,2
1148507,23,22,1990,6,"male",233,14,4,0,0,0,0,0,0
1148517,26,4,1987,11,"male",384,3,1,0,0,0,0,0,0
1148527,47,20,1966,8,"male",823,69,64,40,20,32,13,8,7
1148531,58,1,1955,5,"male",21,66,14,49,35,49,28,0,7
1148541,26,1,1987,1,"male",520,549,446,22,115,22,81,0,34
1148590,59,7,1954,10,"female",1560,110,21,443,81,67,40,376,41
1148591,64,11,1949,6,NA,2103,68,28,3,155,2,84,1,71
1148615,32,17,1981,12,"male",387,9,5,0,0,0,0,0,0
1148637,18,15,1995,6,"male",437,303,252,26,28,26,13,0,15
1148676,39,21,1974,5,"male",1023,156,56,352,609,119,263,233,346
1148716,14,26,1999,3,"male",395,24,15,1,1,0,0,1,1
1148734,28,10,1985,12,"male",9,1,1,1,0,1,0,0,0
1148770,19,20,1994,7,"male",403,138,52,4,17,4,11,0,6
1148778,66,16,1947,2,"female",542,59,51,44,26,43,19,1,7
1148795,48,23,1965,3,"female",1201,175,72,69,126,68,63,1,63
1148807,29,22,1984,10,"male",391,35,14,0,0,0,0,0,0
1148815,15,2,1998,5,"female",289,532,341,116,445,99,326,17,119
1148891,26,2,1987,1,"male",639,76,35,0,0,0,0,0,0
1148901,24,22,1989,4,"male",558,68,33,1815,904,0,286,1815,618
1148929,20,8,1993,2,"female",161,309,135,2124,1007,2124,834,0,173
1148954,14,26,1999,10,"male",184,119,99,0,52,0,41,0,11
1148966,30,13,1983,9,"male",74,77,51,7,13,7,4,0,9
1148967,17,18,1996,9,"male",257,337,114,167,88,153,63,14,25
1148970,22,22,1991,12,"male",248,15,15,0,0,0,0,0,0
1148978,27,2,1986,2,"female",538,263,103,48,281,45,94,3,187
1148980,33,1,1980,12,"female",5,0,0,0,0,0,0,0,0
1148986,19,14,1994,8,"male",380,102,91,17,37,17,22,0,15
1148999,26,1,1987,11,"female",171,37,32,0,12,0,5,0,7
1149008,58,9,1955,12,"female",127,89,22,217,151,0,23,217,128
1149010,100,27,1913,7,"female",2168,46,16,40,43,40,18,0,25
1149037,48,23,1965,4,"male",1303,1014,616,12,11,12,10,0,1
1149040,23,12,1990,12,"male",813,506,363,41,53,6,19,35,34
1149045,18,21,1995,3,"female",476,68,47,8,1,0,1,8,0
1149083,15,11,1998,2,"female",406,248,165,11,32,5,21,6,11
1149113,20,15,1993,12,"female",1636,1297,611,38,124,20,96,18,28
1149123,23,5,1990,6,"male",266,24,10,9,13,5,9,4,4
1149137,46,9,1967,1,"female",215,3,2,0,0,0,0,0,0
1149147,27,11,1986,6,"female",317,339,271,453,438,229,251,224,187
1149157,18,1,1995,1,"male",194,225,178,0,2,0,2,0,0
1149168,17,21,1996,5,"female",486,310,63,59,67,6,19,53,48
1149193,15,5,1998,9,"male",497,265,202,1,6,1,6,0,0
1149209,98,7,1915,1,"male",1621,55,40,24,8,0,3,24,5
1149210,21,8,1992,3,"female",334,18,9,0,0,0,0,0,0
1149230,40,29,1973,3,"male",286,198,141,37,112,36,69,1,43
1149242,65,10,1948,12,"male",2211,42,13,2,6,2,5,0,1
1149248,21,5,1992,11,"female",534,164,92,35,25,31,11,4,14
1149264,58,27,1955,7,"female",268,41,18,2,1,1,1,1,0
1149274,26,1,1987,1,"female",12,9,4,0,0,0,0,0,0
1149275,20,24,1993,3,"male",563,103,60,9,7,9,6,0,1
1149300,49,23,1964,12,"female",1077,58,30,10,6,8,3,2,3
1149302,30,15,1983,4,"male",222,136,116,1,2,1,2,0,0
1149306,24,3,1989,5,"male",1123,0,0,0,0,0,0,0,0
1149340,21,4,1992,8,"male",387,52,23,2,0,1,0,1,0
1149378,103,15,1910,9,"male",864,348,247,5,13,3,9,2,4
1149396,20,13,1993,4,"male",347,216,156,16,12,16,9,0,3
1149415,20,7,1993,3,"male",168,349,342,30,10,2,5,28,5
1149418,70,1,1943,1,"female",965,194,127,136,61,136,52,0,9
1149443,24,4,1989,5,"female",2281,451,111,371,138,345,30,26,108
1149455,27,23,1986,4,"male",868,104,56,7,31,3,11,4,20
1149516,73,18,1940,2,"female",657,177,83,16,15,8,8,8,7
1149518,26,1,1987,1,"female",363,184,138,0,0,0,0,0,0
1149522,16,12,1997,6,"male",139,113,111,2,2,2,2,0,0
1149531,25,15,1988,12,"male",145,44,35,0,0,0,0,0,0
1149553,68,14,1945,2,"male",854,318,285,0,0,0,0,0,0
1149554,47,7,1966,4,"female",499,251,100,227,47,227,24,0,23
1149555,108,10,1905,5,"female",87,518,118,1,2,0,2,1,0
1149575,67,5,1946,3,"female",36,105,79,2353,801,0,181,2353,620
1149659,23,24,1990,8,"male",367,25,20,0,2,0,1,0,1
1149673,48,25,1965,11,"male",727,31,8,74,35,29,24,45,11
1149684,63,22,1950,6,"female",1432,45,14,10,1,0,0,10,1
1149722,108,12,1905,11,"male",1304,137,53,0,0,0,0,0,0
1149723,22,14,1991,4,"male",524,177,89,35,10,35,4,0,6
1149746,96,12,1917,12,"female",193,235,194,137,79,0,13,137,66
1149776,46,18,1967,8,"male",1405,30,23,0,0,0,0,0,0
1149793,60,9,1953,1,"female",555,656,316,623,937,49,209,574,728
1149802,23,3,1990,9,"female",172,137,71,0,0,0,0,0,0
1149808,108,11,1905,11,"male",102,118,93,1,2,1,2,0,0
1149823,64,10,1949,6,"female",1139,79,35,0,0,0,0,0,0
1149858,21,12,1992,7,"male",296,124,50,0,4,0,0,0,4
1149872,30,23,1983,3,"female",552,83,35,0,1,0,1,0,0
1149914,26,26,1987,9,"female",249,21,15,16,12,16,3,0,9
1149939,18,3,1995,7,"female",501,377,314,0,0,0,0,0,0
1149982,108,18,1905,9,"male",2306,472,74,41,43,41,37,0,6
1150021,20,17,1993,10,"female",5,62,41,32,22,32,7,0,15
1150077,72,9,1941,10,"female",141,0,0,0,0,0,0,0,0
1150079,30,1,1983,8,"male",714,108,76,0,2,0,2,0,0
1150082,43,4,1970,10,"male",435,5,3,0,0,0,0,0,0
1150088,38,5,1975,5,"male",545,23,15,38,3,0,0,38,3
1150106,17,1,1996,1,"male",133,229,210,226,38,192,35,34,3
1150110,20,14,1993,2,"male",766,114,46,41,26,22,11,19,15
1150133,25,11,1988,4,"male",89,11,11,3,0,3,0,0,0
1150162,69,23,1944,7,"female",296,36,28,15,5,0,2,15,3
1150166,30,8,1983,8,"male",377,41,30,18,23,7,18,11,5
1150180,31,6,1982,7,"female",140,17,3,0,0,0,0,0,0
1150184,54,1,1959,8,"male",873,256,21,87,16,0,9,87,7
1150195,22,7,1991,7,"male",528,261,116,6,27,5,7,1,20
1150200,46,13,1967,3,"female",794,332,225,2,0,0,0,2,0
1150214,23,4,1990,4,"female",1433,384,63,34,287,34,211,0,76
1150219,21,2,1992,3,"female",403,258,83,0,6,0,6,0,0
1150256,29,24,1984,3,"male",419,119,91,11,9,8,8,3,1
1150263,24,30,1989,12,"male",507,189,130,14,3,14,0,0,3
1150268,17,16,1996,5,"female",188,100,58,19,0,19,0,0,0
1150301,21,11,1992,9,"female",621,0,0,0,0,0,0,0,0
1150316,16,27,1997,7,"female",316,317,173,328,487,328,238,0,249
1150351,18,1,1995,3,"female",185,87,8,19,28,19,5,0,23
1150361,25,31,1988,12,"female",647,56,17,69,87,69,81,0,6
1150387,30,19,1983,6,"male",177,205,126,10,1,9,0,1,1
1150389,93,19,1920,2,"male",868,1122,266,372,570,134,377,238,193
1150393,37,26,1976,2,"male",298,153,95,2,3,2,3,0,0
1150398,74,5,1939,10,"female",169,63,46,165,103,165,85,0,18
1150403,52,14,1961,2,"female",406,0,0,0,0,0,0,0,0
1150432,71,9,1942,8,"female",1748,144,56,75,54,0,23,75,31
1150444,54,5,1959,5,"male",612,45,31,76,48,76,17,0,31
1150445,22,15,1991,11,"female",207,21,12,5,3,5,3,0,0
1150482,28,1,1985,2,"male",221,53,34,0,3,0,2,0,1
1150484,68,1,1945,7,"male",523,247,193,46,16,6,3,40,13
1150491,62,25,1951,6,"female",428,39,20,0,1,0,1,0,0
1150492,31,17,1982,6,"male",294,34,24,26,71,23,37,3,34
1150532,47,10,1966,4,"female",433,39,30,9,22,9,13,0,9
1150540,14,1,1999,1,"male",477,288,213,17,4,17,2,0,2
1150549,18,16,1995,6,"male",286,37,24,0,10,0,8,0,2
1150551,33,1,1980,1,"male",456,27,23,495,23,396,22,99,1
1150570,21,20,1992,4,"male",1145,531,366,24,44,24,27,0,17
1150578,43,10,1970,11,"female",25,3,2,15,7,15,7,0,0
1150596,33,5,1980,9,"male",392,179,122,510,119,504,88,6,31
1150658,36,15,1977,1,"female",307,16,13,126,93,68,62,58,31
1150662,16,27,1997,5,"male",441,962,854,2408,395,2408,300,0,95
1150663,62,20,1951,9,"female",1729,79,61,1700,42,1700,22,0,20
1150687,68,24,1945,2,"female",1033,436,364,5,16,5,11,0,5
1150703,40,24,1973,3,"female",267,3,2,47,0,0,0,47,0
1150712,55,9,1958,7,"female",271,82,52,55,11,55,10,0,1
1150717,52,24,1961,9,"male",1556,144,43,84,53,83,23,1,30
1150744,21,10,1992,9,"male",59,32,21,123,249,94,191,29,58
1150755,49,5,1964,4,"female",1334,120,62,237,160,163,118,74,42
1150761,35,15,1978,8,"male",155,42,38,1,0,1,0,0,0
1150783,70,15,1943,6,"male",139,14,12,4,6,4,5,0,1
1150785,59,21,1954,10,"female",1060,103,76,1,2,1,0,0,2
1150794,52,14,1961,1,"female",1642,460,264,643,1394,372,492,271,902
1150804,51,1,1962,3,"female",1220,32,10,13,7,13,7,0,0
1150845,25,3,1988,3,"male",351,109,69,84,119,84,101,0,18
1150861,23,7,1990,1,"male",278,66,35,0,0,0,0,0,0
1150879,108,9,1905,1,"male",1227,641,68,14,56,13,46,1,10
1150881,29,1,1984,4,"female",765,170,155,57,75,56,47,1,28
1150882,27,12,1986,5,"male",342,32,21,11,8,11,5,0,3
1150886,23,5,1990,9,"female",79,14,9,0,1,0,0,0,1
1150901,21,9,1992,10,"male",643,238,165,0,0,0,0,0,0
1150913,21,27,1992,11,"female",165,259,154,527,418,354,308,173,110
1150918,15,11,1998,1,"female",313,3707,530,740,781,68,222,672,559
1150940,38,22,1975,5,"male",569,0,0,0,0,0,0,0,0
1150950,15,23,1998,8,"male",421,217,126,45,11,28,6,17,5
1150954,27,3,1986,8,"female",113,44,33,17,115,17,104,0,11
1150960,18,23,1995,10,"male",508,88,48,1,8,1,8,0,0
1150961,23,1,1990,1,"male",179,9,6,1,1,1,0,0,1
1150965,19,6,1994,7,"male",586,42,29,0,4,0,3,0,1
1150974,53,26,1960,2,"female",338,67,50,1270,209,2,57,1268,152
1150988,21,29,1992,12,"female",656,47,24,238,92,237,73,1,19
1151036,17,4,1996,9,"male",374,244,71,29,131,29,73,0,58
1151054,68,12,1945,2,"female",1559,100,50,246,30,246,11,0,19
1151060,36,23,1977,11,"male",266,179,168,7,17,7,17,0,0
1151128,43,25,1970,4,"female",608,33,16,49,35,49,32,0,3
1151152,58,7,1955,4,"female",238,109,90,3,19,3,8,0,11
1151155,23,26,1990,12,"male",421,213,191,12,1,0,1,12,0
1151166,17,26,1996,7,"male",224,117,96,12,7,12,7,0,0
1151184,31,15,1982,5,"male",393,13,9,11,1,11,1,0,0
1151228,25,21,1988,9,"male",292,4,4,7,0,0,0,7,0
1151235,37,22,1976,4,"male",1209,258,85,5,0,5,0,0,0
1151244,34,24,1979,10,"male",128,5,3,0,0,0,0,0,0
1151335,38,6,1975,7,"male",466,1,0,0,0,0,0,0,0
1151374,27,1,1986,11,"male",92,30,23,10,18,9,6,1,12
1151393,19,7,1994,7,"female",643,494,229,109,192,109,182,0,10
1151413,15,7,1998,6,"male",416,169,155,0,0,0,0,0,0
1151424,33,16,1980,2,"male",183,71,51,47,3,4,0,43,3
1151464,21,5,1992,5,"male",755,697,621,10,35,10,25,0,10
1151466,31,14,1982,11,"female",736,31,8,157,57,157,43,0,14
1151488,20,6,1993,5,"male",336,83,49,0,0,0,0,0,0
1151513,17,18,1996,5,"male",206,16,14,0,0,0,0,0,0
1151543,25,7,1988,6,"male",130,12,9,3,0,3,0,0,0
1151556,19,25,1994,11,"female",142,70,63,36,60,36,49,0,11
1151564,19,20,1994,4,"female",344,234,110,40,128,14,74,26,54
1151580,20,23,1993,5,"male",69,128,117,3,4,3,4,0,0
1151582,64,3,1949,9,"female",138,22,18,24,7,8,5,16,2
1151596,40,1,1973,1,"male",283,106,57,650,290,37,74,613,216
1151682,23,26,1990,12,"female",785,188,32,17,5,17,5,0,0
1151688,27,14,1986,5,"male",319,53,22,8,0,0,0,8,0
1151704,21,26,1992,8,"male",24,39,37,11,25,11,14,0,11
1151722,46,28,1967,12,"female",292,37,15,193,40,193,19,0,21
1151745,25,21,1988,5,"male",387,48,35,0,2,0,2,0,0
1151771,47,25,1966,5,"female",548,66,26,4,7,3,4,1,3
1151773,19,21,1994,1,"male",802,492,369,554,93,522,84,32,9
1151780,22,25,1991,10,"female",286,109,60,118,150,112,24,6,126
1151797,26,10,1987,3,"male",206,6,3,1,0,0,0,1,0
1151802,28,1,1985,1,"male",794,204,168,0,0,0,0,0,0
1151808,30,20,1983,11,"female",485,124,99,74,157,53,108,21,49
1151810,65,13,1948,10,"male",59,38,35,11,1,0,0,11,1
1151818,19,17,1994,5,"male",587,1058,563,377,581,364,500,13,81
1151821,61,25,1952,2,"female",432,18,6,209,31,0,0,209,31
1151825,63,18,1950,2,"female",684,21,18,1,0,0,0,1,0
1151828,113,27,1900,10,"female",1534,470,158,60,177,51,97,9,80
1151829,28,12,1985,12,"male",612,105,82,0,1,0,1,0,0
1151836,63,18,1950,8,"male",172,26,10,0,0,0,0,0,0
1151847,39,23,1974,4,"male",230,59,43,6,9,4,3,2,6
1151850,36,21,1977,11,"male",243,102,32,5,41,2,33,3,8
1151879,29,2,1984,1,"male",447,16,0,56,14,56,12,0,2
1151900,54,8,1959,4,"male",212,41,21,6,24,6,18,0,6
1151911,22,1,1991,1,"female",386,296,89,2,39,2,31,0,8
1151937,42,6,1971,7,"male",729,189,23,1,0,1,0,0,0
1151954,17,16,1996,5,"male",175,139,111,0,0,0,0,0,0
1151984,16,12,1997,11,"male",383,89,47,31,4,3,4,28,0
1151997,61,11,1952,11,"male",940,2,0,0,0,0,0,0,0
1152022,32,15,1981,6,"male",721,532,514,0,33,0,33,0,0
1152030,38,7,1975,8,"male",612,8,4,0,0,0,0,0,0
1152042,30,28,1983,4,"male",1046,239,186,0,1,0,1,0,0
1152052,21,14,1992,2,"male",160,112,50,52,24,34,18,18,6
1152063,58,10,1955,10,"female",1358,26,10,0,3,0,0,0,3
1152067,56,16,1957,2,"male",751,16,7,0,1,0,1,0,0
1152071,28,4,1985,4,"male",159,9,6,0,0,0,0,0,0
1152080,29,17,1984,11,"male",278,210,152,68,103,32,71,36,32
1152115,22,1,1991,12,"female",472,413,303,107,214,107,167,0,47
1152120,44,18,1969,8,"male",734,66,19,46,28,11,23,35,5
1152125,30,20,1983,10,"female",537,76,16,132,45,132,43,0,2
1152135,23,3,1990,1,"male",646,212,115,443,770,443,664,0,106
1152161,36,7,1977,12,"male",239,8,7,0,0,0,0,0,0
1152168,67,9,1946,12,"female",1539,742,394,172,90,0,37,172,53
1152175,62,8,1951,9,"male",1179,61,44,0,0,0,0,0,0
1152207,28,1,1985,1,"male",663,9,9,0,0,0,0,0,0
1152216,28,2,1985,5,"male",625,2,1,1,0,0,0,1,0
1152243,28,15,1985,10,"male",622,58,27,1,0,0,0,1,0
1152244,31,30,1982,8,"female",196,29,18,0,0,0,0,0,0
1152246,22,24,1991,9,"male",830,1,1,1,0,1,0,0,0
1152253,25,31,1988,5,"male",359,246,39,1,2,1,2,0,0
1152258,40,26,1973,9,"male",754,105,68,23,3,17,1,6,2
1152266,41,17,1972,10,"male",94,20,17,0,0,0,0,0,0
1152278,24,17,1989,12,"female",212,34,13,117,1,117,1,0,0
1152311,31,25,1982,11,"female",1142,238,140,49,61,49,45,0,16
1152335,61,19,1952,7,"female",279,3,3,0,1,0,0,0,1
1152380,108,29,1905,8,"female",2641,320,158,155,202,138,143,17,59
1152407,33,16,1980,11,"male",694,1,1,0,0,0,0,0,0
1152457,46,20,1967,9,"male",652,58,6,162,20,162,16,0,4
1152494,15,25,1998,11,"female",221,597,320,196,138,196,93,0,45
1152506,50,12,1963,12,"male",290,195,84,14,19,2,7,12,12
1152522,71,21,1942,3,"female",1788,79,36,0,0,0,0,0,0
1152531,34,6,1979,5,"male",23,5,5,2,1,2,1,0,0
1152532,20,10,1993,1,"male",123,180,152,38,6,21,4,17,2
1152533,40,17,1973,2,"female",812,706,316,397,1100,389,507,8,593
1152544,51,16,1962,8,"male",438,0,0,0,0,0,0,0,0
1152546,61,11,1952,12,"male",573,333,296,643,114,642,66,1,48
1152555,16,20,1997,2,"female",234,74,68,8,0,8,0,0,0
1152569,28,4,1985,11,"male",684,404,129,14,77,14,69,0,8
1152578,22,30,1991,6,"male",924,154,86,16,0,13,0,3,0
1152595,21,23,1992,2,"male",506,1367,1198,314,124,314,115,0,9
1152598,57,15,1956,3,"male",278,2,2,0,0,0,0,0,0
1152600,22,1,1991,9,"male",458,58,36,69,14,69,9,0,5
1152638,53,10,1960,3,"female",655,59,34,176,184,176,129,0,55
1152647,20,27,1993,9,"female",412,108,27,248,171,46,34,202,137
1152662,26,22,1987,2,"male",83,112,93,0,2,0,2,0,0
1152676,49,19,1964,11,"male",347,6,6,0,0,0,0,0,0
1152681,25,1,1988,1,"female",13,44,38,3,6,3,6,0,0
1152696,16,4,1997,11,"female",121,396,48,60,46,53,7,7,39
1152708,15,18,1998,3,"male",432,106,59,364,15,349,9,15,6
1152719,32,4,1981,4,"male",574,47,41,8,3,8,0,0,3
1152728,18,22,1995,8,"female",624,1095,556,283,333,157,227,126,106
1152733,18,8,1995,6,"male",372,439,387,2,9,2,6,0,3
1152744,24,29,1989,10,"male",187,102,72,7,1,7,1,0,0
1152795,19,17,1994,1,"female",406,100,47,94,37,47,29,47,8
1152824,52,27,1961,6,"male",509,152,93,14,5,0,3,14,2
1152827,58,9,1955,12,"female",1396,284,245,583,314,166,272,417,42
1152850,54,28,1959,10,"female",106,12,6,7,2,1,1,6,1
1152851,31,16,1982,6,"female",398,21,14,100,20,96,7,4,13
1152883,19,28,1994,6,"male",135,217,154,7038,3479,5610,1030,1428,2449
1152904,17,2,1996,5,"female",510,1251,545,715,981,715,889,0,92
1152910,50,27,1963,9,"male",564,4,1,0,0,0,0,0,0
1152920,21,31,1992,12,"male",448,201,132,120,108,120,89,0,19
1152922,71,11,1942,11,"male",1321,70,32,0,0,0,0,0,0
1152931,24,28,1989,11,"male",338,362,95,105,629,62,343,43,286
1152949,17,26,1996,5,"male",318,722,652,52,166,52,129,0,37
1153000,54,12,1959,5,"female",235,18,5,0,0,0,0,0,0
1153023,45,25,1968,12,"male",958,87,20,61,4,0,1,61,3
1153040,54,20,1959,1,"male",575,53,39,1,15,0,7,1,8
1153043,56,7,1957,11,"female",93,106,45,74,47,0,22,74,25
1153046,33,7,1980,6,"female",334,133,61,4,1,4,1,0,0
1153085,20,1,1993,1,"male",1008,169,83,3,1,0,0,3,1
1153130,21,2,1992,4,"male",774,89,32,36,26,36,25,0,1
1153131,108,25,1905,7,"female",483,100,70,0,0,0,0,0,0
1153151,37,27,1976,7,"male",495,21,12,7,0,7,0,0,0
1153176,44,12,1969,5,"male",391,26,10,6,0,6,0,0,0
1153192,20,17,1993,2,"male",1201,221,98,0,0,0,0,0,0
1153196,71,25,1942,3,"male",1980,156,78,6,2,6,1,0,1
1153295,24,12,1989,12,"male",671,91,42,0,0,0,0,0,0
1153300,23,15,1990,9,"male",523,176,110,10,6,0,3,10,3
1153336,18,14,1995,9,"male",414,71,62,35,1,0,1,35,0
1153342,58,1,1955,7,"female",395,5,2,31,1,31,1,0,0
1153377,23,20,1990,10,"male",495,182,156,13,1,0,1,13,0
1153383,39,6,1974,11,"female",408,86,49,18,9,18,6,0,3
1153392,66,24,1947,5,"male",2148,66,45,8,3,8,3,0,0
1153397,33,1,1980,1,"male",224,0,0,0,0,0,0,0,0
1153409,46,7,1967,4,"male",412,95,72,7,2,7,2,0,0
1153429,49,20,1964,8,"male",748,36,27,15,4,15,2,0,2
1153444,39,15,1974,9,"female",1205,127,77,676,698,327,394,349,304
1153460,57,14,1956,1,"female",938,214,58,136,220,39,64,97,156
1153462,108,4,1905,1,"female",231,204,49,0,0,0,0,0,0
1153503,21,14,1992,2,"male",2304,591,179,2,1,2,1,0,0
1153528,19,18,1994,11,"female",778,1,1,0,0,0,0,0,0
1153531,63,15,1950,8,"male",175,69,45,5,1,0,0,5,1
1153563,105,11,1908,8,"female",1545,1421,226,25,39,9,19,16,20
1153587,18,14,1995,2,"male",1122,816,691,11,9,7,4,4,5
1153608,23,1,1990,1,"male",48,37,33,17,10,17,9,0,1
1153614,16,10,1997,7,"male",580,413,340,77,77,72,65,5,12
1153616,20,17,1993,6,"female",345,83,30,101,144,101,65,0,79
1153617,29,11,1984,4,"male",24,34,24,4,11,4,4,0,7
1153629,19,14,1994,8,"male",442,349,297,25,35,25,30,0,5
1153649,26,4,1987,9,"male",508,206,181,0,0,0,0,0,0
1153660,58,21,1955,1,"female",668,89,59,1497,1928,39,178,1458,1750
1153694,18,27,1995,1,"female",333,42,14,709,669,509,528,200,141
1153716,21,1,1992,6,"female",311,229,142,30,25,30,12,0,13
1153739,63,14,1950,3,"male",113,24,18,3,7,3,3,0,4
1153753,35,18,1978,10,"male",379,7,7,0,0,0,0,0,0
1153762,15,20,1998,10,"male",305,38,22,3,3,3,2,0,1
1153811,29,23,1984,2,"male",201,33,29,0,0,0,0,0,0
1153855,33,21,1980,5,"female",153,15,14,175,163,175,152,0,11
1153857,20,19,1993,8,"male",547,182,104,0,0,0,0,0,0
1153899,30,28,1983,9,"female",428,39,14,43,24,43,18,0,6
1153943,26,14,1987,3,"male",403,116,85,2,4,2,4,0,0
1153951,57,4,1956,4,"male",1108,196,107,408,327,158,254,250,73
1153969,25,29,1988,6,"male",193,120,118,3,1,3,1,0,0
1153980,89,19,1924,6,"male",492,3,3,3,0,3,0,0,0
1153984,52,10,1961,1,"female",1484,51,29,0,0,0,0,0,0
1154101,46,5,1967,1,"female",1744,927,573,2962,616,1352,259,1610,357
1154105,22,4,1991,7,"male",321,13,10,1,0,0,0,1,0
1154122,19,10,1994,9,"female",143,163,107,1097,591,514,246,583,345
1154126,108,29,1905,1,"female",1566,435,324,3,36,2,18,1,18
1154180,41,11,1972,7,"male",368,16,9,64,14,64,9,0,5
1154204,25,7,1988,3,"male",294,85,71,1,1,1,1,0,0
1154232,50,30,1963,5,"female",401,37,14,71,13,70,12,1,1
1154245,42,25,1971,9,"male",263,91,61,40,64,40,53,0,11
1154274,64,11,1949,11,"female",170,56,46,56,5,45,4,11,1
1154280,39,12,1974,7,"male",383,9,9,2,2,0,0,2,2
1154291,20,28,1993,9,"female",185,3,2,1,1,1,1,0,0
1154301,16,10,1997,8,"female",400,41,10,17,1,8,0,9,1
1154303,47,11,1966,12,"male",97,81,52,704,41,451,26,253,15
1154348,48,26,1965,6,"male",824,333,150,5,6,5,4,0,2
1154377,95,18,1918,1,"female",1524,1389,997,21,290,21,220,0,70
1154387,21,2,1992,4,"male",143,118,96,96,206,85,107,11,99
1154445,29,15,1984,10,"male",499,48,37,8,10,6,1,2,9
1154459,18,12,1995,11,"female",282,220,82,6,75,6,39,0,36
1154461,58,24,1955,3,"female",698,37,12,2,1,0,1,2,0
1154464,23,13,1990,3,"male",762,1,1,2,0,2,0,0,0
1154465,27,12,1986,7,"male",684,193,133,0,0,0,0,0,0
1154489,44,14,1969,10,"male",14,65,59,2,0,0,0,2,0
1154551,49,16,1964,8,"female",389,134,79,1,1,0,0,1,1
1154562,26,1,1987,1,"male",268,1,0,0,0,0,0,0,0
1154567,24,4,1989,2,"female",233,747,419,869,961,868,484,1,477
1154586,22,26,1991,2,"male",368,145,91,3,4,0,0,3,4
1154653,50,25,1963,9,"female",27,30,26,27,10,27,10,0,0
1154663,34,24,1979,4,"male",920,21,16,0,6,0,4,0,2
1154664,15,4,1998,9,"female",1151,1080,406,1775,1659,931,657,844,1002
1154673,19,6,1994,2,"male",291,226,137,19,2,4,2,15,0
1154690,55,14,1958,4,"female",471,48,42,0,1,0,1,0,0
1154695,69,25,1944,1,"female",1515,90,21,460,104,200,56,260,48
1154700,21,19,1992,11,"female",345,223,150,80,263,77,166,3,97
1154702,26,14,1987,9,"male",292,397,363,1,0,1,0,0,0
1154707,29,14,1984,2,"male",269,216,173,3,16,3,16,0,0
1154739,30,22,1983,11,"male",297,42,25,0,9,0,0,0,9
1154750,22,8,1991,1,"male",541,72,50,0,0,0,0,0,0
1154751,23,13,1990,10,"male",1485,696,389,2,55,2,48,0,7
1154765,19,20,1994,7,"female",551,1138,179,443,1019,193,252,250,767
1154775,15,4,1998,4,"male",527,30,9,3,1,0,1,3,0
1154815,57,22,1956,5,"female",60,106,71,81,128,81,46,0,82
1154819,28,13,1985,5,"male",77,40,24,146,202,146,63,0,139
1154826,14,23,1999,7,"male",172,1,1,0,0,0,0,0,0
1154882,14,21,1999,6,"female",311,156,92,43,1,34,1,9,0
1154900,35,4,1978,4,"male",333,128,108,94,120,94,89,0,31
1154922,28,23,1985,8,"male",302,1,1,0,0,0,0,0,0
1154926,21,1,1992,1,"male",66,9,8,111,17,85,16,26,1
1154940,27,2,1986,12,"female",638,45,19,19,11,19,1,0,10
1154945,44,18,1969,12,"male",468,26,4,8,1,0,1,8,0
1154952,64,30,1949,1,"female",579,119,83,5,2,0,2,5,0
1154962,59,2,1954,12,"female",376,41,33,1,8,1,3,0,5
1154972,50,19,1963,9,"female",1732,532,126,535,654,439,97,96,557
1155003,46,7,1967,3,"female",1555,555,101,796,1181,332,471,464,710
1155010,13,24,2000,5,"male",76,23,16,89,67,86,23,3,44
1155052,28,16,1985,7,"male",381,210,123,75,237,75,223,0,14
1155057,26,10,1987,6,"male",1047,442,244,32,46,32,35,0,11
1155059,51,17,1962,10,"female",645,345,104,351,264,0,102,351,162
1155074,19,14,1994,8,"male",464,519,278,8,18,8,11,0,7
1155113,35,1,1978,6,"female",1434,155,60,74,162,53,72,21,90
1155212,45,5,1968,7,"male",119,33,14,1,4,1,2,0,2
1155234,66,2,1947,4,"female",1686,382,185,151,307,151,169,0,138
1155253,16,24,1997,4,"female",539,638,511,704,404,685,343,19,61
1155331,62,7,1951,1,"male",326,11,5,1,0,0,0,1,0
1155348,20,12,1993,3,"female",618,438,167,134,317,134,306,0,11
1155382,50,15,1963,11,"male",726,142,45,698,227,493,69,205,158
1155384,68,7,1945,9,"male",543,495,399,11,10,2,6,9,4
1155398,18,5,1995,3,"male",220,22,13,0,0,0,0,0,0
1155418,21,1,1992,1,"male",31,12,12,20,0,20,0,0,0
1155421,20,23,1993,1,"female",457,569,358,247,283,247,149,0,134
1155431,17,20,1996,11,"female",104,212,66,114,63,112,17,2,46
1155437,18,27,1995,7,"female",678,369,206,2191,2083,1838,1206,353,877
1155441,108,15,1905,3,"female",2958,151,66,73,26,60,20,13,6
1155449,32,23,1981,5,"male",402,178,100,8,6,1,2,7,4
1155523,15,8,1998,4,"female",373,322,201,16,3,10,1,6,2
1155525,24,17,1989,5,"male",264,35,15,0,0,0,0,0,0
1155536,57,15,1956,6,"male",1258,31,15,11,7,0,4,11,3
1155539,24,26,1989,4,"male",548,48,1,0,2,0,1,0,1
1155562,106,24,1907,2,"female",1830,261,210,95,68,95,56,0,12
1155578,23,18,1990,7,"male",556,23,5,0,1,0,1,0,0
1155580,108,21,1905,12,"male",1710,565,309,72,89,0,44,72,45
1155587,68,29,1945,11,"female",312,8,6,0,0,0,0,0,0
1155596,35,25,1978,5,"male",532,35,22,48,31,48,13,0,18
1155608,14,4,1999,4,"female",282,119,74,0,19,0,17,0,2
1155656,23,7,1990,5,"male",378,1,1,0,0,0,0,0,0
1155660,18,16,1995,1,"male",218,174,75,0,12,0,10,0,2
1155662,24,15,1989,2,"female",58,0,0,0,0,0,0,0,0
1155663,52,25,1961,4,"male",147,83,57,41,11,2,6,39,5
1155677,23,26,1990,4,"male",344,194,78,133,23,129,21,4,2
1155699,16,23,1997,12,"male",411,260,70,90,76,86,58,4,18
1155706,17,3,1996,2,"male",315,133,20,3,70,3,17,0,53
1155710,28,26,1985,6,"male",427,46,40,0,1,0,0,0,1
1155745,19,11,1994,11,"female",386,448,78,223,365,223,245,0,120
1155758,18,21,1995,9,"female",858,284,107,2,56,2,50,0,6
1155761,24,23,1989,9,"female",569,81,54,54,22,54,9,0,13
1155766,18,15,1995,4,"male",261,202,136,0,0,0,0,0,0
1155773,72,9,1941,7,"female",4,1,1,0,0,0,0,0,0
1155776,18,8,1995,6,"male",713,229,166,1,1,1,1,0,0
1155785,20,6,1993,7,"female",682,956,635,172,122,123,73,49,49
1155813,47,22,1966,9,"female",727,75,45,92,218,92,87,0,131
1155878,77,5,1936,9,"female",1157,61,23,128,18,122,8,6,10
1155892,18,12,1995,6,"female",210,118,84,2,0,0,0,2,0
1155893,17,18,1996,7,"male",535,212,159,100,12,100,10,0,2
1155898,48,20,1965,8,"male",198,236,226,27,5,27,1,0,4
1155904,16,2,1997,12,"male",287,129,102,0,0,0,0,0,0
1155942,33,22,1980,2,"male",270,9,6,0,1,0,0,0,1
1155973,48,27,1965,11,"male",677,117,57,1,20,0,4,1,16
1155978,26,1,1987,1,"male",341,27,27,24,3,24,3,0,0
1155985,16,6,1997,3,"male",332,209,159,5,1,5,1,0,0
1155993,50,15,1963,1,"female",180,18,11,9,6,9,4,0,2
1156000,26,27,1987,5,"male",14,1,0,0,0,0,0,0,0
1156002,22,11,1991,3,"male",121,226,220,5,3,2,0,3,3
1156012,23,13,1990,10,"male",305,199,160,831,27,831,26,0,1
1156019,47,29,1966,5,"male",297,56,45,0,2,0,1,0,1
1156031,15,8,1998,1,"male",118,13,13,0,2,0,1,0,1
1156054,80,20,1933,10,"male",1143,101,52,154,352,19,60,135,292
1156057,44,13,1969,2,"male",437,217,5,477,556,68,144,409,412
1156072,19,24,1994,8,"female",380,845,473,1892,4056,1285,1535,607,2521
1156092,73,30,1940,7,"female",831,27,24,0,0,0,0,0,0
1156100,33,1,1980,1,"male",6,10,10,3,2,3,2,0,0
1156110,39,8,1974,10,"male",60,111,97,351,314,14,135,337,179
1156122,25,7,1988,6,"male",47,25,14,1,2,1,2,0,0
1156149,21,13,1992,12,"female",1735,209,97,310,152,284,118,26,34
1156161,108,31,1905,8,"male",1969,211,91,22,0,22,0,0,0
1156176,55,13,1958,1,"male",300,76,59,40,8,40,6,0,2
1156183,100,27,1913,2,"male",69,58,57,8,0,8,0,0,0
1156207,18,6,1995,7,"female",586,469,203,155,199,119,127,36,72
1156219,19,1,1994,1,"male",254,157,85,0,3,0,1,0,2
1156253,17,16,1996,8,"male",384,261,212,2670,545,1122,269,1548,276
1156260,30,8,1983,1,"male",585,0,0,0,0,0,0,0,0
1156288,15,4,1998,5,"male",537,471,372,0,0,0,0,0,0
1156297,25,3,1988,4,"male",325,249,203,434,254,376,80,58,174
1156315,23,6,1990,9,"male",95,1,1,0,0,0,0,0,0
1156325,19,6,1994,3,"male",305,122,103,2,9,0,6,2,3
1156335,63,28,1950,8,"female",1277,117,98,5,0,0,0,5,0
1156336,16,26,1997,4,"female",54,31,11,20,0,19,0,1,0
1156340,24,16,1989,5,"female",491,892,189,1472,479,1472,301,0,178
1156342,56,6,1957,3,"male",775,132,94,13,8,0,5,13,3
1156360,25,26,1988,3,"male",418,48,31,8,0,8,0,0,0
1156361,97,11,1916,2,"male",1887,140,50,7,0,4,0,3,0
1156404,101,26,1912,2,"male",1837,299,173,389,138,322,87,67,51
1156423,51,19,1962,12,"female",829,58,37,9,1,9,1,0,0
1156437,22,30,1991,11,"female",444,123,83,0,0,0,0,0,0
1156473,26,3,1987,1,"male",265,47,23,1,5,1,3,0,2
1156502,18,17,1995,11,"male",674,273,165,15,8,15,2,0,6
1156522,43,9,1970,6,"female",621,188,101,268,55,268,46,0,9
1156523,23,25,1990,10,"male",1091,687,531,176,88,176,71,0,17
1156531,25,13,1988,6,"male",598,5,5,35,16,0,5,35,11
1156538,31,24,1982,2,"male",126,0,0,0,0,0,0,0,0
1156541,64,9,1949,8,"female",1454,42,15,247,223,228,145,19,78
1156563,22,11,1991,6,"male",564,218,155,14,1,13,0,1,1
1156564,27,10,1986,4,"male",451,15,13,0,11,0,11,0,0
1156577,52,14,1961,3,"female",347,50,26,2293,183,2293,91,0,92
1156601,29,27,1984,1,"female",261,63,48,2,0,2,0,0,0
1156605,61,2,1952,1,"female",1963,219,139,11,43,4,19,7,24
1156620,15,13,1998,7,"female",226,28,11,1,2,1,2,0,0
1156629,28,14,1985,11,"male",552,566,538,0,7,0,5,0,2
1156637,22,17,1991,4,"male",277,261,201,25,11,10,0,15,11
1156639,20,31,1993,10,"female",186,7,4,0,0,0,0,0,0
1156644,21,6,1992,10,"male",65,28,23,9,9,5,7,4,2
1156669,19,27,1994,5,"female",240,76,40,6,15,6,10,0,5
1156677,20,1,1993,6,"male",14,6,5,3,5,3,2,0,3
1156715,54,4,1959,5,"male",557,73,64,17,4,16,2,1,2
1156728,108,16,1905,11,"male",12,6,4,7,7,0,0,7,7
1156757,19,4,1994,2,"male",386,93,28,4,3,4,3,0,0
1156765,48,28,1965,11,"male",480,31,11,137,72,137,56,0,16
1156793,48,16,1965,5,"female",383,98,54,254,121,254,67,0,54
1156800,18,16,1995,10,"female",520,424,248,87,143,87,76,0,67
1156815,104,9,1909,8,"female",1205,35,28,16,1,0,0,16,1
1156820,27,6,1986,7,"female",1675,920,117,134,71,134,60,0,11
1156825,26,15,1987,10,"female",151,31,17,6,39,6,31,0,8
1156835,35,3,1978,1,"male",1255,17,6,10,29,0,10,10,19
1156845,43,27,1970,2,"female",693,46,31,23,44,21,36,2,8
1156856,29,3,1984,12,"male",358,75,49,32,32,32,30,0,2
1156868,25,30,1988,10,"male",413,40,20,34,13,34,13,0,0
1156871,66,6,1947,7,"female",474,3,2,0,0,0,0,0,0
1156919,29,16,1984,10,"male",340,10,5,0,3,0,0,0,3
1156925,23,2,1990,10,"female",188,304,267,585,275,585,227,0,48
1156959,32,24,1981,5,"male",290,176,139,1,0,0,0,1,0
1156968,74,13,1939,5,"male",1028,1304,708,7074,975,3,548,7071,427
1156975,28,22,1985,7,"female",117,22,16,0,0,0,0,0,0
1156993,26,25,1987,5,"male",622,261,205,227,20,227,20,0,0
1157030,83,28,1930,10,"male",1399,86,39,1,1,0,1,1,0
1157060,39,10,1974,10,"male",253,34,17,1,0,1,0,0,0
1157100,56,9,1957,5,"male",77,8,5,1,0,1,0,0,0
1157105,103,7,1910,2,"male",1163,201,61,3,10,3,5,0,5
1157124,27,20,1986,10,"female",453,34,20,0,0,0,0,0,0
1157163,59,5,1954,10,"female",739,133,36,296,141,0,39,296,102
1157166,47,18,1966,11,"male",460,138,51,19,6,19,5,0,1
1157174,14,1,1999,1,"male",169,3311,493,98,109,98,93,0,16
1157188,26,21,1987,7,"female",778,92,28,162,140,123,89,39,51
1157190,67,24,1946,8,"male",372,375,180,22,11,1,6,21,5
1157195,44,10,1969,1,"male",906,80,40,14,11,0,7,14,4
1157199,19,18,1994,9,"male",385,159,129,256,202,171,94,85,108
1157229,30,23,1983,1,"male",506,130,48,10,4,9,1,1,3
1157250,23,13,1990,7,"male",374,112,67,0,0,0,0,0,0
1157264,108,8,1905,12,"male",1259,794,400,106,81,99,68,7,13
1157302,21,26,1992,9,"male",202,117,77,16,25,16,16,0,9
1157329,51,9,1962,8,"male",27,22,15,193,75,190,54,3,21
1157332,26,27,1987,4,"male",322,74,69,3,0,3,0,0,0
1157337,60,21,1953,12,"male",800,40,21,0,0,0,0,0,0
1157368,28,12,1985,3,"male",298,17,17,0,1,0,0,0,1
1157375,74,9,1939,9,"female",979,82,71,79,16,33,5,46,11
1157391,54,30,1959,5,"male",174,57,34,11,10,0,1,11,9
1157392,68,17,1945,8,"male",638,245,187,10,6,10,4,0,2
1157409,60,24,1953,7,"male",1983,182,103,21,31,20,19,1,12
1157424,78,16,1935,11,"female",1652,86,47,128,57,128,27,0,30
1157443,21,5,1992,6,"male",546,145,48,12,32,12,18,0,14
1157446,21,7,1992,2,"male",521,112,70,36,14,36,10,0,4
1157456,23,4,1990,5,"female",51,31,26,1,0,0,0,1,0
1157482,26,6,1987,3,"male",727,306,240,0,0,0,0,0,0
1157494,49,16,1964,5,"male",2290,217,67,74,230,49,151,25,79
1157512,18,19,1995,9,"female",623,761,513,899,558,899,462,0,96
1157520,19,2,1994,12,"male",255,79,58,12,6,3,4,9,2
1157564,25,11,1988,11,"female",864,12,7,0,0,0,0,0,0
1157569,32,28,1981,9,"female",198,4,3,0,0,0,0,0,0
1157580,19,17,1994,1,"male",590,110,73,31,20,13,10,18,10
1157610,102,25,1911,4,"male",848,258,149,21,15,0,7,21,8
1157627,108,29,1905,9,"male",1122,115,68,0,0,0,0,0,0
1157658,19,1,1994,4,"female",601,1156,209,213,1388,200,884,13,504
1157693,23,20,1990,12,"male",730,332,276,26,3,2,0,24,3
1157714,66,6,1947,1,"female",285,20,18,86,9,86,4,0,5
1157762,50,20,1963,12,"male",109,9,7,0,0,0,0,0,0
1157771,47,17,1966,2,"male",533,59,22,1,42,1,37,0,5
1157781,60,20,1953,4,"female",1000,115,35,776,31,576,26,200,5
1157786,42,25,1971,12,"male",626,282,198,2,5,2,2,0,3
1157787,63,18,1950,6,"male",135,35,20,18,6,18,2,0,4
1157789,54,8,1959,5,"male",1143,15,10,0,0,0,0,0,0
1157790,23,6,1990,11,"female",533,214,46,30,172,27,64,3,108
1157827,20,14,1993,2,"female",387,191,39,94,29,93,22,1,7
1157847,55,7,1958,6,"male",49,4,4,0,0,0,0,0,0
1157855,34,5,1979,2,"male",705,88,52,0,2,0,0,0,2
1157895,17,18,1996,3,"female",637,134,39,128,24,124,21,4,3
1157960,19,4,1994,9,"female",347,74,49,68,15,68,12,0,3
1157978,53,18,1960,10,"female",222,174,133,59,43,0,6,59,37
1157980,18,30,1995,3,"male",787,279,154,73,63,17,35,56,28
1158003,16,26,1997,7,"male",488,241,191,6,8,0,1,6,7
1158022,25,28,1988,2,"male",61,25,21,0,0,0,0,0,0
1158030,19,14,1994,12,"male",516,1126,894,2,0,2,0,0,0
1158045,38,6,1975,7,"male",643,36,25,8,0,8,0,0,0
1158047,18,13,1995,11,"male",397,267,40,3,45,3,21,0,24
1158051,43,1,1970,12,"female",275,39,31,1,1,1,1,0,0
1158103,23,9,1990,5,"female",100,779,664,658,549,639,280,19,269
1158132,19,19,1994,8,"male",539,68,43,0,10,0,1,0,9
1158163,32,29,1981,4,"male",300,48,16,0,0,0,0,0,0
1158220,18,24,1995,6,"male",241,547,503,4,0,4,0,0,0
1158230,23,14,1990,1,"male",337,1,0,0,0,0,0,0,0
1158234,20,8,1993,7,"male",1006,275,150,3,8,3,5,0,3
1158243,25,28,1988,11,"male",294,123,77,22,30,22,27,0,3
1158323,100,14,1913,3,"male",2273,559,205,121,167,121,131,0,36
1158357,23,2,1990,1,"female",481,14,6,0,0,0,0,0,0
1158386,25,5,1988,3,"male",1265,323,134,272,45,272,27,0,18
1158395,22,5,1991,4,"male",366,75,68,4,2,0,1,4,1
1158426,21,18,1992,3,"male",833,283,212,193,208,185,135,8,73
1158441,73,14,1940,4,"male",501,46,39,124,57,0,41,124,16
1158450,49,23,1964,9,"male",303,121,78,0,2,0,2,0,0
1158497,37,20,1976,7,"male",617,62,48,3,6,3,4,0,2
1158524,66,15,1947,10,"male",624,40,28,1,2,1,1,0,1
1158530,23,9,1990,5,"male",344,46,40,5,4,5,3,0,1
1158537,68,17,1945,8,"male",469,261,236,3,0,3,0,0,0
1158541,14,10,1999,5,"female",100,124,66,61,11,2,0,59,11
1158545,27,22,1986,2,"female",315,110,35,0,0,0,0,0,0
1158553,21,20,1992,10,"female",306,70,33,158,174,158,71,0,103
1158584,52,15,1961,2,"female",615,33,16,2,2,2,2,0,0
1158588,17,11,1996,10,"female",278,5,4,18,0,0,0,18,0
1158610,95,16,1918,2,"male",1146,394,188,144,138,17,96,127,42
1158613,19,24,1994,5,"male",135,106,98,1,4,1,3,0,1
1158633,30,22,1983,2,"male",208,254,169,5,4,5,4,0,0
1158672,68,18,1945,4,"female",10,23,9,5,0,5,0,0,0
1158695,32,22,1981,7,"male",447,115,73,0,0,0,0,0,0
1158737,22,17,1991,8,"male",31,76,64,15,7,15,5,0,2
1158782,16,23,1997,7,"female",224,370,254,604,618,604,453,0,165
1158794,27,15,1986,6,"male",65,92,80,162,11,135,0,27,11
1158797,18,12,1995,12,"male",341,649,372,37,45,2,9,35,36
1158834,67,10,1946,1,"male",167,79,72,2,0,2,0,0,0
1158875,30,29,1983,12,"male",510,91,45,1,0,1,0,0,0
1158880,58,4,1955,2,"male",961,199,69,0,0,0,0,0,0
1158893,17,1,1996,1,"male",192,44,21,3,1,3,1,0,0
1158918,25,14,1988,12,"male",251,56,36,0,0,0,0,0,0
1158951,66,2,1947,9,"female",511,22,14,38,7,38,6,0,1
1158952,29,23,1984,4,"male",326,54,41,35,92,0,1,35,91
1158990,25,1,1988,1,"male",33,0,0,0,0,0,0,0,0
1159027,19,2,1994,10,"female",179,272,79,625,300,482,246,143,54
1159031,15,3,1998,8,"female",290,60,42,24,11,2,7,22,4
1159053,75,29,1938,12,"male",461,32,14,14,6,0,5,14,1
1159065,28,1,1985,1,"male",98,34,33,15,2,15,2,0,0
1159078,19,26,1994,6,"male",527,920,504,128,100,128,65,0,35
1159082,34,12,1979,9,"male",146,21,14,14,9,14,3,0,6
1159108,26,1,1987,1,"male",214,68,53,0,3,0,0,0,3
1159123,21,9,1992,9,"male",95,142,56,57,21,57,17,0,4
1159141,43,25,1970,9,"male",718,73,40,15,4,15,3,0,1
1159181,13,20,2000,1,"female",581,412,252,1308,116,26,29,1282,87
1159214,51,16,1962,11,"female",470,16,7,3,0,3,0,0,0
1159217,33,10,1980,11,"male",396,105,78,311,142,311,119,0,23
1159224,23,24,1990,4,"female",222,228,134,33,42,33,23,0,19
1159236,17,20,1996,5,"male",517,2458,1710,484,716,481,660,3,56
1159280,21,22,1992,5,"female",177,328,205,289,270,245,154,44,116
1159292,23,25,1990,4,"male",503,169,121,1,0,1,0,0,0
1159297,32,3,1981,9,"female",251,48,36,0,0,0,0,0,0
1159298,22,27,1991,10,"male",491,33,18,5,8,0,2,5,6
1159312,18,12,1995,3,"female",383,195,184,4,1,4,1,0,0
1159317,52,8,1961,10,"female",248,36,8,3,6,0,0,3,6
1159319,21,10,1992,1,"male",287,220,190,0,2,0,1,0,1
1159400,14,29,1999,6,"female",369,753,563,414,122,33,18,381,104
1159404,34,2,1979,6,"male",773,1541,1175,2177,1295,2002,1120,175,175
1159429,14,20,1999,10,"female",102,82,62,5,8,5,5,0,3
1159432,102,6,1911,8,"female",2268,248,141,690,276,655,180,35,96
1159435,50,21,1963,9,"female",2169,294,174,974,1015,238,436,736,579
1159469,63,18,1950,11,"female",872,65,37,3,2,0,2,3,0
1159470,61,19,1952,11,"male",598,157,119,20,12,17,9,3,3
1159524,61,22,1952,8,"female",1770,199,138,217,145,195,68,22,77
1159528,15,10,1998,3,"male",798,208,53,55,27,55,24,0,3
1159543,53,9,1960,5,"male",524,94,53,35,43,0,7,35,36
1159545,31,10,1982,6,"male",339,125,53,0,1,0,1,0,0
1159547,33,1,1980,1,"male",68,10,7,0,0,0,0,0,0
1159624,21,7,1992,4,"female",1176,2207,965,2213,2138,550,684,1663,1454
1159626,29,6,1984,12,"male",259,58,42,0,1,0,0,0,1
1159664,17,23,1996,12,"female",24,68,62,4,5,4,5,0,0
1159665,19,11,1994,3,"female",274,1,0,0,0,0,0,0,0
1159691,35,3,1978,11,"female",116,49,31,77,91,68,35,9,56
1159693,25,3,1988,2,"male",361,260,213,89,157,89,133,0,24
1159710,72,29,1941,11,"male",283,25,24,0,0,0,0,0,0
1159714,35,5,1978,1,"female",860,704,64,582,461,582,445,0,16
1159718,58,20,1955,8,"male",1705,31,8,56,27,20,24,36,3
1159724,18,15,1995,11,"male",112,2,2,5,0,0,0,5,0
1159726,32,14,1981,3,"male",213,49,35,0,0,0,0,0,0
1159727,21,27,1992,1,"female",384,370,74,33,62,33,17,0,45
1159752,22,27,1991,1,"male",209,88,76,1,0,1,0,0,0
1159772,19,14,1994,1,"female",71,375,172,5704,1506,5704,1143,0,363
1159782,67,31,1946,3,"male",723,54,47,0,10,0,4,0,6
1159788,39,10,1974,12,"female",642,17,4,1,4,1,2,0,2
1159800,37,4,1976,8,"female",140,267,214,76,59,76,35,0,24
1159836,53,15,1960,12,"female",332,170,73,27,43,5,10,22,33
1159847,57,29,1956,1,"male",366,114,110,162,28,152,18,10,10
1159950,50,21,1963,9,"female",447,75,43,905,29,905,20,0,9
1159984,47,22,1966,5,"male",420,68,51,139,17,139,8,0,9
1159992,35,31,1978,3,"female",209,37,20,4,4,3,3,1,1
1160036,17,11,1996,8,"female",368,227,88,1,21,1,21,0,0
1160037,43,19,1970,7,"male",288,69,22,38,26,38,16,0,10
1160047,57,30,1956,9,"male",321,35,19,0,0,0,0,0,0
1160048,32,25,1981,5,"male",1169,125,52,2,0,2,0,0,0
1160072,13,12,2000,7,"male",163,24,19,3,1,3,1,0,0
1160095,23,26,1990,12,"female",371,96,80,43,27,20,10,23,17
1160103,21,20,1992,2,"female",381,743,636,118,60,111,32,7,28
1160115,66,26,1947,8,"female",1810,40,20,1219,340,1219,133,0,207
1160147,31,6,1982,10,"male",556,52,50,73,8,73,6,0,2
1160156,32,23,1981,1,"female",187,55,32,2,0,2,0,0,0
1160190,17,20,1996,8,"female",448,154,90,17,35,8,13,9,22
1160192,34,23,1979,9,"male",233,36,28,0,2,0,2,0,0
1160211,16,18,1997,4,"female",257,898,467,240,347,240,289,0,58
1160263,24,26,1989,6,"male",1049,212,98,7,1,7,1,0,0
1160284,25,29,1988,8,"male",56,14,13,0,1,0,1,0,0
1160296,61,31,1952,8,"female",553,44,24,1338,306,0,112,1338,194
1160313,24,14,1989,8,"female",520,44,30,101,152,2,21,99,131
1160396,43,20,1970,9,"male",798,280,166,210,100,210,63,0,37
1160433,27,15,1986,5,"female",243,34,15,0,0,0,0,0,0
1160446,33,24,1980,6,"female",1028,359,243,131,154,104,120,27,34
1160462,29,14,1984,8,"female",484,106,76,1,0,1,0,0,0
1160476,53,5,1960,5,"male",981,24,0,0,1,0,1,0,0
1160488,21,1,1992,1,"male",683,87,43,13,12,13,12,0,0
1160491,20,5,1993,8,"female",880,102,72,16,2,16,2,0,0
1160505,18,25,1995,11,"male",310,734,650,169,243,82,123,87,120
1160510,16,11,1997,8,"male",812,653,529,4,30,4,5,0,25
1160530,18,25,1995,7,"male",39,84,82,365,20,365,18,0,2
1160541,26,12,1987,5,"male",95,10,5,7,5,7,5,0,0
1160569,17,9,1996,9,"female",281,299,176,388,48,388,33,0,15
1160590,68,19,1945,8,"female",131,24,24,12,2,12,2,0,0
1160614,17,2,1996,4,"male",646,314,292,0,0,0,0,0,0
1160616,22,22,1991,11,"female",316,111,55,84,52,8,18,76,34
1160623,22,6,1991,2,"female",285,534,365,180,317,82,197,98,120
1160638,48,2,1965,9,"male",77,25,6,17,2,17,2,0,0
1160651,46,23,1967,8,"male",644,94,87,8,5,7,4,1,1
1160703,26,8,1987,9,"male",100,25,17,0,4,0,3,0,1
1160736,18,7,1995,8,"male",654,612,464,144,51,133,38,11,13
1160771,33,25,1980,1,"male",96,32,12,109,104,109,97,0,7
1160788,29,6,1984,11,"female",598,394,98,4366,5808,3795,2115,571,3693
1160909,15,14,1998,11,"male",306,265,245,0,2,0,1,0,1
1160927,23,21,1990,5,"male",1200,2211,1804,0,1,0,0,0,1
1160932,18,23,1995,11,"female",351,560,297,439,990,439,788,0,202
1160934,61,15,1952,10,"male",1826,44,15,10,7,1,6,9,1
1160935,17,10,1996,1,"male",141,334,307,7,2,7,1,0,1
1160949,18,24,1995,3,"female",613,918,356,555,659,160,225,395,434
1160953,35,3,1978,4,"male",1394,790,673,330,405,283,309,47,96
1160957,69,6,1944,10,"male",169,70,62,0,0,0,0,0,0
1160979,33,14,1980,6,"male",590,249,199,158,108,51,34,107,74
1160981,50,5,1963,4,"male",1103,12,2,0,0,0,0,0,0
1160989,17,25,1996,9,"male",442,194,142,1,0,0,0,1,0
1161023,73,24,1940,2,"female",1002,79,27,0,0,0,0,0,0
1161036,31,29,1982,7,"female",344,50,37,84,89,84,79,0,10
1161043,71,11,1942,11,"female",13,34,32,4,7,0,5,4,2
1161048,26,13,1987,2,"female",457,0,0,0,0,0,0,0,0
1161059,26,27,1987,6,"male",574,202,144,128,99,128,89,0,10
1161061,30,7,1983,4,"male",278,68,49,5,0,5,0,0,0
1161070,21,12,1992,1,"female",624,235,160,0,65,0,44,0,21
1161080,21,11,1992,3,"male",341,125,56,0,17,0,16,0,1
1161088,26,24,1987,6,"female",214,28,23,169,50,169,33,0,17
1161105,32,28,1981,12,"female",241,24,16,0,0,0,0,0,0
1161167,17,11,1996,10,"female",183,347,214,80,248,80,197,0,51
1161190,18,4,1995,3,"female",511,482,267,709,294,17,128,692,166
1161203,19,29,1994,3,"female",269,82,45,2,0,2,0,0,0
1161208,27,16,1986,3,"male",27,13,9,0,0,0,0,0,0
1161228,23,3,1990,5,"male",175,9,4,0,0,0,0,0,0
1161241,40,20,1973,5,"male",10,1,1,10,2,0,0,10,2
1161272,57,30,1956,1,"female",1695,289,168,1770,655,1280,253,490,402
1161317,40,5,1973,12,"male",568,5,0,0,0,0,0,0,0
1161334,16,23,1997,12,"male",1,4,4,0,0,0,0,0,0
1161348,66,17,1947,1,"male",1639,35,11,10,5,8,2,2,3
1161353,31,8,1982,11,"male",348,61,39,548,153,548,114,0,39
1161368,19,15,1994,10,"male",216,99,64,279,72,279,54,0,18
1161374,43,3,1970,2,"female",313,119,52,892,270,604,155,288,115
1161401,18,9,1995,3,"male",340,61,52,0,0,0,0,0,0
1161409,31,16,1982,2,"female",386,40,26,19,8,19,4,0,4
1161474,34,8,1979,10,"male",357,68,36,0,0,0,0,0,0
1161481,39,17,1974,10,"male",244,54,31,313,192,65,141,248,51
1161498,37,8,1976,10,"male",574,93,57,3,95,3,88,0,7
1161500,25,26,1988,11,"male",311,259,244,10,3,0,2,10,1
1161505,18,22,1995,6,"female",337,214,107,465,195,415,131,50,64
1161511,57,26,1956,9,"female",1309,54,31,124,9,123,3,1,6
1161522,44,10,1969,7,"male",223,56,34,5,0,5,0,0,0
1161535,32,6,1981,4,"female",496,122,92,51,0,51,0,0,0
1161547,27,31,1986,1,"male",189,12,10,1,1,1,1,0,0
1161553,92,5,1921,10,"male",1731,339,181,37,43,0,22,37,21
1161585,22,28,1991,3,"male",393,331,258,88,43,88,42,0,1
1161586,32,21,1981,7,"male",116,9,9,13,0,0,0,13,0
1161588,25,1,1988,1,"male",302,80,76,7,4,0,1,7,3
1161600,108,21,1905,10,"male",2116,150,127,5,36,0,9,5,27
1161632,33,22,1980,2,"female",758,93,42,0,2,0,0,0,2
1161636,18,20,1995,5,"male",267,103,59,0,0,0,0,0,0
1161651,43,19,1970,8,"female",1735,823,542,411,491,411,263,0,228
1161654,14,21,1999,8,"female",428,135,108,0,0,0,0,0,0
1161656,21,11,1992,12,"male",278,212,66,1,9,0,4,1,5
1161664,40,25,1973,8,"male",180,24,15,0,0,0,0,0,0
1161669,108,26,1905,3,"male",205,207,169,34,61,27,25,7,36
1161674,54,12,1959,8,"female",703,96,52,7,93,0,53,7,40
1161701,18,24,1995,3,"female",204,136,64,9,26,6,18,3,8
1161714,43,8,1970,5,"male",151,221,169,190,15,190,12,0,3
1161758,27,3,1986,1,"male",825,600,507,4,6,4,3,0,3
1161776,62,6,1951,10,"female",765,43,25,6,0,6,0,0,0
1161807,34,3,1979,3,"male",79,1,1,0,0,0,0,0,0
1161815,24,1,1989,5,"male",345,34,24,0,0,0,0,0,0
1161818,81,10,1932,2,"male",984,48,32,4,13,1,8,3,5
1161871,42,23,1971,8,"female",13,120,79,43,34,25,17,18,17
1161875,18,20,1995,7,"female",335,429,222,41,124,39,78,2,46
1161885,21,9,1992,7,"female",29,3,0,0,0,0,0,0,0
1161931,21,9,1992,6,"male",304,205,175,4,3,0,1,4,2
1161940,71,14,1942,9,"female",1614,160,81,301,160,301,107,0,53
1161951,19,18,1994,1,"male",192,133,95,31,29,29,23,2,6
1161957,19,7,1994,2,"female",630,226,168,478,430,429,176,49,254
1161962,18,6,1995,5,"female",131,74,28,158,49,158,40,0,9
1161982,54,5,1959,6,"male",430,91,39,80,52,0,13,80,39
1162002,23,13,1990,10,"male",186,224,181,315,24,315,10,0,14
1162008,16,3,1997,9,"male",244,27,21,6,3,6,3,0,0
1162010,23,23,1990,4,"male",514,654,568,46,30,41,28,5,2
1162012,18,24,1995,3,"female",185,116,26,6,0,6,0,0,0
1162023,19,13,1994,6,"male",106,29,25,2,2,2,2,0,0
1162034,19,1,1994,1,"male",722,1,1,1,1,1,1,0,0
1162037,24,25,1989,5,"male",1088,159,46,13,36,13,36,0,0
1162090,103,13,1910,4,"male",727,183,131,19,25,19,10,0,15
1162120,43,16,1970,7,"male",450,64,43,0,0,0,0,0,0
1162122,34,22,1979,2,"male",475,22,13,0,0,0,0,0,0
1162157,21,21,1992,11,"male",333,563,340,725,390,656,226,69,164
1162168,27,9,1986,8,"male",961,738,456,486,122,486,109,0,13
1162190,28,19,1985,3,"male",176,25,22,98,33,98,28,0,5
1162210,70,26,1943,6,"female",1137,55,14,4,29,0,7,4,22
1162228,24,5,1989,11,"male",1650,781,541,32,117,23,51,9,66
1162252,14,16,1999,5,"male",401,235,159,0,7,0,7,0,0
1162290,26,2,1987,12,"male",396,238,82,25,47,25,33,0,14
1162316,21,9,1992,4,"male",377,203,122,422,588,282,299,140,289
1162324,25,1,1988,9,"male",384,495,476,110,43,66,23,44,20
1162333,23,23,1990,10,"male",261,72,47,0,1,0,0,0,1
1162379,24,18,1989,2,"male",670,140,94,3,4,0,3,3,1
1162380,24,6,1989,12,"male",414,35,24,5,20,0,5,5,15
1162406,28,27,1985,8,"male",156,10,10,0,0,0,0,0,0
1162409,33,28,1980,4,"male",185,26,17,0,1,0,1,0,0
1162461,35,19,1978,12,"male",295,20,14,8,7,8,7,0,0
1162473,17,19,1996,3,"female",203,489,382,2223,2366,1494,1410,729,956
1162514,15,5,1998,8,"female",234,280,201,29,74,29,72,0,2
1162529,28,3,1985,3,"male",81,41,35,2,9,2,7,0,2
1162532,41,11,1972,5,"male",502,110,52,0,57,0,4,0,53
1162560,18,16,1995,2,"female",390,122,15,1,3,1,2,0,1
1162568,21,7,1992,5,"female",119,43,32,2,1,2,1,0,0
1162581,25,24,1988,5,"male",112,52,38,52,29,0,12,52,17
1162590,25,27,1988,3,"male",137,108,67,0,0,0,0,0,0
1162601,67,6,1946,8,"female",1805,144,97,10,2,9,0,1,2
1162607,17,14,1996,5,"male",276,228,106,1,1,0,0,1,1
1162613,48,23,1965,1,"male",327,94,84,53,29,53,22,0,7
1162646,50,19,1963,6,"female",346,9,5,0,0,0,0,0,0
1162654,19,27,1994,5,"male",190,37,36,0,0,0,0,0,0
1162669,16,10,1997,7,"male",151,340,280,81,23,81,21,0,2
1162698,55,28,1958,11,"female",181,30,8,46,0,46,0,0,0
1162699,56,25,1957,11,"male",617,42,22,7,0,0,0,7,0
1162702,62,13,1951,4,"female",1756,30,13,0,0,0,0,0,0
1162710,42,4,1971,5,"male",1044,14,5,0,1,0,1,0,0
1162734,39,1,1974,4,"male",390,292,206,3,33,3,28,0,5
1162745,69,27,1944,4,"female",809,34,19,105,8,105,6,0,2
1162753,19,1,1994,1,"male",40,24,19,0,1,0,1,0,0
1162759,21,14,1992,2,"male",344,230,28,0,0,0,0,0,0
1162762,24,1,1989,1,"male",577,197,82,690,433,690,374,0,59
1162771,23,23,1990,1,"male",679,2027,601,1280,9570,314,3811,966,5759
1162774,19,3,1994,1,"female",576,88,57,31,16,31,11,0,5
1162812,19,8,1994,5,"male",483,147,104,0,51,0,20,0,31
1162814,40,5,1973,4,"male",33,62,21,2,2,2,1,0,1
1162838,15,15,1998,10,"male",429,1,1,0,0,0,0,0,0
1162843,23,12,1990,9,"female",413,12,6,17,1,15,1,2,0
1162850,36,13,1977,2,"female",423,41,20,1,8,0,1,1,7
1162854,96,15,1917,1,"female",1354,39,21,97,19,71,3,26,16
1162860,65,25,1948,7,"male",606,401,305,74,20,19,5,55,15
1162869,50,14,1963,4,"male",333,194,146,131,28,131,9,0,19
1162870,26,21,1987,10,"male",567,54,35,57,6,57,5,0,1
1162897,19,4,1994,9,"male",831,306,49,0,0,0,0,0,0
1162901,23,6,1990,12,"male",192,127,98,46,9,33,7,13,2
1162911,80,8,1933,8,"male",1546,77,28,1,19,0,5,1,14
1162933,16,6,1997,6,"male",28,8,5,3,2,0,1,3,1
1162938,33,1,1980,9,"male",1682,315,31,15,67,12,47,3,20
1162961,72,30,1941,7,"female",1567,249,147,1227,390,1196,283,31,107
1162971,34,14,1979,11,"female",264,179,157,19,5,11,1,8,4
1163000,22,20,1991,3,"male",539,388,209,5,0,5,0,0,0
1163005,69,27,1944,3,"female",1267,38,25,30,4,30,0,0,4
1163008,17,4,1996,9,"female",392,1447,741,1932,2920,1925,1637,7,1283
1163048,49,14,1964,1,"female",155,64,46,18,0,16,0,2,0
1163071,28,23,1985,4,"male",269,152,126,0,75,0,73,0,2
1163081,21,5,1992,5,"male",174,212,197,6,30,6,24,0,6
1163100,23,21,1990,7,"male",478,330,258,40,70,40,60,0,10
1163101,33,16,1980,7,"male",432,1,1,0,0,0,0,0,0
1163102,33,6,1980,1,"female",278,62,36,94,241,40,142,54,99
1163114,25,22,1988,11,"female",724,55,35,8,13,8,9,0,4
1163167,19,10,1994,3,"female",250,120,99,4,10,4,7,0,3
1163194,52,29,1961,12,"male",696,23,9,0,4,0,3,0,1
1163226,108,22,1905,6,"male",1989,101,47,53,48,47,24,6,24
1163228,34,20,1979,9,"male",138,14,12,2,4,2,4,0,0
1163243,53,1,1960,9,"male",196,32,24,23,31,23,21,0,10
1163252,63,25,1950,11,"male",831,26,17,18,9,0,3,18,6
1163294,51,14,1962,2,"male",570,174,46,44,76,44,68,0,8
1163305,37,19,1976,7,"male",360,18,4,0,0,0,0,0,0
1163315,36,4,1977,1,"male",1363,3,1,0,1,0,0,0,1
1163321,20,3,1993,3,"male",472,91,73,0,0,0,0,0,0
1163324,57,26,1956,1,"female",555,24,17,11,20,0,13,11,7
1163337,26,28,1987,8,"male",259,26,21,214,16,48,1,166,15
1163345,25,1,1988,1,"male",849,190,123,330,617,222,227,108,390
1163366,16,16,1997,9,"male",236,93,90,1,4,0,2,1,2
1163372,28,23,1985,5,"female",508,74,35,17,37,17,11,0,26
1163392,39,28,1974,4,"male",2170,401,201,265,476,187,407,78,69
1163422,21,8,1992,4,"male",216,16,13,28,7,28,3,0,4
1163427,50,22,1963,9,"female",1334,283,94,189,124,189,98,0,26
1163454,27,29,1986,7,"female",308,105,55,21,53,16,28,5,25
1163467,47,7,1966,12,"female",2065,319,191,261,48,261,23,0,25
1163502,26,19,1987,4,"female",194,50,23,45,22,45,15,0,7
1163525,24,2,1989,1,"male",1152,588,261,0,0,0,0,0,0
1163542,34,18,1979,2,"male",478,309,273,5,15,1,4,4,11
1163553,20,16,1993,2,"male",238,11,11,100,3,100,3,0,0
1163579,19,8,1994,11,"female",290,372,122,63,426,63,279,0,147
1163652,21,24,1992,7,"male",535,226,141,13,5,7,2,6,3
1163688,79,1,1934,4,"female",311,45,37,1,0,0,0,1,0
1163690,27,2,1986,9,"female",919,168,84,73,114,65,95,8,19
1163711,25,6,1988,4,"male",274,47,36,0,7,0,0,0,7
1163712,42,6,1971,6,"male",824,58,48,23,2,2,1,21,1
1163715,51,23,1962,4,"male",334,28,28,103,119,103,112,0,7
1163716,18,16,1995,6,"female",447,341,96,187,907,179,355,8,552
1163723,108,7,1905,7,"male",78,28,25,0,0,0,0,0,0
1163730,16,17,1997,12,"male",90,41,34,3,0,3,0,0,0
1163745,22,16,1991,7,"male",487,215,140,41,12,41,10,0,2
1163748,43,30,1970,9,"male",1680,133,87,11,22,11,21,0,1
1163753,34,25,1979,1,"male",549,231,152,8,5,0,2,8,3
1163767,23,11,1990,1,"male",538,106,85,0,2,0,0,0,2
1163847,15,12,1998,8,"female",392,1,1,59,23,59,12,0,11
1163884,25,10,1988,11,"female",423,112,37,4,3,4,2,0,1
1163889,17,13,1996,1,"female",32,952,289,1340,5018,1186,3929,154,1089
1163892,17,28,1996,12,"female",201,48,32,1,0,1,0,0,0
1163893,42,1,1971,1,"male",293,34,9,0,0,0,0,0,0
1163943,28,18,1985,4,"male",636,244,136,15,109,15,52,0,57
1163964,81,20,1932,4,"male",1920,44,9,2,5,2,1,0,4
1163971,66,28,1947,5,"female",603,50,20,10,53,0,31,10,22
1163974,24,17,1989,6,"female",440,0,0,0,0,0,0,0,0
1163987,52,11,1961,4,"female",107,28,21,363,75,0,58,363,17
1163991,23,2,1990,8,"male",290,64,36,19,76,19,56,0,20
1163996,63,14,1950,10,"male",855,42,11,0,0,0,0,0,0
1164011,58,8,1955,7,"female",902,111,56,0,1,0,1,0,0
1164064,62,1,1951,4,"female",436,49,31,20,4,20,3,0,1
1164070,62,28,1951,7,"male",670,50,34,142,21,129,11,13,10
1164074,33,3,1980,1,"female",415,5,4,0,0,0,0,0,0
1164090,31,27,1982,8,"male",200,13,13,6,0,0,0,6,0
1164097,19,18,1994,5,"male",409,717,510,714,729,714,573,0,156
1164116,53,13,1960,8,"female",257,20,6,98,2,98,1,0,1
1164147,27,28,1986,1,"female",467,68,48,2,2,0,0,2,2
1164149,108,20,1905,8,"male",1139,1233,762,214,141,191,93,23,48
1164155,78,20,1935,4,"female",215,31,24,12,98,0,14,12,84
1164160,24,7,1989,7,"female",408,314,165,208,75,150,15,58,60
1164179,53,21,1960,2,"male",733,63,45,15,22,0,0,15,22
1164190,31,15,1982,11,"female",970,260,117,8,22,8,22,0,0
1164197,38,21,1975,2,"female",351,100,70,575,927,303,251,272,676
1164269,60,23,1953,8,"female",671,2,1,1,1,0,0,1,1
1164303,17,11,1996,4,"female",261,400,108,821,506,600,224,221,282
1164317,18,12,1995,6,"male",441,324,260,208,9,207,9,1,0
1164325,15,22,1998,7,"female",356,959,584,109,41,109,17,0,24
1164332,61,30,1952,11,"female",1752,1396,283,903,318,4,60,899,258
1164352,19,5,1994,10,"male",12,44,42,3,2,3,2,0,0
1164371,22,14,1991,3,"female",757,85,53,0,1,0,1,0,0
1164381,19,17,1994,8,"male",136,6,4,2,1,1,0,1,1
1164387,42,26,1971,5,"male",451,4,1,0,0,0,0,0,0
1164391,25,1,1988,1,"male",169,29,22,87,28,87,28,0,0
1164396,53,15,1960,2,"female",226,55,31,30,11,30,6,0,5
1164400,51,19,1962,6,"male",158,31,21,39,50,38,20,1,30
1164402,23,3,1990,7,"male",332,7,5,1,2,0,0,1,2
1164420,67,2,1946,10,"male",405,47,35,0,0,0,0,0,0
1164424,33,7,1980,3,"male",9,15,12,31,15,25,13,6,2
1164430,97,1,1916,1,"female",2036,667,211,18,10,0,6,18,4
1164453,23,1,1990,1,"male",50,23,14,1,0,1,0,0,0
1164493,33,25,1980,3,"female",221,291,169,46,72,46,30,0,42
1164528,28,12,1985,3,"male",497,5,4,0,1,0,0,0,1
1164537,70,30,1943,8,"female",1335,118,35,28,22,28,14,0,8
1164553,103,25,1910,5,"male",916,111,42,17,10,0,2,17,8
1164558,54,2,1959,3,"female",824,120,46,30,29,0,5,30,24
1164578,20,15,1993,8,"male",176,277,105,328,444,263,187,65,257
1164589,25,8,1988,7,"female",292,75,24,0,0,0,0,0,0
1164604,19,10,1994,1,"female",187,20,4,8,36,5,19,3,17
1164611,30,19,1983,2,"female",411,49,38,51,7,51,6,0,1
1164616,54,25,1959,7,"male",675,1356,1103,110,5,110,5,0,0
1164628,15,15,1998,10,"male",216,463,441,0,0,0,0,0,0
1164633,15,3,1998,7,"female",70,253,95,204,93,122,90,82,3
1164638,15,19,1998,7,"female",614,258,136,92,64,89,44,3,20
1164641,46,15,1967,7,"male",465,43,8,0,0,0,0,0,0
1164654,17,29,1996,9,"male",732,132,42,0,0,0,0,0,0
1164667,15,29,1998,4,"female",287,159,95,57,59,57,42,0,17
1164703,18,6,1995,10,"male",163,787,740,83,143,83,98,0,45
1164704,108,19,1905,1,"female",1650,229,77,78,28,34,14,44,14
1164711,23,29,1990,3,"female",1641,853,283,260,167,119,19,141,148
1164738,52,21,1961,9,"male",1333,72,30,7,0,7,0,0,0
1164750,108,10,1905,3,"male",1269,139,89,3,5,2,0,1,5
1164755,38,16,1975,10,"male",544,456,396,117,173,117,120,0,53
1164775,62,10,1951,8,"male",256,5,3,5,0,0,0,5,0
1164793,34,3,1979,3,"female",624,98,55,6,8,4,4,2,4
1164796,25,8,1988,10,"male",1186,1482,940,445,1303,127,412,318,891
1164806,17,1,1996,4,"male",1179,1865,1122,446,1879,212,994,234,885
1164818,21,10,1992,4,"male",345,323,104,234,63,234,58,0,5
1164821,33,1,1980,1,"male",749,4,2,0,2,0,0,0,2
1164828,14,1,1999,5,"male",169,18,17,2,0,2,0,0,0
1164840,47,23,1966,8,"female",400,53,37,10,29,0,3,10,26
1164855,23,9,1990,3,"male",437,149,58,15,7,4,5,11,2
1164858,25,1,1988,1,"female",147,43,32,128,16,128,15,0,1
1164859,24,25,1989,5,"male",149,14,11,0,0,0,0,0,0
1164870,15,16,1998,2,"male",531,18,9,2,0,2,0,0,0
1164877,23,18,1990,4,"male",554,130,113,1,0,1,0,0,0
1164884,29,5,1984,7,"male",404,4,2,0,0,0,0,0,0
1164907,103,23,1910,2,"female",1860,51,32,208,30,208,15,0,15
1164937,35,16,1978,2,"female",522,61,35,2,7,2,7,0,0
1164949,35,29,1978,4,"female",746,116,76,47,163,9,65,38,98
1164988,56,29,1957,8,"male",566,24,12,0,0,0,0,0,0
1164993,108,13,1905,5,"male",1118,473,232,121,17,20,11,101,6
1165004,68,6,1945,4,"female",1129,41,29,2,7,0,4,2,3
1165014,24,3,1989,2,"male",72,11,9,1,0,0,0,1,0
1165022,64,3,1949,4,"female",1850,1106,173,661,3031,644,2110,17,921
1165030,24,26,1989,11,"male",375,324,241,56,1,15,0,41,1
1165036,15,18,1998,9,"male",708,54,37,0,6,0,0,0,6
1165037,37,4,1976,2,"female",471,94,57,325,858,325,778,0,80
1165082,21,18,1992,10,"male",83,21,20,8,0,8,0,0,0
1165089,60,23,1953,11,"female",1629,46,11,5,0,0,0,5,0
1165095,43,11,1970,12,"female",122,3,2,0,0,0,0,0,0
1165104,29,3,1984,12,"male",719,122,34,2,0,2,0,0,0
1165163,21,19,1992,6,"male",1852,679,527,45,1,11,1,34,0
1165179,23,27,1990,7,"male",402,143,128,0,1,0,1,0,0
1165198,19,10,1994,2,"female",172,480,159,716,439,700,399,16,40
1165205,17,20,1996,10,"female",222,17,6,3,0,3,0,0,0
1165242,23,19,1990,3,"male",239,94,74,0,0,0,0,0,0
1165252,65,12,1948,2,"male",641,31,22,7,11,0,11,7,0
1165254,29,28,1984,11,"female",314,2,1,0,0,0,0,0,0
1165260,22,2,1991,9,"female",312,0,0,0,0,0,0,0,0
1165334,21,30,1992,8,"male",127,191,129,125,104,125,33,0,71
1165341,21,15,1992,10,"male",205,3,3,3,0,3,0,0,0
1165343,47,1,1966,8,"male",331,83,60,30,1,0,1,30,0
1165373,56,17,1957,10,"male",379,82,70,165,106,5,3,160,103
1165378,17,3,1996,7,"male",390,4,2,0,3,0,3,0,0
1165380,20,11,1993,8,"male",376,174,110,14,0,14,0,0,0
1165390,43,12,1970,8,"male",69,1,1,54,0,51,0,3,0
1165398,28,5,1985,6,"male",681,237,164,0,6,0,4,0,2
1165406,23,1,1990,1,"female",128,1,0,271,450,271,160,0,290
1165416,16,6,1997,6,"male",544,1,1,0,0,0,0,0,0
1165430,53,22,1960,11,"female",188,24,18,13,10,13,9,0,1
1165444,19,18,1994,11,"female",347,259,26,248,184,248,160,0,24
1165447,33,5,1980,5,"male",165,88,7,33,42,33,35,0,7
1165459,21,3,1992,3,"male",162,3,3,36,21,36,18,0,3
1165464,75,7,1938,6,"male",308,181,149,11,5,11,4,0,1
1165477,21,3,1992,1,"male",333,52,22,0,0,0,0,0,0
1165506,44,21,1969,9,"male",275,129,73,57,71,35,12,22,59
1165509,19,5,1994,3,"male",550,35,12,21,4,6,2,15,2
1165524,25,28,1988,11,"female",589,41,12,7,1,7,1,0,0
1165526,61,28,1952,1,"male",224,132,88,23,72,0,8,23,64
1165527,28,10,1985,7,"male",337,72,23,9,8,0,2,9,6
1165549,86,20,1927,12,"male",2154,559,286,43,8,34,4,9,4
1165558,68,17,1945,12,"female",736,56,35,6,15,6,12,0,3
1165562,35,17,1978,10,"female",27,60,59,187,130,187,101,0,29
1165580,28,2,1985,5,"male",477,159,83,58,10,58,7,0,3
1165581,18,15,1995,10,"male",184,308,243,0,5,0,5,0,0
1165621,57,29,1956,3,"female",1406,251,225,160,82,67,48,93,34
1165658,60,5,1953,1,"female",692,75,46,33,0,0,0,33,0
1165668,23,25,1990,12,"male",375,378,274,11,11,5,9,6,2
1165679,86,10,1927,1,"male",2186,345,197,75,65,0,18,75,47
1165703,74,4,1939,2,"male",1716,281,33,0,3,0,0,0,3
1165711,19,10,1994,11,"female",305,138,88,3,7,3,5,0,2
1165715,53,11,1960,9,"male",584,24,11,33,10,33,8,0,2
1165717,54,28,1959,8,"male",181,51,37,1,0,0,0,1,0
1165732,17,14,1996,12,"female",574,617,331,337,309,54,67,283,242
1165747,17,26,1996,1,"female",128,66,58,2,2,2,0,0,2
1165782,64,23,1949,10,"male",1629,59,16,12,20,12,12,0,8
1165788,16,20,1997,8,"male",164,10,6,0,0,0,0,0,0
1165860,41,23,1972,1,"female",757,405,336,593,472,209,291,384,181
1165867,30,19,1983,11,"male",144,271,198,83,12,10,3,73,9
1165877,61,26,1952,9,"male",414,35,23,0,0,0,0,0,0
1165890,55,8,1958,9,"female",851,175,65,882,301,882,279,0,22
1165925,38,27,1975,9,"male",152,0,0,0,0,0,0,0,0
1165960,50,23,1963,9,"female",215,8,5,4,1,4,1,0,0
1165964,24,22,1989,7,"male",635,154,112,327,32,31,27,296,5
1165980,24,6,1989,9,"male",550,34,28,20,52,0,8,20,44
1165987,42,2,1971,9,"male",111,1,1,0,0,0,0,0,0
1166005,58,19,1955,3,"female",1489,63,12,33,10,1,4,32,6
1166066,19,17,1994,11,"female",415,147,65,23,6,23,6,0,0
1166073,21,15,1992,12,"female",443,249,104,4,27,4,12,0,15
1166084,63,18,1950,3,"male",214,189,87,315,203,315,123,0,80
1166085,69,6,1944,7,"female",1236,34,18,17,2,15,2,2,0
1166139,14,21,1999,6,"female",37,17,9,0,0,0,0,0,0
1166181,69,27,1944,4,"female",311,48,19,207,7,207,1,0,6
1166196,46,31,1967,3,"male",92,47,35,190,132,45,16,145,116
1166210,35,14,1978,6,"male",272,18,9,8,0,0,0,8,0
1166228,19,23,1994,11,"male",825,1020,906,2623,1095,2623,758,0,337
1166271,60,26,1953,7,"female",208,86,39,32,41,0,6,32,35
1166305,66,6,1947,9,"female",1606,55,21,0,0,0,0,0,0
1166318,113,17,1900,10,"female",2413,158,58,184,137,129,90,55,47
1166332,15,20,1998,8,"female",211,336,185,96,335,44,103,52,232
1166339,19,13,1994,3,"male",539,45,37,0,0,0,0,0,0
1166356,25,14,1988,3,"male",27,51,48,0,41,0,38,0,3
1166412,20,24,1993,6,"male",264,203,153,11,3,11,3,0,0
1166421,94,29,1919,4,"male",1181,244,171,1,17,1,17,0,0
1166422,41,30,1972,6,"male",100,75,53,20,4,0,2,20,2
1166460,17,16,1996,9,"male",390,1,1,7,0,0,0,7,0
1166472,19,26,1994,3,"male",575,66,36,7,0,2,0,5,0
1166488,27,8,1986,8,"male",194,40,31,24,10,24,6,0,4
1166499,55,12,1958,1,"male",305,20,14,0,1,0,0,0,1
1166512,51,17,1962,12,"male",2075,192,147,78,171,48,108,30,63
1166516,108,27,1905,10,"male",1298,402,293,0,17,0,8,0,9
1166539,51,16,1962,8,"female",45,8,6,165,168,52,129,113,39
1166555,64,5,1949,3,"female",216,42,31,18,1,0,0,18,1
1166556,18,12,1995,3,"female",578,607,451,594,1320,584,1120,10,200
1166557,24,26,1989,10,"female",363,481,375,3295,4170,2831,3053,464,1117
1166559,25,13,1988,1,"male",88,17,17,3,2,3,2,0,0
1166612,49,8,1964,8,"female",824,39,29,191,69,0,3,191,66
1166614,20,27,1993,11,"female",1265,49,13,1816,181,1035,65,781,116
1166636,17,16,1996,7,"female",112,5,4,3,0,3,0,0,0
1166654,28,18,1985,5,"female",439,331,288,43,39,43,19,0,20
1166661,24,21,1989,10,"male",344,7,1,154,206,154,140,0,66
1166663,20,30,1993,11,"male",330,398,251,62,78,62,68,0,10
1166692,39,27,1974,12,"male",295,58,44,0,1,0,0,0,1
1166743,43,8,1970,7,"female",800,72,65,296,235,264,85,32,150
1166760,25,3,1988,2,"male",243,463,355,343,82,343,51,0,31
1166763,18,12,1995,12,"male",415,147,64,16,26,16,26,0,0
1166773,66,21,1947,11,"male",521,85,24,98,153,0,63,98,90
1166797,23,17,1990,8,"female",1081,22,1,0,0,0,0,0,0
1166799,46,4,1967,3,"male",446,1,1,0,0,0,0,0,0
1166808,72,21,1941,8,"male",1815,22,12,7,8,2,7,5,1
1166849,38,22,1975,9,"female",508,278,79,146,102,2,24,144,78
1166862,34,11,1979,3,"male",270,20,7,15,0,15,0,0,0
1166886,33,11,1980,11,"male",219,16,11,2,1,2,1,0,0
1166903,16,2,1997,12,"female",1307,177,120,423,157,35,108,388,49
1166905,50,11,1963,8,"male",355,301,186,187,247,0,15,187,232
1166915,15,14,1998,9,"male",169,70,57,3,3,3,3,0,0
1166932,20,7,1993,3,"male",165,214,184,100,86,65,46,35,40
1166938,50,15,1963,9,"male",337,27,22,0,0,0,0,0,0
1166951,31,7,1982,6,"female",116,24,11,1,0,1,0,0,0
1166974,26,22,1987,7,"male",741,8,5,5,5,0,1,5,4
1167033,83,31,1930,8,"male",1141,40,29,0,0,0,0,0,0
1167045,21,19,1992,6,"male",668,43,22,22,2,0,0,22,2
1167067,29,10,1984,12,"male",280,218,177,252,139,250,66,2,73
1167099,33,26,1980,7,"male",126,48,33,2,3,2,3,0,0
1167102,20,10,1993,7,"male",559,0,0,0,0,0,0,0,0
1167112,63,1,1950,3,"female",739,20,5,0,0,0,0,0,0
1167116,24,24,1989,8,"female",1247,226,77,6,25,6,23,0,2
1167125,24,26,1989,11,"male",1250,313,189,0,0,0,0,0,0
1167146,36,20,1977,10,"male",1093,75,32,63,229,63,211,0,18
1167149,19,25,1994,12,"female",731,468,161,38,9,36,4,2,5
1167173,33,23,1980,12,"female",84,118,98,167,17,167,17,0,0
1167180,18,15,1995,10,"male",439,133,42,2,1,2,1,0,0
1167183,58,16,1955,1,"male",662,3,2,0,0,0,0,0,0
1167204,21,31,1992,3,"female",287,321,223,2208,940,168,239,2040,701
1167209,58,4,1955,4,"male",882,39,27,0,0,0,0,0,0
1167211,63,25,1950,3,"male",906,27,12,2,7,2,7,0,0
1167214,18,21,1995,8,"female",94,140,125,13,13,13,10,0,3
1167233,22,15,1991,4,"male",380,601,396,281,455,158,306,123,149
1167234,14,28,1999,2,"male",283,524,256,55,61,4,26,51,35
1167248,21,10,1992,2,"male",492,175,114,12,1,12,1,0,0
1167249,73,28,1940,6,"female",1764,29,14,12,8,2,2,10,6
1167251,19,1,1994,4,"female",63,11,8,5,13,5,2,0,11
1167257,28,10,1985,10,"male",510,39,19,7,20,7,18,0,2
1167258,17,7,1996,8,"male",366,63,42,2,1,2,1,0,0
1167260,28,25,1985,3,"male",398,66,63,0,0,0,0,0,0
1167265,20,25,1993,8,"male",24,21,19,5,1,5,1,0,0
1167279,15,3,1998,6,"female",149,1524,585,958,4387,932,2323,26,2064
1167316,18,21,1995,4,"male",429,33,28,1,0,1,0,0,0
1167332,58,14,1955,8,"female",322,16,9,0,1,0,0,0,1
1167337,24,17,1989,3,"male",103,24,11,5,1,5,0,0,1
1167338,28,6,1985,5,"female",551,112,49,1,0,0,0,1,0
1167356,13,28,2000,9,"male",49,94,78,1,2,1,2,0,0
1167379,35,9,1978,1,"male",528,309,265,47,94,0,35,47,59
1167382,53,16,1960,10,"male",525,99,71,32,1,0,1,32,0
1167395,56,17,1957,6,"male",1806,42,18,3,1,3,0,0,1
1167405,42,23,1971,5,"female",71,82,68,411,437,411,269,0,168
1167424,14,1,1999,10,"female",430,436,271,679,211,140,125,539,86
1167427,64,14,1949,3,"female",1695,86,53,1,4,1,2,0,2
1167429,102,20,1911,2,"female",2267,198,119,46,9,26,6,20,3
1167450,65,8,1948,12,"female",289,54,30,24,3,1,0,23,3
1167481,39,23,1974,7,"female",267,98,40,226,43,226,43,0,0
1167489,54,14,1959,10,"female",311,70,38,1381,960,0,119,1381,841
1167496,36,8,1977,8,"male",209,63,35,3,3,0,2,3,1
1167507,34,27,1979,5,"female",300,271,228,622,297,365,88,257,209
1167521,34,23,1979,1,"female",325,28,13,0,5,0,4,0,1
1167528,108,5,1905,2,"male",1853,194,108,4,12,1,1,3,11
1167529,31,27,1982,8,"female",211,3,3,40,20,0,10,40,10
1167532,61,11,1952,6,"male",149,36,29,31,20,31,18,0,2
1167537,59,26,1954,7,"male",327,96,54,23,7,23,6,0,1
1167567,36,14,1977,3,"male",1018,276,216,31,143,31,127,0,16
1167601,21,10,1992,3,"male",423,137,67,54,2,2,2,52,0
1167618,27,6,1986,6,"male",342,52,44,1,1,1,0,0,1
1167635,19,3,1994,7,"female",418,482,285,133,68,93,46,40,22
1167639,26,1,1987,1,"male",126,281,272,35,46,35,42,0,4
1167658,19,5,1994,4,"male",366,315,177,338,36,0,13,338,23
1167664,64,21,1949,10,"female",467,2,2,0,0,0,0,0,0
1167674,29,13,1984,3,"female",551,3,3,9,0,9,0,0,0
1167739,48,27,1965,5,"male",333,88,58,1,3,0,1,1,2
1167748,14,9,1999,9,"female",131,47,18,3,4,3,4,0,0
1167795,41,5,1972,6,"male",10,3,3,41,2,41,2,0,0
1167808,16,11,1997,9,"male",260,62,48,2,1,2,1,0,0
1167816,18,12,1995,11,"female",199,1,0,21,41,21,27,0,14
1167856,22,18,1991,12,"male",427,103,91,23,30,4,11,19,19
1167861,15,19,1998,5,"female",806,30,8,12,3,6,2,6,1
1167868,48,17,1965,1,"female",517,74,37,152,148,73,63,79,85
1167882,43,12,1970,1,"female",499,0,0,0,0,0,0,0,0
1167894,29,21,1984,6,"male",391,11,7,26,18,23,18,3,0
1167950,33,26,1980,6,"female",540,103,74,22,82,22,39,0,43
1168000,83,14,1930,9,"male",772,254,194,87,37,87,24,0,13
1168009,28,10,1985,6,"male",422,248,102,36,9,17,2,19,7
1168020,31,29,1982,1,"male",262,55,31,20,2,0,1,20,1
1168049,37,27,1976,12,"female",749,6,3,7,4,7,4,0,0
1168067,20,8,1993,11,"female",263,122,86,36,76,25,31,11,45
1168091,18,28,1995,6,"male",979,240,135,2,2,2,2,0,0
1168112,28,30,1985,7,"female",140,25,22,53,24,53,13,0,11
1168120,61,2,1952,3,"male",1364,35,30,29,62,3,50,26,12
1168178,14,26,1999,1,"female",575,229,133,3,5,1,3,2,2
1168193,15,19,1998,4,"male",350,77,28,12,16,10,2,2,14
1168200,14,24,1999,2,"female",390,110,51,2,0,2,0,0,0
1168202,38,19,1975,10,"female",63,69,28,3,13,3,11,0,2
1168222,20,13,1993,8,"male",645,849,751,2,103,2,90,0,13
1168237,46,29,1967,8,"male",210,61,57,0,0,0,0,0,0
1168246,41,22,1972,3,"female",1954,227,80,61,656,61,389,0,267
1168264,27,1,1986,1,"male",410,94,16,0,5,0,1,0,4
1168276,29,12,1984,4,"male",710,174,114,32,11,32,11,0,0
1168279,23,7,1990,11,"male",133,1,1,0,0,0,0,0,0
1168282,27,26,1986,7,"female",488,4,1,0,0,0,0,0,0
1168291,60,14,1953,6,"male",250,51,47,1,0,0,0,1,0
1168299,29,1,1984,12,"male",368,46,24,119,5,119,4,0,1
1168359,19,29,1994,1,"female",824,515,429,561,170,511,112,50,58
1168362,24,21,1989,12,"female",499,193,116,379,97,365,38,14,59
1168408,29,13,1984,5,"female",925,619,364,44,87,43,74,1,13
1168414,24,20,1989,8,"male",80,28,24,0,0,0,0,0,0
1168415,55,9,1958,11,"female",581,223,156,374,72,0,14,374,58
1168462,25,2,1988,1,"male",367,379,357,0,0,0,0,0,0
1168471,47,24,1966,12,"female",411,279,174,90,400,37,104,53,296
1168476,39,26,1974,9,"female",20,52,36,361,95,361,45,0,50
1168493,52,10,1961,12,"male",377,8,6,0,0,0,0,0,0
1168494,26,7,1987,7,"male",697,151,83,467,394,466,210,1,184
1168540,62,25,1951,5,"female",1880,30,8,116,20,0,12,116,8
1168553,19,24,1994,11,"male",531,257,126,7,3,7,3,0,0
1168558,24,31,1989,10,"female",739,193,106,0,4,0,3,0,1
1168563,21,7,1992,12,"male",247,69,42,0,0,0,0,0,0
1168578,108,1,1905,1,"male",2026,111,4,4,2,3,1,1,1
1168582,108,23,1905,4,"female",176,32,21,0,4,0,1,0,3
1168593,23,30,1990,10,"male",597,109,78,82,26,82,3,0,23
1168601,27,20,1986,4,"male",516,66,33,12,44,11,27,1,17
1168606,47,27,1966,4,"female",278,46,27,0,2,0,2,0,0
1168644,25,5,1988,11,"female",603,16,11,6,0,6,0,0,0
1168654,27,3,1986,6,"female",282,53,41,42,72,42,72,0,0
1168705,15,19,1998,2,"male",71,23,20,0,0,0,0,0,0
1168723,16,8,1997,5,"male",5,30,30,0,1,0,1,0,0
1168733,20,21,1993,3,"female",135,18,16,6,1,0,0,6,1
1168745,57,14,1956,8,"female",283,85,71,25,29,0,4,25,25
1168753,66,14,1947,12,"male",694,287,143,230,206,230,165,0,41
1168767,20,16,1993,1,"male",766,1822,1594,2,0,2,0,0,0
1168786,103,21,1910,2,"male",1002,390,72,4,173,0,46,4,127
1168791,25,2,1988,5,"female",115,0,0,0,0,0,0,0,0
1168798,17,3,1996,7,"female",827,2413,580,81,1693,2,1408,79,285
1168802,103,9,1910,12,"female",1112,395,108,7,24,7,22,0,2
1168826,24,7,1989,10,"male",19,3,3,0,0,0,0,0,0
1168834,18,21,1995,3,"male",336,106,60,683,781,647,341,36,440
1168837,24,13,1989,12,"female",1838,60,9,265,152,265,92,0,60
1168852,32,14,1981,4,"male",289,51,27,0,0,0,0,0,0
1168861,22,9,1991,3,"male",571,119,46,27,23,27,13,0,10
1168893,20,26,1993,5,"female",518,39,27,158,8,158,3,0,5
1168913,55,24,1958,2,"female",141,9,4,20,10,20,9,0,1
1168916,58,12,1955,4,"male",18,29,18,19,5,19,3,0,2
1168953,22,3,1991,4,"male",274,55,30,14,1,13,1,1,0
1168954,24,5,1989,2,"male",320,293,210,0,1,0,1,0,0
1168975,21,19,1992,7,"male",573,1570,1443,413,92,413,53,0,39
1168992,15,5,1998,5,"female",395,166,63,11,46,11,42,0,4
1169061,16,26,1997,7,"male",666,216,162,8,10,2,4,6,6
1169101,33,13,1980,2,"male",257,72,31,5,29,5,16,0,13
1169143,20,12,1993,6,"female",423,67,26,0,2,0,2,0,0
1169166,58,26,1955,9,"male",763,158,46,8,1,8,1,0,0
1169195,36,3,1977,3,"male",1845,1,0,0,0,0,0,0,0
1169210,32,5,1981,4,"male",90,0,0,0,0,0,0,0,0
1169220,68,30,1945,12,"male",342,218,164,0,0,0,0,0,0
1169243,23,23,1990,10,"male",449,310,274,1,2,1,0,0,2
1169245,107,28,1906,3,"male",2311,797,275,8,4,0,2,8,2
1169248,21,10,1992,6,"male",317,84,56,5,2,5,2,0,0
1169269,25,4,1988,4,"male",340,133,99,2,0,2,0,0,0
1169338,27,16,1986,8,"male",711,20,20,0,0,0,0,0,0
1169348,16,26,1997,12,"male",209,178,155,14,1,5,0,9,1
1169351,24,21,1989,4,"male",185,36,11,9,5,9,4,0,1
1169369,23,10,1990,10,"male",410,215,171,26,9,0,5,26,4
1169371,28,4,1985,3,"male",266,315,224,7,6,7,6,0,0
1169393,28,6,1985,8,"male",470,155,94,1,1,0,0,1,1
1169397,49,1,1964,9,"female",1418,205,98,273,69,121,16,152,53
1169406,51,4,1962,2,"male",1640,67,23,42,26,28,17,14,9
1169427,56,21,1957,6,"female",564,110,49,700,19,0,7,700,12
1169436,48,24,1965,7,"male",345,82,62,469,782,469,524,0,258
1169445,28,29,1985,11,"male",105,5,5,0,0,0,0,0,0
1169459,24,1,1989,2,"male",1848,250,112,249,262,197,174,52,88
1169478,19,12,1994,2,"male",589,183,79,342,248,290,169,52,79
1169496,15,6,1998,6,"male",312,151,115,565,89,565,80,0,9
1169509,18,23,1995,6,"male",18,0,0,0,0,0,0,0,0
1169537,20,27,1993,10,"male",685,1164,782,96,315,96,290,0,25
1169562,23,13,1990,4,"female",472,86,40,8,7,0,5,8,2
1169628,39,6,1974,8,"female",172,43,18,2,0,2,0,0,0
1169635,94,25,1919,9,"male",967,763,293,105,204,0,93,105,111
1169641,31,24,1982,5,"female",51,10,7,18,17,18,2,0,15
1169669,15,17,1998,12,"female",286,233,96,45,84,14,60,31,24
1169729,30,25,1983,9,"female",375,32,5,124,1,124,1,0,0
1169731,29,20,1984,3,"female",524,64,22,1,0,1,0,0,0
1169741,34,22,1979,9,"female",619,177,138,135,155,135,116,0,39
1169764,14,23,1999,5,"female",32,293,174,3423,2222,2581,1847,842,374
1169785,27,26,1986,9,"female",566,198,100,1,2,1,0,0,2
1169791,21,6,1992,6,"male",323,158,133,18,28,18,28,0,0
1169811,54,3,1959,11,"male",349,31,21,6,0,6,0,0,0
1169844,64,26,1949,12,"female",1475,226,161,80,181,80,91,0,90
1169854,14,6,1999,2,"male",291,63,41,11,1,0,1,11,0
1169931,16,16,1997,2,"female",516,2977,2425,443,250,308,166,135,84
1169950,19,10,1994,10,"female",289,579,401,34,619,34,385,0,234
1169952,26,22,1987,7,"female",165,53,3,476,1392,476,844,0,548
1169970,14,12,1999,6,"female",319,61,57,1,0,1,0,0,0
1170012,22,1,1991,1,"female",140,21,16,2,12,2,11,0,1
1170025,22,10,1991,2,"male",231,9,8,0,1,0,1,0,0
1170045,33,25,1980,2,"male",1435,191,101,6,6,6,4,0,2
1170049,33,7,1980,6,"male",946,216,81,29,45,29,10,0,35
1170076,42,29,1971,10,"male",226,17,9,106,40,106,24,0,16
1170091,17,8,1996,7,"female",120,100,94,13,17,8,1,5,16
1170100,63,6,1950,9,"male",1001,181,82,202,153,202,143,0,10
1170101,25,5,1988,7,"female",871,31,22,0,0,0,0,0,0
1170114,28,23,1985,4,"male",204,43,9,0,0,0,0,0,0
1170126,20,26,1993,12,"male",923,63,42,0,0,0,0,0,0
1170133,16,17,1997,9,"female",180,235,34,33,14,29,8,4,6
1170143,67,13,1946,5,"female",1515,59,27,251,197,238,148,13,49
1170151,46,21,1967,9,"female",229,19,15,5,8,4,6,1,2
1170155,55,15,1958,9,"male",430,24,18,0,0,0,0,0,0
1170165,34,5,1979,8,"male",419,40,25,4,0,4,0,0,0
1170174,16,28,1997,8,"male",265,478,447,120,15,4,7,116,8
1170181,29,1,1984,1,"male",92,40,31,3,8,3,8,0,0
1170197,37,20,1976,4,"male",77,12,10,6,22,6,2,0,20
1170202,19,2,1994,12,"female",210,50,37,91,14,91,12,0,2
1170236,21,1,1992,3,"male",530,391,102,3102,1126,3101,338,1,788
1170266,18,12,1995,1,"female",19,4,4,1,0,0,0,1,0
1170273,56,18,1957,11,"female",140,16,14,9,35,9,5,0,30
1170277,60,26,1953,4,"male",1571,23,12,19,14,19,10,0,4
1170303,24,27,1989,3,"female",326,277,170,179,29,172,4,7,25
1170304,20,25,1993,12,"male",34,110,55,538,398,537,332,1,66
1170311,23,26,1990,9,"male",318,178,127,3,41,3,31,0,10
1170324,18,30,1995,12,"female",792,269,121,82,8,82,8,0,0
1170332,35,28,1978,5,"female",344,23,9,180,62,180,61,0,1
1170359,53,14,1960,4,"female",255,72,45,89,57,89,37,0,20
1170375,25,5,1988,2,"male",108,151,141,21,3,21,3,0,0
1170381,35,21,1978,10,"male",778,132,119,0,4,0,4,0,0
1170401,18,22,1995,6,"male",114,5,1,1,0,0,0,1,0
1170418,35,18,1978,12,"female",537,108,79,19,70,19,48,0,22
1170430,51,26,1962,7,"female",182,51,28,0,0,0,0,0,0
1170445,66,8,1947,1,"female",146,43,36,34,6,0,1,34,5
1170480,51,15,1962,6,"male",680,227,155,20,54,15,31,5,23
1170481,28,27,1985,1,"female",94,4,3,1,0,0,0,1,0
1170518,50,25,1963,4,"male",160,41,39,0,0,0,0,0,0
1170540,20,13,1993,12,"female",228,2052,968,3393,1790,3393,1483,0,307
1170563,27,26,1986,1,"male",860,83,56,1,1,1,0,0,1
1170566,22,10,1991,3,"male",439,37,14,46,31,46,26,0,5
1170574,28,14,1985,2,"male",528,33,24,0,0,0,0,0,0
1170603,16,26,1997,1,"male",29,0,0,0,0,0,0,0,0
1170612,45,3,1968,12,"male",363,1,0,0,0,0,0,0,0
1170647,14,10,1999,11,"male",163,66,39,7,19,3,5,4,14
1170677,22,23,1991,9,"male",196,31,27,2,0,0,0,2,0
1170683,22,25,1991,2,"male",631,1,1,4,0,0,0,4,0
1170698,60,1,1953,10,"female",284,62,27,48,94,0,32,48,62
1170713,23,5,1990,11,"male",710,8,7,0,0,0,0,0,0
1170717,23,15,1990,9,"male",29,1,1,22,0,0,0,22,0
1170718,31,4,1982,2,"female",280,399,120,1,0,1,0,0,0
1170724,40,19,1973,10,"male",143,92,77,1,43,0,7,1,36
1170727,36,4,1977,5,"female",284,46,28,239,319,239,294,0,25
1170729,73,24,1940,2,"female",1597,67,41,59,6,59,5,0,1
1170736,50,11,1963,5,"female",1598,194,86,1128,664,1128,444,0,220
1170756,17,25,1996,6,"male",769,73,52,0,0,0,0,0,0
1170766,32,17,1981,10,"male",995,170,76,1,1,1,1,0,0
1170807,35,12,1978,3,"male",32,3,1,7,0,7,0,0,0
1170865,35,24,1978,11,"male",588,61,60,0,3,0,3,0,0
1170882,34,1,1979,1,"male",205,3,3,13,0,13,0,0,0
1170886,18,1,1995,9,"female",225,907,418,66,203,66,187,0,16
1170888,20,17,1993,9,"female",1870,115,58,938,684,819,471,119,213
1170896,23,29,1990,4,"male",394,123,105,124,4,0,1,124,3
1170903,25,5,1988,2,"male",259,3,2,0,0,0,0,0,0
1170906,18,21,1995,7,"male",653,462,215,144,185,144,100,0,85
1170913,18,20,1995,3,"male",218,0,0,0,0,0,0,0,0
1170938,62,3,1951,2,"female",663,58,35,6,17,6,15,0,2
1170939,31,10,1982,3,"male",351,261,94,11,2,11,1,0,1
1170947,94,1,1919,1,"male",592,0,0,0,0,0,0,0,0
1170955,22,1,1991,6,"female",781,488,210,2133,5061,2102,2243,31,2818
1170998,68,2,1945,12,"male",508,961,855,132,1485,132,1172,0,313
1171000,49,27,1964,12,"male",355,67,47,4,14,4,14,0,0
1171020,19,15,1994,5,"female",1012,1591,1222,3285,2274,2016,1376,1269,898
1171043,23,24,1990,3,"male",2,10,8,2,0,2,0,0,0
1171066,108,1,1905,10,"female",1576,90,25,1,8,1,6,0,2
1171082,21,20,1992,5,"male",425,8,5,0,0,0,0,0,0
1171090,62,27,1951,1,"male",733,104,16,308,111,2,51,306,60
1171131,33,10,1980,6,"male",214,1,1,0,0,0,0,0,0
1171138,16,22,1997,2,"male",605,232,162,81,33,33,10,48,23
1171155,28,4,1985,7,"male",485,73,45,7,1,0,0,7,1
1171168,18,4,1995,1,"male",395,140,94,245,200,245,125,0,75
1171174,18,22,1995,5,"male",172,201,186,1,30,1,13,0,17
1171207,28,11,1985,1,"male",347,274,242,1,16,1,14,0,2
1171214,15,1,1998,12,"male",404,265,143,5,3,5,3,0,0
1171227,47,25,1966,1,"female",670,55,38,354,48,354,44,0,4
1171228,17,26,1996,10,"male",158,96,67,13,39,13,13,0,26
1171240,22,27,1991,3,"male",257,143,71,3,2,1,1,2,1
1171251,66,12,1947,4,"female",508,7,3,0,1,0,1,0,0
1171353,53,7,1960,1,"male",405,188,155,874,648,874,101,0,547
1171372,22,12,1991,5,"male",697,707,624,418,89,418,59,0,30
1171416,42,3,1971,7,"male",1632,1028,306,5,68,5,55,0,13
1171422,20,3,1993,2,"female",190,230,127,188,62,99,30,89,32
1171423,103,1,1910,1,"male",375,141,136,0,0,0,0,0,0
1171451,38,8,1975,6,"male",1638,1,0,0,0,0,0,0,0
1171472,17,1,1996,2,"female",64,21,15,1,0,1,0,0,0
1171479,103,12,1910,2,"female",588,130,20,370,169,254,30,116,139
1171540,21,9,1992,4,"male",37,53,44,1,1,1,1,0,0
1171542,103,5,1910,3,"male",854,322,236,7,6,7,4,0,2
1171556,17,29,1996,5,"male",541,272,203,15,0,0,0,15,0
1171565,17,30,1996,11,"female",290,333,275,241,227,44,40,197,187
1171645,28,1,1985,9,"male",221,99,82,16,10,0,1,16,9
1171646,59,25,1954,9,"male",46,91,67,26,0,26,0,0,0
1171659,108,27,1905,7,"male",839,151,82,2,0,2,0,0,0
1171684,22,25,1991,6,"male",873,39,24,2,0,0,0,2,0
1171687,68,12,1945,7,"male",728,72,30,0,0,0,0,0,0
1171714,18,17,1995,3,"male",242,291,239,20,179,20,31,0,148
1171721,54,12,1959,10,"male",263,23,12,26,1,0,0,26,1
1171732,50,25,1963,4,"female",1046,34,24,81,13,80,5,1,8
1171737,18,6,1995,5,"male",345,270,205,432,42,431,32,1,10
1171785,108,26,1905,7,"female",1763,178,60,22,5,4,3,18,2
1171790,47,5,1966,1,"female",656,100,55,98,34,98,18,0,16
1171834,24,30,1989,1,"male",543,137,75,7,13,3,5,4,8
1171843,47,6,1966,2,"female",1755,114,40,319,188,217,95,102,93
1171850,37,25,1976,4,"male",242,125,61,9,12,9,12,0,0
1171860,24,17,1989,5,"male",384,36,28,3,0,0,0,3,0
1171863,27,19,1986,1,"male",279,73,33,0,1,0,0,0,1
1171870,65,23,1948,6,"female",885,85,53,777,230,8,68,769,162
1171872,23,3,1990,11,"female",502,50,21,62,67,53,41,9,26
1171906,21,10,1992,3,"female",176,116,76,3,7,3,7,0,0
1171911,56,11,1957,1,"male",205,69,55,2,2,2,1,0,1
1171915,22,3,1991,9,"female",904,134,58,1709,3330,284,1743,1425,1587
1171922,53,24,1960,12,"female",1731,58,41,19,5,18,3,1,2
1171938,33,22,1980,11,"male",900,361,237,188,225,188,185,0,40
1171943,57,8,1956,8,"female",723,98,59,173,32,173,28,0,4
1171968,45,3,1968,9,"female",311,34,15,69,168,0,35,69,133
1171974,53,18,1960,3,"male",40,69,60,4,0,0,0,4,0
1172006,32,1,1981,9,"female",386,210,147,14,7,13,5,1,2
1172044,19,18,1994,10,"female",839,3721,1535,68,825,63,579,5,246
1172053,19,12,1994,12,"male",15,41,21,95,81,91,61,4,20
1172062,26,1,1987,1,"male",165,15,6,1867,9,1867,8,0,1
1172063,20,14,1993,8,"female",584,244,105,799,398,181,136,618,262
1172067,19,17,1994,8,"male",598,665,358,745,351,506,248,239,103
1172070,33,30,1980,5,"male",148,50,44,29,84,29,54,0,30
1172088,30,28,1983,1,"female",377,296,144,503,69,1,6,502,63
1172114,23,19,1990,10,"male",98,10,7,13,5,0,4,13,1
1172129,47,25,1966,5,"female",446,84,35,7292,494,7291,285,1,209
1172137,51,24,1962,3,"female",174,34,30,11,15,11,13,0,2
1172141,103,29,1910,7,"male",690,276,194,166,4601,166,3340,0,1261
1172147,45,1,1968,1,"male",283,93,76,22,3,0,2,22,1
1172159,21,11,1992,8,"female",426,113,70,315,320,194,149,121,171
1172167,20,29,1993,5,"female",637,757,271,147,205,61,131,86,74
1172175,18,21,1995,12,"male",89,83,36,3,1,3,1,0,0
1172185,25,8,1988,8,"female",409,71,41,271,142,271,124,0,18
1172186,67,15,1946,8,"female",1757,44,17,89,5,89,4,0,1
1172199,37,11,1976,10,"male",736,137,49,40,66,33,41,7,25
1172263,25,20,1988,4,"male",293,395,362,1,0,1,0,0,0
1172299,23,7,1990,6,"female",404,102,44,84,34,11,2,73,32
1172308,83,10,1930,9,"female",1868,1058,405,5,445,5,384,0,61
1172309,27,10,1986,6,"female",330,53,14,2,4,2,4,0,0
1172314,70,12,1943,9,"female",1716,208,45,0,0,0,0,0,0
1172340,32,17,1981,5,"female",768,555,133,2307,1281,149,428,2158,853
1172366,31,5,1982,7,"female",517,224,118,92,7,92,7,0,0
1172381,32,29,1981,5,"male",13,9,8,6,2,6,2,0,0
1172445,31,15,1982,1,"female",183,136,43,20,49,20,35,0,14
1172446,31,1,1982,1,"female",223,0,0,0,0,0,0,0,0
1172447,52,4,1961,4,"female",311,64,31,44,13,27,6,17,7
1172457,98,24,1915,12,"female",641,210,115,2,6,2,3,0,3
1172466,26,1,1987,1,"female",590,70,53,1,1,1,1,0,0
1172476,48,5,1965,1,"female",172,30,24,10,3,10,0,0,3
1172482,20,13,1993,9,"female",1521,137,76,247,336,31,75,216,261
1172486,103,26,1910,1,"male",765,614,302,240,468,240,283,0,185
1172517,108,6,1905,9,"female",961,413,241,301,128,9,47,292,81
1172579,27,24,1986,6,"male",256,3,3,7,3,5,2,2,1
1172584,50,14,1963,10,"female",487,21,2,8,28,7,28,1,0
1172607,19,23,1994,5,"male",232,89,65,65,14,59,7,6,7
1172622,15,10,1998,3,"male",653,487,338,556,416,43,55,513,361
1172655,50,19,1963,1,"male",767,471,280,11,0,0,0,11,0
1172662,75,11,1938,10,"male",1390,99,42,19,56,0,1,19,55
1172669,43,27,1970,10,"female",212,63,41,87,52,87,28,0,24
1172680,33,22,1980,6,"female",129,70,65,3,29,1,11,2,18
1172731,21,18,1992,7,"female",173,2,2,54,0,54,0,0,0
1172745,113,24,1900,2,"male",1808,160,92,0,0,0,0,0,0
1172751,59,25,1954,12,"female",563,47,26,61,13,4,10,57,3
1172753,18,11,1995,7,"female",263,242,195,11,12,11,11,0,1
1172761,50,21,1963,7,"male",546,163,109,7,99,4,62,3,37
1172765,30,3,1983,3,"male",1414,2,1,16,4,15,3,1,1
1172780,18,11,1995,6,"male",378,306,153,334,129,231,78,103,51
1172783,18,19,1995,4,"male",438,31,26,3,5,0,3,3,2
1172815,22,27,1991,7,"male",675,54,33,2,1,2,0,0,1
1172816,51,16,1962,10,"male",549,52,38,131,32,131,25,0,7
1172819,25,23,1988,10,"female",386,490,310,188,199,133,62,55,137
1172838,21,25,1992,10,"male",239,316,254,162,113,5,40,157,73
1172842,19,31,1994,12,"male",490,532,410,4,102,4,76,0,26
1172852,32,19,1981,9,"female",622,108,94,1040,727,1040,646,0,81
1172878,21,2,1992,1,"male",223,64,50,1,0,1,0,0,0
1172881,20,15,1993,1,"male",335,121,93,24,15,24,12,0,3
1172894,26,15,1987,10,"male",355,16,12,0,0,0,0,0,0
1172912,16,2,1997,11,"male",22,16,12,0,0,0,0,0,0
1172915,49,1,1964,3,"female",317,99,47,27,1,27,1,0,0
1172920,27,14,1986,12,"female",225,143,38,173,445,173,249,0,196
1172947,21,21,1992,9,"male",482,139,106,0,4,0,2,0,2
1172980,26,10,1987,6,"male",254,234,182,76,185,76,124,0,61
1173013,20,9,1993,10,"female",699,3611,973,4507,7768,4414,6909,93,859
1173025,58,27,1955,4,"female",957,180,114,113,153,113,32,0,121
1173044,37,27,1976,6,"male",406,196,37,358,194,358,173,0,21
1173053,18,5,1995,6,"female",663,493,388,7309,1089,6688,647,621,442
1173060,26,19,1987,3,"female",497,240,215,37,26,37,26,0,0
1173080,38,18,1975,9,"male",507,33,30,0,0,0,0,0,0
1173114,41,28,1972,1,"male",459,1,1,0,0,0,0,0,0
1173119,21,7,1992,1,"female",26,42,36,59,45,12,7,47,38
1173125,55,21,1958,6,"male",864,197,135,259,1992,259,1576,0,416
1173177,47,4,1966,10,"female",356,17,13,49,17,49,16,0,1
1173205,20,10,1993,9,"female",348,4,3,0,2,0,0,0,2
1173235,49,13,1964,4,"male",517,90,76,289,174,18,92,271,82
1173239,42,24,1971,11,"female",627,11,0,0,0,0,0,0,0
1173243,53,2,1960,2,"female",142,30,13,1365,1566,674,1074,691,492
1173284,31,19,1982,7,"male",374,224,188,0,3,0,1,0,2
1173287,32,30,1981,4,"male",567,320,281,0,0,0,0,0,0
1173289,14,14,1999,1,"male",162,138,114,51,5,44,0,7,5
1173291,57,17,1956,4,"male",66,73,63,23,1,23,1,0,0
1173304,14,25,1999,12,"female",142,315,190,259,88,65,67,194,21
1173331,22,24,1991,8,"male",645,371,254,98,62,98,47,0,15
1173353,23,24,1990,3,"male",1408,164,24,9,5,6,3,3,2
1173373,64,4,1949,2,"male",1721,540,329,597,375,159,176,438,199
1173406,29,10,1984,8,"male",41,5,1,10,3,10,2,0,1
1173411,22,12,1991,9,"male",611,3627,62,41,2372,41,2005,0,367
1173412,28,20,1985,11,"male",541,225,165,52,3,52,1,0,2
1173435,32,14,1981,11,"male",178,63,45,0,1,0,1,0,0
1173455,23,16,1990,8,"male",398,391,266,0,0,0,0,0,0
1173458,54,15,1959,1,"female",478,31,12,19,2,19,2,0,0
1173481,25,25,1988,12,"male",416,30,27,0,3,0,0,0,3
1173494,21,7,1992,1,"female",330,102,70,70,53,69,49,1,4
1173502,21,16,1992,7,"male",187,550,474,485,503,485,441,0,62
1173522,36,30,1977,4,"male",393,74,64,0,0,0,0,0,0
1173524,17,14,1996,3,"male",10,47,47,43,11,43,10,0,1
1173534,17,30,1996,10,"male",682,139,89,129,128,118,41,11,87
1173536,21,26,1992,9,"female",362,81,38,120,32,120,32,0,0
1173539,47,17,1966,12,"female",287,110,64,2,4,0,3,2,1
1173549,19,10,1994,1,"male",560,290,235,4,1,4,1,0,0
1173554,23,13,1990,11,"male",386,63,40,27,16,27,13,0,3
1173556,15,5,1998,5,"female",60,185,138,3,5,1,4,2,1
1173561,68,13,1945,9,"male",1214,290,255,0,0,0,0,0,0
1173562,28,9,1985,12,"female",740,61,18,0,0,0,0,0,0
1173569,69,17,1944,11,"female",732,18,14,2,0,0,0,2,0
1173571,23,7,1990,2,"male",479,6,6,3,3,3,3,0,0
1173602,19,14,1994,8,"female",405,209,73,15,6,15,6,0,0
1173611,57,10,1956,4,"female",226,70,35,77,33,0,14,77,19
1173614,31,15,1982,5,"male",770,3,3,0,0,0,0,0,0
1173615,27,27,1986,10,"male",76,11,6,9,7,9,6,0,1
1173628,39,28,1974,2,"female",205,63,43,105,11,105,7,0,4
1173630,29,18,1984,4,"female",261,51,18,1,0,1,0,0,0
1173641,19,15,1994,3,"male",679,1131,357,6,9,6,8,0,1
1173673,30,21,1983,6,"female",251,1,0,5,5,4,3,1,2
1173674,21,22,1992,11,"male",660,655,420,9,3,9,2,0,1
1173729,26,27,1987,12,"female",314,15,14,0,3,0,2,0,1
1173742,69,10,1944,3,"female",1805,67,22,82,36,13,3,69,33
1173782,18,5,1995,3,"male",834,3121,1721,270,1958,63,739,207,1219
1173810,14,6,1999,7,"female",605,107,51,13,4,13,1,0,3
1173854,49,11,1964,11,"female",339,197,135,116,19,116,13,0,6
1173862,62,20,1951,4,"female",102,78,62,466,182,466,107,0,75
1173874,20,15,1993,12,"male",345,850,757,174,291,125,183,49,108
1173886,24,24,1989,5,"female",206,50,14,2,7,2,4,0,3
1173887,16,6,1997,8,"female",785,2339,802,446,1046,446,830,0,216
1173888,108,26,1905,11,"female",1002,332,50,1,9,1,8,0,1
1174067,21,27,1992,5,"male",88,8,2,9,16,9,14,0,2
1174070,14,10,1999,11,"male",9,6,0,0,0,0,0,0,0
1174079,33,9,1980,8,"female",252,72,39,44,123,44,114,0,9
1174080,73,5,1940,9,"female",1225,111,58,52,226,40,183,12,43
1174089,21,9,1992,9,"male",439,254,156,93,50,46,45,47,5
1174093,56,9,1957,5,"male",1567,43,34,4,2,0,1,4,1
1174103,21,1,1992,5,"male",216,140,90,7,0,4,0,3,0
1174113,17,28,1996,8,"male",140,126,120,10,1,10,1,0,0
1174132,74,24,1939,9,"female",78,51,42,101,14,0,9,101,5
1174143,26,6,1987,11,"female",50,81,56,226,690,102,178,124,512
1174159,26,29,1987,12,"female",479,67,58,59,39,20,34,39,5
1174163,15,11,1998,8,"male",149,8,6,2,2,2,2,0,0
1174206,25,26,1988,9,"male",265,114,82,89,8,77,5,12,3
1174210,57,24,1956,1,"male",535,67,65,2,1,0,0,2,1
1174242,103,1,1910,4,"male",562,57,34,296,95,296,88,0,7
1174268,21,28,1992,7,"female",235,222,173,108,20,2,14,106,6
1174270,54,23,1959,11,"male",1478,217,122,156,68,0,8,156,60
1174273,31,4,1982,10,"female",127,11,8,30,12,30,6,0,6
1174274,46,24,1967,12,"male",523,1,1,0,0,0,0,0,0
1174299,20,20,1993,1,"male",221,38,25,5,0,0,0,5,0
1174315,59,21,1954,10,"female",515,21,20,0,0,0,0,0,0
1174358,77,21,1936,9,"female",1818,165,61,120,22,58,6,62,16
1174367,21,2,1992,8,"male",251,77,58,7,1,7,1,0,0
1174373,49,19,1964,4,"female",1042,465,278,12,1,0,0,12,1
1174401,60,15,1953,6,"female",672,57,45,150,27,150,15,0,12
1174427,18,17,1995,11,"male",106,274,184,13,21,13,10,0,11
1174483,73,12,1940,6,"female",1673,112,31,1799,568,43,359,1756,209
1174503,22,7,1991,6,"male",115,63,40,1,0,1,0,0,0
1174510,21,15,1992,2,"male",1520,217,165,0,16,0,10,0,6
1174549,22,22,1991,2,"male",598,107,61,21,0,21,0,0,0
1174555,19,11,1994,7,"male",588,582,414,81,176,81,162,0,14
1174599,72,10,1941,2,"male",2023,149,30,11,9,0,6,11,3
1174609,19,7,1994,3,"female",162,180,157,62,35,15,20,47,15
1174612,21,5,1992,5,"female",12,242,238,2194,1214,237,657,1957,557
1174626,17,16,1996,10,"female",152,56,25,75,100,67,63,8,37
1174636,18,31,1995,12,"male",464,42,31,0,5,0,2,0,3
1174645,21,26,1992,1,"male",360,272,113,0,2,0,2,0,0
1174681,20,15,1993,7,"male",264,22,22,22,13,22,12,0,1
1174706,26,5,1987,5,"male",398,0,0,0,0,0,0,0,0
1174713,34,27,1979,10,"female",381,53,23,0,0,0,0,0,0
1174724,63,9,1950,2,"male",270,54,43,0,4,0,2,0,2
1174729,41,21,1972,6,"female",734,39,31,464,577,462,507,2,70
1174734,19,25,1994,12,"male",622,281,180,1,0,0,0,1,0
1174736,14,9,1999,1,"male",307,64,31,0,0,0,0,0,0
1174752,24,5,1989,8,"female",192,73,55,2,4,0,3,2,1
1174798,15,23,1998,4,"female",702,29,22,7,8,1,3,6,5
1174815,103,18,1910,1,"male",1136,300,136,78,93,77,71,1,22
1174822,17,28,1996,3,"female",399,2495,765,143,3045,143,2445,0,600
1174830,22,30,1991,10,"male",372,126,92,8,19,8,17,0,2
1174853,36,14,1977,1,"male",103,41,39,3,1,3,0,0,1
1174882,61,28,1952,9,"female",892,26,12,114,18,0,9,114,9
1174906,23,1,1990,1,"male",531,82,31,45,19,0,6,45,13
1174923,44,22,1969,5,"male",365,57,26,4,5,0,3,4,2
1174956,21,24,1992,5,"male",174,16,11,0,1,0,1,0,0
1174959,23,4,1990,10,"male",293,1,0,0,0,0,0,0,0
1174970,16,30,1997,12,"female",662,433,241,3,13,3,12,0,1
1174974,18,4,1995,11,"male",369,183,159,777,42,236,23,541,19
1174978,59,24,1954,1,"male",551,0,0,71,6,0,4,71,2
1175027,20,9,1993,8,"male",306,12,7,0,0,0,0,0,0
1175063,17,9,1996,10,"male",329,93,52,7,4,1,3,6,1
1175080,18,12,1995,6,"male",662,112,64,2,1,0,1,2,0
1175165,25,8,1988,6,"male",1576,193,113,3,2,3,1,0,1
1175186,18,1,1995,8,"female",100,176,80,853,94,853,57,0,37
1175206,103,8,1910,4,"male",940,335,174,15,0,15,0,0,0
1175212,17,6,1996,9,"male",631,401,328,49,33,12,15,37,18
1175244,20,3,1993,3,"male",246,210,168,0,0,0,0,0,0
1175246,42,9,1971,7,"male",447,49,28,0,0,0,0,0,0
1175270,28,23,1985,12,"male",380,146,97,73,34,37,19,36,15
1175279,28,11,1985,8,"male",259,17,14,0,0,0,0,0,0
1175291,48,1,1965,3,"male",1518,13,10,5,1,0,1,5,0
1175315,65,23,1948,7,"female",1073,468,343,157,238,2,177,155,61
1175317,103,5,1910,3,"female",1163,463,187,264,231,0,68,264,163
1175339,18,19,1995,12,"male",9,44,39,26,15,26,10,0,5
1175357,70,28,1943,12,"female",1760,59,28,33,6,0,2,33,4
1175385,56,12,1957,10,"male",42,19,12,617,155,485,72,132,83
1175388,19,14,1994,6,"female",1326,378,99,872,1765,812,949,60,816
1175400,24,15,1989,6,"male",179,1,0,0,0,0,0,0,0
1175429,17,31,1996,1,"male",188,42,27,1,0,0,0,1,0
1175435,22,9,1991,12,"male",356,250,184,444,194,444,186,0,8
1175438,94,28,1919,1,"male",865,80,21,11,0,11,0,0,0
1175441,39,27,1974,10,"female",431,34,20,0,0,0,0,0,0
1175454,57,7,1956,8,"male",1680,58,10,56,18,0,3,56,15
1175462,21,30,1992,6,"female",571,1317,425,365,817,269,742,96,75
1175474,40,21,1973,5,"female",16,134,118,79,132,48,74,31,58
1175538,14,21,1999,11,"male",191,41,28,0,0,0,0,0,0
1175547,17,6,1996,9,"male",22,13,10,0,0,0,0,0,0
1175551,65,18,1948,8,"female",39,77,62,0,0,0,0,0,0
1175588,25,1,1988,1,"female",48,10,8,3,14,3,14,0,0
1175599,26,31,1987,1,"male",378,44,35,0,0,0,0,0,0
1175661,20,25,1993,1,"female",273,62,37,0,0,0,0,0,0
1175670,32,19,1981,10,"female",433,101,34,62,54,62,33,0,21
1175676,26,16,1987,10,"male",214,1,1,1,19,1,1,0,18
1175678,103,1,1910,1,"male",2018,402,308,20,19,19,7,1,12
1175739,25,23,1988,9,"male",27,0,0,0,0,0,0,0,0
1175744,17,22,1996,8,"male",478,369,218,374,362,287,212,87,150
1175757,42,25,1971,9,"male",331,50,30,4,0,4,0,0,0
1175762,58,13,1955,5,"female",821,43,8,591,12,588,8,3,4
1175769,39,19,1974,11,"female",663,695,445,13,679,11,176,2,503
1175787,23,11,1990,6,"female",161,130,121,13,19,7,14,6,5
1175797,14,23,1999,4,"male",354,41,7,0,0,0,0,0,0
1175825,27,4,1986,5,"male",552,217,140,3,0,3,0,0,0
1175839,36,22,1977,9,"female",544,137,117,0,4,0,3,0,1
1175884,43,10,1970,12,"female",559,3,0,32,0,32,0,0,0
1175889,42,28,1971,9,"male",968,2,0,0,0,0,0,0,0
1175961,19,8,1994,5,"male",455,596,504,144,25,34,16,110,9
1175965,15,25,1998,7,"female",423,206,169,61,4,61,4,0,0
1175966,32,14,1981,9,"female",186,1,0,15,1,13,1,2,0
1175971,51,31,1962,7,"female",301,7,2,17,4,0,1,17,3
1175981,27,7,1986,3,"male",429,12,9,0,0,0,0,0,0
1175993,18,26,1995,10,"female",831,185,88,14,40,14,31,0,9
1176003,53,2,1960,1,"female",1586,138,66,326,635,325,552,1,83
1176029,32,18,1981,12,"male",559,386,340,1,1,1,0,0,1
1176031,22,19,1991,4,"female",122,91,79,235,87,235,61,0,26
1176038,31,15,1982,7,"male",162,143,113,2,16,2,11,0,5
1176054,39,17,1974,10,"male",602,247,216,2,38,2,33,0,5
1176062,46,7,1967,8,"male",101,34,5,3,0,3,0,0,0
1176068,21,19,1992,11,"female",942,863,589,813,1152,630,826,183,326
1176069,25,22,1988,8,"female",545,524,264,281,235,150,115,131,120
1176082,18,1,1995,8,"male",122,39,26,0,0,0,0,0,0
1176088,31,21,1982,2,"male",384,61,37,16,7,16,4,0,3
1176141,15,5,1998,7,"male",526,188,99,4,7,0,1,4,6
1176228,42,26,1971,2,"female",874,35,21,1,0,1,0,0,0
1176231,16,15,1997,8,"female",150,0,0,0,0,0,0,0,0
1176232,63,30,1950,5,"female",168,25,15,15,13,0,0,15,13
1176253,62,12,1951,4,"female",1437,210,116,313,146,293,122,20,24
1176299,20,8,1993,9,"female",174,132,36,13,33,6,15,7,18
1176333,41,29,1972,2,"male",996,8,2,5,1,5,1,0,0
1176337,23,22,1990,7,"female",74,169,146,705,170,705,93,0,77
1176343,33,9,1980,6,"male",267,216,120,731,566,275,331,456,235
1176369,25,16,1988,5,"female",1099,51,16,37,3,37,3,0,0
1176389,23,25,1990,7,"female",644,219,20,29,112,19,48,10,64
1176409,21,27,1992,1,"female",487,186,45,7,4,7,3,0,1
1176424,20,30,1993,10,"female",494,1675,1167,858,265,52,226,806,39
1176425,30,16,1983,4,"male",202,23,23,0,0,0,0,0,0
1176436,43,29,1970,8,"female",279,6,5,1,0,1,0,0,0
1176448,65,15,1948,1,"female",1432,471,164,92,166,56,70,36,96
1176449,82,10,1931,1,"female",1192,24,8,5,0,0,0,5,0
1176459,25,19,1988,12,"male",255,16,12,0,0,0,0,0,0
1176480,49,26,1964,10,"female",1475,20,5,0,0,0,0,0,0
1176493,24,25,1989,6,"female",330,84,66,228,164,175,122,53,42
1176494,24,4,1989,4,"female",562,49,13,16,28,14,23,2,5
1176496,30,31,1983,12,"male",420,15,7,0,0,0,0,0,0
1176524,42,10,1971,7,"female",230,30,23,5,13,5,10,0,3
1176533,52,23,1961,12,"female",509,212,155,193,34,169,6,24,28
1176552,108,29,1905,8,"female",989,244,109,43,5,43,1,0,4
1176568,53,24,1960,8,"male",118,2,2,0,2,0,2,0,0
1176572,18,7,1995,5,"female",480,410,343,5,25,5,17,0,8
1176589,23,1,1990,1,"male",624,21,10,13,0,0,0,13,0
1176593,34,15,1979,6,"male",284,97,65,28,49,28,49,0,0
1176594,26,11,1987,9,"male",300,39,23,0,6,0,5,0,1
1176602,50,28,1963,5,"female",50,9,4,22,12,0,1,22,11
1176604,17,28,1996,4,"male",248,28,18,13,3,1,3,12,0
1176670,30,22,1983,12,"male",55,2,1,0,0,0,0,0,0
1176696,24,1,1989,1,"male",205,316,292,0,0,0,0,0,0
1176717,44,25,1969,10,"male",187,71,31,45,108,45,100,0,8
1176751,22,12,1991,8,"female",490,201,107,282,249,282,184,0,65
1176766,17,26,1996,4,"female",31,652,45,1138,2913,426,858,712,2055
1176775,24,10,1989,1,"male",107,8,6,77,18,77,10,0,8
1176785,57,28,1956,2,"female",1087,65,21,114,19,114,13,0,6
1176812,56,3,1957,3,"male",310,3,2,0,0,0,0,0,0
1176823,21,8,1992,6,"male",979,179,64,9,2,9,2,0,0
1176842,50,21,1963,12,"male",574,73,39,0,0,0,0,0,0
1176854,26,30,1987,1,"male",29,4,0,42,9,39,0,3,9
1176864,25,4,1988,2,"female",128,71,68,6,3,6,3,0,0
1176884,51,22,1962,3,"female",805,155,94,20,57,20,56,0,1
1176918,14,6,1999,1,"male",504,185,73,5,5,0,2,5,3
1176923,25,26,1988,10,"male",228,123,98,53,24,53,6,0,18
1176940,27,7,1986,2,"male",141,3,3,3,0,1,0,2,0
1176986,38,24,1975,3,"male",480,30,19,0,58,0,1,0,57
1176988,35,17,1978,3,"female",505,261,185,101,26,101,9,0,17
1176992,20,14,1993,10,"female",526,10,0,0,0,0,0,0,0
1177018,25,5,1988,9,"female",279,11,8,1,0,1,0,0,0
1177024,34,11,1979,6,"male",595,28,21,0,0,0,0,0,0
1177056,96,15,1917,6,"male",905,229,166,4,0,4,0,0,0
1177068,22,11,1991,5,"male",574,727,538,1,4,1,4,0,0
1177113,52,10,1961,2,"female",1477,137,68,263,190,37,52,226,138
1177140,26,19,1987,4,"male",501,84,36,0,2,0,0,0,2
1177148,16,18,1997,5,"male",459,157,142,0,27,0,6,0,21
1177162,24,25,1989,11,"male",321,38,19,2,1,2,1,0,0
1177187,56,30,1957,10,"female",270,90,75,58,22,6,17,52,5
1177221,22,18,1991,6,"female",74,138,98,154,145,154,94,0,51
1177223,55,11,1958,3,"male",22,0,0,0,0,0,0,0,0
1177239,28,10,1985,1,"male",207,14,8,1,1,0,0,1,1
1177259,55,30,1958,8,"male",1368,198,162,0,0,0,0,0,0
1177267,19,7,1994,4,"male",222,502,423,75,134,75,101,0,33
1177288,49,26,1964,2,"female",593,22,13,0,0,0,0,0,0
1177300,18,30,1995,11,"male",587,0,0,0,0,0,0,0,0
1177332,108,24,1905,11,"female",749,722,298,1400,2387,410,603,990,1784
1177336,27,1,1986,1,"male",637,47,38,4,18,4,10,0,8
1177367,35,11,1978,8,"male",284,288,217,73,58,2,20,71,38
1177388,82,13,1931,3,"female",1182,2,0,0,0,0,0,0,0
1177415,30,18,1983,2,"female",361,7,5,0,0,0,0,0,0
1177501,34,15,1979,6,"male",201,66,54,83,57,83,3,0,54
1177515,60,30,1953,6,"male",936,32,12,0,0,0,0,0,0
1177518,40,22,1973,8,"male",519,243,111,33,146,33,114,0,32
1177546,55,13,1958,12,"female",286,522,328,1384,299,1380,118,4,181
1177572,27,10,1986,1,"male",205,0,0,0,0,0,0,0,0
1177586,36,23,1977,2,"male",630,96,55,45,3,0,1,45,2
1177603,33,1,1980,1,"male",274,1,1,11,3,11,1,0,2
1177614,20,4,1993,3,"female",258,569,343,804,526,360,304,444,222
1177621,41,19,1972,8,"female",78,271,137,311,447,311,271,0,176
1177632,19,14,1994,9,"male",741,154,85,183,197,180,95,3,102
1177663,18,13,1995,3,"male",226,225,38,0,0,0,0,0,0
1177676,30,29,1983,4,"female",353,60,35,11,40,11,28,0,12
1177684,20,17,1993,2,"male",43,25,23,169,5,169,4,0,1
1177691,62,14,1951,2,"male",992,47,27,32,5,32,4,0,1
1177708,57,11,1956,5,"female",564,78,72,79,25,77,17,2,8
1177720,19,12,1994,5,"male",199,57,39,0,5,0,0,0,5
1177732,26,28,1987,7,"male",81,78,71,14,21,14,16,0,5
1177752,19,26,1994,8,"female",477,284,149,20,40,20,12,0,28
1177756,23,15,1990,12,"male",159,62,61,5,5,0,3,5,2
1177759,67,27,1946,12,"male",135,50,27,57,6,0,5,57,1
1177790,60,27,1953,11,"male",2125,15,5,2,1,0,0,2,1
1177820,63,4,1950,12,"female",1997,37,17,129,107,70,67,59,40
1177885,33,2,1980,11,"male",1039,42,21,0,1,0,0,0,1
1177916,18,18,1995,11,"female",352,102,63,0,12,0,11,0,1
1177934,18,25,1995,11,"male",425,49,46,1,30,0,19,1,11
1177941,23,17,1990,10,"female",450,247,179,162,124,138,106,24,18
1177949,55,19,1958,1,"male",1417,55,28,0,2,0,1,0,1
1177968,19,12,1994,1,"female",424,925,767,1844,242,159,136,1685,106
1177978,38,3,1975,6,"male",256,56,14,0,7,0,5,0,2
1178016,34,15,1979,8,"female",491,72,34,358,114,358,104,0,10
1178027,65,17,1948,3,"female",1448,282,214,1,0,0,0,1,0
1178065,75,17,1938,9,"male",1599,102,28,8,274,3,60,5,214
1178074,22,19,1991,4,"male",115,248,42,57,53,1,11,56,42
1178137,16,9,1997,9,"female",368,1285,939,1097,401,1097,326,0,75
1178141,47,5,1966,6,"male",374,66,57,73,97,0,5,73,92
1178179,26,26,1987,8,"male",280,329,240,388,61,130,13,258,48
1178196,24,21,1989,11,"female",1338,288,214,118,74,76,14,42,60
1178211,32,9,1981,12,"male",581,266,165,13,7,13,7,0,0
1178216,51,12,1962,9,"female",101,104,70,23,16,23,15,0,1
1178231,17,1,1996,1,"male",56,20,19,6,0,6,0,0,0
1178233,27,9,1986,10,"male",178,113,102,21,0,21,0,0,0
1178239,70,1,1943,3,"female",536,53,41,1,2,1,2,0,0
1178242,43,1,1970,9,"male",281,275,234,75,143,75,63,0,80
1178263,59,7,1954,4,"male",1590,78,6,2,2,1,2,1,0
1178286,22,20,1991,12,"female",438,279,135,581,108,482,52,99,56
1178289,65,27,1948,6,"male",535,16,9,2,1,0,0,2,1
1178292,18,23,1995,7,"female",167,48,1,1,0,1,0,0,0
1178305,19,8,1994,9,"female",348,373,188,65,87,65,69,0,18
1178308,46,23,1967,1,"female",496,15,9,1,0,1,0,0,0
1178343,81,2,1932,2,"female",642,55,35,0,0,0,0,0,0
1178386,29,3,1984,12,"male",395,120,79,0,0,0,0,0,0
1178430,28,15,1985,10,"male",446,161,159,0,0,0,0,0,0
1178443,17,16,1996,8,"female",188,598,14,13,63,13,62,0,1
1178444,22,1,1991,1,"male",482,9,7,1,0,1,0,0,0
1178458,19,27,1994,4,"female",384,563,147,873,215,873,160,0,55
1178489,66,7,1947,9,"male",1065,101,80,8,16,0,4,8,12
1178491,38,2,1975,5,"female",81,108,98,836,615,828,433,8,182
1178505,32,3,1981,2,"male",15,10,10,64,152,53,108,11,44
1178519,35,23,1978,2,"male",476,158,107,62,56,1,36,61,20
1178555,47,18,1966,10,"male",451,18,12,24,14,4,4,20,10
1178563,41,3,1972,10,"female",114,8,3,1,2,1,2,0,0
1178573,23,14,1990,4,"male",344,12,6,0,0,0,0,0,0
1178595,33,5,1980,8,"female",1220,597,236,793,637,793,441,0,196
1178602,20,25,1993,1,"male",592,94,38,7,8,0,5,7,3
1178611,18,10,1995,9,"male",249,81,45,28,1,28,1,0,0
1178616,23,4,1990,11,"female",342,86,68,165,115,25,21,140,94
1178621,40,23,1973,8,"male",307,29,17,74,29,72,23,2,6
1178624,21,17,1992,9,"male",518,649,317,287,250,287,212,0,38
1178645,42,4,1971,2,"male",277,83,79,0,1,0,0,0,1
1178652,45,4,1968,5,"male",393,21,9,6,5,6,5,0,0
1178679,27,16,1986,5,"male",738,242,155,1,0,1,0,0,0
1178698,50,6,1963,8,"female",130,116,87,3,6,3,3,0,3
1178716,27,8,1986,4,"male",423,146,81,382,292,107,159,275,133
1178725,23,16,1990,9,"male",443,1,1,0,0,0,0,0,0
1178755,25,12,1988,2,"male",573,241,190,16,18,16,18,0,0
1178767,17,25,1996,2,"female",967,637,365,885,675,453,472,432,203
1178774,19,3,1994,1,"female",342,636,341,322,452,257,131,65,321
1178814,16,20,1997,10,"female",24,7,7,3,2,3,2,0,0
1178818,33,8,1980,4,"male",676,105,53,8,21,8,12,0,9
1178836,29,22,1984,8,"male",319,48,44,0,0,0,0,0,0
1178845,38,9,1975,6,"male",180,26,23,5,0,5,0,0,0
1178876,19,15,1994,1,"male",305,16,13,0,1,0,0,0,1
1178900,20,15,1993,5,"male",738,205,75,4,0,0,0,4,0
1178908,24,6,1989,7,"male",131,21,14,31,14,31,8,0,6
1178929,34,26,1979,12,"male",230,19,3,0,0,0,0,0,0
1178941,52,4,1961,5,"female",373,114,88,145,46,12,21,133,25
1179002,66,26,1947,5,"male",988,17,7,3,7,0,2,3,5
1179008,108,20,1905,3,"male",708,69,41,7,2,7,1,0,1
1179014,73,8,1940,2,"male",535,22,18,88,11,0,0,88,11
1179048,18,22,1995,10,"male",338,217,129,242,391,182,201,60,190
1179056,28,30,1985,3,"male",443,376,336,1,4,1,0,0,4
1179066,27,19,1986,6,"male",633,186,167,2,1,0,0,2,1
1179081,14,19,1999,4,"female",585,1446,490,369,738,229,297,140,441
1179092,100,7,1913,12,"female",101,454,142,631,107,631,99,0,8
1179100,20,13,1993,5,"male",392,135,101,0,0,0,0,0,0
1179167,33,28,1980,1,"female",389,143,46,519,211,498,123,21,88
1179211,19,21,1994,12,"female",355,2,2,0,0,0,0,0,0
1179219,53,25,1960,4,"female",537,34,9,1,6,1,1,0,5
1179248,18,17,1995,11,"female",18,58,45,2,7,2,7,0,0
1179290,20,8,1993,4,"female",432,97,77,12,3,12,3,0,0
1179351,50,23,1963,9,"male",699,99,39,15,1,7,1,8,0
1179363,43,15,1970,4,"male",319,134,124,167,15,167,14,0,1
1179371,17,24,1996,1,"female",258,4230,697,467,1175,239,492,228,683
1179379,57,25,1956,6,"male",1194,38,11,1,12,1,10,0,2
1179384,42,15,1971,10,"female",73,36,4,0,0,0,0,0,0
1179391,26,15,1987,5,"female",1231,1,1,14,3,12,3,2,0
1179392,21,10,1992,3,"male",390,164,118,883,35,739,25,144,10
1179423,60,30,1953,1,"female",1564,180,119,1142,221,1142,177,0,44
1179437,108,7,1905,3,"female",1380,247,100,80,100,0,8,80,92
1179452,21,5,1992,2,"male",679,159,143,7,3,7,1,0,2
1179482,74,18,1939,7,"male",1573,6,5,1,0,1,0,0,0
1179493,14,10,1999,2,"male",226,112,69,2,54,2,51,0,3
1179499,49,5,1964,12,"male",64,10,10,15,1,15,1,0,0
1179502,18,24,1995,9,"female",198,74,41,22,0,0,0,22,0
1179510,58,27,1955,8,"female",1755,214,149,83,212,0,108,83,104
1179517,22,11,1991,5,"female",258,46,36,0,0,0,0,0,0
1179551,36,18,1977,12,"male",1409,1037,243,475,346,376,153,99,193
1179569,23,2,1990,2,"male",21,3,3,5,0,5,0,0,0
1179579,30,4,1983,10,"male",226,21,6,2,1,0,0,2,1
1179598,53,5,1960,11,"female",1352,50,21,0,0,0,0,0,0
1179622,54,11,1959,5,"female",122,208,201,720,107,2,28,718,79
1179653,26,18,1987,8,"male",651,11,8,1,0,1,0,0,0
1179685,74,11,1939,7,"male",301,1,1,0,0,0,0,0,0
1179698,33,1,1980,1,"male",320,0,0,0,0,0,0,0,0
1179744,18,26,1995,2,"female",368,3728,1654,444,574,444,476,0,98
1179776,16,14,1997,9,"female",516,244,88,46,1,3,0,43,1
1179795,54,21,1959,2,"male",19,23,19,12,6,7,2,5,4
1179800,83,22,1930,11,"male",255,261,210,75,23,75,7,0,16
1179807,26,10,1987,7,"male",199,32,26,0,0,0,0,0,0
1179837,25,9,1988,10,"female",261,27,9,2,4,0,0,2,4
1179853,16,18,1997,10,"female",249,113,100,4,12,2,4,2,8
1179858,66,5,1947,1,"female",1611,338,70,137,115,0,44,137,71
1179861,21,6,1992,6,"male",949,189,122,2,1,2,1,0,0
1179887,15,4,1998,3,"female",198,12,9,0,0,0,0,0,0
1179900,23,19,1990,10,"female",512,107,62,375,322,375,287,0,35
1179934,54,13,1959,12,"male",620,23,16,1268,60,864,34,404,26
1179976,21,1,1992,1,"male",4,41,40,0,0,0,0,0,0
1179981,19,28,1994,7,"male",249,63,24,17,10,15,10,2,0
1180009,35,20,1978,6,"female",34,54,31,49,31,49,30,0,1
1180011,24,10,1989,2,"male",1451,520,375,1331,585,590,119,741,466
1180015,55,26,1958,1,"male",1262,357,240,0,30,0,9,0,21
1180040,32,6,1981,10,"male",300,200,83,61,30,58,20,3,10
1180077,20,22,1993,7,"female",243,111,107,175,47,170,32,5,15
1180123,25,3,1988,9,"male",637,193,145,118,112,108,38,10,74
1180170,25,9,1988,5,"female",1401,454,265,316,308,0,23,316,285
1180189,58,9,1955,3,"male",1290,57,10,0,0,0,0,0,0
1180200,51,31,1962,3,"female",103,76,41,35,2,35,1,0,1
1180230,60,14,1953,9,"male",366,219,23,6,22,6,15,0,7
1180255,25,20,1988,7,"female",390,1,0,0,0,0,0,0,0
1180270,61,20,1952,5,"female",838,64,23,1,0,1,0,0,0
1180316,52,15,1961,9,"male",1625,13,7,0,0,0,0,0,0
1180338,50,22,1963,8,"female",587,321,182,338,34,338,32,0,2
1180347,18,7,1995,7,"male",180,89,75,122,50,122,48,0,2
1180353,21,5,1992,10,"male",1380,635,329,101,58,83,46,18,12
1180364,19,15,1994,5,"male",324,33,22,11,1,11,1,0,0
1180373,57,4,1956,12,"female",473,115,86,190,82,15,27,175,55
1180380,103,17,1910,9,"male",1012,1028,744,61,46,61,35,0,11
1180381,29,22,1984,11,"male",673,65,9,0,0,0,0,0,0
1180386,108,12,1905,1,"female",226,115,86,236,162,0,25,236,137
1180431,113,1,1900,11,NA,1252,441,309,385,313,169,97,216,216
1180435,35,5,1978,7,"male",296,18,12,7,6,7,3,0,3
1180455,23,4,1990,5,"male",270,344,145,378,62,354,23,24,39
1180477,37,16,1976,8,"male",690,137,33,1,0,1,0,0,0
1180487,26,8,1987,10,"male",586,82,23,11,4,11,3,0,1
1180492,25,3,1988,6,"male",234,78,49,62,32,62,30,0,2
1180509,34,1,1979,1,"male",1333,73,39,154,4,154,4,0,0
1180542,38,25,1975,12,"male",1017,131,75,0,0,0,0,0,0
1180548,32,18,1981,5,"female",359,59,17,4,8,4,3,0,5
1180576,32,10,1981,5,"female",501,105,63,50,126,48,81,2,45
1180614,51,30,1962,9,"female",33,53,51,35,113,35,35,0,78
1180617,20,7,1993,1,"male",4,72,72,9,0,3,0,6,0
1180624,57,1,1956,1,"female",1780,145,110,515,202,298,52,217,150
1180644,103,15,1910,1,"male",939,1405,944,49,3,47,2,2,1
1180659,19,9,1994,3,"male",142,183,103,55,650,19,380,36,270
1180662,46,1,1967,11,"female",519,206,169,193,70,193,50,0,20
1180682,18,30,1995,8,"female",236,535,271,236,804,86,525,150,279
1180708,24,11,1989,11,"male",112,13,12,0,1,0,0,0,1
1180746,55,29,1958,5,"male",1688,471,352,41,19,10,13,31,6
1180755,28,1,1985,1,"male",336,65,32,5,18,5,6,0,12
1180778,107,10,1906,6,"female",1194,118,58,692,72,0,7,692,65
1180780,39,3,1974,1,"male",412,66,39,18,1,0,0,18,1
1180800,17,18,1996,4,"male",90,81,11,0,3,0,2,0,1
1180806,26,5,1987,3,"female",589,1400,761,2132,350,2132,264,0,86
1180822,65,4,1948,10,"female",481,46,17,88,86,6,57,82,29
1180826,29,10,1984,2,"male",24,54,54,61,19,59,14,2,5
1180845,15,5,1998,4,"female",217,2,2,12,1,12,0,0,1
1180906,17,16,1996,6,"male",154,192,145,465,181,454,101,11,80
1180935,18,27,1995,8,"female",173,134,84,5,39,3,22,2,17
1180941,33,16,1980,5,"male",249,30,20,58,10,51,10,7,0
1180965,27,11,1986,5,"male",727,70,31,9,0,9,0,0,0
1180970,38,6,1975,6,"female",383,111,71,51,123,1,25,50,98
1180974,69,2,1944,5,"male",1467,108,54,18,71,18,57,0,14
1180990,108,21,1905,5,"female",2138,213,111,36,3,6,2,30,1
1180995,29,15,1984,3,"male",164,11,10,3,0,3,0,0,0
1181008,44,11,1969,5,"female",245,24,10,2,18,2,7,0,11
1181020,25,8,1988,10,"male",592,139,81,36,19,35,8,1,11
1181031,68,1,1945,4,"female",614,1089,990,2,14,2,6,0,8
1181042,22,8,1991,8,"female",698,247,126,29,65,29,25,0,40
1181047,26,5,1987,9,"male",427,942,586,5443,1100,5443,1008,0,92
1181083,28,28,1985,9,"female",342,544,405,46,63,46,18,0,45
1181088,31,27,1982,12,"female",162,30,15,128,94,128,92,0,2
1181103,25,20,1988,10,"male",399,151,119,0,3,0,3,0,0
1181107,44,24,1969,2,"female",429,37,15,148,107,141,93,7,14
1181120,30,27,1983,10,"male",430,15,9,1,0,1,0,0,0
1181165,20,5,1993,12,"male",618,210,169,5,4,5,2,0,2
1181215,22,2,1991,2,"female",494,151,53,83,177,5,73,78,104
1181228,29,14,1984,2,"female",286,24,15,1,10,1,10,0,0
1181235,102,15,1911,8,"male",676,84,47,70,35,70,7,0,28
1181247,16,16,1997,9,"female",174,304,268,0,1,0,0,0,1
1181254,51,2,1962,6,"female",130,43,13,74,212,74,166,0,46
1181288,20,3,1993,2,"female",812,242,98,429,378,429,300,0,78
1181303,27,15,1986,5,"male",662,114,72,34,0,27,0,7,0
1181306,23,3,1990,12,"male",1089,213,134,15,4,15,3,0,1
1181324,16,26,1997,7,"male",211,95,55,0,0,0,0,0,0
1181335,21,2,1992,6,"male",236,34,26,45,82,25,45,20,37
1181336,69,14,1944,3,"male",613,62,12,4,4,0,2,4,2
1181347,55,10,1958,5,"female",306,31,21,128,5,128,3,0,2
1181355,33,1,1980,5,"male",313,171,135,15,10,15,10,0,0
1181411,26,8,1987,10,"female",629,817,475,911,293,897,265,14,28
1181414,108,29,1905,4,"male",1359,520,314,320,306,320,185,0,121
1181420,25,1,1988,10,"male",218,16,15,2,0,2,0,0,0
1181458,61,1,1952,12,"female",1518,109,54,68,225,68,132,0,93
1181461,14,19,1999,7,"male",138,45,25,20,1,20,1,0,0
1181482,17,22,1996,8,"female",605,733,499,36,50,22,31,14,19
1181483,23,16,1990,2,"female",280,68,60,0,1,0,1,0,0
1181488,63,23,1950,3,"female",1631,70,26,68,29,68,16,0,13
1181490,15,2,1998,10,"female",780,725,317,4596,1310,3650,766,946,544
1181491,29,1,1984,11,"female",446,48,22,36,55,36,53,0,2
1181500,34,25,1979,11,"male",407,83,61,103,9,100,4,3,5
1181508,19,12,1994,10,"female",376,387,204,1443,1620,1441,1247,2,373
1181509,56,28,1957,1,"female",809,282,151,729,407,118,167,611,240
1181528,64,23,1949,8,"male",787,9,4,2,6,0,0,2,6
1181529,20,26,1993,10,"male",212,177,68,1,3,1,2,0,1
1181542,31,7,1982,7,"female",1170,283,206,1069,821,531,554,538,267
1181562,14,24,1999,6,"female",503,29,28,1,2,1,2,0,0
1181584,53,12,1960,4,"male",286,18,14,0,0,0,0,0,0
1181588,100,14,1913,1,"female",1722,88,37,55,52,27,33,28,19
1181591,14,24,1999,2,"male",571,375,358,16,14,0,5,16,9
1181596,37,2,1976,2,"male",456,92,54,3,8,1,2,2,6
1181597,42,14,1971,2,"female",369,22,11,55,2,55,2,0,0
1181599,14,13,1999,3,"male",25,166,152,615,49,602,41,13,8
1181613,14,6,1999,5,"male",50,466,445,18,80,18,75,0,5
1181614,50,22,1963,2,"female",566,20,16,3,0,3,0,0,0
1181622,13,1,2000,7,"female",14,72,37,50,189,49,105,1,84
1181623,51,22,1962,1,"male",208,3,2,9,2,0,2,9,0
1181643,28,27,1985,10,"male",21,23,13,0,13,0,5,0,8
1181676,20,2,1993,2,"male",397,33,11,0,0,0,0,0,0
1181679,41,25,1972,9,"male",46,3,2,3,2,2,1,1,1
1181699,14,1,1999,4,"female",201,380,122,190,226,190,180,0,46
1181701,26,1,1987,1,"male",419,30,9,2,1,2,1,0,0
1181712,51,21,1962,3,"female",1156,45,23,30,3,30,2,0,1
1181729,28,14,1985,11,"male",371,801,670,871,222,871,200,0,22
1181740,57,1,1956,4,"male",255,5,4,0,1,0,0,0,1
1181752,57,17,1956,1,"male",20,4,4,3,1,3,1,0,0
1181756,53,1,1960,2,"female",396,0,0,0,0,0,0,0,0
1181771,23,17,1990,12,"female",413,46,26,1,0,0,0,1,0
1181772,72,15,1941,2,"female",308,120,97,0,1,0,1,0,0
1181783,46,24,1967,10,"female",431,110,51,39,28,0,14,39,14
1181834,59,19,1954,6,"female",129,35,32,1,1,1,1,0,0
1181838,56,2,1957,6,"male",1935,45,14,17,25,16,16,1,9
1181850,20,19,1993,2,"male",671,198,114,28,3,26,2,2,1
1181855,46,28,1967,2,"male",395,87,62,27,1,27,1,0,0
1181862,24,25,1989,9,"male",122,237,219,1,1,1,1,0,0
1181902,24,21,1989,7,"male",788,381,164,326,329,326,251,0,78
1181917,21,12,1992,7,"male",54,8,6,0,0,0,0,0,0
1181939,15,29,1998,8,"female",625,2825,1281,528,3535,451,3060,77,475
1181963,20,17,1993,9,"female",113,63,4,0,0,0,0,0,0
1181980,93,1,1920,1,"male",576,39,33,1,1,0,0,1,1
1181996,16,16,1997,11,"male",564,137,90,0,0,0,0,0,0
1182022,19,10,1994,11,"male",270,131,87,20,3,0,0,20,3
1182024,23,9,1990,1,"female",274,167,124,433,474,284,155,149,319
1182030,17,25,1996,2,"female",172,346,29,1244,1556,1244,876,0,680
1182043,18,30,1995,5,"female",235,261,133,382,302,143,213,239,89
1182047,38,14,1975,9,"male",276,167,144,363,190,363,127,0,63
1182062,41,29,1972,10,"female",518,104,61,3,2,3,1,0,1
1182077,64,1,1949,3,"female",229,180,49,3,2,3,0,0,2
1182093,52,27,1961,11,"female",96,203,17,8,4,8,4,0,0
1182094,18,14,1995,1,"male",710,232,127,0,0,0,0,0,0
1182112,14,14,1999,4,"male",49,84,81,6,1,6,0,0,1
1182124,23,10,1990,7,"male",1263,336,294,9,6,9,6,0,0
1182125,21,29,1992,9,"male",408,371,302,57,91,57,87,0,4
1182132,18,4,1995,3,"male",189,30,13,10,17,0,7,10,10
1182150,28,28,1985,12,"male",427,73,62,10,20,10,18,0,2
1182151,13,3,2000,7,"female",13,230,77,4,107,4,81,0,26
1182154,16,31,1997,8,"male",257,3,2,0,0,0,0,0,0
1182157,23,17,1990,10,"male",222,692,424,884,533,653,217,231,316
1182164,71,15,1942,6,"male",450,10,7,3,0,0,0,3,0
1182166,17,3,1996,4,"male",426,169,133,228,113,220,65,8,48
1182187,25,12,1988,3,"male",303,36,26,68,23,53,0,15,23
1182201,25,31,1988,8,"female",183,5,3,2,204,0,3,2,201
1182212,20,4,1993,12,"male",316,53,29,1,19,1,13,0,6
1182222,42,19,1971,3,"female",27,69,22,2150,858,180,94,1970,764
1182272,19,17,1994,3,"male",363,11,10,0,0,0,0,0,0
1182282,15,10,1998,9,"female",436,1331,683,471,674,52,433,419,241
1182286,31,13,1982,9,"female",144,87,52,134,46,134,40,0,6
1182290,22,27,1991,1,"female",93,12,2,10,15,0,3,10,12
1182301,47,12,1966,9,"male",236,49,29,15,5,1,3,14,2
1182305,59,13,1954,7,"female",537,118,67,1,0,1,0,0,0
1182332,51,10,1962,6,"male",758,78,37,8,4,7,2,1,2
1182350,15,24,1998,3,"female",39,132,78,73,26,73,12,0,14
1182364,18,22,1995,3,"female",404,3769,2550,3162,1258,2941,630,221,628
1182366,13,21,2000,3,"male",61,0,0,0,0,0,0,0,0
1182395,14,1,1999,8,"female",325,950,71,0,46,0,35,0,11
1182408,33,12,1980,12,"male",50,23,21,8,20,0,19,8,1
1182424,28,2,1985,11,"male",370,45,31,0,21,0,16,0,5
1182433,33,3,1980,3,"female",624,495,215,105,177,23,120,82,57
1182458,21,14,1992,11,"male",447,388,168,62,87,62,53,0,34
1182473,58,30,1955,11,"male",100,77,45,1,3,1,1,0,2
1182481,19,27,1994,3,"male",763,444,303,6,1,0,0,6,1
1182493,19,21,1994,11,"female",207,303,162,0,0,0,0,0,0
1182494,29,18,1984,2,"male",607,69,31,10,7,0,0,10,7
1182497,16,7,1997,8,"female",648,348,235,0,0,0,0,0,0
1182510,23,23,1990,10,"female",473,137,79,30,14,27,9,3,5
1182519,23,13,1990,2,"male",47,62,62,13,9,13,9,0,0
1182545,17,14,1996,2,"male",193,24,19,3,0,2,0,1,0
1182560,56,24,1957,2,"male",27,3,3,1,0,1,0,0,0
1182561,29,13,1984,4,"female",784,28,11,0,0,0,0,0,0
1182571,57,18,1956,12,"male",221,82,40,21,2,4,2,17,0
1182585,29,7,1984,8,"male",498,327,208,33,25,30,21,3,4
1182596,44,9,1969,8,"male",365,2,0,0,0,0,0,0,0
1182641,65,13,1948,7,"female",2054,54,23,169,98,151,57,18,41
1182715,16,1,1997,5,"male",204,12,10,0,0,0,0,0,0
1182730,18,27,1995,12,"male",181,514,236,0,29,0,23,0,6
1182755,20,24,1993,7,"female",6,32,30,9,13,9,8,0,5
1182766,50,1,1963,9,"male",281,2,1,0,2,0,2,0,0
1182793,63,2,1950,11,"female",72,7,1,0,0,0,0,0,0
1182842,24,26,1989,8,"female",186,59,34,14,3,14,3,0,0
1182879,19,14,1994,2,"female",487,96,70,0,0,0,0,0,0
1182894,52,12,1961,3,"female",5,19,12,2,3,0,0,2,3
1182923,50,15,1963,7,"male",676,5,5,0,0,0,0,0,0
1182926,26,21,1987,6,"male",241,126,119,24,0,21,0,3,0
1182962,108,6,1905,12,NA,1988,599,234,130,81,129,62,1,19
1182988,14,9,1999,12,"female",199,55,40,0,0,0,0,0,0
1183038,67,29,1946,4,"female",404,43,33,68,3,68,2,0,1
1183044,73,2,1940,2,"female",1639,134,76,57,217,53,146,4,71
1183066,108,1,1905,1,"male",2394,324,64,0,1,0,1,0,0
1183132,93,16,1920,4,"female",1547,20,12,11,5,3,0,8,5
1183147,55,5,1958,5,"male",480,33,25,70,78,0,1,70,77
1183153,23,10,1990,3,"male",168,59,47,13,1,13,1,0,0
1183166,19,12,1994,11,"female",424,239,137,814,655,814,302,0,353
1183170,40,23,1973,3,"male",83,36,32,0,0,0,0,0,0
1183189,53,18,1960,2,"male",136,29,22,50,9,50,5,0,4
1183211,32,9,1981,10,"male",674,34,21,0,0,0,0,0,0
1183232,61,31,1952,12,"male",294,11,6,4,1,0,0,4,1
1183233,68,8,1945,8,"male",216,112,101,7,9,7,6,0,3
1183237,18,1,1995,1,"female",19,182,162,65,345,65,293,0,52
1183249,65,2,1948,5,"female",1532,133,49,353,221,0,15,353,206
1183259,38,23,1975,9,"male",1307,21,10,18,26,18,22,0,4
1183269,43,25,1970,11,"male",184,17,3,3,1,3,1,0,0
1183276,18,20,1995,7,"male",94,154,125,8,1,8,0,0,1
1183281,16,28,1997,8,"male",466,1496,1238,6,0,0,0,6,0
1183297,19,10,1994,11,"male",674,1126,979,8,35,6,26,2,9
1183299,62,9,1951,3,"male",635,294,279,0,0,0,0,0,0
1183311,108,28,1905,11,"female",1756,39,17,78,79,38,27,40,52
1183338,20,23,1993,8,"female",1620,581,233,306,202,191,119,115,83
1183349,44,3,1969,10,"male",437,23,12,0,0,0,0,0,0
1183365,72,14,1941,12,"female",1564,66,21,265,195,135,161,130,34
1183369,54,7,1959,3,"male",639,112,51,30,23,2,6,28,17
1183373,18,6,1995,2,"male",361,449,201,0,0,0,0,0,0
1183412,28,1,1985,10,"male",624,30,25,1,1,1,1,0,0
1183418,53,14,1960,2,"male",1243,114,59,13,35,12,20,1,15
1183424,44,1,1969,1,"male",963,95,32,102,97,86,32,16,65
1183427,24,11,1989,2,"male",345,58,24,0,1,0,0,0,1
1183454,18,28,1995,4,"female",198,229,71,7,8,7,7,0,1
1183457,30,6,1983,9,"female",282,3,3,0,0,0,0,0,0
1183470,31,10,1982,12,"male",620,56,37,0,11,0,3,0,8
1183475,103,13,1910,12,"male",748,795,442,18,20,0,9,18,11
1183479,23,1,1990,1,"male",38,1,1,5,1,5,0,0,1
1183492,21,4,1992,4,"male",1484,147,64,3,0,3,0,0,0
1183506,52,11,1961,3,"female",708,1086,584,8,3,7,3,1,0
1183525,23,17,1990,8,"female",153,47,38,209,322,193,226,16,96
1183549,27,20,1986,6,"male",979,82,27,12,23,12,22,0,1
1183560,47,9,1966,5,"male",393,1,1,0,0,0,0,0,0
1183592,108,6,1905,10,"male",1485,186,94,17,8,17,7,0,1
1183618,23,8,1990,12,"male",405,180,155,0,1,0,1,0,0
1183635,67,9,1946,7,"male",860,47,29,3,1,0,1,3,0
1183638,31,20,1982,8,"male",329,5,5,0,0,0,0,0,0
1183640,61,27,1952,6,"female",535,31,14,0,0,0,0,0,0
1183646,57,13,1956,10,"female",538,334,143,2184,2360,2184,1626,0,734
1183651,32,5,1981,8,"male",230,16,12,12,5,12,3,0,2
1183666,39,6,1974,5,"female",270,37,19,1117,341,637,130,480,211
1183702,108,16,1905,6,"female",749,420,173,0,0,0,0,0,0
1183704,21,19,1992,11,"male",108,5,4,0,0,0,0,0,0
1183760,18,28,1995,9,"female",346,46,23,1,25,0,12,1,13
1183762,26,15,1987,3,"male",393,96,67,0,3,0,1,0,2
1183775,29,16,1984,3,"female",398,306,162,578,262,578,89,0,173
1183808,34,28,1979,2,"male",398,138,96,0,122,0,36,0,86
1183853,33,8,1980,2,"male",780,58,24,2,0,2,0,0,0
1183854,58,21,1955,9,"female",628,106,43,139,16,0,4,139,12
1183863,20,24,1993,3,"male",5,2,1,0,0,0,0,0,0
1183885,30,15,1983,2,"female",297,33,19,75,42,75,38,0,4
1183963,35,10,1978,3,"male",164,68,65,326,20,279,8,47,12
1183964,50,1,1963,8,"female",1335,312,222,3527,1592,761,697,2766,895
1183968,103,22,1910,5,"male",1377,613,350,481,618,444,383,37,235
1184020,18,22,1995,5,"female",279,27,21,25,39,22,26,3,13
1184094,57,3,1956,9,"female",2170,15,12,0,7,0,5,0,2
1184097,20,12,1993,4,"male",619,134,105,4,3,0,2,4,1
1184126,13,9,2000,5,"female",349,447,220,46,36,46,35,0,1
1184153,33,26,1980,11,"male",906,49,34,0,0,0,0,0,0
1184178,20,20,1993,12,"male",345,92,80,248,120,248,117,0,3
1184186,106,2,1907,10,"female",1308,107,35,176,93,169,68,7,25
1184289,36,30,1977,7,"male",561,49,23,10,1,10,1,0,0
1184290,29,9,1984,7,"male",485,70,49,0,0,0,0,0,0
1184310,27,6,1986,10,"male",388,34,25,1,3,1,1,0,2
1184318,19,23,1994,4,"male",657,36,15,7,1,0,0,7,1
1184324,20,13,1993,9,"female",779,4,2,3338,16,3272,8,66,8
1184326,108,1,1905,7,"female",250,78,52,223,152,41,37,182,115
1184358,67,24,1946,12,"female",2373,301,223,605,346,604,134,1,212
1184360,71,24,1942,5,"female",1863,101,40,288,62,288,51,0,11
1184363,64,10,1949,5,"female",173,6,6,0,3,0,3,0,0
1184367,17,4,1996,5,"female",894,1204,672,353,197,295,173,58,24
1184382,45,23,1968,10,"female",546,16,7,2,1,2,1,0,0
1184407,15,28,1998,8,"female",655,1680,263,26,112,26,66,0,46
1184422,23,4,1990,2,"female",281,85,47,376,175,376,168,0,7
1184423,21,12,1992,5,"male",345,1,1,5,2,5,2,0,0
1184432,25,1,1988,1,"male",59,32,21,3,3,3,3,0,0
1184476,14,1,1999,5,"female",225,2023,1460,296,3400,296,2162,0,1238
1184494,24,5,1989,10,"female",390,332,191,52,21,51,15,1,6
1184500,29,26,1984,5,"male",1451,120,49,7,3,7,1,0,2
1184510,28,27,1985,5,"female",513,787,446,1635,760,437,295,1198,465
1184515,74,8,1939,11,"male",683,87,22,509,810,3,205,506,605
1184519,66,30,1947,8,"female",627,93,55,9,39,0,28,9,11
1184531,78,4,1935,11,"male",1448,70,22,99,116,34,11,65,105
1184535,96,22,1917,3,"female",1515,253,95,50,46,0,21,50,25
1184556,69,20,1944,5,"female",1434,45,31,4,0,4,0,0,0
1184558,14,4,1999,5,"female",390,90,42,6,2,6,2,0,0
1184569,22,31,1991,10,"male",433,76,40,161,45,0,10,161,35
1184578,108,31,1905,12,"female",196,1709,97,5208,3307,4926,2484,282,823
1184629,61,3,1952,3,"male",30,38,22,131,22,131,15,0,7
1184634,59,11,1954,12,"male",2328,247,52,1,6,1,5,0,1
1184677,47,11,1966,7,"female",1461,72,17,348,73,337,60,11,13
1184680,57,25,1956,12,"female",571,56,19,10,0,10,0,0,0
1184682,19,26,1994,9,"female",1141,323,138,40,0,26,0,14,0
1184685,57,2,1956,1,"female",615,2,1,0,0,0,0,0,0
1184690,28,9,1985,11,"female",220,67,61,1,0,1,0,0,0
1184705,17,25,1996,1,"male",615,354,293,0,42,0,41,0,1
1184728,103,16,1910,12,"male",467,346,214,20,58,20,55,0,3
1184736,68,17,1945,7,"male",124,20,15,0,0,0,0,0,0
1184741,38,18,1975,4,"male",488,33,19,45,58,45,49,0,9
1184772,106,21,1907,2,"female",1301,240,61,2,5,2,4,0,1
1184775,75,18,1938,11,"male",1727,151,65,4,7,4,3,0,4
1184776,22,10,1991,6,"male",1385,47,31,0,0,0,0,0,0
1184840,15,13,1998,12,"female",126,507,357,1016,2053,1016,1308,0,745
1184841,25,23,1988,10,"male",126,96,60,3,2,0,1,3,1
1184859,26,2,1987,2,"male",531,72,71,17,1,17,1,0,0
1184931,65,29,1948,5,"male",1713,38,20,6,6,6,2,0,4
1184946,23,1,1990,3,"female",149,15,15,1,0,1,0,0,0
1184958,24,25,1989,7,"male",528,142,66,0,0,0,0,0,0
1185061,65,17,1948,6,"female",1591,49,17,19,18,14,9,5,9
1185063,21,6,1992,6,"female",75,96,29,0,0,0,0,0,0
1185064,85,13,1928,5,"male",1293,97,63,39,9,0,7,39,2
1185129,20,21,1993,9,"female",374,310,98,22,430,22,360,0,70
1185173,26,11,1987,7,"female",245,86,68,223,37,223,24,0,13
1185191,72,17,1941,10,"female",544,80,72,5,2,5,1,0,1
1185246,113,8,1900,7,"female",1147,49,31,33,18,0,6,33,12
1185247,25,28,1988,5,"male",114,146,90,3,18,3,7,0,11
1185258,18,1,1995,10,"male",64,22,21,4,0,4,0,0,0
1185275,27,31,1986,3,"male",457,56,51,3,0,0,0,3,0
1185279,36,27,1977,5,"female",59,0,0,0,0,0,0,0,0
1185300,17,12,1996,7,"female",545,2154,159,230,199,152,121,78,78
1185301,16,7,1997,4,"female",617,616,334,119,74,1,15,118,59
1185321,19,30,1994,6,"male",643,346,81,29,86,3,12,26,74
1185324,23,3,1990,3,"male",313,27,22,1,0,1,0,0,0
1185342,24,31,1989,10,"male",61,0,0,0,2,0,0,0,2
1185374,24,12,1989,11,"female",656,80,28,5,8,2,3,3,5
1185375,92,1,1921,6,"male",506,501,264,110,3,110,0,0,3
1185378,54,29,1959,10,"male",438,161,92,27,13,0,3,27,10
1185403,62,20,1951,2,"male",363,1,1,0,0,0,0,0,0
1185462,15,7,1998,5,"female",555,1010,400,1429,901,12,369,1417,532
1185498,19,5,1994,7,"male",374,109,70,57,77,57,62,0,15
1185500,54,15,1959,4,"female",67,35,30,193,230,193,69,0,161
1185502,29,16,1984,10,"male",54,0,0,0,0,0,0,0,0
1185525,18,4,1995,7,"male",1212,3,2,0,1,0,0,0,1
1185526,55,17,1958,7,"female",99,59,51,0,18,0,18,0,0
1185595,43,21,1970,2,"male",980,78,38,89,87,87,63,2,24
1185622,96,6,1917,1,"female",737,58,27,8,3,8,3,0,0
1185657,49,5,1964,6,"female",257,6,5,199,3,0,3,199,0
1185673,43,31,1970,12,"female",726,75,63,32,12,32,10,0,2
1185677,55,30,1958,5,"male",12,6,6,3,0,3,0,0,0
1185734,113,9,1900,2,"male",1164,86,22,0,6,0,5,0,1
1185745,25,1,1988,1,"male",262,72,18,53,15,53,15,0,0
1185753,58,16,1955,12,"male",710,1689,269,221,1074,3,317,218,757
1185764,26,1,1987,5,"male",150,122,77,27,1,27,1,0,0
1185797,27,7,1986,7,"male",101,20,11,1,0,1,0,0,0
1185798,19,7,1994,2,"male",409,484,141,27,6,0,3,27,3
1185799,26,1,1987,1,"male",534,1354,1256,27,9,27,9,0,0
1185809,25,2,1988,1,"male",24,4,4,0,0,0,0,0,0
1185839,22,11,1991,3,"female",470,625,340,1028,270,609,124,419,146
1185843,27,20,1986,7,"male",220,58,49,3,0,3,0,0,0
1185871,65,4,1948,2,"female",844,68,41,1,1,1,1,0,0
1185889,16,16,1997,12,"male",154,1,1,0,0,0,0,0,0
1185966,25,1,1988,1,"male",19,20,16,2,5,2,5,0,0
1185971,21,6,1992,2,"male",19,0,0,0,0,0,0,0,0
1185993,32,1,1981,1,"male",147,22,10,2179,4,2179,3,0,1
1186005,46,27,1967,11,"female",455,24,15,75,84,68,57,7,27
1186031,66,1,1947,9,"male",816,38,18,6,3,4,3,2,0
1186046,58,28,1955,8,"female",941,139,57,2050,2095,2047,190,3,1905
1186053,65,20,1948,2,"female",661,20,19,29,16,0,3,29,13
1186091,27,4,1986,9,"male",175,56,37,0,0,0,0,0,0
1186093,41,12,1972,2,"male",65,4,1,0,0,0,0,0,0
1186106,16,7,1997,1,"male",566,103,51,152,22,126,15,26,7
1186125,41,1,1972,1,"male",272,40,21,260,93,104,35,156,58
1186143,49,27,1964,9,"male",834,167,102,315,27,116,0,199,27
1186150,19,16,1994,8,"male",136,65,50,3,1,3,1,0,0
1186167,19,2,1994,12,"male",391,161,127,0,15,0,6,0,9
1186187,27,10,1986,7,"female",594,102,36,1,76,1,39,0,37
1186236,108,9,1905,7,"female",39,2,2,1,1,0,0,1,1
1186244,40,17,1973,11,"female",460,22,14,5,10,5,6,0,4
1186255,18,11,1995,3,"female",476,505,237,40,153,35,88,5,65
1186285,28,14,1985,10,"male",21,14,12,26,3,6,3,20,0
1186300,19,24,1994,10,"female",103,200,152,2175,17,2049,14,126,3
1186303,21,18,1992,11,"female",202,201,101,586,412,586,362,0,50
1186304,94,7,1919,1,"female",864,4359,835,110,211,110,180,0,31
1186312,55,4,1958,1,"male",1758,188,48,7,33,7,30,0,3
1186319,27,25,1986,3,"male",570,150,94,0,42,0,39,0,3
1186322,17,2,1996,11,"female",355,773,641,32,25,32,18,0,7
1186329,19,12,1994,11,"female",404,246,192,28,20,28,10,0,10
1186358,33,28,1980,2,"male",373,3,1,0,0,0,0,0,0
1186359,32,29,1981,3,"male",212,1,1,2,2,2,2,0,0
1186378,28,1,1985,7,"female",989,269,119,3,54,3,40,0,14
1186388,33,6,1980,9,"male",509,19,14,0,4,0,0,0,4
1186431,27,15,1986,10,"male",192,62,54,4,38,4,32,0,6
1186450,15,23,1998,2,"male",220,116,98,9,1,5,1,4,0
1186458,14,30,1999,10,"female",413,198,57,76,67,0,18,76,49
1186471,18,22,1995,3,"male",569,55,23,147,30,147,26,0,4
1186476,16,15,1997,2,"female",462,240,105,258,139,258,131,0,8
1186532,31,12,1982,6,"male",250,20,17,0,0,0,0,0,0
1186542,15,16,1998,11,"female",50,69,46,20,40,20,23,0,17
1186545,14,27,1999,6,"female",31,205,40,6,16,6,14,0,2
1186561,22,15,1991,5,"female",184,46,33,19,14,19,13,0,1
1186566,29,3,1984,5,"male",382,64,18,0,0,0,0,0,0
1186602,15,4,1998,10,"male",671,157,11,1,8,0,1,1,7
1186625,26,17,1987,7,"male",499,119,92,0,1,0,1,0,0
1186628,108,3,1905,11,"male",1125,368,124,53,47,53,43,0,4
1186660,31,29,1982,11,"male",395,58,35,9,3,9,3,0,0
1186668,15,3,1998,6,"female",659,79,37,16,12,7,3,9,9
1186673,27,1,1986,4,"female",194,5,3,0,0,0,0,0,0
1186709,26,27,1987,11,"male",829,71,35,0,0,0,0,0,0
1186722,21,22,1992,10,"male",726,249,171,2,4,2,4,0,0
1186752,19,29,1994,8,"male",545,140,52,471,408,242,149,229,259
1186760,57,5,1956,7,"female",1486,21,14,160,60,70,32,90,28
1186779,28,8,1985,2,"male",440,46,21,0,0,0,0,0,0
1186789,47,14,1966,5,"female",123,216,174,22,20,22,20,0,0
1186806,63,28,1950,9,"male",1080,14,13,37,4,37,4,0,0
1186829,22,1,1991,6,"male",163,239,213,11,3,3,0,8,3
1186832,56,4,1957,11,"male",1364,76,29,13,8,5,4,8,4
1186843,34,18,1979,2,"male",113,35,29,2,1,2,1,0,0
1186853,20,6,1993,3,"male",121,227,179,8,29,3,18,5,11
1186856,60,12,1953,11,"female",265,36,15,16,4,16,4,0,0
1186862,29,1,1984,1,"male",321,150,54,46,37,46,36,0,1
1186868,23,13,1990,7,"female",607,480,173,501,336,501,312,0,24
1186926,42,7,1971,10,"female",1028,56,28,144,60,143,40,1,20
1186937,62,9,1951,3,"female",592,35,27,1,19,0,17,1,2
1186964,49,7,1964,3,"male",430,192,122,0,13,0,1,0,12
1186989,46,1,1967,8,"male",279,14,13,3,0,1,0,2,0
1187043,34,11,1979,3,"male",232,53,41,0,0,0,0,0,0
1187062,15,8,1998,12,"male",421,333,304,0,4,0,2,0,2
1187072,21,12,1992,10,"female",788,128,67,603,166,590,87,13,79
1187100,18,2,1995,6,"female",427,378,198,626,623,409,327,217,296
1187119,19,17,1994,3,"male",304,30,28,0,0,0,0,0,0
1187142,41,31,1972,12,"male",676,56,32,0,4,0,2,0,2
1187200,16,30,1997,9,"male",281,141,101,1,0,1,0,0,0
1187225,21,1,1992,1,"male",149,20,20,0,0,0,0,0,0
1187255,27,23,1986,7,"male",50,23,17,1,1,1,1,0,0
1187266,18,10,1995,5,"male",481,150,135,26,53,26,38,0,15
1187283,24,2,1989,7,"male",478,85,41,135,27,135,21,0,6
1187285,18,24,1995,2,"female",263,19,7,0,1,0,0,0,1
1187298,20,9,1993,2,"female",288,54,33,0,0,0,0,0,0
1187315,22,18,1991,9,"male",1674,282,132,116,294,106,243,10,51
1187319,64,4,1949,9,"female",1743,39,13,23,31,20,7,3,24
1187341,42,15,1971,4,"male",250,31,20,3,0,3,0,0,0
1187350,30,27,1983,12,"female",912,48,17,50,14,50,13,0,1
1187379,61,25,1952,10,"male",1039,39,4,1,0,0,0,1,0
1187381,67,13,1946,9,"male",783,113,55,88,190,0,99,88,91
1187408,53,11,1960,8,"female",672,6,5,0,0,0,0,0,0
1187410,21,1,1992,9,"male",5,1,1,1,0,0,0,1,0
1187413,33,18,1980,5,"male",132,206,180,69,80,69,69,0,11
1187420,45,6,1968,2,"male",1919,3826,709,1483,4618,521,964,962,3654
1187458,26,17,1987,2,"male",542,123,58,1,0,1,0,0,0
1187470,52,1,1961,7,"male",456,43,15,5,0,5,0,0,0
1187497,24,25,1989,8,"male",1556,407,144,18,37,18,33,0,4
1187547,23,3,1990,6,"male",297,352,295,455,205,455,166,0,39
1187553,30,24,1983,9,"male",562,71,43,1,0,1,0,0,0
1187554,68,18,1945,9,"female",661,1665,416,6871,2627,6871,2045,0,582
1187572,20,12,1993,6,"male",460,112,91,213,18,195,17,18,1
1187589,49,9,1964,6,"female",944,118,39,8,61,8,33,0,28
1187598,40,29,1973,9,"male",259,22,17,301,215,9,46,292,169
1187600,23,18,1990,12,"female",188,112,18,895,1338,688,754,207,584
1187610,19,21,1994,7,"male",400,1724,1112,895,998,52,771,843,227
1187615,15,13,1998,5,"female",214,149,50,80,4,80,3,0,1
1187620,18,24,1995,12,"male",148,1282,1070,632,570,542,466,90,104
1187623,20,12,1993,11,"male",753,53,25,0,0,0,0,0,0
1187624,66,2,1947,12,"female",408,60,46,272,67,0,16,272,51
1187664,54,2,1959,9,"female",305,87,52,2,0,2,0,0,0
1187669,32,30,1981,9,"female",567,27,15,38,16,38,11,0,5
1187673,16,12,1997,2,"male",260,100,54,30,4,30,4,0,0
1187694,68,11,1945,12,"male",188,15,9,3,5,3,3,0,2
1187703,26,31,1987,1,"female",680,266,159,1368,1331,244,519,1124,812
1187727,22,1,1991,1,"male",512,87,58,0,6,0,6,0,0
1187729,26,21,1987,11,"female",217,304,258,138,17,138,9,0,8
1187755,19,13,1994,3,"female",113,17,17,241,1052,240,346,1,706
1187775,41,26,1972,8,"female",1261,230,121,751,425,220,235,531,190
1187822,22,18,1991,6,"male",17,5,5,2,0,0,0,2,0
1187830,66,19,1947,10,"male",702,82,28,0,0,0,0,0,0
1187860,26,25,1987,5,"male",665,323,160,5,28,2,10,3,18
1187887,59,31,1954,10,"female",324,22,13,2,1,2,0,0,1
1187926,38,29,1975,7,"male",582,44,13,29,2,29,2,0,0
1187948,103,5,1910,12,"female",1692,170,130,1611,2226,699,1134,912,1092
1187958,15,29,1998,7,"male",195,118,85,2,9,2,1,0,8
1187963,56,19,1957,11,"female",719,72,32,290,192,0,59,290,133
1187982,40,18,1973,7,"male",363,39,21,2,12,2,5,0,7
1187987,108,14,1905,8,"female",1808,195,84,411,145,341,95,70,50
1188002,56,30,1957,6,"female",446,59,28,33,1,33,1,0,0
1188011,63,1,1950,5,"male",208,191,125,3,1,0,0,3,1
1188027,21,4,1992,10,"male",208,288,255,269,143,243,105,26,38
1188030,47,20,1966,7,"female",331,124,80,548,94,548,14,0,80
1188084,17,19,1996,12,"female",455,163,75,330,104,298,64,32,40
1188095,53,7,1960,9,"male",731,74,64,0,12,0,7,0,5
1188099,20,25,1993,8,"male",318,267,252,0,1,0,1,0,0
1188197,37,19,1976,11,"female",423,103,8,0,4,0,4,0,0
1188212,44,20,1969,1,"male",451,40,14,0,0,0,0,0,0
1188231,25,12,1988,2,"female",294,92,78,1,0,1,0,0,0
1188241,67,26,1946,4,"female",958,16,11,0,0,0,0,0,0
1188256,108,12,1905,7,"female",1055,2922,1366,4,107,4,69,0,38
1188269,22,20,1991,11,"male",325,45,18,24,43,24,28,0,15
1188283,15,23,1998,1,"male",6,0,0,0,0,0,0,0,0
1188305,14,9,1999,4,"male",19,20,19,5,51,0,12,5,39
1188329,19,1,1994,1,"male",41,39,29,0,0,0,0,0,0
1188333,26,6,1987,9,"male",13,21,20,0,0,0,0,0,0
1188340,17,22,1996,5,"female",326,758,526,61,122,61,23,0,99
1188376,21,29,1992,9,"male",376,15,7,0,2,0,0,0,2
1188393,24,8,1989,7,"female",162,31,10,1049,532,1049,480,0,52
1188401,41,3,1972,4,"male",574,173,147,109,8,108,8,1,0
1188404,54,22,1959,2,"male",684,196,42,35,68,26,27,9,41
1188414,17,16,1996,5,"female",385,117,48,141,155,2,82,139,73
1188438,42,17,1971,11,"male",293,78,59,630,563,600,421,30,142
1188463,20,22,1993,12,"female",81,36,31,250,71,232,44,18,27
1188468,70,21,1943,2,"female",53,29,17,1,4,0,0,1,4
1188476,51,1,1962,7,"male",256,186,169,1045,33,1045,19,0,14
1188511,19,18,1994,10,"male",496,97,77,0,0,0,0,0,0
1188537,54,24,1959,3,"male",1446,433,222,124,193,112,109,12,84
1188549,113,7,1900,4,"male",1246,288,219,495,223,44,127,451,96
1188578,31,28,1982,12,"female",324,166,121,1,2,0,1,1,1
1188601,108,6,1905,12,"male",494,75,35,5,3,5,2,0,1
1188607,58,9,1955,5,"female",375,152,115,524,494,0,216,524,278
1188623,23,10,1990,8,"male",399,128,49,229,79,229,50,0,29
1188640,53,10,1960,5,"female",334,3,1,0,0,0,0,0,0
1188670,55,7,1958,7,"male",635,121,24,0,0,0,0,0,0
1188671,33,23,1980,9,"male",339,26,15,1,11,1,7,0,4
1188684,52,9,1961,3,"female",268,7,6,0,0,0,0,0,0
1188686,21,8,1992,8,"female",76,7,1,0,0,0,0,0,0
1188707,27,9,1986,7,"male",115,59,43,1,0,1,0,0,0
1188716,66,20,1947,8,"female",564,311,153,872,114,830,62,42,52
1188738,39,24,1974,9,"female",282,15,7,22,3,0,1,22,2
1188805,19,1,1994,11,"female",212,252,42,295,279,295,211,0,68
1188817,23,20,1990,10,"male",6,4,3,1,0,0,0,1,0
1188848,16,10,1997,11,"male",330,7,2,4,0,0,0,4,0
1188861,52,27,1961,6,"male",42,4,3,12,2,12,2,0,0
1188896,67,8,1946,2,"female",1756,183,122,482,324,348,169,134,155
1188913,64,16,1949,1,"female",1473,82,46,175,76,175,76,0,0
1188932,54,25,1959,1,"male",1315,50,28,9,4,4,0,5,4
1188947,103,3,1910,3,"female",646,445,282,0,29,0,12,0,17
1188960,83,25,1930,1,"female",1866,145,57,264,159,0,20,264,139
1188980,27,13,1986,7,"female",645,20,10,5,5,5,1,0,4
1188985,55,7,1958,1,"male",746,98,61,0,1,0,1,0,0
1189000,66,9,1947,4,"female",573,98,48,69,4,69,2,0,2
1189003,63,17,1950,3,"female",421,29,19,64,50,0,10,64,40
1189018,54,5,1959,5,"female",658,46,21,0,6,0,5,0,1
1189033,29,10,1984,2,"male",184,71,65,1,2,1,0,0,2
1189053,64,17,1949,2,"male",1352,73,30,0,0,0,0,0,0
1189079,93,2,1920,6,"female",349,110,50,0,0,0,0,0,0
1189086,17,24,1996,3,"male",92,113,89,0,1,0,1,0,0
1189090,17,21,1996,9,"female",174,191,102,159,72,159,48,0,24
1189091,32,28,1981,9,"male",221,222,202,6,7,6,2,0,5
1189104,33,8,1980,12,"female",68,46,27,369,213,369,178,0,35
1189115,18,27,1995,5,"male",393,223,139,0,0,0,0,0,0
1189135,61,29,1952,3,"female",448,913,798,305,93,305,54,0,39
1189165,49,6,1964,11,"female",434,101,60,66,31,51,18,15,13
1189203,45,20,1968,2,"female",285,24,14,20,0,7,0,13,0
1189204,69,24,1944,4,"male",348,0,0,0,0,0,0,0,0
1189225,43,27,1970,4,"male",368,142,97,1,3,1,3,0,0
1189233,93,1,1920,5,"female",239,269,222,233,433,91,114,142,319
1189237,14,25,1999,3,"female",103,119,78,31,7,31,7,0,0
1189247,37,5,1976,12,"male",535,31,15,41,0,41,0,0,0
1189300,101,12,1912,12,"female",450,7,6,9,1,1,0,8,1
1189324,59,15,1954,10,"female",767,107,64,33,1072,0,585,33,487
1189368,25,12,1988,10,"male",905,342,245,27,19,27,13,0,6
1189380,20,8,1993,6,"female",194,199,138,183,281,183,195,0,86
1189404,43,12,1970,12,"female",1603,170,62,217,140,217,89,0,51
1189418,14,11,1999,5,"female",405,138,58,109,7,98,2,11,5
1189420,23,10,1990,1,"female",234,78,46,3,0,0,0,3,0
1189442,70,9,1943,10,"female",273,75,49,30,54,9,30,21,24
1189445,38,28,1975,6,"female",299,40,24,2,6,0,1,2,5
1189451,17,18,1996,10,"male",215,169,46,17,6,17,5,0,1
1189457,19,1,1994,1,"male",589,1,0,0,0,0,0,0,0
1189463,24,16,1989,9,"female",335,46,14,49,50,48,27,1,23
1189479,62,15,1951,10,"female",113,110,29,27,96,0,41,27,55
1189480,15,22,1998,7,"male",63,107,103,0,8,0,7,0,1
1189493,16,25,1997,9,"female",494,2928,320,652,842,407,290,245,552
1189507,75,10,1938,12,"female",386,12,9,6,6,0,2,6,4
1189529,24,11,1989,7,"female",183,1,0,0,0,0,0,0,0
1189554,16,11,1997,8,"female",445,96,56,15,12,1,2,14,10
1189575,29,11,1984,10,"female",439,36,21,9,54,9,44,0,10
1189628,33,17,1980,3,"male",494,39,3,0,3,0,3,0,0
1189636,44,1,1969,2,"female",327,60,41,12,8,12,6,0,2
1189655,49,29,1964,11,"male",226,1,1,0,0,0,0,0,0
1189679,49,31,1964,12,"female",288,51,30,2820,61,0,12,2820,49
1189683,16,27,1997,2,"female",47,94,83,25,41,25,18,0,23
1189687,52,19,1961,5,"female",1556,669,592,1641,588,601,506,1040,82
1189700,17,4,1996,4,"female",570,149,39,0,3,0,2,0,1
1189704,21,6,1992,10,"male",52,67,56,0,0,0,0,0,0
1189730,18,10,1995,11,"male",186,124,100,2,0,2,0,0,0
1189740,14,20,1999,10,"male",309,148,72,0,4,0,2,0,2
1189754,25,8,1988,2,"male",108,86,48,4,1,4,1,0,0
1189794,90,13,1923,6,"male",620,430,366,76,18,61,10,15,8
1189798,17,23,1996,4,"female",299,132,86,11,7,11,5,0,2
1189813,27,14,1986,7,"male",255,53,13,12,0,12,0,0,0
1189821,19,1,1994,12,"female",551,370,162,346,702,302,263,44,439
1189838,90,13,1923,5,"female",1018,453,104,539,545,539,512,0,33
1189869,67,12,1946,10,"female",984,32,10,34,40,0,0,34,40
1189872,45,3,1968,2,"male",312,81,58,169,338,169,139,0,199
1189879,27,9,1986,12,"female",183,73,56,1,1,1,1,0,0
1189903,68,18,1945,12,"female",2221,190,134,142,99,139,69,3,30
1189908,41,15,1972,10,"female",206,168,116,55,66,55,49,0,17
1189928,56,1,1957,6,"female",397,49,34,69,25,69,7,0,18
1189931,20,2,1993,6,"male",207,82,35,9,10,9,5,0,5
1189986,18,26,1995,2,"female",239,122,77,20,15,20,11,0,4
1189992,36,24,1977,9,"male",691,39,34,1,1,1,1,0,0
1190002,19,14,1994,1,"female",312,552,373,2765,4393,2696,2151,69,2242
1190008,52,15,1961,12,"female",923,73,34,3,7,0,3,3,4
1190058,29,11,1984,12,"male",310,83,66,3,0,3,0,0,0
1190062,13,13,2000,8,"male",9,0,0,0,0,0,0,0,0
1190078,18,3,1995,1,"male",144,286,199,455,402,455,235,0,167
1190143,21,17,1992,5,"male",160,385,311,12,98,12,83,0,15
1190171,27,12,1986,11,"male",528,15,10,12,1,12,1,0,0
1190174,18,28,1995,10,"male",270,794,683,86,42,86,26,0,16
1190179,63,25,1950,5,"female",366,68,35,0,0,0,0,0,0
1190194,32,20,1981,10,"male",913,201,91,13,30,13,16,0,14
1190221,22,9,1991,12,"male",511,164,144,0,0,0,0,0,0
1190244,70,25,1943,1,"female",1505,260,146,583,170,2,9,581,161
1190274,70,4,1943,10,"male",1450,64,36,10,4,0,2,10,2
1190279,54,10,1959,2,"female",903,327,179,44,4,34,3,10,1
1190307,47,29,1966,6,"female",271,4,4,1,2,0,1,1,1
1190351,34,9,1979,6,"female",1110,29,11,4,25,4,14,0,11
1190365,18,5,1995,9,"female",631,217,99,2,23,2,12,0,11
1190380,32,7,1981,12,"male",626,19,12,0,0,0,0,0,0
1190411,17,7,1996,8,"male",603,118,62,27,3,0,1,27,2
1190428,58,28,1955,11,"female",2289,67,43,25,82,2,40,23,42
1190431,33,1,1980,1,"male",293,2,2,0,0,0,0,0,0
1190474,82,1,1931,4,"female",147,22,18,0,0,0,0,0,0
1190480,32,1,1981,1,"female",636,47,10,0,0,0,0,0,0
1190482,18,5,1995,5,"female",183,361,161,437,290,437,173,0,117
1190494,22,5,1991,5,"male",306,152,87,70,56,50,30,20,26
1190502,23,1,1990,11,"female",339,59,37,1,8,1,2,0,6
1190503,23,11,1990,8,"male",937,0,0,0,0,0,0,0,0
1190516,18,31,1995,8,"male",280,575,415,1053,527,883,130,170,397
1190531,95,26,1918,8,"male",1448,594,426,7,15,7,5,0,10
1190548,21,12,1992,2,"male",900,171,123,2,0,2,0,0,0
1190582,91,9,1922,2,"female",942,701,471,57,23,5,14,52,9
1190599,67,1,1946,12,"female",533,119,88,2058,722,0,9,2058,713
1190603,41,17,1972,10,"female",521,929,126,723,2378,340,880,383,1498
1190605,55,19,1958,9,"female",1450,46,31,89,48,81,26,8,22
1190613,58,2,1955,6,"male",1378,160,87,9,2,8,0,1,2
1190616,25,31,1988,8,"male",439,114,70,1,1,1,1,0,0
1190628,26,1,1987,10,"male",190,44,28,0,0,0,0,0,0
1190680,53,20,1960,2,"female",1456,73,30,58,106,26,84,32,22
1190692,36,29,1977,9,"female",629,34,25,104,56,36,31,68,25
1190719,62,23,1951,5,"male",826,6,5,0,0,0,0,0,0
1190721,14,2,1999,6,"female",472,302,151,50,409,49,163,1,246
1190749,50,28,1963,10,"male",1041,33,23,0,0,0,0,0,0
1190760,38,11,1975,1,"male",1197,21,14,0,0,0,0,0,0
1190772,16,1,1997,3,"female",434,173,54,8,0,8,0,0,0
1190796,60,10,1953,6,"female",608,102,70,236,438,235,265,1,173
1190799,20,10,1993,6,"male",430,109,78,33,15,32,4,1,11
1190837,29,21,1984,8,"male",660,77,75,1,0,1,0,0,0
1190864,100,31,1913,12,"male",785,359,273,19,15,19,5,0,10
1190907,27,8,1986,9,"female",44,29,20,14,54,14,29,0,25
1190912,26,28,1987,5,"male",484,128,55,123,62,98,43,25,19
1190920,25,31,1988,12,"female",222,143,98,38,88,38,88,0,0
1190939,19,24,1994,4,"female",482,190,104,13,42,10,21,3,21
1190950,17,31,1996,12,"male",161,637,362,2402,2922,2399,1416,3,1506
1190959,24,7,1989,7,"male",97,17,15,0,0,0,0,0,0
1190968,23,26,1990,7,"male",428,148,117,1,18,1,18,0,0
1190970,108,29,1905,10,"male",1882,211,9,1,19,0,8,1,11
1190982,39,15,1974,8,"female",302,22,14,18,1,18,1,0,0
1191029,32,19,1981,7,"male",693,384,323,87,26,87,26,0,0
1191051,21,28,1992,4,"female",474,350,160,783,991,783,689,0,302
1191063,100,3,1913,6,"female",1827,376,238,204,52,204,31,0,21
1191086,21,21,1992,8,"female",612,112,63,2947,3188,2650,2247,297,941
1191100,19,24,1994,1,"male",87,52,46,1,1,1,1,0,0
1191101,22,13,1991,5,"male",313,29,17,0,1,0,0,0,1
1191112,33,23,1980,5,"male",452,92,76,0,1,0,1,0,0
1191139,36,13,1977,7,"male",287,133,108,14,113,14,90,0,23
1191187,26,12,1987,5,"male",143,68,42,0,0,0,0,0,0
1191204,22,4,1991,9,"female",81,449,205,28,242,28,132,0,110
1191230,22,11,1991,7,"male",284,109,99,474,288,469,203,5,85
1191233,103,24,1910,7,"male",1369,1246,430,1644,2908,948,921,696,1987
1191269,35,3,1978,10,"female",384,105,97,21,99,21,99,0,0
1191274,25,17,1988,9,"male",912,505,333,4,40,4,35,0,5
1191292,69,18,1944,10,"male",471,19,12,5,2,5,1,0,1
1191306,17,8,1996,1,"male",182,216,170,1,0,0,0,1,0
1191310,69,18,1944,2,"female",1539,106,46,1,5,0,2,1,3
1191321,22,30,1991,9,"female",445,183,86,73,26,73,14,0,12
1191333,39,24,1974,8,"female",420,44,21,34,13,0,6,34,7
1191339,19,30,1994,10,"female",811,397,316,170,206,164,120,6,86
1191348,44,22,1969,3,"male",306,85,67,0,0,0,0,0,0
1191383,68,30,1945,9,"female",634,386,232,1,2,0,0,1,2
1191402,20,29,1993,3,"male",456,211,139,34,18,34,3,0,15
1191410,23,26,1990,11,"male",1101,716,584,1,2,0,1,1,1
1191441,56,18,1957,7,"male",157,89,73,48,16,48,11,0,5
1191455,102,8,1911,6,"male",2096,452,143,66,97,15,43,51,54
1191458,20,1,1993,3,"male",301,166,52,0,0,0,0,0,0
1191484,108,26,1905,12,"male",1731,53,13,11,6,0,2,11,4
1191502,47,15,1966,5,"female",715,118,72,18,283,18,225,0,58
1191506,22,19,1991,9,"female",513,202,174,16,1,16,1,0,0
1191511,28,21,1985,12,"female",599,38,17,9,1,9,0,0,1
1191518,17,14,1996,12,"female",405,198,57,0,1,0,0,0,1
1191527,29,17,1984,11,"male",80,11,11,0,0,0,0,0,0
1191566,15,13,1998,7,"male",463,42,21,117,17,116,14,1,3
1191582,19,20,1994,2,"female",588,770,518,579,701,163,333,416,368
1191583,40,27,1973,6,"female",509,20,11,110,1,110,1,0,0
1191587,32,3,1981,6,"male",13,1039,902,708,400,618,396,90,4
1191592,17,30,1996,9,"male",417,192,140,6,1,5,1,1,0
1191603,42,14,1971,8,"male",302,1,0,10,3,8,3,2,0
1191609,22,23,1991,8,"male",61,14,6,0,0,0,0,0,0
1191632,38,4,1975,3,"female",885,135,96,12,24,12,24,0,0
1191725,26,9,1987,7,"male",377,359,145,2,4,0,1,2,3
1191733,25,26,1988,1,"female",587,161,99,44,53,44,50,0,3
1191770,23,8,1990,3,"female",358,123,68,306,166,306,59,0,107
1191775,41,27,1972,12,"male",302,27,16,0,1,0,1,0,0
1191790,32,15,1981,3,"female",361,15,10,199,90,104,33,95,57
1191812,108,11,1905,7,"female",960,771,594,107,19,98,16,9,3
1191847,19,11,1994,4,"male",65,119,115,35,25,35,14,0,11
1191871,71,10,1942,3,"female",1059,4714,527,519,1588,519,1426,0,162
1191879,17,28,1996,12,"male",444,96,56,25,28,21,7,4,21
1191882,20,5,1993,5,"male",390,504,356,0,0,0,0,0,0
1191902,15,15,1998,4,"male",309,329,258,2136,299,2136,236,0,63
1191923,42,19,1971,5,"male",157,64,60,9,21,2,18,7,3
1191932,22,1,1991,1,"male",277,67,63,1,1,0,1,1,0
1191936,23,26,1990,4,"female",433,59,39,0,0,0,0,0,0
1191937,20,6,1993,6,"female",1,1,1,0,0,0,0,0,0
1191948,55,2,1958,2,"male",59,2,2,0,0,0,0,0,0
1191962,52,3,1961,1,"female",430,65,35,662,179,662,67,0,112
1191963,28,18,1985,7,"male",526,68,49,28,44,28,38,0,6
1191983,73,1,1940,7,"male",1095,52,37,1,1,0,0,1,1
1191988,21,17,1992,6,"male",283,256,105,30,7,30,7,0,0
1192007,21,15,1992,7,"male",593,247,96,81,19,0,3,81,16
1192042,28,10,1985,3,"female",249,2,2,0,1,0,0,0,1
1192063,15,8,1998,8,"male",400,199,167,11,1,11,1,0,0
1192065,20,24,1993,10,"male",425,285,111,1,31,1,30,0,1
1192072,25,27,1988,7,"female",369,233,168,3970,7092,285,3010,3685,4082
1192100,42,28,1971,8,"male",285,8,8,0,0,0,0,0,0
1192102,60,1,1953,4,"male",898,13,9,56,10,0,4,56,6
1192136,38,19,1975,4,"male",250,55,40,7,11,2,4,5,7
1192141,37,2,1976,1,"male",120,53,39,0,0,0,0,0,0
1192148,35,1,1978,1,"female",119,1,1,0,0,0,0,0,0
1192168,13,20,2000,8,"male",34,11,11,17,13,0,0,17,13
1192182,15,7,1998,8,"male",131,264,126,39,17,39,12,0,5
1192183,103,1,1910,1,"male",1486,66,24,26,32,0,13,26,19
1192200,23,12,1990,1,"male",22,39,34,26,32,23,17,3,15
1192226,18,11,1995,12,"female",315,610,349,1249,2322,1249,2092,0,230
1192245,14,11,1999,12,"male",249,90,40,211,31,0,0,211,31
1192264,24,6,1989,5,"female",651,3,1,0,0,0,0,0,0
1192283,74,18,1939,12,"male",717,10,7,1,0,0,0,1,0
1192287,24,25,1989,3,"female",57,86,68,166,267,164,172,2,95
1192300,33,26,1980,11,"male",506,99,76,48,82,48,80,0,2
1192313,108,31,1905,12,"female",419,170,142,11,3,11,2,0,1
1192350,55,9,1958,1,"male",693,132,71,266,172,46,70,220,102
1192362,42,18,1971,1,"male",76,12,12,8,0,8,0,0,0
1192370,50,27,1963,4,"male",1635,101,29,0,18,0,14,0,4
1192378,22,5,1991,10,"male",722,276,197,1,46,1,22,0,24
1192385,50,1,1963,1,"male",7,19,16,7,5,7,4,0,1
1192410,38,15,1975,6,"female",433,87,41,19,43,19,37,0,6
1192416,38,3,1975,7,"male",189,107,28,6,61,6,13,0,48
1192438,18,18,1995,3,"male",145,158,70,28,13,20,10,8,3
1192440,68,13,1945,8,"female",1295,28,16,2,1,1,0,1,1
1192441,20,22,1993,7,"male",181,2,2,0,0,0,0,0,0
1192447,43,20,1970,4,"female",227,33,16,7,2,4,0,3,2
1192461,65,22,1948,9,"male",421,30,19,2,1,0,0,2,1
1192484,48,21,1965,1,"male",84,54,32,13,10,3,5,10,5
1192502,62,29,1951,5,"female",1569,26,18,42,0,0,0,42,0
1192545,23,1,1990,1,"female",666,2,1,0,0,0,0,0,0
1192548,28,16,1985,3,"female",122,108,83,16,9,16,7,0,2
1192558,22,24,1991,12,"male",54,59,57,0,0,0,0,0,0
1192562,25,8,1988,4,"female",664,71,38,1,7,1,2,0,5
1192564,51,26,1962,7,"male",18,16,16,0,0,0,0,0,0
1192569,23,9,1990,1,"female",260,17,11,71,19,71,13,0,6
1192593,29,20,1984,10,"female",255,21,4,0,0,0,0,0,0
1192601,58,25,1955,9,"male",1267,224,131,5,79,5,72,0,7
1192619,32,9,1981,9,"male",729,59,32,7,0,7,0,0,0
1192628,14,6,1999,3,"male",112,31,22,1,0,1,0,0,0
1192631,19,5,1994,12,"male",308,121,71,124,47,124,45,0,2
1192652,33,18,1980,8,"male",874,69,40,104,100,104,72,0,28
1192656,108,25,1905,5,"male",882,145,86,51,6,48,6,3,0
1192666,33,25,1980,12,"female",479,85,71,119,64,119,61,0,3
1192672,61,8,1952,9,"female",37,92,13,5,18,0,10,5,8
1192725,64,5,1949,7,"female",1706,80,42,358,99,10,51,348,48
1192736,23,15,1990,12,"male",278,329,228,42,95,29,14,13,81
1192757,47,2,1966,5,"male",1660,43,14,0,0,0,0,0,0
1192782,15,3,1998,7,"male",148,72,56,3,0,3,0,0,0
1192842,21,11,1992,12,"male",300,467,431,14,6,2,6,12,0
1192897,47,9,1966,10,"male",311,0,0,0,0,0,0,0,0
1192912,52,29,1961,10,"female",444,70,41,135,368,135,321,0,47
1192963,23,15,1990,2,"female",404,99,82,2,17,0,7,2,10
1192976,49,19,1964,4,"female",263,236,221,63,5,0,0,63,5
1192996,29,25,1984,9,"male",110,38,20,82,30,14,15,68,15
1193068,38,8,1975,10,"female",285,3,0,0,0,0,0,0,0
1193098,67,25,1946,2,"female",310,20,15,9,3,6,0,3,3
1193119,37,19,1976,3,"male",631,335,222,8,6,8,0,0,6
1193132,19,5,1994,6,"female",634,185,60,264,63,264,47,0,16
1193138,20,28,1993,10,"male",334,89,81,0,3,0,3,0,0
1193140,34,25,1979,5,"male",745,2,2,0,0,0,0,0,0
1193152,53,17,1960,10,"female",491,32,13,1,2,1,2,0,0
1193166,19,16,1994,8,"male",4,9,9,7,1,0,1,7,0
1193198,21,12,1992,6,"male",1088,114,66,4,5,0,1,4,4
1193210,69,25,1944,11,"male",871,491,295,310,513,218,425,92,88
1193219,33,4,1980,12,"female",704,174,133,3,0,0,0,3,0
1193225,113,1,1900,12,"male",2319,72,40,2,5,2,5,0,0
1193244,22,8,1991,8,"male",685,134,96,315,306,182,154,133,152
1193254,29,23,1984,3,"male",141,36,30,5,4,0,1,5,3
1193259,23,25,1990,1,"male",243,410,334,149,83,32,23,117,60
1193260,34,16,1979,3,"female",604,46,28,0,0,0,0,0,0
1193275,51,28,1962,4,"male",230,0,0,0,0,0,0,0,0
1193284,58,18,1955,5,"female",534,69,55,27,90,0,49,27,41
1193316,35,11,1978,7,"male",679,33,20,18,9,18,3,0,6
1193353,18,8,1995,10,"male",652,62,43,0,0,0,0,0,0
1193375,58,15,1955,8,"male",796,111,85,47,55,38,34,9,21
1193381,38,1,1975,6,"female",455,112,103,0,0,0,0,0,0
1193406,82,16,1931,2,"male",733,22,6,3,10,0,0,3,10
1193434,17,17,1996,12,"male",26,12,12,0,0,0,0,0,0
1193440,45,5,1968,11,"male",947,62,7,0,0,0,0,0,0
1193461,33,6,1980,11,"female",275,91,72,985,81,985,69,0,12
1193466,33,17,1980,2,"male",128,2,0,0,0,0,0,0,0
1193498,25,3,1988,3,"female",396,100,89,4,0,4,0,0,0
1193506,57,16,1956,10,"male",1042,43,16,0,0,0,0,0,0
1193523,21,21,1992,1,"male",502,75,56,0,0,0,0,0,0
1193560,38,13,1975,11,"male",816,213,121,22,12,22,10,0,2
1193585,17,1,1996,1,"female",2,215,185,292,478,292,244,0,234
1193591,21,3,1992,6,"male",723,478,326,240,75,1,44,239,31
1193605,17,25,1996,10,"male",403,555,493,36,45,7,17,29,28
1193625,14,1,1999,5,"male",486,123,87,7,0,7,0,0,0
1193633,22,3,1991,1,"female",610,250,124,8,30,8,14,0,16
1193642,41,16,1972,6,"female",551,17,6,11,6,11,6,0,0
1193647,22,31,1991,8,"female",185,734,457,38,18,38,12,0,6
1193653,20,10,1993,10,"female",69,142,119,159,122,58,52,101,70
1193664,25,5,1988,11,"male",189,4,3,2,2,2,0,0,2
1193671,25,1,1988,1,"male",84,117,80,0,0,0,0,0,0
1193676,19,25,1994,7,"female",446,322,86,203,208,37,98,166,110
1193679,18,15,1995,12,"female",361,1092,304,1208,1459,1204,715,4,744
1193694,68,25,1945,12,"male",644,179,93,92,44,0,21,92,23
1193699,48,1,1965,5,"female",549,21,4,5,4,3,3,2,1
1193705,18,13,1995,5,"male",529,0,0,1,0,1,0,0,0
1193723,28,1,1985,1,"female",677,11,7,0,0,0,0,0,0
1193790,18,2,1995,1,"male",281,68,27,7,5,7,4,0,1
1193811,29,24,1984,5,"male",377,45,32,1,1,0,0,1,1
1193813,15,27,1998,8,"female",295,216,142,0,0,0,0,0,0
1193838,23,4,1990,9,"male",220,63,34,0,0,0,0,0,0
1193884,25,8,1988,5,"male",723,314,170,36,17,36,16,0,1
1193911,17,21,1996,12,"female",673,697,459,347,479,283,110,64,369
1193977,35,14,1978,7,"male",484,89,42,1,1,1,1,0,0
1193980,51,22,1962,8,"male",57,0,0,0,0,0,0,0,0
1193989,30,18,1983,6,"male",270,139,117,0,0,0,0,0,0
1193995,47,7,1966,8,"male",1349,13,8,1,23,0,10,1,13
1193997,46,7,1967,4,"female",1862,181,93,189,596,0,154,189,442
1194020,23,20,1990,7,"male",365,216,139,28,10,28,10,0,0
1194098,23,25,1990,6,"male",523,54,34,7,0,4,0,3,0
1194148,16,31,1997,5,"female",558,2219,1712,9633,8874,5744,3841,3889,5033
1194160,44,11,1969,5,"male",137,25,13,6,40,6,8,0,32
1194178,81,5,1932,10,"male",1133,77,19,0,0,0,0,0,0
1194196,25,6,1988,12,"female",555,96,15,0,3,0,3,0,0
1194212,49,28,1964,5,"male",424,113,106,121,1,0,0,121,1
1194214,35,29,1978,1,"female",227,60,35,29,28,29,20,0,8
1194224,23,8,1990,1,"male",483,17,17,0,4,0,4,0,0
1194234,16,1,1997,1,"male",16,20,12,1,2,1,2,0,0
1194242,25,20,1988,10,"male",113,69,65,3,62,3,32,0,30
1194245,44,13,1969,4,"male",357,12,4,0,0,0,0,0,0
1194262,18,27,1995,8,"female",156,276,194,90,25,0,3,90,22
1194272,36,20,1977,2,"male",540,63,18,3,0,3,0,0,0
1194301,17,19,1996,3,"female",651,933,462,685,560,316,294,369,266
1194324,18,6,1995,11,"male",272,90,86,3,0,3,0,0,0
1194333,19,11,1994,12,"male",491,388,232,3,1,0,1,3,0
1194340,36,30,1977,4,"male",840,118,86,15,26,0,8,15,18
1194357,58,1,1955,12,"female",204,4,4,100,0,100,0,0,0
1194359,58,7,1955,12,"female",1346,74,19,2,5,2,3,0,2
1194367,65,10,1948,12,"female",1183,27,14,4,19,4,15,0,4
1194397,25,12,1988,10,"female",155,150,90,1878,703,1878,492,0,211
1194400,19,5,1994,12,"female",426,190,89,57,25,13,4,44,21
1194403,67,3,1946,4,"female",661,27,19,89,31,0,4,89,27
1194404,26,2,1987,8,"male",441,113,65,14,21,13,15,1,6
1194491,59,30,1954,3,"female",54,40,8,4,0,1,0,3,0
1194521,52,13,1961,7,"male",775,112,40,16,5,16,3,0,2
1194526,44,11,1969,3,"male",619,105,81,47,8,47,3,0,5
1194543,44,16,1969,7,"female",368,130,98,19,41,19,41,0,0
1194572,18,15,1995,12,"female",210,27,15,96,59,87,40,9,19
1194575,43,9,1970,4,"female",1713,62,21,93,5,93,5,0,0
1194597,17,16,1996,11,"male",688,1012,722,57,72,6,36,51,36
1194604,19,29,1994,12,"male",415,142,96,0,9,0,5,0,4
1194629,22,13,1991,11,"male",442,41,27,0,0,0,0,0,0
1194638,19,11,1994,9,"female",250,940,360,802,1359,759,946,43,413
1194647,23,19,1990,7,"male",941,285,91,0,0,0,0,0,0
1194656,33,15,1980,8,"male",471,20,7,0,0,0,0,0,0
1194662,46,2,1967,2,"male",600,68,50,11,3,11,3,0,0
1194680,80,20,1933,1,"female",937,416,208,124,71,124,52,0,19
1194689,79,30,1934,5,"female",927,63,41,0,11,0,9,0,2
1194714,25,1,1988,1,"male",24,56,55,3,5,3,0,0,5
1194755,27,19,1986,10,"male",253,39,23,11,44,11,28,0,16
1194759,24,13,1989,1,"male",636,245,125,0,3,0,3,0,0
1194762,28,1,1985,6,"male",160,103,76,77,70,77,47,0,23
1194813,26,1,1987,1,"male",463,2,2,0,0,0,0,0,0
1194863,33,1,1980,1,"male",17,0,0,0,0,0,0,0,0
1194897,14,31,1999,1,"male",530,93,64,6,25,4,2,2,23
1194929,64,18,1949,7,"male",406,18,12,0,0,0,0,0,0
1194930,27,8,1986,8,"female",41,103,93,2273,849,849,386,1424,463
1194931,15,17,1998,10,"male",386,55,38,180,4,180,2,0,2
1194985,40,26,1973,6,"male",774,103,36,0,4,0,4,0,0
1194987,17,2,1996,11,"male",427,204,193,1,0,1,0,0,0
1194990,17,8,1996,7,"male",524,61,36,0,0,0,0,0,0
1194997,54,6,1959,1,"male",78,19,17,19,1,19,1,0,0
1195021,81,30,1932,7,"female",1348,69,28,85,34,1,13,84,21
1195031,39,26,1974,2,"male",252,83,60,228,125,228,117,0,8
1195060,72,1,1941,4,"female",1426,44,14,14,28,11,22,3,6
1195071,62,24,1951,11,"male",154,49,40,2127,90,2127,55,0,35
1195077,56,13,1957,4,"male",707,20,11,5,0,5,0,0,0
1195088,25,6,1988,1,"male",34,31,28,17,14,17,12,0,2
1195093,20,20,1993,1,"female",304,108,59,346,22,346,14,0,8
1195097,42,2,1971,11,"female",61,2,1,0,0,0,0,0,0
1195116,33,1,1980,1,"male",742,32,26,9,0,0,0,9,0
1195140,45,13,1968,5,"male",651,13,2,0,1,0,0,0,1
1195161,25,30,1988,10,"male",14,124,123,52,6,52,6,0,0
1195173,57,14,1956,3,"female",234,57,40,14,84,14,54,0,30
1195181,18,25,1995,1,"male",466,148,78,4,5,4,5,0,0
1195206,25,3,1988,6,"male",22,6,4,1,1,1,1,0,0
1195234,21,13,1992,7,"male",193,42,22,5,4,5,0,0,4
1195238,18,2,1995,9,"male",502,32,18,1,0,1,0,0,0
1195245,40,26,1973,11,"female",81,33,28,168,36,0,14,168,22
1195262,63,3,1950,2,"female",629,41,25,22,1,22,1,0,0
1195295,20,2,1993,1,"male",416,9,9,0,0,0,0,0,0
1195304,20,27,1993,6,"male",695,348,254,2,1,2,1,0,0
1195317,37,24,1976,11,"female",196,8,7,1235,2,1235,2,0,0
1195325,21,20,1992,4,"female",1618,559,346,19,68,19,52,0,16
1195331,65,17,1948,8,"female",1810,617,509,716,747,476,324,240,423
1195355,65,10,1948,2,"female",362,12,4,1,0,0,0,1,0
1195366,24,3,1989,7,"female",685,178,100,153,86,4,23,149,63
1195375,22,1,1991,1,"male",163,34,31,11,0,7,0,4,0
1195412,58,9,1955,3,"male",166,66,53,3,0,3,0,0,0
1195423,50,31,1963,12,"male",649,23,21,12,13,5,7,7,6
1195428,29,19,1984,4,"male",775,60,11,0,0,0,0,0,0
1195470,57,2,1956,1,"female",945,325,252,304,152,0,68,304,84
1195474,14,1,1999,1,"female",307,182,125,3440,1630,2252,1013,1188,617
1195479,35,28,1978,10,"female",396,204,102,344,406,278,257,66,149
1195500,24,16,1989,7,"male",349,351,195,0,3,0,2,0,1
1195501,103,4,1910,7,"male",1719,95,36,16,18,13,9,3,9
1195523,14,7,1999,1,"female",71,29,7,17,0,17,0,0,0
1195569,53,6,1960,2,"female",841,61,24,98,80,59,32,39,48
1195571,28,7,1985,11,"male",362,110,93,0,2,0,1,0,1
1195583,25,20,1988,6,"male",235,5,3,0,0,0,0,0,0
1195584,22,8,1991,11,"male",672,140,43,23,13,23,11,0,2
1195593,73,18,1940,3,"male",1402,124,28,120,1,6,1,114,0
1195607,29,26,1984,1,"male",198,152,113,3,3,3,2,0,1
1195659,19,19,1994,6,"male",471,64,33,1,1,1,1,0,0
1195674,42,21,1971,9,"male",114,13,11,13,0,0,0,13,0
1195698,19,27,1994,5,"male",527,192,117,0,3,0,3,0,0
1195704,15,6,1998,3,"male",342,126,108,0,0,0,0,0,0
1195708,58,6,1955,5,"male",1653,49,21,0,0,0,0,0,0
1195723,41,15,1972,2,"female",404,30,10,101,84,85,80,16,4
1195738,16,30,1997,9,"female",364,8,8,216,11,215,3,1,8
1195772,18,20,1995,3,"male",517,272,101,197,297,197,185,0,112
1195793,58,23,1955,8,"female",342,88,43,72,19,36,13,36,6
1195805,46,20,1967,12,"female",376,13,10,12,0,12,0,0,0
1195833,23,1,1990,1,"male",668,16,1,0,0,0,0,0,0
1195836,14,30,1999,12,"male",177,6,5,0,0,0,0,0,0
1195846,29,7,1984,7,"male",1165,329,288,4,35,4,30,0,5
1195856,18,5,1995,5,"female",254,938,473,968,849,895,503,73,346
1195858,41,6,1972,9,"male",152,96,64,55,14,55,2,0,12
1195888,62,5,1951,4,"female",538,127,91,606,29,605,25,1,4
1195891,57,2,1956,8,"male",1433,19,3,0,0,0,0,0,0
1195923,14,3,1999,10,"male",35,112,84,88,51,88,22,0,29
1195928,33,1,1980,1,"male",632,5,0,0,1,0,1,0,0
1195943,26,7,1987,8,"female",413,78,57,19,8,0,4,19,4
1195952,14,1,1999,1,"male",11,7,6,0,0,0,0,0,0
1195995,34,14,1979,5,"female",945,487,267,417,969,190,669,227,300
1195996,18,21,1995,8,"male",72,16,13,12,0,12,0,0,0
1196009,68,17,1945,8,"male",490,191,109,30,7,30,7,0,0
1196012,34,14,1979,2,"female",286,391,324,45,17,43,15,2,2
1196031,19,11,1994,12,"female",498,317,134,398,337,391,193,7,144
1196063,57,15,1956,4,"male",579,73,43,34,29,30,14,4,15
1196099,68,22,1945,6,"male",466,11,7,4,1,4,1,0,0
1196103,23,7,1990,1,"male",144,74,64,1,1,1,1,0,0
1196144,37,20,1976,4,"female",626,19,9,32,37,32,32,0,5
1196152,21,27,1992,3,"male",13,19,17,0,0,0,0,0,0
1196162,31,26,1982,11,"male",951,145,90,0,2,0,1,0,1
1196180,77,13,1936,12,"female",5,12,11,3,2,0,2,3,0
1196189,87,23,1926,10,"female",190,49,40,18,1,0,0,18,1
1196203,66,9,1947,10,"female",1137,28,16,0,0,0,0,0,0
1196218,45,29,1968,2,"female",229,6,3,0,0,0,0,0,0
1196225,29,23,1984,9,"male",756,209,50,6,12,0,8,6,4
1196239,19,10,1994,3,"male",881,580,379,13,4,5,2,8,2
1196243,34,27,1979,8,"male",305,28,11,0,8,0,0,0,8
1196254,17,11,1996,4,"male",392,840,762,233,52,22,27,211,25
1196257,21,15,1992,10,"female",498,259,161,21,5,10,4,11,1
1196272,23,18,1990,3,"male",397,52,26,2,2,2,0,0,2
1196288,55,29,1958,6,"male",138,64,36,0,0,0,0,0,0
1196307,33,29,1980,9,"male",737,103,24,34,0,0,0,34,0
1196318,68,17,1945,8,"male",1554,761,378,123,114,95,46,28,68
1196371,18,12,1995,12,"female",90,350,140,500,521,500,354,0,167
1196452,63,31,1950,12,"male",810,107,19,100,59,38,33,62,26
1196474,44,16,1969,11,"male",634,6,4,0,0,0,0,0,0
1196506,23,8,1990,5,"male",206,122,58,1,12,1,8,0,4
1196511,29,20,1984,11,"female",381,2,1,34,5,32,5,2,0
1196514,19,31,1994,1,"male",436,45,42,4,1,0,1,4,0
1196543,16,26,1997,9,"male",286,24,20,13,0,0,0,13,0
1196558,31,25,1982,2,"male",672,158,108,154,4,154,3,0,1
1196565,30,15,1983,3,"male",27,131,126,23,3,9,1,14,2
1196580,22,9,1991,4,"male",110,225,187,26,32,26,23,0,9
1196581,38,6,1975,3,"male",515,52,45,0,0,0,0,0,0
1196621,46,30,1967,9,"male",203,54,35,5,0,0,0,5,0
1196629,25,9,1988,12,"male",610,143,62,1,44,1,37,0,7
1196631,19,29,1994,5,"female",512,994,488,1858,337,1858,258,0,79
1196675,14,26,1999,10,"female",188,146,94,171,26,171,18,0,8
1196680,18,14,1995,8,"female",151,299,273,74,62,74,49,0,13
1196681,20,25,1993,7,"male",1039,478,362,52,45,52,35,0,10
1196686,35,30,1978,6,"male",483,115,48,0,2,0,2,0,0
1196687,52,25,1961,9,"female",415,126,67,4,10,0,1,4,9
1196707,35,23,1978,12,"male",646,77,48,17,32,11,4,6,28
1196711,52,13,1961,6,"female",1579,93,35,4,23,4,11,0,12
1196740,34,25,1979,1,"male",194,0,0,0,0,0,0,0,0
1196743,19,12,1994,3,"male",898,1460,919,423,320,419,305,4,15
1196787,20,8,1993,8,"male",306,267,239,18,6,17,3,1,3
1196791,25,16,1988,10,"male",309,62,46,0,0,0,0,0,0
1196823,17,27,1996,10,"female",191,78,6,1,1,1,1,0,0
1196827,16,25,1997,3,"female",83,364,330,37,25,37,25,0,0
1196846,22,11,1991,3,"male",403,251,139,43,97,24,24,19,73
1196901,42,29,1971,6,"female",406,46,34,112,5,112,4,0,1
1196904,23,9,1990,9,"male",651,1459,619,59,27,59,27,0,0
1196914,14,31,1999,1,"male",105,60,51,3,0,0,0,3,0
1196938,16,22,1997,3,"female",618,156,61,60,34,60,33,0,1
1196960,25,29,1988,1,"male",107,34,33,0,3,0,0,0,3
1196961,14,4,1999,6,"male",559,159,80,16,3,16,3,0,0
1196963,54,27,1959,8,"female",540,46,25,66,92,0,66,66,26
1196995,15,16,1998,7,"female",291,1668,183,219,193,219,70,0,123
1196997,19,6,1994,4,"female",404,3529,1919,166,491,166,356,0,135
1196998,62,27,1951,5,"female",510,67,45,920,76,918,65,2,11
1197001,21,30,1992,3,"female",64,192,33,13,9,13,9,0,0
1197050,53,30,1960,4,"female",569,85,38,18,7,18,7,0,0
1197078,71,19,1942,2,"female",375,50,32,37,4,20,4,17,0
1197094,26,18,1987,1,"male",358,211,106,3,1,2,0,1,1
1197099,38,25,1975,9,"male",1799,156,62,5,2,5,0,0,2
1197101,23,2,1990,5,"male",412,8,8,0,0,0,0,0,0
1197123,21,29,1992,10,"male",611,160,69,68,80,68,45,0,35
1197133,17,24,1996,6,"female",403,15,11,4,0,0,0,4,0
1197167,25,7,1988,3,"male",521,21,15,0,6,0,5,0,1
1197178,48,25,1965,7,"female",984,90,51,31,161,31,103,0,58
1197190,108,30,1905,3,"female",36,190,117,36,12,3,4,33,8
1197264,38,18,1975,8,"female",569,153,116,66,153,50,74,16,79
1197288,38,7,1975,12,"female",1060,57,31,90,88,90,49,0,39
1197323,22,1,1991,3,"male",67,92,91,3,5,3,4,0,1
1197337,24,13,1989,11,"male",200,369,203,65,287,64,105,1,182
1197369,21,7,1992,2,"male",372,19,9,1,5,0,2,1,3
1197372,59,7,1954,12,"male",1825,25,16,4,16,0,10,4,6
1197377,108,21,1905,7,"male",1142,270,169,290,47,290,12,0,35
1197382,38,25,1975,5,"male",395,175,164,1,0,1,0,0,0
1197391,33,8,1980,4,"male",454,118,88,1,1,1,1,0,0
1197421,39,2,1974,6,"female",314,69,54,332,143,270,88,62,55
1197423,14,21,1999,7,"female",389,576,391,0,2,0,1,0,1
1197433,48,25,1965,7,"male",356,127,93,45,1,45,1,0,0
1197438,26,14,1987,9,"female",649,48,28,464,242,463,146,1,96
1197454,17,17,1996,4,"male",241,513,271,52,107,18,11,34,96
1197460,108,5,1905,8,"male",756,292,98,37,54,16,30,21,24
1197476,27,12,1986,2,"female",572,69,50,83,20,83,15,0,5
1197485,52,25,1961,9,"male",1006,232,163,332,233,51,54,281,179
1197495,33,24,1980,12,"male",187,68,55,608,52,608,44,0,8
1197506,17,18,1996,1,"male",221,926,889,5,0,0,0,5,0
1197509,26,5,1987,2,"male",129,301,256,29,38,29,31,0,7
1197511,23,1,1990,1,"male",523,206,99,12,5,3,3,9,2
1197527,40,18,1973,9,"female",669,125,100,23,5,23,5,0,0
1197534,60,23,1953,4,"female",1534,141,31,65,66,58,40,7,26
1197542,52,21,1961,11,"female",215,186,158,303,22,303,9,0,13
1197545,21,15,1992,5,"male",348,443,344,0,0,0,0,0,0
1197567,23,20,1990,9,"male",553,287,201,8,4,8,3,0,1
1197578,19,14,1994,3,"male",157,226,170,66,362,62,98,4,264
1197601,35,1,1978,2,"female",189,164,117,85,73,66,39,19,34
1197619,23,14,1990,8,"female",326,211,146,764,398,731,327,33,71
1197625,36,14,1977,9,"male",83,75,65,12,23,12,11,0,12
1197626,16,9,1997,3,"female",566,97,51,19,18,19,15,0,3
1197627,45,22,1968,1,"male",1890,158,88,21,3,4,3,17,0
1197637,32,1,1981,1,"male",53,0,0,0,0,0,0,0,0
1197652,14,1,1999,6,"male",265,76,47,21,19,21,14,0,5
1197668,14,16,1999,4,"female",505,381,186,533,272,523,147,10,125
1197687,21,10,1992,9,"male",89,4,4,0,4,0,3,0,1
1197697,106,19,1907,10,"male",1662,689,191,29,22,0,11,29,11
1197717,42,20,1971,2,"male",283,80,16,189,59,189,29,0,30
1197724,15,1,1998,9,"male",655,83,35,16,15,8,9,8,6
1197731,19,15,1994,7,"male",606,17,10,954,65,165,55,789,10
1197734,30,19,1983,12,"male",47,4,3,236,36,236,5,0,31
1197756,23,31,1990,7,"female",148,153,85,69,218,23,75,46,143
1197763,30,1,1983,1,"male",445,16,12,10,5,10,5,0,0
1197765,21,24,1992,2,"male",1404,328,220,0,1,0,1,0,0
1197779,29,1,1984,1,"male",460,25,21,10,1,10,1,0,0
1197783,19,6,1994,4,"male",3,29,25,62,19,1,13,61,6
1197790,15,19,1998,6,"female",586,2026,870,917,1815,910,1067,7,748
1197798,47,20,1966,10,"male",175,47,37,33,6,33,6,0,0
1197833,34,18,1979,10,"female",889,247,157,5,24,4,9,1,15
1197871,20,10,1993,12,"female",531,234,30,0,22,0,11,0,11
1197883,16,20,1997,8,"female",167,141,85,7,10,7,3,0,7
1197895,20,31,1993,7,"male",7,15,14,2,3,2,2,0,1
1197896,51,1,1962,10,"female",428,160,119,9,23,8,18,1,5
1197930,18,18,1995,3,"male",17,9,6,0,0,0,0,0,0
1197947,22,22,1991,6,"male",395,424,294,156,236,156,187,0,49
1197975,79,25,1934,1,"female",1662,47,20,200,22,0,17,200,5
1197979,26,22,1987,11,"male",822,64,31,20,19,20,18,0,1
1197984,64,26,1949,12,"female",552,33,25,73,10,0,6,73,4
1197986,23,18,1990,1,"male",145,24,24,0,0,0,0,0,0
1197993,18,14,1995,2,"female",306,237,38,6,7,6,1,0,6
1198007,18,22,1995,6,"female",313,101,34,24,5,24,5,0,0
1198024,31,23,1982,6,"male",104,143,89,81,34,81,6,0,28
1198028,28,24,1985,11,"female",210,218,186,20,1,20,1,0,0
1198051,108,18,1905,12,"male",1117,35,22,0,0,0,0,0,0
1198072,22,12,1991,2,"male",451,413,51,2,3,0,1,2,2
1198093,23,25,1990,6,"female",485,376,254,0,2,0,1,0,1
1198096,67,20,1946,6,"female",73,6,0,39,17,0,0,39,17
1198100,39,2,1974,10,"female",234,210,104,239,391,230,134,9,257
1198185,18,31,1995,8,"male",858,102,56,99,24,2,15,97,9
1198202,30,18,1983,12,"male",695,330,225,4,15,3,11,1,4
1198208,27,15,1986,3,"male",148,50,36,38,10,0,5,38,5
1198212,21,4,1992,3,"male",12,1,1,0,0,0,0,0,0
1198216,25,25,1988,11,"male",49,16,13,1,0,1,0,0,0
1198224,28,1,1985,1,"male",263,65,29,1,0,0,0,1,0
1198240,30,29,1983,12,"male",300,214,106,82,28,82,22,0,6
1198277,58,14,1955,1,"female",1836,588,307,374,498,225,194,149,304
1198281,54,9,1959,11,"female",1074,144,83,69,348,69,228,0,120
1198308,27,11,1986,11,"female",241,46,39,10,35,10,26,0,9
1198309,25,19,1988,5,"male",648,4,4,2,0,1,0,1,0
1198314,38,12,1975,11,"male",1610,311,129,5,9,5,8,0,1
1198343,35,16,1978,2,"male",194,145,79,5,47,5,30,0,17
1198348,14,26,1999,10,"male",97,68,44,1,1,1,1,0,0
1198349,16,20,1997,4,"male",239,228,119,0,0,0,0,0,0
1198372,37,14,1976,7,"female",299,44,22,14,6,0,1,14,5
1198411,33,3,1980,9,"male",256,553,507,0,4,0,0,0,4
1198453,44,28,1969,12,"male",313,179,153,141,132,75,43,66,89
1198478,14,18,1999,4,"female",13,74,16,11,37,0,17,11,20
1198487,61,27,1952,8,"male",465,26,11,0,1,0,0,0,1
1198492,16,14,1997,3,"female",255,888,424,2522,4308,2108,2489,414,1819
1198495,38,15,1975,3,"male",31,0,0,6,18,6,17,0,1
1198528,31,1,1982,12,"male",407,223,99,1,0,0,0,1,0
1198586,16,28,1997,1,"female",31,38,22,4,5,1,2,3,3
1198629,15,5,1998,3,"female",687,311,228,1747,890,1681,744,66,146
1198641,23,10,1990,10,"male",661,324,300,404,897,404,799,0,98
1198657,24,30,1989,1,"male",149,19,16,4,8,4,3,0,5
1198683,62,29,1951,7,"male",1015,4,3,0,0,0,0,0,0
1198699,19,5,1994,4,"male",110,165,149,7,10,7,5,0,5
1198709,53,15,1960,10,"female",2087,179,28,14,90,12,75,2,15
1198754,33,18,1980,10,"male",585,18,0,0,25,0,13,0,12
1198760,25,18,1988,8,"male",794,311,82,0,8,0,4,0,4
1198780,53,6,1960,5,"male",426,10,4,0,0,0,0,0,0
1198786,26,7,1987,3,"female",328,142,95,69,140,69,70,0,70
1198824,17,10,1996,12,"female",756,4458,1492,1485,6365,776,4355,709,2010
1198855,24,8,1989,5,"male",404,87,17,0,0,0,0,0,0
1198869,57,30,1956,5,"male",70,215,215,47,0,0,0,47,0
1198878,26,17,1987,8,"female",643,33,13,3,0,3,0,0,0
1198894,32,5,1981,5,"male",310,69,12,4,1,4,0,0,1
1198907,89,20,1924,7,"female",1536,2025,946,854,676,845,476,9,200
1198963,18,10,1995,1,"male",804,2710,1149,459,1131,459,838,0,293
1198981,16,6,1997,3,"female",27,36,26,96,45,96,33,0,12
1198991,65,16,1948,2,"female",1098,185,99,70,202,70,186,0,16
1199017,41,17,1972,5,"female",237,254,178,30,60,0,28,30,32
1199018,21,4,1992,3,"female",163,10,6,23,8,23,8,0,0
1199021,28,19,1985,12,"female",392,103,72,0,9,0,7,0,2
1199022,26,12,1987,6,"female",421,31,19,5,3,5,2,0,1
1199023,18,28,1995,5,"male",757,657,491,19,103,12,93,7,10
1199073,19,17,1994,3,"female",364,327,93,0,1,0,1,0,0
1199074,53,7,1960,6,"female",1556,1046,570,1155,1655,307,324,848,1331
1199083,52,12,1961,2,"female",767,153,77,331,207,197,93,134,114
1199085,28,8,1985,6,"male",855,347,146,113,258,34,63,79,195
1199094,22,2,1991,6,"male",819,1503,636,842,1689,825,1094,17,595
1199157,58,11,1955,12,"female",934,28,3,8,2,8,2,0,0
1199176,38,21,1975,12,"female",655,124,63,0,1,0,1,0,0
1199181,18,12,1995,6,"male",677,368,269,0,0,0,0,0,0
1199218,37,25,1976,11,"female",630,402,331,343,148,343,123,0,25
1199245,21,10,1992,9,"male",228,276,192,1,0,0,0,1,0
1199250,32,21,1981,7,"female",408,114,61,46,32,46,29,0,3
1199262,18,9,1995,3,"male",255,25,16,0,2,0,2,0,0
1199274,36,9,1977,10,"female",222,50,38,346,84,346,65,0,19
1199279,17,23,1996,1,"male",32,12,12,0,8,0,2,0,6
1199315,20,7,1993,4,"male",377,181,152,6,11,6,7,0,4
1199330,17,9,1996,6,"male",479,907,685,514,180,142,130,372,50
1199335,20,29,1993,12,"male",378,406,313,0,0,0,0,0,0
1199362,34,24,1979,12,"male",253,53,45,147,146,147,93,0,53
1199386,18,27,1995,9,"male",415,332,167,97,542,84,462,13,80
1199393,25,14,1988,1,"male",655,107,49,29,0,29,0,0,0
1199395,27,3,1986,1,"female",236,13,9,0,0,0,0,0,0
1199418,61,17,1952,5,"female",102,39,29,35,68,35,52,0,16
1199437,36,16,1977,1,"male",91,16,15,4,1,4,1,0,0
1199445,73,1,1940,2,"male",255,18,13,4,3,0,1,4,2
1199446,27,25,1986,8,"female",158,60,43,7,0,7,0,0,0
1199472,108,1,1905,1,"male",2331,303,32,0,8,0,4,0,4
1199480,17,5,1996,3,"male",531,167,66,86,52,0,23,86,29
1199515,20,10,1993,5,"male",646,794,506,14,7,9,1,5,6
1199555,18,31,1995,10,"female",289,73,32,620,240,615,190,5,50
1199581,14,1,1999,12,"male",15,0,0,0,0,0,0,0,0
1199611,18,12,1995,9,"male",356,255,130,13,32,1,16,12,16
1199618,60,23,1953,8,"male",261,89,29,0,0,0,0,0,0
1199649,53,7,1960,9,"female",864,69,51,9,10,7,3,2,7
1199654,78,26,1935,8,"female",327,30,26,0,0,0,0,0,0
1199693,27,20,1986,1,"male",172,139,132,143,2,143,2,0,0
1199706,22,7,1991,8,"female",89,189,84,107,154,107,86,0,68
1199711,18,27,1995,9,"female",1544,2242,1756,3090,6645,1511,3586,1579,3059
1199722,49,21,1964,4,"female",535,87,57,19,8,19,7,0,1
1199749,39,18,1974,12,"male",205,110,82,1131,242,1131,242,0,0
1199766,26,26,1987,12,"male",641,86,83,1,16,1,5,0,11
1199771,24,1,1989,10,"male",6,5,5,4,1,4,1,0,0
1199780,42,28,1971,3,"male",373,101,55,306,114,306,28,0,86
1199785,15,11,1998,9,"male",584,186,165,16,29,16,21,0,8
1199790,37,6,1976,6,"male",728,54,25,2,3,2,3,0,0
1199818,26,15,1987,10,"female",76,1,1,389,28,389,27,0,1
1199830,24,7,1989,7,"male",30,137,132,156,34,155,9,1,25
1199854,38,17,1975,8,"male",396,16,2,0,8,0,1,0,7
1199886,27,11,1986,12,"male",361,89,47,47,76,47,57,0,19
1199889,22,29,1991,12,"male",325,10,7,4,4,2,1,2,3
1199919,46,24,1967,12,"female",434,9,8,7,2,7,0,0,2
1199935,62,1,1951,3,"female",150,30,26,49,16,49,13,0,3
1200043,65,7,1948,5,"male",235,21,17,0,0,0,0,0,0
1200045,35,5,1978,1,"male",568,1,1,0,0,0,0,0,0
1200048,26,2,1987,4,"female",262,450,229,164,111,164,71,0,40
1200050,23,1,1990,7,"female",100,132,82,22,3,20,1,2,2
1200051,38,28,1975,5,"female",141,46,35,97,5,97,5,0,0
1200089,22,15,1991,1,"female",127,28,16,149,96,149,3,0,93
1200100,17,5,1996,5,"female",9,6,3,38,34,38,34,0,0
1200112,33,27,1980,5,"female",200,0,0,0,0,0,0,0,0
1200117,25,2,1988,1,"female",84,275,225,581,233,540,84,41,149
1200120,24,16,1989,6,"female",366,102,73,529,479,529,447,0,32
1200169,27,3,1986,2,"female",904,46,9,3,0,3,0,0,0
1200174,28,24,1985,3,"male",671,1,0,0,0,0,0,0,0
1200188,40,11,1973,8,"male",326,210,158,51,18,51,17,0,1
1200205,48,6,1965,9,"female",1480,192,115,3,18,3,15,0,3
1200212,52,22,1961,4,"female",1482,101,49,1,0,0,0,1,0
1200224,32,31,1981,1,"female",262,365,144,2604,725,2604,681,0,44
1200229,25,3,1988,3,"male",719,52,28,4,6,4,4,0,2
1200231,43,19,1970,11,"female",893,0,0,1,0,0,0,1,0
1200252,17,18,1996,10,"male",315,481,440,3,37,3,28,0,9
1200263,20,15,1993,5,"male",75,97,73,0,0,0,0,0,0
1200275,28,13,1985,2,"female",462,120,36,12,19,8,5,4,14
1200306,26,18,1987,2,"male",330,99,63,47,0,47,0,0,0
1200370,17,8,1996,10,"female",316,437,247,20,36,20,19,0,17
1200392,22,30,1991,6,"male",472,144,119,0,0,0,0,0,0
1200417,19,6,1994,10,"male",319,72,72,0,8,0,4,0,4
1200434,26,3,1987,3,"female",242,152,49,350,326,347,187,3,139
1200442,48,1,1965,4,"female",54,27,10,1,12,1,8,0,4
1200446,44,19,1969,7,"female",988,516,89,0,10,0,9,0,1
1200463,19,13,1994,8,"male",488,57,23,3,0,3,0,0,0
1200475,28,1,1985,1,"male",126,35,31,31,8,3,0,28,8
1200479,18,14,1995,5,"female",43,148,50,694,381,682,298,12,83
1200544,49,12,1964,9,"male",257,357,315,792,401,263,171,529,230
1200549,13,1,2000,7,"male",32,5,5,0,0,0,0,0,0
1200555,103,22,1910,6,"male",1914,448,211,491,456,218,339,273,117
1200585,83,1,1930,8,"male",1427,8,1,0,0,0,0,0,0
1200597,17,22,1996,5,"male",369,173,119,0,6,0,4,0,2
1200599,15,24,1998,3,"female",567,283,187,35,3,0,0,35,3
1200615,61,1,1952,1,"male",591,163,96,7,7,0,7,7,0
1200649,41,9,1972,10,"male",421,88,53,128,157,124,85,4,72
1200665,24,25,1989,12,"female",514,480,212,26,124,23,105,3,19
1200679,56,30,1957,8,"male",24,8,8,15,11,15,11,0,0
1200699,47,22,1966,6,"female",1770,243,135,63,114,61,84,2,30
1200711,13,28,2000,3,"male",185,117,95,0,0,0,0,0,0
1200717,18,19,1995,2,"female",284,278,200,0,4,0,4,0,0
1200763,20,1,1993,1,"male",27,8,6,0,0,0,0,0,0
1200814,103,1,1910,1,"male",1525,13,8,50,6,49,6,1,0
1200837,33,25,1980,11,"female",275,732,35,6724,4264,6724,3442,0,822
1200846,22,16,1991,9,"male",304,116,72,4,11,0,4,4,7
1200873,21,30,1992,12,"female",258,203,36,0,1,0,1,0,0
1200896,38,19,1975,9,"male",516,35,17,0,0,0,0,0,0
1200926,28,2,1985,8,"female",297,161,113,335,635,268,500,67,135
1200948,33,14,1980,3,"male",293,20,14,59,58,59,27,0,31
1200952,25,10,1988,3,"male",71,84,73,0,0,0,0,0,0
1200964,46,22,1967,11,"female",60,20,7,10,5,10,5,0,0
1200968,20,26,1993,1,"male",398,220,182,24,31,3,6,21,25
1200990,15,8,1998,9,"male",297,152,133,0,0,0,0,0,0
1201023,103,11,1910,8,"male",269,58,50,7,17,7,11,0,6
1201042,36,16,1977,2,"male",12,3,3,0,0,0,0,0,0
1201046,32,31,1981,8,"female",311,470,328,10,7,10,6,0,1
1201069,36,9,1977,12,"female",606,51,31,70,2,65,1,5,1
1201071,37,10,1976,10,"male",418,2,2,0,0,0,0,0,0
1201072,30,9,1983,4,"male",46,71,66,14,1,14,1,0,0
1201106,48,15,1965,3,"female",403,27,20,0,0,0,0,0,0
1201176,47,8,1966,6,"male",311,196,104,3798,113,3798,102,0,11
1201207,103,23,1910,4,"male",1647,231,99,1,0,1,0,0,0
1201215,32,7,1981,12,"male",166,162,125,33,25,33,17,0,8
1201226,33,16,1980,4,"female",517,196,163,3,116,3,70,0,46
1201235,21,3,1992,12,"female",365,571,53,1,14,0,12,1,2
1201238,32,17,1981,11,"male",213,41,17,3,6,3,6,0,0
1201240,55,1,1958,10,"male",406,24,5,6,1,6,1,0,0
1201254,55,17,1958,4,"female",1745,41,18,113,77,113,55,0,22
1201261,101,14,1912,7,"male",300,187,134,23,2,23,2,0,0
1201263,24,1,1989,1,"male",480,48,42,3,10,3,7,0,3
1201271,41,4,1972,5,"male",606,178,162,0,0,0,0,0,0
1201281,29,30,1984,12,"female",30,7,7,0,1,0,0,0,1
1201289,22,18,1991,9,"female",536,199,103,9,13,9,9,0,4
1201300,27,8,1986,4,"male",587,26,2,0,0,0,0,0,0
1201321,24,15,1989,12,"male",616,1977,1770,53,153,26,133,27,20
1201337,19,27,1994,5,"male",405,71,48,20,28,20,26,0,2
1201344,15,25,1998,7,"female",31,31,9,0,0,0,0,0,0
1201358,43,19,1970,11,"male",82,28,17,23,3,23,1,0,2
1201393,23,1,1990,10,"male",31,84,52,9,13,9,9,0,4
1201417,55,13,1958,3,"female",239,36,35,5,1,0,0,5,1
1201429,57,26,1956,7,"female",1528,77,26,0,0,0,0,0,0
1201442,19,12,1994,9,"female",603,391,42,0,0,0,0,0,0
1201447,40,6,1973,3,"male",1378,104,32,43,57,43,43,0,14
1201470,23,24,1990,6,"male",811,33,22,26,1,26,1,0,0
1201478,62,4,1951,1,"female",1747,59,20,2,1,2,1,0,0
1201496,14,25,1999,9,"male",186,146,80,13,10,13,9,0,1
1201499,64,25,1949,2,"female",924,21,2,13,3,0,0,13,3
1201511,18,27,1995,1,"female",885,261,159,339,270,217,192,122,78
1201521,113,12,1900,5,"female",1722,248,170,73,81,70,47,3,34
1201532,15,11,1998,12,"male",429,264,193,107,15,1,1,106,14
1201579,30,1,1983,1,"male",638,52,27,2,8,2,5,0,3
1201600,56,14,1957,9,"female",458,70,39,43,28,0,8,43,20
1201622,22,17,1991,12,"female",302,584,45,908,709,908,661,0,48
1201649,104,17,1909,2,"male",1524,48,36,23,3,0,2,23,1
1201658,48,9,1965,3,"male",100,4,4,1,0,0,0,1,0
1201673,27,24,1986,5,"male",723,128,121,1,0,1,0,0,0
1201706,60,6,1953,10,"female",536,109,35,0,0,0,0,0,0
1201711,63,28,1950,1,"male",536,405,50,72,30,0,5,72,25
1201721,98,12,1915,5,"male",1070,219,166,0,6,0,6,0,0
1201728,20,28,1993,12,"female",516,386,239,268,534,0,122,268,412
1201739,21,2,1992,8,"male",307,39,14,0,0,0,0,0,0
1201748,23,11,1990,10,"female",427,85,38,0,0,0,0,0,0
1201756,108,8,1905,3,"female",1326,1233,506,163,180,143,111,20,69
1201801,22,16,1991,12,"male",445,4037,1704,147,2997,147,2419,0,578
1201812,48,19,1965,8,"male",358,64,36,6,6,6,5,0,1
1201823,60,2,1953,6,"female",715,120,86,229,22,229,22,0,0
1201832,23,1,1990,1,"female",96,87,23,167,171,165,32,2,139
1201859,57,3,1956,11,"male",1791,163,88,4,27,4,25,0,2
1201907,36,22,1977,5,"female",368,108,73,159,431,159,362,0,69
1201909,21,10,1992,11,"male",1248,259,229,0,0,0,0,0,0
1201916,28,25,1985,3,"male",913,51,28,7,12,7,7,0,5
1201921,28,3,1985,3,"male",116,59,34,52,57,36,21,16,36
1201928,14,25,1999,1,"female",555,543,305,305,263,141,133,164,130
1201940,108,1,1905,5,"male",1309,717,388,39,53,38,24,1,29
1201943,54,28,1959,2,"male",217,222,45,12,4,8,4,4,0
1201955,14,9,1999,4,"male",58,127,109,2,0,2,0,0,0
1201966,27,10,1986,4,"male",143,14,12,6,0,6,0,0,0
1201986,21,20,1992,4,"male",390,89,9,7,0,7,0,0,0
1202029,17,5,1996,12,"female",69,261,191,811,635,783,385,28,250
1202071,21,16,1992,11,"male",395,133,76,0,0,0,0,0,0
1202077,43,1,1970,1,"male",988,92,49,0,17,0,8,0,9
1202123,52,4,1961,9,"male",555,38,18,11,15,11,11,0,4
1202147,24,25,1989,10,"male",1324,105,25,131,40,131,20,0,20
1202215,108,12,1905,1,"male",1137,145,73,25,8,25,8,0,0
1202244,70,22,1943,9,"male",1742,81,61,1,6,1,6,0,0
1202274,108,28,1905,3,"female",1131,77,27,6,5,0,1,6,4
1202280,29,8,1984,3,"male",533,112,85,14,4,14,3,0,1
1202320,16,24,1997,5,"male",66,183,176,108,7,108,7,0,0
1202335,19,12,1994,9,"male",622,115,29,5,0,5,0,0,0
1202345,51,7,1962,10,"female",202,84,59,36,63,0,23,36,40
1202346,33,13,1980,9,"female",222,64,52,6,4,6,4,0,0
1202369,33,7,1980,3,"male",302,0,0,0,0,0,0,0,0
1202446,23,1,1990,1,"male",22,28,19,3,18,3,16,0,2
1202455,28,4,1985,11,"female",188,89,50,557,498,557,405,0,93
1202459,21,8,1992,8,"male",366,205,54,0,69,0,42,0,27
1202462,108,12,1905,12,"female",708,43,31,1,1,1,1,0,0
1202469,44,15,1969,9,"male",224,0,0,0,0,0,0,0,0
1202488,75,25,1938,12,"female",1742,14,6,0,0,0,0,0,0
1202490,28,3,1985,12,"male",492,199,140,0,0,0,0,0,0
1202503,33,1,1980,5,"female",424,63,33,67,44,67,37,0,7
1202513,29,9,1984,5,"male",262,33,16,3,0,0,0,3,0
1202538,34,20,1979,3,"female",158,16,8,49,8,49,8,0,0
1202560,20,4,1993,5,"male",623,1078,854,740,133,740,115,0,18
1202569,18,20,1995,3,"female",762,231,83,9,0,0,0,9,0
1202585,38,5,1975,4,"male",751,70,16,28,15,28,14,0,1
1202595,32,2,1981,7,"female",603,144,23,69,81,69,68,0,13
1202601,108,11,1905,6,"male",1025,9,5,0,0,0,0,0,0
1202605,18,29,1995,10,"female",179,395,16,6,28,6,20,0,8
1202608,15,2,1998,5,"male",536,517,346,0,0,0,0,0,0
1202618,21,12,1992,11,"female",346,233,85,219,330,189,316,30,14
1202623,16,15,1997,2,"male",697,264,166,0,5,0,1,0,4
1202656,61,15,1952,2,"female",545,215,164,3,7,0,3,3,4
1202666,22,16,1991,5,"male",158,646,591,421,468,421,394,0,74
1202694,33,31,1980,8,"male",356,19,6,4,2,4,2,0,0
1202754,55,9,1958,1,"male",1190,546,206,47,58,2,17,45,41
1202779,15,4,1998,2,"female",440,103,23,2,0,2,0,0,0
1202791,18,4,1995,10,"female",234,302,172,753,447,753,340,0,107
1202802,63,26,1950,5,"male",186,78,68,885,77,883,51,2,26
1202839,63,25,1950,2,"female",1722,172,86,2394,700,911,220,1483,480
1202843,21,13,1992,11,"female",29,34,29,282,23,266,11,16,12
1202856,31,3,1982,3,"female",189,54,48,1,0,0,0,1,0
1202867,20,18,1993,2,"female",209,102,41,71,35,58,3,13,32
1202879,26,13,1987,8,"female",418,315,73,383,294,383,181,0,113
1202897,63,17,1950,11,"female",462,46,23,0,0,0,0,0,0
1202923,19,11,1994,8,"male",335,121,92,0,0,0,0,0,0
1202967,16,5,1997,1,"male",38,206,91,9,33,6,23,3,10
1202969,45,15,1968,12,"male",445,58,22,7,11,0,2,7,9
1202986,56,13,1957,4,"male",1724,32,4,49,26,23,7,26,19
1203040,32,1,1981,4,"female",451,8,4,19,1,18,1,1,0
1203041,18,27,1995,5,"male",472,93,63,5,3,1,0,4,3
1203081,17,1,1996,9,"male",312,78,69,107,20,107,17,0,3
1203115,108,13,1905,11,"female",197,588,123,1048,1221,1048,1098,0,123
1203116,21,2,1992,7,"female",613,62,28,50,6,50,6,0,0
1203119,49,18,1964,8,"female",343,62,55,0,2,0,1,0,1
1203151,35,5,1978,12,"male",638,280,170,25,24,24,14,1,10
1203170,14,18,1999,3,"female",196,65,30,33,31,10,12,23,19
1203207,71,23,1942,6,"female",1853,61,8,16,13,16,8,0,5
1203220,25,1,1988,1,"male",1055,88,62,1,0,1,0,0,0
1203228,27,9,1986,2,"male",332,102,76,13,11,13,10,0,1
1203265,15,23,1998,12,"male",104,16,14,434,50,280,7,154,43
1203269,17,1,1996,1,"male",182,228,200,283,43,283,43,0,0
1203274,22,18,1991,8,"female",178,15,13,45,13,45,9,0,4
1203288,14,31,1999,12,"male",157,21,17,4,1,0,0,4,1
1203302,34,16,1979,1,"male",854,22,13,3,0,3,0,0,0
1203320,54,14,1959,8,"male",381,67,55,0,0,0,0,0,0
1203331,67,9,1946,8,"male",996,40,18,26,63,18,20,8,43
1203333,52,5,1961,6,"male",580,191,132,13,0,2,0,11,0
1203348,23,9,1990,12,"female",564,145,78,3,0,3,0,0,0
1203355,18,6,1995,12,"female",117,97,42,24,51,24,26,0,25
1203361,56,26,1957,11,"female",137,23,14,3,12,3,6,0,6
1203382,47,23,1966,5,"male",458,139,79,66,116,0,33,66,83
1203399,108,21,1905,12,"male",815,214,158,1,1,1,1,0,0
1203417,73,8,1940,2,"male",1569,105,21,6,2,6,0,0,2
1203445,57,16,1956,11,"male",902,162,108,102,69,0,12,102,57
1203460,49,16,1964,5,"female",225,26,20,121,44,121,33,0,11
1203464,19,12,1994,5,"male",126,33,32,0,8,0,1,0,7
1203482,20,20,1993,2,"male",204,55,41,4,11,4,10,0,1
1203493,48,1,1965,3,"female",230,157,97,20,39,20,32,0,7
1203500,27,30,1986,7,"male",336,345,227,298,203,298,193,0,10
1203513,19,1,1994,12,"female",537,268,79,73,9,2,5,71,4
1203544,23,3,1990,7,"male",301,16,7,21,1,21,1,0,0
1203552,19,1,1994,5,"female",946,121,61,979,852,798,160,181,692
1203562,18,1,1995,4,"male",178,44,37,2,4,2,2,0,2
1203584,77,20,1936,12,"female",407,2,2,0,0,0,0,0,0
1203607,34,19,1979,7,"female",395,40,25,64,7,64,7,0,0
1203621,37,10,1976,10,"male",317,2,1,0,0,0,0,0,0
1203627,35,7,1978,10,"male",901,4,3,0,0,0,0,0,0
1203643,63,18,1950,7,"male",1275,964,846,20,4,20,4,0,0
1203648,39,26,1974,8,"male",630,2,1,3,1,0,0,3,1
1203655,19,2,1994,2,"male",42,92,72,1,2,1,2,0,0
1203660,19,10,1994,5,"male",230,50,15,2,9,2,8,0,1
1203675,43,4,1970,9,"male",58,19,19,0,0,0,0,0,0
1203683,29,10,1984,10,"male",411,38,22,0,0,0,0,0,0
1203684,46,16,1967,5,"female",329,31,30,2,0,2,0,0,0
1203695,26,3,1987,12,"female",676,13,7,5,0,5,0,0,0
1203707,28,24,1985,4,"female",113,128,101,335,178,320,150,15,28
1203718,52,8,1961,3,"female",375,199,172,21,12,0,3,21,9
1203724,22,29,1991,4,"male",1027,743,624,42,22,11,16,31,6
1203766,18,27,1995,12,"female",233,431,58,223,100,223,65,0,35
1203771,59,18,1954,10,"female",873,333,251,1871,830,103,195,1768,635
1203780,21,11,1992,8,"female",480,736,378,51,37,11,22,40,15
1203787,25,16,1988,2,"male",234,25,21,0,0,0,0,0,0
1203804,25,17,1988,8,"male",396,53,34,0,2,0,2,0,0
1203875,15,11,1998,12,"male",41,0,0,0,0,0,0,0,0
1203878,16,25,1997,3,"female",27,83,42,18,15,18,10,0,5
1203879,30,20,1983,11,"male",524,51,39,0,13,0,8,0,5
1203893,45,7,1968,10,"male",44,26,18,158,11,158,2,0,9
1203894,36,29,1977,12,"female",571,1,0,20,25,20,18,0,7
1203902,22,14,1991,9,"female",25,10,10,0,1,0,1,0,0
1203904,15,4,1998,10,"female",167,129,82,1,5,0,2,1,3
1203916,108,27,1905,6,"male",139,2343,42,253,353,0,216,253,137
1203935,58,23,1955,4,"female",260,72,32,113,93,0,3,113,90
1203969,29,8,1984,11,"male",554,290,161,207,55,202,20,5,35
1203981,18,13,1995,3,"male",401,747,618,0,0,0,0,0,0
1203983,59,22,1954,10,"female",107,11,9,0,0,0,0,0,0
1203984,71,11,1942,4,"male",124,173,38,191,198,178,165,13,33
1203989,30,18,1983,11,"male",394,0,0,0,0,0,0,0,0
1204028,30,5,1983,7,"male",540,121,113,52,144,14,29,38,115
1204037,52,1,1961,11,"female",260,21,15,107,13,107,13,0,0
1204041,19,12,1994,6,"female",128,151,88,567,74,567,64,0,10
1204057,32,31,1981,7,"male",311,36,16,4,12,3,1,1,11
1204088,31,1,1982,2,"male",1389,299,165,0,5,0,4,0,1
1204102,54,14,1959,7,"female",371,88,73,8,0,8,0,0,0
1204106,19,17,1994,2,"female",482,101,35,3,1,3,1,0,0
1204109,24,31,1989,10,"male",189,6,6,1,0,1,0,0,0
1204120,69,12,1944,10,"female",260,17,17,1,1,1,1,0,0
1204124,45,7,1968,10,"male",649,25,6,4,37,2,1,2,36
1204133,59,17,1954,3,"male",1139,108,81,0,0,0,0,0,0
1204145,45,31,1968,1,"female",1170,110,67,174,197,56,137,118,60
1204153,14,28,1999,2,"male",68,13,6,3,0,3,0,0,0
1204178,51,13,1962,8,"male",1117,42,5,0,1,0,1,0,0
1204210,48,28,1965,5,"female",479,57,29,674,290,672,133,2,157
1204230,59,25,1954,7,"female",437,67,59,200,45,200,26,0,19
1204240,18,16,1995,8,"female",57,10,7,1,4,1,1,0,3
1204255,24,15,1989,7,"male",385,397,256,71,16,35,10,36,6
1204299,16,8,1997,9,"male",356,232,166,125,46,121,15,4,31
1204301,19,29,1994,10,"female",1240,436,149,4071,2281,1111,394,2960,1887
1204337,23,11,1990,7,"male",160,69,60,0,0,0,0,0,0
1204359,52,11,1961,5,"female",721,279,189,213,115,179,50,34,65
1204385,25,1,1988,1,"male",3,3,3,2,0,2,0,0,0
1204396,19,6,1994,10,"female",325,556,280,18,9,4,3,14,6
1204406,37,16,1976,7,"male",485,2,2,0,0,0,0,0,0
1204427,18,6,1995,9,"male",44,46,42,1,2,1,0,0,2
1204456,47,20,1966,10,"female",389,69,29,81,62,0,18,81,44
1204468,33,14,1980,8,"male",78,67,51,69,142,69,105,0,37
1204472,26,1,1987,1,"female",56,42,16,52,4,52,4,0,0
1204483,17,29,1996,4,"female",715,1252,807,356,286,276,93,80,193
1204494,45,15,1968,8,"male",182,6,6,1,0,1,0,0,0
1204503,57,12,1956,4,"female",100,0,0,0,0,0,0,0,0
1204504,26,30,1987,11,"male",162,87,55,0,0,0,0,0,0
1204508,28,11,1985,6,"male",144,168,138,110,11,110,5,0,6
1204563,24,22,1989,5,"male",162,1,0,0,0,0,0,0,0
1204564,27,4,1986,11,"female",551,135,77,16,32,16,30,0,2
1204584,21,9,1992,9,"male",739,340,211,49,16,0,3,49,13
1204594,63,6,1950,12,"female",1438,63,24,124,53,124,39,0,14
1204597,69,8,1944,5,"male",782,5,5,0,0,0,0,0,0
1204600,19,2,1994,11,"male",400,188,158,0,1,0,1,0,0
1204601,16,10,1997,1,"female",657,187,130,84,46,84,31,0,15
1204619,26,31,1987,5,"male",1542,124,74,8,3,8,2,0,1
1204631,26,12,1987,1,"male",1300,303,104,2,453,1,249,1,204
1204634,15,23,1998,9,"male",370,87,80,0,1,0,1,0,0
1204638,19,6,1994,7,"male",114,259,239,953,99,953,95,0,4
1204665,103,26,1910,9,"male",611,334,240,432,754,356,540,76,214
1204683,61,11,1952,7,"female",473,48,30,4,33,0,13,4,20
1204696,55,6,1958,7,"male",1401,13,7,1,0,1,0,0,0
1204700,48,21,1965,9,"male",642,73,48,0,0,0,0,0,0
1204745,43,6,1970,7,"female",748,168,69,203,310,203,277,0,33
1204749,24,7,1989,12,"male",386,103,63,230,53,151,38,79,15
1204753,45,10,1968,11,"male",396,300,216,262,209,262,133,0,76
1204758,32,28,1981,8,"male",1037,116,45,198,170,40,37,158,133
1204766,48,20,1965,1,"male",287,229,92,14,42,14,28,0,14
1204771,71,21,1942,1,"female",1385,97,48,0,12,0,9,0,3
1204819,45,1,1968,11,"male",274,6,5,1,0,1,0,0,0
1204824,23,27,1990,12,"female",81,204,122,17,23,11,17,6,6
1204832,82,15,1931,11,"female",994,52,36,0,1,0,1,0,0
1204838,18,10,1995,6,"male",472,208,192,12,1,8,1,4,0
1204874,50,26,1963,10,"male",223,21,16,4,2,4,2,0,0
1204882,25,4,1988,3,"male",358,195,99,145,51,145,47,0,4
1204890,15,10,1998,12,"female",516,582,232,0,8,0,7,0,1
1204897,26,1,1987,1,"male",98,41,34,4,0,4,0,0,0
1204920,49,3,1964,4,"male",227,174,127,10,9,10,8,0,1
1204945,68,19,1945,12,"male",1653,780,487,48,118,48,111,0,7
1204947,66,12,1947,11,"female",1239,209,138,360,169,285,95,75,74
1204953,16,8,1997,2,"female",422,22,18,23,0,11,0,12,0
1204969,29,19,1984,12,"male",206,39,28,15,13,15,8,0,5
1204985,43,18,1970,5,"female",501,14,10,14,0,14,0,0,0
1204995,100,31,1913,3,"female",169,315,197,97,409,97,356,0,53
1205008,22,23,1991,2,"female",301,2553,699,2148,6220,124,1342,2024,4878
1205014,15,1,1998,1,"male",257,234,51,5,0,0,0,5,0
1205027,30,26,1983,1,"male",375,5,4,0,0,0,0,0,0
1205037,70,23,1943,5,"male",557,437,209,142,41,128,25,14,16
1205051,32,5,1981,12,"female",115,31,9,87,122,87,70,0,52
1205070,33,24,1980,11,"male",666,109,56,0,3,0,1,0,2
1205083,45,16,1968,2,"male",570,15,11,0,0,0,0,0,0
1205087,32,8,1981,5,"male",408,115,87,64,16,64,10,0,6
1205091,20,28,1993,8,"male",611,2,0,1,0,1,0,0,0
1205100,15,16,1998,12,"male",290,383,327,47,7,36,6,11,1
1205116,25,15,1988,4,"female",553,765,525,905,404,398,133,507,271
1205123,18,30,1995,4,"male",390,121,80,1,0,1,0,0,0
1205204,103,27,1910,12,"male",1319,145,87,51,31,51,12,0,19
1205220,53,1,1960,1,"male",70,5,5,3,1,3,1,0,0
1205222,74,19,1939,4,"female",1377,21,9,1,2,0,1,1,1
1205228,31,15,1982,10,"female",264,46,31,0,2,0,1,0,1
1205276,101,27,1912,12,"female",489,525,359,41,11,0,1,41,10
1205297,33,3,1980,2,"female",90,57,21,17,53,17,4,0,49
1205358,18,17,1995,1,"male",131,39,28,0,0,0,0,0,0
1205360,22,4,1991,4,"male",180,89,62,0,4,0,3,0,1
1205408,25,15,1988,5,"female",216,62,48,38,41,38,16,0,25
1205425,18,25,1995,7,"female",580,231,101,78,66,72,32,6,34
1205427,42,11,1971,11,"male",471,109,95,0,1,0,1,0,0
1205457,19,4,1994,8,"female",869,1132,486,409,1719,289,1215,120,504
1205533,22,26,1991,3,"female",645,79,69,200,102,114,57,86,45
1205535,45,10,1968,2,"male",155,8,8,1,0,1,0,0,0
1205564,18,11,1995,3,"male",248,242,129,14,9,3,6,11,3
1205593,42,24,1971,6,"male",85,9,9,751,0,745,0,6,0
1205595,108,15,1905,10,"male",2064,241,175,38,40,7,21,31,19
1205622,63,23,1950,6,"female",816,139,72,42,21,0,5,42,16
1205646,28,14,1985,2,"male",185,5,3,163,7,0,1,163,6
1205648,29,5,1984,2,"male",435,3,2,0,0,0,0,0,0
1205673,56,4,1957,12,"male",794,54,38,13,1,13,0,0,1
1205699,24,5,1989,9,"female",100,48,23,3,0,3,0,0,0
1205726,22,21,1991,10,"male",186,145,133,33,17,9,3,24,14
1205759,24,20,1989,2,"male",332,766,656,54,237,54,161,0,76
1205766,68,6,1945,11,"male",446,175,121,1039,597,694,181,345,416
1205781,55,6,1958,9,"male",1122,258,176,20,294,8,177,12,117
1205793,20,21,1993,6,"male",467,198,114,3,19,3,19,0,0
1205799,19,12,1994,4,"female",395,21,12,7,0,7,0,0,0
1205825,26,25,1987,9,"female",564,18,15,255,93,255,59,0,34
1205840,26,1,1987,12,"male",429,55,37,2,1,2,1,0,0
1205923,17,29,1996,10,"male",397,1100,935,128,118,5,51,123,67
1205935,24,3,1989,2,"male",294,28,8,0,0,0,0,0,0
1205947,14,15,1999,3,"male",22,51,47,0,10,0,7,0,3
1205953,14,19,1999,5,"female",613,95,57,159,74,151,52,8,22
1205988,65,23,1948,4,"female",46,56,43,331,78,331,67,0,11
1205998,47,1,1966,3,"female",346,202,138,159,94,117,51,42,43
1206003,88,7,1925,1,"female",2351,39,15,158,13,45,12,113,1
1206010,27,19,1986,3,"female",50,125,18,0,1,0,1,0,0
1206059,56,27,1957,5,"male",96,120,98,29,7,28,6,1,1
1206087,18,7,1995,10,"male",448,29,26,0,0,0,0,0,0
1206109,25,1,1988,1,"female",20,1,0,1,1,0,0,1,1
1206125,25,6,1988,11,"male",244,81,34,178,45,56,22,122,23
1206152,22,14,1991,2,"male",23,0,0,0,0,0,0,0,0
1206179,17,1,1996,1,"male",85,576,547,576,394,576,149,0,245
1206180,58,11,1955,8,"female",2438,95,36,205,154,119,108,86,46
1206209,103,30,1910,10,"female",1083,197,96,249,223,249,134,0,89
1206224,74,30,1939,1,"male",119,35,30,2,8,2,1,0,7
1206233,23,8,1990,3,"male",293,77,56,0,5,0,5,0,0
1206254,57,21,1956,12,"male",403,79,50,2,2,0,1,2,1
1206271,20,26,1993,3,"female",704,98,76,0,2,0,2,0,0
1206278,20,19,1993,5,"female",306,152,112,2,58,0,13,2,45
1206311,35,26,1978,11,"male",604,190,72,0,2,0,1,0,1
1206318,66,8,1947,4,"female",879,248,133,779,838,0,74,779,764
1206319,14,9,1999,1,"male",266,61,40,7,1,7,1,0,0
1206327,103,25,1910,5,"female",1426,590,31,12,14,0,5,12,9
1206334,61,9,1952,11,"male",2245,27,12,8,6,7,3,1,3
1206337,94,8,1919,4,"male",259,309,149,1,17,1,4,0,13
1206354,81,9,1932,8,"male",372,158,132,73,80,25,45,48,35
1206363,23,22,1990,8,"male",511,34,19,8,2,8,2,0,0
1206366,70,31,1943,5,"female",606,213,180,148,55,0,7,148,48
1206383,40,3,1973,6,"male",666,138,81,67,72,67,67,0,5
1206406,42,18,1971,1,"male",462,133,81,18,0,0,0,18,0
1206441,14,17,1999,6,"male",486,68,58,1,0,1,0,0,0
1206458,30,1,1983,7,"female",628,254,194,2,22,1,0,1,22
1206466,23,17,1990,2,"male",356,114,56,7,0,7,0,0,0
1206476,92,6,1921,1,"male",1466,359,231,417,237,417,194,0,43
1206493,20,25,1993,2,"male",687,251,211,0,0,0,0,0,0
1206499,21,9,1992,6,"female",295,114,90,581,60,581,31,0,29
1206545,33,8,1980,8,"female",257,5,3,0,0,0,0,0,0
1206569,21,24,1992,5,"male",658,286,57,8,96,2,72,6,24
1206571,41,23,1972,6,"male",1466,77,34,19,0,19,0,0,0
1206573,47,28,1966,4,"male",1527,157,72,197,170,72,52,125,118
1206579,21,13,1992,6,"female",1473,982,253,244,92,148,41,96,51
1206596,21,18,1992,11,"male",255,29,18,6,38,0,2,6,36
1206603,18,21,1995,5,"female",471,111,61,24,21,24,19,0,2
1206631,34,2,1979,8,"male",450,68,27,208,161,208,136,0,25
1206640,15,28,1998,6,"male",118,104,82,1,1,1,1,0,0
1206651,21,9,1992,8,"male",869,1038,877,74,49,50,47,24,2
1206653,15,5,1998,8,"male",163,205,129,5,30,0,8,5,22
1206656,31,26,1982,10,"female",605,20,6,21,7,21,7,0,0
1206659,23,5,1990,3,"female",563,26,14,0,0,0,0,0,0
1206691,69,13,1944,2,"male",810,36,26,22,1,22,1,0,0
1206695,40,9,1973,4,"female",124,73,62,68,79,68,73,0,6
1206709,21,5,1992,5,"female",386,333,217,94,77,72,38,22,39
1206750,32,16,1981,4,"male",282,188,154,1,12,1,9,0,3
1206757,23,10,1990,10,"male",84,22,20,0,0,0,0,0,0
1206782,54,4,1959,6,"female",1309,53,17,568,53,412,39,156,14
1206790,22,4,1991,2,"male",345,35,28,1,0,0,0,1,0
1206800,29,17,1984,2,"female",567,302,196,205,149,118,72,87,77
1206808,71,11,1942,2,"female",194,34,32,1,1,0,1,1,0
1206815,29,17,1984,6,"female",124,1,1,2,0,0,0,2,0
1206835,53,26,1960,6,"female",787,43,11,36,5,21,5,15,0
1206837,61,15,1952,4,"female",245,72,48,8,4,5,2,3,2
1206860,23,19,1990,4,"male",364,349,182,362,171,350,95,12,76
1206865,23,16,1990,6,"female",448,70,27,189,36,0,9,189,27
1206890,34,9,1979,5,"male",355,195,183,8,11,2,8,6,3
1206896,22,5,1991,1,"female",433,129,91,291,205,56,72,235,133
1206959,49,21,1964,5,"male",145,41,28,13,1,13,1,0,0
1206986,24,6,1989,9,"male",233,53,46,41,4,41,3,0,1
1206998,108,4,1905,3,"female",263,121,63,22,5,22,5,0,0
1207002,21,25,1992,5,"male",419,186,115,2,5,2,5,0,0
1207005,15,5,1998,6,"male",41,44,33,0,0,0,0,0,0
1207024,17,21,1996,11,"male",1054,500,421,0,6,0,1,0,5
1207057,71,18,1942,5,"male",1078,24,19,386,413,0,89,386,324
1207082,16,6,1997,9,"male",133,28,17,13,0,3,0,10,0
1207121,20,26,1993,7,"male",442,65,39,0,0,0,0,0,0
1207152,19,19,1994,4,"male",86,150,106,187,3,187,1,0,2
1207177,66,12,1947,10,"male",378,106,78,14,54,14,7,0,47
1207193,53,10,1960,3,"male",979,58,38,20,44,20,28,0,16
1207216,47,29,1966,10,"female",161,54,31,90,98,90,30,0,68
1207218,21,4,1992,1,"male",242,147,40,1,0,1,0,0,0
1207228,26,15,1987,5,"male",828,560,474,1,3,1,2,0,1
1207246,35,11,1978,2,"male",440,178,113,63,7,63,7,0,0
1207252,23,25,1990,2,"female",404,350,256,560,403,560,341,0,62
1207275,66,12,1947,3,"female",1583,102,80,0,0,0,0,0,0
1207284,23,9,1990,12,"male",226,745,251,853,1156,792,508,61,648
1207324,19,19,1994,2,"female",330,29,8,26,1,1,0,25,1
1207354,23,9,1990,7,"male",292,347,316,1,1,1,1,0,0
1207355,22,23,1991,5,"male",216,96,88,3,0,3,0,0,0
1207359,23,9,1990,2,"male",94,0,0,0,0,0,0,0,0
1207376,18,19,1995,8,"male",199,148,112,19,0,19,0,0,0
1207393,14,15,1999,3,"male",298,71,61,1,0,1,0,0,0
1207411,44,19,1969,4,"female",446,34,22,44,25,44,24,0,1
1207422,16,29,1997,8,"male",589,0,0,0,0,0,0,0,0
1207426,62,10,1951,8,"male",781,128,82,1,0,1,0,0,0
1207432,18,1,1995,6,"male",1,0,0,0,0,0,0,0,0
1207439,16,17,1997,9,"male",507,240,114,266,240,56,154,210,86
1207459,20,3,1993,12,"male",355,30,17,0,1,0,0,0,1
1207496,96,30,1917,8,"male",845,35,23,0,0,0,0,0,0
1207501,31,17,1982,8,"male",118,43,42,1,0,0,0,1,0
1207505,100,1,1913,9,"male",108,25,23,262,178,122,99,140,79
1207526,23,11,1990,7,"female",535,209,86,9,12,9,7,0,5
1207600,48,12,1965,11,"male",863,11,7,1,2,0,1,1,1
1207628,17,8,1996,2,"female",450,1611,953,229,1012,174,835,55,177
1207639,103,4,1910,4,"male",403,1148,977,70,66,70,60,0,6
1207708,21,3,1992,5,"male",284,120,116,0,0,0,0,0,0
1207744,64,29,1949,10,"female",435,24,22,0,0,0,0,0,0
1207749,21,5,1992,2,"female",318,510,244,4897,1955,3919,1174,978,781
1207752,29,21,1984,9,"male",524,142,67,1,20,1,15,0,5
1207760,57,21,1956,7,"male",1283,85,56,0,3,0,3,0,0
1207797,20,30,1993,8,"female",144,64,19,5,17,5,7,0,10
1207820,34,12,1979,12,"male",357,6,1,0,0,0,0,0,0
1207825,14,6,1999,9,"male",398,53,35,0,1,0,1,0,0
1207840,56,18,1957,10,"female",675,40,34,30,18,0,5,30,13
1207853,49,28,1964,5,"female",136,113,87,170,939,170,590,0,349
1207917,19,24,1994,2,"male",865,46,4,0,2,0,2,0,0
1207929,17,10,1996,7,"female",321,119,94,2,12,1,7,1,5
1207942,32,28,1981,4,"male",242,166,130,20,2,0,1,20,1
1207945,99,14,1914,3,"male",23,21,16,2,2,2,1,0,1
1207948,21,1,1992,10,"male",531,113,57,30,36,21,19,9,17
1207962,33,10,1980,12,"male",599,134,55,1,1,0,1,1,0
1207979,48,15,1965,5,"female",1524,103,55,67,10,0,1,67,9
1207989,16,26,1997,3,"male",620,293,252,2,0,2,0,0,0
1207999,25,4,1988,7,"male",393,131,97,22,10,22,5,0,5
1208046,108,12,1905,4,"male",1152,147,76,5,4,5,4,0,0
1208050,65,17,1948,2,"female",291,74,56,2055,1054,1966,204,89,850
1208067,25,16,1988,4,"male",38,3,3,0,0,0,0,0,0
1208077,21,1,1992,4,"female",455,489,266,129,85,27,35,102,50
1208079,51,1,1962,2,"female",207,58,44,157,51,157,34,0,17
1208088,14,31,1999,5,"male",317,136,53,62,3,20,0,42,3
1208092,48,25,1965,3,"female",1237,22,2,0,8,0,4,0,4
1208105,70,4,1943,12,"female",212,18,15,0,2,0,1,0,1
1208113,68,30,1945,7,"female",1812,118,18,30,15,30,9,0,6
1208118,101,9,1912,6,"female",2020,307,256,479,486,319,278,160,208
1208119,29,25,1984,9,"male",645,196,148,2,76,2,75,0,1
1208125,108,5,1905,1,"female",22,8,5,2,8,2,7,0,1
1208138,19,1,1994,1,"male",684,230,107,230,109,229,95,1,14
1208162,22,28,1991,12,"male",175,505,201,13,384,12,100,1,284
1208167,58,1,1955,5,"male",622,22,21,0,3,0,3,0,0
1208183,57,8,1956,8,"male",295,95,47,28,13,0,11,28,2
1208200,47,23,1966,1,"female",545,94,39,18,1,0,1,18,0
1208206,27,29,1986,10,"male",364,102,68,4,2,4,1,0,1
1208226,25,27,1988,11,"female",294,81,46,22,41,22,27,0,14
1208227,19,30,1994,11,"male",691,168,128,440,126,430,71,10,55
1208275,48,1,1965,1,"male",350,365,290,1057,564,1057,419,0,145
1208276,17,6,1996,11,"male",749,347,191,35,3,2,0,33,3
1208305,23,1,1990,7,"male",443,73,47,0,0,0,0,0,0
1208344,50,9,1963,12,"male",276,490,199,587,299,262,56,325,243
1208345,19,11,1994,2,"male",229,69,66,5,0,5,0,0,0
1208363,63,16,1950,11,"male",35,47,42,1,8,1,6,0,2
1208364,28,11,1985,9,"male",1481,262,170,1,1,1,1,0,0
1208379,20,15,1993,9,"male",324,3,3,0,1,0,1,0,0
1208380,26,20,1987,8,"male",195,29,22,2,0,2,0,0,0
1208384,54,10,1959,4,"female",894,82,27,1175,115,0,12,1175,103
1208442,16,16,1997,4,"female",119,249,214,927,369,415,241,512,128
1208504,16,17,1997,12,"female",593,271,209,99,23,26,9,73,14
1208558,18,7,1995,8,"female",251,124,65,2,5,2,5,0,0
1208589,36,15,1977,12,"male",687,138,55,11,0,7,0,4,0
1208668,46,10,1967,7,"male",524,124,85,151,12,30,2,121,10
1208672,18,1,1995,1,"male",575,216,150,67,288,67,263,0,25
1208677,40,12,1973,6,"male",624,13,5,0,2,0,1,0,1
1208696,94,9,1919,7,"female",487,94,80,6,14,0,5,6,9
1208771,24,14,1989,10,"male",76,31,31,1,1,0,1,1,0
1208786,24,1,1989,2,"female",278,28,14,0,4,0,2,0,2
1208788,22,18,1991,12,"male",234,30,30,10,4,3,2,7,2
1208816,42,21,1971,12,"male",479,70,44,7,16,7,16,0,0
1208827,29,30,1984,7,"male",762,35,13,109,0,109,0,0,0
1208828,45,24,1968,5,"male",289,42,16,35,27,0,21,35,6
1208850,58,18,1955,3,"male",197,13,10,225,0,0,0,225,0
1208857,23,27,1990,5,"female",735,164,101,1,6,1,3,0,3
1208868,18,6,1995,5,"female",647,511,228,1424,872,1362,695,62,177
1208878,25,3,1988,3,"male",339,3,1,100,4,94,4,6,0
1208890,17,14,1996,6,"male",404,299,223,161,25,137,15,24,10
1208929,62,30,1951,11,"male",653,33,23,0,0,0,0,0,0
1208970,33,23,1980,7,"female",2279,489,199,115,227,69,198,46,29
1209009,15,1,1998,1,"male",459,5,4,2,0,1,0,1,0
1209016,34,20,1979,3,"male",212,126,82,46,2,46,2,0,0
1209021,80,3,1933,3,"male",1171,33,14,0,0,0,0,0,0
1209030,36,1,1977,9,"female",198,48,25,650,579,650,520,0,59
1209041,23,21,1990,7,"female",599,831,486,413,441,413,202,0,239
1209066,23,4,1990,9,"male",216,69,12,5,14,4,6,1,8
1209067,20,21,1993,5,"female",322,71,30,1216,139,1216,20,0,119
1209119,26,9,1987,7,"male",717,96,44,1,38,0,21,1,17
1209123,102,15,1911,6,"male",774,1196,995,2411,823,2411,766,0,57
1209139,45,4,1968,11,"male",488,704,219,1357,3213,1056,1999,301,1214
1209144,15,21,1998,9,"female",140,1,1,0,1,0,0,0,1
1209161,60,23,1953,9,"female",1852,37,27,635,41,0,31,635,10
1209178,57,26,1956,5,"female",460,82,37,51,61,0,10,51,51
1209209,18,1,1995,1,"male",84,21,19,0,0,0,0,0,0
1209216,13,15,2000,1,"female",232,148,57,62,40,51,21,11,19
1209227,22,5,1991,4,"male",263,99,65,3,26,3,21,0,5
1209271,26,31,1987,1,"female",1048,5,5,0,5,0,3,0,2
1209272,67,25,1946,8,"male",324,148,125,25,11,25,9,0,2
1209304,31,22,1982,8,"female",500,69,51,8,3,8,3,0,0
1209310,15,8,1998,3,"female",480,418,272,0,0,0,0,0,0
1209320,18,18,1995,6,"female",1071,4544,1721,421,1158,129,618,292,540
1209345,22,2,1991,6,"female",397,54,23,0,8,0,4,0,4
1209375,29,19,1984,10,"male",77,24,20,106,7,106,7,0,0
1209384,65,5,1948,1,"male",596,148,80,10,150,9,24,1,126
1209390,21,8,1992,5,"male",259,101,49,159,521,155,316,4,205
1209405,29,18,1984,5,"male",44,10,9,0,0,0,0,0,0
1209410,21,15,1992,4,"male",429,14,6,9,4,4,2,5,2
1209411,18,1,1995,1,"male",74,53,38,50,15,50,15,0,0
1209412,61,19,1952,3,"male",1571,161,56,11,17,10,9,1,8
1209426,19,1,1994,7,"female",327,3036,1141,644,1394,430,463,214,931
1209430,18,19,1995,5,"male",146,410,370,280,381,276,274,4,107
1209440,48,17,1965,3,"female",441,133,62,0,12,0,9,0,3
1209463,53,25,1960,3,"male",184,1,1,0,0,0,0,0,0
1209477,34,1,1979,3,"female",247,11,10,0,0,0,0,0,0
1209482,23,26,1990,6,"female",783,14,9,2,1,2,0,0,1
1209494,20,10,1993,7,"male",126,112,101,106,3,57,2,49,1
1209499,45,28,1968,1,"female",77,161,112,564,626,564,511,0,115
1209552,67,8,1946,1,"male",1326,100,14,54,4,0,2,54,2
1209569,56,13,1957,1,"male",263,10,7,0,0,0,0,0,0
1209573,22,17,1991,8,"female",141,0,0,72,72,16,16,56,56
1209574,14,23,1999,5,"female",254,431,208,65,70,62,10,3,60
1209588,19,22,1994,4,"male",452,12,5,3,0,3,0,0,0
1209607,40,24,1973,10,"male",15,3,3,2,0,2,0,0,0
1209624,26,1,1987,1,"male",248,119,36,0,0,0,0,0,0
1209677,29,31,1984,12,"male",332,419,389,0,115,0,39,0,76
1209714,50,18,1963,2,"male",83,16,12,0,0,0,0,0,0
1209723,20,6,1993,1,"female",37,24,20,22,20,22,19,0,1
1209737,17,27,1996,11,"male",12,0,0,0,0,0,0,0,0
1209778,35,19,1978,9,"male",1662,44,17,0,0,0,0,0,0
1209804,20,14,1993,6,"female",183,22,19,1,0,1,0,0,0
1209819,25,24,1988,12,"male",334,3,0,0,0,0,0,0,0
1209827,44,18,1969,12,"female",720,414,221,174,21,157,11,17,10
1209843,37,9,1976,2,"male",304,1,0,0,0,0,0,0,0
1209847,26,3,1987,4,"female",873,61,33,1,4,0,1,1,3
1209857,18,2,1995,6,"male",551,139,111,20,7,20,7,0,0
1209878,29,1,1984,2,"female",318,65,41,10,10,8,5,2,5
1209895,108,20,1905,1,"female",1742,699,539,184,164,158,86,26,78
1209936,16,27,1997,7,"female",1011,1600,604,379,795,294,620,85,175
1209938,19,17,1994,11,"female",432,248,197,17,25,1,8,16,17
1209941,51,9,1962,12,"female",472,2,2,0,0,0,0,0,0
1209960,35,3,1978,5,"female",381,77,51,394,294,394,218,0,76
1209984,93,20,1920,12,"male",1172,91,68,57,15,57,14,0,1
1209993,45,23,1968,12,"female",402,4,0,0,0,0,0,0,0
1210000,29,12,1984,6,"male",141,178,131,0,0,0,0,0,0
1210002,20,2,1993,1,"female",234,470,269,11,201,11,76,0,125
1210005,17,27,1996,9,"male",484,10,0,0,2,0,2,0,0
1210006,28,2,1985,7,"male",256,38,15,0,0,0,0,0,0
1210008,21,4,1992,9,"male",303,10,7,5,0,5,0,0,0
1210013,45,7,1968,6,"female",354,8,6,1,0,1,0,0,0
1210014,49,16,1964,6,"female",364,19,7,0,0,0,0,0,0
1210033,19,6,1994,5,"male",519,54,22,0,0,0,0,0,0
1210046,19,30,1994,6,"male",217,1,1,0,0,0,0,0,0
1210113,24,22,1989,9,"female",621,175,75,282,188,282,179,0,9
1210115,15,11,1998,9,"male",473,31,23,2,0,2,0,0,0
1210124,54,25,1959,9,"male",158,22,11,0,8,0,3,0,5
1210128,67,2,1946,5,"male",534,2,0,0,0,0,0,0,0
1210132,108,5,1905,7,"female",1485,386,149,5,3,5,3,0,0
1210151,101,14,1912,5,"male",284,832,754,58,519,53,397,5,122
1210152,23,21,1990,11,"male",307,113,59,2,0,2,0,0,0
1210157,27,12,1986,12,"male",598,62,45,0,1,0,0,0,1
1210182,18,27,1995,7,"male",209,56,39,13,0,13,0,0,0
1210184,15,19,1998,11,"male",322,378,214,0,1,0,0,0,1
1210189,20,19,1993,3,"male",638,342,226,3,1,3,1,0,0
1210197,23,30,1990,8,"male",640,1273,990,7,0,0,0,7,0
1210206,24,8,1989,8,"female",266,263,69,5,6,5,6,0,0
1210207,49,4,1964,12,"female",675,57,41,109,68,104,27,5,41
1210212,28,24,1985,5,"female",775,823,494,446,556,406,303,40,253
1210217,28,26,1985,6,"male",320,177,58,1,4,0,2,1,2
1210219,45,6,1968,6,"male",783,60,17,11,8,11,5,0,3
1210223,19,28,1994,3,"male",85,68,48,1,1,1,1,0,0
1210225,57,8,1956,1,"male",1566,63,16,7,2,0,0,7,2
1210241,26,28,1987,8,"female",383,40,8,0,1,0,0,0,1
1210256,50,25,1963,5,"male",1031,28,16,0,0,0,0,0,0
1210269,19,9,1994,6,"female",268,3035,281,932,1904,932,1446,0,458
1210280,100,18,1913,1,"female",1064,874,623,68,113,68,82,0,31
1210283,58,4,1955,5,"female",730,16,6,11,0,5,0,6,0
1210286,94,19,1919,12,"female",1400,227,126,1,6,1,5,0,1
1210334,18,21,1995,3,"female",458,103,42,2,1,0,1,2,0
1210337,36,11,1977,1,"male",759,58,37,4,3,0,2,4,1
1210367,25,6,1988,1,"male",37,138,123,3,3,3,3,0,0
1210370,18,10,1995,11,"female",13,88,77,248,583,187,299,61,284
1210374,108,19,1905,12,"female",1568,67,38,0,0,0,0,0,0
1210384,47,22,1966,7,"male",1532,33,19,35,6,35,3,0,3
1210396,26,7,1987,11,"female",190,21,11,3,0,3,0,0,0
1210398,36,24,1977,7,"female",340,183,128,386,315,386,258,0,57
1210426,27,4,1986,1,"male",161,172,124,438,368,10,45,428,323
1210429,28,14,1985,4,"male",203,107,87,2,34,2,32,0,2
1210452,18,8,1995,6,"male",582,0,0,0,0,0,0,0,0
1210457,76,1,1937,9,"female",1430,122,73,15,11,15,6,0,5
1210470,20,24,1993,3,"male",627,12,4,0,0,0,0,0,0
1210477,44,5,1969,4,"male",646,102,78,345,334,276,289,69,45
1210479,18,14,1995,1,"male",45,90,71,8,22,8,14,0,8
1210484,56,28,1957,10,"male",457,222,180,92,214,74,133,18,81
1210493,67,29,1946,5,"female",478,40,23,122,16,122,12,0,4
1210515,55,6,1958,4,"female",317,10,9,10,9,0,2,10,7
1210535,31,9,1982,5,"female",402,156,45,134,99,134,78,0,21
1210550,29,28,1984,6,"male",533,67,64,5,2,4,0,1,2
1210573,19,14,1994,9,"male",253,54,28,2,2,2,1,0,1
1210603,40,23,1973,2,"female",512,251,178,7,5,7,5,0,0
1210629,16,21,1997,12,"female",140,242,73,1,82,1,59,0,23
1210631,41,28,1972,3,"male",1895,292,64,25,33,25,24,0,9
1210637,61,14,1952,10,"female",473,73,65,452,11,0,6,452,5
1210642,23,5,1990,1,"male",179,35,17,0,6,0,0,0,6
1210683,39,3,1974,4,"female",387,169,133,13,169,13,112,0,57
1210711,28,15,1985,8,"male",105,1,0,0,0,0,0,0,0
1210718,61,19,1952,12,"female",1659,147,69,23,67,11,13,12,54
1210719,25,30,1988,8,"male",11,24,15,4,2,4,2,0,0
1210762,25,31,1988,12,"male",57,500,443,1794,1384,752,400,1042,984
1210766,35,28,1978,2,"male",364,79,68,8,3,0,2,8,1
1210798,13,4,2000,1,"female",0,0,0,0,0,0,0,0,0
1210836,16,11,1997,4,"male",254,138,120,13,10,13,5,0,5
1210861,30,20,1983,3,"male",142,66,45,19,8,19,3,0,5
1210867,22,4,1991,2,"male",474,729,569,2747,643,141,505,2606,138
1210875,30,23,1983,2,"male",42,10,4,0,0,0,0,0,0
1210877,108,13,1905,4,"female",66,311,64,25,16,25,15,0,1
1210887,14,20,1999,9,"male",271,13,8,0,0,0,0,0,0
1210908,69,24,1944,2,"female",159,40,15,29,33,0,22,29,11
1210948,75,14,1938,2,"female",835,80,32,7,3,0,1,7,2
1210956,103,27,1910,11,"female",732,342,93,184,151,184,135,0,16
1210992,17,4,1996,10,"male",191,14,10,9,4,1,4,8,0
1210993,18,10,1995,6,"female",525,516,178,4,27,4,17,0,10
1211032,31,10,1982,10,"male",696,660,630,2,19,2,10,0,9
1211050,24,23,1989,3,"male",6,1,1,0,0,0,0,0,0
1211091,24,19,1989,9,"male",257,30,18,13,0,0,0,13,0
1211093,68,27,1945,12,"male",1347,400,282,14,6,14,6,0,0
1211114,45,1,1968,1,"male",434,20,16,0,0,0,0,0,0
1211132,24,28,1989,1,"male",651,1,1,0,0,0,0,0,0
1211146,40,2,1973,2,"male",1466,178,96,0,19,0,10,0,9
1211159,18,15,1995,4,"male",66,6,6,1,0,0,0,1,0
1211195,64,22,1949,2,"male",357,42,32,0,0,0,0,0,0
1211213,18,4,1995,5,"female",524,243,124,107,173,92,74,15,99
1211223,103,31,1910,5,"male",1599,467,372,357,250,4,12,353,238
1211235,16,2,1997,9,"female",307,851,639,1504,1183,8,84,1496,1099
1211256,22,24,1991,5,"male",65,22,19,24,30,24,20,0,10
1211285,20,3,1993,10,"female",648,9,9,20,1,20,1,0,0
1211299,22,10,1991,6,"male",406,19,10,0,0,0,0,0,0
1211306,53,1,1960,1,"female",384,69,44,16,21,16,12,0,9
1211342,37,5,1976,6,"female",431,0,0,0,0,0,0,0,0
1211368,15,6,1998,8,"male",321,353,267,39,28,1,8,38,20
1211388,75,22,1938,4,"male",2397,499,327,127,77,29,42,98,35
1211398,33,26,1980,5,"male",208,9,9,0,0,0,0,0,0
1211421,28,6,1985,2,"male",759,193,141,0,0,0,0,0,0
1211434,66,19,1947,10,"female",866,14,4,2,5,0,1,2,4
1211455,33,13,1980,9,"female",253,325,94,54,13,0,5,54,8
1211458,68,14,1945,11,"male",13,48,39,2,4,0,0,2,4
1211460,66,30,1947,9,"female",172,16,15,7940,773,7940,340,0,433
1211468,18,8,1995,4,"male",61,31,23,26,1,8,0,18,1
1211470,57,17,1956,11,"male",59,0,0,0,0,0,0,0,0
1211474,27,3,1986,10,"male",440,51,16,292,38,292,31,0,7
1211478,51,28,1962,2,"female",1199,62,37,180,87,0,26,180,61
1211484,20,28,1993,10,"male",366,21,15,6,12,0,3,6,9
1211493,25,7,1988,4,"male",596,270,40,8,22,0,18,8,4
1211494,15,25,1998,1,"female",201,356,284,361,331,8,100,353,231
1211529,31,8,1982,12,"male",102,42,35,1,2,1,2,0,0
1211556,27,8,1986,4,"female",142,104,37,0,0,0,0,0,0
1211574,36,30,1977,7,"male",392,69,55,0,7,0,5,0,2
1211585,72,4,1941,4,"female",356,28,21,8,4,8,4,0,0
1211598,19,24,1994,6,"male",36,238,185,5,76,5,43,0,33
1211603,32,30,1981,3,"male",233,35,33,0,0,0,0,0,0
1211611,30,6,1983,5,"female",265,182,150,449,253,335,73,114,180
1211645,17,1,1996,1,"female",118,2,0,0,0,0,0,0,0
1211683,20,31,1993,8,"male",297,232,165,22,10,21,2,1,8
1211700,16,11,1997,11,"male",395,176,158,0,47,0,17,0,30
1211710,45,19,1968,9,"female",212,23,22,5,2,5,2,0,0
1211748,77,4,1936,9,"female",1483,51,16,73,114,1,84,72,30
1211758,56,21,1957,8,"female",346,94,87,43,8,43,6,0,2
1211767,26,16,1987,1,"female",470,857,771,3,5,1,5,2,0
1211771,17,17,1996,10,"male",468,250,139,85,77,46,33,39,44
1211802,18,12,1995,8,"female",94,574,240,1185,792,0,88,1185,704
1211816,35,26,1978,3,"female",163,51,41,80,11,80,10,0,1
1211840,28,7,1985,7,"male",78,30,18,74,17,74,17,0,0
1211924,93,26,1920,3,"female",973,483,185,1926,2019,373,1314,1553,705
1211935,19,12,1994,1,"male",419,40,23,0,0,0,0,0,0
1211942,15,13,1998,8,"male",680,210,52,0,3,0,3,0,0
1211954,25,1,1988,1,"male",271,65,57,0,54,0,30,0,24
1211969,27,7,1986,7,"female",834,59,30,0,0,0,0,0,0
1211995,40,20,1973,9,"male",49,52,43,1,3,1,2,0,1
1212001,39,23,1974,6,"male",489,31,21,38,18,38,17,0,1
1212024,18,1,1995,1,"male",364,48,36,0,0,0,0,0,0
1212025,52,23,1961,10,"female",549,44,17,9,7,9,5,0,2
1212061,64,23,1949,3,"female",1127,136,54,184,49,79,13,105,36
1212065,32,19,1981,12,"male",246,132,83,64,131,8,38,56,93
1212075,78,1,1935,8,"female",63,173,128,1727,379,1727,280,0,99
1212077,19,11,1994,11,"male",495,151,108,0,4,0,4,0,0
1212093,23,29,1990,9,"female",651,137,56,139,0,74,0,65,0
1212095,18,4,1995,6,"male",473,47,32,0,18,0,9,0,9
1212150,50,22,1963,6,"female",439,60,46,0,0,0,0,0,0
1212157,108,12,1905,5,"female",1405,403,188,73,118,12,82,61,36
1212185,17,16,1996,3,"male",168,50,26,18,33,18,26,0,7
1212207,86,19,1927,7,"male",607,36,27,0,0,0,0,0,0
1212208,21,8,1992,1,"female",740,248,149,21,15,21,6,0,9
1212210,20,20,1993,11,"female",458,466,243,301,337,193,71,108,266
1212225,21,18,1992,9,"female",341,174,80,588,175,47,26,541,149
1212233,57,10,1956,11,"male",1713,110,70,0,0,0,0,0,0
1212257,59,28,1954,12,"male",171,179,109,1,0,1,0,0,0
1212258,29,11,1984,1,"male",420,9,1,4,9,0,0,4,9
1212302,15,17,1998,8,"male",166,79,68,15,9,8,4,7,5
1212317,25,20,1988,10,"female",1459,257,87,60,310,60,226,0,84
1212368,18,17,1995,8,"female",456,137,102,280,176,280,164,0,12
1212376,19,28,1994,4,NA,237,374,194,254,184,252,166,2,18
1212378,33,15,1980,7,"male",22,32,30,1233,56,1233,38,0,18
1212391,77,27,1936,8,"male",1424,40,27,0,0,0,0,0,0
1212394,37,22,1976,12,"female",201,89,77,2,11,2,6,0,5
1212433,23,5,1990,1,"male",282,242,40,5,1,5,1,0,0
1212443,63,14,1950,1,"male",975,505,412,5751,677,4135,228,1616,449
1212453,28,1,1985,1,"female",1039,0,0,0,0,0,0,0,0
1212470,21,1,1992,12,"male",568,30,20,0,0,0,0,0,0
1212485,59,9,1954,4,"female",1537,226,38,5,14,5,10,0,4
1212492,25,1,1988,1,"male",258,70,54,0,0,0,0,0,0
1212509,16,21,1997,3,"male",406,91,62,20,0,20,0,0,0
1212514,73,13,1940,2,"male",1370,138,98,45,21,0,3,45,18
1212537,46,5,1967,5,"female",748,115,45,7,28,0,4,7,24
1212545,21,11,1992,9,"male",57,1,1,30,3,30,3,0,0
1212550,18,9,1995,12,"female",178,220,94,525,389,483,296,42,93
1212561,18,4,1995,4,"male",416,191,148,161,80,161,75,0,5
1212595,68,24,1945,11,"male",1171,520,395,8,28,8,28,0,0
1212608,31,9,1982,11,"male",211,110,40,5,16,2,5,3,11
1212632,17,12,1996,8,"male",16,22,21,2,13,2,10,0,3
1212641,25,4,1988,3,"male",960,48,44,14,1,14,0,0,1
1212708,34,23,1979,3,"male",954,103,97,0,0,0,0,0,0
1212714,20,28,1993,5,"female",703,195,35,58,57,8,30,50,27
1212730,17,8,1996,8,"male",370,80,41,21,3,21,3,0,0
1212740,31,23,1982,9,"female",553,43,10,121,219,121,210,0,9
1212755,25,1,1988,5,"male",270,36,19,49,16,27,4,22,12
1212765,56,13,1957,12,"male",388,164,132,23,5,0,0,23,5
1212775,19,22,1994,9,"female",219,580,313,432,544,143,309,289,235
1212781,23,19,1990,11,"male",92,81,54,0,1,0,0,0,1
1212819,100,12,1913,2,"male",1233,26,6,0,0,0,0,0,0
1212832,51,13,1962,11,"female",118,99,57,121,68,121,55,0,13
1212850,59,24,1954,9,"female",699,23,21,50,5,16,2,34,3
1212857,31,29,1982,10,"female",163,361,52,288,797,288,579,0,218
1212861,21,6,1992,8,"male",359,72,50,0,0,0,0,0,0
1212864,13,9,2000,2,"female",200,294,262,32,22,8,3,24,19
1212902,25,25,1988,5,"female",32,1,1,8,1,0,0,8,1
1212924,23,31,1990,3,"male",880,1366,949,85,18,85,18,0,0
1212943,15,14,1998,5,"female",457,731,427,4,0,4,0,0,0
1212983,103,15,1910,2,"male",1476,36,11,1,1,1,1,0,0
1212986,27,1,1986,7,"female",15,28,25,3,12,0,5,3,7
1213018,36,22,1977,2,"male",637,17,8,3,3,0,0,3,3
1213025,21,26,1992,3,"female",311,115,49,2,3,2,3,0,0
1213068,17,20,1996,11,"male",55,18,15,0,0,0,0,0,0
1213077,50,25,1963,10,"male",415,55,13,9,7,0,0,9,7
1213086,28,25,1985,5,"male",367,9,9,6,3,0,2,6,1
1213120,84,14,1929,6,"female",996,31,23,2,0,0,0,2,0
1213123,47,6,1966,11,"female",493,38,12,0,0,0,0,0,0
1213125,14,9,1999,3,"female",171,2173,1365,1265,7702,118,5921,1147,1781
1213126,14,31,1999,1,"female",444,203,115,94,26,0,7,94,19
1213158,49,4,1964,12,"male",638,10,2,1,0,1,0,0,0
1213172,26,26,1987,9,"female",651,60,31,496,166,422,68,74,98
1213181,30,16,1983,10,"male",219,0,0,0,0,0,0,0,0
1213186,17,18,1996,4,"male",12,0,0,0,0,0,0,0,0
1213224,82,15,1931,11,"male",158,36,30,0,0,0,0,0,0
1213278,26,3,1987,7,"male",49,95,92,99,0,99,0,0,0
1213279,27,23,1986,11,"male",555,37,21,1,0,0,0,1,0
1213290,18,25,1995,7,"female",240,24,12,10,0,10,0,0,0
1213304,35,21,1978,12,"male",705,126,77,0,0,0,0,0,0
1213317,37,18,1976,8,"female",479,110,45,55,36,55,19,0,17
1213324,66,7,1947,1,"male",561,0,0,0,0,0,0,0,0
1213339,44,25,1969,6,"female",688,32,13,14,1,10,0,4,1
1213352,23,14,1990,2,"female",284,47,32,6,6,6,6,0,0
1213388,103,1,1910,4,"male",1372,544,309,29,4,0,1,29,3
1213402,74,23,1939,6,"male",1381,153,82,2,1,0,0,2,1
1213415,25,3,1988,7,"female",631,124,75,0,2,0,2,0,0
1213421,51,11,1962,12,"male",621,16,8,0,0,0,0,0,0
1213439,25,23,1988,12,"male",615,14,8,0,1,0,1,0,0
1213458,33,7,1980,12,"male",230,1,1,0,0,0,0,0,0
1213463,14,10,1999,8,"female",401,1354,632,570,128,55,63,515,65
1213475,53,30,1960,11,"female",520,37,26,400,23,8,5,392,18
1213485,65,20,1948,12,"male",305,58,45,160,4,0,2,160,2
1213512,33,19,1980,10,"male",94,9,9,8,1,8,0,0,1
1213515,58,23,1955,5,"female",216,60,52,77,27,0,2,77,25
1213516,21,14,1992,7,"male",537,344,301,4,21,4,18,0,3
1213527,21,11,1992,9,"female",449,203,154,52,202,26,49,26,153
1213552,29,1,1984,6,"female",219,224,80,9,2,9,1,0,1
1213554,64,22,1949,3,"female",392,46,33,305,25,0,5,305,20
1213564,28,24,1985,4,"male",866,65,54,14,4,14,4,0,0
1213567,38,1,1975,1,"male",146,109,95,2,0,0,0,2,0
1213592,64,27,1949,5,"female",626,52,17,29,29,7,24,22,5
1213614,29,21,1984,7,"male",222,23,13,2,0,0,0,2,0
1213659,25,5,1988,5,"male",94,7,5,2,2,2,2,0,0
1213690,15,22,1998,12,"male",92,143,96,33,2,20,1,13,1
1213707,29,23,1984,4,"female",694,120,93,19,23,19,10,0,13
1213712,18,14,1995,10,"female",38,2,1,135,158,132,135,3,23
1213732,26,1,1987,1,"male",320,1,1,0,0,0,0,0,0
1213737,28,28,1985,11,"male",560,40,39,0,0,0,0,0,0
1213740,20,23,1993,7,"female",27,0,0,0,0,0,0,0,0
1213782,91,23,1922,4,NA,2039,63,18,76,42,74,17,2,25
1213789,14,29,1999,7,"female",77,95,37,72,5,72,5,0,0
1213808,22,18,1991,10,"female",443,212,103,57,43,56,11,1,32
1213820,18,29,1995,9,"female",291,369,261,181,295,47,214,134,81
1213840,16,12,1997,7,"male",852,468,251,2039,509,1678,291,361,218
1213866,68,5,1945,1,"female",256,69,56,2219,123,2219,100,0,23
1213876,47,23,1966,9,"male",649,71,23,3,6,0,2,3,4
1213884,113,5,1900,2,"female",1529,302,84,3,0,3,0,0,0
1213897,28,10,1985,7,"female",322,68,37,287,89,236,16,51,73
1213900,67,23,1946,11,"female",634,86,39,12,8,12,8,0,0
1213904,20,1,1993,1,"female",212,162,123,245,119,245,63,0,56
1213926,47,7,1966,12,"female",797,299,182,655,369,413,160,242,209
1213934,61,3,1952,8,"male",1655,44,12,2,0,2,0,0,0
1213941,14,1,1999,1,"male",206,29,23,0,0,0,0,0,0
1213970,13,26,2000,4,"male",199,37,6,0,0,0,0,0,0
1213982,62,20,1951,5,"female",1175,278,130,3,201,0,18,3,183
1213985,17,8,1996,11,"female",589,40,29,14,3,14,3,0,0
1213986,63,9,1950,1,"male",1592,56,13,0,3,0,2,0,1
1214006,82,27,1931,4,"female",440,225,201,3,2,0,1,3,1
1214007,24,23,1989,3,"male",250,76,70,0,0,0,0,0,0
1214028,32,25,1981,12,"female",286,116,76,4,22,4,21,0,1
1214046,17,6,1996,11,"male",648,274,163,836,745,627,280,209,465
1214091,59,7,1954,12,"male",441,52,31,0,1,0,1,0,0
1214115,31,22,1982,1,"female",626,30,11,0,0,0,0,0,0
1214117,16,4,1997,3,"female",331,183,168,9,1,4,0,5,1
1214126,108,10,1905,12,"male",2252,237,127,12,40,11,37,1,3
1214127,15,4,1998,2,"male",326,353,234,10,43,10,43,0,0
1214139,43,21,1970,3,"female",520,58,55,180,99,23,67,157,32
1214156,18,29,1995,4,"male",698,210,113,385,296,245,163,140,133
1214240,25,25,1988,1,"female",443,199,156,23,77,23,77,0,0
1214250,18,15,1995,12,"male",584,146,43,0,1,0,0,0,1
1214259,77,31,1936,7,"female",74,6,5,1,1,0,0,1,1
1214262,19,9,1994,11,"male",287,75,51,0,2,0,1,0,1
1214283,28,21,1985,9,"male",494,307,205,1,1,1,1,0,0
1214296,68,3,1945,5,"female",1365,223,83,1807,461,0,237,1807,224
1214299,31,6,1982,4,"female",108,99,72,941,758,941,631,0,127
1214346,42,2,1971,10,"female",879,41,34,21,4,21,4,0,0
1214393,37,4,1976,2,"male",255,30,21,20,3,0,0,20,3
1214402,31,9,1982,3,"male",1056,57,20,5,0,1,0,4,0
1214405,26,28,1987,2,"female",291,40,17,0,0,0,0,0,0
1214418,64,2,1949,6,"female",1255,39,29,858,97,791,76,67,21
1214420,53,10,1960,1,"male",653,114,99,60,0,60,0,0,0
1214485,60,12,1953,2,"female",315,25,8,2,3,0,3,2,0
1214514,25,1,1988,5,"male",4,27,27,2,0,2,0,0,0
1214525,52,18,1961,4,"male",171,11,10,3,1,3,1,0,0
1214542,17,19,1996,2,"male",658,118,60,40,31,34,17,6,14
1214595,103,12,1910,3,"male",1464,649,357,0,0,0,0,0,0
1214610,28,8,1985,6,"male",641,82,22,1,5,1,5,0,0
1214618,66,23,1947,1,"male",605,39,28,55,107,55,87,0,20
1214627,22,28,1991,4,"male",205,226,203,8,22,6,17,2,5
1214643,49,3,1964,12,"male",366,56,39,33,39,33,18,0,21
1214647,29,31,1984,12,"male",1168,163,147,0,54,0,54,0,0
1214687,23,1,1990,10,"female",400,16,6,26,3,0,2,26,1
1214690,23,31,1990,10,"male",1225,511,312,0,0,0,0,0,0
1214711,18,11,1995,9,"female",718,748,323,218,613,151,220,67,393
1214742,23,22,1990,8,"male",382,111,98,0,0,0,0,0,0
1214774,17,14,1996,2,"female",764,95,0,0,10,0,7,0,3
1214793,25,20,1988,10,"female",438,100,97,89,70,89,52,0,18
1214817,47,3,1966,1,"male",143,53,46,29,13,29,13,0,0
1214826,34,14,1979,11,"male",655,53,17,2,3,1,3,1,0
1214842,17,30,1996,3,"male",65,56,43,3,35,2,29,1,6
1214845,25,12,1988,1,"male",363,179,150,368,96,0,28,368,68
1214858,55,9,1958,1,"male",192,73,42,39,100,35,52,4,48
1214867,35,2,1978,4,"male",209,4,3,0,0,0,0,0,0
1214920,21,16,1992,6,"female",24,28,21,4,17,4,17,0,0
1214925,39,3,1974,2,"male",584,30,22,1,0,0,0,1,0
1214927,18,26,1995,12,"female",454,1,1,0,0,0,0,0,0
1214932,15,23,1998,6,"male",187,4,4,289,6,0,0,289,6
1214955,21,5,1992,2,"male",130,175,118,545,1102,470,975,75,127
1214956,27,15,1986,12,"male",358,314,177,40,59,39,30,1,29
1215053,103,1,1910,4,NA,1956,59,29,1,1,0,0,1,1
1215073,41,23,1972,8,"male",866,19,14,1,3,0,1,1,2
1215090,23,1,1990,1,"female",550,67,41,73,132,73,123,0,9
1215099,17,18,1996,11,"male",166,145,97,14,7,14,6,0,1
1215123,95,28,1918,9,"male",523,188,74,15,7,15,6,0,1
1215134,44,16,1969,9,"male",190,93,54,0,1,0,1,0,0
1215159,68,6,1945,12,"female",2248,110,43,320,132,316,103,4,29
1215174,37,28,1976,10,"male",146,31,27,1,5,1,5,0,0
1215185,48,9,1965,6,"female",344,78,43,104,19,104,9,0,10
1215196,31,14,1982,5,"female",705,106,92,289,136,289,135,0,1
1215208,25,25,1988,1,"female",66,6,4,32,0,32,0,0,0
1215265,37,12,1976,4,"male",505,39,21,0,0,0,0,0,0
1215309,53,3,1960,11,"female",1195,103,39,1,10,0,7,1,3
1215316,24,23,1989,7,"female",424,108,64,0,3,0,1,0,2
1215333,19,1,1994,1,"male",190,309,57,2,0,0,0,2,0
1215342,94,9,1919,5,"male",454,506,346,33,18,4,11,29,7
1215357,44,27,1969,5,"female",1288,99,62,19,94,6,38,13,56
1215376,34,25,1979,11,"male",122,22,17,18,4,18,1,0,3
1215395,23,7,1990,6,"female",412,218,99,455,26,316,10,139,16
1215404,50,17,1963,11,"female",605,50,34,43,16,43,16,0,0
1215420,18,20,1995,4,"male",397,1106,979,71,293,71,274,0,19
1215430,40,30,1973,12,"female",1033,5,2,12,23,12,0,0,23
1215452,19,18,1994,6,"male",407,229,145,2,1,2,1,0,0
1215456,101,9,1912,10,"male",818,1656,1318,79,46,21,30,58,16
1215458,21,29,1992,6,"male",929,258,99,42,99,5,92,37,7
1215482,32,14,1981,7,"male",1043,174,132,6,59,5,44,1,15
1215528,64,15,1949,7,"male",129,41,30,3,2,1,1,2,1
1215529,22,20,1991,10,"female",64,353,325,3230,2240,1843,986,1387,1254
1215550,58,8,1955,8,"male",360,68,18,230,79,219,20,11,59
1215558,29,28,1984,4,"male",887,202,145,50,8,50,7,0,1
1215567,30,28,1983,6,"male",217,78,73,15,19,15,16,0,3
1215569,77,26,1936,3,"male",1178,2,0,0,0,0,0,0,0
1215579,55,7,1958,7,"female",311,102,78,155,47,155,21,0,26
1215608,78,11,1935,12,"male",101,97,41,3,0,2,0,1,0
1215638,25,4,1988,2,"male",125,13,13,5,0,1,0,4,0
1215639,20,1,1993,1,"male",193,229,179,39,36,39,23,0,13
1215648,57,5,1956,5,"female",777,107,75,69,68,66,59,3,9
1215666,24,19,1989,1,"female",6,0,0,0,0,0,0,0,0
1215682,69,19,1944,3,"female",323,88,29,172,22,172,16,0,6
1215703,40,30,1973,12,"male",159,4,2,1,1,1,0,0,1
1215748,22,10,1991,2,"male",19,0,0,0,0,0,0,0,0
1215753,56,6,1957,2,"female",179,5,5,1,1,1,1,0,0
1215762,18,17,1995,2,"male",227,366,288,469,1,469,0,0,1
1215822,60,10,1953,10,"male",1249,30,12,34,177,15,131,19,46
1215851,17,5,1996,1,"male",616,2410,1329,122,26,122,22,0,4
1215854,63,21,1950,12,"male",1580,38,19,8,3,8,2,0,1
1215869,49,10,1964,11,"female",271,54,40,128,88,0,26,128,62
1215881,24,12,1989,3,"male",718,302,261,0,6,0,0,0,6
1215900,57,20,1956,10,"male",929,42,18,8,7,8,5,0,2
1215906,27,28,1986,5,"male",712,166,125,11,7,11,6,0,1
1215911,29,10,1984,1,"male",948,12,6,1,0,1,0,0,0
1215921,22,25,1991,6,"female",302,30,10,55,31,55,22,0,9
1215927,69,12,1944,8,"female",11,36,34,7,9,7,6,0,3
1215928,108,1,1905,1,"male",1544,185,103,33,38,10,6,23,32
1215954,20,11,1993,6,"female",786,1009,647,1031,305,764,169,267,136
1215962,69,27,1944,2,"male",758,102,67,72,52,0,24,72,28
1215968,29,11,1984,12,"female",703,975,491,518,413,474,265,44,148
1215976,19,14,1994,8,"male",51,10,9,3,0,3,0,0,0
1215999,103,20,1910,8,"male",1463,588,189,66,100,26,35,40,65
1216002,18,27,1995,11,"male",0,28,26,6,18,0,3,6,15
1216012,31,15,1982,10,"male",16,44,44,3,2,3,0,0,2
1216030,17,10,1996,10,"male",219,445,387,0,1,0,1,0,0
1216039,35,15,1978,8,"female",1834,215,137,64,111,63,70,1,41
1216070,22,11,1991,8,"male",291,191,165,829,693,829,667,0,26
1216100,24,29,1989,6,"female",778,566,385,143,306,63,141,80,165
1216109,33,10,1980,12,"male",415,50,33,0,0,0,0,0,0
1216124,27,3,1986,3,"female",560,103,55,15,55,13,43,2,12
1216134,19,5,1994,1,"male",312,78,62,6,3,6,2,0,1
1216153,18,1,1995,1,"male",112,0,0,0,0,0,0,0,0
1216160,23,12,1990,12,"female",865,28,15,0,0,0,0,0,0
1216237,26,1,1987,1,"male",323,113,91,1,0,1,0,0,0
1216260,22,31,1991,5,"male",294,95,73,0,0,0,0,0,0
1216268,21,10,1992,4,"male",312,32,24,54,47,54,7,0,40
1216275,42,19,1971,1,"male",179,19,14,23,0,22,0,1,0
1216277,55,22,1958,12,"female",694,80,66,5,93,5,64,0,29
1216280,18,15,1995,5,"male",477,43,29,0,0,0,0,0,0
1216299,17,1,1996,2,"male",304,1,1,4,0,4,0,0,0
1216309,22,31,1991,5,"female",231,385,337,1,0,1,0,0,0
1216342,23,28,1990,2,"male",397,14,9,46,39,40,23,6,16
1216355,78,1,1935,8,"male",864,19,5,0,0,0,0,0,0
1216379,21,8,1992,11,"male",524,123,77,14,4,13,3,1,1
1216384,29,19,1984,7,"male",8,3,3,1,4,0,3,1,1
1216418,17,5,1996,1,"male",687,156,48,20,0,6,0,14,0
1216435,35,9,1978,4,"male",1556,137,75,1,1,1,1,0,0
1216444,19,1,1994,8,"female",469,4863,241,37,166,36,117,1,49
1216448,27,12,1986,2,"male",479,77,43,1,0,0,0,1,0
1216450,103,20,1910,8,"male",1409,424,75,9,9,9,7,0,2
1216453,20,26,1993,4,"male",343,242,81,2442,204,1159,69,1283,135
1216454,113,25,1900,2,"female",1567,249,83,22,19,19,12,3,7
1216465,18,3,1995,10,"female",447,56,22,1,23,1,23,0,0
1216466,63,16,1950,6,"female",1948,551,358,232,279,27,88,205,191
1216467,25,1,1988,1,"male",859,54,45,3,0,0,0,3,0
1216471,68,1,1945,4,"female",1315,352,157,8,3,0,0,8,3
1216530,49,14,1964,5,"male",292,5,3,0,2,0,2,0,0
1216554,65,2,1948,9,"female",369,103,46,190,69,0,31,190,38
1216559,108,11,1905,1,"female",1789,346,174,1145,594,563,271,582,323
1216569,17,12,1996,9,"female",346,576,462,0,0,0,0,0,0
1216575,41,24,1972,7,"male",199,57,45,4,0,4,0,0,0
1216586,38,1,1975,10,"male",267,8,7,0,0,0,0,0,0
1216610,14,24,1999,10,"female",234,198,108,9,93,7,46,2,47
1216650,28,19,1985,12,"male",618,91,53,0,0,0,0,0,0
1216708,29,6,1984,11,"female",403,28,25,166,26,166,16,0,10
1216711,31,2,1982,6,"female",303,14,8,1,0,1,0,0,0
1216732,36,21,1977,4,"male",619,381,132,12,40,5,28,7,12
1216737,52,29,1961,5,"female",699,361,170,665,1171,0,468,665,703
1216761,56,2,1957,11,"male",202,60,52,29,15,19,10,10,5
1216774,19,15,1994,2,"male",256,3,2,2,2,0,2,2,0
1216834,16,12,1997,11,"female",1518,593,165,3,113,3,83,0,30
1216843,20,23,1993,9,"female",703,751,516,3345,2029,2744,624,601,1405
1216850,27,28,1986,8,"male",510,231,195,10,0,10,0,0,0
1216864,26,20,1987,3,"male",483,26,20,24,7,24,7,0,0
1216906,33,25,1980,9,"male",181,176,164,0,0,0,0,0,0
1216950,18,20,1995,7,"female",194,22,8,0,0,0,0,0,0
1216957,25,8,1988,6,"female",223,108,55,169,220,168,199,1,21
1216982,28,18,1985,1,"male",243,465,234,10,17,6,3,4,14
1217002,46,20,1967,5,"female",792,227,83,50,286,0,42,50,244
1217004,23,1,1990,1,"male",250,25,15,131,44,81,33,50,11
1217008,23,10,1990,12,"female",743,303,93,28,171,28,160,0,11
1217009,32,29,1981,8,"female",17,1,1,0,0,0,0,0,0
1217041,19,3,1994,5,"male",376,12,10,0,0,0,0,0,0
1217064,17,1,1996,5,"female",152,170,139,37,20,37,15,0,5
1217072,49,10,1964,4,"male",89,24,13,1,1,1,1,0,0
1217091,24,18,1989,10,"female",361,56,37,42,31,41,15,1,16
1217092,51,17,1962,6,"male",404,0,0,0,0,0,0,0,0
1217101,29,24,1984,7,"male",106,10,10,0,0,0,0,0,0
1217119,58,2,1955,12,"male",93,47,37,8,19,8,9,0,10
1217151,17,7,1996,10,"male",68,5,4,17,2,6,1,11,1
1217176,17,21,1996,2,"female",1063,3891,623,2122,2061,2054,708,68,1353
1217177,27,30,1986,11,"male",523,241,194,0,1,0,1,0,0
1217198,22,12,1991,6,"male",155,87,11,34,0,34,0,0,0
1217222,38,12,1975,12,"male",473,38,26,9,15,0,1,9,14
1217294,25,14,1988,9,"female",279,23,21,1,2,1,2,0,0
1217304,16,5,1997,6,"male",257,563,505,158,26,158,13,0,13
1217330,14,5,1999,10,"male",230,177,137,9,0,9,0,0,0
1217338,14,14,1999,2,"female",420,700,370,1937,626,1793,425,144,201
1217344,22,26,1991,8,"female",826,713,166,55,71,55,54,0,17
1217384,32,4,1981,10,"female",195,112,99,1114,283,1112,194,2,89
1217385,19,6,1994,11,"male",147,97,72,22,12,15,9,7,3
1217390,18,21,1995,1,"male",456,1058,893,27,13,27,4,0,9
1217430,15,25,1998,6,"female",456,212,78,16,37,16,24,0,13
1217433,54,1,1959,7,"female",496,39,23,12,11,0,4,12,7
1217455,47,5,1966,12,"female",509,343,252,2,9,0,4,2,5
1217470,18,1,1995,2,"male",428,350,186,28,3,28,2,0,1
1217489,16,12,1997,6,"female",551,160,106,300,61,283,42,17,19
1217494,19,1,1994,1,"male",215,48,41,3,1,0,1,3,0
1217495,18,29,1995,11,"female",1370,618,251,479,251,462,97,17,154
1217548,34,29,1979,10,"male",197,114,55,0,0,0,0,0,0
1217567,40,5,1973,9,"male",467,82,58,302,90,294,60,8,30
1217589,17,15,1996,11,"male",281,1,1,0,0,0,0,0,0
1217603,17,16,1996,10,"male",54,33,31,1,0,0,0,1,0
1217644,16,5,1997,11,"female",404,6,6,9,0,9,0,0,0
1217713,103,5,1910,10,"female",1397,425,197,32,18,0,8,32,10
1217775,20,18,1993,11,"male",535,110,87,7,1,7,1,0,0
1217812,41,7,1972,9,"female",573,132,70,126,155,115,121,11,34
1217813,55,8,1958,3,"male",1231,187,127,6453,4167,6402,1982,51,2185
1217816,56,12,1957,5,"female",1712,467,31,119,1215,119,935,0,280
1217829,32,10,1981,8,"female",41,19,19,1,1,1,1,0,0
1217836,49,20,1964,5,"female",144,2,1,0,0,0,0,0,0
1217850,55,3,1958,12,"female",320,13,5,21,0,21,0,0,0
1217851,53,1,1960,2,"female",285,147,97,9,47,0,13,9,34
1217897,40,24,1973,11,"female",553,233,157,349,142,320,73,29,69
1217898,36,7,1977,10,"female",539,97,37,85,66,84,26,1,40
1217900,52,10,1961,3,"female",95,18,5,229,15,0,5,229,10
1217921,48,10,1965,10,"male",343,62,49,0,0,0,0,0,0
1217932,27,10,1986,4,"female",148,32,20,8,6,8,4,0,2
1217951,113,1,1900,1,NA,1579,76,28,108,148,108,86,0,62
1217995,21,17,1992,2,"male",438,41,24,39,53,39,40,0,13
1218002,14,3,1999,4,"female",251,696,534,0,37,0,37,0,0
1218031,41,4,1972,4,"male",2,0,0,0,0,0,0,0,0
1218035,42,5,1971,4,"male",130,5,4,105,38,105,11,0,27
1218038,24,20,1989,9,"male",406,278,168,57,51,57,41,0,10
1218052,37,20,1976,9,"male",136,21,10,145,16,3,1,142,15
1218066,41,28,1972,6,"female",558,199,112,422,541,328,389,94,152
1218071,75,24,1938,5,"female",430,9,7,84,23,84,6,0,17
1218077,18,18,1995,9,"female",728,76,66,2,0,2,0,0,0
1218094,100,5,1913,6,"male",655,768,276,262,390,219,179,43,211
1218112,54,9,1959,7,"female",290,29,19,22,6,22,6,0,0
1218120,65,25,1948,10,"female",427,223,44,74,56,73,39,1,17
1218188,22,22,1991,6,"female",569,372,63,81,169,1,35,80,134
1218203,20,16,1993,6,"male",604,111,87,27,13,27,8,0,5
1218279,16,25,1997,7,"male",454,327,286,2,9,2,7,0,2
1218282,25,25,1988,5,"male",271,24,16,20,115,18,70,2,45
1218353,65,7,1948,10,"male",1743,134,40,45,76,37,42,8,34
1218364,53,29,1960,12,"male",363,573,449,103,446,101,278,2,168
1218382,58,10,1955,5,"male",417,55,47,1,15,1,11,0,4
1218421,29,26,1984,10,"male",488,41,32,4,0,1,0,3,0
1218428,15,7,1998,11,"male",427,259,141,45,80,40,62,5,18
1218441,43,11,1970,10,"male",661,117,32,0,0,0,0,0,0
1218444,26,27,1987,4,"female",219,115,42,55,179,44,88,11,91
1218453,25,1,1988,10,"female",497,175,91,10,1,8,0,2,1
1218454,13,19,2000,7,"male",4,1,0,0,0,0,0,0,0
1218455,18,23,1995,4,"male",486,2191,1509,3150,2344,59,1595,3091,749
1218487,47,1,1966,3,"female",1157,60,34,133,31,130,24,3,7
1218492,34,15,1979,2,"male",809,2,2,0,0,0,0,0,0
1218493,46,26,1967,3,"female",583,49,32,15,18,2,6,13,12
1218494,108,1,1905,1,"male",1246,282,111,113,89,16,63,97,26
1218539,33,1,1980,1,"male",706,21,9,0,0,0,0,0,0
1218562,108,2,1905,2,"male",91,53,51,40,19,36,18,4,1
1218582,35,15,1978,4,"female",697,13,11,2,23,0,11,2,12
1218583,56,21,1957,11,"female",684,200,130,27,15,0,6,27,9
1218589,35,13,1978,4,"male",460,71,58,31,28,31,27,0,1
1218606,23,20,1990,11,"female",825,136,82,3,15,3,14,0,1
1218616,67,28,1946,10,"female",628,33,22,6,0,6,0,0,0
1218630,32,19,1981,9,"male",240,34,18,2,14,2,9,0,5
1218644,14,27,1999,7,"female",22,118,100,3,8,3,4,0,4
1218661,26,30,1987,7,"male",230,168,75,43,221,32,161,11,60
1218688,105,19,1908,8,"male",229,429,237,147,138,142,79,5,59
1218744,100,11,1913,8,"male",1311,154,96,31,1,31,1,0,0
1218754,25,21,1988,4,"male",637,145,131,0,0,0,0,0,0
1218757,28,27,1985,7,"male",628,78,45,11,8,11,7,0,1
1218769,69,20,1944,9,"male",908,3,0,21,3,0,0,21,3
1218779,108,6,1905,7,"female",911,1071,648,219,299,124,124,95,175
1218788,20,14,1993,9,"male",257,117,72,4,7,4,7,0,0
1218802,67,18,1946,5,"female",1666,213,79,52,6,10,3,42,3
1218803,28,15,1985,11,"male",427,35,19,1,1,1,0,0,1
1218807,20,15,1993,6,"male",16,29,27,20,10,20,10,0,0
1218821,108,12,1905,11,"male",915,105,91,4,12,0,11,4,1
1218829,17,20,1996,4,"female",432,1223,81,3,60,3,50,0,10
1218845,48,12,1965,11,"female",1648,174,133,7,10,7,10,0,0
1218878,25,29,1988,4,"male",813,241,197,26,3,26,3,0,0
1218915,65,5,1948,12,"female",2228,59,20,15,31,10,17,5,14
1218962,83,29,1930,6,"male",513,446,341,60,39,60,26,0,13
1218996,15,2,1998,6,"female",152,303,46,6,14,6,13,0,1
1219000,47,3,1966,7,"female",1582,49,18,20,24,5,17,15,7
1219005,67,28,1946,7,"female",743,103,41,111,351,2,145,109,206
1219017,54,9,1959,9,"female",406,37,11,26,17,19,3,7,14
1219060,23,1,1990,1,"male",527,153,80,24,14,24,11,0,3
1219068,37,16,1976,6,"female",433,30,10,0,0,0,0,0,0
1219094,55,24,1958,3,"male",815,16,6,0,0,0,0,0,0
1219099,69,17,1944,8,"female",395,26,15,3,2,0,0,3,2
1219129,60,10,1953,8,"male",55,162,63,1,14,0,11,1,3
1219178,24,6,1989,1,"male",242,28,7,0,0,0,0,0,0
1219184,70,30,1943,11,"female",1460,44,14,65,32,64,19,1,13
1219201,20,10,1993,8,"male",530,286,135,10,41,9,20,1,21
1219212,15,31,1998,8,"female",192,11,10,30,1,29,0,1,1
1219254,25,28,1988,3,"male",265,135,42,14,1,5,1,9,0
1219349,19,21,1994,6,"female",564,160,36,161,26,161,22,0,4
1219381,48,6,1965,5,"female",541,25,14,332,10,175,10,157,0
1219390,17,2,1996,5,"male",451,425,351,57,36,0,23,57,13
1219421,28,23,1985,9,"male",289,81,38,16,14,0,10,16,4
1219473,16,16,1997,5,"male",159,146,131,455,358,455,238,0,120
1219474,68,19,1945,3,"female",491,58,33,118,36,118,11,0,25
1219475,18,19,1995,7,"male",370,10,5,0,0,0,0,0,0
1219476,25,4,1988,1,"male",266,23,16,63,35,10,9,53,26
1219477,17,16,1996,7,"male",545,0,0,0,0,0,0,0,0
1219487,19,3,1994,7,"male",128,272,248,20,15,20,13,0,2
1219500,31,29,1982,7,"female",463,357,302,184,124,155,83,29,41
1219508,18,28,1995,9,"female",197,312,54,256,96,251,55,5,41
1219527,45,23,1968,4,"female",335,1,1,2,2,2,2,0,0
1219537,31,1,1982,7,"female",194,60,34,5,6,5,6,0,0
1219565,64,9,1949,2,"female",1647,171,94,2,2,1,0,1,2
1219571,25,20,1988,4,"female",35,144,1,3,8,3,8,0,0
1219618,20,19,1993,8,"male",669,374,342,0,0,0,0,0,0
1219628,55,12,1958,8,"male",372,29,6,0,131,0,50,0,81
1219631,16,10,1997,10,"female",73,498,432,119,637,119,213,0,424
1219672,75,13,1938,8,"male",481,170,130,379,137,329,97,50,40
1219680,15,29,1998,10,"male",217,714,579,16,1,16,1,0,0
1219769,66,1,1947,8,"male",1916,26,7,25,14,0,9,25,5
1219782,38,6,1975,4,"male",437,18,9,0,4,0,4,0,0
1219792,17,8,1996,8,"female",175,81,64,107,99,106,88,1,11
1219794,32,24,1981,7,"male",38,104,51,53,56,53,47,0,9
1219802,29,25,1984,2,"male",417,223,124,130,18,130,13,0,5
1219809,28,19,1985,12,"female",172,205,71,141,27,141,19,0,8
1219812,32,13,1981,12,"female",224,26,7,1,1,1,1,0,0
1219815,20,24,1993,8,"male",31,114,105,20,11,20,5,0,6
1219818,54,29,1959,7,"female",135,39,28,0,0,0,0,0,0
1219836,90,20,1923,12,"female",1457,56,36,2,0,1,0,1,0
1219839,18,1,1995,1,"male",274,98,75,0,0,0,0,0,0
1219860,17,20,1996,12,"female",110,125,73,7,0,7,0,0,0
1219897,19,19,1994,1,"male",16,32,32,12,0,12,0,0,0
1219898,108,28,1905,9,"male",1579,96,48,75,64,74,44,1,20
1219922,26,1,1987,11,"male",884,300,206,442,84,441,76,1,8
1219926,31,1,1982,1,"male",301,105,15,1,5,1,0,0,5
1219943,19,8,1994,3,"male",115,31,22,1,0,1,0,0,0
1219951,54,24,1959,12,"male",905,101,52,38,27,0,15,38,12
1219965,31,28,1982,7,"male",641,7,7,6,3,0,0,6,3
1220006,38,1,1975,1,"female",326,71,47,26,9,26,6,0,3
1220034,65,25,1948,4,"female",1268,51,37,146,0,146,0,0,0
1220035,18,14,1995,7,"female",17,69,25,10,23,10,13,0,10
1220036,17,7,1996,8,"male",1343,504,370,0,3,0,0,0,3
1220038,35,2,1978,8,"female",165,220,105,70,142,12,27,58,115
1220070,25,24,1988,8,"male",266,132,72,6,16,6,11,0,5
1220072,35,16,1978,4,"female",1864,666,487,110,306,108,79,2,227
1220080,30,21,1983,12,"female",585,149,118,1285,1084,1285,837,0,247
1220083,103,22,1910,1,"male",646,1508,685,2,48,2,24,0,24
1220113,23,25,1990,1,"female",486,1987,748,607,515,607,361,0,154
1220120,51,5,1962,4,"female",621,56,40,0,0,0,0,0,0
1220130,62,10,1951,5,"female",711,76,30,24,0,24,0,0,0
1220131,50,4,1963,2,"female",499,2,0,0,0,0,0,0,0
1220138,46,12,1967,12,"male",99,17,7,0,0,0,0,0,0
1220157,22,18,1991,3,"male",235,49,46,2,0,2,0,0,0
1220163,32,24,1981,5,"female",735,143,80,107,354,67,266,40,88
1220180,25,15,1988,9,"male",500,30,17,0,4,0,4,0,0
1220195,25,1,1988,1,"male",27,126,104,6,14,6,5,0,9
1220254,23,9,1990,1,"female",535,0,0,0,0,0,0,0,0
1220262,67,31,1946,7,"female",1411,147,39,568,116,0,55,568,61
1220272,17,10,1996,5,"male",20,0,0,1,0,1,0,0,0
1220276,18,8,1995,8,"female",643,970,682,179,422,109,255,70,167
1220318,20,18,1993,7,"female",609,839,537,359,1077,142,632,217,445
1220323,20,6,1993,4,"male",704,440,352,40,10,2,0,38,10
1220330,68,14,1945,7,"female",397,50,34,99,68,96,44,3,24
1220331,52,4,1961,8,"female",776,224,176,133,45,117,22,16,23
1220344,25,21,1988,8,"male",336,33,14,11,6,11,6,0,0
1220396,62,27,1951,5,"female",43,23,23,11,2,11,2,0,0
1220424,43,14,1970,2,"male",67,15,11,1,0,1,0,0,0
1220444,31,4,1982,6,"male",758,78,34,4,1,4,1,0,0
1220450,70,21,1943,10,"female",1299,59,31,45,19,0,10,45,9
1220451,19,21,1994,12,"male",360,99,59,28,37,0,16,28,21
1220488,22,21,1991,4,"female",300,95,44,72,0,68,0,4,0
1220490,46,13,1967,6,"female",1844,98,45,527,974,176,698,351,276
1220496,29,28,1984,11,"male",51,18,17,43,14,43,9,0,5
1220502,38,30,1975,3,"female",462,1,0,2,3,0,1,2,2
1220509,68,4,1945,8,"male",2188,41,8,2,5,0,1,2,4
1220524,43,26,1970,11,"male",284,3,2,1,1,1,1,0,0
1220547,25,11,1988,10,"female",673,189,95,187,94,150,89,37,5
1220557,108,31,1905,12,"male",819,98,68,1,12,1,12,0,0
1220613,25,20,1988,3,"male",278,17,11,24,17,24,17,0,0
1220628,36,24,1977,12,"female",548,67,46,22,56,5,36,17,20
1220647,53,2,1960,4,"male",635,400,319,5211,52,282,2,4929,50
1220655,23,2,1990,8,"male",244,661,617,176,82,176,67,0,15
1220672,60,19,1953,2,"male",257,36,28,6,1,6,0,0,1
1220674,61,24,1952,6,"female",861,63,13,0,0,0,0,0,0
1220723,52,9,1961,8,"female",311,33,17,89,54,89,18,0,36
1220727,19,26,1994,9,"male",275,316,221,2,8,2,7,0,1
1220739,68,5,1945,12,"male",1644,31,11,8,36,5,32,3,4
1220763,26,19,1987,8,"male",82,166,163,3,0,0,0,3,0
1220777,37,9,1976,5,"male",544,8,7,16,18,16,16,0,2
1220782,28,22,1985,3,"male",224,72,56,385,267,385,184,0,83
1220784,20,4,1993,2,"female",682,248,142,8,5,8,5,0,0
1220790,32,14,1981,6,"male",1284,171,88,97,161,43,73,54,88
1220862,37,21,1976,1,"male",1206,20,6,9,0,9,0,0,0
1220890,45,14,1968,3,"female",489,1,1,0,0,0,0,0,0
1220891,26,29,1987,12,"female",469,189,126,75,57,63,33,12,24
1220897,21,7,1992,7,"male",290,189,87,14,1,13,1,1,0
1220910,43,25,1970,9,"male",878,171,91,2,4,2,1,0,3
1220916,23,15,1990,6,"male",569,50,40,0,0,0,0,0,0
1220945,103,30,1910,12,"male",1066,1145,953,17,14,17,12,0,2
1220972,19,5,1994,8,"female",940,295,209,736,864,386,341,350,523
1220976,27,13,1986,12,"male",81,126,103,10,1,10,1,0,0
1220983,91,12,1922,9,"male",416,24,7,6,5,6,4,0,1
1220986,20,19,1993,5,"male",413,73,22,0,1,0,1,0,0
1221003,57,9,1956,5,"female",1272,30,11,11,25,1,10,10,15
1221011,57,25,1956,1,"male",482,55,16,2,5,2,5,0,0
1221026,14,5,1999,2,"female",111,17,1,0,0,0,0,0,0
1221056,24,19,1989,2,"female",486,17,13,7,2,7,2,0,0
1221107,24,31,1989,12,"male",556,82,62,2,1,2,1,0,0
1221115,18,20,1995,5,"male",268,94,23,1,11,1,2,0,9
1221123,13,2,2000,3,"male",239,329,230,56,39,39,7,17,32
1221143,23,5,1990,5,"female",588,62,43,465,520,423,436,42,84
1221152,103,12,1910,12,"female",1459,327,124,0,0,0,0,0,0
1221158,15,14,1998,4,"female",27,23,14,239,202,239,139,0,63
1221161,36,6,1977,1,"female",1642,126,70,486,206,429,164,57,42
1221188,23,20,1990,1,"male",461,24,11,0,6,0,3,0,3
1221194,24,13,1989,12,"male",892,704,556,302,555,238,512,64,43
1221204,18,13,1995,8,"female",540,3718,1407,17,66,17,59,0,7
1221219,19,26,1994,8,"female",470,1676,656,2247,2506,711,1101,1536,1405
1221242,22,6,1991,6,"male",90,144,124,12,30,4,17,8,13
1221251,16,20,1997,12,"male",317,23,11,2,0,0,0,2,0
1221253,15,14,1998,4,"female",40,470,414,1969,867,1955,736,14,131
1221274,41,19,1972,8,"male",665,3,1,0,0,0,0,0,0
1221275,51,28,1962,9,"female",27,35,28,12,15,0,7,12,8
1221276,21,2,1992,5,"female",463,69,31,8,4,0,2,8,2
1221283,28,2,1985,8,"male",39,68,56,2,7,2,6,0,1
1221290,29,3,1984,4,"male",1313,61,32,0,0,0,0,0,0
1221331,100,2,1913,7,"female",1687,997,354,104,163,104,78,0,85
1221348,34,9,1979,10,"male",695,12,11,0,1,0,0,0,1
1221402,19,23,1994,5,"male",776,597,478,4,1,4,1,0,0
1221406,20,13,1993,8,"male",606,42,27,14,2,0,0,14,2
1221425,101,15,1912,2,"female",2367,582,262,213,100,41,48,172,52
1221445,62,10,1951,4,"female",1136,65,32,34,121,4,10,30,111
1221451,76,1,1937,11,"female",1947,77,50,79,7,0,3,79,4
1221463,22,6,1991,5,"female",418,414,279,356,85,346,51,10,34
1221473,19,2,1994,1,"male",121,40,13,5,3,5,0,0,3
1221526,16,2,1997,4,"male",350,44,35,8,2,8,0,0,2
1221558,14,4,1999,9,"male",235,603,478,34,15,7,6,27,9
1221559,22,1,1991,3,"male",950,82,46,16,0,16,0,0,0
1221591,19,29,1994,4,"male",31,26,25,1,1,1,0,0,1
1221595,23,3,1990,4,"male",291,316,232,3,25,3,22,0,3
1221599,15,8,1998,6,"male",521,742,603,19,6,1,4,18,2
1221604,18,8,1995,8,"female",305,489,296,145,331,136,234,9,97
1221638,33,1,1980,9,"male",611,669,208,29,421,28,116,1,305
1221686,14,10,1999,5,"female",1028,350,133,1131,881,1011,388,120,493
1221694,25,1,1988,1,"male",100,116,78,4,8,3,3,1,5
1221712,51,4,1962,7,"female",297,4,2,0,0,0,0,0,0
1221713,39,28,1974,5,"male",938,77,43,15,258,5,180,10,78
1221718,17,3,1996,5,"female",50,107,93,133,0,133,0,0,0
1221738,28,16,1985,4,"male",466,148,119,58,5,2,0,56,5
1221771,43,13,1970,9,"male",584,361,171,128,128,24,28,104,100
1221786,18,7,1995,8,"female",328,417,265,1246,273,1246,183,0,90
1221823,26,2,1987,10,"male",15,0,0,0,0,0,0,0,0
1221843,14,8,1999,6,"female",246,162,116,332,313,69,146,263,167
1221859,22,13,1991,9,"male",451,77,33,18,18,7,14,11,4
1221878,28,21,1985,3,"male",479,59,50,0,0,0,0,0,0
1221890,19,20,1994,11,"female",105,11,7,0,0,0,0,0,0
1221898,19,13,1994,8,"female",165,128,98,52,94,52,55,0,39
1221927,108,22,1905,10,"male",1594,107,22,0,0,0,0,0,0
1221949,19,13,1994,5,"female",418,245,88,101,265,99,188,2,77
1221961,29,7,1984,9,"female",315,195,54,22,23,22,23,0,0
1221962,50,10,1963,2,"male",26,7,7,55,29,55,28,0,1
1221969,18,23,1995,9,"female",244,332,268,1109,349,610,202,499,147
1221970,95,3,1918,9,"male",10,4,3,4,1,4,1,0,0
1221977,57,29,1956,6,"male",983,77,51,1,4,0,1,1,3
1221983,19,14,1994,7,"male",437,164,19,0,0,0,0,0,0
1221985,18,22,1995,7,"male",675,61,37,47,18,47,5,0,13
1221997,21,20,1992,3,"male",240,1099,1024,40,2,25,2,15,0
1222029,20,31,1993,5,"female",944,1514,662,2184,2482,2162,2125,22,357
1222039,47,16,1966,3,"female",594,16,7,0,1,0,0,0,1
1222051,23,8,1990,10,"female",360,266,194,354,176,265,118,89,58
1222057,14,7,1999,8,"female",157,223,141,154,246,154,74,0,172
1222069,17,19,1996,8,"male",399,216,131,54,70,1,29,53,41
1222072,38,17,1975,8,"male",334,74,42,1,0,1,0,0,0
1222075,39,30,1974,11,"female",250,297,250,893,342,883,192,10,150
1222080,42,20,1971,5,"female",177,76,70,18,3,18,2,0,1
1222094,14,21,1999,11,"female",161,102,55,344,126,221,79,123,47
1222124,15,30,1998,10,"male",173,113,49,0,3,0,2,0,1
1222143,19,7,1994,7,"male",193,76,18,2,2,0,0,2,2
1222160,14,28,1999,2,"male",250,7,4,0,4,0,4,0,0
1222197,24,2,1989,2,"male",492,131,101,6,7,6,3,0,4
1222225,52,2,1961,12,"female",440,19,15,5,2,5,0,0,2
1222227,16,18,1997,6,"male",619,566,504,0,0,0,0,0,0
1222242,29,11,1984,9,"male",630,13,12,0,0,0,0,0,0
1222254,36,28,1977,8,"male",55,1,1,5,0,0,0,5,0
1222273,19,4,1994,4,"female",403,3949,1383,403,1501,375,630,28,871
1222287,15,18,1998,6,"female",776,2228,369,391,747,222,418,169,329
1222294,29,4,1984,2,"male",55,15,13,4,3,4,3,0,0
1222296,66,30,1947,1,"female",41,12,10,7,3,7,3,0,0
1222310,22,9,1991,8,"male",375,183,148,0,0,0,0,0,0
1222311,24,15,1989,9,"male",40,2,1,0,0,0,0,0,0
1222324,25,22,1988,5,"female",613,372,184,362,341,360,259,2,82
1222359,26,28,1987,6,"female",66,18,10,4,24,4,4,0,20
1222391,63,23,1950,8,"male",110,57,40,0,6,0,5,0,1
1222398,17,11,1996,4,"female",629,2788,464,61,166,61,143,0,23
1222435,13,26,2000,3,"female",139,74,58,0,0,0,0,0,0
1222437,57,6,1956,1,"male",444,36,19,2,0,2,0,0,0
1222439,24,9,1989,3,"female",315,266,37,81,15,81,13,0,2
1222442,32,26,1981,7,"female",416,44,14,3,15,3,14,0,1
1222459,74,4,1939,3,"female",574,13,7,14,2,0,0,14,2
1222467,53,19,1960,3,"male",460,10,5,4,0,4,0,0,0
1222468,63,7,1950,7,"female",776,38,23,64,42,64,26,0,16
1222486,91,29,1922,3,"female",2443,434,241,154,123,137,96,17,27
1222524,15,10,1998,3,"male",338,227,171,11,5,11,4,0,1
1222579,21,5,1992,2,"male",700,99,82,28,1,28,1,0,0
1222611,21,13,1992,4,"female",157,6,6,9,3,8,3,1,0
1222625,52,25,1961,5,"female",185,21,17,26,13,25,5,1,8
1222634,25,3,1988,9,"male",84,11,10,5,2,5,2,0,0
1222647,15,30,1998,4,"female",32,3,3,3,6,3,0,0,6
1222696,25,13,1988,2,"male",450,314,163,9,60,9,32,0,28
1222706,18,1,1995,7,"male",434,399,225,0,63,0,56,0,7
1222738,20,1,1993,6,"male",358,224,146,4,257,4,238,0,19
1222739,35,19,1978,5,"male",494,134,99,1,0,1,0,0,0
1222748,72,10,1941,6,"male",372,38,26,0,0,0,0,0,0
1222761,52,6,1961,2,"female",165,27,14,220,75,220,32,0,43
1222773,47,14,1966,5,"male",196,12,4,0,0,0,0,0,0
1222778,48,9,1965,4,"female",822,173,89,549,94,399,49,150,45
1222803,20,21,1993,10,"female",509,172,83,88,8,81,3,7,5
1222820,33,4,1980,9,"female",16,225,203,62,65,62,49,0,16
1222886,73,11,1940,2,"female",1236,103,55,5,0,0,0,5,0
1222889,64,14,1949,2,"female",662,37,25,8,4,6,4,2,0
1222946,23,15,1990,12,"male",143,8,7,0,0,0,0,0,0
1222949,16,6,1997,3,"male",226,294,143,138,27,0,13,138,14
1222958,61,3,1952,9,"female",961,326,217,64,122,19,14,45,108
1223012,56,28,1957,9,"female",1011,290,184,43,82,42,20,1,62
1223015,17,8,1996,2,"female",518,462,279,1607,1461,327,893,1280,568
1223025,53,1,1960,9,"female",131,39,16,8,2,8,1,0,1
1223033,47,27,1966,1,"male",557,29,23,1,10,1,5,0,5
1223046,24,22,1989,7,"male",478,34,17,0,5,0,3,0,2
1223065,55,12,1958,7,"male",970,29,19,0,0,0,0,0,0
1223090,91,28,1922,4,"male",662,454,165,304,457,139,123,165,334
1223127,23,2,1990,7,"male",548,36,22,2,1,0,0,2,1
1223140,38,8,1975,8,"male",672,106,34,25,7,16,6,9,1
1223166,43,5,1970,9,"male",807,11,3,0,0,0,0,0,0
1223179,100,27,1913,11,"male",663,144,86,596,114,583,69,13,45
1223191,50,16,1963,5,"male",420,14,4,0,0,0,0,0,0
1223255,67,13,1946,8,"female",950,131,62,3394,477,3394,441,0,36
1223296,25,5,1988,3,"female",413,98,66,16,19,16,19,0,0
1223303,17,27,1996,11,"female",198,266,110,731,424,731,179,0,245
1223305,28,5,1985,1,"male",187,127,118,1,0,1,0,0,0
1223323,47,14,1966,5,"male",799,373,309,13,11,13,9,0,2
1223327,21,20,1992,8,"male",26,1,1,3,1,3,1,0,0
1223353,37,12,1976,9,"male",671,61,37,6,0,6,0,0,0
1223376,23,12,1990,11,"female",418,27,8,197,282,190,114,7,168
1223379,18,15,1995,12,"male",150,129,46,820,41,820,31,0,10
1223391,19,22,1994,12,"male",570,287,190,112,108,41,49,71,59
1223392,49,22,1964,5,"female",505,715,571,8,5,8,4,0,1
1223393,21,15,1992,7,"male",4,0,0,0,0,0,0,0,0
1223401,20,11,1993,6,"male",92,74,63,3,13,3,7,0,6
1223411,28,1,1985,1,"male",737,84,50,2,19,0,2,2,17
1223441,37,29,1976,11,"female",504,21,15,49,16,49,12,0,4
1223447,55,8,1958,1,"female",163,44,33,39,13,39,7,0,6
1223480,56,11,1957,10,"female",214,19,17,4,1,4,0,0,1
1223481,20,1,1993,1,"male",14,19,10,1,1,1,1,0,0
1223499,20,18,1993,3,"male",260,5,5,0,0,0,0,0,0
1223518,31,6,1982,2,"male",193,80,50,33,85,33,49,0,36
1223527,23,27,1990,8,"male",421,33,26,0,1,0,1,0,0
1223549,37,10,1976,6,"male",157,126,120,9,24,0,17,9,7
1223554,64,13,1949,5,"male",1245,35,16,0,3,0,0,0,3
1223556,25,1,1988,1,"male",506,349,327,0,0,0,0,0,0
1223563,26,1,1987,1,"male",212,83,60,10,2,10,2,0,0
1223605,30,3,1983,12,"female",243,845,172,264,294,264,254,0,40
1223643,75,14,1938,7,"male",319,77,58,131,19,0,16,131,3
1223652,81,21,1932,10,"female",521,24,10,8,17,0,5,8,12
1223681,22,1,1991,1,"male",294,1,0,0,0,0,0,0,0
1223714,43,11,1970,4,"male",607,382,279,8,2,5,0,3,2
1223717,37,1,1976,1,"male",226,4,1,0,5,0,5,0,0
1223719,17,1,1996,1,"male",569,586,448,11,7,7,5,4,2
1223731,22,16,1991,11,"male",693,447,396,24,27,15,10,9,17
1223739,18,18,1995,1,"female",695,4535,1916,492,983,322,511,170,472
1223757,68,17,1945,8,"female",200,538,58,621,653,621,386,0,267
1223761,28,28,1985,9,"male",303,96,42,5,29,5,19,0,10
1223777,27,11,1986,12,"male",746,63,42,1,1,1,1,0,0
1223809,23,12,1990,4,"female",440,352,147,475,53,274,21,201,32
1223825,63,20,1950,3,"male",458,128,61,40,32,28,11,12,21
1223882,19,10,1994,1,"male",57,11,11,4,12,4,11,0,1
1223939,100,5,1913,9,"female",1559,969,423,196,361,187,337,9,24
1223967,40,8,1973,5,"male",565,164,121,13,5,2,3,11,2
1223968,18,20,1995,9,"male",109,36,27,108,34,108,21,0,13
1223972,44,17,1969,12,"male",492,28,16,0,0,0,0,0,0
1223981,30,25,1983,11,"male",1579,102,31,1115,258,451,150,664,108
1224015,18,28,1995,9,"male",18,15,12,28,8,28,6,0,2
1224051,51,12,1962,10,"male",1091,57,41,6,8,0,3,6,5
1224062,42,30,1971,3,"male",95,40,19,49,88,49,69,0,19
1224091,19,28,1994,6,"male",492,166,80,28,1,1,1,27,0
1224119,17,12,1996,11,"male",176,108,106,4,0,4,0,0,0
1224130,18,15,1995,9,"male",313,7,4,12,1,0,0,12,1
1224141,60,24,1953,4,"male",600,107,84,1568,62,0,4,1568,58
1224151,31,23,1982,5,"female",1354,1576,325,5,1313,1,837,4,476
1224155,17,26,1996,7,"female",54,1,0,0,0,0,0,0,0
1224156,43,12,1970,12,"male",560,53,46,15,4,15,2,0,2
1224157,18,28,1995,6,"male",325,147,76,143,108,122,45,21,63
1224159,50,4,1963,4,"male",491,10,9,0,0,0,0,0,0
1224166,46,21,1967,5,"male",204,23,5,2,2,2,2,0,0
1224180,22,5,1991,2,"male",359,58,29,117,169,87,62,30,107
1224195,17,18,1996,10,"female",911,1999,1135,599,393,72,230,527,163
1224201,33,8,1980,5,"male",256,16,16,50,21,50,16,0,5
1224221,17,13,1996,9,"female",276,5,3,20,19,0,2,20,17
1224251,26,3,1987,1,"male",260,44,22,16,2,16,1,0,1
1224258,62,24,1951,7,"male",415,17,15,5,3,5,2,0,1
1224301,19,30,1994,11,"female",347,1333,132,31,397,31,313,0,84
1224320,58,1,1955,1,"female",318,42,34,1,0,1,0,0,0
1224327,18,19,1995,2,"male",433,552,468,3,11,3,5,0,6
1224336,22,29,1991,7,"female",15,24,8,0,2,0,1,0,1
1224342,42,21,1971,7,"male",293,313,211,2694,872,2694,785,0,87
1224343,76,31,1937,3,"male",354,159,68,5,1,5,1,0,0
1224356,24,1,1989,1,"male",250,142,15,1,3,1,1,0,2
1224363,22,1,1991,3,"male",612,78,55,1,1,0,0,1,1
1224377,25,19,1988,2,"female",510,141,74,10,29,10,16,0,13
1224404,16,1,1997,1,"male",335,72,59,0,0,0,0,0,0
1224411,71,28,1942,7,"female",29,7,6,0,0,0,0,0,0
1224417,18,18,1995,4,"male",229,162,132,119,2,119,2,0,0
1224427,50,25,1963,4,"female",2200,100,29,16,35,16,26,0,9
1224428,25,6,1988,2,"male",652,44,29,19,0,15,0,4,0
1224436,93,5,1920,1,"female",1758,127,32,38,17,15,10,23,7
1224456,108,10,1905,8,"male",578,204,153,31,9,0,7,31,2
1224488,50,22,1963,12,"male",961,90,32,0,0,0,0,0,0
1224516,45,5,1968,2,"female",718,70,54,6,1,0,1,6,0
1224553,25,1,1988,1,"male",304,103,62,2,9,2,4,0,5
1224580,64,13,1949,8,"male",1902,67,30,4,2,3,0,1,2
1224585,29,20,1984,10,"male",205,235,2,6,4,6,3,0,1
1224594,34,22,1979,11,"female",85,214,176,1101,1113,520,313,581,800
1224603,34,14,1979,1,"female",655,31,18,25,4,25,4,0,0
1224686,14,27,1999,4,"female",17,41,35,109,144,109,96,0,48
1224694,19,30,1994,4,"male",310,101,75,722,85,722,75,0,10
1224714,61,18,1952,11,"male",222,77,50,2,0,2,0,0,0
1224734,66,3,1947,4,"female",1838,60,35,963,90,963,61,0,29
1224745,52,15,1961,12,"male",884,143,53,180,202,114,134,66,68
1224768,42,2,1971,11,"female",84,2,1,0,0,0,0,0,0
1224787,16,9,1997,4,"female",173,161,50,18,4,18,4,0,0
1224789,15,25,1998,2,"female",726,1660,300,18,13,18,10,0,3
1224800,15,24,1998,5,"female",411,18,9,9,13,5,8,4,5
1224802,26,8,1987,7,"male",1661,591,510,2,1,2,1,0,0
1224809,18,13,1995,5,"male",246,94,32,0,1,0,1,0,0
1224845,23,24,1990,12,"female",4,9,7,54,12,0,4,54,8
1224865,103,19,1910,4,"male",1447,197,114,276,215,83,81,193,134
1224866,63,30,1950,10,"female",1319,109,50,574,299,13,81,561,218
1224880,30,5,1983,2,"female",630,17,12,0,3,0,1,0,2
1224884,112,1,1901,1,"male",1455,33,21,27,18,0,8,27,10
1224890,65,18,1948,9,"female",597,20,16,2,0,0,0,2,0
1224917,66,27,1947,5,"female",1412,7,4,0,1,0,1,0,0
1224941,18,28,1995,4,"female",191,11,9,1,3,1,3,0,0
1224960,19,13,1994,3,"female",199,302,83,19,38,17,13,2,25
1224967,51,18,1962,12,"male",384,1,0,0,0,0,0,0,0
1224989,25,1,1988,1,"male",240,1,0,0,0,0,0,0,0
1225008,31,29,1982,12,"male",661,130,105,0,0,0,0,0,0
1225014,16,4,1997,4,"male",508,254,164,5,2,5,2,0,0
1225016,27,13,1986,3,"male",157,3,0,0,0,0,0,0,0
1225020,19,23,1994,4,"male",137,95,71,0,3,0,3,0,0
1225031,15,3,1998,3,"male",364,212,157,0,0,0,0,0,0
1225046,14,9,1999,2,"male",626,167,54,7,1,7,1,0,0
1225065,18,20,1995,9,"female",714,470,373,628,715,339,518,289,197
1225114,51,1,1962,1,"male",1499,105,19,1,1,1,1,0,0
1225116,47,26,1966,8,"female",457,171,75,163,76,163,56,0,20
1225137,23,8,1990,10,"male",586,91,70,55,93,55,33,0,60
1225157,14,9,1999,9,"male",339,115,111,0,0,0,0,0,0
1225182,18,1,1995,1,"female",35,20,13,3,3,3,3,0,0
1225197,40,15,1973,4,"male",52,213,99,107,17,106,9,1,8
1225198,103,1,1910,1,"male",1221,1129,656,35,27,35,25,0,2
1225222,26,1,1987,1,"male",453,260,196,22,23,0,6,22,17
1225237,18,14,1995,8,"female",163,219,104,67,100,22,50,45,50
1225240,27,5,1986,2,"female",383,296,34,212,368,122,297,90,71
1225243,35,22,1978,6,"female",376,342,130,25,149,0,33,25,116
1225276,25,3,1988,6,"male",637,39,30,0,0,0,0,0,0
1225278,22,19,1991,1,"male",166,89,53,6,12,6,9,0,3
1225306,61,11,1952,5,"female",2079,25,10,9,13,7,10,2,3
1225367,23,20,1990,5,"female",224,22,21,209,146,42,16,167,130
1225429,25,21,1988,9,"female",552,711,581,572,319,572,199,0,120
1225434,27,22,1986,1,"male",733,72,27,42,14,42,8,0,6
1225492,21,2,1992,2,"male",622,142,71,54,65,54,26,0,39
1225540,28,15,1985,1,"male",982,1,1,0,0,0,0,0,0
1225541,22,29,1991,11,"female",415,49,39,58,22,58,15,0,7
1225545,108,10,1905,11,"male",698,299,246,29,24,21,3,8,21
1225564,19,23,1994,6,"male",180,57,32,89,29,87,25,2,4
1225567,17,30,1996,4,"female",257,98,60,1,1,1,0,0,1
1225572,33,5,1980,8,"female",261,330,188,331,276,36,93,295,183
1225583,26,10,1987,10,"male",627,12,3,0,0,0,0,0,0
1225618,23,6,1990,11,"female",1853,519,324,1177,1542,88,589,1089,953
1225642,30,3,1983,8,"female",632,4,4,0,0,0,0,0,0
1225653,57,16,1956,8,"female",1819,101,30,44,45,43,28,1,17
1225678,17,16,1996,11,"male",1365,190,85,16,0,7,0,9,0
1225706,22,29,1991,7,"male",507,202,152,7,40,7,31,0,9
1225711,72,7,1941,9,NA,2092,26,0,0,0,0,0,0,0
1225748,27,2,1986,10,"male",256,59,44,191,141,177,108,14,33
1225759,25,12,1988,12,"male",747,69,31,0,0,0,0,0,0
1225761,18,16,1995,5,"female",351,181,57,22,52,14,29,8,23
1225763,20,10,1993,7,"female",295,124,83,114,7,112,5,2,2
1225768,38,27,1975,9,"male",648,3,3,0,0,0,0,0,0
1225773,25,1,1988,2,"male",352,137,99,25,7,25,4,0,3
1225778,18,12,1995,12,"female",733,154,99,0,2,0,2,0,0
1225781,30,28,1983,3,"male",698,104,80,6,33,6,18,0,15
1225825,26,13,1987,6,"male",171,13,11,0,0,0,0,0,0
1225832,35,4,1978,11,"female",284,44,34,35,1,0,0,35,1
1225861,22,12,1991,7,"male",115,68,45,100,4,100,0,0,4
1225866,47,15,1966,1,"male",310,46,15,7,28,7,10,0,18
1225868,20,27,1993,2,"male",150,411,267,330,829,330,639,0,190
1225876,16,19,1997,12,"male",56,19,18,0,0,0,0,0,0
1225877,34,26,1979,12,"male",978,292,147,1,1,0,0,1,1
1225880,24,4,1989,8,"male",237,381,288,19,59,19,14,0,45
1225881,52,2,1961,11,"female",625,36,26,6,12,6,10,0,2
1225898,35,30,1978,9,"female",1318,118,59,53,112,52,70,1,42
1225913,46,3,1967,2,"male",141,31,23,274,120,0,68,274,52
1225914,14,8,1999,7,"female",209,420,238,1,15,1,10,0,5
1225929,14,26,1999,3,"male",219,154,103,15,1,8,1,7,0
1225931,67,15,1946,10,"female",112,31,27,17,5,0,3,17,2
1225936,20,2,1993,5,"male",69,16,12,0,0,0,0,0,0
1225971,100,18,1913,11,"male",433,117,58,5,2,5,1,0,1
1226024,25,13,1988,7,"male",660,324,252,0,0,0,0,0,0
1226044,30,8,1983,8,"female",706,35,18,5,1,5,1,0,0
1226051,17,12,1996,6,"male",734,434,324,2,29,1,15,1,14
1226110,63,6,1950,10,"male",1166,7,0,4,1,2,0,2,1
1226134,79,29,1934,5,"female",367,17,6,62,0,62,0,0,0
1226141,45,13,1968,11,"male",344,1,1,0,0,0,0,0,0
1226144,45,10,1968,8,"female",441,41,26,22,82,22,82,0,0
1226170,27,21,1986,4,"male",793,90,55,182,72,182,65,0,7
1226207,23,12,1990,12,"female",220,85,72,1,2,1,2,0,0
1226208,14,3,1999,2,"male",322,165,75,1,1,1,1,0,0
1226236,102,14,1911,11,"female",231,108,33,24,60,24,21,0,39
1226241,60,29,1953,9,"female",1013,181,149,808,600,2,76,806,524
1226273,60,3,1953,3,"female",444,14,11,11,2,11,1,0,1
1226279,19,26,1994,3,"male",127,62,46,24,10,19,9,5,1
1226285,32,16,1981,5,"female",409,805,485,161,309,145,119,16,190
1226290,28,11,1985,11,"female",601,225,54,2462,736,2462,636,0,100
1226294,17,9,1996,9,"male",258,13,9,0,0,0,0,0,0
1226308,59,7,1954,5,"female",277,11,8,0,1,0,1,0,0
1226345,16,28,1997,3,"male",677,361,272,59,36,59,17,0,19
1226351,16,9,1997,10,"female",147,74,58,1,12,1,12,0,0
1226412,54,18,1959,10,"male",458,43,11,1,4,1,2,0,2
1226420,33,2,1980,5,"female",542,1,1,0,0,0,0,0,0
1226422,22,9,1991,11,"male",542,63,32,0,15,0,1,0,14
1226425,31,16,1982,6,"male",100,7,6,47,1,47,0,0,1
1226443,62,27,1951,12,"female",170,14,5,1,0,0,0,1,0
1226454,16,5,1997,5,"female",15,47,33,24,16,24,11,0,5
1226462,20,19,1993,8,"male",1208,343,251,1,33,1,22,0,11
1226471,29,13,1984,8,"female",523,32,25,13,0,13,0,0,0
1226499,42,4,1971,12,"male",940,555,261,179,136,179,54,0,82
1226511,19,28,1994,12,"female",172,746,649,501,856,380,285,121,571
1226526,32,27,1981,10,"male",539,14,6,19,3,19,3,0,0
1226554,54,3,1959,3,"female",1344,151,67,195,153,194,94,1,59
1226565,35,14,1978,12,"male",212,0,0,0,0,0,0,0,0
1226589,64,7,1949,3,"female",305,12,6,49,7,49,7,0,0
1226599,53,24,1960,2,"female",436,43,42,101,60,101,59,0,1
1226603,30,5,1983,6,"male",405,191,54,12,3,4,2,8,1
1226607,28,31,1985,12,"male",325,11,6,0,0,0,0,0,0
1226619,53,1,1960,8,"female",602,189,127,159,229,0,70,159,159
1226625,23,27,1990,12,"female",885,2521,900,67,312,12,120,55,192
1226663,18,12,1995,2,"female",270,537,479,185,120,161,84,24,36
1226667,14,30,1999,12,"male",216,272,215,102,22,102,15,0,7
1226689,21,4,1992,4,"female",815,251,78,0,1,0,0,0,1
1226703,22,11,1991,5,"female",496,87,37,0,2,0,2,0,0
1226728,18,18,1995,12,"female",810,1062,655,678,110,678,86,0,24
1226729,47,29,1966,4,"female",669,22,14,98,5,98,4,0,1
1226742,23,19,1990,1,"female",316,464,114,2,24,2,20,0,4
1226743,23,26,1990,3,"male",916,365,264,53,6,53,5,0,1
1226768,27,30,1986,8,"male",283,70,50,39,21,28,17,11,4
1226776,55,4,1958,1,"female",595,210,145,355,204,0,100,355,104
1226790,17,4,1996,1,"female",274,513,229,5,9,5,6,0,3
1226830,45,1,1968,4,"female",397,36,24,5,10,5,4,0,6
1226834,18,10,1995,6,"male",30,177,135,15,3,15,2,0,1
1226847,23,7,1990,7,"female",309,84,62,356,60,356,56,0,4
1226867,63,21,1950,11,"female",752,762,461,92,116,92,44,0,72
1226877,25,11,1988,11,"male",754,171,155,10,14,10,3,0,11
1226878,49,7,1964,6,"male",334,229,189,452,531,0,117,452,414
1226925,28,28,1985,1,"male",34,86,86,0,20,0,7,0,13
1226929,30,19,1983,12,"female",967,472,248,226,437,153,243,73,194
1226930,18,10,1995,11,"female",321,378,316,95,133,95,84,0,49
1226932,25,1,1988,1,"male",111,79,72,37,5,37,3,0,2
1226956,22,17,1991,1,"male",225,91,58,407,29,407,23,0,6
1226971,13,2,2000,3,"male",92,49,34,26,8,20,4,6,4
1226975,16,29,1997,11,"female",665,1179,793,1727,1841,1407,1319,320,522
1226976,24,24,1989,8,"male",602,644,551,564,627,563,498,1,129
1226982,38,9,1975,1,"male",205,104,29,126,14,126,13,0,1
1226988,19,17,1994,2,"male",472,76,57,0,0,0,0,0,0
1226989,18,16,1995,4,"male",231,58,31,473,87,473,46,0,41
1227016,15,7,1998,2,"male",194,28,25,1,0,0,0,1,0
1227040,33,30,1980,4,"male",132,11,9,33,12,0,12,33,0
1227052,52,28,1961,7,"male",380,29,23,17,0,17,0,0,0
1227057,14,18,1999,8,"female",196,3280,836,461,1224,461,973,0,251
1227074,52,21,1961,12,"male",202,3,3,0,0,0,0,0,0
1227086,37,7,1976,5,"male",642,8,8,33,4,33,2,0,2
1227106,50,1,1963,3,"male",697,31,21,0,20,0,3,0,17
1227142,45,19,1968,9,"female",120,18,12,18,3,18,3,0,0
1227160,15,27,1998,6,"male",498,83,50,0,1,0,1,0,0
1227186,17,18,1996,1,"male",447,11,9,15,1,15,0,0,1
1227214,58,31,1955,1,"female",421,10,8,0,3,0,3,0,0
1227267,16,5,1997,9,"male",381,708,641,0,3,0,1,0,2
1227285,55,18,1958,7,"male",335,74,46,202,62,0,27,202,35
1227288,17,13,1996,3,"male",340,99,29,0,0,0,0,0,0
1227331,49,20,1964,4,"male",389,56,30,15,12,15,8,0,4
1227336,20,5,1993,3,"male",140,1,1,0,0,0,0,0,0
1227356,23,28,1990,4,"female",378,120,75,86,34,86,20,0,14
1227373,19,19,1994,8,"female",565,242,137,335,196,275,75,60,121
1227386,33,17,1980,8,"male",136,57,25,1,0,1,0,0,0
1227412,23,15,1990,3,"male",449,98,94,19,7,6,4,13,3
1227421,19,26,1994,6,"male",837,101,62,12,37,2,17,10,20
1227440,28,6,1985,2,"male",938,110,51,6,1,6,1,0,0
1227455,15,5,1998,1,"male",608,141,41,70,7,70,4,0,3
1227457,25,11,1988,2,"male",199,115,47,93,50,93,38,0,12
1227460,48,1,1965,11,"male",501,51,32,11,11,7,7,4,4
1227464,66,6,1947,3,"male",1563,82,28,0,0,0,0,0,0
1227475,26,13,1987,9,"male",412,1,0,5,0,5,0,0,0
1227487,18,5,1995,3,"female",569,489,235,567,227,567,199,0,28
1227505,20,25,1993,5,"male",758,676,522,7,15,7,11,0,4
1227509,40,22,1973,10,"male",542,269,129,18,47,18,39,0,8
1227541,32,14,1981,4,"male",458,89,61,3,3,3,3,0,0
1227543,33,22,1980,5,"male",138,7,5,3,0,3,0,0,0
1227559,16,12,1997,9,"female",335,431,149,70,3,69,2,1,1
1227573,90,24,1923,8,"female",1069,136,55,49,39,46,17,3,22
1227577,13,19,2000,1,"female",278,651,471,937,1131,857,625,80,506
1227602,41,29,1972,3,"male",7,4,4,1,0,1,0,0,0
1227643,15,1,1998,1,"male",132,67,53,0,0,0,0,0,0
1227669,15,18,1998,8,"female",340,308,145,18,21,11,13,7,8
1227677,20,5,1993,5,"male",50,41,31,96,17,96,4,0,13
1227686,34,24,1979,10,"male",696,96,76,27,53,21,25,6,28
1227706,25,5,1988,2,"female",361,12,6,0,1,0,1,0,0
1227707,23,20,1990,10,"female",117,202,50,16,23,16,17,0,6
1227724,20,27,1993,8,"male",532,182,19,0,0,0,0,0,0
1227732,43,29,1970,12,"female",169,104,67,307,85,307,51,0,34
1227734,18,27,1995,6,"male",367,182,158,2,0,2,0,0,0
1227755,16,21,1997,6,"male",311,60,32,27,130,3,82,24,48
1227798,48,25,1965,5,"male",456,21,15,23,15,0,2,23,13
1227810,23,5,1990,11,"female",1042,4620,1806,4756,9787,2574,6345,2182,3442
1227849,29,31,1984,5,"male",658,48,19,16,2,0,2,16,0
1227857,53,10,1960,1,"female",473,116,94,1,0,0,0,1,0
1227863,73,30,1940,9,"female",1437,278,144,1,91,0,0,1,91
1227867,62,5,1951,6,"female",705,1,1,1,0,1,0,0,0
1227869,19,8,1994,9,"male",527,1740,1493,779,385,779,313,0,72
1227894,17,6,1996,10,"male",155,150,146,58,8,58,7,0,1
1227940,30,24,1983,11,"male",1066,76,66,0,1,0,1,0,0
1227948,50,1,1963,2,"female",502,6,2,10,0,10,0,0,0
1227965,64,13,1949,6,"male",1755,25,18,66,2,66,2,0,0
1227977,65,21,1948,9,"female",1655,205,139,55,20,0,3,55,17
1228000,18,12,1995,3,"male",683,37,19,0,5,0,5,0,0
1228010,64,20,1949,1,"male",1439,53,29,1,1,0,1,1,0
1228064,17,20,1996,3,"male",159,213,130,1,5,1,5,0,0
1228091,78,7,1935,7,"male",636,62,48,0,1,0,0,0,1
1228100,68,6,1945,6,"female",1039,1649,107,173,151,173,131,0,20
1228119,35,18,1978,11,"male",544,36,23,149,22,149,10,0,12
1228122,81,13,1932,2,"female",1607,700,276,9,133,9,78,0,55
1228159,31,2,1982,1,"female",361,52,25,0,3,0,1,0,2
1228164,40,22,1973,3,"male",76,80,72,32,20,7,5,25,15
1228165,22,27,1991,12,"female",723,651,436,8,1,1,0,7,1
1228167,24,17,1989,1,"female",484,1641,886,23,285,23,247,0,38
1228171,26,13,1987,12,"female",271,1,1,0,1,0,0,0,1
1228196,28,1,1985,9,"male",349,117,58,91,37,41,12,50,25
1228211,63,26,1950,5,"male",1366,7,6,64,14,0,13,64,1
1228217,49,2,1964,2,"male",98,6,6,0,0,0,0,0,0
1228270,19,2,1994,12,"male",320,72,56,13,4,11,0,2,4
1228275,16,30,1997,1,"female",106,408,373,273,917,273,885,0,32
1228363,79,26,1934,9,"male",722,21,14,0,0,0,0,0,0
1228387,39,24,1974,5,"male",345,49,27,4,1,0,0,4,1
1228418,21,1,1992,1,"male",83,6,6,0,0,0,0,0,0
1228447,15,19,1998,11,"male",617,608,384,2593,2240,1498,1928,1095,312
1228474,32,7,1981,7,"male",221,113,59,13,8,9,6,4,2
1228477,21,19,1992,8,"male",319,187,126,36,21,36,15,0,6
1228497,62,29,1951,12,"female",2221,202,92,233,217,114,145,119,72
1228618,72,27,1941,4,"female",1740,63,47,103,36,37,10,66,26
1228619,27,25,1986,1,"female",487,36,23,0,0,0,0,0,0
1228650,24,5,1989,8,"male",222,89,50,9,83,9,42,0,41
1228655,25,29,1988,2,"female",283,18,6,10,6,10,2,0,4
1228663,72,8,1941,9,"female",1830,237,147,269,131,267,69,2,62
1228719,21,29,1992,4,"female",396,316,254,0,0,0,0,0,0
1228721,13,1,2000,1,"male",36,57,55,0,1,0,0,0,1
1228728,108,5,1905,8,"male",140,203,49,18,16,0,10,18,6
1228781,29,12,1984,9,"female",936,28,16,2,4,0,1,2,3
1228811,19,6,1994,7,"female",1507,220,61,92,567,75,141,17,426
1228814,41,18,1972,11,"female",522,66,24,71,57,66,33,5,24
1228816,16,3,1997,2,"female",129,125,23,38,48,15,18,23,30
1228835,28,3,1985,3,"male",53,8,1,0,0,0,0,0,0
1228841,38,16,1975,10,"male",488,34,24,0,0,0,0,0,0
1228844,21,10,1992,4,"female",382,721,479,60,71,42,27,18,44
1228855,23,9,1990,11,"male",1111,39,1,0,2,0,0,0,2
1228909,45,23,1968,5,"female",297,11,10,23,12,23,9,0,3
1228968,24,9,1989,4,"female",411,359,259,261,59,261,40,0,19
1228975,72,16,1941,3,"female",1521,33,8,0,5,0,1,0,4
1228976,19,23,1994,2,"male",639,1535,1053,399,521,15,230,384,291
1228994,45,25,1968,6,"female",222,0,0,0,0,0,0,0,0
1228997,23,5,1990,3,"female",312,292,188,935,353,919,279,16,74
1229037,44,17,1969,4,"female",643,115,71,206,302,206,110,0,192
1229040,26,2,1987,3,"female",559,143,96,157,99,157,70,0,29
1229043,26,21,1987,4,"male",5,7,7,9,0,9,0,0,0
1229054,54,8,1959,7,"male",427,99,74,0,0,0,0,0,0
1229068,29,24,1984,1,"male",1231,121,62,51,12,51,10,0,2
1229097,25,10,1988,5,"female",279,20,11,34,6,34,6,0,0
1229119,68,10,1945,6,"male",1430,67,8,3,46,0,6,3,40
1229131,21,23,1992,1,"female",256,108,50,189,7,1,3,188,4
1229140,25,16,1988,2,"female",101,31,24,1,0,1,0,0,0
1229156,25,1,1988,1,"male",264,61,51,3,1,3,1,0,0
1229169,64,11,1949,7,"male",824,123,98,454,16,452,14,2,2
1229177,29,27,1984,12,"female",392,71,33,241,50,241,32,0,18
1229192,24,27,1989,5,"female",1450,610,375,98,205,86,116,12,89
1229195,68,6,1945,2,"male",1784,29,15,21,8,0,6,21,2
1229207,19,6,1994,7,"male",549,75,44,3,1,1,0,2,1
1229217,17,23,1996,2,"male",314,158,136,4,4,4,4,0,0
1229234,18,10,1995,9,"female",41,15,9,27,3,27,3,0,0
1229240,26,13,1987,1,"male",163,1,1,4,4,0,4,4,0
1229250,45,23,1968,9,"male",619,167,67,784,389,783,276,1,113
1229257,54,3,1959,4,"male",1754,147,56,1,5,1,5,0,0
1229276,49,12,1964,11,"female",1168,48,19,20,15,0,8,20,7
1229283,15,1,1998,1,"female",567,367,282,1213,930,1212,776,1,154
1229293,46,12,1967,9,"male",535,572,402,54,289,18,106,36,183
1229350,26,21,1987,3,"male",1144,294,81,3,1,3,0,0,1
1229352,15,6,1998,1,"female",86,3,3,153,30,2,9,151,21
1229372,19,11,1994,11,"female",385,19,14,8,0,0,0,8,0
1229385,56,6,1957,1,"female",1351,202,133,82,58,82,40,0,18
1229397,23,17,1990,5,"male",68,0,0,0,0,0,0,0,0
1229425,33,3,1980,11,"male",193,27,25,0,3,0,2,0,1
1229502,20,29,1993,11,"male",352,147,102,17,11,17,4,0,7
1229515,58,6,1955,4,"male",710,521,461,63,127,56,56,7,71
1229532,26,22,1987,10,"male",71,77,73,14,14,14,8,0,6
1229539,13,9,2000,6,"male",485,240,167,54,42,11,20,43,22
1229548,51,5,1962,3,"male",8,0,0,0,0,0,0,0,0
1229549,58,3,1955,12,"female",556,43,24,9,1,8,1,1,0
1229551,27,7,1986,12,"male",425,206,173,0,0,0,0,0,0
1229572,27,6,1986,3,"female",101,5,4,4,1,4,1,0,0
1229581,59,6,1954,8,"female",986,26,13,56,13,0,8,56,5
1229617,21,4,1992,8,"female",1456,1246,149,59,587,0,396,59,191
1229622,36,27,1977,9,"male",2258,2561,1711,127,1893,47,1442,80,451
1229700,18,18,1995,2,"female",34,32,20,68,141,62,94,6,47
1229717,19,5,1994,11,"male",208,72,52,0,12,0,3,0,9
1229722,41,1,1972,5,"male",792,158,92,4,4,4,4,0,0
1229746,35,25,1978,9,"female",412,93,50,141,142,141,87,0,55
1229795,36,29,1977,8,"female",647,10,5,0,0,0,0,0,0
1229796,22,12,1991,4,"male",840,227,72,15,2,15,1,0,1
1229808,22,22,1991,1,"female",386,6,1,0,0,0,0,0,0
1229811,24,8,1989,3,"female",400,42,10,1,0,0,0,1,0
1229812,17,22,1996,4,"male",230,699,587,344,127,344,78,0,49
1229817,19,17,1994,3,"male",77,28,14,13,141,13,15,0,126
1229821,23,22,1990,3,"male",226,6,1,0,2,0,2,0,0
1229864,16,5,1997,1,"male",148,70,49,3,11,3,11,0,0
1229898,25,1,1988,1,"female",508,230,51,9,63,9,22,0,41
1229907,16,17,1997,3,"male",1543,324,159,2,5,2,3,0,2
1229910,21,13,1992,12,"female",612,25,12,0,0,0,0,0,0
1229949,51,25,1962,7,"female",1209,55,28,55,57,0,2,55,55
1229972,26,11,1987,3,"male",821,239,196,0,34,0,13,0,21
1229974,21,1,1992,1,"male",1132,132,73,1,0,1,0,0,0
1229982,22,7,1991,4,"female",526,260,208,4,0,4,0,0,0
1230000,22,14,1991,5,"male",494,203,64,1,0,1,0,0,0
1230003,27,11,1986,11,"male",205,28,14,0,0,0,0,0,0
1230008,21,12,1992,8,"male",356,301,258,0,3,0,3,0,0
1230028,22,29,1991,9,"female",701,999,702,51,167,51,101,0,66
1230031,32,5,1981,5,"male",731,38,31,3,4,0,0,3,4
1230061,17,19,1996,7,"female",243,248,188,29,80,25,14,4,66
1230062,108,10,1905,10,"male",964,88,40,243,152,243,102,0,50
1230160,39,1,1974,1,"male",715,344,229,2,7,2,7,0,0
1230168,96,13,1917,8,"female",1590,277,179,330,372,326,296,4,76
1230183,48,25,1965,1,"male",441,45,28,119,3,0,1,119,2
1230184,17,2,1996,7,"male",319,167,82,0,1,0,1,0,0
1230204,102,6,1911,8,"female",1622,222,69,0,6,0,3,0,3
1230226,32,19,1981,2,"male",1576,326,276,12,45,12,21,0,24
1230287,20,16,1993,6,"female",578,600,312,37,40,1,7,36,33
1230289,62,8,1951,10,"female",523,107,42,3,8,0,7,3,1
1230317,77,29,1936,11,"female",730,104,74,0,0,0,0,0,0
1230352,18,5,1995,1,"male",649,272,201,72,48,58,30,14,18
1230360,48,6,1965,8,"female",1593,167,101,2184,828,2022,501,162,327
1230371,26,10,1987,7,"male",64,43,28,0,0,0,0,0,0
1230400,100,3,1913,4,"female",192,118,106,168,8,168,1,0,7
1230406,14,24,1999,10,"male",574,236,138,51,89,47,71,4,18
1230410,19,15,1994,6,"male",298,0,0,0,0,0,0,0,0
1230418,82,13,1931,8,"female",747,30,23,3,0,0,0,3,0
1230443,26,11,1987,12,"male",615,134,65,0,0,0,0,0,0
1230460,23,28,1990,9,"male",45,8,6,1,0,0,0,1,0
1230466,15,14,1998,9,"male",163,263,220,28,25,28,14,0,11
1230470,28,12,1985,9,"male",435,289,248,213,134,8,132,205,2
1230527,28,25,1985,5,"male",356,147,109,1,8,1,0,0,8
1230541,24,1,1989,11,"female",477,112,27,0,1,0,1,0,0
1230562,19,25,1994,6,"male",347,274,231,19,47,19,46,0,1
1230603,17,26,1996,3,"male",282,194,99,356,500,184,243,172,257
1230625,17,3,1996,2,"male",307,99,59,10,1,0,1,10,0
1230632,35,5,1978,10,"female",1098,180,87,70,254,68,138,2,116
1230641,19,4,1994,2,"female",270,281,34,207,283,207,271,0,12
1230661,66,14,1947,8,"male",6,17,16,17,5,17,5,0,0
1230695,48,25,1965,3,"male",1733,178,45,0,0,0,0,0,0
1230732,43,11,1970,2,"male",62,41,35,10,3,3,2,7,1
1230734,19,10,1994,9,"male",155,275,199,175,33,174,25,1,8
1230743,17,5,1996,5,"female",88,28,27,6,40,6,40,0,0
1230749,50,15,1963,12,"male",294,35,27,11,4,11,4,0,0
1230751,43,1,1970,12,"male",851,374,261,40,324,34,131,6,193
1230768,26,1,1987,1,"male",254,2,2,5,0,5,0,0,0
1230771,18,21,1995,2,"male",622,142,54,34,2,34,2,0,0
1230782,60,12,1953,7,"male",999,18,9,1,0,0,0,1,0
1230783,63,11,1950,10,"female",1082,202,98,293,94,0,15,293,79
1230784,18,9,1995,5,"male",117,10,8,0,1,0,1,0,0
1230798,18,20,1995,8,"female",195,213,162,39,38,21,8,18,30
1230830,23,18,1990,3,"female",244,22,15,19,88,19,27,0,61
1230845,53,11,1960,1,"male",1226,56,30,31,54,31,26,0,28
1230863,23,16,1990,12,"female",575,363,182,234,244,228,93,6,151
1230864,27,1,1986,1,"female",1023,4,3,5,2,5,2,0,0
1230885,16,1,1997,4,"female",187,204,140,35,13,6,3,29,10
1230897,65,28,1948,1,"female",272,13,10,3,1,3,1,0,0
1230909,50,28,1963,7,"male",601,0,0,0,0,0,0,0,0
1230920,21,9,1992,12,"male",88,19,17,13,0,13,0,0,0
1230922,14,25,1999,8,"male",177,498,428,308,160,229,135,79,25
1230945,40,26,1973,9,"female",340,4,2,0,0,0,0,0,0
1230946,24,23,1989,8,"male",499,138,77,11,7,3,3,8,4
1230963,46,15,1967,10,"male",1281,29,3,0,2,0,0,0,2
1230967,51,17,1962,2,"female",1555,223,85,103,64,103,47,0,17
1230970,61,19,1952,10,"female",300,80,64,0,0,0,0,0,0
1230982,23,23,1990,10,"female",806,90,55,0,1,0,1,0,0
1231000,38,21,1975,9,"male",754,41,10,22,5,22,4,0,1
1231040,32,17,1981,7,"male",28,0,0,1,9,1,4,0,5
1231070,21,1,1992,12,"male",175,195,114,32,79,19,27,13,52
1231116,25,13,1988,7,"male",405,233,71,18,29,18,26,0,3
1231143,17,30,1996,1,"male",423,317,249,415,25,386,18,29,7
1231185,50,14,1963,7,"male",313,66,49,1,1,1,1,0,0
1231197,23,1,1990,2,"female",310,244,87,151,252,108,105,43,147
1231201,30,5,1983,11,"male",192,119,43,4,8,4,5,0,3
1231210,31,29,1982,8,"female",306,53,40,0,0,0,0,0,0
1231222,47,25,1966,8,"male",295,470,348,73,585,47,173,26,412
1231235,108,4,1905,5,"female",161,157,91,0,0,0,0,0,0
1231242,44,9,1969,4,"female",530,233,153,28,20,28,18,0,2
1231245,93,29,1920,6,"male",789,766,304,54,87,54,55,0,32
1231250,19,8,1994,5,"female",207,410,200,2008,405,1979,283,29,122
1231256,15,28,1998,4,"male",306,58,37,0,0,0,0,0,0
1231302,40,17,1973,7,"male",733,6,3,31,12,19,8,12,4
1231307,25,28,1988,10,"male",239,67,25,1,1,1,1,0,0
1231310,20,2,1993,2,"male",1004,182,153,2,4,2,4,0,0
1231360,18,30,1995,5,"male",290,0,0,0,0,0,0,0,0
1231369,23,1,1990,1,"male",276,54,31,0,6,0,6,0,0
1231396,18,8,1995,8,"female",62,42,32,0,0,0,0,0,0
1231398,16,4,1997,6,"male",588,113,40,0,20,0,9,0,11
1231408,35,20,1978,8,"male",647,263,70,3,0,3,0,0,0
1231444,25,7,1988,6,"female",181,95,72,156,161,156,157,0,4
1231469,21,18,1992,10,"male",1800,219,106,6,9,1,1,5,8
1231470,16,12,1997,1,"female",581,286,222,0,0,0,0,0,0
1231484,23,1,1990,1,"male",482,56,41,2,0,2,0,0,0
1231507,51,11,1962,12,"female",247,69,33,61,32,61,21,0,11
1231524,22,13,1991,4,"male",24,0,0,0,0,0,0,0,0
1231529,32,20,1981,12,"female",1975,332,199,570,406,207,89,363,317
1231531,24,21,1989,6,"female",264,170,42,13,28,13,22,0,6
1231545,29,7,1984,9,"female",939,24,12,3,0,3,0,0,0
1231549,17,18,1996,1,"male",608,194,79,616,204,162,129,454,75
1231551,18,13,1995,7,"female",346,27,20,1,0,1,0,0,0
1231555,67,2,1946,12,"male",670,53,32,16,7,16,3,0,4
1231558,15,16,1998,3,"male",233,13,4,1,0,0,0,1,0
1231564,27,4,1986,4,"male",148,37,23,1,7,1,4,0,3
1231576,58,8,1955,10,"female",419,52,35,2,1,2,1,0,0
1231577,16,27,1997,11,"male",745,495,376,17,6,9,3,8,3
1231588,100,1,1913,1,"male",428,138,101,56,94,52,76,4,18
1231595,15,20,1998,4,"male",595,65,43,6,28,0,3,6,25
1231609,19,10,1994,11,"male",729,267,180,4,0,3,0,1,0
1231614,20,4,1993,1,"female",247,343,109,143,113,143,74,0,39
1231633,19,28,1994,6,"male",346,18,18,34,9,34,6,0,3
1231641,26,17,1987,12,"female",605,53,28,0,1,0,0,0,1
1231668,17,20,1996,5,"male",169,154,134,10,12,10,8,0,4
1231686,39,27,1974,2,"female",284,102,44,56,19,56,15,0,4
1231698,57,17,1956,4,"female",623,7,4,1,0,0,0,1,0
1231704,25,1,1988,1,"female",293,31,28,46,38,46,31,0,7
1231707,108,9,1905,6,"male",135,31,28,0,0,0,0,0,0
1231719,19,23,1994,7,"male",444,382,318,5,4,5,1,0,3
1231732,65,3,1948,1,"male",164,5,3,3,42,3,4,0,38
1231747,37,10,1976,8,"male",765,204,88,165,281,165,261,0,20
1231759,19,12,1994,2,"female",215,154,75,223,47,223,39,0,8
1231773,50,1,1963,3,"female",1845,320,206,57,145,57,86,0,59
1231833,78,28,1935,2,"male",761,71,37,0,2,0,1,0,1
1231855,36,8,1977,5,"female",432,62,43,65,36,56,21,9,15
1231860,34,30,1979,3,"male",595,285,114,448,87,448,59,0,28
1231880,63,28,1950,11,"male",416,11,2,0,0,0,0,0,0
1231910,23,7,1990,11,"female",160,101,74,10,64,10,48,0,16
1231919,33,5,1980,9,"male",17,90,89,6,3,6,3,0,0
1231939,26,21,1987,7,"male",250,11,9,17,0,17,0,0,0
1231941,33,23,1980,5,"male",102,32,18,7,3,3,3,4,0
1231943,21,1,1992,2,"male",108,156,109,2,10,2,8,0,2
1231959,83,15,1930,9,"female",370,31,19,18,1,0,0,18,1
1231961,17,6,1996,5,"male",244,92,45,0,2,0,1,0,1
1231971,20,24,1993,9,"male",297,248,160,72,286,72,185,0,101
1231988,23,17,1990,6,"female",13,56,52,230,67,230,43,0,24
1231991,26,8,1987,7,"male",275,145,113,64,53,64,27,0,26
1232041,24,17,1989,11,"male",432,2,2,1,0,1,0,0,0
1232043,66,15,1947,12,"male",480,211,195,0,0,0,0,0,0
1232051,37,1,1976,5,"male",998,18,13,5,0,5,0,0,0
1232080,23,21,1990,9,"female",176,40,26,10,87,8,64,2,23
1232081,35,24,1978,3,"female",607,54,42,0,8,0,2,0,6
1232094,21,13,1992,8,"male",612,20,14,0,0,0,0,0,0
1232102,31,31,1982,3,"female",315,74,52,303,42,302,37,1,5
1232107,25,12,1988,9,"male",277,400,266,4,0,4,0,0,0
1232131,23,14,1990,1,"male",356,14,13,0,0,0,0,0,0
1232152,22,19,1991,6,"female",341,299,171,14,2,14,2,0,0
1232160,65,25,1948,3,"male",878,112,37,3,0,3,0,0,0
1232167,23,11,1990,9,"male",407,294,198,64,44,64,25,0,19
1232173,29,24,1984,9,"female",420,74,22,1,18,0,9,1,9
1232228,32,28,1981,6,"female",62,6,6,4,3,4,1,0,2
1232233,20,5,1993,8,"female",634,83,34,1353,171,1326,68,27,103
1232267,17,10,1996,9,"male",742,1280,1057,347,341,331,260,16,81
1232301,108,28,1905,2,"female",2271,76,28,48,11,5,8,43,3
1232315,20,10,1993,10,"male",126,25,15,25,8,5,5,20,3
1232327,62,25,1951,6,"male",1059,112,16,166,37,0,2,166,35
1232344,55,9,1958,12,"male",657,89,78,10,8,10,4,0,4
1232354,20,18,1993,4,"male",404,10,3,0,0,0,0,0,0
1232355,73,18,1940,12,"female",299,285,268,1207,363,882,190,325,173
1232374,54,4,1959,7,"female",1767,256,201,55,98,40,64,15,34
1232380,33,13,1980,12,"female",349,18,7,6,2,6,2,0,0
1232400,14,29,1999,7,"male",623,254,152,460,856,354,599,106,257
1232408,63,10,1950,3,"male",640,77,18,0,2,0,1,0,1
1232528,19,31,1994,8,"female",643,364,100,1059,775,1026,495,33,280
1232556,57,22,1956,12,"female",96,14,11,284,11,0,6,284,5
1232570,24,10,1989,11,"female",556,1,0,0,0,0,0,0,0
1232578,45,7,1968,3,"male",1518,15,8,4,3,1,2,3,1
1232584,68,27,1945,7,"male",485,449,365,15,126,9,59,6,67
1232620,35,20,1978,4,"male",523,115,78,5,1,5,0,0,1
1232627,50,23,1963,8,"female",443,162,119,235,17,235,9,0,8
1232633,108,18,1905,7,"male",746,1340,1168,9,4,9,4,0,0
1232637,60,15,1953,12,"female",2111,79,53,50,13,44,8,6,5
1232662,57,16,1956,6,"female",1707,112,33,152,165,152,121,0,44
1232665,26,26,1987,10,"male",551,214,165,33,31,0,1,33,30
1232681,49,9,1964,10,"male",221,0,0,0,0,0,0,0,0
1232701,13,16,2000,5,"male",18,17,11,14,12,14,9,0,3
1232715,25,24,1988,10,"male",134,119,115,0,10,0,3,0,7
1232744,41,5,1972,5,"female",282,166,130,25,5,0,4,25,1
1232748,26,5,1987,5,"male",531,63,22,1,0,0,0,1,0
1232749,40,13,1973,4,"male",335,63,45,6,2,0,1,6,1
1232771,71,7,1942,5,"male",23,62,57,1507,18,0,4,1507,14
1232798,33,17,1980,5,"male",850,116,77,9,38,8,31,1,7
1232804,19,18,1994,8,"male",855,44,32,12,1,12,0,0,1
1232825,30,29,1983,4,"female",901,11,5,287,0,263,0,24,0
1232834,35,19,1978,2,"male",327,63,50,1,4,1,4,0,0
1232859,25,1,1988,1,"male",149,70,40,1,0,1,0,0,0
1232870,16,25,1997,3,"female",269,139,39,24,39,19,27,5,12
1232874,49,11,1964,8,"female",211,59,38,108,33,108,26,0,7
1232880,64,19,1949,5,"female",299,21,1,21,0,21,0,0,0
1232884,27,21,1986,4,"female",1033,350,198,76,123,48,35,28,88
1232886,108,8,1905,10,"male",980,314,145,1694,230,1450,114,244,116
1232906,29,20,1984,6,"male",365,241,203,97,35,20,11,77,24
1232911,36,16,1977,5,"female",20,19,15,70,28,70,16,0,12
1232953,18,17,1995,5,"male",436,38,24,17,12,17,12,0,0
1232971,22,15,1991,4,"female",395,64,49,3,4,0,0,3,4
1232981,25,10,1988,6,"male",464,207,154,1,2,1,2,0,0
1232985,25,12,1988,9,"male",217,92,26,0,0,0,0,0,0
1232992,18,28,1995,4,"female",271,533,289,70,122,26,42,44,80
1232993,14,17,1999,1,"male",217,254,180,7,1,7,1,0,0
1233006,23,25,1990,9,"male",673,386,305,0,0,0,0,0,0
1233037,103,6,1910,4,"male",1266,903,728,20,22,17,16,3,6
1233049,19,1,1994,5,"male",385,414,391,51,101,38,24,13,77
1233050,56,3,1957,3,"female",1945,110,57,7,2,6,1,1,1
1233052,33,15,1980,11,"male",37,52,45,9,20,9,16,0,4
1233062,68,29,1945,9,"female",1360,978,670,245,202,244,148,1,54
1233079,21,10,1992,6,"male",694,232,182,33,11,33,11,0,0
1233087,62,14,1951,6,"female",795,91,65,903,332,24,277,879,55
1233102,30,30,1983,8,"male",342,76,42,2,5,2,0,0,5
1233124,16,28,1997,5,"female",82,51,33,3,7,3,6,0,1
1233139,15,11,1998,1,"female",550,918,519,659,899,396,560,263,339
1233153,70,1,1943,8,"male",22,76,66,10,2,0,0,10,2
1233155,18,2,1995,1,"male",222,91,66,0,0,0,0,0,0
1233194,50,23,1963,5,"female",1270,225,58,11,8,6,1,5,7
1233195,64,4,1949,9,"female",128,70,38,0,1,0,0,0,1
1233204,98,2,1915,1,"female",1462,191,59,98,76,95,63,3,13
1233232,57,10,1956,5,"female",19,16,10,3,22,3,10,0,12
1233289,25,1,1988,1,"male",121,0,0,0,0,0,0,0,0
1233322,41,3,1972,8,"male",626,23,11,94,2,94,2,0,0
1233358,30,3,1983,7,"male",273,9,8,4,0,4,0,0,0
1233392,22,26,1991,6,"male",226,392,38,2,1,2,1,0,0
1233395,32,23,1981,2,"female",486,15,12,0,0,0,0,0,0
1233401,45,10,1968,1,"male",132,1,0,0,0,0,0,0,0
1233417,14,11,1999,8,"female",224,165,51,7,54,7,53,0,1
1233470,15,18,1998,4,"male",181,121,98,48,15,48,11,0,4
1233483,21,2,1992,2,"male",617,307,132,106,73,106,70,0,3
1233490,26,12,1987,10,"female",431,81,53,37,9,37,4,0,5
1233524,30,9,1983,7,"male",1289,285,226,68,40,63,33,5,7
1233529,108,1,1905,1,"male",1120,43,12,24,5,0,2,24,3
1233547,24,22,1989,7,"male",242,54,34,0,0,0,0,0,0
1233559,40,17,1973,7,"female",520,36,15,227,54,151,52,76,2
1233567,30,27,1983,6,"female",128,161,151,288,242,188,157,100,85
1233569,41,17,1972,6,"male",218,61,46,28,2,28,0,0,2
1233581,27,9,1986,10,"male",528,43,42,0,3,0,1,0,2
1233587,20,15,1993,8,"male",236,149,37,13,1,13,0,0,1
1233629,38,23,1975,2,"male",519,48,11,86,38,86,22,0,16
1233635,33,7,1980,2,"female",291,100,86,1,0,1,0,0,0
1233636,37,22,1976,5,"female",462,256,163,8,9,5,5,3,4
1233637,46,5,1967,6,"male",366,101,77,23,12,23,11,0,1
1233645,51,12,1962,10,"female",593,10,5,1,2,0,2,1,0
1233684,25,25,1988,12,"male",250,2,2,0,0,0,0,0,0
1233689,19,7,1994,4,"male",346,373,313,125,285,123,85,2,200
1233705,41,18,1972,12,"female",489,74,38,5,6,5,5,0,1
1233726,18,18,1995,5,"male",355,25,23,0,0,0,0,0,0
1233745,36,25,1977,12,"male",309,0,0,0,0,0,0,0,0
1233776,28,18,1985,7,"male",522,282,152,229,146,150,128,79,18
1233785,53,3,1960,4,"female",142,135,70,0,0,0,0,0,0
1233797,74,4,1939,3,"male",607,52,26,0,0,0,0,0,0
1233815,52,20,1961,9,"female",157,49,36,44,6,44,6,0,0
1233826,62,6,1951,1,"female",663,44,31,32,5,29,5,3,0
1233838,27,22,1986,5,"female",231,105,49,5,0,5,0,0,0
1233839,80,17,1933,6,"female",2325,615,194,46,6,46,6,0,0
1233882,58,25,1955,7,"male",1204,55,11,0,0,0,0,0,0
1233900,53,6,1960,12,"male",2409,51,27,125,27,124,16,1,11
1233901,50,21,1963,10,"female",949,35,26,1,3,0,1,1,2
1233925,31,30,1982,7,"female",214,246,169,87,244,73,114,14,130
1233935,48,30,1965,8,"female",289,7,5,0,0,0,0,0,0
1233938,59,17,1954,12,"male",338,13,10,0,0,0,0,0,0
1233953,17,30,1996,12,"male",455,635,479,800,709,768,356,32,353
1233968,67,7,1946,7,"male",1363,13,7,12,2,12,0,0,2
1234001,30,25,1983,2,"male",514,21,9,30,10,27,9,3,1
1234018,39,23,1974,5,"female",466,143,77,92,51,85,20,7,31
1234025,55,31,1958,10,"female",23,22,20,9,9,0,1,9,8
1234028,15,24,1998,3,"male",1033,144,92,2,1,0,0,2,1
1234076,15,8,1998,1,"female",412,139,61,20,64,7,36,13,28
1234096,49,12,1964,12,"female",1508,193,123,106,132,104,83,2,49
1234107,22,24,1991,9,"male",292,62,54,20,2,20,1,0,1
1234116,27,10,1986,9,"female",435,18,10,13,1,13,1,0,0
1234125,19,5,1994,10,"male",13,5,5,14,6,14,6,0,0
1234145,23,1,1990,1,"male",79,2,2,0,3,0,3,0,0
1234162,32,1,1981,9,"male",145,31,15,34,9,34,9,0,0
1234171,21,9,1992,2,"female",445,223,170,59,69,59,51,0,18
1234175,58,29,1955,7,"female",589,90,69,5,6,4,4,1,2
1234182,30,4,1983,5,"male",292,45,1,99,28,98,24,1,4
1234225,26,12,1987,10,"male",206,37,27,2,0,0,0,2,0
1234286,22,2,1991,10,"male",31,32,30,18,27,18,11,0,16
1234304,22,19,1991,10,"male",540,69,46,12,13,0,6,12,7
1234315,25,6,1988,11,"female",163,409,77,260,469,249,343,11,126
1234354,18,11,1995,6,"male",779,289,107,0,1,0,0,0,1
1234360,23,3,1990,4,"male",882,61,53,7,2,7,2,0,0
1234366,15,6,1998,1,"male",938,109,55,11,18,1,1,10,17
1234389,18,15,1995,2,"female",859,345,224,3,2,3,2,0,0
1234390,53,25,1960,12,"male",1000,602,210,17,29,17,5,0,24
1234402,43,30,1970,4,"male",538,38,17,10,2,10,2,0,0
1234424,43,1,1970,1,"male",182,601,167,5,173,0,140,5,33
1234444,20,8,1993,1,"female",657,297,200,446,396,80,84,366,312
1234446,50,1,1963,9,"female",512,43,27,3,2,0,2,3,0
1234484,37,28,1976,3,"female",489,183,121,65,6,65,5,0,1
1234506,63,2,1950,4,"female",1565,45,20,400,321,400,133,0,188
1234531,32,8,1981,3,"male",633,87,56,30,161,28,77,2,84
1234550,21,7,1992,2,"male",234,75,18,4,0,4,0,0,0
1234590,40,6,1973,8,"female",465,90,18,133,115,133,61,0,54
1234602,23,9,1990,5,"male",303,156,135,0,0,0,0,0,0
1234606,54,4,1959,9,"male",22,0,0,23,0,0,0,23,0
1234625,54,21,1959,1,"female",532,53,21,3,5,3,5,0,0
1234653,18,1,1995,4,"female",531,535,190,49,87,10,43,39,44
1234661,31,6,1982,7,"male",1347,309,247,0,0,0,0,0,0
1234666,29,26,1984,6,"female",123,19,9,262,74,262,53,0,21
1234700,23,7,1990,11,"male",358,24,20,4,1,4,1,0,0
1234707,27,28,1986,9,"male",650,52,39,4,0,4,0,0,0
1234730,26,3,1987,5,"male",52,28,19,12,7,12,7,0,0
1234737,101,26,1912,5,"male",925,907,578,4,5,4,5,0,0
1234739,41,11,1972,11,"male",244,12,12,0,0,0,0,0,0
1234750,26,26,1987,12,"female",12,5,3,0,0,0,0,0,0
1234776,113,19,1900,11,"female",1391,521,212,899,482,896,371,3,111
1234802,21,3,1992,8,"female",753,296,191,0,0,0,0,0,0
1234827,21,26,1992,6,"male",1147,116,68,52,44,52,36,0,8
1234849,43,18,1970,12,"male",179,30,25,100,43,100,38,0,5
1234870,18,8,1995,8,"male",225,259,132,14,15,14,12,0,3
1234873,38,23,1975,3,"female",539,415,305,3,13,3,13,0,0
1234944,22,3,1991,4,"male",511,571,513,8,16,8,11,0,5
1234969,23,26,1990,2,"male",173,467,416,527,94,172,78,355,16
1234992,23,14,1990,2,"male",485,873,791,154,58,154,55,0,3
1234999,28,20,1985,4,"male",623,300,178,0,0,0,0,0,0
1235002,34,20,1979,2,"male",328,81,56,4,1,1,1,3,0
1235019,25,12,1988,12,"male",265,39,36,0,4,0,3,0,1
1235028,63,8,1950,10,"female",308,36,26,23,6,23,6,0,0
1235040,23,27,1990,5,"male",297,99,96,4,11,0,5,4,6
1235054,19,9,1994,3,"female",311,46,30,35,15,35,13,0,2
1235067,53,5,1960,10,"male",1364,44,26,4,4,4,2,0,2
1235068,72,8,1941,7,"male",116,23,18,27,40,27,14,0,26
1235096,21,1,1992,1,"female",1486,0,0,0,0,0,0,0,0
1235102,66,11,1947,10,"male",1146,421,269,2240,801,1509,426,731,375
1235162,108,8,1905,2,"male",1029,313,161,0,0,0,0,0,0
1235182,55,3,1958,6,"female",384,58,37,93,60,0,8,93,52
1235196,30,28,1983,2,"male",660,46,41,5,0,5,0,0,0
1235209,15,24,1998,7,"male",61,6,5,12,9,12,9,0,0
1235230,23,3,1990,3,"male",277,4,1,37,5,25,5,12,0
1235254,87,14,1926,3,NA,1997,52,24,6,0,0,0,6,0
1235269,26,7,1987,8,"female",210,65,35,10,5,10,2,0,3
1235273,27,2,1986,11,"male",1369,1341,957,2878,1738,2878,1616,0,122
1235324,57,3,1956,1,"female",1381,235,123,178,319,44,32,134,287
1235336,61,1,1952,11,"male",1949,277,221,0,11,0,11,0,0
1235339,39,23,1974,1,"male",230,165,145,0,8,0,8,0,0
1235409,19,21,1994,7,"female",616,225,25,165,192,165,178,0,14
1235416,26,6,1987,11,"male",111,37,36,0,0,0,0,0,0
1235418,44,3,1969,10,"male",950,275,203,46,75,46,46,0,29
1235422,93,1,1920,9,"male",1110,327,215,74,39,19,18,55,21
1235438,19,13,1994,12,"male",587,765,455,4,18,0,9,4,9
1235442,19,24,1994,11,"female",290,122,43,88,117,84,81,4,36
1235457,27,6,1986,2,"male",157,99,93,28,0,28,0,0,0
1235480,30,12,1983,2,"male",267,40,33,0,0,0,0,0,0
1235508,38,9,1975,6,"male",1474,57,43,108,43,104,13,4,30
1235516,49,15,1964,5,"male",855,125,51,7,0,0,0,7,0
1235576,23,3,1990,1,"female",169,34,12,2,8,2,6,0,2
1235579,17,14,1996,9,"female",487,31,15,369,47,369,20,0,27
1235593,28,7,1985,9,"male",293,9,8,1,0,1,0,0,0
1235622,20,17,1993,7,"female",387,96,38,2,9,2,0,0,9
1235626,29,18,1984,9,"male",277,16,8,1,0,1,0,0,0
1235628,36,22,1977,12,"male",401,258,194,39,5,38,4,1,1
1235662,64,11,1949,6,"female",1287,247,164,374,266,0,22,374,244
1235698,38,19,1975,9,"male",435,3,1,0,0,0,0,0,0
1235700,18,24,1995,1,"male",694,435,368,0,2,0,2,0,0
1235712,23,10,1990,10,"female",997,29,29,11,3,11,2,0,1
1235772,68,4,1945,10,"male",249,438,396,59,54,59,41,0,13
1235780,65,30,1948,5,"male",292,9,6,0,0,0,0,0,0
1235791,62,15,1951,6,"female",142,33,32,29,14,0,5,29,9
1235815,22,4,1991,2,"female",561,50,41,5,0,5,0,0,0
1235870,59,26,1954,6,"male",452,40,37,5,13,0,3,5,10
1235872,24,10,1989,1,"male",576,142,34,246,144,246,116,0,28
1235910,37,12,1976,10,"male",352,26,25,7,11,0,2,7,9
1235916,21,1,1992,1,"male",151,36,25,9,7,0,6,9,1
1235926,28,9,1985,9,"male",1693,72,29,26,26,22,14,4,12
1235931,63,12,1950,8,"female",1009,138,60,42,10,0,4,42,6
1235940,37,20,1976,12,"female",389,152,108,110,107,9,38,101,69
1235962,18,22,1995,10,"male",197,97,80,0,0,0,0,0,0
1235976,18,23,1995,10,"male",105,45,28,4,9,4,7,0,2
1235980,23,19,1990,9,"female",112,840,769,4105,1741,3259,912,846,829
1236012,29,5,1984,6,"male",261,48,39,0,1,0,0,0,1
1236032,50,19,1963,1,"female",562,24,16,0,5,0,2,0,3
1236036,33,11,1980,1,"male",493,35,27,0,0,0,0,0,0
1236048,81,15,1932,3,"male",493,44,29,0,28,0,21,0,7
1236095,23,10,1990,3,"male",525,99,95,0,3,0,1,0,2
1236097,50,25,1963,5,"female",786,350,207,30,29,0,3,30,26
1236108,18,2,1995,10,"female",236,258,209,34,95,19,18,15,77
1236130,16,15,1997,7,"male",244,141,65,27,17,27,17,0,0
1236147,41,7,1972,11,"male",325,27,26,7,26,7,4,0,22
1236156,33,22,1980,2,"male",13,21,18,2,0,2,0,0,0
1236161,27,24,1986,7,"female",925,1146,905,36,364,36,236,0,128
1236194,24,7,1989,10,"male",91,64,38,90,61,90,33,0,28
1236199,15,23,1998,7,"male",485,159,112,12,1,1,0,11,1
1236209,48,30,1965,1,"male",600,125,68,66,20,0,8,66,12
1236232,18,17,1995,3,"male",216,141,96,0,0,0,0,0,0
1236258,24,30,1989,8,"male",94,10,7,2,4,0,4,2,0
1236272,14,31,1999,5,"male",433,78,53,1,0,0,0,1,0
1236287,53,1,1960,4,"male",43,24,17,8,8,7,5,1,3
1236296,18,18,1995,10,"male",54,229,214,55,59,55,24,0,35
1236346,28,25,1985,11,"male",349,66,47,6,5,6,5,0,0
1236349,16,7,1997,11,"male",100,13,9,0,0,0,0,0,0
1236373,15,4,1998,2,"female",202,6,5,3,0,3,0,0,0
1236374,23,1,1990,1,"male",251,56,37,67,0,61,0,6,0
1236394,25,14,1988,12,"male",589,23,17,0,0,0,0,0,0
1236397,36,20,1977,12,"male",116,198,154,30,61,30,44,0,17
1236398,108,29,1905,1,"female",1858,289,84,50,31,50,15,0,16
1236401,30,6,1983,4,"female",280,211,49,721,214,721,182,0,32
1236439,39,30,1974,7,"male",578,122,78,24,49,0,38,24,11
1236444,18,15,1995,7,"female",124,283,253,13,15,13,7,0,8
1236451,28,16,1985,12,"female",26,25,20,143,12,142,11,1,1
1236454,68,8,1945,4,"male",17,22,20,0,0,0,0,0,0
1236456,34,2,1979,2,"female",184,37,25,84,22,84,4,0,18
1236502,108,1,1905,1,"male",1193,72,24,1,0,0,0,1,0
1236507,42,18,1971,4,"male",366,60,37,163,20,163,5,0,15
1236526,47,10,1966,11,"female",1328,46,13,1,27,1,19,0,8
1236567,22,13,1991,4,"female",330,54,26,2,0,2,0,0,0
1236568,28,9,1985,8,"female",386,188,123,0,0,0,0,0,0
1236578,14,28,1999,9,"female",225,335,204,156,237,156,232,0,5
1236586,29,7,1984,4,"female",589,237,85,26,3,26,2,0,1
1236644,17,15,1996,7,"female",454,656,461,132,185,132,91,0,94
1236660,19,19,1994,2,"male",275,108,74,42,64,25,42,17,22
1236661,68,13,1945,2,"male",1539,1407,970,12,50,12,30,0,20
1236694,30,21,1983,9,"male",211,6,6,4,6,4,6,0,0
1236695,80,19,1933,12,"male",347,731,268,146,169,146,149,0,20
1236697,47,1,1966,3,"male",391,64,49,5,20,0,17,5,3
1236714,18,4,1995,9,"male",686,1830,716,1,22,0,3,1,19
1236719,33,31,1980,3,"male",266,29,18,2,1,2,1,0,0
1236723,26,5,1987,4,"male",57,27,11,5,5,4,4,1,1
1236738,23,1,1990,2,"female",769,573,402,3931,2620,336,471,3595,2149
1236748,29,23,1984,3,"female",56,26,25,0,0,0,0,0,0
1236757,50,12,1963,10,"female",905,315,142,21,69,20,42,1,27
1236798,42,4,1971,5,"female",571,73,24,193,4,0,1,193,3
1236805,32,30,1981,4,"female",473,5,4,32,17,10,3,22,14
1236819,19,1,1994,1,"female",236,15,10,7,17,7,14,0,3
1236854,39,25,1974,5,"female",443,5,4,1,0,1,0,0,0
1236857,56,30,1957,4,"female",592,70,45,1,0,1,0,0,0
1236874,37,6,1976,12,"male",103,16,9,32,20,32,18,0,2
1236878,17,14,1996,5,"male",1236,668,175,0,207,0,76,0,131
1236913,53,6,1960,4,"female",493,585,388,365,496,0,85,365,411
1236937,48,14,1965,7,"female",508,274,192,1842,1033,1842,433,0,600
1236941,65,27,1948,12,"female",117,28,23,1,2,0,0,1,2
1236952,28,1,1985,1,"female",903,1,0,0,0,0,0,0,0
1236959,19,23,1994,10,"male",105,81,59,8,5,8,4,0,1
1236966,21,13,1992,6,"male",548,7,4,1,0,0,0,1,0
1237067,22,21,1991,4,"male",189,13,12,0,0,0,0,0,0
1237095,30,23,1983,12,"female",301,35,18,20,10,20,8,0,2
1237099,39,22,1974,5,"male",289,84,69,1,0,0,0,1,0
1237143,29,29,1984,1,"female",841,115,45,32,4,32,2,0,2
1237205,69,9,1944,6,"female",1209,13,2,28,21,28,12,0,9
1237217,24,13,1989,7,"female",703,80,66,1,0,1,0,0,0
1237223,20,29,1993,1,"male",94,227,191,2,4,2,4,0,0
1237224,113,15,1900,7,"male",1294,643,350,54,2,0,0,54,2
1237247,16,10,1997,9,"male",245,3,3,0,12,0,10,0,2
1237273,94,13,1919,5,"male",1727,2200,1552,80,286,11,185,69,101
1237310,83,22,1930,9,"male",2406,160,25,2,1,2,1,0,0
1237352,33,13,1980,12,"male",759,78,12,0,2,0,2,0,0
1237359,24,19,1989,12,"male",890,63,16,51,63,51,30,0,33
1237360,26,17,1987,10,"male",389,241,191,22,37,22,30,0,7
1237377,67,20,1946,1,"male",474,54,42,24,8,24,8,0,0
1237383,52,6,1961,7,"female",152,41,25,223,82,0,23,223,59
1237386,18,11,1995,3,"female",465,391,159,227,240,167,168,60,72
1237399,62,18,1951,9,"female",671,14,2,1,0,1,0,0,0
1237417,28,17,1985,9,"male",512,895,768,0,1,0,1,0,0
1237433,56,17,1957,3,"female",1631,50,34,29,22,2,12,27,10
1237449,52,17,1961,12,"female",8,14,13,45,15,0,1,45,14
1237504,16,12,1997,11,"female",18,164,131,8,55,8,22,0,33
1237544,75,11,1938,7,"female",1110,92,43,737,116,61,84,676,32
1237552,57,1,1956,9,"male",631,34,4,0,6,0,3,0,3
1237561,19,25,1994,10,"male",356,194,140,136,26,31,3,105,23
1237572,31,9,1982,3,"male",798,112,44,13,7,13,6,0,1
1237577,18,30,1995,10,"male",7,10,9,1,0,1,0,0,0
1237604,60,4,1953,4,"male",358,0,0,0,0,0,0,0,0
1237636,100,3,1913,4,"male",1330,580,198,88,100,39,30,49,70
1237649,18,15,1995,5,"female",430,2435,1614,2840,3135,536,1061,2304,2074
1237656,58,14,1955,11,"female",1149,283,100,84,4,84,1,0,3
1237666,62,3,1951,10,"male",666,30,19,9,1,9,0,0,1
1237697,66,26,1947,11,"female",1483,159,65,71,89,0,21,71,68
1237704,29,17,1984,8,"male",1339,40,27,0,1,0,1,0,0
1237739,57,16,1956,12,"female",749,210,99,5,11,0,9,5,2
1237741,79,26,1934,11,"female",714,119,101,879,441,0,177,879,264
1237746,50,2,1963,8,"male",546,28,20,8,2,8,1,0,1
1237747,50,30,1963,1,"male",607,7,5,0,0,0,0,0,0
1237761,35,19,1978,3,"male",103,65,62,59,37,37,27,22,10
1237769,19,28,1994,10,"female",466,298,202,18,75,18,74,0,1
1237786,15,5,1998,2,"female",285,87,50,185,321,140,289,45,32
1237834,18,24,1995,6,"male",140,69,48,0,1,0,0,0,1
1237841,14,14,1999,9,"male",215,87,50,2,10,2,6,0,4
1237848,34,23,1979,10,"male",166,196,18,0,2,0,0,0,2
1237875,45,30,1968,1,"male",307,132,64,35,5,0,2,35,3
1237915,38,8,1975,6,"male",779,22,1,6,0,6,0,0,0
1237916,32,18,1981,3,"male",354,9,9,1,1,0,0,1,1
1237931,58,21,1955,5,"male",88,14,5,11,0,11,0,0,0
1237943,43,8,1970,3,"male",471,51,22,0,0,0,0,0,0
1237980,52,13,1961,11,"male",339,35,30,4,22,0,7,4,15
1238006,38,22,1975,10,"male",2202,226,129,289,1420,94,973,195,447
1238021,19,25,1994,11,"female",658,569,363,2132,1147,0,777,2132,370
1238038,46,30,1967,6,"male",84,8,7,1,0,1,0,0,0
1238044,65,12,1948,10,"female",509,11,5,4,2,0,0,4,2
1238073,58,8,1955,8,"male",549,12,5,0,0,0,0,0,0
1238093,16,22,1997,12,"male",221,178,92,21,0,21,0,0,0
1238111,47,15,1966,2,"female",149,48,36,239,184,239,165,0,19
1238141,17,8,1996,2,"male",664,12,8,0,0,0,0,0,0
1238165,45,28,1968,7,"male",456,1568,1297,6,18,6,17,0,1
1238169,15,24,1998,8,"male",407,164,108,55,49,40,25,15,24
1238182,38,7,1975,1,"male",222,73,45,16,24,16,14,0,10
1238187,23,5,1990,2,"male",735,206,141,0,1,0,1,0,0
1238201,17,17,1996,3,"male",199,85,21,0,0,0,0,0,0
1238216,76,13,1937,5,"female",449,15,8,2,0,2,0,0,0
1238227,103,5,1910,11,"male",1030,799,491,1,8,1,8,0,0
1238239,34,13,1979,4,"male",724,30,8,1,2,1,1,0,1
1238261,16,18,1997,11,"male",384,113,85,6,8,4,0,2,8
1238262,36,20,1977,7,"male",610,76,68,12,3,12,2,0,1
1238268,51,4,1962,9,"female",1725,225,149,2135,1121,635,852,1500,269
1238270,66,9,1947,11,"female",425,25,9,10,6,10,5,0,1
1238273,21,22,1992,9,"male",213,104,55,2,0,2,0,0,0
1238309,48,14,1965,6,"female",1731,110,57,464,395,211,231,253,164
1238317,22,14,1991,2,"male",105,79,58,40,22,40,21,0,1
1238319,33,4,1980,8,"female",638,67,36,2,1,2,1,0,0
1238325,25,9,1988,12,"male",198,222,176,20,11,20,10,0,1
1238367,14,26,1999,4,"male",117,87,68,0,0,0,0,0,0
1238375,16,27,1997,2,"male",506,26,5,2,3,2,1,0,2
1238386,31,25,1982,7,"male",179,0,0,1,0,1,0,0,0
1238394,15,7,1998,2,"male",264,76,48,18,6,5,4,13,2
1238457,28,30,1985,11,"male",434,276,179,6,33,6,20,0,13
1238471,20,10,1993,8,"male",652,219,53,0,0,0,0,0,0
1238485,49,19,1964,8,"male",501,60,22,0,0,0,0,0,0
1238516,38,14,1975,6,"male",6,21,20,4,13,4,3,0,10
1238531,36,10,1977,5,"female",434,18,9,28,40,28,40,0,0
1238535,28,5,1985,3,"female",425,66,14,3,1,3,1,0,0
1238537,23,10,1990,1,"female",26,2,0,0,0,0,0,0,0
1238548,18,15,1995,10,"female",479,256,179,46,17,0,7,46,10
1238557,16,1,1997,12,"male",290,135,23,5,3,5,3,0,0
1238583,37,21,1976,5,"female",654,739,147,646,1705,500,597,146,1108
1238614,52,23,1961,2,"male",408,24,3,0,0,0,0,0,0
1238630,38,5,1975,9,"male",235,136,103,134,3,28,0,106,3
1238635,26,1,1987,1,"female",376,28,14,0,36,0,23,0,13
1238637,24,2,1989,5,"male",572,96,35,0,0,0,0,0,0
1238641,56,11,1957,3,"male",1314,66,24,162,62,0,19,162,43
1238660,103,9,1910,3,"male",1004,1326,822,8,4,7,3,1,1
1238690,16,20,1997,1,"female",478,778,270,2504,514,111,297,2393,217
1238701,53,12,1960,9,"male",471,202,146,225,346,225,171,0,175
1238710,22,6,1991,8,"male",418,107,65,27,39,27,13,0,26
1238733,22,4,1991,11,"female",613,88,12,0,2,0,1,0,1
1238734,18,1,1995,1,"male",118,27,21,2,1,2,1,0,0
1238737,18,6,1995,8,"female",953,2569,1275,3810,3571,43,1244,3767,2327
1238747,62,8,1951,3,"male",961,140,95,195,39,73,19,122,20
1238780,28,12,1985,12,"male",343,54,41,0,0,0,0,0,0
1238797,26,29,1987,12,"male",664,187,165,12,0,11,0,1,0
1238798,55,23,1958,7,"male",1453,152,108,4,7,0,1,4,6
1238800,21,3,1992,1,"female",200,48,27,0,0,0,0,0,0
1238807,74,20,1939,10,"female",242,72,44,8,11,8,2,0,9
1238835,77,18,1936,4,"male",1382,527,301,9,9,3,5,6,4
1238849,44,11,1969,3,"female",233,47,31,222,32,119,12,103,20
1238862,21,10,1992,10,"male",210,118,108,0,1,0,0,0,1
1238873,22,7,1991,12,"male",1314,174,119,17,1,0,0,17,1
1238936,26,6,1987,9,"female",256,6,4,582,7,582,0,0,7
1238945,36,21,1977,6,"female",1994,186,42,30,11,30,9,0,2
1238971,51,13,1962,9,"female",983,217,68,175,72,51,22,124,50
1238994,31,3,1982,5,"male",321,437,426,4,8,4,5,0,3
1238997,93,30,1920,11,"male",1740,113,59,70,15,70,8,0,7
1239000,28,9,1985,12,"male",463,323,253,4,35,4,33,0,2
1239006,21,11,1992,6,"female",730,415,331,927,472,894,246,33,226
1239018,96,29,1917,8,"male",886,121,96,1,2,0,1,1,1
1239034,68,11,1945,5,"male",696,294,237,10,84,10,64,0,20
1239061,75,5,1938,9,"male",2338,113,46,1,1,0,1,1,0
1239074,14,3,1999,6,"male",227,76,35,1,0,0,0,1,0
1239078,25,18,1988,5,"female",202,113,91,12,3,7,1,5,2
1239091,103,26,1910,7,"female",1049,104,63,65,61,65,52,0,9
1239094,21,1,1992,10,"male",58,58,45,0,0,0,0,0,0
1239098,32,3,1981,3,"male",425,2,0,0,0,0,0,0,0
1239105,19,15,1994,1,"male",110,320,298,9,3,9,2,0,1
1239116,28,10,1985,1,"female",289,132,86,527,6,522,3,5,3
1239129,26,8,1987,9,"female",516,17,6,0,0,0,0,0,0
1239132,59,20,1954,7,"female",823,95,59,322,29,265,22,57,7
1239168,30,8,1983,10,"male",512,76,67,0,0,0,0,0,0
1239179,33,1,1980,1,"male",368,62,54,9,5,9,5,0,0
1239217,49,28,1964,11,"female",1608,129,46,170,175,57,94,113,81
1239286,14,13,1999,4,"female",287,895,768,1,3,1,3,0,0
1239287,18,13,1995,2,"male",7,2,2,0,0,0,0,0,0
1239318,17,1,1996,3,"female",542,3,1,0,0,0,0,0,0
1239322,71,1,1942,6,"male",1246,28,17,8,21,8,20,0,1
1239331,25,27,1988,5,"male",403,188,154,5,5,5,5,0,0
1239340,38,20,1975,10,"male",89,43,41,79,27,79,21,0,6
1239345,45,7,1968,3,"male",268,15,3,1,4,0,0,1,4
1239355,22,10,1991,10,"female",595,82,42,90,32,90,30,0,2
1239373,14,29,1999,5,"female",487,432,333,313,217,122,117,191,100
1239383,23,5,1990,6,"male",130,4,3,0,0,0,0,0,0
1239385,27,12,1986,2,"female",816,9,8,0,0,0,0,0,0
1239399,16,21,1997,3,"female",163,168,42,3,31,3,25,0,6
1239401,20,21,1993,8,"male",132,40,25,0,0,0,0,0,0
1239406,29,16,1984,12,"male",206,75,68,0,4,0,3,0,1
1239413,60,31,1953,1,"male",397,27,21,2,1,2,1,0,0
1239484,24,15,1989,10,"male",50,9,6,0,0,0,0,0,0
1239519,16,5,1997,9,"male",438,194,79,157,22,8,13,149,9
1239521,50,31,1963,10,"female",617,23,8,7,2,2,2,5,0
1239552,34,7,1979,1,"male",892,99,84,0,0,0,0,0,0
1239592,18,6,1995,5,"male",6,14,10,0,0,0,0,0,0
1239607,36,4,1977,7,"female",884,282,76,42,94,42,25,0,69
1239623,13,8,2000,4,"female",272,97,73,19,6,19,4,0,2
1239641,106,20,1907,4,"male",1193,4,0,0,0,0,0,0,0
1239643,31,11,1982,9,"female",783,48,34,5,4,0,1,5,3
1239684,19,8,1994,2,"female",838,31,10,7,0,7,0,0,0
1239685,64,13,1949,6,"female",1320,1078,646,1138,2251,359,698,779,1553
1239690,18,24,1995,10,"female",894,500,211,12,17,8,11,4,6
1239699,67,12,1946,11,"female",1025,45,22,547,59,0,9,547,50
1239702,13,18,2000,3,"male",128,8,3,0,1,0,0,0,1
1239719,16,5,1997,3,"male",489,272,143,0,1,0,0,0,1
1239771,56,22,1957,8,"female",1502,100,63,1206,346,1206,102,0,244
1239775,23,11,1990,11,"male",572,194,82,50,85,49,78,1,7
1239804,20,3,1993,7,"male",1073,210,16,0,8,0,3,0,5
1239814,21,8,1992,6,"male",341,799,744,1,4,1,1,0,3
1239817,68,24,1945,8,"male",526,324,206,11,7,11,7,0,0
1239820,24,20,1989,11,"male",85,13,13,0,1,0,1,0,0
1239860,22,22,1991,11,"male",386,200,169,2,2,2,2,0,0
1239880,16,17,1997,9,"female",55,71,45,32,9,30,3,2,6
1239881,37,16,1976,8,"female",226,61,51,329,136,307,74,22,62
1239897,15,24,1998,4,"female",461,218,69,933,1225,161,1082,772,143
1239905,25,5,1988,4,"male",542,162,127,89,28,82,14,7,14
1239911,54,6,1959,5,"female",218,74,36,7,6,0,1,7,5
1239912,25,12,1988,1,"male",228,25,17,10,16,10,12,0,4
1239923,23,28,1990,10,"male",86,46,41,0,0,0,0,0,0
1239931,17,12,1996,4,"male",185,54,35,0,1,0,1,0,0
1239950,31,2,1982,2,"male",262,144,122,0,0,0,0,0,0
1239954,33,5,1980,5,"male",272,97,90,0,1,0,1,0,0
1239957,26,15,1987,6,"female",1392,314,193,422,351,135,189,287,162
1239959,17,24,1996,7,"female",7,41,34,2,13,2,6,0,7
1239966,35,3,1978,6,"female",396,11,7,2,0,2,0,0,0
1239982,23,20,1990,8,"male",241,93,76,5,3,0,3,5,0
1239986,17,13,1996,3,"male",39,42,39,45,22,45,15,0,7
1239990,17,24,1996,2,"female",400,1424,508,498,1043,290,486,208,557
1239997,25,16,1988,9,"female",28,6,6,2,3,2,0,0,3
1240015,25,10,1988,10,"male",95,114,98,0,10,0,7,0,3
1240017,15,14,1998,3,"male",286,39,28,0,0,0,0,0,0
1240020,18,8,1995,7,"male",228,51,21,7,20,4,7,3,13
1240027,19,3,1994,1,"female",1176,1696,1024,284,387,56,198,228,189
1240028,52,16,1961,11,"male",971,4,3,0,0,0,0,0,0
1240029,23,3,1990,10,"female",162,5,1,0,0,0,0,0,0
1240043,17,22,1996,1,"male",223,130,121,0,0,0,0,0,0
1240052,35,12,1978,1,"male",654,101,25,149,46,118,18,31,28
1240053,21,29,1992,10,"male",668,143,68,27,7,26,5,1,2
1240080,14,4,1999,7,"male",196,253,190,157,48,152,45,5,3
1240111,29,16,1984,11,"male",1445,93,56,3,1,3,1,0,0
1240112,21,23,1992,11,"male",732,318,264,3,2,0,2,3,0
1240129,18,5,1995,10,"male",519,2,1,0,0,0,0,0,0
1240135,21,19,1992,4,"male",387,249,242,0,32,0,16,0,16
1240145,106,17,1907,4,"male",1511,238,107,34,9,34,9,0,0
1240148,52,30,1961,12,"male",938,143,67,35,15,10,9,25,6
1240165,34,16,1979,2,"male",320,0,0,0,0,0,0,0,0
1240170,59,18,1954,11,"female",522,51,27,0,0,0,0,0,0
1240196,27,10,1986,2,"male",103,295,236,1528,432,1528,211,0,221
1240220,25,20,1988,7,"male",82,45,45,1,5,1,0,0,5
1240225,24,15,1989,3,"male",327,20,13,32,18,23,17,9,1
1240248,23,22,1990,1,"male",82,35,14,300,0,289,0,11,0
1240279,33,19,1980,3,"female",593,32,6,10,9,5,6,5,3
1240288,46,7,1967,2,"male",322,4,4,0,0,0,0,0,0
1240312,101,9,1912,3,"male",454,217,188,3,1,3,1,0,0
1240314,29,2,1984,10,"male",487,44,36,42,21,42,17,0,4
1240318,21,10,1992,4,"male",621,449,313,141,125,141,104,0,21
1240333,17,5,1996,12,"male",683,249,220,0,2,0,1,0,1
1240358,17,11,1996,12,"male",650,206,150,23,6,18,5,5,1
1240367,26,13,1987,6,"male",352,2,1,0,0,0,0,0,0
1240377,37,25,1976,11,"female",555,242,167,1979,1832,807,547,1172,1285
1240382,22,21,1991,4,"male",404,136,51,0,1,0,1,0,0
1240415,20,20,1993,3,"female",185,216,47,32,124,32,81,0,43
1240423,19,18,1994,6,"male",143,370,344,29,41,29,21,0,20
1240446,64,2,1949,10,"male",441,52,6,2,14,2,9,0,5
1240450,107,5,1906,1,"female",637,953,794,176,180,158,38,18,142
1240469,104,14,1909,1,"female",1465,408,182,213,241,29,107,184,134
1240482,55,5,1958,11,"female",525,64,42,111,37,111,33,0,4
1240490,16,13,1997,12,"male",158,253,176,491,278,226,233,265,45
1240499,15,1,1998,6,"female",21,2,2,9,6,0,5,9,1
1240530,31,31,1982,3,"female",467,1037,107,2883,572,2883,514,0,58
1240537,45,25,1968,9,"male",1955,7,2,3,3,2,3,1,0
1240541,34,29,1979,9,"female",1238,38,22,39,152,36,130,3,22
1240547,80,30,1933,4,"male",472,71,20,212,23,0,8,212,15
1240560,65,25,1948,11,"male",1168,109,27,3,18,0,9,3,9
1240575,93,30,1920,4,"male",1635,707,507,85,101,1,74,84,27
1240616,29,5,1984,10,"female",111,137,114,10,6,10,3,0,3
1240624,65,29,1948,8,"male",348,4,3,0,0,0,0,0,0
1240647,15,16,1998,1,"male",494,764,459,40,148,34,123,6,25
1240659,30,6,1983,2,"male",489,873,779,2,1,2,1,0,0
1240671,56,29,1957,10,"female",1611,110,43,1,7,1,6,0,1
1240698,40,13,1973,8,"female",668,72,39,539,256,85,164,454,92
1240778,54,13,1959,4,"male",1338,55,14,2,3,2,1,0,2
1240779,17,15,1996,11,"male",549,183,63,1,0,1,0,0,0
1240780,23,23,1990,2,"male",556,109,104,4,1,4,1,0,0
1240801,22,8,1991,8,"female",567,87,36,12,16,12,12,0,4
1240816,25,1,1988,1,"male",205,89,64,2,6,2,0,0,6
1240835,17,17,1996,9,"male",242,813,504,9965,8042,534,3133,9431,4909
1240836,19,18,1994,2,"male",322,34,20,0,0,0,0,0,0
1240845,62,10,1951,2,"female",505,14,7,0,0,0,0,0,0
1240852,14,7,1999,5,"female",369,347,236,2,0,2,0,0,0
1240869,36,1,1977,4,"male",453,40,24,0,0,0,0,0,0
1240891,20,11,1993,5,"male",616,765,523,74,178,74,118,0,60
1240892,19,15,1994,2,"male",598,152,34,3,4,0,0,3,4
1240898,14,18,1999,2,"female",420,232,119,1267,18,241,13,1026,5
1240927,38,10,1975,1,"male",387,5,5,0,0,0,0,0,0
1240932,21,9,1992,8,"male",327,282,68,0,0,0,0,0,0
1240933,108,3,1905,1,"male",880,122,48,129,43,129,27,0,16
1240950,17,26,1996,9,"male",292,467,252,47,156,47,66,0,90
1240951,62,16,1951,10,"female",879,259,148,36,50,0,5,36,45
1240963,24,19,1989,9,"male",361,201,179,21,3,21,3,0,0
1240977,50,20,1963,8,"female",887,19,14,772,11,286,5,486,6
1240985,78,16,1935,1,"male",909,26,17,0,0,0,0,0,0
1241023,31,8,1982,9,"male",227,80,63,79,39,72,17,7,22
1241072,28,1,1985,10,"male",597,86,63,0,6,0,5,0,1
1241080,14,30,1999,12,"male",221,264,156,44,73,11,29,33,44
1241084,50,1,1963,11,"female",72,22,19,115,6,115,3,0,3
1241119,69,7,1944,11,"female",674,65,49,4,3,4,3,0,0
1241133,14,27,1999,4,"male",308,99,54,0,1,0,1,0,0
1241151,29,8,1984,6,"female",1182,121,84,128,437,118,290,10,147
1241165,26,2,1987,7,"female",547,106,64,0,17,0,7,0,10
1241170,68,16,1945,4,"male",155,54,41,124,8,124,7,0,1
1241178,24,1,1989,1,"male",353,47,20,1,0,1,0,0,0
1241223,15,2,1998,2,"female",395,56,43,261,61,261,50,0,11
1241251,47,17,1966,7,"male",310,43,34,3,0,0,0,3,0
1241265,18,6,1995,2,"male",226,200,120,54,67,54,8,0,59
1241269,54,30,1959,8,"male",536,28,20,7,20,0,13,7,7
1241273,23,13,1990,2,"male",558,2982,1464,0,39,0,25,0,14
1241277,55,20,1958,12,"female",359,73,21,727,288,36,192,691,96
1241310,39,15,1974,6,"male",732,95,67,90,0,90,0,0,0
1241313,17,26,1996,2,"female",494,195,72,4,2,0,2,4,0
1241324,26,7,1987,1,"male",398,269,194,9,119,9,68,0,51
1241327,25,30,1988,10,"female",735,238,76,720,150,720,138,0,12
1241356,66,6,1947,3,"female",1177,45,15,8,1,0,0,8,1
1241361,47,15,1966,3,"male",300,38,33,0,3,0,2,0,1
1241369,19,10,1994,9,"female",590,704,168,79,217,74,63,5,154
1241370,17,20,1996,5,"female",56,403,101,274,727,252,472,22,255
1241375,65,13,1948,12,"male",1003,132,61,95,132,0,62,95,70
1241407,21,28,1992,4,"female",146,94,71,414,27,405,23,9,4
1241430,88,15,1925,3,"male",1863,259,83,32,67,0,21,32,46
1241436,43,23,1970,1,"male",528,35,26,9,43,9,22,0,21
1241438,62,20,1951,4,"male",1084,137,89,0,8,0,3,0,5
1241440,33,19,1980,1,"male",1376,41,30,77,0,47,0,30,0
1241455,32,17,1981,6,"female",1326,89,52,90,46,90,23,0,23
1241473,51,22,1962,11,"male",53,7,4,0,0,0,0,0,0
1241494,54,25,1959,8,"female",360,23,19,0,1,0,1,0,0
1241497,60,13,1953,7,"male",1707,25,10,1,15,0,1,1,14
1241524,51,1,1962,4,"female",384,182,92,7,42,7,12,0,30
1241526,42,1,1971,1,"male",294,33,24,22,1,22,0,0,1
1241572,57,10,1956,7,"male",921,89,63,34,74,6,53,28,21
1241577,41,31,1972,10,"female",291,97,49,0,0,0,0,0,0
1241587,46,5,1967,10,"female",588,204,130,553,67,533,46,20,21
1241611,68,9,1945,3,"male",1755,149,31,28,14,28,6,0,8
1241616,31,30,1982,8,"female",508,68,28,229,229,229,200,0,29
1241689,28,10,1985,10,"male",301,86,53,173,79,46,53,127,26
1241754,21,2,1992,2,"male",890,180,137,1,1,0,1,1,0
1241771,37,10,1976,10,"female",417,84,55,1,6,1,6,0,0
1241774,41,21,1972,6,"female",477,31,23,14,31,0,4,14,27
1241805,24,7,1989,8,"male",407,37,19,5,34,5,23,0,11
1241820,30,13,1983,6,"male",722,27,13,0,0,0,0,0,0
1241839,18,19,1995,12,"male",624,108,56,0,19,0,11,0,8
1241845,107,5,1906,1,"female",556,124,54,44,34,0,0,44,34
1241847,17,5,1996,10,"male",494,531,420,601,574,508,507,93,67
1241852,31,1,1982,2,"male",641,129,63,2,20,0,11,2,9
1241875,19,14,1994,8,"female",523,108,22,7,3,7,2,0,1
1241878,53,5,1960,5,"male",807,53,13,0,1,0,0,0,1
1241897,16,24,1997,3,"male",315,164,91,5,1,5,1,0,0
1241911,108,17,1905,10,"male",716,527,209,17,11,17,6,0,5
1241924,63,6,1950,5,"female",159,3,1,0,0,0,0,0,0
1241928,80,14,1933,4,"male",189,243,180,18,1,16,1,2,0
1241931,28,5,1985,1,"female",598,60,47,2,0,0,0,2,0
1241934,22,15,1991,3,"male",404,248,176,12,4,12,0,0,4
1241954,48,23,1965,3,"female",756,92,75,519,292,494,168,25,124
1241986,26,1,1987,1,"male",167,56,54,8,88,8,53,0,35
1241995,17,25,1996,4,"female",592,233,60,0,27,0,17,0,10
1242000,94,31,1919,1,"female",1382,430,162,27,36,26,24,1,12
1242019,75,29,1938,1,"female",517,234,153,426,254,426,124,0,130
1242050,56,17,1957,11,"male",882,95,47,1,5,1,3,0,2
1242057,28,29,1985,3,"male",328,45,20,0,12,0,10,0,2
1242084,23,4,1990,9,"female",1627,3095,474,222,312,1,218,221,94
1242093,108,8,1905,1,"female",1064,229,156,332,42,332,23,0,19
1242108,22,17,1991,7,"female",140,6,3,17,0,17,0,0,0
1242134,18,9,1995,11,"female",88,169,154,74,77,72,56,2,21
1242140,25,21,1988,12,"male",586,160,127,6,6,6,6,0,0
1242179,47,25,1966,9,"female",183,52,30,91,140,91,112,0,28
1242197,21,6,1992,9,"male",72,8,5,41,2,41,1,0,1
1242199,49,8,1964,12,"female",1487,203,133,1441,371,1441,202,0,169
1242235,18,8,1995,4,"male",409,204,45,18,5,18,4,0,1
1242246,57,22,1956,6,"male",697,17,5,5,4,0,0,5,4
1242252,23,24,1990,12,"male",676,511,345,9,0,9,0,0,0
1242272,53,29,1960,10,"male",588,13,6,12,12,12,12,0,0
1242286,15,19,1998,3,"male",167,9,8,3,0,0,0,3,0
1242294,17,5,1996,2,"male",54,1,1,0,0,0,0,0,0
1242367,23,28,1990,8,"male",327,110,82,13,31,13,27,0,4
1242377,23,15,1990,7,"male",115,5,2,0,0,0,0,0,0
1242403,18,10,1995,1,"female",337,257,200,158,76,46,44,112,32
1242432,45,15,1968,5,"female",193,20,16,1568,416,208,5,1360,411
1242435,16,14,1997,3,"male",320,87,18,6,9,6,9,0,0
1242475,41,1,1972,9,"female",429,50,32,39,13,37,8,2,5
1242494,29,7,1984,5,"female",880,437,382,373,358,172,206,201,152
1242518,15,1,1998,12,"female",916,204,161,2031,1817,226,798,1805,1019
1242558,113,1,1900,12,"male",1794,114,51,106,159,85,113,21,46
1242563,19,15,1994,9,"male",225,20,11,14,2,0,0,14,2
1242568,90,23,1923,9,"male",122,0,0,0,0,0,0,0,0
1242591,63,24,1950,10,"female",693,20,11,0,0,0,0,0,0
1242609,25,1,1988,1,"male",59,8,7,0,0,0,0,0,0
1242618,68,5,1945,4,"male",858,767,554,1202,249,1202,182,0,67
1242624,26,1,1987,1,"female",358,111,48,13,62,13,28,0,34
1242635,79,12,1934,8,"female",1290,28,14,13,3,0,0,13,3
1242646,16,13,1997,7,"male",440,846,690,60,37,42,23,18,14
1242649,23,9,1990,7,"male",129,45,29,1,0,1,0,0,0
1242662,18,23,1995,1,"female",219,534,369,71,105,71,95,0,10
1242706,28,15,1985,11,"male",465,10,4,0,0,0,0,0,0
1242764,23,8,1990,8,"male",360,31,31,0,0,0,0,0,0
1242765,23,5,1990,11,"male",383,94,76,6,0,0,0,6,0
1242786,23,10,1990,5,"female",395,212,76,42,84,32,48,10,36
1242816,26,25,1987,3,"female",115,403,306,142,345,90,247,52,98
1242818,30,11,1983,1,"male",1418,35,10,9,0,9,0,0,0
1242826,24,5,1989,9,"male",1300,72,21,10,2,10,1,0,1
1242866,19,12,1994,12,"male",358,368,311,49,276,49,216,0,60
1242873,17,13,1996,6,"female",193,153,113,14,55,13,49,1,6
1242875,19,4,1994,1,"female",203,624,194,192,132,192,112,0,20
1242883,85,27,1928,4,"male",1960,220,99,153,133,0,19,153,114
1242886,39,10,1974,10,"male",11,10,10,2,1,2,1,0,0
1242888,33,2,1980,9,"female",97,243,128,90,45,90,28,0,17
1242914,19,1,1994,7,"female",156,161,152,363,69,350,66,13,3
1242933,25,4,1988,10,"male",835,343,253,2,2,2,2,0,0
1242957,62,18,1951,8,"male",295,3,2,30,0,30,0,0,0
1242980,44,25,1969,6,"male",611,118,12,26,7,0,1,26,6
1242989,82,24,1931,2,"male",576,45,26,38,7,0,6,38,1
1242998,20,25,1993,2,"male",90,48,36,0,0,0,0,0,0
1243035,24,12,1989,4,"male",55,56,47,0,0,0,0,0,0
1243048,29,5,1984,7,"male",131,3,3,0,0,0,0,0,0
1243066,62,18,1951,8,"female",798,251,153,444,98,62,36,382,62
1243091,14,21,1999,3,"male",223,161,85,69,2,34,1,35,1
1243092,21,26,1992,5,"male",310,124,89,3,17,3,9,0,8
1243107,41,3,1972,12,"male",35,1,1,3,0,3,0,0,0
1243111,42,20,1971,10,"female",463,51,37,4,20,4,16,0,4
1243116,32,6,1981,8,"female",112,38,24,0,0,0,0,0,0
1243122,24,19,1989,12,"male",374,274,243,1,0,1,0,0,0
1243158,26,10,1987,9,"male",75,37,29,0,0,0,0,0,0
1243160,62,1,1951,11,"male",1230,164,130,12,3,0,3,12,0
1243234,29,14,1984,8,"female",356,278,198,188,207,156,84,32,123
1243236,17,6,1996,7,"female",56,4,1,0,0,0,0,0,0
1243241,18,30,1995,11,"male",82,73,70,4,0,4,0,0,0
1243245,18,2,1995,5,"male",349,254,211,0,1,0,1,0,0
1243263,108,2,1905,11,"female",1203,991,156,250,439,250,324,0,115
1243313,16,18,1997,4,"male",448,0,0,50,0,50,0,0,0
1243314,14,14,1999,1,"female",366,209,189,0,0,0,0,0,0
1243388,21,31,1992,10,"female",381,224,106,129,118,121,50,8,68
1243416,67,7,1946,8,"female",520,108,94,36,26,0,12,36,14
1243455,18,20,1995,4,"male",211,76,23,10,188,10,138,0,50
1243459,39,18,1974,10,"female",212,56,49,29,17,19,17,10,0
1243542,63,7,1950,12,"male",465,2,0,0,0,0,0,0,0
1243603,24,3,1989,6,"male",361,206,134,223,7,223,4,0,3
1243620,24,15,1989,5,"female",61,33,13,38,48,38,39,0,9
1243631,25,1,1988,1,"male",12,0,0,1,0,1,0,0,0
1243641,18,9,1995,11,"male",149,85,68,79,37,79,22,0,15
1243643,33,13,1980,11,"female",445,20,16,13,0,13,0,0,0
1243644,103,17,1910,6,"male",814,1605,1048,87,47,87,39,0,8
1243647,18,8,1995,2,"male",511,141,101,42,8,5,5,37,3
1243650,36,30,1977,12,"male",520,40,9,2,11,0,7,2,4
1243652,34,4,1979,12,"female",253,50,21,5,2,5,2,0,0
1243670,20,5,1993,2,"male",256,66,47,1,1,1,1,0,0
1243677,19,6,1994,3,"male",651,262,190,0,0,0,0,0,0
1243707,26,10,1987,3,"male",590,44,40,0,1,0,0,0,1
1243711,49,2,1964,2,"male",1046,49,35,0,0,0,0,0,0
1243729,19,30,1994,7,"male",251,168,121,37,4,30,3,7,1
1243740,16,1,1997,1,"male",329,121,66,0,0,0,0,0,0
1243756,20,6,1993,4,"female",292,240,113,105,66,103,31,2,35
1243757,108,5,1905,10,"male",1429,593,192,25,22,1,8,24,14
1243795,26,9,1987,8,"female",119,17,13,98,48,90,19,8,29
1243799,50,10,1963,9,"male",1370,125,50,2,2,2,2,0,0
1243802,94,21,1919,4,"male",315,300,232,602,259,602,220,0,39
1243839,50,22,1963,9,"female",508,58,37,507,220,507,155,0,65
1243901,59,25,1954,12,"male",1005,139,34,2,11,0,7,2,4
1243909,26,1,1987,1,"male",531,146,131,0,0,0,0,0,0
1243950,57,27,1956,12,"female",1405,223,150,512,440,508,363,4,77
1243952,23,25,1990,1,"male",1273,334,243,66,18,66,14,0,4
1243956,27,1,1986,1,"male",4,28,26,4,86,4,66,0,20
1243990,33,25,1980,8,"female",1100,213,146,631,105,631,48,0,57
1244001,26,25,1987,12,"male",541,70,29,6,21,5,9,1,12
1244017,25,2,1988,1,"male",340,1,1,1,0,0,0,1,0
1244033,74,7,1939,5,"male",867,15,11,40,27,0,10,40,17
1244046,19,22,1994,2,"male",609,146,88,0,0,0,0,0,0
1244067,24,11,1989,6,"male",469,151,98,86,357,70,164,16,193
1244088,16,10,1997,5,"male",231,327,276,2,170,0,12,2,158
1244089,62,3,1951,6,"female",547,38,25,64,14,64,8,0,6
1244119,24,20,1989,8,"male",573,163,97,52,65,43,32,9,33
1244149,69,16,1944,5,"female",476,54,28,14,23,0,2,14,21
1244163,39,20,1974,6,"male",81,6,5,22,0,22,0,0,0
1244174,22,24,1991,12,"female",384,316,30,0,7,0,6,0,1
1244198,38,16,1975,7,"male",385,33,26,25,23,24,11,1,12
1244220,47,12,1966,2,"male",422,3,3,1,0,1,0,0,0
1244243,35,19,1978,12,"male",145,15,4,43,15,43,15,0,0
1244244,33,6,1980,2,"male",414,36,16,94,51,0,7,94,44
1244261,13,4,2000,2,"male",229,83,70,1,10,0,5,1,5
1244273,31,22,1982,9,"female",172,15,10,4,3,4,3,0,0
1244292,51,7,1962,10,"male",394,36,23,2,1,2,1,0,0
1244332,113,29,1900,9,"male",1424,781,691,215,9,215,9,0,0
1244334,47,23,1966,4,"female",1127,69,33,114,162,114,54,0,108
1244340,32,26,1981,6,"female",540,75,50,2333,1440,1802,1083,531,357
1244352,16,24,1997,5,"male",762,261,148,5,0,0,0,5,0
1244356,18,20,1995,3,"male",168,114,6,2,9,2,7,0,2
1244389,15,4,1998,3,"male",566,425,223,21,35,21,24,0,11
1244412,71,27,1942,3,"female",921,17,12,4,6,0,4,4,2
1244421,98,5,1915,9,"male",697,2668,644,814,299,109,272,705,27
1244426,19,1,1994,1,"male",396,4770,639,1345,1951,1279,1686,66,265
1244458,17,3,1996,10,"male",355,262,189,339,145,242,113,97,32
1244486,69,19,1944,7,"male",1512,90,59,4,7,2,3,2,4
1244506,15,17,1998,6,"male",617,1,1,0,0,0,0,0,0
1244547,67,15,1946,4,"female",1534,30,11,0,0,0,0,0,0
1244573,29,7,1984,9,"female",582,10,6,0,0,0,0,0,0
1244598,45,23,1968,4,"male",661,173,112,2,25,0,8,2,17
1244619,15,19,1998,3,"male",483,230,195,34,75,3,20,31,55
1244641,18,8,1995,1,"male",315,94,71,1,5,0,4,1,1
1244646,26,10,1987,8,"female",361,161,145,1,7,0,4,1,3
1244649,51,21,1962,7,"female",61,17,15,19,1,19,0,0,1
1244662,20,21,1993,4,"male",629,149,93,8,5,8,4,0,1
1244681,20,21,1993,11,"female",434,2,1,0,0,0,0,0,0
1244682,27,10,1986,3,"male",641,35,18,14,86,5,53,9,33
1244687,35,4,1978,1,"female",399,575,430,0,0,0,0,0,0
1244715,40,4,1973,7,"female",129,28,22,81,63,81,55,0,8
1244731,19,4,1994,8,"male",259,484,206,2300,985,2253,792,47,193
1244735,32,28,1981,11,"male",462,32,6,1,0,1,0,0,0
1244736,38,24,1975,7,"male",413,39,22,0,0,0,0,0,0
1244749,14,20,1999,2,"male",76,253,228,65,51,65,26,0,25
1244753,17,17,1996,7,"male",476,1189,1005,23,30,23,27,0,3
1244755,113,12,1900,10,"female",1432,61,27,13,23,0,18,13,5
1244756,23,12,1990,9,"male",316,81,34,6,0,6,0,0,0
1244783,25,25,1988,4,"male",636,241,140,103,77,103,54,0,23
1244798,20,4,1993,2,"female",437,48,22,3,3,3,2,0,1
1244808,18,24,1995,12,"female",583,3013,972,864,2973,864,2609,0,364
1244823,101,29,1912,9,"female",562,104,66,6,3,6,3,0,0
1244829,74,22,1939,10,"female",358,100,60,5,0,0,0,5,0
1244835,22,23,1991,11,"female",321,890,642,1081,1001,1081,965,0,36
1244863,51,5,1962,5,"male",909,82,49,346,168,346,79,0,89
1244914,51,19,1962,9,"female",733,101,62,216,46,50,33,166,13
1244929,54,30,1959,1,"female",309,88,30,357,119,192,24,165,95
1244936,28,3,1985,9,"male",20,1,1,0,0,0,0,0,0
1244953,20,16,1993,12,"male",587,252,140,1,0,1,0,0,0
1244961,27,29,1986,1,"female",297,117,40,34,27,34,6,0,21
1244969,18,16,1995,8,"male",426,831,587,698,1908,698,1499,0,409
1244970,37,28,1976,4,"male",175,10,7,1,1,1,1,0,0
1244976,54,22,1959,7,"female",25,10,8,0,0,0,0,0,0
1244978,16,9,1997,9,"male",582,266,176,424,507,82,310,342,197
1244980,26,18,1987,3,"male",318,121,63,54,9,54,9,0,0
1244983,34,1,1979,7,"male",375,8,5,0,0,0,0,0,0
1244989,103,1,1910,1,"female",523,121,100,8,0,0,0,8,0
1244996,17,3,1996,7,"male",381,526,476,0,80,0,61,0,19
1244997,26,2,1987,7,"female",389,140,75,2,193,2,162,0,31
1245038,18,14,1995,3,"female",432,1977,471,475,2204,405,1456,70,748
1245055,43,6,1970,1,"female",360,380,292,87,142,87,21,0,121
1245061,23,8,1990,8,"male",59,149,88,0,0,0,0,0,0
1245062,42,10,1971,3,"male",146,19,19,1,0,0,0,1,0
1245068,16,6,1997,7,"female",523,46,38,0,0,0,0,0,0
1245069,108,12,1905,3,"male",1505,59,16,2,80,2,59,0,21
1245097,13,13,2000,5,"female",22,36,15,106,29,92,14,14,15
1245098,15,1,1998,1,"male",491,349,174,1,0,0,0,1,0
1245115,22,11,1991,10,"female",1256,596,139,710,737,179,507,531,230
1245118,48,19,1965,3,"male",534,9,4,0,0,0,0,0,0
1245215,21,16,1992,9,"male",46,41,41,108,23,97,17,11,6
1245225,15,10,1998,5,"male",625,58,29,90,8,90,5,0,3
1245248,20,27,1993,8,"male",53,19,15,2,2,2,1,0,1
1245259,50,16,1963,12,"female",884,74,37,242,177,242,75,0,102
1245264,20,16,1993,8,"male",722,44,34,3,0,3,0,0,0
1245296,18,25,1995,11,"male",668,21,17,0,2,0,0,0,2
1245297,24,1,1989,11,"male",138,171,122,2,4,2,4,0,0
1245301,51,27,1962,10,"female",281,68,35,37,121,24,65,13,56
1245304,31,15,1982,11,"male",808,695,393,16,17,16,8,0,9
1245327,17,12,1996,2,"male",133,25,19,0,1,0,1,0,0
1245342,28,21,1985,1,"male",443,10,1,0,0,0,0,0,0
1245409,24,7,1989,9,"female",126,158,61,148,96,134,89,14,7
1245446,46,10,1967,2,"male",953,30,19,0,4,0,2,0,2
1245479,21,2,1992,11,"male",225,116,46,0,0,0,0,0,0
1245499,23,4,1990,2,"male",631,207,130,317,36,74,29,243,7
1245519,69,13,1944,10,"male",630,50,39,29,83,0,27,29,56
1245523,19,14,1994,12,"female",80,1102,483,305,1005,298,505,7,500
1245611,14,6,1999,8,"male",234,172,156,4,0,4,0,0,0
1245646,85,5,1928,10,"male",111,5,4,48,9,0,0,48,9
1245658,15,8,1998,12,"male",307,38,29,0,0,0,0,0,0
1245707,17,23,1996,6,"female",1056,624,349,237,404,125,205,112,199
1245734,17,3,1996,12,"male",155,29,22,9,12,9,10,0,2
1245754,42,8,1971,7,"male",429,44,31,0,0,0,0,0,0
1245763,24,14,1989,8,"male",238,28,14,5,2,0,2,5,0
1245789,21,16,1992,10,"male",326,35,17,1,2,1,2,0,0
1245800,60,2,1953,2,"female",467,20,14,0,0,0,0,0,0
1245801,22,23,1991,9,"female",874,4297,3654,1968,2006,1825,1632,143,374
1245835,41,1,1972,3,"male",651,128,94,183,587,78,228,105,359
1245865,32,15,1981,11,"female",1217,100,48,20,42,20,28,0,14
1245877,21,11,1992,4,"male",328,211,45,20,2,20,1,0,1
1245884,17,16,1996,3,"female",644,383,205,351,120,76,83,275,37
1245892,32,11,1981,12,"female",390,18,16,200,1,162,1,38,0
1245909,19,3,1994,8,"male",286,38,19,2,6,2,2,0,4
1245910,20,24,1993,11,"female",410,259,85,301,313,0,49,301,264
1245932,103,28,1910,7,"female",207,160,50,3,13,3,13,0,0
1245935,17,29,1996,4,"male",321,303,91,42,9,42,9,0,0
1245954,22,11,1991,11,"male",183,97,29,0,10,0,8,0,2
1245956,83,5,1930,6,"male",90,27,25,31,0,3,0,28,0
1245958,26,1,1987,1,"male",378,46,43,0,3,0,0,0,3
1245976,73,17,1940,12,"male",275,67,59,70,84,0,61,70,23
1245997,55,22,1958,3,"female",113,26,13,219,121,218,77,1,44
1246018,28,7,1985,7,"female",576,82,39,62,6,62,3,0,3
1246047,26,1,1987,1,"male",53,0,0,0,0,0,0,0,0
1246090,44,27,1969,4,"male",435,7,5,0,2,0,1,0,1
1246152,77,29,1936,3,"female",2195,147,49,373,274,330,192,43,82
1246177,22,19,1991,9,"male",1072,792,575,1,2,0,1,1,1
1246195,26,9,1987,9,"female",502,117,88,278,111,117,31,161,80
1246197,24,20,1989,8,"male",58,8,4,24,10,24,10,0,0
1246202,25,17,1988,11,"female",348,76,48,0,0,0,0,0,0
1246225,14,15,1999,3,"male",493,372,31,5,7,0,4,5,3
1246241,60,23,1953,8,"male",667,52,46,0,0,0,0,0,0
1246260,61,22,1952,1,"male",1910,444,187,0,0,0,0,0,0
1246304,31,8,1982,5,"female",652,213,103,61,14,61,8,0,6
1246326,16,3,1997,4,"male",350,1108,900,1,0,1,0,0,0
1246331,18,11,1995,11,"male",649,73,61,0,0,0,0,0,0
1246340,17,1,1996,6,"female",827,58,12,0,0,0,0,0,0
1246358,24,17,1989,6,"male",22,0,0,0,0,0,0,0,0
1246362,55,10,1958,3,"female",620,94,66,36,56,1,43,35,13
1246367,29,19,1984,12,"male",186,1,1,1,0,1,0,0,0
1246434,27,3,1986,8,"male",102,35,29,216,2,216,1,0,1
1246435,20,26,1993,9,"male",353,399,222,31,89,28,34,3,55
1246451,19,18,1994,9,"male",282,64,24,0,1,0,1,0,0
1246466,53,20,1960,2,"female",1325,55,14,61,74,6,34,55,40
1246481,19,31,1994,12,"female",604,784,437,1,189,1,155,0,34
1246506,14,6,1999,1,"male",382,107,66,181,253,43,89,138,164
1246515,63,18,1950,1,"male",1181,10,8,1,0,1,0,0,0
1246520,60,1,1953,1,"male",487,6,3,0,0,0,0,0,0
1246538,45,17,1968,11,"female",1239,1834,350,1175,919,786,482,389,437
1246539,34,9,1979,5,"male",449,46,23,1,0,0,0,1,0
1246553,17,15,1996,7,"male",289,183,148,2,4,1,1,1,3
1246571,23,19,1990,9,"male",57,160,147,194,62,42,43,152,19
1246588,76,19,1937,3,"male",283,34,29,0,4,0,2,0,2
1246601,18,20,1995,12,"female",321,9,7,1,0,1,0,0,0
1246603,18,1,1995,8,"female",666,4351,270,8,86,8,69,0,17
1246605,67,12,1946,1,"female",1486,152,110,70,39,8,15,62,24
1246615,57,23,1956,8,"male",1005,9,3,0,0,0,0,0,0
1246642,50,14,1963,10,"male",539,38,15,0,0,0,0,0,0
1246650,40,2,1973,7,"male",700,41,14,0,3,0,3,0,0
1246665,21,28,1992,5,"male",510,23,11,2,23,0,5,2,18
1246671,19,25,1994,8,"female",76,101,10,1,1,1,1,0,0
1246678,15,23,1998,8,"male",124,93,60,3,3,3,3,0,0
1246684,37,12,1976,9,"female",465,154,82,410,243,19,67,391,176
1246688,26,8,1987,7,"female",419,144,35,22,0,22,0,0,0
1246709,58,22,1955,1,"male",273,193,87,672,207,7,78,665,129
1246712,113,19,1900,7,"female",1809,219,135,0,2,0,0,0,2
1246730,22,25,1991,11,"male",197,34,26,31,2,29,2,2,0
1246758,53,28,1960,10,"male",741,52,4,0,1,0,0,0,1
1246770,16,4,1997,10,"male",305,697,330,2,1,2,1,0,0
1246818,15,1,1998,1,"male",313,280,160,164,98,153,54,11,44
1246821,21,2,1992,5,"female",591,104,82,154,303,56,168,98,135
1246822,13,15,2000,9,"male",214,37,8,51,39,51,30,0,9
1246831,15,14,1998,10,"female",149,126,70,18,39,0,18,18,21
1246880,26,15,1987,8,"male",50,19,17,0,1,0,1,0,0
1246903,63,9,1950,8,"female",254,22,21,283,20,0,1,283,19
1246910,27,18,1986,9,"male",337,25,18,0,0,0,0,0,0
1246913,42,10,1971,2,"male",792,88,65,0,1,0,1,0,0
1246927,31,16,1982,3,"male",234,108,95,90,57,87,46,3,11
1246949,38,29,1975,5,"male",219,0,0,0,0,0,0,0,0
1246958,19,17,1994,7,"female",529,765,272,22,11,22,5,0,6
1246960,25,7,1988,2,"male",430,93,62,31,20,30,16,1,4
1246969,25,1,1988,1,"male",215,14,11,6,0,6,0,0,0
1247009,21,3,1992,6,"female",336,115,87,32,25,32,23,0,2
1247042,22,12,1991,7,"female",717,114,84,2643,125,2638,114,5,11
1247053,78,2,1935,9,"female",192,130,100,555,527,0,148,555,379
1247117,20,22,1993,1,NA,242,65,35,49,14,2,11,47,3
1247123,19,15,1994,9,"male",62,8,3,0,0,0,0,0,0
1247143,61,17,1952,11,"male",414,484,302,24,77,17,68,7,9
1247147,32,18,1981,1,"female",284,196,102,243,193,187,70,56,123
1247160,21,4,1992,2,"male",1206,108,71,18,2,3,1,15,1
1247174,58,15,1955,3,"female",1984,424,180,230,378,15,172,215,206
1247180,18,25,1995,3,"male",270,196,120,52,16,52,12,0,4
1247196,20,27,1993,8,"male",692,361,243,0,3,0,1,0,2
1247217,78,20,1935,3,"male",1819,54,16,0,0,0,0,0,0
1247219,31,5,1982,11,"male",417,70,63,0,1,0,1,0,0
1247224,57,3,1956,4,"male",971,220,111,1,3,1,1,0,2
1247227,17,23,1996,11,"female",654,1551,1132,412,101,412,67,0,34
1247277,21,25,1992,10,"male",367,254,180,252,625,252,426,0,199
1247306,45,5,1968,3,"female",249,19,12,1,5,1,1,0,4
1247407,26,5,1987,5,"male",89,0,0,0,0,0,0,0,0
1247437,25,8,1988,8,"male",335,107,91,11,2,11,2,0,0
1247438,19,20,1994,5,"male",533,208,167,0,3,0,3,0,0
1247466,17,16,1996,11,"male",529,254,211,0,1,0,0,0,1
1247482,15,19,1998,1,"female",481,586,487,0,0,0,0,0,0
1247517,61,27,1952,3,"male",1108,71,13,2,1,0,0,2,1
1247565,46,15,1967,7,"male",1047,139,35,10,14,2,4,8,10
1247567,20,31,1993,12,"male",505,196,151,0,2,0,1,0,1
1247572,20,15,1993,5,"male",232,372,283,116,286,72,146,44,140
1247586,18,14,1995,5,"male",38,88,76,136,25,136,25,0,0
1247600,25,16,1988,12,"male",198,35,31,0,0,0,0,0,0
1247603,70,5,1943,12,"male",26,147,132,0,0,0,0,0,0
1247619,58,13,1955,10,"male",187,55,42,99,48,0,14,99,34
1247669,24,23,1989,3,"female",459,15,8,18,11,18,7,0,4
1247703,19,12,1994,7,"female",1122,1579,1088,224,558,35,247,189,311
1247714,18,14,1995,3,"male",172,68,59,0,0,0,0,0,0
1247770,30,1,1983,4,"male",612,1,0,0,0,0,0,0,0
1247824,21,16,1992,8,"female",240,100,33,18,10,18,9,0,1
1247833,29,7,1984,10,"female",412,269,196,7,2,7,1,0,1
1247857,14,20,1999,7,"male",433,279,236,10,12,9,11,1,1
1247862,26,8,1987,4,"male",622,115,78,2,41,2,13,0,28
1247866,69,13,1944,5,"male",1776,52,11,0,0,0,0,0,0
1247873,28,25,1985,1,"male",313,171,59,3,7,3,3,0,4
1247880,20,30,1993,8,"male",730,293,168,2,29,2,13,0,16
1247884,16,24,1997,6,"female",252,1006,487,1549,1097,1030,835,519,262
1247887,55,26,1958,8,"female",311,46,27,867,727,867,278,0,449
1247904,103,8,1910,7,"male",806,205,137,0,0,0,0,0,0
1247913,21,21,1992,4,"male",185,256,191,109,97,109,91,0,6
1247929,77,6,1936,4,"male",1317,34,14,12,12,0,3,12,9
1247935,55,30,1958,9,"male",1691,39,15,0,0,0,0,0,0
1247950,37,10,1976,1,"male",501,48,21,23,64,23,40,0,24
1247972,21,29,1992,11,"male",869,286,163,188,313,139,162,49,151
1248034,34,10,1979,10,"male",142,40,30,5,2,0,1,5,1
1248039,45,26,1968,7,"female",383,9,5,0,0,0,0,0,0
1248053,23,20,1990,3,"male",73,46,38,0,3,0,3,0,0
1248070,17,12,1996,5,"male",52,54,25,2,3,2,3,0,0
1248113,48,15,1965,1,"female",76,41,22,9,28,9,7,0,21
1248119,69,18,1944,9,"male",24,37,33,0,1,0,1,0,0
1248129,72,14,1941,9,"male",677,20,13,0,0,0,0,0,0
1248135,69,18,1944,4,"female",1776,1330,947,4142,5084,1487,3361,2655,1723
1248155,57,11,1956,10,"male",1681,128,33,15,4,9,1,6,3
1248177,50,14,1963,8,"male",408,30,8,8,2,7,2,1,0
1248182,85,5,1928,10,"female",1641,41,7,0,0,0,0,0,0
1248219,65,21,1948,12,"male",303,1,1,4,4,0,3,4,1
1248224,15,30,1998,12,"male",317,1,1,0,0,0,0,0,0
1248225,14,18,1999,3,"female",478,1025,532,1165,793,403,313,762,480
1248235,15,18,1998,2,"female",378,1333,939,787,806,787,692,0,114
1248240,23,25,1990,2,"male",12,3,3,0,0,0,0,0,0
1248253,22,6,1991,2,"female",267,129,104,65,12,65,11,0,1
1248266,63,30,1950,4,"male",2187,59,26,21,1,21,1,0,0
1248273,67,21,1946,1,"male",381,18,12,0,0,0,0,0,0
1248297,55,14,1958,6,"male",1700,2062,645,166,197,166,168,0,29
1248305,35,23,1978,7,"male",491,195,149,15,43,15,28,0,15
1248332,92,13,1921,2,"female",1298,241,122,464,278,44,62,420,216
1248348,100,10,1913,12,"male",460,72,6,9,5,0,3,9,2
1248360,20,28,1993,3,"male",253,41,31,22,1,21,0,1,1
1248408,26,2,1987,2,"male",291,155,88,0,0,0,0,0,0
1248415,23,16,1990,10,"male",714,86,49,5,4,0,0,5,4
1248434,51,22,1962,7,"female",1721,256,145,1763,842,545,495,1218,347
1248443,62,15,1951,8,"female",1765,47,31,58,21,57,11,1,10
1248458,23,1,1990,10,"female",18,27,21,1349,1336,1108,324,241,1012
1248498,20,2,1993,1,"female",521,970,319,930,620,891,443,39,177
1248528,15,19,1998,8,"male",296,23,21,0,0,0,0,0,0
1248558,17,15,1996,3,"female",310,167,135,405,69,358,55,47,14
1248568,63,5,1950,5,"male",1371,1137,434,8301,3991,4639,2380,3662,1611
1248584,24,20,1989,12,"male",414,38,27,0,0,0,0,0,0
1248608,37,1,1976,1,"male",111,58,48,84,36,84,33,0,3
1248619,18,19,1995,6,"female",552,433,288,37,61,37,53,0,8
1248643,55,2,1958,5,"female",304,112,100,80,289,80,228,0,61
1248677,68,4,1945,2,"male",1256,515,442,0,16,0,10,0,6
1248678,16,8,1997,7,"male",1051,225,135,40,10,4,1,36,9
1248685,47,7,1966,3,"male",84,1,1,0,0,0,0,0,0
1248700,49,8,1964,6,"female",1954,87,60,210,137,102,56,108,81
1248709,24,3,1989,1,"male",590,242,195,123,115,123,100,0,15
1248766,22,12,1991,12,"male",81,20,10,0,4,0,4,0,0
1248834,15,24,1998,5,"male",86,36,22,65,15,65,15,0,0
1248835,42,25,1971,9,"female",93,17,11,13,3,13,3,0,0
1248888,45,1,1968,3,"male",735,21,11,28,8,28,7,0,1
1248950,21,24,1992,4,"male",213,59,51,4,6,4,6,0,0
1248965,26,28,1987,10,"male",464,102,67,26,3,26,0,0,3
1248967,37,7,1976,1,"male",117,64,62,50,0,50,0,0,0
1248983,38,17,1975,3,"female",369,273,112,3422,1318,3418,821,4,497
1248988,16,24,1997,6,"male",532,148,50,50,8,50,5,0,3
1248993,24,30,1989,10,"female",161,34,31,86,51,86,39,0,12
1249018,18,10,1995,6,"male",999,470,339,2,0,2,0,0,0
1249020,17,19,1996,8,"female",865,1639,261,408,2660,316,1229,92,1431
1249022,22,15,1991,4,"male",495,127,87,0,0,0,0,0,0
1249043,33,21,1980,6,"male",219,42,30,2,7,0,3,2,4
1249096,48,8,1965,3,"male",1380,135,48,31,7,31,4,0,3
1249098,19,5,1994,8,"female",329,10,8,0,0,0,0,0,0
1249100,17,17,1996,5,"female",110,39,26,0,0,0,0,0,0
1249123,17,10,1996,11,"female",26,0,0,0,0,0,0,0,0
1249132,27,9,1986,5,"male",132,8,4,5,1,5,1,0,0
1249136,52,24,1961,12,"female",1741,67,16,180,110,26,73,154,37
1249177,25,25,1988,10,"male",34,9,0,0,0,0,0,0,0
1249198,16,10,1997,1,"female",296,1366,682,100,832,100,627,0,205
1249210,59,12,1954,5,"female",1775,406,298,847,355,73,104,774,251
1249237,26,12,1987,6,"female",302,22,16,17,17,17,6,0,11
1249239,31,30,1982,9,"male",111,15,15,3,3,2,1,1,2
1249250,19,18,1994,6,"male",1297,1374,159,448,5104,231,3446,217,1658
1249296,55,17,1958,6,"male",1391,401,322,0,12,0,3,0,9
1249308,49,4,1964,12,"male",399,17,9,9,4,9,4,0,0
1249324,26,20,1987,5,"male",416,62,57,0,3,0,3,0,0
1249328,18,7,1995,11,"male",404,251,178,198,36,15,20,183,16
1249339,108,22,1905,8,"male",959,542,174,74,37,74,17,0,20
1249358,30,25,1983,6,"male",260,52,23,33,76,30,49,3,27
1249375,42,16,1971,6,"male",259,37,12,14,5,14,5,0,0
1249380,46,30,1967,3,"male",369,22,7,25,16,25,16,0,0
1249387,44,11,1969,3,"female",790,136,33,552,1590,70,441,482,1149
1249397,43,11,1970,9,"female",600,53,25,649,97,0,27,649,70
1249403,74,17,1939,2,"male",1585,50,28,70,4,67,3,3,1
1249421,17,11,1996,11,"male",681,428,389,17,11,17,11,0,0
1249426,41,11,1972,11,"male",1230,79,52,0,0,0,0,0,0
1249440,16,24,1997,2,"male",509,21,16,2,0,0,0,2,0
1249442,19,29,1994,4,"female",390,468,300,25,34,25,30,0,4
1249448,22,9,1991,1,"male",186,98,82,9,1,6,0,3,1
1249458,15,23,1998,3,"male",318,164,85,39,1,39,1,0,0
1249466,21,27,1992,7,"male",597,49,47,3,2,0,0,3,2
1249490,34,21,1979,9,"male",1059,1103,981,49,92,49,70,0,22
1249526,19,8,1994,9,"male",756,395,279,7,2,0,2,7,0
1249528,29,8,1984,8,"female",676,112,36,24,56,24,42,0,14
1249534,17,10,1996,1,"male",411,60,45,51,20,50,12,1,8
1249556,15,1,1998,7,"male",7,83,80,30,6,30,6,0,0
1249569,30,1,1983,3,"female",858,276,192,315,234,12,143,303,91
1249574,113,10,1900,9,"female",1487,72,23,109,231,109,99,0,132
1249583,82,17,1931,4,"female",560,53,32,34,1,33,0,1,1
1249600,14,7,1999,4,"female",250,352,213,3,76,3,55,0,21
1249611,68,1,1945,1,"male",250,158,121,57,79,13,43,44,36
1249633,22,19,1991,3,"female",298,130,110,0,18,0,7,0,11
1249650,19,18,1994,3,"male",287,62,47,8,0,7,0,1,0
1249654,15,4,1998,3,"male",42,51,41,3,4,1,1,2,3
1249696,104,28,1909,2,"female",1508,82,10,0,0,0,0,0,0
1249700,14,11,1999,1,"male",233,103,52,8,6,0,0,8,6
1249701,22,11,1991,4,"female",441,20,7,10,9,10,9,0,0
1249708,20,21,1993,10,"male",589,0,0,0,0,0,0,0,0
1249717,23,7,1990,8,"male",404,80,29,54,6,50,3,4,3
1249750,14,15,1999,4,"female",237,232,169,45,27,2,5,43,22
1249808,22,20,1991,2,"female",557,663,515,229,326,102,124,127,202
1249810,53,28,1960,12,"female",1391,14,4,1,0,0,0,1,0
1249814,56,4,1957,5,"female",649,47,26,6,10,0,3,6,7
1249817,20,11,1993,2,"male",273,112,94,0,3,0,0,0,3
1249833,57,15,1956,6,"female",1086,209,153,466,814,360,721,106,93
1249867,19,13,1994,5,"male",486,103,70,0,0,0,0,0,0
1249898,25,26,1988,11,"male",403,15,9,0,1,0,1,0,0
1249944,103,11,1910,5,"male",480,297,208,204,233,204,172,0,61
1249947,27,6,1986,4,"male",1022,160,84,12,18,4,17,8,1
1249952,55,13,1958,12,"male",1048,16,16,0,0,0,0,0,0
1249988,17,21,1996,1,"female",510,354,16,0,11,0,11,0,0
1249989,28,14,1985,4,"male",219,43,21,18,36,18,29,0,7
1250000,18,10,1995,4,"male",42,1,1,3,0,3,0,0,0
1250001,21,6,1992,4,"female",504,275,51,41,217,41,166,0,51
1250009,30,6,1983,6,"male",230,11,8,0,0,0,0,0,0
1250026,16,7,1997,12,"female",339,233,150,116,42,94,15,22,27
1250046,61,24,1952,9,"female",783,65,47,5,3,0,1,5,2
1250052,26,2,1987,7,"male",215,37,24,22,6,22,5,0,1
1250054,62,6,1951,5,"male",649,62,21,39,53,38,41,1,12
1250056,25,1,1988,1,"male",457,1,1,0,0,0,0,0,0
1250060,43,24,1970,5,"female",256,19,5,62,139,62,116,0,23
1250127,18,21,1995,9,"male",30,114,93,986,91,0,69,986,22
1250138,59,27,1954,6,"female",102,15,11,13,14,13,11,0,3
1250141,19,26,1994,9,"female",107,21,14,0,1,0,1,0,0
1250149,23,24,1990,7,"male",24,9,7,3,0,0,0,3,0
1250182,22,5,1991,8,"female",836,49,19,259,182,259,56,0,126
1250192,67,30,1946,6,"male",773,127,66,336,9,0,1,336,8
1250200,17,10,1996,10,"male",748,317,237,14,4,14,4,0,0
1250204,23,20,1990,4,"female",523,15,10,27,1,27,0,0,1
1250214,16,27,1997,1,"male",501,171,75,196,44,17,27,179,17
1250226,106,1,1907,1,"female",2788,191,110,149,97,136,53,13,44
1250232,25,25,1988,2,"female",371,105,79,224,51,224,51,0,0
1250239,19,12,1994,10,"male",492,171,90,93,49,0,10,93,39
1250285,48,15,1965,9,"female",290,218,196,279,414,279,326,0,88
1250319,43,23,1970,6,"female",766,2032,1253,344,529,101,116,243,413
1250325,97,2,1916,7,"male",303,116,74,17,188,0,64,17,124
1250367,15,12,1998,9,"male",530,32,24,7,2,0,0,7,2
1250368,70,31,1943,8,"male",994,49,17,49,560,0,83,49,477
1250384,32,5,1981,3,"male",542,165,98,0,0,0,0,0,0
1250409,38,23,1975,12,"male",714,142,62,15,32,15,28,0,4
1250430,18,2,1995,6,"male",155,180,173,3,2,3,1,0,1
1250445,27,2,1986,2,"male",241,85,58,58,76,58,55,0,21
1250459,30,1,1983,1,"male",357,45,42,8,2,8,2,0,0
1250476,23,4,1990,6,"male",592,112,58,1,15,1,5,0,10
1250481,79,18,1934,8,"female",648,18,13,1,5,0,3,1,2
1250504,21,26,1992,1,"male",198,249,196,109,200,32,73,77,127
1250506,18,10,1995,8,"female",138,60,24,0,0,0,0,0,0
1250507,53,24,1960,5,"male",1513,181,137,7,19,7,13,0,6
1250529,20,13,1993,6,"female",335,269,127,75,216,75,122,0,94
1250530,52,16,1961,10,"male",456,198,100,91,119,91,68,0,51
1250536,53,5,1960,12,"male",381,34,11,73,1,73,1,0,0
1250552,26,17,1987,6,"male",149,7,6,0,0,0,0,0,0
1250582,103,27,1910,8,"male",1352,433,248,5,24,4,9,1,15
1250590,45,30,1968,12,"female",271,25,13,1,3,1,3,0,0
1250620,22,13,1991,3,"male",399,201,143,0,0,0,0,0,0
1250623,36,15,1977,12,"male",809,12,4,0,4,0,1,0,3
1250662,68,31,1945,1,"female",1497,577,213,0,0,0,0,0,0
1250663,20,28,1993,4,"male",1033,271,118,0,0,0,0,0,0
1250702,18,7,1995,6,"female",193,167,124,141,142,140,123,1,19
1250717,24,17,1989,11,"male",1436,15,9,6,10,6,9,0,1
1250740,24,9,1989,9,"female",284,16,7,13,0,0,0,13,0
1250756,23,15,1990,7,"male",594,356,304,52,72,42,38,10,34
1250772,30,12,1983,2,"male",434,69,41,0,0,0,0,0,0
1250806,43,6,1970,3,"male",229,1,0,0,0,0,0,0,0
1250814,60,13,1953,3,"male",233,11,5,1,3,0,2,1,1
1250826,85,9,1928,2,"female",743,15,12,4,1,0,0,4,1
1250831,15,23,1998,4,"male",26,117,114,8,4,0,0,8,4
1250834,68,17,1945,8,"female",593,23,15,18,36,3,26,15,10
1250847,65,4,1948,8,"female",2351,63,33,19,10,1,5,18,5
1250879,13,25,2000,8,"female",67,24,4,4,1,4,1,0,0
1250900,14,16,1999,12,"female",205,372,265,321,83,115,38,206,45
1250904,16,1,1997,2,"male",170,115,83,0,1,0,0,0,1
1250919,35,13,1978,11,"female",84,50,23,8,4,8,3,0,1
1250921,16,19,1997,7,"male",463,156,101,8,9,8,9,0,0
1250930,77,7,1936,12,"male",1718,99,30,631,157,0,74,631,83
1250933,20,16,1993,7,"female",502,106,60,110,32,64,9,46,23
1250937,20,1,1993,7,"male",228,373,360,27,2,0,0,27,2
1250978,68,16,1945,8,"female",1072,82,33,40,37,1,15,39,22
1250995,25,18,1988,9,"male",251,140,106,267,568,267,432,0,136
1251010,105,19,1908,1,"female",823,416,108,71,50,71,46,0,4
1251035,24,3,1989,3,"female",109,20,9,11,11,11,4,0,7
1251040,57,10,1956,3,"female",1091,14,8,1,6,1,3,0,3
1251057,43,2,1970,1,"male",384,85,17,1,0,0,0,1,0
1251074,32,6,1981,2,"female",361,27,19,6,25,0,4,6,21
1251075,22,10,1991,6,"female",67,68,52,681,1025,181,470,500,555
1251130,32,28,1981,7,"female",790,177,131,1225,534,1118,311,107,223
1251134,19,18,1994,12,"male",1190,1,1,8,5,5,1,3,4
1251161,21,22,1992,1,"female",397,18,8,163,1,0,0,163,1
1251183,19,7,1994,9,"male",102,149,124,521,514,497,261,24,253
1251186,14,10,1999,8,"male",78,50,45,8,2,8,1,0,1
1251191,45,6,1968,8,"female",249,93,51,232,302,232,199,0,103
1251244,49,6,1964,7,"female",682,148,57,0,0,0,0,0,0
1251264,18,30,1995,3,"female",295,191,90,833,708,44,246,789,462
1251265,43,3,1970,2,"female",162,76,32,3696,785,3694,385,2,400
1251266,29,9,1984,9,"male",49,64,57,1,5,0,0,1,5
1251268,63,20,1950,12,"male",246,581,524,0,0,0,0,0,0
1251271,56,9,1957,5,"female",541,84,53,239,58,0,21,239,37
1251276,19,3,1994,8,"female",502,267,183,80,254,80,252,0,2
1251316,25,28,1988,9,"male",711,280,215,14,34,14,34,0,0
1251319,65,23,1948,7,"female",1392,106,47,265,109,0,31,265,78
1251338,53,18,1960,4,"male",195,44,25,1,0,1,0,0,0
1251344,24,29,1989,11,"male",56,53,51,28,12,10,9,18,3
1251375,44,21,1969,11,"female",211,379,334,4218,2413,4218,2215,0,198
1251405,19,24,1994,5,"male",554,336,287,27,10,11,6,16,4
1251412,21,20,1992,10,"female",374,26,17,1,0,0,0,1,0
1251417,65,30,1948,4,"male",1988,343,101,0,0,0,0,0,0
1251430,33,29,1980,1,"male",571,56,40,67,82,28,11,39,71
1251435,14,1,1999,1,"male",2,15,15,0,0,0,0,0,0
1251495,33,18,1980,5,"male",560,33,22,3,4,3,2,0,2
1251505,18,14,1995,6,"male",149,245,227,0,5,0,5,0,0
1251523,26,24,1987,7,"female",85,231,26,13,49,13,42,0,7
1251535,34,2,1979,9,"male",885,36,25,17,15,17,2,0,13
1251542,16,18,1997,8,"female",373,930,817,162,297,162,150,0,147
1251554,18,3,1995,2,"male",297,342,176,1,11,0,3,1,8
1251587,37,20,1976,5,"male",382,76,61,6,20,5,4,1,16
1251602,35,26,1978,12,"male",627,17,7,0,0,0,0,0,0
1251635,27,6,1986,6,"male",1248,610,387,29,23,28,16,1,7
1251644,18,27,1995,1,"female",283,549,344,395,1246,182,820,213,426
1251662,32,16,1981,1,"male",573,57,28,66,1,66,1,0,0
1251668,16,27,1997,5,"female",558,29,23,145,119,141,112,4,7
1251677,14,21,1999,9,"female",355,369,236,480,102,177,85,303,17
1251693,66,12,1947,1,"female",115,13,8,86,12,86,5,0,7
1251724,36,13,1977,5,"male",905,182,162,1,0,1,0,0,0
1251734,36,29,1977,1,"female",271,162,70,273,904,273,623,0,281
1251738,15,10,1998,12,"male",181,47,17,22,1,15,0,7,1
1251777,21,14,1992,6,"male",210,89,72,10,3,1,3,9,0
1251789,33,13,1980,8,"male",118,13,7,19,0,19,0,0,0
1251792,23,4,1990,12,"female",332,654,150,20,84,18,70,2,14
1251799,70,4,1943,7,"female",742,59,39,150,195,0,72,150,123
1251873,18,4,1995,2,"female",281,88,59,57,16,12,10,45,6
1251895,53,10,1960,3,"male",888,192,138,0,0,0,0,0,0
1251904,17,28,1996,11,"male",164,48,31,23,1,23,1,0,0
1251934,20,28,1993,11,"male",492,211,186,13,7,13,6,0,1
1251947,18,22,1995,2,"female",903,158,94,51,155,31,53,20,102
1251967,67,13,1946,7,"female",337,26,20,1,2,0,0,1,2
1251997,16,2,1997,9,"male",381,457,223,0,25,0,6,0,19
1252005,26,28,1987,6,"female",347,311,181,719,764,345,141,374,623
1252028,41,8,1972,2,"male",402,33,29,0,0,0,0,0,0
1252079,25,8,1988,5,"male",294,120,82,53,20,10,19,43,1
1252092,57,30,1956,9,"male",268,87,57,12,43,12,11,0,32
1252103,47,11,1966,8,"male",282,246,139,94,37,0,7,94,30
1252107,19,5,1994,10,"male",766,200,128,26,14,26,14,0,0
1252124,34,25,1979,9,"male",319,36,28,1,0,1,0,0,0
1252139,28,22,1985,11,"female",525,30,15,0,4,0,0,0,4
1252157,16,27,1997,5,"female",155,431,342,396,8,74,5,322,3
1252170,46,26,1967,8,"male",186,62,51,0,0,0,0,0,0
1252175,16,1,1997,1,"male",13,36,29,0,5,0,5,0,0
1252177,21,3,1992,5,"male",207,191,177,6,6,6,6,0,0
1252180,41,27,1972,3,"male",549,0,0,0,0,0,0,0,0
1252190,17,26,1996,7,"male",188,131,40,4,6,0,0,4,6
1252205,14,15,1999,6,"female",191,13,7,0,2,0,2,0,0
1252210,76,1,1937,5,"male",755,21,9,58,6,0,1,58,5
1252215,18,1,1995,2,"female",202,222,106,5,38,1,12,4,26
1252231,38,19,1975,1,"male",407,14,11,0,0,0,0,0,0
1252253,34,29,1979,6,"female",724,4,1,3,0,0,0,3,0
1252259,36,7,1977,1,"male",8,0,0,0,0,0,0,0,0
1252265,25,30,1988,8,"female",104,165,104,54,83,46,48,8,35
1252282,16,8,1997,8,"female",444,324,138,151,203,105,62,46,141
1252283,19,13,1994,3,"male",470,2468,947,4,45,4,44,0,1
1252295,23,9,1990,6,"male",241,138,126,0,1,0,1,0,0
1252315,64,20,1949,4,"male",763,56,44,8,21,7,21,1,0
1252335,64,15,1949,7,"female",678,14,11,4,0,4,0,0,0
1252342,22,1,1991,2,"male",419,57,40,198,26,196,2,2,24
1252344,28,26,1985,8,"male",551,23,14,0,0,0,0,0,0
1252356,18,1,1995,8,"male",434,1,1,0,0,0,0,0,0
1252404,16,15,1997,10,"male",416,553,393,1068,510,709,141,359,369
1252413,39,8,1974,9,"male",382,31,3,0,0,0,0,0,0
1252470,103,31,1910,12,"male",1978,1134,623,452,261,16,75,436,186
1252481,44,23,1969,9,"male",184,0,0,0,0,0,0,0,0
1252499,26,21,1987,8,"female",163,135,103,6,61,6,49,0,12
1252507,63,16,1950,4,"female",1588,30,18,0,19,0,13,0,6
1252537,26,3,1987,5,"male",358,69,16,0,13,0,13,0,0
1252612,27,5,1986,5,"male",1138,34,8,0,0,0,0,0,0
1252629,25,22,1988,12,"male",529,1001,444,862,166,862,139,0,27
1252632,22,28,1991,5,"male",311,48,33,2,3,2,3,0,0
1252648,33,15,1980,2,"male",60,25,21,1335,328,1137,119,198,209
1252660,26,1,1987,1,"male",260,107,82,18,9,17,5,1,4
1252684,19,17,1994,5,"male",138,22,16,0,0,0,0,0,0
1252686,25,9,1988,11,"female",332,36,21,7,3,7,3,0,0
1252718,15,20,1998,5,"male",336,1993,267,2964,5546,2865,4202,99,1344
1252725,61,12,1952,8,"female",787,48,13,207,195,29,143,178,52
1252733,16,10,1997,4,"male",124,178,40,1,1,1,1,0,0
1252736,103,14,1910,2,"male",779,900,579,1637,506,1637,253,0,253
1252751,29,13,1984,12,"female",308,27,7,10,1,0,0,10,1
1252782,16,29,1997,10,"male",253,73,38,26,17,26,15,0,2
1252804,26,14,1987,4,"male",612,39,25,4,7,4,2,0,5
1252823,26,17,1987,8,"male",364,14,14,0,3,0,1,0,2
1252889,53,17,1960,2,"male",1347,2,1,0,0,0,0,0,0
1252903,15,14,1998,4,"male",31,166,134,522,215,169,145,353,70
1252908,16,25,1997,5,"male",172,258,136,35,27,0,8,35,19
1252910,59,22,1954,3,"male",363,64,48,9,10,9,10,0,0
1252925,30,23,1983,12,"male",1542,215,197,0,0,0,0,0,0
1252934,22,15,1991,9,"male",204,93,87,13,3,11,2,2,1
1252953,50,25,1963,8,"female",860,250,113,1237,432,257,212,980,220
1252982,61,24,1952,12,"female",1349,89,30,24,10,1,1,23,9
1253004,48,27,1965,5,"female",643,29,18,41,38,41,12,0,26
1253039,21,6,1992,5,"female",708,175,76,12,6,12,6,0,0
1253049,41,25,1972,1,"male",29,0,0,0,0,0,0,0,0
1253113,20,1,1993,2,"male",345,96,47,6,7,5,4,1,3
1253128,14,17,1999,8,"male",16,10,9,3,0,3,0,0,0
1253151,20,18,1993,8,"female",669,289,140,0,8,0,1,0,7
1253173,38,15,1975,4,"male",805,27,14,20,37,19,27,1,10
1253186,113,10,1900,11,"male",1223,333,219,26,14,5,4,21,10
1253256,66,3,1947,5,"female",507,126,59,5,0,0,0,5,0
1253292,53,14,1960,12,"male",435,249,84,34,22,25,4,9,18
1253297,36,11,1977,7,"male",108,132,125,87,7,87,6,0,1
1253302,25,20,1988,6,"female",370,63,19,2,0,2,0,0,0
1253306,39,25,1974,8,"female",211,128,92,0,0,0,0,0,0
1253324,26,23,1987,12,"female",405,0,0,0,0,0,0,0,0
1253354,21,7,1992,2,"male",348,48,42,14,1,0,0,14,1
1253358,38,15,1975,2,"male",298,31,30,0,2,0,0,0,2
1253375,52,19,1961,9,"female",595,3945,1311,150,1025,55,637,95,388
1253389,25,1,1988,1,"male",134,1,1,0,0,0,0,0,0
1253402,57,22,1956,3,"male",89,17,12,157,3,37,1,120,2
1253409,56,16,1957,2,"female",504,1410,71,227,329,227,212,0,117
1253424,26,10,1987,11,"female",1082,686,470,1019,222,683,54,336,168
1253437,23,31,1990,10,"female",162,87,75,284,343,16,50,268,293
1253450,19,23,1994,6,"male",373,474,394,36,82,33,58,3,24
1253452,26,24,1987,3,"female",482,204,95,614,45,614,27,0,18
1253466,48,25,1965,7,"female",1693,179,80,118,371,8,225,110,146
1253468,26,1,1987,1,"female",440,27,21,4,2,4,2,0,0
1253485,24,14,1989,4,"male",85,37,12,1,0,1,0,0,0
1253500,62,5,1951,4,"male",1894,32,18,1,1,0,0,1,1
1253503,26,7,1987,6,"male",368,1,1,1,0,1,0,0,0
1253515,81,13,1932,6,"female",381,72,55,12,2,11,2,1,0
1253521,27,21,1986,8,"male",29,16,16,28,9,28,3,0,6
1253526,16,27,1997,6,"male",291,274,16,17,6,17,6,0,0
1253552,37,5,1976,11,"male",193,35,24,2,1,2,1,0,0
1253566,21,15,1992,2,"female",393,151,118,43,14,21,5,22,9
1253598,31,2,1982,5,"female",304,87,61,18,21,18,12,0,9
1253599,44,9,1969,6,"female",976,124,58,489,67,489,47,0,20
1253634,36,23,1977,1,"male",307,56,22,7,22,4,7,3,15
1253650,33,15,1980,1,"male",402,302,167,47,11,45,8,2,3
1253666,17,1,1996,8,"male",345,44,20,9,9,9,6,0,3
1253680,22,11,1991,1,"female",166,8,8,49,14,49,13,0,1
1253690,58,11,1955,1,"female",678,14,8,0,1,0,1,0,0
1253697,61,12,1952,4,"female",1592,324,187,512,500,10,183,502,317
1253698,20,28,1993,1,"female",442,121,81,0,0,0,0,0,0
1253755,16,6,1997,8,"male",382,39,35,0,21,0,14,0,7
1253763,49,10,1964,1,"male",862,115,48,619,960,166,437,453,523
1253765,21,18,1992,6,"male",473,102,65,0,2,0,1,0,1
1253773,14,19,1999,5,"male",378,295,252,32,8,32,7,0,1
1253802,21,23,1992,10,"male",160,46,40,14,11,5,2,9,9
1253804,17,22,1996,7,"male",273,139,110,19,10,16,10,3,0
1253847,19,25,1994,11,"female",1709,406,250,636,425,593,268,43,157
1253852,18,9,1995,8,"male",151,79,56,351,170,344,40,7,130
1253864,63,7,1950,2,"female",313,114,104,983,90,983,67,0,23
1253902,66,17,1947,1,"male",249,37,28,30,24,30,23,0,1
1253917,61,9,1952,2,"female",663,72,44,179,49,0,15,179,34
1253931,108,14,1905,6,"female",164,6,4,0,0,0,0,0,0
1253942,53,28,1960,5,"female",260,257,199,653,12,652,6,1,6
1253966,25,22,1988,7,"female",328,142,86,39,36,39,13,0,23
1253979,21,25,1992,7,"male",724,86,59,42,33,42,30,0,3
1253992,27,2,1986,10,"female",381,236,118,4,29,4,22,0,7
1254044,28,1,1985,1,"male",242,82,55,15,10,10,4,5,6
1254047,38,16,1975,4,"male",543,163,69,0,3,0,1,0,2
1254052,32,25,1981,8,"male",353,70,64,17,9,17,8,0,1
1254087,20,1,1993,9,"male",96,28,19,19,43,12,26,7,17
1254094,44,2,1969,8,"male",405,43,31,0,1,0,0,0,1
1254102,24,13,1989,3,"male",446,127,84,0,0,0,0,0,0
1254110,19,21,1994,7,"female",71,167,123,129,200,42,56,87,144
1254113,21,30,1992,10,"female",583,102,49,385,250,385,132,0,118
1254117,15,6,1998,3,"female",404,158,51,46,55,46,43,0,12
1254118,48,30,1965,6,"male",325,260,93,3,1,2,0,1,1
1254133,24,1,1989,12,"male",141,17,11,13,4,13,4,0,0
1254141,58,19,1955,12,"male",315,3,1,0,0,0,0,0,0
1254149,18,1,1995,8,"male",388,182,79,11,2,11,2,0,0
1254165,22,5,1991,5,"female",575,274,208,28,85,28,77,0,8
1254195,45,13,1968,11,"male",477,170,129,502,224,502,167,0,57
1254198,22,18,1991,8,"male",511,103,68,0,7,0,3,0,4
1254224,25,1,1988,1,"male",92,3,2,4,2,4,2,0,0
1254227,14,17,1999,3,"male",293,125,68,1,0,0,0,1,0
1254234,57,4,1956,9,"male",536,406,244,2,285,0,84,2,201
1254243,28,30,1985,4,"male",545,173,142,0,0,0,0,0,0
1254269,25,17,1988,2,"female",123,426,400,33,321,21,168,12,153
1254281,87,14,1926,11,"male",1007,309,120,15,13,3,8,12,5
1254313,18,10,1995,7,"female",147,346,189,615,614,612,446,3,168
1254325,68,10,1945,3,"male",1891,103,45,119,36,8,4,111,32
1254353,48,20,1965,6,"male",1003,109,73,101,37,84,29,17,8
1254354,20,25,1993,11,"male",297,147,88,263,79,132,52,131,27
1254381,19,2,1994,1,"male",497,263,204,4,4,4,2,0,2
1254390,35,2,1978,3,"male",794,22,3,5,11,5,11,0,0
1254391,21,12,1992,4,"male",436,278,103,3,88,3,50,0,38
1254395,31,6,1982,9,"male",437,208,180,2,13,0,3,2,10
1254412,31,24,1982,8,"male",430,18,13,0,0,0,0,0,0
1254415,25,24,1988,12,"male",465,1,0,1,0,1,0,0,0
1254421,35,1,1978,7,"female",255,7,3,0,0,0,0,0,0
1254453,36,26,1977,12,"male",371,96,68,135,56,79,36,56,20
1254461,18,5,1995,7,"male",97,9,8,0,0,0,0,0,0
1254469,62,10,1951,2,"male",371,19,15,5,12,0,2,5,10
1254489,28,1,1985,1,"male",106,65,8,95,104,95,66,0,38
1254492,90,4,1923,7,"male",0,0,0,95,78,95,56,0,22
1254493,18,12,1995,10,"female",174,5,3,16,4,16,4,0,0
1254511,29,7,1984,11,"male",84,28,15,1,4,1,3,0,1
1254517,39,3,1974,5,"male",761,2,0,0,0,0,0,0,0
1254524,51,18,1962,7,"male",765,27,16,0,0,0,0,0,0
1254527,56,8,1957,3,"male",701,22,3,3,5,0,2,3,3
1254528,51,27,1962,1,"male",1446,30,11,13,16,13,14,0,2
1254542,33,27,1980,8,"male",199,139,103,7,8,7,4,0,4
1254572,38,22,1975,10,"female",266,14,11,0,1,0,1,0,0
1254573,22,12,1991,12,"male",13,1,1,2,3,2,2,0,1
1254586,26,24,1987,12,"male",190,51,50,0,0,0,0,0,0
1254605,18,6,1995,5,"male",45,73,68,0,1,0,0,0,1
1254609,19,23,1994,6,"female",393,341,126,249,310,242,242,7,68
1254643,19,19,1994,8,"male",302,12,12,67,9,21,2,46,7
1254645,29,3,1984,5,"male",489,269,226,18,35,4,6,14,29
1254675,43,15,1970,1,"male",254,0,0,0,0,0,0,0,0
1254686,25,1,1988,1,"male",253,32,31,1,1,1,1,0,0
1254697,18,18,1995,12,"female",418,177,132,208,63,38,32,170,31
1254757,67,20,1946,7,"female",382,20,7,198,91,198,32,0,59
1254768,18,16,1995,6,"female",480,47,20,0,2,0,1,0,1
1254794,30,5,1983,2,"male",139,86,40,31,15,31,7,0,8
1254820,28,29,1985,8,"female",13,14,13,10,7,10,5,0,2
1254822,13,1,2000,1,"male",105,16,16,2,3,0,2,2,1
1254856,15,4,1998,3,"male",732,148,95,58,1,57,1,1,0
1254888,37,14,1976,6,"female",297,1,1,0,0,0,0,0,0
1254890,14,20,1999,10,"male",81,127,114,0,11,0,8,0,3
1254912,23,10,1990,11,"female",354,257,67,2363,828,2363,714,0,114
1254923,29,29,1984,9,"female",441,141,56,88,45,88,32,0,13
1254935,23,25,1990,12,"female",237,88,71,0,0,0,0,0,0
1254942,16,19,1997,2,"female",209,11,6,10,14,8,7,2,7
1254950,47,1,1966,4,"female",690,137,95,23,54,23,50,0,4
1254958,16,10,1997,10,"male",408,118,108,3,1,0,0,3,1
1254974,20,11,1993,2,"male",155,62,54,4,2,4,2,0,0
1254987,34,20,1979,8,"male",145,189,61,131,133,131,133,0,0
1254995,48,17,1965,10,"male",1262,49,17,7,7,0,0,7,7
1255001,25,8,1988,7,"female",381,210,34,186,284,186,242,0,42
1255007,18,31,1995,10,"male",7,0,0,0,0,0,0,0,0
1255032,25,20,1988,9,"male",755,70,27,450,38,450,37,0,1
1255033,72,12,1941,11,"male",94,19,18,2,4,2,0,0,4
1255048,66,10,1947,11,"male",860,151,85,100,25,99,16,1,9
1255060,51,10,1962,9,"male",83,0,0,0,0,0,0,0,0
1255066,37,17,1976,2,"male",316,27,11,3,16,3,15,0,1
1255105,26,1,1987,1,"male",470,17,9,0,0,0,0,0,0
1255114,19,8,1994,12,"male",239,65,38,3,0,0,0,3,0
1255117,69,13,1944,6,"female",1152,161,101,399,242,387,171,12,71
1255121,22,15,1991,10,"female",1826,114,55,39,92,39,63,0,29
1255123,17,15,1996,3,"female",742,582,339,472,496,106,250,366,246
1255140,26,1,1987,1,"male",68,23,19,8,0,8,0,0,0
1255144,50,6,1963,10,"male",1300,14,4,4,7,4,2,0,5
1255147,58,12,1955,3,"male",537,23,11,0,1,0,0,0,1
1255192,20,30,1993,5,"male",533,1423,1198,212,1555,66,185,146,1370
1255218,19,10,1994,8,"male",493,227,136,439,22,439,18,0,4
1255228,49,6,1964,11,"female",252,29,20,22,47,7,15,15,32
1255246,32,16,1981,6,"male",382,35,11,5,24,5,14,0,10
1255289,44,1,1969,1,"female",37,92,62,96,26,96,24,0,2
1255302,30,25,1983,10,"female",77,143,19,187,265,187,200,0,65
1255309,21,8,1992,10,"male",825,435,185,0,1,0,0,0,1
1255323,16,2,1997,6,"female",365,291,119,468,224,0,130,468,94
1255372,20,16,1993,9,"male",677,305,290,7,0,7,0,0,0
1255416,27,16,1986,7,"female",1747,310,153,495,492,78,358,417,134
1255446,19,19,1994,8,"male",38,1,1,0,0,0,0,0,0
1255477,43,23,1970,7,"male",446,16,10,0,0,0,0,0,0
1255478,33,5,1980,5,"male",410,47,28,0,0,0,0,0,0
1255528,76,24,1937,10,"female",1327,58,26,2,2,0,2,2,0
1255532,18,29,1995,6,"male",153,235,217,106,3,0,0,106,3
1255545,45,1,1968,1,"male",306,36,35,0,0,0,0,0,0
1255567,53,25,1960,12,"female",1299,244,116,150,285,24,74,126,211
1255586,20,18,1993,3,"female",259,355,77,2,6,2,6,0,0
1255666,53,20,1960,7,"female",105,45,30,1,0,0,0,1,0
1255691,48,23,1965,11,"male",273,38,22,22,2,22,0,0,2
1255715,41,10,1972,6,"male",328,133,122,0,0,0,0,0,0
1255753,17,22,1996,10,"female",266,1076,463,2434,933,2434,834,0,99
1255775,31,13,1982,5,"male",200,152,123,20,18,17,9,3,9
1255786,68,10,1945,12,"male",1113,781,463,102,46,47,25,55,21
1255794,26,10,1987,9,"male",911,221,160,274,171,180,75,94,96
1255828,18,18,1995,7,"female",137,243,75,0,1,0,1,0,0
1255837,59,5,1954,7,"female",816,125,76,84,345,0,171,84,174
1255867,25,29,1988,3,"male",306,5,0,6,3,5,2,1,1
1255871,17,11,1996,4,"female",277,5,3,0,0,0,0,0,0
1255881,108,23,1905,4,"male",511,126,56,7,4,0,0,7,4
1255893,20,31,1993,8,"male",421,138,68,139,165,139,115,0,50
1255902,37,17,1976,3,"male",23,14,11,25,20,23,9,2,11
1255909,23,29,1990,3,"male",231,117,91,7,33,7,22,0,11
1255930,24,16,1989,10,"male",736,578,481,144,132,144,127,0,5
1255949,36,11,1977,2,"male",451,299,192,41,26,41,25,0,1
1255965,33,20,1980,11,"male",327,0,0,0,0,0,0,0,0
1255972,68,28,1945,10,"female",568,240,118,79,155,79,146,0,9
1255983,58,3,1955,9,"female",929,83,43,302,31,229,2,73,29
1256012,47,24,1966,5,"female",1221,93,56,114,22,60,4,54,18
1256020,21,16,1992,10,"female",241,216,195,45,3,2,0,43,3
1256021,108,10,1905,9,"male",1615,209,65,47,60,18,32,29,28
1256032,31,9,1982,6,"female",155,218,97,786,611,698,181,88,430
1256033,15,14,1998,6,"male",458,215,114,114,71,78,32,36,39
1256035,17,2,1996,1,"male",635,388,279,1,1,0,1,1,0
1256056,17,19,1996,6,"male",411,8,2,2,0,2,0,0,0
1256095,21,3,1992,4,"female",356,53,26,0,0,0,0,0,0
1256121,18,15,1995,2,"male",261,105,66,1,1,0,0,1,1
1256153,25,6,1988,12,"female",369,1,1,0,3,0,0,0,3
1256167,70,25,1943,1,"male",429,24,10,31,10,1,3,30,7
1256172,26,26,1987,11,"male",333,46,26,13,20,7,17,6,3
1256173,38,1,1975,3,"male",393,179,81,10,11,7,1,3,10
1256186,108,30,1905,3,"male",853,258,178,0,0,0,0,0,0
1256222,33,12,1980,2,"female",469,93,41,188,57,117,34,71,23
1256224,30,21,1983,5,"female",796,595,262,387,348,387,265,0,83
1256232,29,20,1984,10,"female",167,170,118,32,21,6,4,26,17
1256245,23,7,1990,2,"female",1077,580,203,66,127,66,89,0,38
1256250,110,20,1903,5,"male",1964,778,327,36,15,0,3,36,12
1256256,16,21,1997,10,"female",124,245,180,1014,1431,1009,858,5,573
1256304,107,2,1906,5,"female",270,83,72,26,1,2,0,24,1
1256315,62,20,1951,10,"male",1382,161,41,14,5,5,3,9,2
1256330,22,8,1991,8,"male",444,435,411,191,160,191,159,0,1
1256335,29,2,1984,9,"male",294,31,19,4,2,4,2,0,0
1256339,25,21,1988,3,"female",289,93,63,374,100,374,54,0,46
1256355,52,10,1961,11,"male",394,235,115,2894,4463,189,1643,2705,2820
1256382,38,4,1975,11,"male",781,169,41,6,0,6,0,0,0
1256393,19,25,1994,3,"male",345,163,134,1,3,1,3,0,0
1256394,25,25,1988,3,"male",864,164,45,12,18,12,7,0,11
1256403,22,30,1991,8,"male",578,36,12,3,2,3,1,0,1
1256409,38,1,1975,1,"male",416,41,37,0,0,0,0,0,0
1256412,22,10,1991,1,"male",0,0,0,0,0,0,0,0,0
1256436,18,8,1995,12,"male",222,352,285,2,1,2,0,0,1
1256456,29,29,1984,11,"female",312,505,356,16,338,16,305,0,33
1256484,25,1,1988,1,"male",240,1,1,1,0,1,0,0,0
1256491,70,14,1943,12,"male",984,61,39,119,31,119,21,0,10
1256492,49,10,1964,12,"female",651,69,40,1,3,1,3,0,0
1256561,48,14,1965,12,"female",429,257,218,66,4,4,1,62,3
1256584,24,19,1989,4,"male",308,60,26,7,0,7,0,0,0
1256591,22,25,1991,4,"male",372,144,99,0,0,0,0,0,0
1256604,44,5,1969,10,"male",1395,32,20,7,10,7,9,0,1
1256606,28,11,1985,7,"male",307,343,308,526,120,467,111,59,9
1256622,38,27,1975,12,"male",155,114,108,12,129,9,63,3,66
1256649,55,6,1958,4,"male",327,78,54,0,4,0,2,0,2
1256658,74,5,1939,7,"female",1137,82,46,140,46,0,37,140,9
1256667,24,5,1989,10,"male",414,33,21,32,34,32,21,0,13
1256673,33,20,1980,1,"male",35,43,36,337,24,337,17,0,7
1256690,23,1,1990,9,"female",1257,266,141,94,147,81,88,13,59
1256698,47,1,1966,1,"female",538,29,17,0,0,0,0,0,0
1256701,43,3,1970,11,"female",387,115,52,272,143,252,120,20,23
1256719,36,18,1977,9,"male",271,2,2,1,0,1,0,0,0
1256730,61,19,1952,3,"female",216,47,34,18,14,0,1,18,13
1256735,63,20,1950,2,"male",602,1,0,0,0,0,0,0,0
1256754,18,27,1995,5,"male",601,121,68,0,0,0,0,0,0
1256759,55,30,1958,5,"female",77,22,18,0,0,0,0,0,0
1256809,16,20,1997,6,"male",139,194,180,0,0,0,0,0,0
1256890,14,31,1999,3,"male",174,661,231,3,0,0,0,3,0
1256914,18,14,1995,2,"male",255,634,596,9,0,0,0,9,0
1256920,33,15,1980,3,"male",470,9,5,0,3,0,1,0,2
1256924,53,27,1960,4,"female",1831,128,64,103,102,98,26,5,76
1256967,18,1,1995,6,"male",338,292,180,2,7,0,5,2,2
1257015,18,19,1995,7,"male",1049,31,8,10,0,10,0,0,0
1257023,91,1,1922,6,"female",1262,163,50,850,8,0,2,850,6
1257024,15,4,1998,3,"female",387,155,72,7,28,7,26,0,2
1257079,39,3,1974,10,"female",752,156,61,127,30,7,12,120,18
1257087,36,1,1977,1,"male",256,29,19,0,1,0,0,0,1
1257109,13,30,2000,5,"female",61,1,1,0,0,0,0,0,0
1257112,70,4,1943,6,"male",422,50,34,30,47,0,30,30,17
1257144,106,20,1907,4,"male",867,635,389,190,303,150,135,40,168
1257149,20,23,1993,3,"male",88,50,33,0,0,0,0,0,0
1257204,25,1,1988,1,"male",84,29,16,1,4,1,4,0,0
1257216,20,29,1993,8,"female",651,361,166,41,234,34,52,7,182
1257219,39,11,1974,10,"male",143,26,23,3,14,3,8,0,6
1257254,41,14,1972,11,"female",276,65,53,1012,196,1012,145,0,51
1257256,19,1,1994,1,"male",199,112,81,17,250,17,179,0,71
1257258,18,14,1995,3,"female",280,1416,30,62,114,62,104,0,10
1257270,56,17,1957,11,"male",56,132,104,148,108,59,42,89,66
1257276,22,22,1991,3,"female",339,3,2,0,0,0,0,0,0
1257282,23,30,1990,6,"male",135,91,50,33,69,33,57,0,12
1257311,25,1,1988,1,"male",181,1,1,0,0,0,0,0,0
1257319,23,19,1990,7,"male",298,107,49,159,281,120,177,39,104
1257333,20,29,1993,12,"male",196,2,2,0,0,0,0,0,0
1257341,15,3,1998,3,"male",245,10,4,164,8,164,5,0,3
1257346,14,1,1999,6,"male",169,1231,1101,1138,1331,996,1142,142,189
1257430,39,24,1974,1,"male",282,1,0,0,0,0,0,0,0
1257461,47,29,1966,5,"female",895,33,15,8,3,8,0,0,3
1257473,103,27,1910,9,"male",725,295,273,4,1,4,1,0,0
1257479,45,18,1968,5,"male",539,9,6,10,1,10,1,0,0
1257484,56,31,1957,7,"male",2043,161,64,17,4,1,1,16,3
1257486,21,25,1992,2,"male",470,452,403,0,0,0,0,0,0
1257499,44,14,1969,10,"male",888,12,8,1,1,0,0,1,1
1257503,108,16,1905,12,"female",924,66,32,117,85,1,49,116,36
1257520,23,7,1990,10,"male",122,66,44,17,5,4,3,13,2
1257527,23,12,1990,10,"male",461,16,7,0,0,0,0,0,0
1257530,40,15,1973,5,"female",203,18,13,2,1,0,0,2,1
1257534,50,1,1963,8,"male",959,263,184,17,7,17,3,0,4
1257572,18,4,1995,4,"male",534,115,103,3,0,0,0,3,0
1257588,68,9,1945,8,"female",1739,107,36,0,1,0,0,0,1
1257594,67,5,1946,5,"male",66,19,17,32,40,32,12,0,28
1257621,23,23,1990,12,"male",38,37,30,6,8,5,1,1,7
1257633,72,23,1941,9,"male",312,6,5,1,0,0,0,1,0
1257637,34,19,1979,8,"male",365,144,73,30,22,30,19,0,3
1257648,18,17,1995,11,"male",70,32,26,4,1,4,1,0,0
1257668,30,29,1983,1,"male",640,14,9,0,1,0,0,0,1
1257706,22,20,1991,11,"male",401,318,269,30,37,27,24,3,13
1257719,35,12,1978,2,"male",276,101,41,7,2,0,0,7,2
1257750,26,4,1987,4,"male",292,70,55,0,0,0,0,0,0
1257754,17,15,1996,5,"female",305,188,150,52,1,52,1,0,0
1257800,54,25,1959,7,"male",138,12,2,18,32,18,7,0,25
1257843,68,28,1945,3,"male",1025,28,5,112,6,0,3,112,3
1257899,21,30,1992,4,"male",468,228,204,23,90,23,86,0,4
1257933,67,17,1946,7,"female",808,39,28,65,1,65,1,0,0
1257957,72,16,1941,11,"female",1680,113,54,55,137,11,100,44,37
1257963,83,16,1930,3,"female",1434,445,193,69,102,0,25,69,77
1257968,26,4,1987,10,"male",198,76,62,0,0,0,0,0,0
1258008,60,4,1953,7,"male",1120,94,88,0,0,0,0,0,0
1258020,21,17,1992,8,"male",1494,811,301,190,324,170,271,20,53
1258042,55,10,1958,12,"female",397,69,50,2,8,0,5,2,3
1258045,25,6,1988,6,"male",26,5,4,3,1,3,1,0,0
1258119,17,29,1996,10,"male",476,834,670,1643,112,1593,95,50,17
1258123,47,6,1966,1,"female",219,16,8,0,17,0,1,0,16
1258126,20,17,1993,5,"male",272,179,114,11,9,11,9,0,0
1258153,16,26,1997,1,"male",535,437,213,8,44,8,32,0,12
1258154,62,24,1951,9,"female",1129,38,21,58,47,0,23,58,24
1258156,16,4,1997,11,"male",241,41,9,17,1,17,1,0,0
1258179,16,31,1997,1,"male",372,419,217,399,376,399,269,0,107
1258200,63,31,1950,1,"female",636,224,153,93,58,0,6,93,52
1258213,23,6,1990,5,"male",459,404,300,14,75,14,31,0,44
1258216,28,4,1985,11,"female",257,509,443,392,403,252,322,140,81
1258224,90,4,1923,7,"male",16,43,41,8,8,8,2,0,6
1258229,27,25,1986,9,"male",281,5,4,0,0,0,0,0,0
1258257,18,16,1995,3,"female",182,78,38,6,4,6,1,0,3
1258275,19,7,1994,12,"male",414,225,182,0,0,0,0,0,0
1258285,45,3,1968,9,"male",551,19,11,0,0,0,0,0,0
1258298,44,9,1969,9,"female",331,13,9,3,1,3,1,0,0
1258311,30,14,1983,2,"male",279,58,28,577,287,307,68,270,219
1258312,23,11,1990,9,"male",338,19,12,229,15,229,8,0,7
1258339,25,17,1988,9,"male",391,25,25,0,3,0,3,0,0
1258343,103,28,1910,4,"male",944,138,50,1,2,1,2,0,0
1258366,23,10,1990,10,"male",143,93,74,139,40,130,36,9,4
1258374,63,13,1950,4,"female",134,7,7,0,0,0,0,0,0
1258388,74,29,1939,4,"female",1785,100,57,54,11,32,9,22,2
1258394,99,14,1914,2,"male",445,130,68,5,9,5,9,0,0
1258425,28,28,1985,12,"male",502,25,6,35,0,35,0,0,0
1258428,36,31,1977,3,"female",263,99,59,66,156,24,38,42,118
1258431,34,3,1979,6,"female",328,65,41,6,1,0,0,6,1
1258433,33,2,1980,10,"male",264,40,27,1,0,1,0,0,0
1258441,84,20,1929,7,"male",1367,6,3,0,0,0,0,0,0
1258444,55,17,1958,3,"female",294,86,63,61,19,61,7,0,12
1258449,15,2,1998,10,"male",25,108,66,495,255,50,120,445,135
1258450,25,11,1988,11,"female",584,283,167,56,196,37,114,19,82
1258502,22,10,1991,9,"female",512,14,7,28,24,1,0,27,24
1258514,71,22,1942,11,"male",655,98,54,782,292,0,120,782,172
1258523,14,14,1999,5,"female",240,864,531,0,0,0,0,0,0
1258528,33,3,1980,3,"male",701,228,195,1,6,1,2,0,4
1258534,74,22,1939,6,"female",1606,120,29,9,43,8,11,1,32
1258542,18,23,1995,7,"female",420,48,31,0,0,0,0,0,0
1258559,104,9,1909,11,"male",1272,297,211,110,68,0,31,110,37
1258560,20,5,1993,11,"male",150,253,229,17,0,16,0,1,0
1258572,27,14,1986,4,"male",279,139,115,378,117,378,50,0,67
1258576,19,17,1994,6,"male",355,469,377,61,24,61,20,0,4
1258606,37,23,1976,3,"male",269,50,36,1,4,1,4,0,0
1258620,23,10,1990,8,"male",302,200,63,38,72,38,54,0,18
1258682,108,24,1905,9,"male",1365,275,93,14,5,14,3,0,2
1258691,40,13,1973,2,"female",538,126,99,8,7,8,5,0,2
1258711,57,17,1956,1,"female",1622,171,61,28,35,3,27,25,8
1258751,38,4,1975,12,"male",1583,422,272,10,38,6,8,4,30
1258773,63,19,1950,3,"female",1249,639,151,13,33,13,33,0,0
1258778,13,20,2000,7,"male",81,42,21,0,0,0,0,0,0
1258784,102,13,1911,10,"female",2021,82,46,7,16,7,14,0,2
1258790,21,1,1992,1,"male",147,214,188,10,3,10,3,0,0
1258794,25,28,1988,2,"male",276,1,0,0,0,0,0,0,0
1258795,68,13,1945,11,"female",12,41,39,185,32,0,14,185,18
1258809,13,10,2000,2,"female",161,81,67,5,21,2,11,3,10
1258832,103,17,1910,3,"male",954,146,124,0,20,0,19,0,1
1258851,35,30,1978,5,"female",339,5,4,10,0,0,0,10,0
1258864,48,16,1965,8,"male",128,3,3,0,0,0,0,0,0
1258865,25,1,1988,8,"male",967,124,46,52,15,50,6,2,9
1258874,21,4,1992,10,"female",420,50,45,126,25,123,12,3,13
1258888,23,9,1990,1,"male",333,273,232,0,5,0,2,0,3
1258891,22,20,1991,10,"female",69,0,0,0,0,0,0,0,0
1258897,20,24,1993,12,"male",366,36,7,0,2,0,2,0,0
1258903,24,19,1989,5,"male",1312,193,105,2,0,2,0,0,0
1258913,15,18,1998,6,"male",252,14,10,0,0,0,0,0,0
1258952,21,1,1992,1,"male",321,51,49,0,0,0,0,0,0
1259022,23,4,1990,4,"female",557,0,0,0,0,0,0,0,0
1259034,29,26,1984,6,"female",278,41,32,0,1,0,0,0,1
1259052,34,31,1979,10,"female",78,1,0,0,0,0,0,0,0
1259062,34,17,1979,8,"female",478,68,37,110,17,63,10,47,7
1259115,25,6,1988,9,"male",199,66,66,0,0,0,0,0,0
1259118,25,28,1988,12,"male",375,665,527,24,3,16,1,8,2
1259142,19,9,1994,9,"male",42,18,18,7,0,4,0,3,0
1259145,19,23,1994,9,"male",597,162,62,23,15,5,3,18,12
1259155,57,26,1956,8,"male",1201,28,17,7,0,7,0,0,0
1259196,66,23,1947,7,"female",838,108,53,142,112,113,62,29,50
1259217,29,1,1984,1,"male",23,1,1,0,0,0,0,0,0
1259242,20,12,1993,5,"male",428,16,7,0,0,0,0,0,0
1259262,23,23,1990,9,"male",89,3,0,0,0,0,0,0,0
1259286,54,29,1959,4,"male",58,4,4,521,11,495,6,26,5
1259294,19,18,1994,10,"female",338,168,111,141,12,0,4,141,8
1259296,31,17,1982,8,"male",22,31,24,10,7,10,5,0,2
1259355,64,11,1949,6,"male",1520,31,20,0,0,0,0,0,0
1259357,32,21,1981,9,"male",256,12,11,0,1,0,0,0,1
1259363,19,16,1994,11,"female",715,3153,1338,6,387,5,218,1,169
1259381,108,14,1905,5,"female",281,94,60,40,132,40,98,0,34
1259392,26,20,1987,2,"male",43,3,0,19,0,1,0,18,0
1259418,23,29,1990,8,"female",301,46,15,184,69,14,29,170,40
1259421,18,12,1995,5,"male",916,1395,881,155,203,69,128,86,75
1259476,33,21,1980,9,"male",317,0,0,0,0,0,0,0,0
1259477,35,19,1978,1,"male",469,20,15,1,0,1,0,0,0
1259478,57,8,1956,3,"male",291,66,45,7,71,3,41,4,30
1259502,55,7,1958,7,"female",1461,120,53,1770,412,927,238,843,174
1259573,32,17,1981,12,"male",296,98,69,2,2,0,2,2,0
1259584,19,9,1994,12,"male",476,61,44,4,0,0,0,4,0
1259590,70,4,1943,12,"female",1220,163,110,646,232,0,58,646,174
1259623,21,9,1992,7,"male",120,87,64,0,0,0,0,0,0
1259630,65,4,1948,12,"female",1569,196,124,655,511,369,269,286,242
1259648,20,28,1993,1,"male",391,119,58,6,46,6,27,0,19
1259661,14,19,1999,12,"female",281,240,91,211,248,89,235,122,13
1259682,17,17,1996,2,"male",70,40,32,51,25,31,11,20,14
1259687,24,18,1989,6,"male",28,4,4,6,2,6,1,0,1
1259692,34,10,1979,9,"male",722,145,133,11,18,10,15,1,3
1259717,29,4,1984,1,"male",745,144,70,0,0,0,0,0,0
1259757,19,20,1994,12,"female",300,223,36,80,333,80,209,0,124
1259767,37,15,1976,6,"female",348,29,18,0,5,0,5,0,0
1259776,69,18,1944,10,"male",1594,65,39,0,0,0,0,0,0
1259778,60,11,1953,5,"male",516,12,2,0,1,0,0,0,1
1259790,25,18,1988,4,"male",84,94,42,1,0,1,0,0,0
1259802,37,3,1976,6,"female",204,48,28,43,65,32,50,11,15
1259824,38,11,1975,9,"female",997,395,266,6,0,6,0,0,0
1259832,28,1,1985,1,"male",578,164,127,6,21,6,13,0,8
1259852,19,18,1994,4,"male",669,203,148,0,0,0,0,0,0
1259853,21,15,1992,9,"male",232,74,43,7,11,0,6,7,5
1259883,31,20,1982,7,"female",358,107,41,121,13,121,11,0,2
1259924,57,9,1956,4,"male",41,4,2,68,6,12,5,56,1
1259942,27,28,1986,2,"female",244,107,86,71,35,5,32,66,3
1259964,71,3,1942,11,"female",307,722,508,5669,1730,4857,535,812,1195
1259987,69,5,1944,6,"female",346,38,27,29,11,29,8,0,3
1259999,30,13,1983,4,"male",419,38,34,0,0,0,0,0,0
1260004,17,17,1996,11,"female",366,276,92,1,0,1,0,0,0
1260013,26,30,1987,3,"female",679,182,44,5,105,5,86,0,19
1260052,15,6,1998,6,"female",202,22,16,1,1,1,1,0,0
1260059,17,25,1996,9,"female",604,189,146,93,98,63,45,30,53
1260066,55,4,1958,9,"male",604,56,32,0,6,0,6,0,0
1260084,21,2,1992,6,"male",178,16,8,1,1,1,1,0,0
1260088,33,16,1980,10,"female",2026,85,34,94,117,41,65,53,52
1260130,23,19,1990,1,"female",400,1130,304,30,407,14,354,16,53
1260132,34,18,1979,10,"male",423,44,10,49,14,49,11,0,3
1260155,28,5,1985,6,"male",601,22,11,0,3,0,2,0,1
1260200,54,8,1959,1,"male",412,62,50,3,1,0,1,3,0
1260239,61,6,1952,5,"female",548,8,6,20,10,9,5,11,5
1260276,66,15,1947,11,"female",1202,584,321,22,909,1,88,21,821
1260277,49,29,1964,5,"female",294,20,14,25,9,24,7,1,2
1260308,28,20,1985,9,"female",794,74,41,312,425,289,309,23,116
1260335,21,12,1992,6,"female",209,64,39,901,443,900,163,1,280
1260339,28,1,1985,1,"male",181,42,22,3,8,3,2,0,6
1260351,22,4,1991,5,"male",519,123,77,1,1,0,1,1,0
1260366,59,5,1954,5,"female",171,23,16,204,9,204,4,0,5
1260372,35,28,1978,9,"male",325,57,29,2,2,2,2,0,0
1260442,103,29,1910,12,"male",612,169,110,94,30,94,19,0,11
1260457,25,8,1988,2,"male",22,1,0,0,0,0,0,0,0
1260459,60,28,1953,9,"female",1167,114,26,0,0,0,0,0,0
1260511,68,19,1945,12,"male",235,218,131,1,3,1,3,0,0
1260529,21,11,1992,8,"male",456,43,28,10,4,10,2,0,2
1260563,93,25,1920,4,"male",249,158,130,53,20,6,9,47,11
1260570,23,2,1990,3,"male",104,2,2,47,1,0,0,47,1
1260572,64,28,1949,9,"male",26,0,0,3,0,0,0,3,0
1260575,16,27,1997,10,"male",240,36,21,2,2,2,2,0,0
1260614,26,17,1987,9,"male",1317,195,31,0,2,0,2,0,0
1260622,27,9,1986,9,"female",100,15,11,93,15,85,11,8,4
1260623,14,1,1999,8,"male",95,14,12,0,0,0,0,0,0
1260628,52,4,1961,3,"male",742,111,75,40,137,40,85,0,52
1260658,18,21,1995,10,"female",688,553,262,1203,862,80,421,1123,441
1260669,53,19,1960,10,"female",177,50,33,3,8,3,8,0,0
1260670,38,5,1975,12,"male",1216,4,1,0,0,0,0,0,0
1260699,25,1,1988,1,"male",18,10,10,2,0,0,0,2,0
1260742,41,6,1972,5,"female",466,121,54,0,0,0,0,0,0
1260744,16,11,1997,6,"male",444,189,92,12,6,8,5,4,1
1260745,28,10,1985,8,"female",200,6,3,8,0,0,0,8,0
1260768,44,15,1969,9,"female",104,87,46,138,296,137,165,1,131
1260772,23,1,1990,10,"male",465,127,85,0,0,0,0,0,0
1260778,26,11,1987,9,"female",578,426,340,106,99,106,50,0,49
1260796,30,14,1983,10,"female",256,25,19,3,4,3,4,0,0
1260800,103,4,1910,10,"male",790,235,192,5,2,5,2,0,0
1260812,23,9,1990,12,"female",248,306,108,80,6,49,2,31,4
1260852,24,6,1989,1,"male",538,103,78,4,1,4,1,0,0
1260856,33,1,1980,6,"male",644,75,46,0,5,0,4,0,1
1260857,22,23,1991,7,"female",424,99,60,232,28,199,26,33,2
1260880,45,29,1968,10,"female",450,27,24,0,11,0,7,0,4
1260884,26,7,1987,6,"female",111,14,9,42,1,42,1,0,0
1260913,21,23,1992,8,"male",19,136,125,541,217,541,203,0,14
1260936,53,19,1960,8,"female",2256,568,423,1815,1224,996,733,819,491
1260946,21,4,1992,12,"female",698,995,540,1016,1021,753,504,263,517
1260990,17,7,1996,12,"male",207,86,77,0,0,0,0,0,0
1260994,25,15,1988,11,"female",60,17,13,20,19,20,12,0,7
1260998,44,7,1969,7,"female",24,37,24,6,56,6,51,0,5
1261004,42,2,1971,12,"male",540,24,16,76,12,76,6,0,6
1261080,42,5,1971,8,"female",264,24,17,1,10,1,6,0,4
1261100,64,26,1949,1,"female",79,33,20,32,11,32,10,0,1
1261108,31,2,1982,7,"female",1780,145,57,27,80,18,58,9,22
1261112,14,13,1999,10,"male",191,18,13,7,9,7,8,0,1
1261113,74,23,1939,6,"male",110,82,63,0,6,0,3,0,3
1261129,55,26,1958,10,"male",99,15,9,8,5,0,5,8,0
1261138,25,12,1988,2,"female",905,110,52,89,69,89,41,0,28
1261141,33,3,1980,6,"male",443,29,20,0,1,0,1,0,0
1261148,108,29,1905,3,"female",1766,170,108,948,273,387,87,561,186
1261153,24,5,1989,3,"female",463,243,76,265,162,265,98,0,64
1261180,25,12,1988,7,"male",139,80,54,4,8,4,8,0,0
1261214,64,14,1949,12,"female",1784,122,96,128,112,13,59,115,53
1261222,19,7,1994,12,"male",306,121,120,0,0,0,0,0,0
1261264,51,2,1962,1,"female",438,8,6,3,0,3,0,0,0
1261266,14,27,1999,2,"male",128,319,43,1,2,1,0,0,2
1261270,37,19,1976,1,"male",388,63,30,42,11,41,7,1,4
1261279,18,8,1995,8,"male",351,89,60,0,157,0,91,0,66
1261301,19,16,1994,4,"male",718,75,66,6,3,6,3,0,0
1261327,39,20,1974,1,"male",684,45,23,1,4,1,4,0,0
1261344,26,13,1987,4,"male",569,245,211,0,1,0,0,0,1
1261369,39,23,1974,8,"male",831,149,8,1,0,1,0,0,0
1261396,27,10,1986,11,"female",393,59,35,118,389,112,187,6,202
1261442,15,9,1998,11,"male",334,66,38,28,2,25,0,3,2
1261460,29,27,1984,10,"male",442,111,57,81,108,73,27,8,81
1261503,24,14,1989,2,"male",237,150,109,0,12,0,10,0,2
1261515,14,8,1999,12,"female",119,257,104,87,52,87,48,0,4
1261526,25,1,1988,1,"male",438,19,14,2,4,2,3,0,1
1261541,21,20,1992,11,"male",651,180,178,0,0,0,0,0,0
1261545,18,17,1995,4,"male",869,594,312,53,153,18,93,35,60
1261558,55,1,1958,1,"male",794,433,49,0,3,0,1,0,2
1261562,39,15,1974,1,"male",485,35,22,19,5,8,2,11,3
1261566,66,9,1947,10,"male",663,71,46,385,13,0,2,385,11
1261579,53,14,1960,12,"female",1641,325,152,193,113,18,66,175,47
1261583,31,1,1982,5,"male",236,108,78,0,0,0,0,0,0
1261593,43,2,1970,2,"male",506,86,64,8,3,5,3,3,0
1261596,21,14,1992,5,"male",173,172,141,23,1,15,0,8,1
1261645,19,26,1994,10,"male",576,127,106,0,2,0,1,0,1
1261676,68,17,1945,8,"female",869,4207,488,14,178,14,125,0,53
1261695,50,30,1963,10,"male",164,30,4,0,3,0,1,0,2
1261720,21,25,1992,10,"male",501,114,82,4,0,4,0,0,0
1261722,24,8,1989,3,"male",662,225,108,0,0,0,0,0,0
1261731,27,6,1986,8,"female",699,116,78,153,73,149,45,4,28
1261781,41,28,1972,1,"female",113,73,32,2,3,2,1,0,2
1261798,65,3,1948,2,"male",2164,39,7,82,17,0,5,82,12
1261829,33,7,1980,3,"male",384,8,4,0,0,0,0,0,0
1261844,33,14,1980,11,"female",651,32,22,1,0,1,0,0,0
1261847,14,19,1999,7,"female",318,252,198,155,189,0,31,155,158
1261849,36,15,1977,5,"female",1082,224,129,403,122,372,70,31,52
1261862,44,12,1969,10,"male",298,1,0,0,0,0,0,0,0
1261889,19,27,1994,3,"female",263,116,84,195,32,87,16,108,16
1261922,33,22,1980,1,"male",1270,101,49,9,2,6,1,3,1
1261927,18,22,1995,10,"female",1006,188,97,107,47,97,41,10,6
1261931,70,13,1943,11,"female",1706,198,61,435,328,253,234,182,94
1261946,54,6,1959,10,"female",1205,162,93,344,83,8,13,336,70
1261952,19,3,1994,7,"male",253,167,43,36,20,36,16,0,4
1261954,23,9,1990,12,NA,186,19,12,22,0,22,0,0,0
1261980,21,8,1992,3,"female",534,981,551,340,302,238,154,102,148
1261984,44,4,1969,7,"male",355,21,16,6,0,6,0,0,0
1261986,18,10,1995,6,"male",16,12,8,5,2,1,0,4,2
1261987,25,9,1988,11,"male",420,208,173,16,16,14,12,2,4
1261995,18,1,1995,5,"female",208,4,4,130,0,26,0,104,0
1261999,108,28,1905,1,"female",1327,399,230,14,30,14,14,0,16
1262011,24,8,1989,2,"male",262,68,54,47,2,47,2,0,0
1262012,21,16,1992,3,"male",625,455,185,215,168,128,103,87,65
1262038,108,6,1905,9,"female",188,25,11,14,33,0,3,14,30
1262039,18,10,1995,1,"female",232,970,681,21,48,21,18,0,30
1262085,42,21,1971,4,"female",278,11,6,0,0,0,0,0,0
1262088,52,4,1961,6,"male",42,0,0,1,1,1,1,0,0
1262112,24,23,1989,8,"male",614,359,277,1,0,1,0,0,0
1262137,26,2,1987,1,"male",80,67,39,0,15,0,2,0,13
1262185,55,15,1958,10,"female",308,184,101,765,155,765,120,0,35
1262193,14,7,1999,7,"male",156,753,682,9,3,9,3,0,0
1262203,24,1,1989,3,"male",139,4,0,0,0,0,0,0,0
1262212,37,6,1976,3,"female",383,14,7,36,28,36,12,0,16
1262213,31,1,1982,1,"female",616,5,3,14,4,5,0,9,4
1262224,38,11,1975,8,"male",15,41,38,32,9,29,7,3,2
1262233,19,13,1994,8,"male",75,48,44,3,0,3,0,0,0
1262235,17,20,1996,9,"male",387,55,32,2,2,2,2,0,0
1262236,21,4,1992,1,"female",650,245,216,0,3,0,1,0,2
1262245,103,30,1910,9,"male",1314,1223,892,271,183,271,166,0,17
1262251,57,1,1956,5,"male",460,27,15,0,0,0,0,0,0
1262287,43,31,1970,10,"female",96,28,19,268,53,0,14,268,39
1262298,68,13,1945,11,"female",720,29,15,270,52,11,25,259,27
1262334,55,27,1958,10,"female",426,37,32,0,0,0,0,0,0
1262377,30,10,1983,1,"male",17,13,13,0,2,0,2,0,0
1262399,23,29,1990,3,"male",156,216,193,218,253,200,175,18,78
1262434,24,9,1989,4,"female",496,70,51,25,38,25,27,0,11
1262449,20,25,1993,4,"female",127,114,76,7,63,7,33,0,30
1262454,27,7,1986,5,"male",212,146,115,144,16,129,13,15,3
1262458,42,22,1971,3,"male",621,24,8,10,11,10,10,0,1
1262472,20,15,1993,7,"female",29,17,16,0,0,0,0,0,0
1262483,21,1,1992,1,"male",165,11,5,8,1,8,0,0,1
1262501,43,5,1970,3,"female",210,127,75,2818,3936,447,2417,2371,1519
1262506,20,8,1993,6,"male",524,188,167,0,0,0,0,0,0
1262529,103,11,1910,3,"female",629,342,201,38,56,38,48,0,8
1262549,24,17,1989,8,"male",477,19,17,0,4,0,0,0,4
1262576,16,26,1997,3,"female",526,203,181,998,28,998,10,0,18
1262654,24,27,1989,10,"male",114,40,33,0,0,0,0,0,0
1262657,25,18,1988,8,"male",515,44,25,435,13,0,0,435,13
1262673,23,20,1990,11,"female",1467,1338,322,31,72,4,40,27,32
1262684,25,20,1988,12,"male",54,61,28,412,38,412,37,0,1
1262711,17,14,1996,5,"male",1431,252,109,9,12,0,2,9,10
1262734,38,19,1975,8,"female",978,136,78,374,925,132,528,242,397
1262742,19,27,1994,1,"male",521,180,134,11,27,10,24,1,3
1262772,34,6,1979,7,"male",559,203,142,1,20,1,16,0,4
1262788,101,30,1912,1,"male",1868,468,266,12,13,6,9,6,4
1262794,29,8,1984,2,"male",199,131,74,625,91,616,78,9,13
1262796,65,24,1948,11,"female",151,6,4,0,0,0,0,0,0
1262799,23,20,1990,11,"male",33,231,215,125,135,87,50,38,85
1262813,63,16,1950,10,"male",659,2,1,0,0,0,0,0,0
1262839,14,23,1999,4,"male",297,201,142,72,42,5,23,67,19
1262842,44,13,1969,5,"female",181,11,10,2,0,2,0,0,0
1262867,52,29,1961,11,"female",331,48,26,33,2,31,2,2,0
1262868,23,14,1990,9,"male",90,102,11,19,22,7,7,12,15
1262925,15,6,1998,5,"male",417,42,36,1,0,0,0,1,0
1262946,47,20,1966,1,"female",569,45,33,61,36,61,28,0,8
1262957,100,27,1913,1,"male",1817,124,71,30,69,30,62,0,7
1262968,21,17,1992,12,"male",579,97,55,0,0,0,0,0,0
1262974,25,24,1988,12,"male",157,26,21,29,11,29,6,0,5
1262983,21,16,1992,11,"male",457,153,98,0,0,0,0,0,0
1262989,18,30,1995,9,"female",156,272,36,1680,331,1680,312,0,19
1262999,18,2,1995,4,"female",114,167,63,2,6,0,1,2,5
1263044,55,1,1958,11,"male",659,104,33,2684,1229,2,7,2682,1222
1263054,32,5,1981,4,"female",169,2,1,2,0,2,0,0,0
1263077,23,30,1990,7,"female",389,326,150,1883,3312,1883,2157,0,1155
1263079,62,12,1951,7,"female",450,94,35,110,269,110,72,0,197
1263084,69,1,1944,4,"male",245,10,6,2,0,2,0,0,0
1263087,28,3,1985,2,"male",111,11,10,0,0,0,0,0,0
1263100,35,29,1978,5,"male",362,29,7,0,0,0,0,0,0
1263108,19,17,1994,5,"male",273,41,21,0,1,0,1,0,0
1263120,38,7,1975,11,"male",310,121,98,161,3,0,3,161,0
1263146,23,29,1990,7,"male",1168,62,25,1,0,1,0,0,0
1263165,28,2,1985,2,"male",639,30,25,34,2,32,1,2,1
1263208,20,30,1993,7,"female",417,146,101,529,132,470,108,59,24
1263214,30,23,1983,8,"male",1947,89,55,11,2,7,0,4,2
1263224,34,15,1979,12,"female",255,111,54,5,10,0,0,5,10
1263230,35,17,1978,3,"male",320,85,78,1,4,1,3,0,1
1263300,26,28,1987,5,"male",296,202,122,7,15,7,8,0,7
1263334,108,31,1905,12,"female",1781,416,200,648,485,0,158,648,327
1263335,23,28,1990,11,"male",639,162,114,20,52,3,29,17,23
1263364,21,9,1992,10,"male",154,146,112,7,2,7,2,0,0
1263384,18,16,1995,3,"male",12,4,3,2,6,2,2,0,4
1263397,16,6,1997,1,"male",151,59,52,0,26,0,21,0,5
1263400,55,13,1958,7,"female",493,49,28,196,32,0,26,196,6
1263402,23,10,1990,12,"male",282,0,0,0,0,0,0,0,0
1263424,15,18,1998,5,"male",582,233,91,0,0,0,0,0,0
1263461,23,12,1990,11,"male",950,197,174,5,0,4,0,1,0
1263523,27,28,1986,9,"female",340,186,86,646,685,646,562,0,123
1263528,19,19,1994,8,"male",308,113,99,13,0,3,0,10,0
1263542,60,19,1953,2,"male",1336,39,29,164,47,0,11,164,36
1263615,23,1,1990,1,"male",470,250,170,34,65,34,49,0,16
1263626,20,1,1993,2,"male",514,392,308,307,32,224,18,83,14
1263647,27,12,1986,5,"male",402,107,41,1,1,1,1,0,0
1263671,38,29,1975,11,"male",302,68,45,520,75,238,42,282,33
1263678,67,3,1946,4,"female",94,43,31,4,11,0,0,4,11
1263683,67,23,1946,12,"female",1014,34,7,0,0,0,0,0,0
1263685,17,14,1996,10,"female",270,1340,1021,4915,2496,3984,1076,931,1420
1263705,55,30,1958,7,"female",488,48,26,79,10,79,8,0,2
1263753,35,8,1978,10,"male",586,32,19,3,4,0,0,3,4
1263780,35,1,1978,12,"male",656,36,30,20,0,0,0,20,0
1263784,22,10,1991,3,"male",1026,26,15,0,7,0,0,0,7
1263833,54,9,1959,3,"male",1167,97,45,77,116,77,92,0,24
1263849,18,26,1995,3,"female",188,1512,177,203,412,203,350,0,62
1263854,28,11,1985,7,"male",199,29,21,0,0,0,0,0,0
1263883,108,5,1905,1,"male",890,903,587,9,0,9,0,0,0
1263893,18,24,1995,1,"male",209,287,134,0,10,0,5,0,5
1263912,80,3,1933,1,"female",175,58,32,381,51,381,32,0,19
1263917,27,12,1986,8,"male",50,65,60,0,11,0,5,0,6
1263919,19,10,1994,3,"male",336,14,12,434,113,434,99,0,14
1263928,24,24,1989,3,"male",827,42,30,50,13,49,12,1,1
1263947,33,10,1980,11,"male",377,207,143,10,0,10,0,0,0
1263976,78,27,1935,11,"female",1822,158,64,1632,518,0,72,1632,446
1263977,65,14,1948,10,"female",394,38,25,34,4,0,0,34,4
1264049,19,6,1994,3,"male",273,33,28,0,0,0,0,0,0
1264055,40,2,1973,4,"female",468,22,16,128,13,128,9,0,4
1264056,26,9,1987,9,"female",550,16,11,122,6,30,3,92,3
1264057,44,2,1969,12,"male",578,173,73,64,49,17,30,47,19
1264058,22,10,1991,6,"female",349,73,37,219,270,156,74,63,196
1264069,65,22,1948,10,"male",1273,120,21,2,36,2,22,0,14
1264073,25,1,1988,1,"male",50,19,18,4,0,4,0,0,0
1264089,14,13,1999,10,"female",329,213,108,113,93,95,85,18,8
1264096,19,9,1994,2,"male",101,34,34,14,0,14,0,0,0
1264097,20,3,1993,2,"male",412,913,701,66,1971,66,1676,0,295
1264101,105,30,1908,10,"male",1980,739,223,22,22,1,12,21,10
1264112,21,1,1992,1,"male",25,20,18,4,7,4,4,0,3
1264134,52,5,1961,4,"male",1706,109,82,17,17,14,4,3,13
1264137,18,2,1995,8,"male",671,6,3,4,3,4,2,0,1
1264167,67,16,1946,10,"female",2248,48,22,229,226,216,198,13,28
1264260,23,31,1990,8,"female",171,239,136,617,1288,470,483,147,805
1264266,21,21,1992,2,"female",115,69,61,270,157,49,72,221,85
1264284,58,6,1955,10,"male",195,98,39,1,3,0,2,1,1
1264301,54,23,1959,9,"female",419,45,27,80,1,80,1,0,0
1264303,52,11,1961,10,"female",262,90,62,96,30,35,21,61,9
1264331,22,14,1991,11,"female",380,254,93,83,206,83,198,0,8
1264345,17,22,1996,4,"female",268,374,88,79,41,0,22,79,19
1264355,17,31,1996,3,"male",413,67,52,1,0,0,0,1,0
1264362,63,3,1950,3,"female",1265,44,33,188,24,188,15,0,9
1264381,51,19,1962,3,"female",351,185,95,57,12,57,3,0,9
1264407,27,10,1986,6,"female",703,29,23,2,56,1,49,1,7
1264450,19,17,1994,3,"male",645,909,780,77,87,77,79,0,8
1264451,21,2,1992,2,"male",353,417,338,7,12,7,9,0,3
1264457,26,31,1987,7,"male",250,51,22,1,0,1,0,0,0
1264461,23,18,1990,3,"male",228,140,98,3,17,0,2,3,15
1264509,18,1,1995,3,"male",299,240,217,0,0,0,0,0,0
1264594,30,29,1983,7,"female",578,2,2,0,0,0,0,0,0
1264601,83,17,1930,2,"female",1808,26,5,0,5,0,5,0,0
1264608,31,20,1982,10,"male",414,68,29,35,16,35,13,0,3
1264644,27,1,1986,1,"male",85,2,2,0,0,0,0,0,0
1264649,45,2,1968,11,"female",143,76,57,66,38,0,7,66,31
1264662,19,4,1994,4,"male",434,229,95,1,0,1,0,0,0
1264665,29,8,1984,4,"male",605,253,231,58,15,33,14,25,1
1264705,21,6,1992,5,"male",936,90,8,2,86,0,19,2,67
1264712,18,12,1995,2,"female",215,136,60,309,194,16,66,293,128
1264720,50,28,1963,8,"female",749,65,42,158,57,139,33,19,24
1264734,56,24,1957,1,"female",667,77,68,0,0,0,0,0,0
1264752,18,5,1995,11,"male",245,144,91,0,0,0,0,0,0
1264774,22,25,1991,9,"male",287,65,30,3,0,3,0,0,0
1264782,42,1,1971,2,"female",598,16,12,9,0,0,0,9,0
1264790,18,5,1995,3,"male",96,19,12,3,1,3,1,0,0
1264794,31,14,1982,5,"male",665,129,50,9,6,0,0,9,6
1264798,67,29,1946,5,"female",1347,59,25,17,19,10,8,7,11
1264803,14,9,1999,5,"female",459,117,68,54,9,0,1,54,8
1264831,15,13,1998,6,"male",231,50,38,0,0,0,0,0,0
1264850,25,17,1988,9,"male",336,12,4,165,1,165,1,0,0
1264857,30,22,1983,12,"female",336,36,33,165,28,165,14,0,14
1264862,20,18,1993,1,"male",380,209,116,11,10,10,7,1,3
1264878,22,5,1991,9,"male",343,14,11,13,15,5,14,8,1
1264879,22,4,1991,8,"female",112,22,20,0,0,0,0,0,0
1264902,31,23,1982,2,"male",823,4,0,0,0,0,0,0,0
1264927,24,13,1989,3,"male",485,142,107,0,0,0,0,0,0
1264965,23,4,1990,4,"female",690,437,295,508,501,508,297,0,204
1264972,44,8,1969,9,"male",618,0,0,0,0,0,0,0,0
1264979,35,20,1978,4,"female",282,16,9,0,0,0,0,0,0
1264988,63,30,1950,6,"male",490,61,48,0,1,0,1,0,0
1264989,22,21,1991,2,"male",1023,243,113,55,7,55,3,0,4
1264995,26,11,1987,5,"female",85,11,2,3,0,3,0,0,0
1265041,21,2,1992,5,"female",528,218,124,183,8,0,4,183,4
1265049,26,28,1987,9,"female",151,61,52,139,19,139,8,0,11
1265121,19,6,1994,3,"female",525,196,95,0,1,0,0,0,1
1265122,31,10,1982,12,"male",797,187,157,7,10,7,7,0,3
1265135,21,14,1992,1,"male",585,249,104,14,2,0,1,14,1
1265147,17,10,1996,9,"male",22,11,10,0,0,0,0,0,0
1265167,17,22,1996,2,"male",94,24,19,91,29,91,26,0,3
1265245,54,28,1959,5,"female",524,184,122,147,234,0,82,147,152
1265271,17,30,1996,11,"female",357,13,12,55,42,52,20,3,22
1265283,19,19,1994,5,"male",476,337,197,52,84,26,31,26,53
1265303,14,4,1999,9,"female",248,203,90,14,49,6,26,8,23
1265320,39,8,1974,8,"female",132,31,15,1215,397,1215,259,0,138
1265325,53,3,1960,9,"female",1074,31,11,54,50,47,40,7,10
1265336,33,29,1980,5,"female",850,260,225,60,15,60,14,0,1
1265347,20,19,1993,12,"female",590,286,203,55,55,1,9,54,46
1265372,17,31,1996,5,"male",336,389,288,65,61,65,12,0,49
1265379,103,28,1910,11,"female",1180,3191,246,75,300,45,158,30,142
1265423,18,11,1995,6,"male",516,2129,1678,2803,4724,62,2647,2741,2077
1265439,20,5,1993,2,"male",359,44,2,6,0,6,0,0,0
1265445,27,30,1986,3,"male",263,22,18,29,0,0,0,29,0
1265455,42,12,1971,6,"female",221,8,6,1,0,1,0,0,0
1265463,22,7,1991,8,"female",92,24,14,4,4,0,2,4,2
1265603,46,4,1967,6,"male",490,11,3,0,0,0,0,0,0
1265609,33,11,1980,1,"male",520,29,16,4,6,4,4,0,2
1265649,42,6,1971,12,"female",347,33,20,0,6,0,3,0,3
1265687,40,16,1973,9,"female",315,18,5,66,27,64,14,2,13
1265702,45,29,1968,12,"female",820,286,154,3,16,3,9,0,7
1265737,28,27,1985,8,"female",451,71,35,34,58,0,22,34,36
1265766,75,23,1938,7,"male",1870,112,86,12,20,12,20,0,0
1265786,18,28,1995,7,"male",245,149,126,1,0,0,0,1,0
1265817,26,15,1987,8,"female",300,97,33,116,2,116,2,0,0
1265826,31,9,1982,1,"male",298,46,34,1,6,1,1,0,5
1265828,35,9,1978,11,"male",676,214,75,23,7,23,4,0,3
1265845,14,4,1999,4,"female",220,548,364,258,433,243,338,15,95
1265848,20,10,1993,12,"male",736,817,701,3,7,3,6,0,1
1265888,33,24,1980,9,"female",910,358,99,2132,2110,1314,1433,818,677
1265927,21,15,1992,5,"male",312,8,4,0,2,0,1,0,1
1265971,61,2,1952,3,"male",615,89,63,60,58,52,8,8,50
1265986,23,21,1990,9,"male",593,151,110,4,4,2,2,2,2
1265994,93,30,1920,8,"female",888,132,59,63,54,59,28,4,26
1265999,64,13,1949,1,"female",1705,267,137,490,860,90,260,400,600
1266006,17,30,1996,5,"male",1131,279,202,1326,1453,945,952,381,501
1266015,103,6,1910,4,"male",2331,349,189,184,196,77,117,107,79
1266035,57,24,1956,10,"male",553,63,49,131,65,0,41,131,24
1266045,18,6,1995,10,"male",88,36,33,0,0,0,0,0,0
1266061,26,19,1987,7,"male",33,8,8,22,1,22,1,0,0
1266063,19,22,1994,8,"male",295,67,60,3,0,3,0,0,0
1266083,53,2,1960,11,"male",1348,156,100,55,79,34,64,21,15
1266085,22,30,1991,12,"female",2,8,6,0,1,0,1,0,0
1266120,22,1,1991,1,"male",274,59,52,2,1,2,0,0,1
1266141,24,16,1989,10,"male",148,21,14,10,0,10,0,0,0
1266153,102,21,1911,10,"male",770,309,111,45,35,45,33,0,2
1266154,78,30,1935,10,"female",428,31,28,0,0,0,0,0,0
1266161,56,11,1957,10,"male",863,62,13,4,38,0,25,4,13
1266166,28,5,1985,5,"female",830,452,286,313,715,242,487,71,228
1266181,21,21,1992,5,"female",173,79,58,127,233,125,189,2,44
1266188,37,30,1976,9,"female",340,31,16,0,0,0,0,0,0
1266194,108,9,1905,10,"male",271,159,79,569,246,569,225,0,21
1266225,25,15,1988,4,"female",315,125,40,9,2,6,1,3,1
1266287,27,28,1986,3,"male",106,71,45,5,1,5,1,0,0
1266302,63,29,1950,5,"female",847,148,55,215,92,206,80,9,12
1266354,17,6,1996,12,"male",702,411,132,42,43,42,24,0,19
1266385,21,9,1992,9,"male",25,159,120,658,371,658,227,0,144
1266412,26,16,1987,11,"male",277,633,582,92,101,92,69,0,32
1266440,15,15,1998,9,"female",292,311,168,0,0,0,0,0,0
1266486,30,11,1983,7,"male",319,223,109,107,33,0,13,107,20
1266499,87,22,1926,12,"female",1705,26,13,0,0,0,0,0,0
1266523,39,4,1974,1,"male",858,5,5,9,0,0,0,9,0
1266528,58,25,1955,3,"female",88,27,13,38,5,38,1,0,4
1266535,16,23,1997,7,"male",392,173,127,9,3,0,1,9,2
1266549,23,17,1990,1,"female",381,46,28,88,84,88,59,0,25
1266555,45,30,1968,4,"male",306,1,1,0,0,0,0,0,0
1266591,24,28,1989,10,"male",269,126,100,153,100,149,90,4,10
1266600,65,22,1948,10,"male",631,82,62,0,21,0,11,0,10
1266602,14,23,1999,8,"male",263,242,221,15,7,15,7,0,0
1266611,19,17,1994,7,"male",30,16,11,1,0,1,0,0,0
1266618,28,1,1985,1,"male",70,0,0,0,0,0,0,0,0
1266638,24,3,1989,6,"male",281,368,314,122,181,122,145,0,36
1266653,61,9,1952,1,"female",145,42,28,118,28,0,11,118,17
1266659,22,20,1991,4,"female",300,67,16,0,0,0,0,0,0
1266664,30,20,1983,7,"female",284,53,33,0,2,0,1,0,1
1266665,27,17,1986,7,"male",375,135,132,110,80,110,78,0,2
1266684,23,18,1990,10,"female",70,2,1,17,0,0,0,17,0
1266690,63,14,1950,8,"female",1184,139,90,461,152,370,120,91,32
1266691,24,22,1989,12,"male",217,262,154,69,92,69,63,0,29
1266704,28,28,1985,8,"male",78,86,78,0,0,0,0,0,0
1266732,21,13,1992,9,"male",306,359,262,387,565,387,524,0,41
1266734,25,15,1988,12,"female",440,63,12,18,32,18,25,0,7
1266766,25,21,1988,7,"female",739,278,151,245,165,245,64,0,101
1266788,19,25,1994,1,"male",323,17,4,0,0,0,0,0,0
1266819,19,11,1994,2,"female",293,27,15,7,160,7,107,0,53
1266831,18,19,1995,9,"female",443,197,83,28,44,25,9,3,35
1266834,23,6,1990,5,"male",740,921,844,8,9,4,6,4,3
1266905,47,21,1966,11,"female",152,17,11,36,13,36,13,0,0
1266915,20,30,1993,9,"female",652,4,0,0,0,0,0,0,0
1266918,34,30,1979,3,"male",606,63,33,1,55,1,33,0,22
1266947,35,30,1978,8,"female",214,96,81,31,10,31,4,0,6
1266963,33,23,1980,4,"male",225,94,52,32,1,32,1,0,0
1267063,25,8,1988,2,"female",138,83,57,326,151,326,125,0,26
1267079,92,7,1921,7,"female",1235,4153,2271,1048,1986,404,1244,644,742
1267096,73,22,1940,9,"female",349,225,72,0,88,0,19,0,69
1267102,28,8,1985,12,"male",1321,195,132,1,1,1,1,0,0
1267147,27,20,1986,12,"female",358,171,67,19,36,2,24,17,12
1267152,30,19,1983,5,"female",681,239,148,323,238,15,25,308,213
1267160,72,1,1941,7,"female",950,10,8,0,0,0,0,0,0
1267174,113,30,1900,1,"female",1873,556,114,775,871,558,737,217,134
1267214,15,25,1998,4,"male",531,694,329,15,2,15,2,0,0
1267236,23,3,1990,1,"male",867,221,179,22,0,19,0,3,0
1267269,45,18,1968,2,"female",382,89,61,5,4,5,4,0,0
1267270,18,8,1995,8,"male",529,14,14,1,0,0,0,1,0
1267280,15,25,1998,11,"female",648,808,465,3504,3023,3246,1822,258,1201
1267301,68,19,1945,8,"female",714,95,57,0,2,0,1,0,1
1267307,41,29,1972,12,"female",339,15,6,2,0,2,0,0,0
1267318,41,13,1972,2,"male",240,379,325,387,268,387,182,0,86
1267352,23,11,1990,4,"male",883,2211,1684,3294,546,1447,496,1847,50
1267366,23,10,1990,9,"male",516,416,318,22,31,22,30,0,1
1267387,27,22,1986,10,"male",1639,12,4,0,3,0,2,0,1
1267401,26,24,1987,4,"male",8,13,9,0,0,0,0,0,0
1267458,19,6,1994,12,"female",485,130,87,209,184,171,154,38,30
1267470,58,25,1955,5,"male",494,21,15,0,0,0,0,0,0
1267526,32,22,1981,3,"female",1588,350,95,549,1337,378,1107,171,230
1267542,49,4,1964,4,"female",1753,199,75,15,27,15,16,0,11
1267551,33,21,1980,6,"male",612,512,422,137,55,132,30,5,25
1267622,53,31,1960,12,"male",116,20,16,7,11,5,4,2,7
1267653,108,23,1905,9,"male",1156,209,76,20,1,15,0,5,1
1267662,17,20,1996,10,"female",590,2053,836,244,685,244,479,0,206
1267671,36,13,1977,4,"male",446,40,33,30,22,30,11,0,11
1267728,54,28,1959,8,"female",232,41,25,8,3,8,3,0,0
1267740,22,1,1991,1,"male",272,26,17,0,3,0,1,0,2
1267789,14,12,1999,8,"male",36,14,2,0,0,0,0,0,0
1267811,25,28,1988,9,"male",442,80,6,26,65,26,47,0,18
1267849,23,5,1990,9,"male",334,21,15,0,0,0,0,0,0
1267863,51,19,1962,9,"male",552,24,3,2,27,1,19,1,8
1267880,25,7,1988,7,"male",244,14,12,1,0,1,0,0,0
1267891,16,27,1997,11,"male",257,22,14,1,0,1,0,0,0
1267910,35,17,1978,2,"male",466,47,41,118,31,75,8,43,23
1267927,42,31,1971,5,"female",292,38,26,0,1,0,1,0,0
1267936,66,13,1947,1,"female",1165,107,62,1,1,1,1,0,0
1267938,22,1,1991,9,"male",307,203,31,0,0,0,0,0,0
1267945,62,27,1951,11,"female",949,109,85,2,5,2,5,0,0
1267953,103,12,1910,6,"male",941,626,445,18,5,18,5,0,0
1267974,22,5,1991,4,"male",382,98,57,78,5,39,3,39,2
1267985,32,20,1981,2,"male",236,94,45,4,0,0,0,4,0
1267998,18,24,1995,9,"male",1339,171,109,30,11,30,8,0,3
1268032,40,27,1973,10,"male",596,19,14,5,2,5,2,0,0
1268041,18,29,1995,5,"male",1378,1253,449,400,419,107,320,293,99
1268043,26,3,1987,6,"male",170,154,128,149,179,149,77,0,102
1268052,108,25,1905,12,"male",1507,122,35,0,46,0,12,0,34
1268078,108,4,1905,9,"female",1079,555,319,42,31,42,20,0,11
1268085,45,22,1968,8,"male",474,60,47,86,3,61,3,25,0
1268095,20,29,1993,6,"male",731,648,289,20,19,3,4,17,15
1268128,23,7,1990,12,"male",538,146,23,7,6,7,1,0,5
1268130,20,14,1993,3,"female",459,384,179,612,1194,608,987,4,207
1268137,26,9,1987,9,"female",250,1137,686,862,390,347,312,515,78
1268142,45,20,1968,12,"female",536,67,30,328,189,290,162,38,27
1268145,30,20,1983,1,"female",521,159,75,0,1,0,0,0,1
1268173,21,11,1992,11,"male",46,32,10,7,6,7,5,0,1
1268188,16,20,1997,6,"female",528,1137,609,214,640,120,430,94,210
1268190,26,16,1987,5,"male",415,55,36,44,19,44,17,0,2
1268240,23,26,1990,2,"male",144,1,1,111,231,25,84,86,147
1268247,26,28,1987,2,"male",388,42,32,0,2,0,2,0,0
1268253,25,20,1988,12,"male",538,13,6,1,1,0,1,1,0
1268265,41,25,1972,9,"female",428,40,18,0,1,0,1,0,0
1268274,16,9,1997,1,"male",480,162,69,93,143,76,68,17,75
1268287,31,25,1982,3,"male",140,38,37,0,1,0,1,0,0
1268294,20,5,1993,7,"male",664,553,262,142,241,142,198,0,43
1268299,23,17,1990,9,"male",227,109,90,79,13,79,8,0,5
1268318,19,24,1994,2,"male",238,275,199,0,1,0,1,0,0
1268323,27,11,1986,11,"female",105,27,11,3,2,3,2,0,0
1268329,15,15,1998,9,"male",621,96,62,4,9,4,5,0,4
1268335,22,22,1991,7,"female",444,1031,358,431,579,82,298,349,281
1268339,22,3,1991,3,"female",244,258,167,582,767,37,558,545,209
1268356,22,14,1991,2,"male",77,78,59,1,3,0,2,1,1
1268385,21,18,1992,4,"female",550,130,77,300,68,203,25,97,43
1268390,72,30,1941,12,"male",628,37,21,8,1,8,1,0,0
1268401,33,23,1980,11,"male",306,123,64,1,3,0,2,1,1
1268422,22,25,1991,5,"male",447,257,158,45,41,45,30,0,11
1268434,27,1,1986,7,"male",810,180,165,193,25,193,24,0,1
1268436,20,14,1993,2,"male",45,0,0,0,0,0,0,0,0
1268443,25,1,1988,10,"male",62,19,14,7,7,7,2,0,5
1268492,19,10,1994,11,"male",715,397,301,2,9,2,8,0,1
1268504,27,6,1986,9,"male",1428,533,206,1,10,0,5,1,5
1268543,55,6,1958,6,"female",191,10,2,2,2,2,2,0,0
1268548,56,3,1957,7,"female",1272,36,10,45,7,45,5,0,2
1268598,27,9,1986,3,"male",301,58,27,27,44,3,14,24,30
1268600,56,20,1957,12,"female",356,10,9,0,0,0,0,0,0
1268648,53,24,1960,1,"female",645,520,305,1,5,1,3,0,2
1268652,17,27,1996,11,"male",204,12,10,19,3,0,0,19,3
1268675,15,19,1998,11,"female",392,965,180,135,493,56,225,79,268
1268687,55,28,1958,1,"male",774,1200,716,6,41,0,27,6,14
1268695,20,8,1993,10,"male",27,2,1,0,0,0,0,0,0
1268773,25,14,1988,5,"female",342,32,18,61,9,0,2,61,7
1268782,68,10,1945,2,"male",1350,339,176,1,24,0,12,1,12
1268819,23,1,1990,1,"male",370,94,61,65,29,65,25,0,4
1268840,43,7,1970,10,"male",520,18,13,14,0,14,0,0,0
1268846,108,6,1905,10,"male",1107,2653,410,499,378,497,335,2,43
1268860,46,23,1967,9,"female",301,127,76,85,23,85,19,0,4
1268878,24,13,1989,7,"male",1073,353,225,1,0,0,0,1,0
1268896,44,8,1969,1,"male",283,2,1,0,0,0,0,0,0
1268897,17,12,1996,9,"male",303,3,2,0,0,0,0,0,0
1268909,62,7,1951,8,"female",216,165,119,1187,1676,1187,1473,0,203
1268915,17,1,1996,10,"male",246,120,88,2,0,2,0,0,0
1268924,24,30,1989,3,"male",169,364,207,430,700,427,451,3,249
1268926,27,2,1986,8,"male",276,184,137,0,0,0,0,0,0
1268927,38,1,1975,3,"female",518,61,35,0,1,0,1,0,0
1268969,18,12,1995,6,"male",197,262,155,44,43,22,19,22,24
1268975,21,3,1992,3,"male",430,121,100,1,68,1,49,0,19
1268996,37,31,1976,12,"male",334,52,37,45,8,45,7,0,1
1269011,24,3,1989,7,"male",193,39,35,0,1,0,1,0,0
1269046,26,1,1987,1,"female",749,217,98,165,143,106,75,59,68
1269064,15,2,1998,2,"male",503,0,0,0,0,0,0,0,0
1269065,47,9,1966,5,"male",504,66,44,444,93,377,58,67,35
1269075,35,11,1978,6,"female",381,114,55,126,40,126,40,0,0
1269088,72,7,1941,2,"male",1502,105,60,5,4,0,0,5,4
1269126,94,4,1919,5,"male",1074,310,232,194,19,109,18,85,1
1269131,17,15,1996,8,"male",334,527,469,36,72,36,28,0,44
1269136,25,22,1988,12,"male",655,343,309,79,4,79,3,0,1
1269137,20,26,1993,4,"male",925,387,204,51,114,51,90,0,24
1269144,44,27,1969,1,"male",412,5,2,29,7,29,2,0,5
1269151,36,11,1977,9,"male",1052,147,118,307,2,307,2,0,0
1269167,49,17,1964,10,"male",477,9,8,9,0,0,0,9,0
1269172,20,25,1993,8,"male",238,9,7,31,19,29,4,2,15
1269185,16,14,1997,1,"male",398,307,190,5,15,5,14,0,1
1269193,18,1,1995,1,"male",292,256,121,1,14,1,8,0,6
1269231,23,9,1990,4,"male",160,45,38,32,1,32,1,0,0
1269242,34,29,1979,11,"male",321,65,61,126,148,126,137,0,11
1269250,20,12,1993,9,"male",344,342,314,5,6,5,6,0,0
1269264,28,23,1985,10,"male",360,17,16,0,0,0,0,0,0
1269284,25,4,1988,11,"male",428,83,25,0,0,0,0,0,0
1269288,108,11,1905,9,"male",1714,408,232,535,372,535,250,0,122
1269294,19,23,1994,8,"male",262,161,120,6,0,6,0,0,0
1269295,23,17,1990,8,"male",5,8,8,61,0,61,0,0,0
1269302,18,22,1995,5,"male",209,97,88,2,4,2,4,0,0
1269316,54,14,1959,1,"male",681,8,3,0,0,0,0,0,0
1269357,44,18,1969,6,"female",1030,12,5,0,0,0,0,0,0
1269367,25,1,1988,1,"male",286,45,33,85,41,85,24,0,17
1269375,25,19,1988,11,"female",154,29,24,0,2,0,2,0,0
1269391,51,29,1962,3,"male",409,3,2,0,0,0,0,0,0
1269393,20,4,1993,4,"male",543,72,50,2304,1664,2304,987,0,677
1269396,15,3,1998,5,"female",210,208,107,0,0,0,0,0,0
1269411,54,14,1959,8,"male",2177,587,335,192,398,36,66,156,332
1269420,18,31,1995,12,"female",233,30,21,2,7,2,6,0,1
1269436,15,17,1998,9,"female",449,1233,683,1275,1226,1230,1036,45,190
1269443,15,23,1998,12,"female",582,1215,425,89,74,89,32,0,42
1269479,20,9,1993,11,"female",335,467,24,1,17,1,13,0,4
1269503,61,29,1952,2,"female",1736,84,38,41,46,0,8,41,38
1269518,113,20,1900,8,"female",2480,102,17,8,18,8,16,0,2
1269520,108,7,1905,5,"female",1937,352,173,88,23,2,14,86,9
1269538,16,12,1997,12,"female",927,397,247,1385,279,1385,163,0,116
1269612,26,10,1987,7,"male",448,362,229,593,366,497,199,96,167
1269617,33,6,1980,6,"male",497,37,12,0,1,0,1,0,0
1269623,28,14,1985,5,"male",399,183,80,1,5,1,4,0,1
1269666,19,26,1994,7,"female",315,174,45,49,38,49,30,0,8
1269694,54,28,1959,5,"female",1156,15,6,151,25,0,4,151,21
1269697,48,21,1965,1,"female",1007,128,25,116,51,114,33,2,18
1269705,39,18,1974,1,"female",380,35,26,57,25,1,2,56,23
1269745,34,1,1979,4,"male",352,19,6,0,0,0,0,0,0
1269752,20,1,1993,4,"female",353,267,164,28,26,2,8,26,18
1269819,15,6,1998,3,"female",145,76,21,1,18,1,9,0,9
1269849,18,15,1995,12,"female",1482,6,1,0,1,0,0,0,1
1269866,23,30,1990,5,"female",113,300,150,166,131,166,91,0,40
1269872,103,9,1910,12,"female",939,226,111,139,33,32,9,107,24
1269881,21,9,1992,11,"male",114,41,29,3,2,3,1,0,1
1269893,25,16,1988,8,"male",596,54,33,10,4,10,4,0,0
1269911,22,5,1991,2,"male",366,15,13,25,0,25,0,0,0
1269912,35,16,1978,11,"male",143,33,30,41,55,41,25,0,30
1269927,18,22,1995,3,"male",253,458,415,133,116,133,98,0,18
1269937,16,19,1997,1,"female",631,3763,498,6369,19397,2386,12342,3983,7055
1269947,33,11,1980,4,"male",326,72,53,38,9,8,3,30,6
1269956,17,2,1996,4,"male",430,138,86,2,11,2,9,0,2
1269977,28,18,1985,3,"male",134,5,4,1,0,1,0,0,0
1270004,30,12,1983,4,"male",237,73,67,1,0,1,0,0,0
1270007,25,1,1988,1,"male",35,23,19,2,29,2,23,0,6
1270033,30,6,1983,3,"male",940,9,3,0,2,0,0,0,2
1270035,29,1,1984,1,"male",193,54,20,21,28,21,18,0,10
1270036,84,9,1929,1,"female",1577,75,38,22,33,7,16,15,17
1270078,18,13,1995,2,"male",239,257,108,0,0,0,0,0,0
1270094,85,5,1928,8,"male",2133,218,107,0,0,0,0,0,0
1270146,14,2,1999,11,"male",280,57,33,46,10,42,8,4,2
1270186,17,25,1996,9,"male",735,516,349,47,36,37,16,10,20
1270209,50,13,1963,4,"female",309,414,145,1514,616,1449,458,65,158
1270224,41,6,1972,6,"female",166,359,307,1480,1652,120,597,1360,1055
1270233,22,19,1991,9,"male",312,1,0,0,0,0,0,0,0
1270240,33,23,1980,10,"male",157,1,0,9,3,4,0,5,3
1270245,41,5,1972,3,"male",195,5,0,3,1,3,1,0,0
1270255,57,13,1956,3,"male",449,16,10,3,0,3,0,0,0
1270266,37,14,1976,8,"female",360,133,66,159,79,158,58,1,21
1270267,57,4,1956,4,"male",787,53,19,9,13,0,8,9,5
1270277,103,28,1910,6,"male",982,281,92,691,479,691,222,0,257
1270282,82,31,1931,5,"female",1568,26,13,8,1,0,1,8,0
1270308,44,10,1969,7,"male",554,85,64,1,0,1,0,0,0
1270309,27,20,1986,10,"male",660,56,8,41,0,41,0,0,0
1270314,25,1,1988,6,"male",222,316,250,5,4,5,4,0,0
1270367,23,18,1990,9,"male",521,47,32,28,15,28,6,0,9
1270371,23,20,1990,7,"female",314,43,34,3,25,3,7,0,18
1270387,19,19,1994,4,"male",480,219,193,1,0,0,0,1,0
1270394,24,3,1989,3,"female",120,51,35,58,31,58,28,0,3
1270406,26,1,1987,1,"female",35,1054,708,2430,2626,136,360,2294,2266
1270454,17,3,1996,5,"male",860,228,156,5,8,1,4,4,4
1270467,25,20,1988,12,"female",162,1020,589,3896,3392,959,1585,2937,1807
1270482,26,14,1987,10,"male",1277,267,166,6,8,6,2,0,6
1270493,23,1,1990,2,"male",198,150,110,0,11,0,6,0,5
1270515,48,28,1965,10,"female",619,92,69,147,55,0,10,147,45
1270520,16,27,1997,8,"male",322,90,75,284,174,281,56,3,118
1270561,26,20,1987,3,"female",77,169,116,98,78,12,65,86,13
1270573,25,1,1988,1,"male",259,330,320,0,0,0,0,0,0
1270582,23,27,1990,6,"male",893,214,127,0,3,0,3,0,0
1270589,33,24,1980,12,"male",427,64,42,1,0,1,0,0,0
1270630,17,18,1996,7,"female",324,1625,545,172,456,147,417,25,39
1270635,28,5,1985,11,"male",578,80,17,19,2,19,2,0,0
1270637,19,18,1994,5,"female",423,418,162,2,5,2,4,0,1
1270663,30,5,1983,2,"female",1209,419,235,95,387,24,165,71,222
1270678,21,24,1992,5,"female",375,353,301,31,59,31,42,0,17
1270680,16,7,1997,2,"male",50,29,20,0,0,0,0,0,0
1270717,21,22,1992,2,"male",288,427,304,364,123,364,90,0,33
1270726,23,10,1990,5,"male",334,179,151,50,44,0,9,50,35
1270750,68,7,1945,7,"male",111,19,17,1,0,0,0,1,0
1270778,17,13,1996,3,"male",420,130,77,3,16,3,5,0,11
1270799,18,29,1995,8,"male",568,391,339,16,0,0,0,16,0
1270830,23,4,1990,4,"male",583,249,203,1,0,1,0,0,0
1270864,108,31,1905,8,"male",1200,146,76,14,3,1,2,13,1
1270873,77,25,1936,12,"male",64,9,4,0,0,0,0,0,0
1270893,48,29,1965,11,"male",573,12,4,0,0,0,0,0,0
1270918,64,1,1949,7,"female",990,44,16,0,1,0,0,0,1
1270938,70,24,1943,8,"female",1024,68,36,1,1,0,0,1,1
1270956,20,12,1993,2,"female",482,57,5,0,0,0,0,0,0
1270973,30,23,1983,11,"male",309,249,145,38,57,38,23,0,34
1271002,49,20,1964,4,"male",1088,15,4,0,0,0,0,0,0
1271012,21,3,1992,4,"male",564,170,82,1,0,1,0,0,0
1271045,66,23,1947,11,"male",70,2,2,0,0,0,0,0,0
1271055,49,25,1964,3,"female",1117,396,206,15,10,15,6,0,4
1271072,108,13,1905,6,"male",1674,4770,2032,4,40,0,34,4,6
1271110,53,25,1960,6,"male",421,49,38,3,6,0,3,3,3
1271120,65,23,1948,11,"female",1190,116,37,53,63,1,29,52,34
1271145,57,8,1956,9,"male",1459,34,13,3,1,0,1,3,0
1271149,28,4,1985,2,"male",640,65,47,16,2,16,2,0,0
1271174,60,17,1953,10,"male",1600,277,106,5,10,4,6,1,4
1271178,64,12,1949,7,"female",1619,42,9,2,0,2,0,0,0
1271188,19,3,1994,6,"male",498,255,210,16,2,16,2,0,0
1271214,46,19,1967,2,"female",85,67,66,108,72,106,51,2,21
1271215,88,23,1925,6,"male",458,272,203,1,1,1,0,0,1
1271235,46,13,1967,9,"male",1201,33,24,2,2,0,1,2,1
1271338,34,20,1979,2,"female",729,21,16,0,0,0,0,0,0
1271360,24,12,1989,1,"male",882,38,24,1,2,1,2,0,0
1271367,51,12,1962,2,"female",56,15,10,10,4,10,4,0,0
1271395,27,8,1986,6,"male",192,27,24,0,0,0,0,0,0
1271405,19,15,1994,11,"male",523,62,56,0,21,0,17,0,4
1271431,51,29,1962,3,"male",461,13,4,0,1,0,1,0,0
1271438,14,7,1999,2,"male",168,655,537,0,0,0,0,0,0
1271483,44,30,1969,10,"male",139,92,71,33,22,0,9,33,13
1271485,24,20,1989,7,"male",545,443,286,213,468,178,406,35,62
1271525,17,23,1996,3,"male",561,2347,1411,1353,1636,885,749,468,887
1271528,20,18,1993,4,"female",572,272,171,486,177,388,124,98,53
1271532,57,2,1956,9,"male",61,151,79,569,27,0,8,569,19
1271533,19,27,1994,1,"male",340,50,34,0,0,0,0,0,0
1271541,69,6,1944,12,"male",2082,33,9,3,8,3,3,0,5
1271567,31,9,1982,2,"male",303,7,5,0,0,0,0,0,0
1271571,21,10,1992,6,"male",857,363,170,15,80,8,12,7,68
1271595,103,15,1910,1,"female",662,222,108,16,8,16,8,0,0
1271602,24,14,1989,2,"male",302,105,78,1,0,0,0,1,0
1271608,19,2,1994,11,"female",458,3,2,0,0,0,0,0,0
1271610,21,8,1992,7,"female",404,332,171,195,93,195,53,0,40
1271644,31,16,1982,7,"male",626,179,63,6,0,6,0,0,0
1271656,47,11,1966,12,"male",639,8,5,0,0,0,0,0,0
1271662,26,3,1987,3,"male",408,20,20,9,4,0,2,9,2
1271666,31,9,1982,10,"male",488,51,23,25,17,25,14,0,3
1271681,41,15,1972,9,"male",494,7,2,13,0,9,0,4,0
1271686,38,15,1975,6,"male",148,9,8,336,15,0,13,336,2
1271689,15,12,1998,8,"female",346,66,41,659,612,659,279,0,333
1271702,61,12,1952,3,"female",1713,118,69,168,66,1,55,167,11
1271729,14,13,1999,11,"female",182,17,11,9,3,9,0,0,3
1271732,53,12,1960,10,"male",380,24,11,213,10,213,3,0,7
1271784,17,26,1996,7,"female",580,190,51,1018,662,808,240,210,422
1271789,52,25,1961,8,"female",152,51,34,126,62,94,28,32,34
1271795,23,25,1990,12,"female",613,517,217,75,137,75,119,0,18
1271829,19,31,1994,7,"male",476,13,9,1,0,1,0,0,0
1271873,25,8,1988,8,"male",300,19,16,3,2,3,0,0,2
1271937,41,9,1972,9,"female",116,21,7,0,0,0,0,0,0
1271950,44,23,1969,3,"female",370,72,46,18,67,18,27,0,40
1271962,17,4,1996,12,"male",541,50,44,0,0,0,0,0,0
1271980,61,23,1952,12,"female",724,35,20,2,1,0,0,2,1
1271981,22,1,1991,4,"male",317,260,213,1,1,1,1,0,0
1271986,33,8,1980,5,"female",802,214,96,3,5,1,5,2,0
1271987,18,23,1995,3,"male",303,6,6,4,1,0,0,4,1
1272005,23,18,1990,12,"male",188,3,3,0,4,0,0,0,4
1272040,59,12,1954,5,"female",536,0,0,0,0,0,0,0,0
1272055,21,3,1992,11,"male",361,122,81,2697,1234,2676,480,21,754
1272063,20,25,1993,5,"male",362,30,22,1,0,1,0,0,0
1272124,59,6,1954,6,"male",1664,355,157,630,447,205,159,425,288
1272126,15,30,1998,4,"male",699,253,150,2,37,2,37,0,0
1272133,22,10,1991,5,"female",219,17,8,20,0,8,0,12,0
1272175,34,1,1979,5,"male",206,10,6,0,1,0,1,0,0
1272207,32,21,1981,8,"male",503,109,51,19,15,19,4,0,11
1272213,31,29,1982,12,"male",496,249,183,43,15,0,3,43,12
1272215,55,2,1958,8,"female",203,127,32,184,55,184,35,0,20
1272218,62,23,1951,9,"female",1888,183,134,247,81,247,34,0,47
1272236,23,23,1990,7,"female",313,25,8,77,55,0,7,77,48
1272238,28,26,1985,2,"female",533,369,275,111,187,8,21,103,166
1272256,31,1,1982,2,"male",139,88,85,0,6,0,6,0,0
1272274,71,16,1942,3,"female",785,87,70,244,51,244,19,0,32
1272327,62,20,1951,9,"male",1161,78,15,0,0,0,0,0,0
1272348,50,2,1963,10,"male",483,0,0,0,0,0,0,0,0
1272375,18,23,1995,12,"male",707,241,188,8,4,8,4,0,0
1272380,30,20,1983,4,"female",290,86,28,88,160,88,58,0,102
1272390,27,25,1986,11,"female",433,326,230,44,41,44,26,0,15
1272393,26,25,1987,7,"female",510,7,6,0,1,0,1,0,0
1272425,18,31,1995,1,"male",268,31,22,0,0,0,0,0,0
1272428,20,14,1993,6,"male",377,86,50,16,21,16,20,0,1
1272429,100,21,1913,3,"male",512,123,81,4,8,4,6,0,2
1272444,27,13,1986,6,"male",111,134,113,1,0,1,0,0,0
1272455,21,15,1992,10,"female",469,52,30,45,40,45,38,0,2
1272462,57,1,1956,1,"male",83,55,50,3,10,2,3,1,7
1272472,25,1,1988,1,"male",38,28,20,25,9,25,8,0,1
1272474,48,6,1965,1,"male",90,86,71,9,4,9,2,0,2
1272479,19,20,1994,3,"male",13,2,2,72,9,0,0,72,9
1272528,64,16,1949,2,"male",481,129,73,0,0,0,0,0,0
1272529,21,8,1992,12,"male",193,4,2,7,2,0,0,7,2
1272561,51,11,1962,9,"male",258,40,36,8,5,0,4,8,1
1272592,108,2,1905,7,"female",1996,431,348,64,33,31,17,33,16
1272662,50,5,1963,9,"female",1920,312,120,93,179,93,128,0,51
1272674,28,13,1985,11,"female",563,52,25,152,66,152,50,0,16
1272678,63,1,1950,1,"female",2136,131,65,303,145,303,118,0,27
1272707,79,26,1934,5,"male",1156,30,23,20,5,20,2,0,3
1272711,17,15,1996,2,"female",804,36,20,0,25,0,15,0,10
1272732,19,13,1994,11,"male",284,75,44,0,2,0,1,0,1
1272758,43,7,1970,5,"male",340,18,12,0,1,0,0,0,1
1272764,23,30,1990,7,"male",202,102,89,105,4,105,2,0,2
1272774,62,15,1951,9,"female",1180,407,143,987,118,451,63,536,55
1272807,38,14,1975,2,"male",510,20,3,263,35,262,30,1,5
1272809,50,20,1963,4,"female",1151,48,34,8,6,8,3,0,3
1272839,35,18,1978,1,"male",240,317,242,40,122,1,41,39,81
1272840,63,6,1950,5,"female",190,29,26,0,0,0,0,0,0
1272847,25,1,1988,1,"male",15,23,17,397,42,397,39,0,3
1272854,37,18,1976,2,"male",339,74,51,0,0,0,0,0,0
1272869,34,6,1979,3,"female",195,165,115,13,66,13,52,0,14
1272875,21,30,1992,4,"female",430,100,70,64,42,64,27,0,15
1272892,16,4,1997,2,"male",141,98,2,0,3,0,1,0,2
1272918,26,31,1987,10,"female",309,211,63,82,186,82,123,0,63
1272921,61,19,1952,5,"female",1425,88,43,78,31,73,18,5,13
1272928,17,5,1996,2,"male",306,32,21,2,12,0,4,2,8
1272935,108,7,1905,9,"female",2194,111,34,315,365,40,226,275,139
1272957,18,24,1995,12,"male",144,312,288,2,1,2,1,0,0
1272974,22,12,1991,4,"male",547,1,1,0,0,0,0,0,0
1272997,53,5,1960,1,"male",114,11,8,0,0,0,0,0,0
1273012,21,6,1992,6,"female",484,36,20,0,0,0,0,0,0
1273029,61,31,1952,12,"female",355,25,12,240,7,173,2,67,5
1273030,22,16,1991,5,"male",278,202,119,217,89,217,74,0,15
1273032,17,22,1996,8,"male",456,96,79,2,5,2,1,0,4
1273088,16,27,1997,6,"male",153,74,56,0,1,0,1,0,0
1273093,36,15,1977,11,"female",661,0,0,0,0,0,0,0,0
1273096,63,24,1950,6,"male",1225,32,28,0,0,0,0,0,0
1273119,23,17,1990,4,"female",394,98,46,3,0,3,0,0,0
1273130,57,30,1956,7,"male",1076,17,14,0,0,0,0,0,0
1273143,23,7,1990,11,"male",32,19,14,0,1,0,0,0,1
1273193,18,10,1995,8,"male",180,95,23,159,22,0,0,159,22
1273211,43,27,1970,11,"male",1141,99,35,0,0,0,0,0,0
1273250,73,24,1940,9,"female",787,27,13,21,4,0,1,21,3
1273259,92,20,1921,10,"male",394,46,28,32,6,11,1,21,5
1273268,53,28,1960,3,"female",1803,243,161,52,101,51,50,1,51
1273280,35,31,1978,7,"female",370,118,74,6,27,6,24,0,3
1273289,51,10,1962,3,"male",326,7,4,0,4,0,2,0,2
1273323,23,10,1990,4,"male",274,63,22,456,1243,9,564,447,679
1273325,16,1,1997,1,"female",579,651,320,48,38,27,31,21,7
1273336,18,16,1995,12,"female",1003,1108,492,6280,3100,3026,1598,3254,1502
1273340,69,25,1944,6,"female",1828,29,8,0,0,0,0,0,0
1273342,21,12,1992,2,"female",519,5,2,0,0,0,0,0,0
1273352,53,21,1960,9,"female",890,21,18,40,7,34,7,6,0
1273370,42,24,1971,8,"male",485,21,11,2,0,2,0,0,0
1273405,66,5,1947,5,"male",1345,89,30,0,0,0,0,0,0
1273429,56,26,1957,6,"female",916,138,93,94,167,93,136,1,31
1273436,36,10,1977,9,"female",528,70,57,16,163,16,145,0,18
1273463,45,1,1968,1,"male",956,181,150,13,2,13,2,0,0
1273468,15,14,1998,3,"female",477,286,153,39,23,39,20,0,3
1273471,79,7,1934,8,"female",924,17,8,69,20,69,5,0,15
1273493,58,20,1955,3,"male",1930,69,25,22,18,21,9,1,9
1273498,18,17,1995,4,"female",511,20,17,55,0,55,0,0,0
1273550,26,22,1987,11,"male",1042,273,180,9,0,9,0,0,0
1273559,18,11,1995,11,"male",389,223,144,98,46,96,37,2,9
1273584,23,1,1990,3,"male",140,22,21,68,6,68,4,0,2
1273597,53,9,1960,12,"female",1651,393,234,5238,5032,2841,1142,2397,3890
1273612,21,16,1992,7,"male",871,288,115,4,50,4,48,0,2
1273617,17,16,1996,9,"male",254,51,21,0,0,0,0,0,0
1273624,20,18,1993,3,"male",172,125,124,13,1,13,1,0,0
1273625,49,14,1964,8,"male",1067,35,21,0,3,0,1,0,2
1273630,25,4,1988,1,"male",169,40,29,9,7,9,7,0,0
1273639,39,11,1974,7,"male",175,69,45,51,4,26,1,25,3
1273641,32,4,1981,6,"male",646,27,12,1,0,0,0,1,0
1273646,16,13,1997,9,"female",163,245,42,6,52,6,32,0,20
1273648,66,1,1947,12,"male",559,28,15,1,5,0,2,1,3
1273661,23,26,1990,10,"female",679,291,82,215,129,133,81,82,48
1273692,68,15,1945,3,"male",1201,132,60,154,90,38,68,116,22
1273694,23,1,1990,7,"female",559,125,29,0,0,0,0,0,0
1273719,17,12,1996,2,"male",278,46,37,6,17,6,15,0,2
1273722,66,22,1947,4,"male",1091,15,8,1,1,1,1,0,0
1273724,19,25,1994,8,"female",164,614,37,180,276,180,217,0,59
1273744,33,1,1980,2,"male",547,803,626,344,193,344,131,0,62
1273770,20,23,1993,4,"male",234,55,43,3,8,3,8,0,0
1273775,23,1,1990,1,"female",561,2,1,0,0,0,0,0,0
1273784,68,23,1945,5,"female",669,1911,412,1038,262,57,190,981,72
1273862,14,1,1999,11,"female",670,825,516,528,669,372,425,156,244
1273880,33,2,1980,2,"male",37,71,42,1,1,1,1,0,0
1273881,103,23,1910,12,"female",713,420,373,49,45,49,32,0,13
1273884,30,12,1983,8,"female",357,58,29,0,2,0,2,0,0
1273900,27,10,1986,1,"female",591,85,64,327,0,327,0,0,0
1273931,29,14,1984,8,"male",296,27,25,0,1,0,1,0,0
1273992,15,16,1998,12,"male",189,59,46,7,1,7,0,0,1
1274012,27,15,1986,10,"female",585,17,10,115,7,115,7,0,0
1274021,45,7,1968,8,"female",1550,41,14,5,2,0,1,5,1
1274024,24,20,1989,10,"male",326,205,186,3,8,3,3,0,5
1274039,49,6,1964,7,"male",603,8,1,1,5,0,2,1,3
1274046,23,15,1990,7,"male",473,21,14,8,0,8,0,0,0
1274052,20,1,1993,1,"female",97,44,19,2,7,1,2,1,5
1274057,26,12,1987,6,"male",883,25,12,2,0,2,0,0,0
1274068,23,24,1990,4,"female",241,186,151,1,1,0,0,1,1
1274072,17,1,1996,10,"male",301,14,8,1,1,1,1,0,0
1274073,27,10,1986,5,"male",581,46,26,3,0,3,0,0,0
1274146,15,12,1998,3,"male",772,200,110,0,0,0,0,0,0
1274155,46,21,1967,10,"female",459,40,21,22,15,3,7,19,8
1274180,39,16,1974,1,"male",1115,80,55,78,23,78,13,0,10
1274204,64,3,1949,2,"female",116,33,16,36,10,3,8,33,2
1274216,26,16,1987,8,"male",107,67,60,1,1,1,1,0,0
1274222,28,27,1985,12,"male",327,101,89,1,9,1,9,0,0
1274238,28,5,1985,5,"male",640,256,224,0,0,0,0,0,0
1274248,25,1,1988,1,"male",294,54,54,2,0,0,0,2,0
1274257,24,16,1989,10,"male",741,202,117,22,0,6,0,16,0
1274287,54,23,1959,4,"male",798,163,77,42,18,4,7,38,11
1274296,24,10,1989,1,"male",853,261,162,5,53,5,41,0,12
1274318,68,28,1945,5,"male",681,399,191,0,12,0,9,0,3
1274324,100,17,1913,6,"male",1838,178,16,4,10,4,4,0,6
1274347,17,28,1996,3,"female",1187,400,183,294,102,279,93,15,9
1274387,29,14,1984,8,"male",248,416,286,1298,312,222,222,1076,90
1274392,62,21,1951,5,"male",234,22,19,87,7,72,3,15,4
1274399,24,7,1989,9,"male",294,157,77,2,0,2,0,0,0
1274414,25,27,1988,11,"male",948,91,79,5,0,5,0,0,0
1274420,22,23,1991,2,"female",389,140,59,1,1,1,0,0,1
1274436,19,2,1994,2,"male",262,93,32,27,25,4,8,23,17
1274441,47,10,1966,8,"male",918,314,123,86,145,74,82,12,63
1274457,31,6,1982,1,"male",244,20,7,3,1,3,1,0,0
1274463,21,19,1992,4,"female",1177,3442,1037,1571,7340,1571,4816,0,2524
1274477,24,15,1989,10,"male",531,321,174,0,5,0,4,0,1
1274484,16,26,1997,4,"male",108,366,335,66,88,63,23,3,65
1274494,53,1,1960,1,"male",764,57,49,0,0,0,0,0,0
1274538,46,20,1967,10,"female",460,51,31,101,279,101,135,0,144
1274576,35,29,1978,8,"male",317,73,42,1,0,1,0,0,0
1274593,20,25,1993,10,"female",18,84,11,23,89,23,41,0,48
1274597,65,20,1948,5,"female",96,68,48,345,240,345,212,0,28
1274679,17,1,1996,2,"male",402,1,1,0,14,0,0,0,14
1274687,17,7,1996,9,"male",213,72,55,0,0,0,0,0,0
1274703,49,20,1964,1,"female",158,57,52,56,1,40,1,16,0
1274705,26,30,1987,3,"female",463,7,6,20,0,20,0,0,0
1274716,26,11,1987,1,"male",332,62,41,1,1,1,0,0,1
1274728,29,2,1984,3,"male",544,109,87,2,2,2,0,0,2
1274751,16,8,1997,8,"male",458,34,29,1,0,0,0,1,0
1274777,17,6,1996,4,"male",693,153,54,5,3,0,1,5,2
1274794,21,11,1992,11,"female",346,209,172,101,55,46,12,55,43
1274812,14,19,1999,3,"male",287,31,19,2,1,2,1,0,0
1274824,26,1,1987,1,"male",423,40,25,1,0,1,0,0,0
1274826,54,16,1959,8,"female",1367,421,227,354,395,93,109,261,286
1274847,36,2,1977,5,"male",53,20,17,0,0,0,0,0,0
1274853,29,17,1984,12,"male",597,229,106,1,0,1,0,0,0
1274860,26,20,1987,9,"male",756,28,15,9,9,0,4,9,5
1274881,36,30,1977,10,"female",560,324,140,891,697,612,567,279,130
1274920,15,24,1998,1,"female",562,260,160,456,250,418,148,38,102
1274951,27,17,1986,12,"male",195,126,109,18,4,18,1,0,3
1274959,22,30,1991,3,"female",283,7,3,8,0,0,0,8,0
1274973,57,14,1956,10,"male",739,109,61,9,48,0,12,9,36
1274975,30,30,1983,3,"female",804,182,119,40,108,40,40,0,68
1274981,18,24,1995,2,"male",8,1,1,0,0,0,0,0,0
1275015,80,12,1933,8,"male",1294,658,291,142,30,142,30,0,0
1275018,21,14,1992,9,"female",207,118,29,143,299,143,277,0,22
1275072,42,19,1971,12,"male",200,165,143,148,122,146,88,2,34
1275078,28,2,1985,3,"male",719,147,90,1,1,1,1,0,0
1275095,22,26,1991,10,"female",479,1095,78,200,92,200,75,0,17
1275133,35,5,1978,2,"male",135,64,48,0,12,0,7,0,5
1275136,61,9,1952,7,"female",1825,58,26,37,56,6,30,31,26
1275155,37,19,1976,3,"male",481,224,121,77,122,65,86,12,36
1275253,41,24,1972,3,"female",166,84,43,54,28,54,10,0,18
1275256,52,14,1961,11,"female",223,54,35,75,34,75,33,0,1
1275269,43,23,1970,9,"female",48,27,22,990,145,990,50,0,95
1275282,70,21,1943,11,"female",732,69,44,0,0,0,0,0,0
1275309,61,4,1952,7,"female",140,76,40,10,23,0,8,10,15
1275310,14,4,1999,1,"male",35,319,243,1275,1072,559,751,716,321
1275323,20,28,1993,5,"male",924,271,204,78,53,58,7,20,46
1275335,66,4,1947,9,"female",121,92,42,68,16,50,10,18,6
1275361,56,10,1957,6,"female",212,12,8,0,0,0,0,0,0
1275378,40,19,1973,11,"male",154,23,15,1,0,1,0,0,0
1275431,21,24,1992,8,"male",125,24,16,0,1,0,0,0,1
1275477,60,13,1953,3,"male",744,236,113,0,2,0,2,0,0
1275481,55,4,1958,6,"female",584,173,73,8,24,2,0,6,24
1275489,63,16,1950,8,"female",1697,146,91,93,91,0,48,93,43
1275502,26,15,1987,6,"male",939,354,222,31,185,23,71,8,114
1275514,14,2,1999,4,"male",330,119,73,6,0,2,0,4,0
1275529,59,15,1954,2,"female",1692,67,29,3,2,3,2,0,0
1275552,39,19,1974,3,"male",854,38,31,0,1,0,0,0,1
1275567,27,19,1986,8,"female",358,118,59,68,7,1,3,67,4
1275585,14,6,1999,3,"female",350,360,208,1,0,1,0,0,0
1275605,35,24,1978,2,"female",233,53,40,3,3,3,1,0,2
1275615,43,26,1970,11,"male",657,1072,680,220,139,215,129,5,10
1275620,23,1,1990,5,"female",517,95,71,57,63,57,47,0,16
1275663,18,12,1995,12,"male",599,324,242,2,31,1,18,1,13
1275674,96,13,1917,1,"female",374,358,217,12,55,1,25,11,30
1275706,19,9,1994,2,"male",453,147,125,0,164,0,96,0,68
1275716,54,22,1959,7,"female",541,33,16,4,2,0,2,4,0
1275731,14,20,1999,7,"male",87,36,28,15,3,15,2,0,1
1275739,26,13,1987,5,"male",719,19,19,0,1,0,1,0,0
1275743,14,30,1999,3,"male",256,0,0,11,4,0,2,11,2
1275778,50,1,1963,10,"female",561,48,42,60,13,1,6,59,7
1275782,46,9,1967,11,"male",400,48,34,74,3,0,2,74,1
1275791,45,13,1968,9,"male",217,0,0,0,0,0,0,0,0
1275821,38,16,1975,5,"male",865,12,11,8,12,8,10,0,2
1275828,53,6,1960,10,"female",304,9,4,3,16,3,16,0,0
1275863,105,2,1908,4,"male",1303,253,201,0,2,0,2,0,0
1275871,42,23,1971,4,"male",320,62,58,420,73,420,60,0,13
1275917,40,11,1973,10,"male",87,12,11,8,35,8,33,0,2
1275926,33,6,1980,10,"male",500,86,66,2,5,2,2,0,3
1275945,64,23,1949,10,"female",343,4,4,0,0,0,0,0,0
1275969,66,21,1947,5,"male",423,158,43,14,53,0,6,14,47
1275973,13,11,2000,6,"male",140,66,43,19,2,19,1,0,1
1276009,18,1,1995,8,"female",218,232,196,27,5,27,5,0,0
1276043,45,28,1968,6,"male",626,44,22,18,12,10,9,8,3
1276054,55,24,1958,1,"female",470,18,3,69,14,69,7,0,7
1276125,32,19,1981,6,"male",540,440,287,8,184,8,115,0,69
1276134,17,26,1996,12,"male",979,445,344,2,0,2,0,0,0
1276152,36,7,1977,1,"male",532,126,71,83,130,70,57,13,73
1276194,19,1,1994,1,"male",1058,321,263,4,4,2,2,2,2
1276214,17,20,1996,3,"male",779,210,184,4,5,0,0,4,5
1276219,31,1,1982,7,"male",294,181,87,7,14,0,3,7,11
1276244,61,2,1952,10,"female",763,3,1,0,0,0,0,0,0
1276246,19,28,1994,6,"male",611,276,158,451,251,451,196,0,55
1276248,24,18,1989,11,"female",186,47,22,8,6,8,4,0,2
1276254,49,12,1964,2,"female",259,73,55,119,77,119,71,0,6
1276261,14,28,1999,5,"male",151,27,7,0,6,0,4,0,2
1276265,19,5,1994,11,"male",20,8,7,0,0,0,0,0,0
1276325,29,26,1984,9,"male",441,57,36,7,22,0,5,7,17
1276335,29,20,1984,12,"male",60,42,36,1,2,1,1,0,1
1276341,94,7,1919,10,"female",806,579,229,209,177,209,164,0,13
1276399,32,24,1981,4,"male",328,142,98,17,60,15,24,2,36
1276416,50,17,1963,3,"female",234,25,15,1,1,0,0,1,1
1276432,23,26,1990,2,"female",160,28,22,178,2,178,2,0,0
1276435,28,17,1985,2,"male",407,181,56,2,0,2,0,0,0
1276438,24,30,1989,9,"male",677,123,71,0,0,0,0,0,0
1276466,63,2,1950,9,"female",145,58,27,21,130,21,30,0,100
1276474,23,3,1990,1,"male",589,113,69,33,1,33,1,0,0
1276500,24,4,1989,2,"female",543,372,291,0,8,0,6,0,2
1276503,66,1,1947,12,"female",127,112,70,1,8,1,4,0,4
1276517,19,13,1994,3,"male",701,86,48,11,0,6,0,5,0
1276529,20,6,1993,6,"male",188,80,42,30,153,27,48,3,105
1276564,22,5,1991,6,"male",482,15,13,1,1,1,1,0,0
1276569,55,2,1958,6,"male",1435,74,49,7,0,2,0,5,0
1276570,31,20,1982,10,"female",599,44,7,0,9,0,9,0,0
1276578,36,30,1977,1,"male",107,38,31,5,0,5,0,0,0
1276582,24,28,1989,11,"male",440,614,506,38,21,38,13,0,8
1276606,108,5,1905,3,"male",1775,190,103,50,22,1,5,49,17
1276656,27,6,1986,6,"female",631,107,57,9,45,9,44,0,1
1276670,17,3,1996,2,"male",426,114,71,13,47,13,33,0,14
1276693,102,4,1911,5,"male",775,201,93,12,13,0,2,12,11
1276729,22,18,1991,2,"male",661,358,225,65,83,47,71,18,12
1276742,24,13,1989,2,"female",2100,133,85,467,257,467,223,0,34
1276743,19,25,1994,1,"male",577,242,203,0,2,0,2,0,0
1276746,18,8,1995,11,"female",512,441,212,71,167,55,108,16,59
1276790,39,1,1974,5,"male",256,3,3,3,0,3,0,0,0
1276797,26,1,1987,1,"male",500,2,2,0,0,0,0,0,0
1276837,22,18,1991,1,"female",528,306,145,0,1,0,0,0,1
1276847,20,1,1993,1,"male",756,2,0,1,0,1,0,0,0
1276857,102,26,1911,12,"male",1749,374,148,339,210,0,93,339,117
1276882,22,22,1991,6,"female",643,406,195,0,2,0,2,0,0
1276911,65,27,1948,4,"male",934,143,97,10,5,5,1,5,4
1276971,19,1,1994,2,"male",51,15,12,62,77,42,56,20,21
1276976,89,12,1924,7,"male",1741,179,74,3,2,0,2,3,0
1276992,14,1,1999,1,"male",170,0,0,0,0,0,0,0,0
1277002,24,27,1989,6,"female",388,99,73,5,26,5,16,0,10
1277014,30,24,1983,10,"female",760,39,25,0,0,0,0,0,0
1277017,35,27,1978,12,"female",294,25,11,10,4,1,2,9,2
1277020,50,1,1963,12,"female",752,105,44,17,52,1,19,16,33
1277050,29,26,1984,2,"male",1403,84,26,13,16,0,8,13,8
1277069,36,24,1977,5,"male",99,5,2,0,0,0,0,0,0
1277126,30,26,1983,9,"female",728,85,44,133,91,122,41,11,50
1277225,21,25,1992,3,"male",429,323,109,2338,433,2323,191,15,242
1277227,64,29,1949,5,"female",125,58,50,1408,98,1408,67,0,31
1277233,18,29,1995,8,"male",458,207,162,3,0,0,0,3,0
1277249,13,11,2000,7,"male",365,301,259,17,0,8,0,9,0
1277266,28,4,1985,5,"female",301,62,41,0,0,0,0,0,0
1277288,19,1,1994,7,"male",358,1256,1010,10,58,10,20,0,38
1277365,16,10,1997,5,"female",503,284,162,663,501,24,85,639,416
1277414,38,21,1975,2,"male",1,6,6,0,1,0,0,0,1
1277435,19,7,1994,10,"male",399,147,109,720,573,265,231,455,342
1277456,103,15,1910,7,"female",670,395,76,63,63,63,54,0,9
1277463,57,1,1956,10,"female",55,23,17,7,4,7,4,0,0
1277473,31,26,1982,1,"male",391,53,37,12,3,12,2,0,1
1277476,25,6,1988,3,"male",47,25,14,0,0,0,0,0,0
1277528,15,18,1998,8,"female",543,182,20,44,0,44,0,0,0
1277570,31,29,1982,12,"male",352,65,35,2,8,2,7,0,1
1277572,20,20,1993,7,"female",17,28,9,2,0,2,0,0,0
1277579,16,9,1997,5,"female",385,13,13,0,0,0,0,0,0
1277609,17,26,1996,8,"male",293,67,47,21,13,21,3,0,10
1277640,75,26,1938,1,NA,1469,38,14,20,1,18,0,2,1
1277646,75,4,1938,3,"female",71,11,4,0,0,0,0,0,0
1277682,28,25,1985,10,"female",1155,351,211,936,1080,689,671,247,409
1277718,23,12,1990,1,"female",629,243,189,839,952,815,733,24,219
1277729,26,5,1987,10,"male",960,80,60,44,3,44,3,0,0
1277736,32,26,1981,6,"female",591,214,154,422,565,419,458,3,107
1277769,27,26,1986,10,"male",60,6,5,0,0,0,0,0,0
1277778,39,25,1974,12,"female",62,122,88,45,93,45,65,0,28
1277783,14,9,1999,12,"male",314,77,42,0,0,0,0,0,0
1277820,59,29,1954,5,"male",98,33,29,3,0,2,0,1,0
1277824,31,12,1982,12,"male",1372,328,203,13,19,13,12,0,7
1277844,15,30,1998,12,"male",425,133,105,0,0,0,0,0,0
1277855,32,18,1981,3,"male",303,270,206,12,7,12,4,0,3
1277856,24,5,1989,7,"male",318,85,69,0,0,0,0,0,0
1277863,15,29,1998,3,"male",693,648,173,42,100,1,41,41,59
1277894,27,25,1986,2,"female",390,252,172,281,88,281,25,0,63
1277902,16,8,1997,4,"male",527,76,55,0,1,0,1,0,0
1277905,19,1,1994,2,"male",61,69,27,0,0,0,0,0,0
1277906,69,1,1944,6,"female",397,30,25,48,4,48,4,0,0
1277948,63,3,1950,4,"female",1270,351,100,29,12,28,11,1,1
1277957,21,2,1992,4,"female",799,635,466,36,157,26,145,10,12
1277965,27,8,1986,4,"male",541,75,53,0,0,0,0,0,0
1277968,28,17,1985,9,"female",2195,1386,449,1609,981,1494,542,115,439
1277969,45,30,1968,4,"male",815,51,29,1,0,0,0,1,0
1277971,70,22,1943,10,"female",904,35,17,40,27,3,18,37,9
1277999,25,15,1988,3,"female",245,29,0,0,4,0,4,0,0
1278019,19,4,1994,5,"male",328,211,99,70,3,39,2,31,1
1278036,49,4,1964,1,"female",572,122,108,302,88,302,78,0,10
1278037,35,12,1978,4,"female",551,706,533,104,233,73,179,31,54
1278053,14,24,1999,7,"female",294,26,21,10,5,0,2,10,3
1278082,21,26,1992,11,"male",46,81,78,12,4,12,4,0,0
1278106,23,5,1990,5,"female",273,82,49,94,72,94,52,0,20
1278156,27,10,1986,2,"male",301,4,3,21,0,21,0,0,0
1278158,23,15,1990,7,"female",838,31,26,3,0,3,0,0,0
1278163,37,6,1976,11,"female",473,702,608,126,1246,126,768,0,478
1278174,40,18,1973,5,"male",516,23,20,0,0,0,0,0,0
1278179,25,2,1988,2,"male",136,31,26,1,0,1,0,0,0
1278202,34,26,1979,4,"female",894,119,54,89,128,89,63,0,65
1278207,52,19,1961,5,"male",981,81,18,424,145,424,113,0,32
1278209,36,18,1977,2,"male",506,10,3,11,3,11,0,0,3
1278227,28,16,1985,4,"female",866,289,59,85,9,25,6,60,3
1278232,43,1,1970,1,"male",563,27,15,0,0,0,0,0,0
1278254,26,9,1987,9,"male",982,201,97,0,0,0,0,0,0
1278272,27,31,1986,10,"male",259,27,18,5,16,0,7,5,9
1278286,33,11,1980,11,"male",188,151,78,5,6,5,3,0,3
1278288,19,14,1994,9,"male",387,290,131,148,146,148,92,0,54
1278293,28,10,1985,4,"male",999,83,66,0,0,0,0,0,0
1278304,26,15,1987,1,"male",193,437,346,2547,666,2547,573,0,93
1278360,68,9,1945,9,"male",1858,472,196,116,18,0,6,116,12
1278361,25,27,1988,5,"female",840,172,90,103,224,103,177,0,47
1278367,25,10,1988,10,"male",358,27,12,2,0,2,0,0,0
1278377,19,19,1994,3,"male",329,85,78,1,0,0,0,1,0
1278413,25,1,1988,2,"male",211,71,36,1,0,1,0,0,0
1278436,23,3,1990,3,"male",27,17,17,1,1,1,1,0,0
1278444,17,16,1996,6,"female",578,409,194,0,4,0,3,0,1
1278447,19,20,1994,8,"male",408,287,126,1,0,1,0,0,0
1278460,21,2,1992,12,"female",1091,15,8,76,25,19,4,57,21
1278466,16,25,1997,5,"male",150,395,330,0,29,0,25,0,4
1278474,55,1,1958,12,"female",186,71,51,12,9,0,3,12,6
1278477,29,25,1984,9,"female",686,197,142,1029,827,805,538,224,289
1278490,24,11,1989,3,"male",1639,342,154,93,136,74,87,19,49
1278494,17,27,1996,11,"female",224,512,304,126,156,26,66,100,90
1278501,78,6,1935,7,NA,2321,30,19,0,0,0,0,0,0
1278505,20,18,1993,10,"female",474,517,382,397,515,154,115,243,400
1278534,19,2,1994,12,"female",7,6,6,0,0,0,0,0,0
1278535,53,6,1960,12,"female",1063,294,262,216,54,70,11,146,43
1278576,16,14,1997,2,"male",366,377,342,0,0,0,0,0,0
1278580,46,14,1967,10,"male",406,21,12,36,3,36,0,0,3
1278624,104,29,1909,6,"male",1565,164,71,1,1,1,1,0,0
1278636,33,19,1980,9,"male",181,17,11,10,11,10,11,0,0
1278643,19,20,1994,1,"male",209,347,209,10,15,10,10,0,5
1278717,29,6,1984,11,"male",121,137,80,2,36,0,7,2,29
1278733,100,3,1913,5,"male",1243,553,298,615,446,615,386,0,60
1278734,25,1,1988,1,"female",278,25,21,0,0,0,0,0,0
1278749,32,30,1981,6,"male",492,78,10,0,0,0,0,0,0
1278756,15,3,1998,4,"male",266,342,244,23,2,1,0,22,2
1278780,26,4,1987,5,"male",21,2,2,0,0,0,0,0,0
1278789,15,7,1998,10,"female",617,244,178,57,4,57,3,0,1
1278790,108,23,1905,9,"female",179,8,7,0,1,0,0,0,1
1278792,46,4,1967,5,"male",610,57,22,34,37,33,26,1,11
1278795,17,6,1996,9,"male",388,123,106,12,0,0,0,12,0
1278811,64,24,1949,2,"female",283,92,51,5,0,5,0,0,0
1278856,16,30,1997,11,"male",338,34,24,1,0,1,0,0,0
1278899,16,4,1997,4,"male",247,314,238,5,0,5,0,0,0
1278908,25,3,1988,5,"male",58,0,0,0,0,0,0,0,0
1278911,89,7,1924,8,"male",876,68,48,32,10,3,3,29,7
1278982,62,15,1951,3,"female",1770,111,49,116,212,109,180,7,32
1279002,75,7,1938,9,"male",452,31,30,4,6,3,2,1,4
1279005,56,28,1957,11,"male",223,6,5,1,1,1,1,0,0
1279014,57,23,1956,6,"male",261,165,6,0,1,0,0,0,1
1279058,20,10,1993,11,"female",791,241,162,1,2,1,2,0,0
1279066,19,5,1994,10,"female",230,77,46,769,1151,732,441,37,710
1279151,72,2,1941,9,"female",1440,63,19,3,0,3,0,0,0
1279152,55,8,1958,11,"female",422,217,184,1268,468,0,181,1268,287
1279161,24,17,1989,5,"female",380,112,85,90,43,87,16,3,27
1279162,15,30,1998,7,"female",326,546,365,874,1461,874,1319,0,142
1279172,45,11,1968,1,"male",1107,64,9,1,6,1,4,0,2
1279211,45,4,1968,4,"male",902,182,66,228,261,228,209,0,52
1279233,21,1,1992,1,"male",65,14,6,0,0,0,0,0,0
1279249,21,7,1992,1,"male",359,210,79,23,2,7,0,16,2
1279284,29,29,1984,2,"female",383,23,12,1,0,1,0,0,0
1279295,83,28,1930,11,"female",655,33,11,32,23,32,22,0,1
1279346,29,19,1984,12,"male",536,137,105,8,53,1,20,7,33
1279348,26,1,1987,11,"male",606,202,170,0,37,0,23,0,14
1279381,32,31,1981,10,"male",144,8,5,3,1,3,1,0,0
1279386,23,1,1990,1,"female",248,65,39,1,2,0,1,1,1
1279393,16,3,1997,8,"male",112,248,224,110,17,102,11,8,6
1279423,24,19,1989,11,"male",175,265,235,9,5,9,4,0,1
1279439,18,29,1995,4,"female",127,434,316,167,238,150,170,17,68
1279446,93,6,1920,8,"female",2226,328,97,613,233,54,93,559,140
1279458,22,25,1991,2,"female",372,230,98,6,57,6,33,0,24
1279471,32,10,1981,6,"male",26,34,32,214,204,214,204,0,0
1279485,62,21,1951,4,"female",1190,81,28,610,118,144,80,466,38
1279491,100,7,1913,3,"female",1613,42,19,55,133,48,44,7,89
1279560,40,9,1973,3,"male",317,41,24,32,103,32,47,0,56
1279587,19,27,1994,7,"female",232,310,89,459,238,243,173,216,65
1279588,52,23,1961,6,"male",724,24,21,3,1,0,1,3,0
1279626,18,21,1995,8,"female",185,180,162,667,290,653,216,14,74
1279631,50,27,1963,6,"male",118,9,8,0,0,0,0,0,0
1279654,27,30,1986,3,"male",419,34,7,2,0,2,0,0,0
1279679,22,16,1991,4,"male",386,98,67,1,1,1,1,0,0
1279706,26,9,1987,5,"male",317,1,1,1,0,1,0,0,0
1279723,25,8,1988,8,"male",413,80,76,12,1,12,1,0,0
1279749,66,17,1947,8,"female",552,83,62,1995,222,1868,113,127,109
1279776,36,19,1977,12,"female",402,8,5,157,16,0,0,157,16
1279777,19,11,1994,8,"male",71,7,6,0,0,0,0,0,0
1279780,26,9,1987,1,"male",344,15,3,0,0,0,0,0,0
1279783,21,13,1992,4,"male",408,12,10,0,0,0,0,0,0
1279791,22,5,1991,5,"male",349,136,100,21,32,21,19,0,13
1279826,23,25,1990,11,"male",304,13,5,0,1,0,0,0,1
1279838,16,10,1997,6,"female",96,372,176,2370,3523,18,792,2352,2731
1279843,29,3,1984,10,"female",548,23,19,2,1,2,1,0,0
1279856,49,22,1964,10,"female",535,90,53,54,59,0,23,54,36
1279858,56,4,1957,10,"male",237,33,29,0,0,0,0,0,0
1279868,19,14,1994,1,"male",677,219,145,80,68,80,64,0,4
1279883,68,1,1945,7,"male",1839,67,30,48,14,11,9,37,5
1279884,32,5,1981,7,"male",152,58,44,23,7,23,6,0,1
1279904,25,14,1988,12,"male",216,43,28,2,14,2,13,0,1
1279939,56,11,1957,9,"female",1189,985,404,220,367,220,266,0,101
1279941,29,10,1984,10,"female",1238,515,236,612,443,612,351,0,92
1279955,22,30,1991,1,"female",195,251,115,42,27,3,5,39,22
1279977,60,17,1953,1,"female",962,62,26,573,107,1,48,572,59
1279997,42,22,1971,4,"male",527,47,8,0,0,0,0,0,0
1280015,28,22,1985,8,"male",569,53,33,1,0,1,0,0,0
1280016,24,8,1989,12,"male",560,79,58,5,23,5,15,0,8
1280036,108,30,1905,8,"male",1635,206,57,57,16,33,11,24,5
1280073,96,28,1917,1,"female",1838,820,397,843,1005,245,322,598,683
1280097,15,13,1998,1,"male",295,7,7,0,0,0,0,0,0
1280129,27,13,1986,3,"male",381,610,380,190,103,75,44,115,59
1280149,18,23,1995,5,"male",184,144,116,0,5,0,5,0,0
1280163,29,16,1984,1,"male",283,28,21,0,1,0,0,0,1
1280176,18,3,1995,1,"male",31,49,47,11,20,11,2,0,18
1280181,29,16,1984,10,"male",589,218,122,10,19,10,16,0,3
1280184,22,30,1991,11,"male",142,124,112,37,20,37,20,0,0
1280195,21,10,1992,10,"male",139,10,2,0,0,0,0,0,0
1280209,36,29,1977,10,"male",534,27,25,0,0,0,0,0,0
1280215,108,25,1905,8,"male",1368,236,66,1582,72,1524,25,58,47
1280222,25,19,1988,7,"male",373,184,117,311,11,311,10,0,1
1280238,38,1,1975,9,"male",148,3,1,3,0,2,0,1,0
1280252,31,2,1982,4,"female",82,14,12,0,0,0,0,0,0
1280308,20,26,1993,3,"female",300,150,20,3,16,3,12,0,4
1280348,18,27,1995,1,"female",267,322,221,10,17,10,17,0,0
1280386,16,10,1997,6,"female",687,1402,660,21,39,19,31,2,8
1280394,59,25,1954,7,"female",1708,13,7,105,11,105,10,0,1
1280401,24,13,1989,4,"male",183,32,22,5,22,5,19,0,3
1280467,23,15,1990,6,"male",474,134,107,29,1,29,1,0,0
1280478,74,24,1939,9,"male",729,45,33,10,0,0,0,10,0
1280485,16,30,1997,11,"female",68,68,63,6,0,6,0,0,0
1280505,29,7,1984,5,"female",223,3,3,0,0,0,0,0,0
1280536,15,14,1998,5,"female",433,234,177,58,76,58,68,0,8
1280539,68,15,1945,6,"male",81,8,5,1,0,0,0,1,0
1280567,42,21,1971,2,"male",439,10,7,0,0,0,0,0,0
1280588,52,29,1961,4,"male",854,107,21,1,11,0,5,1,6
1280593,108,20,1905,9,"male",1669,614,260,5,0,0,0,5,0
1280604,28,17,1985,2,"male",261,45,33,12,2,11,1,1,1
1280620,89,4,1924,3,"female",684,112,87,28,5,0,0,28,5
1280628,15,8,1998,6,"male",486,75,59,0,0,0,0,0,0
1280634,60,25,1953,10,"female",578,702,441,298,242,155,145,143,97
1280651,18,29,1995,11,"female",348,32,21,2,5,2,2,0,3
1280662,40,2,1973,12,"male",759,53,23,6,39,6,28,0,11
1280663,21,7,1992,4,"female",2314,3135,1441,1725,2441,1563,1193,162,1248
1280687,24,17,1989,8,"male",711,424,236,268,91,248,51,20,40
1280711,14,1,1999,1,"male",329,181,137,379,136,2,47,377,89
1280717,33,22,1980,12,"male",232,90,83,21,0,6,0,15,0
1280721,23,13,1990,10,"female",509,70,18,5,24,5,20,0,4
1280757,55,15,1958,8,"female",1592,198,53,343,1030,343,581,0,449
1280773,18,18,1995,5,"female",510,273,141,35,17,35,17,0,0
1280811,13,23,2000,2,"male",254,115,97,1,0,1,0,0,0
1280840,27,11,1986,11,"male",384,43,38,0,0,0,0,0,0
1280865,22,4,1991,4,"male",532,162,125,1,2,1,1,0,1
1280883,33,4,1980,11,"male",225,66,56,1,26,1,16,0,10
1280902,22,10,1991,10,"male",568,101,56,0,0,0,0,0,0
1280904,93,12,1920,4,"male",16,41,40,1,1,1,1,0,0
1280913,20,16,1993,8,"female",51,144,127,4,6,4,6,0,0
1280916,17,23,1996,3,"male",214,2,1,0,0,0,0,0,0
1280984,17,19,1996,6,"female",149,292,168,269,345,228,169,41,176
1280992,39,12,1974,11,"male",196,89,76,23,50,23,36,0,14
1281003,54,17,1959,8,"male",132,86,78,0,0,0,0,0,0
1281048,18,3,1995,8,"female",131,72,41,81,174,80,51,1,123
1281068,33,11,1980,3,"female",298,42,14,89,94,89,56,0,38
1281087,14,22,1999,7,"male",373,82,32,14,0,2,0,12,0
1281096,16,31,1997,5,"male",283,565,336,0,33,0,24,0,9
1281099,55,9,1958,11,"female",868,180,59,107,175,103,77,4,98
1281102,19,3,1994,5,"male",639,71,59,1,1,1,1,0,0
1281105,68,11,1945,12,"male",1292,37,15,5,1,0,1,5,0
1281166,54,28,1959,11,"female",306,27,24,1,2,1,1,0,1
1281183,113,14,1900,4,"female",1541,32,20,29,7,1,3,28,4
1281184,19,25,1994,8,"female",39,9,7,4,10,4,10,0,0
1281190,27,21,1986,6,"female",304,401,274,588,1810,260,571,328,1239
1281194,31,2,1982,5,"male",444,16,14,127,18,127,12,0,6
1281202,23,4,1990,9,"male",604,354,307,0,10,0,8,0,2
1281204,16,21,1997,4,"male",136,132,118,11,9,11,9,0,0
1281209,18,11,1995,4,"male",1030,22,13,0,0,0,0,0,0
1281219,36,19,1977,10,"female",282,135,128,298,434,297,362,1,72
1281242,19,19,1994,8,"male",47,101,96,92,40,92,20,0,20
1281266,66,30,1947,7,"male",1753,38,12,29,29,29,29,0,0
1281292,34,1,1979,11,"female",698,165,115,66,203,4,71,62,132
1281331,20,9,1993,11,"male",53,32,18,1,3,1,2,0,1
1281341,19,9,1994,12,"male",223,0,0,0,0,0,0,0,0
1281375,16,10,1997,10,"female",151,2051,941,3631,3750,720,1710,2911,2040
1281395,28,7,1985,4,"male",820,58,48,0,1,0,0,0,1
1281397,29,2,1984,4,"male",215,116,112,16,1,16,1,0,0
1281412,18,22,1995,2,"male",576,916,701,38,14,38,9,0,5
1281421,62,10,1951,6,"male",1834,52,15,0,0,0,0,0,0
1281425,23,16,1990,9,"female",218,280,206,39,11,0,1,39,10
1281484,55,28,1958,3,"female",874,34,28,9,14,0,10,9,4
1281492,16,7,1997,6,"male",297,290,93,2,1,0,0,2,1
1281507,55,20,1958,4,"female",1278,114,83,0,1,0,1,0,0
1281512,38,5,1975,9,"male",747,177,120,0,0,0,0,0,0
1281522,32,22,1981,5,"male",928,163,59,62,9,62,7,0,2
1281539,42,6,1971,2,"male",1633,43,23,5,20,5,18,0,2
1281574,72,23,1941,7,"female",708,80,45,163,36,163,24,0,12
1281596,62,17,1951,8,"male",1557,14,5,0,2,0,2,0,0
1281598,20,16,1993,3,"male",479,304,161,0,2,0,1,0,1
1281615,29,12,1984,12,"male",28,12,6,3,1,3,1,0,0
1281618,21,14,1992,9,"male",742,152,114,0,0,0,0,0,0
1281620,63,23,1950,6,"male",252,42,35,260,859,260,371,0,488
1281630,37,17,1976,6,"male",1128,82,38,3,37,0,26,3,11
1281637,29,6,1984,1,"male",174,100,43,47,7,47,7,0,0
1281647,24,22,1989,9,"female",450,97,63,17,5,7,3,10,2
1281667,24,19,1989,7,"male",280,288,260,57,122,45,49,12,73
1281679,53,2,1960,5,"male",255,30,13,18,7,12,6,6,1
1281700,49,19,1964,4,"female",1894,1076,750,1224,1334,1033,570,191,764
1281706,15,25,1998,1,"female",594,428,200,103,116,103,96,0,20
1281713,30,18,1983,4,"female",261,109,33,164,239,147,163,17,76
1281715,43,7,1970,1,"female",77,39,28,15,26,15,20,0,6
1281733,29,14,1984,8,"male",126,23,23,8,1,5,1,3,0
1281745,82,10,1931,1,"female",1200,23,12,1,12,0,5,1,7
1281752,35,23,1978,8,"female",184,20,15,73,16,72,14,1,2
1281759,29,18,1984,11,"female",602,8,7,15,0,0,0,15,0
1281795,62,15,1951,1,"male",281,35,14,0,3,0,1,0,2
1281825,25,11,1988,9,"female",240,270,94,282,417,281,325,1,92
1281828,29,11,1984,6,"male",163,2,0,184,91,0,14,184,77
1281829,25,15,1988,11,"female",1331,8,2,2,0,0,0,2,0
1281860,37,5,1976,12,"male",127,219,180,17,19,17,17,0,2
1281865,21,3,1992,7,"male",202,97,64,34,98,34,75,0,23
1281886,60,14,1953,2,NA,1491,84,55,232,21,151,14,81,7
1281897,19,3,1994,4,"male",414,531,464,158,80,122,37,36,43
1281918,68,24,1945,6,"male",682,220,152,0,0,0,0,0,0
1281919,18,5,1995,8,"female",287,303,167,1263,1206,535,454,728,752
1281966,14,24,1999,2,"female",404,2451,921,210,891,1,291,209,600
1281985,27,10,1986,12,"male",950,120,85,2,0,2,0,0,0
1281998,28,27,1985,4,"male",504,57,41,6,6,6,6,0,0
1282004,62,20,1951,10,"female",1342,22,4,2,1,2,1,0,0
1282031,19,8,1994,10,"female",387,276,156,77,198,77,147,0,51
1282034,22,30,1991,9,"male",144,243,217,986,554,842,386,144,168
1282048,17,1,1996,11,"male",1221,3563,1023,25,113,5,33,20,80
1282095,16,5,1997,9,"female",630,1243,644,179,483,161,440,18,43
1282107,43,21,1970,12,"male",351,264,184,1471,440,1471,388,0,52
1282129,17,12,1996,7,"female",609,274,120,833,316,832,230,1,86
1282131,35,18,1978,9,"male",438,153,147,129,11,127,8,2,3
1282157,64,22,1949,9,"male",227,8,7,0,0,0,0,0,0
1282207,66,10,1947,4,"female",398,103,62,886,71,886,45,0,26
1282222,50,8,1963,10,"female",150,138,87,2104,360,2104,226,0,134
1282227,16,19,1997,9,"male",881,175,87,2,4,2,3,0,1
1282257,25,16,1988,4,"male",588,387,343,488,134,488,122,0,12
1282293,14,12,1999,9,"female",80,24,15,3,1,3,1,0,0
1282301,47,26,1966,5,"male",94,81,73,1,3,1,1,0,2
1282308,54,26,1959,2,"female",137,24,17,4,1,4,0,0,1
1282333,52,2,1961,1,"female",1153,257,99,589,121,589,56,0,65
1282387,56,24,1957,8,"female",787,73,36,687,996,0,443,687,553
1282389,20,15,1993,9,"male",206,231,138,1,4,1,4,0,0
1282390,30,13,1983,10,"male",261,45,23,41,29,41,23,0,6
1282414,19,5,1994,12,"male",278,13,6,0,2,0,2,0,0
1282426,29,10,1984,5,"male",291,56,35,0,1,0,0,0,1
1282438,26,29,1987,1,"male",265,60,46,0,2,0,2,0,0
1282457,57,5,1956,6,"male",260,204,135,6,13,6,10,0,3
1282469,77,11,1936,6,"female",753,78,47,3,29,0,5,3,24
1282486,65,24,1948,10,"male",57,3,2,22,28,22,19,0,9
1282487,99,9,1914,1,"male",2247,315,205,24,15,3,9,21,6
1282498,57,26,1956,5,"female",1041,31,8,137,41,0,20,137,21
1282502,42,29,1971,7,"female",357,12,6,0,0,0,0,0,0
1282515,21,22,1992,5,"male",429,263,188,20,10,20,10,0,0
1282517,81,7,1932,6,"female",622,68,22,305,61,0,7,305,54
1282526,58,1,1955,3,"female",950,70,23,0,0,0,0,0,0
1282528,40,2,1973,1,"male",334,5,0,0,0,0,0,0,0
1282541,19,1,1994,1,"male",325,1,1,0,0,0,0,0,0
1282563,23,2,1990,4,"male",475,90,66,0,15,0,13,0,2
1282572,23,11,1990,11,"male",115,39,14,4,7,4,6,0,1
1282593,35,29,1978,10,"female",227,116,109,412,364,412,267,0,97
1282595,29,6,1984,2,"male",343,152,71,193,381,193,358,0,23
1282603,16,22,1997,1,"male",331,579,60,27,5,14,2,13,3
1282660,59,22,1954,3,"female",129,96,64,350,480,0,72,350,408
1282704,30,31,1983,12,"male",627,105,74,4,3,4,3,0,0
1282725,40,22,1973,5,"male",475,99,76,0,4,0,3,0,1
1282727,30,11,1983,6,"male",976,129,43,53,37,53,36,0,1
1282728,30,11,1983,6,"male",403,17,2,0,0,0,0,0,0
1282746,23,25,1990,1,"male",59,25,24,0,0,0,0,0,0
1282747,40,13,1973,2,"female",35,10,9,4,2,4,0,0,2
1282755,60,5,1953,6,"female",165,4,1,2,0,0,0,2,0
1282763,25,10,1988,7,"male",183,4,3,0,0,0,0,0,0
1282832,24,11,1989,1,"male",610,70,30,4,10,4,6,0,4
1282840,33,21,1980,8,"male",393,76,53,1,3,1,2,0,1
1282848,46,20,1967,4,"male",717,170,96,1,0,0,0,1,0
1282851,44,8,1969,9,"female",26,37,34,53,1,52,1,1,0
1282856,35,5,1978,1,"female",334,203,57,3210,1325,3210,1166,0,159
1282859,43,29,1970,11,"male",588,38,20,0,0,0,0,0,0
1282861,32,9,1981,9,"male",850,50,25,7,0,7,0,0,0
1282866,61,5,1952,6,"female",1809,39,16,0,0,0,0,0,0
1282871,28,25,1985,1,"male",783,93,27,5,4,0,4,5,0
1282887,25,19,1988,9,"female",17,0,0,0,0,0,0,0,0
1282888,108,1,1905,8,"female",62,84,56,12,26,12,22,0,4
1282918,108,11,1905,2,"male",1601,198,119,14,182,7,178,7,4
1282924,18,13,1995,4,"male",49,76,72,4,0,4,0,0,0
1282949,33,9,1980,8,"male",77,7,5,0,1,0,1,0,0
1282967,70,7,1943,3,"female",442,53,41,134,1,80,0,54,1
1282977,22,8,1991,9,"male",657,131,92,0,34,0,32,0,2
1282985,20,7,1993,9,"male",241,352,318,3,5,3,2,0,3
1282987,25,1,1988,1,"male",40,12,10,6,0,6,0,0,0
1282989,40,19,1973,1,"male",129,6,4,115,8,0,1,115,7
1283008,51,4,1962,12,"female",605,54,6,7,4,1,4,6,0
1283024,19,24,1994,4,"male",464,857,751,37,8,0,3,37,5
1283081,108,3,1905,10,"male",3,59,23,5,5,5,5,0,0
1283099,19,4,1994,6,"male",552,19,17,1,1,1,1,0,0
1283108,45,7,1968,1,"female",917,183,101,7,9,7,5,0,4
1283127,23,27,1990,3,"male",321,19,11,1,13,1,11,0,2
1283141,29,1,1984,7,"male",220,49,28,24,22,24,12,0,10
1283146,33,16,1980,9,"male",122,291,261,21,15,19,10,2,5
1283179,40,2,1973,7,"male",376,30,13,1,7,1,6,0,1
1283204,57,7,1956,9,"female",806,35,14,42,75,42,33,0,42
1283212,19,16,1994,11,"female",553,138,86,6,4,6,2,0,2
1283265,25,19,1988,12,"male",428,19,13,2,2,0,2,2,0
1283271,16,30,1997,9,"male",601,145,118,0,1,0,1,0,0
1283298,20,12,1993,1,"male",3,7,7,2,0,2,0,0,0
1283299,68,21,1945,9,"female",1718,52,18,610,789,535,63,75,726
1283305,20,30,1993,5,"female",133,19,14,20,52,20,30,0,22
1283356,25,16,1988,10,"male",432,161,88,27,13,20,8,7,5
1283359,55,18,1958,11,"male",467,27,15,1,3,1,3,0,0
1283363,23,10,1990,10,"male",131,56,51,0,1,0,1,0,0
1283378,28,30,1985,12,"female",1369,21,4,0,0,0,0,0,0
1283387,28,18,1985,4,"male",794,5,2,0,0,0,0,0,0
1283408,108,6,1905,10,"male",92,50,37,48,20,47,15,1,5
1283418,60,19,1953,12,"female",142,242,142,5,6,5,6,0,0
1283454,94,22,1919,8,"female",758,430,90,10,23,10,21,0,2
1283492,60,16,1953,10,"female",620,38,28,3,4,3,4,0,0
1283504,45,1,1968,8,"male",23,16,13,89,61,6,36,83,25
1283509,58,14,1955,1,"female",1329,80,40,328,152,0,40,328,112
1283597,74,15,1939,9,"female",1687,181,87,0,0,0,0,0,0
1283626,37,5,1976,3,"female",68,29,14,87,72,87,41,0,31
1283632,20,13,1993,1,"female",746,183,104,0,0,0,0,0,0
1283652,20,15,1993,12,"male",800,201,84,43,24,0,8,43,16
1283665,90,26,1923,4,"male",1420,447,187,59,2,0,2,59,0
1283688,102,10,1911,10,"male",1883,260,147,38,20,27,7,11,13
1283694,33,28,1980,1,"female",416,19,8,3,28,0,18,3,10
1283697,24,20,1989,11,"female",575,280,135,2,3,2,3,0,0
1283703,18,14,1995,5,"male",816,512,433,37,109,37,51,0,58
1283711,17,27,1996,12,"female",506,278,203,0,0,0,0,0,0
1283727,57,7,1956,4,"male",314,2,1,1,0,0,0,1,0
1283734,13,9,2000,5,"male",166,14,13,1,0,1,0,0,0
1283744,26,1,1987,1,"male",110,2,1,0,1,0,1,0,0
1283759,23,11,1990,1,"male",1007,36,27,0,1,0,0,0,1
1283763,30,17,1983,7,"male",427,71,39,22,16,22,13,0,3
1283793,28,24,1985,2,"male",4,1,1,1,2,1,2,0,0
1283799,18,17,1995,10,"male",477,14,8,0,0,0,0,0,0
1283801,37,3,1976,9,"female",306,0,0,0,0,0,0,0,0
1283812,53,22,1960,10,"female",254,59,51,42,24,0,11,42,13
1283816,59,16,1954,2,"female",99,32,14,15,4,0,1,15,3
1283845,36,12,1977,1,"male",772,170,91,7,74,7,29,0,45
1283867,37,29,1976,12,"female",1523,191,80,446,218,101,81,345,137
1283878,24,25,1989,11,"female",372,1774,176,44,407,16,332,28,75
1283899,64,31,1949,10,"female",123,9,7,2,1,0,0,2,1
1283917,37,29,1976,10,"male",186,38,19,0,0,0,0,0,0
1283931,30,20,1983,8,"male",555,207,125,22,39,22,38,0,1
1283942,54,28,1959,7,"female",908,176,71,1088,678,777,433,311,245
1283945,21,26,1992,2,"male",532,277,222,28,106,28,53,0,53
1283985,36,17,1977,6,"male",676,5,0,0,0,0,0,0,0
1284025,25,15,1988,4,"male",183,216,153,273,291,273,223,0,68
1284048,25,22,1988,6,"female",582,22,3,3,0,3,0,0,0
1284059,22,25,1991,2,"male",446,97,78,1827,162,0,31,1827,131
1284087,15,1,1998,6,"male",561,16,11,0,11,0,2,0,9
1284091,33,1,1980,1,"male",271,32,18,3,30,3,20,0,10
1284102,41,14,1972,3,"male",412,1936,1488,6,0,6,0,0,0
1284135,33,7,1980,8,"male",661,63,41,3,3,0,1,3,2
1284175,18,24,1995,11,"male",467,421,364,220,67,149,40,71,27
1284225,14,29,1999,6,"male",188,199,169,0,0,0,0,0,0
1284236,108,29,1905,7,"female",1694,230,121,77,34,77,30,0,4
1284247,24,1,1989,1,"male",277,47,34,18,5,18,5,0,0
1284306,18,11,1995,7,"male",720,418,310,0,0,0,0,0,0
1284317,42,15,1971,4,"female",44,19,11,35,9,35,7,0,2
1284321,27,31,1986,8,"male",243,146,67,2,3,2,3,0,0
1284396,20,8,1993,1,"male",468,271,133,72,83,27,50,45,33
1284401,19,25,1994,3,"female",340,54,30,31,15,31,1,0,14
1284405,31,5,1982,4,"male",173,84,55,5,19,5,13,0,6
1284423,26,28,1987,12,"male",534,346,288,35,51,35,20,0,31
1284430,38,9,1975,1,"male",692,20,10,0,0,0,0,0,0
1284433,24,19,1989,7,"female",211,62,50,10,4,10,3,0,1
1284484,25,8,1988,1,"female",742,292,165,60,94,60,36,0,58
1284508,16,15,1997,2,"female",520,425,196,585,172,355,148,230,24
1284510,35,22,1978,10,"male",400,42,37,1,1,1,1,0,0
1284526,21,7,1992,2,"male",259,224,158,8,3,0,0,8,3
1284536,51,31,1962,8,"female",186,13,9,5,1,4,1,1,0
1284546,93,14,1920,4,"female",218,368,100,1,0,1,0,0,0
1284551,28,13,1985,11,"male",238,14,7,2,1,2,1,0,0
1284557,20,19,1993,7,"male",335,132,59,0,0,0,0,0,0
1284567,31,7,1982,8,"male",168,48,19,0,12,0,6,0,6
1284583,21,7,1992,9,"female",829,188,95,1,0,1,0,0,0
1284595,22,26,1991,9,"male",168,61,48,0,0,0,0,0,0
1284597,18,7,1995,7,"male",331,475,406,37,17,37,11,0,6
1284601,17,22,1996,5,"male",155,52,45,0,5,0,3,0,2
1284640,31,9,1982,11,"male",303,82,50,1,0,1,0,0,0
1284652,22,12,1991,12,"male",709,573,490,2197,2057,2197,1981,0,76
1284653,18,23,1995,5,"male",58,46,42,2,2,2,1,0,1
1284674,15,24,1998,9,"male",89,60,47,49,36,49,33,0,3
1284676,53,20,1960,3,"male",1193,403,149,383,310,82,241,301,69
1284687,15,2,1998,2,"female",47,150,139,51,90,51,47,0,43
1284700,25,5,1988,8,"female",104,1,1,0,0,0,0,0,0
1284719,25,10,1988,8,"male",51,52,41,3,10,3,0,0,10
1284724,34,23,1979,6,"male",331,19,16,0,6,0,4,0,2
1284731,23,25,1990,10,"male",542,461,229,76,78,76,67,0,11
1284746,112,1,1901,1,"male",1165,4310,543,664,227,0,52,664,175
1284761,30,15,1983,2,"female",605,141,56,227,1299,216,1100,11,199
1284771,16,9,1997,1,"female",382,124,62,15,4,13,4,2,0
1284772,15,8,1998,1,"male",502,49,38,1,4,0,2,1,2
1284787,41,10,1972,1,"male",368,159,128,7,0,7,0,0,0
1284790,23,2,1990,10,"male",622,531,345,1,44,1,32,0,12
1284815,53,18,1960,3,"male",38,76,69,63,81,63,46,0,35
1284824,15,2,1998,6,"female",556,1179,1001,1760,1215,962,429,798,786
1284837,18,6,1995,6,"male",14,0,0,0,0,0,0,0,0
1284843,61,18,1952,8,"female",2028,141,68,3,1,3,0,0,1
1284852,68,21,1945,1,"female",1881,102,59,46,22,39,7,7,15
1284867,65,24,1948,6,"male",586,49,44,1,1,1,1,0,0
1284874,21,1,1992,3,"female",150,246,63,369,217,369,176,0,41
1284878,19,16,1994,3,"female",1124,481,250,1889,1287,1842,549,47,738
1284911,71,18,1942,4,"female",1502,71,54,9,4,8,4,1,0
1284956,57,24,1956,12,"female",313,83,41,41,6,0,1,41,5
1284983,64,17,1949,12,"male",1,12,11,0,0,0,0,0,0
1284990,17,2,1996,4,"male",305,417,155,35,146,35,109,0,37
1284996,25,1,1988,1,"male",45,0,0,0,0,0,0,0,0
1285013,20,9,1993,7,"male",245,153,111,0,0,0,0,0,0
1285020,16,17,1997,4,"male",183,123,55,1,2,1,2,0,0
1285044,46,10,1967,4,"male",390,30,8,0,0,0,0,0,0
1285052,32,30,1981,9,"female",499,74,16,62,98,62,82,0,16
1285065,23,27,1990,10,"female",585,224,118,137,185,113,142,24,43
1285082,26,25,1987,10,"female",16,85,84,33,31,33,23,0,8
1285083,29,10,1984,2,"male",56,30,22,2,2,2,2,0,0
1285084,30,20,1983,11,"female",95,8,2,6,17,6,4,0,13
1285106,47,6,1966,5,"male",283,10,8,0,0,0,0,0,0
1285114,28,30,1985,12,"female",247,87,52,20,136,20,125,0,11
1285140,37,1,1976,5,"female",229,15,12,5,13,0,0,5,13
1285151,24,22,1989,10,"female",256,468,352,1046,330,1044,217,2,113
1285158,29,11,1984,10,"female",65,24,7,13,24,13,19,0,5
1285162,71,15,1942,2,"female",254,14,12,1,1,0,1,1,0
1285174,52,7,1961,5,"male",226,40,35,32,27,32,18,0,9
1285180,73,10,1940,2,"male",1591,80,52,61,149,61,83,0,66
1285206,47,1,1966,1,"male",152,103,79,41,52,41,44,0,8
1285209,22,1,1991,1,"male",93,3,1,0,0,0,0,0,0
1285211,40,30,1973,9,"female",466,21,13,11,13,2,9,9,4
1285219,44,18,1969,12,"male",429,35,19,0,1,0,0,0,1
1285224,31,21,1982,11,"male",624,93,39,17,14,17,5,0,9
1285235,33,25,1980,10,"female",254,10,2,44,2,44,2,0,0
1285249,50,2,1963,8,"male",91,2,0,0,0,0,0,0,0
1285260,30,13,1983,1,"male",199,7,0,0,3,0,3,0,0
1285286,25,23,1988,12,"male",168,149,131,49,729,49,674,0,55
1285299,32,10,1981,8,"female",489,191,84,1,4,0,0,1,4
1285334,22,29,1991,9,"male",407,313,278,42,27,42,16,0,11
1285348,64,20,1949,5,"female",208,5,2,0,0,0,0,0,0
1285353,24,26,1989,7,"female",1031,91,62,131,139,21,32,110,107
1285367,31,7,1982,2,"male",1067,0,0,0,0,0,0,0,0
1285530,36,3,1977,5,"female",376,122,101,28,142,0,53,28,89
1285538,20,18,1993,9,"male",220,8,4,1,0,1,0,0,0
1285540,40,5,1973,10,"female",432,20,16,101,15,99,11,2,4
1285563,33,7,1980,12,"female",133,177,135,319,191,318,89,1,102
1285576,14,14,1999,1,"female",522,187,103,1806,158,1806,116,0,42
1285600,22,27,1991,9,"female",374,207,65,98,87,98,72,0,15
1285614,18,2,1995,2,"male",192,101,82,116,21,116,21,0,0
1285616,26,20,1987,11,"female",591,67,56,34,57,33,40,1,17
1285643,45,21,1968,4,"female",77,85,33,54,155,54,72,0,83
1285645,18,24,1995,2,"female",733,101,68,87,63,87,48,0,15
1285650,50,5,1963,12,"female",1468,95,53,885,269,724,211,161,58
1285674,16,21,1997,8,"female",388,129,64,35,16,34,8,1,8
1285681,19,11,1994,8,"male",692,277,166,4,2,4,2,0,0
1285683,31,2,1982,3,"female",458,114,77,112,469,112,456,0,13
1285708,46,1,1967,1,"male",478,15,15,1,2,0,1,1,1
1285714,53,17,1960,5,"female",404,39,38,1424,145,1424,68,0,77
1285773,103,11,1910,2,"female",1305,230,98,4,81,4,76,0,5
1285799,47,30,1966,7,"male",563,15,13,14,2,14,1,0,1
1285804,65,20,1948,2,"female",1256,67,37,0,1,0,0,0,1
1285815,22,19,1991,11,"female",261,665,297,1423,1794,453,747,970,1047
1285820,51,17,1962,4,"male",766,196,167,77,120,77,55,0,65
1285829,49,20,1964,9,"male",527,25,11,83,4,83,3,0,1
1285834,71,15,1942,9,"female",964,13,9,679,13,0,8,679,5
1285836,18,24,1995,2,"female",106,363,129,33,67,6,18,27,49
1285865,108,5,1905,5,"male",297,270,171,8,3,8,3,0,0
1285873,17,20,1996,1,"female",289,3,2,1,0,0,0,1,0
1285885,28,23,1985,12,"male",532,109,48,28,7,15,6,13,1
1285921,68,22,1945,9,"female",591,694,471,1128,705,1128,558,0,147
1285938,30,12,1983,2,"male",213,70,31,203,47,203,33,0,14
1285950,22,17,1991,11,"male",647,52,36,111,20,111,17,0,3
1285953,38,13,1975,2,"male",249,24,15,0,0,0,0,0,0
1285962,26,5,1987,6,"female",440,32,15,0,0,0,0,0,0
1285964,44,25,1969,8,"male",646,22,11,1,1,1,1,0,0
1285965,19,16,1994,2,"male",93,60,49,129,141,0,0,129,141
1285969,15,1,1998,7,"female",518,161,105,71,41,52,33,19,8
1285972,15,6,1998,12,"male",356,715,656,10,1,10,1,0,0
1285981,27,27,1986,4,"male",1580,62,39,2,1,2,1,0,0
1286019,33,20,1980,2,"male",807,170,86,0,0,0,0,0,0
1286033,43,14,1970,1,"female",78,43,31,50,10,50,7,0,3
1286067,16,3,1997,3,"male",268,12,11,0,0,0,0,0,0
1286082,17,7,1996,10,"male",231,334,207,376,445,355,291,21,154
1286085,40,28,1973,2,"male",118,65,51,0,1,0,1,0,0
1286096,28,5,1985,8,"male",287,78,76,52,8,52,8,0,0
1286100,22,15,1991,6,"female",51,71,49,46,18,32,4,14,14
1286116,30,26,1983,4,"male",624,16,9,8,2,7,1,1,1
1286117,27,20,1986,9,"female",517,35,33,155,27,0,4,155,23
1286123,21,4,1992,7,"male",463,67,49,4,26,4,12,0,14
1286157,26,7,1987,8,"male",418,58,23,0,0,0,0,0,0
1286158,21,6,1992,2,"female",498,175,135,7,34,7,22,0,12
1286162,71,6,1942,3,"male",390,19,9,0,0,0,0,0,0
1286179,23,6,1990,7,"male",437,0,0,0,0,0,0,0,0
1286218,22,29,1991,4,"male",477,88,65,0,0,0,0,0,0
1286222,36,24,1977,9,"female",416,78,61,11,17,8,7,3,10
1286226,79,12,1934,1,"female",1279,19,10,0,0,0,0,0,0
1286228,46,16,1967,7,"male",947,62,22,31,1,31,1,0,0
1286230,66,14,1947,11,"male",395,7,5,19,0,0,0,19,0
1286232,21,28,1992,4,"female",185,56,26,3,5,3,5,0,0
1286236,48,9,1965,10,"male",504,203,149,215,17,215,13,0,4
1286260,24,4,1989,12,"male",799,174,163,26,26,4,15,22,11
1286262,19,18,1994,8,"male",492,300,163,4,6,0,0,4,6
1286271,27,4,1986,1,"male",670,335,244,13,12,13,12,0,0
1286294,48,6,1965,10,"male",1494,82,18,38,39,38,34,0,5
1286303,68,5,1945,8,"male",705,28,27,0,0,0,0,0,0
1286310,20,3,1993,6,"female",505,196,151,23,45,4,34,19,11
1286319,20,27,1993,9,"male",400,258,199,1261,606,579,180,682,426
1286334,21,6,1992,1,"female",187,217,135,149,148,149,47,0,101
1286343,82,31,1931,5,"female",244,64,41,19,8,19,6,0,2
1286377,103,31,1910,12,"male",1142,391,303,1,6,1,6,0,0
1286394,17,12,1996,3,"male",124,159,119,170,376,170,280,0,96
1286426,34,23,1979,12,"male",585,8,6,1,6,0,0,1,6
1286431,108,24,1905,5,"female",1423,370,107,1,4,0,2,1,2
1286435,35,10,1978,1,"female",429,2,1,0,0,0,0,0,0
1286457,13,24,2000,4,"female",185,294,228,3,87,3,56,0,31
1286466,99,13,1914,5,"female",1238,3216,705,99,19,99,4,0,15
1286487,37,25,1976,11,"female",352,71,21,121,49,121,25,0,24
1286532,69,10,1944,10,"female",226,3,3,2,1,0,0,2,1
1286568,48,13,1965,6,"female",732,200,104,25,39,24,10,1,29
1286594,15,20,1998,10,"male",337,45,26,127,34,127,26,0,8
1286620,17,4,1996,2,"male",121,18,11,0,0,0,0,0,0
1286630,64,25,1949,7,"male",304,64,31,0,0,0,0,0,0
1286656,21,3,1992,4,"male",1000,507,119,78,32,28,19,50,13
1286657,61,15,1952,9,"female",1706,403,203,15,6,15,1,0,5
1286712,39,3,1974,10,"male",103,2,2,0,1,0,0,0,1
1286741,107,26,1906,2,"female",63,475,411,45,78,0,11,45,67
1286742,18,15,1995,7,"male",278,5,2,0,0,0,0,0,0
1286760,46,9,1967,4,"male",200,36,18,0,0,0,0,0,0
1286783,20,5,1993,10,"female",494,238,180,212,41,196,39,16,2
1286799,20,13,1993,11,"male",855,934,845,10,28,8,26,2,2
1286805,18,18,1995,1,"male",905,622,347,13,3,13,3,0,0
1286812,16,8,1997,3,"male",446,286,115,30,0,30,0,0,0
1286814,42,24,1971,9,"female",424,84,48,58,223,58,198,0,25
1286857,63,13,1950,2,"female",393,56,32,168,31,0,5,168,26
1286897,55,7,1958,4,"male",798,843,728,786,251,513,133,273,118
1286920,20,2,1993,9,"female",49,36,21,132,158,132,111,0,47
1286923,24,27,1989,9,"male",626,247,215,2,1,2,1,0,0
1286943,25,5,1988,10,"male",184,27,22,1,3,1,2,0,1
1286970,25,20,1988,10,"female",269,49,39,29,19,29,11,0,8
1286976,27,30,1986,7,"female",552,186,97,316,404,205,369,111,35
1286996,50,5,1963,2,"male",295,53,8,11,5,7,2,4,3
1286997,64,26,1949,7,"female",602,54,33,18,67,0,38,18,29
1286999,25,10,1988,10,"male",614,218,118,2,0,2,0,0,0
1287002,25,1,1988,1,"male",28,19,15,30,6,30,3,0,3
1287027,20,14,1993,6,"male",42,435,400,52,30,52,23,0,7
1287032,24,26,1989,10,"female",334,89,52,159,126,159,104,0,22
1287066,56,26,1957,1,"female",215,47,39,1,21,0,2,1,19
1287067,29,26,1984,4,"male",200,47,35,0,1,0,0,0,1
1287073,53,15,1960,4,"female",1583,490,327,452,278,0,22,452,256
1287109,19,25,1994,5,"male",464,1152,965,0,0,0,0,0,0
1287111,17,25,1996,7,"female",155,116,76,3,62,1,26,2,36
1287116,19,23,1994,6,"male",372,19,19,0,0,0,0,0,0
1287118,36,29,1977,7,"female",16,18,10,21,6,6,4,15,2
1287180,48,24,1965,7,"female",606,8,7,20,16,15,13,5,3
1287195,44,26,1969,3,"male",304,133,102,451,187,321,108,130,79
1287198,31,18,1982,4,"male",183,67,62,5,20,2,2,3,18
1287199,108,1,1905,1,"male",928,349,232,197,29,115,3,82,26
1287221,56,24,1957,11,"male",86,54,35,7920,648,1456,144,6464,504
1287224,64,15,1949,5,"male",239,43,40,7,44,7,26,0,18
1287250,53,10,1960,6,"male",1428,393,132,78,37,78,17,0,20
1287260,15,15,1998,12,"male",226,131,79,20,12,20,11,0,1
1287273,29,8,1984,9,"male",235,62,48,4,1,4,1,0,0
1287278,108,4,1905,2,"male",1377,1341,714,1194,1405,1177,1042,17,363
1287331,52,5,1961,2,"female",237,153,130,9,29,0,2,9,27
1287346,44,3,1969,11,"male",73,28,10,34,18,0,9,34,9
1287359,44,21,1969,10,"male",724,1,1,5,0,5,0,0,0
1287395,25,21,1988,2,"male",732,271,162,3,37,0,14,3,23
1287400,14,16,1999,1,"male",262,232,67,0,0,0,0,0,0
1287410,16,2,1997,10,"female",264,312,185,494,403,294,109,200,294
1287419,43,10,1970,7,"male",349,64,44,26,10,22,5,4,5
1287440,56,27,1957,6,"male",663,259,154,78,66,15,32,63,34
1287447,26,28,1987,5,"male",448,14,10,4,9,4,4,0,5
1287460,19,31,1994,12,"male",385,135,89,16,0,16,0,0,0
1287472,32,6,1981,9,"male",539,116,69,359,243,359,187,0,56
1287501,16,12,1997,11,"male",306,36,30,63,0,0,0,63,0
1287535,43,6,1970,6,"male",616,94,79,229,15,0,11,229,4
1287555,91,20,1922,3,"female",204,206,172,213,7,213,4,0,3
1287561,18,28,1995,2,"male",469,253,90,0,0,0,0,0,0
1287594,19,24,1994,4,"female",86,322,72,13,13,13,10,0,3
1287625,28,12,1985,12,"male",766,134,97,272,111,272,108,0,3
1287634,39,28,1974,10,"female",545,71,16,33,18,23,15,10,3
1287682,68,18,1945,10,"male",591,33,23,0,0,0,0,0,0
1287687,50,5,1963,3,"male",455,41,26,15,0,0,0,15,0
1287689,25,9,1988,9,"female",53,39,37,2,6,2,6,0,0
1287695,36,12,1977,12,"female",1242,694,276,497,584,413,239,84,345
1287755,63,4,1950,12,"female",1301,4,0,2,5,1,0,1,5
1287781,31,16,1982,9,"male",353,443,398,12,1,12,1,0,0
1287784,20,10,1993,5,"female",387,153,111,98,55,57,21,41,34
1287794,26,10,1987,2,"female",374,242,62,22,17,12,9,10,8
1287823,54,31,1959,10,"female",984,7,4,1,7,0,4,1,3
1287842,33,1,1980,1,"female",378,19,10,6,21,1,10,5,11
1287846,40,1,1973,9,"male",458,4,0,0,0,0,0,0,0
1287876,16,11,1997,1,"female",213,46,20,7,13,7,13,0,0
1287897,18,12,1995,11,"male",233,71,48,1,0,1,0,0,0
1287930,45,8,1968,9,"female",350,19,12,0,1,0,1,0,0
1287953,19,17,1994,10,"male",193,297,254,73,25,48,7,25,18
1287982,108,26,1905,8,"male",1039,76,58,11,0,0,0,11,0
1287988,103,20,1910,1,"male",1170,7,7,34,5,11,4,23,1
1287998,68,13,1945,4,"male",885,1588,880,1743,566,1743,527,0,39
1288003,60,19,1953,4,"male",1652,142,70,53,109,50,55,3,54
1288024,60,19,1953,8,"female",404,144,42,863,590,0,228,863,362
1288032,16,20,1997,10,"female",98,304,146,0,0,0,0,0,0
1288062,16,23,1997,9,"female",402,99,18,4,14,4,9,0,5
1288063,18,4,1995,3,"male",140,2,2,0,0,0,0,0,0
1288091,27,5,1986,10,"male",362,11,6,35,3,0,0,35,3
1288098,23,4,1990,7,"female",392,82,43,3,109,3,98,0,11
1288109,103,12,1910,8,"female",833,137,35,59,9,0,6,59,3
1288120,36,25,1977,7,"male",518,43,15,31,1,2,1,29,0
1288188,29,4,1984,9,"male",569,177,113,6,4,3,1,3,3
1288283,54,2,1959,5,"male",402,28,11,43,11,0,2,43,9
1288320,35,12,1978,3,"female",625,508,373,402,400,402,305,0,95
1288333,27,12,1986,12,"male",393,164,153,0,0,0,0,0,0
1288341,60,1,1953,6,"female",571,54,49,19,1,0,0,19,1
1288342,54,25,1959,3,"female",572,108,18,66,3,48,2,18,1
1288346,39,16,1974,7,"male",634,113,58,0,0,0,0,0,0
1288366,38,19,1975,4,"male",91,79,48,39,43,39,18,0,25
1288381,52,17,1961,3,"female",280,99,59,153,93,153,52,0,41
1288389,33,9,1980,11,"male",178,40,32,1,0,1,0,0,0
1288435,31,3,1982,4,"male",534,289,173,31,76,31,63,0,13
1288467,18,30,1995,11,"male",499,112,86,2,0,0,0,2,0
1288482,60,23,1953,8,"male",329,96,58,5,41,0,20,5,21
1288504,52,27,1961,4,"male",222,46,31,9,3,0,0,9,3
1288518,21,30,1992,4,"male",325,28,23,5,4,0,1,5,3
1288530,21,5,1992,11,"female",589,36,3,0,0,0,0,0,0
1288541,44,12,1969,9,"female",657,71,36,0,0,0,0,0,0
1288548,23,22,1990,1,"male",111,38,23,14,6,12,5,2,1
1288558,19,27,1994,5,"male",221,383,245,140,75,107,32,33,43
1288583,48,18,1965,5,"male",588,73,17,7,5,0,0,7,5
1288630,63,24,1950,10,"female",827,21,16,0,0,0,0,0,0
1288632,21,4,1992,4,"female",290,52,43,0,0,0,0,0,0
1288654,14,1,1999,1,"female",269,109,84,9,20,9,19,0,1
1288675,57,21,1956,5,"male",191,13,11,10,6,8,5,2,1
1288676,21,21,1992,11,"male",251,0,0,0,0,0,0,0,0
1288711,26,4,1987,1,"female",875,51,31,199,6,199,3,0,3
1288713,17,29,1996,9,"female",333,349,187,463,282,463,232,0,50
1288723,51,13,1962,3,"female",730,15,14,0,0,0,0,0,0
1288726,16,26,1997,8,"female",346,387,287,80,18,4,8,76,10
1288747,35,3,1978,3,"male",191,15,14,1,0,1,0,0,0
1288777,18,28,1995,4,"male",430,174,37,7,2,6,1,1,1
1288782,30,5,1983,5,"male",508,27,25,24,0,0,0,24,0
1288788,29,19,1984,7,"female",299,5,0,1,0,0,0,1,0
1288803,18,13,1995,9,"female",411,168,24,38,128,3,50,35,78
1288815,61,7,1952,3,"male",398,96,77,10,45,10,37,0,8
1288835,25,4,1988,4,"female",24,27,19,14,0,13,0,1,0
1288857,14,1,1999,4,"male",131,110,97,1,0,1,0,0,0
1288901,32,20,1981,9,"male",288,12,11,0,0,0,0,0,0
1288925,16,14,1997,5,"male",801,1045,350,556,3078,27,1237,529,1841
1288946,25,29,1988,11,"male",295,353,239,436,179,436,158,0,21
1288947,18,1,1995,2,"female",116,5,3,0,1,0,1,0,0
1288969,23,18,1990,7,"male",448,10,5,0,0,0,0,0,0
1288972,35,16,1978,6,"female",294,101,68,959,881,283,558,676,323
1288974,18,13,1995,10,"male",20,23,15,57,45,20,18,37,27
1288984,47,26,1966,6,"male",713,535,237,1,3,1,1,0,2
1288987,17,11,1996,1,"female",589,1265,369,734,580,194,298,540,282
1288995,42,7,1971,9,"female",366,29,28,67,6,67,4,0,2
1289016,32,24,1981,9,"male",620,99,78,0,11,0,3,0,8
1289040,18,12,1995,4,"female",209,1364,207,1086,241,1086,139,0,102
1289042,15,3,1998,12,"female",273,408,76,100,23,0,10,100,13
1289067,21,22,1992,2,"male",58,4,4,31,9,21,7,10,2
1289076,49,5,1964,5,"female",894,32,25,12,8,12,3,0,5
1289087,108,1,1905,1,"male",1327,222,138,344,118,99,58,245,60
1289090,43,28,1970,11,"male",60,45,45,2,0,0,0,2,0
1289106,73,28,1940,9,"female",296,24,13,42,5,42,4,0,1
1289117,29,8,1984,4,"female",258,6,3,0,0,0,0,0,0
1289129,50,25,1963,12,"female",365,70,45,187,114,5,70,182,44
1289138,18,24,1995,2,"male",101,16,8,58,7,57,6,1,1
1289160,37,13,1976,9,"female",548,129,34,33,63,11,30,22,33
1289200,72,8,1941,10,"male",1296,31,19,0,0,0,0,0,0
1289244,58,29,1955,1,"female",215,28,23,2,0,0,0,2,0
1289277,17,22,1996,3,"male",342,64,36,157,5,0,2,157,3
1289323,31,3,1982,7,"female",689,269,172,27,10,21,8,6,2
1289337,24,16,1989,12,"male",402,15,12,3,1,0,0,3,1
1289343,20,5,1993,3,"female",466,651,586,1161,773,254,594,907,179
1289354,19,21,1994,4,"male",71,17,7,0,5,0,4,0,1
1289375,48,6,1965,4,"female",324,100,52,129,16,129,12,0,4
1289384,21,28,1992,11,"female",1474,1984,189,685,530,353,280,332,250
1289395,22,25,1991,2,"male",140,61,53,233,49,233,36,0,13
1289407,102,1,1911,1,"female",2244,1345,483,80,959,0,431,80,528
1289409,68,7,1945,10,"female",68,146,133,182,88,0,6,182,82
1289432,58,25,1955,5,"female",456,191,110,322,110,322,90,0,20
1289448,32,12,1981,10,"male",1688,774,241,199,104,165,78,34,26
1289466,72,9,1941,1,"male",567,19,7,0,0,0,0,0,0
1289468,45,10,1968,12,"male",10,0,0,0,0,0,0,0,0
1289491,15,11,1998,12,"male",730,221,113,62,67,14,19,48,48
1289497,59,21,1954,7,"male",41,66,64,132,9,1,0,131,9
1289507,16,1,1997,1,"female",732,1119,518,448,317,448,272,0,45
1289582,53,8,1960,10,"female",129,56,48,168,25,168,13,0,12
1289592,25,25,1988,12,"male",460,1,0,0,0,0,0,0,0
1289606,52,1,1961,5,"male",275,22,13,0,0,0,0,0,0
1289629,14,5,1999,1,"female",115,323,305,1498,787,596,528,902,259
1289657,63,18,1950,6,"female",1669,527,276,352,508,349,326,3,182
1289679,47,15,1966,7,"female",1556,112,80,264,199,251,153,13,46
1289698,103,31,1910,12,"female",578,98,65,119,23,119,19,0,4
1289715,26,29,1987,9,"female",267,14,7,0,14,0,8,0,6
1289717,24,27,1989,8,"female",332,83,70,45,16,45,13,0,3
1289724,23,26,1990,1,"male",382,120,87,0,0,0,0,0,0
1289727,26,1,1987,1,"male",524,65,59,2,0,2,0,0,0
1289785,31,24,1982,9,"male",351,52,41,0,0,0,0,0,0
1289817,55,13,1958,12,"female",325,2,1,0,0,0,0,0,0
1289847,49,20,1964,2,"female",672,154,91,93,221,0,110,93,111
1289874,23,1,1990,7,"male",4,2,2,1,0,1,0,0,0
1289876,71,2,1942,2,"female",538,34,23,2,1,2,1,0,0
1289885,20,5,1993,11,"male",640,270,119,1405,1144,259,171,1146,973
1289889,26,4,1987,1,"female",367,12,12,0,0,0,0,0,0
1289890,55,17,1958,12,"male",74,22,21,12,0,12,0,0,0
1289925,13,14,2000,1,"female",243,556,209,9446,5344,9446,4945,0,399
1289932,18,1,1995,1,"male",371,5,4,529,9,326,2,203,7
1289944,17,7,1996,8,"female",219,213,88,62,55,62,50,0,5
1290000,39,19,1974,6,"male",316,21,5,1231,83,574,49,657,34
1290051,37,18,1976,7,"male",923,238,133,0,0,0,0,0,0
1290058,28,9,1985,10,"male",88,70,65,92,2,0,1,92,1
1290061,32,1,1981,2,"male",202,195,135,46,246,11,120,35,126
1290063,16,1,1997,8,"female",541,1048,661,1105,742,1103,300,2,442
1290068,93,8,1920,12,"female",1019,160,98,3,1,3,1,0,0
1290069,20,17,1993,2,"male",536,704,589,36,7,10,3,26,4
1290073,25,3,1988,10,"female",787,225,34,165,430,165,325,0,105
1290102,22,27,1991,9,"male",72,194,192,36,21,36,20,0,1
1290104,15,27,1998,2,"male",405,38,7,3,0,3,0,0,0
1290107,28,16,1985,10,"female",487,13,9,9,5,9,3,0,2
1290151,18,12,1995,6,"male",378,229,138,8,0,8,0,0,0
1290166,27,20,1986,12,"male",132,16,13,0,0,0,0,0,0
1290167,33,29,1980,6,"male",238,41,18,0,0,0,0,0,0
1290171,21,12,1992,5,"male",330,443,313,0,0,0,0,0,0
1290192,64,21,1949,2,"female",863,103,48,165,330,0,269,165,61
1290214,16,23,1997,3,"male",444,275,229,13,32,0,5,13,27
1290219,50,25,1963,8,"female",1692,256,212,611,753,76,523,535,230
1290236,46,31,1967,10,"female",163,14,11,23,11,23,9,0,2
1290266,45,2,1968,10,"male",589,177,108,2,5,2,0,0,5
1290283,18,25,1995,4,"male",621,21,21,0,0,0,0,0,0
1290345,34,13,1979,7,"male",75,724,706,2,223,2,157,0,66
1290349,19,3,1994,8,"male",492,312,260,88,98,26,54,62,44
1290377,85,20,1928,9,"male",469,78,26,9,0,9,0,0,0
1290396,16,14,1997,8,"male",743,2294,1157,6,0,6,0,0,0
1290398,47,27,1966,10,"male",363,24,17,0,0,0,0,0,0
1290411,105,1,1908,3,"female",1686,775,334,171,144,88,38,83,106
1290433,24,16,1989,9,"female",1664,81,47,2,15,1,15,1,0
1290435,30,8,1983,8,"male",241,144,127,1,6,1,4,0,2
1290457,18,17,1995,10,"male",94,0,0,2,1,0,0,2,1
1290467,23,3,1990,3,"female",159,53,25,86,61,86,47,0,14
1290474,103,20,1910,12,"male",705,711,646,81,24,65,19,16,5
1290475,21,12,1992,11,"male",290,74,63,0,0,0,0,0,0
1290519,27,7,1986,9,"male",152,0,0,0,0,0,0,0,0
1290599,16,12,1997,9,"female",110,306,271,10,48,10,30,0,18
1290603,14,4,1999,3,"female",329,338,261,10,4,4,1,6,3
1290615,40,19,1973,10,"female",724,89,50,2,13,2,8,0,5
1290652,38,12,1975,11,"female",7,17,13,10,110,10,67,0,43
1290696,91,6,1922,4,"male",1376,231,101,208,41,208,32,0,9
1290698,15,25,1998,4,"female",547,0,0,0,0,0,0,0,0
1290721,36,3,1977,2,"male",409,110,64,5,4,5,1,0,3
1290756,21,8,1992,8,"female",377,207,41,16,120,16,63,0,57
1290769,22,11,1991,11,"male",17,46,44,6,4,4,3,2,1
1290770,24,10,1989,3,"female",113,32,15,19,0,19,0,0,0
1290824,29,23,1984,9,"male",757,159,95,49,1,43,1,6,0
1290827,94,9,1919,2,"male",283,85,48,0,0,0,0,0,0
1290836,53,26,1960,11,"female",639,17,14,80,49,76,44,4,5
1290841,58,21,1955,2,"male",930,34,10,0,14,0,4,0,10
1290848,65,19,1948,8,"male",521,12,12,1,4,1,3,0,1
1290855,30,15,1983,11,"female",321,124,75,110,51,110,41,0,10
1290889,28,21,1985,8,"male",614,34,16,2,2,0,0,2,2
1290910,21,12,1992,1,"female",645,71,32,167,82,165,67,2,15
1290918,32,11,1981,5,"male",721,87,64,449,17,449,13,0,4
1290927,19,4,1994,4,"male",497,117,63,0,0,0,0,0,0
1290941,24,3,1989,7,"female",104,17,4,0,0,0,0,0,0
1290966,18,28,1995,1,"male",117,4,4,3,5,0,1,3,4
1290982,31,20,1982,11,"male",406,90,49,2,0,1,0,1,0
1290994,23,11,1990,8,"male",655,162,92,1,1,1,0,0,1
1291024,27,7,1986,5,"male",282,20,2,0,0,0,0,0,0
1291035,56,21,1957,12,"female",556,39,9,0,125,0,115,0,10
1291063,15,29,1998,12,"female",290,132,87,0,8,0,7,0,1
1291071,54,27,1959,7,"male",474,289,188,53,21,53,21,0,0
1291076,31,12,1982,6,"male",246,51,36,8,9,8,5,0,4
1291098,23,19,1990,12,"female",100,5,3,78,5,78,5,0,0
1291101,24,12,1989,9,"male",899,200,153,3,3,3,2,0,1
1291107,36,14,1977,8,"female",486,528,419,3,32,3,25,0,7
1291132,24,25,1989,4,"female",297,67,39,165,93,141,74,24,19
1291201,37,10,1976,10,"male",215,50,21,1,1,1,1,0,0
1291259,23,11,1990,11,"male",713,57,38,7,10,2,3,5,7
1291276,21,4,1992,11,"female",759,105,42,13,1,13,0,0,1
1291279,31,16,1982,12,"female",18,135,128,362,195,299,148,63,47
1291280,23,15,1990,10,"male",299,95,87,1,2,1,2,0,0
1291288,20,14,1993,10,"male",758,73,28,9,12,9,11,0,1
1291354,58,16,1955,9,"male",1341,96,55,0,1,0,1,0,0
1291369,14,25,1999,4,"male",49,28,20,3,3,3,3,0,0
1291391,20,1,1993,1,"male",230,124,23,148,83,148,56,0,27
1291394,41,18,1972,11,"female",316,92,66,83,47,77,44,6,3
1291400,32,7,1981,3,"male",178,65,41,5,91,3,32,2,59
1291442,25,15,1988,4,"male",477,3,1,0,0,0,0,0,0
1291447,27,1,1986,1,"male",145,19,11,0,0,0,0,0,0
1291450,22,6,1991,12,"female",586,264,138,1,1,1,1,0,0
1291456,30,8,1983,3,"male",645,140,65,1,1,0,0,1,1
1291467,16,8,1997,10,"female",499,1860,181,1550,2537,1547,2391,3,146
1291469,66,8,1947,10,"female",812,120,29,1,2,0,0,1,2
1291530,56,16,1957,1,"male",531,146,124,2,4,0,1,2,3
1291561,63,4,1950,7,"male",789,12,10,5,8,0,1,5,7
1291586,22,19,1991,9,"male",234,119,89,10,1,10,1,0,0
1291590,25,11,1988,11,"female",529,155,84,21,5,21,1,0,4
1291613,48,23,1965,4,"male",1739,12,8,1,1,1,0,0,1
1291616,30,10,1983,8,"female",31,287,236,154,613,12,96,142,517
1291630,47,21,1966,11,"female",473,36,19,0,0,0,0,0,0
1291663,25,29,1988,2,"male",19,1,1,1,22,1,13,0,9
1291675,15,20,1998,1,"male",313,106,64,16,17,16,14,0,3
1291732,35,3,1978,8,"male",973,54,35,2,0,2,0,0,0
1291773,50,12,1963,8,"female",546,57,37,10,6,10,6,0,0
1291791,15,9,1998,4,"male",39,70,65,214,20,213,8,1,12
1291794,42,14,1971,9,"male",1593,73,19,2,5,2,5,0,0
1291829,13,28,2000,1,"male",656,450,268,93,5,70,0,23,5
1291836,18,23,1995,1,"male",223,150,125,28,5,28,4,0,1
1291928,26,2,1987,3,"female",327,83,40,276,160,276,89,0,71
1291931,21,14,1992,1,"female",199,279,162,251,44,238,32,13,12
1291948,51,8,1962,11,"male",186,0,0,3,0,3,0,0,0
1291954,60,16,1953,10,"female",554,231,136,1,2,0,1,1,1
1291959,17,23,1996,1,"male",390,1192,985,25,6,4,5,21,1
1291966,34,26,1979,7,"female",314,45,22,60,76,60,72,0,4
1292008,63,27,1950,12,"female",243,41,33,11,6,11,5,0,1
1292033,27,10,1986,4,"male",699,146,107,40,21,40,3,0,18
1292034,69,19,1944,9,"female",1337,30,6,21,2,0,0,21,2
1292058,20,16,1993,6,"female",8,9,7,10,1,10,1,0,0
1292078,16,15,1997,9,"female",253,197,103,55,40,17,24,38,16
1292087,70,31,1943,7,"female",420,34,27,2,4,0,1,2,3
1292089,51,16,1962,2,"male",824,8,7,1,0,1,0,0,0
1292106,18,1,1995,7,"male",575,180,79,2,50,2,32,0,18
1292110,16,27,1997,12,"female",353,570,291,0,5,0,5,0,0
1292111,19,18,1994,12,"male",141,38,36,5,0,5,0,0,0
1292116,31,6,1982,6,"female",442,89,39,209,46,209,32,0,14
1292134,18,21,1995,4,"male",364,262,186,634,578,560,372,74,206
1292166,91,1,1922,1,"male",14,99,97,414,132,414,26,0,106
1292174,23,1,1990,7,"female",105,1,0,0,0,0,0,0,0
1292217,71,25,1942,4,"male",26,7,7,64,0,0,0,64,0
1292219,24,19,1989,11,"male",833,104,78,58,33,19,23,39,10
1292228,18,6,1995,6,"female",272,256,195,0,17,0,10,0,7
1292255,61,5,1952,10,"female",1818,79,42,17,143,0,83,17,60
1292263,22,17,1991,3,"male",1170,759,372,15,6,12,1,3,5
1292280,35,16,1978,2,"female",1136,51,29,29,39,0,18,29,21
1292293,39,27,1974,3,"female",611,657,477,148,423,126,139,22,284
1292297,29,14,1984,8,"male",150,134,47,0,0,0,0,0,0
1292305,52,4,1961,5,"male",1675,115,46,2,1,1,1,1,0
1292386,79,3,1934,4,"female",62,91,39,67,55,32,45,35,10
1292392,14,8,1999,4,"male",366,952,665,42,62,30,39,12,23
1292405,18,2,1995,4,"male",131,44,31,2,5,2,4,0,1
1292423,13,10,2000,3,"male",84,164,96,24,14,7,4,17,10
1292426,17,22,1996,4,"male",128,304,299,0,5,0,5,0,0
1292451,24,16,1989,5,"male",565,36,24,2,1,2,0,0,1
1292462,15,5,1998,10,"female",263,106,72,0,0,0,0,0,0
1292483,25,8,1988,10,"male",96,70,54,0,0,0,0,0,0
1292491,15,14,1998,9,"male",432,192,163,0,19,0,19,0,0
1292535,24,23,1989,4,"male",357,27,22,0,1,0,0,0,1
1292537,29,1,1984,1,"female",407,2,2,0,0,0,0,0,0
1292549,20,5,1993,11,"female",300,57,39,189,50,189,48,0,2
1292554,22,7,1991,2,"male",609,258,184,0,4,0,3,0,1
1292555,26,19,1987,4,"female",209,61,39,0,2,0,2,0,0
1292558,19,1,1994,1,"female",74,427,36,3288,3389,3288,2671,0,718
1292586,18,16,1995,2,"male",589,148,88,0,0,0,0,0,0
1292599,20,8,1993,12,"male",640,2141,881,251,738,179,218,72,520
1292606,17,28,1996,9,"female",324,1182,509,287,714,284,230,3,484
1292615,25,15,1988,12,"male",587,1,0,1,0,1,0,0,0
1292632,100,13,1913,4,"male",2178,503,219,30,16,11,8,19,8
1292640,19,16,1994,11,"male",212,9,3,2,0,0,0,2,0
1292642,16,9,1997,9,"male",245,0,0,0,0,0,0,0,0
1292651,83,28,1930,5,"female",1414,128,34,78,4,0,1,78,3
1292655,32,13,1981,11,"female",197,69,56,95,162,93,100,2,62
1292675,45,2,1968,4,"female",276,86,41,413,384,403,249,10,135
1292687,77,28,1936,2,"female",2078,7,2,2,2,0,0,2,2
1292695,17,11,1996,2,"male",357,439,407,30,6,0,5,30,1
1292713,71,11,1942,3,"female",599,50,32,56,3,56,2,0,1
1292721,20,24,1993,7,"male",182,38,14,0,0,0,0,0,0
1292728,103,30,1910,12,"female",1427,4676,243,359,135,178,55,181,80
1292744,26,30,1987,4,"female",591,38,14,0,0,0,0,0,0
1292747,19,1,1994,1,"male",27,259,250,60,194,60,160,0,34
1292818,20,14,1993,5,"male",655,58,53,1,0,1,0,0,0
1292833,25,21,1988,2,"male",484,40,22,2,0,2,0,0,0
1292871,18,13,1995,2,"male",98,241,204,12,11,12,11,0,0
1292873,19,28,1994,12,"male",194,583,410,2065,540,2065,501,0,39
1292911,58,28,1955,7,"female",703,74,22,182,47,0,22,182,25
1292919,18,19,1995,5,"male",320,524,61,1,4,1,1,0,3
1292922,16,12,1997,1,"female",276,245,197,126,14,122,12,4,2
1292930,27,23,1986,12,"male",402,231,94,5,4,5,4,0,0
1292941,15,7,1998,5,"male",588,327,190,4,2,2,1,2,1
1292962,32,28,1981,12,"male",553,12,11,4,3,4,3,0,0
1293023,22,6,1991,2,"male",325,245,228,43,26,43,14,0,12
1293035,108,14,1905,4,"female",1563,891,266,104,210,39,137,65,73
1293047,66,13,1947,11,"female",908,57,15,15,9,15,6,0,3
1293061,29,24,1984,9,"female",395,182,115,49,21,49,11,0,10
1293066,38,5,1975,12,"male",346,8,7,13,8,8,7,5,1
1293077,17,24,1996,11,"male",22,10,10,1,4,0,0,1,4
1293093,56,1,1957,10,"male",492,25,12,0,0,0,0,0,0
1293121,38,11,1975,8,"female",199,113,99,150,129,127,60,23,69
1293136,19,18,1994,3,"female",178,548,442,427,311,413,115,14,196
1293191,48,3,1965,1,"male",473,23,12,0,0,0,0,0,0
1293232,27,24,1986,10,"male",66,21,19,2,3,2,3,0,0
1293235,64,3,1949,10,"female",915,49,32,0,8,0,1,0,7
1293249,48,23,1965,3,"male",42,20,16,0,0,0,0,0,0
1293266,38,14,1975,7,"female",142,87,80,25,31,25,30,0,1
1293268,20,6,1993,9,"female",14,316,246,191,394,74,250,117,144
1293283,22,16,1991,6,"male",517,15,9,20,26,4,3,16,23
1293293,17,4,1996,1,"female",121,39,26,5,4,5,2,0,2
1293306,18,15,1995,10,"male",155,196,92,112,9,112,5,0,4
1293355,20,20,1993,4,"male",492,187,130,8,33,8,29,0,4
1293370,21,13,1992,4,"male",164,11,9,0,0,0,0,0,0
1293379,25,25,1988,3,"male",780,65,44,56,6,0,1,56,5
1293383,20,10,1993,4,"male",117,22,22,3,4,3,3,0,1
1293384,23,9,1990,3,"male",6,40,33,12,15,12,13,0,2
1293387,15,20,1998,10,"male",877,290,167,63,1,0,0,63,1
1293399,32,8,1981,1,"male",390,14,11,2,0,2,0,0,0
1293422,22,27,1991,7,"male",194,350,282,2171,934,6,465,2165,469
1293431,18,18,1995,11,"male",21,1,1,0,0,0,0,0,0
1293432,16,19,1997,4,"female",463,397,270,47,50,47,26,0,24
1293448,27,19,1986,9,"male",305,39,35,6,7,6,2,0,5
1293452,20,6,1993,2,"male",861,293,99,5,41,5,22,0,19
1293459,22,21,1991,7,"male",55,272,36,1,11,1,5,0,6
1293496,108,6,1905,3,"female",687,294,99,7,8,7,7,0,1
1293511,17,20,1996,5,"male",274,681,542,62,14,62,13,0,1
1293520,16,5,1997,5,"male",178,46,37,9,3,9,3,0,0
1293542,27,16,1986,1,"male",1600,259,103,22,33,22,22,0,11
1293551,73,4,1940,9,"female",675,225,146,77,68,77,58,0,10
1293564,15,23,1998,5,"male",1,20,20,12,5,10,5,2,0
1293596,49,17,1964,5,"male",779,29,26,11,5,6,5,5,0
1293610,43,14,1970,5,"male",666,32,14,32,54,32,42,0,12
1293619,17,7,1996,10,"male",1247,190,129,2,0,2,0,0,0
1293660,113,28,1900,12,"male",1257,143,103,647,811,647,708,0,103
1293678,18,2,1995,10,"male",408,4,3,5,0,5,0,0,0
1293725,21,13,1992,1,"male",256,296,151,21,72,14,52,7,20
1293733,32,13,1981,8,"female",603,341,294,93,89,93,65,0,24
1293756,40,25,1973,7,"male",610,122,89,1,0,0,0,1,0
1293806,27,12,1986,3,"male",398,129,97,28,18,27,15,1,3
1293834,53,17,1960,5,"female",751,20,17,11,9,0,3,11,6
1293838,31,2,1982,12,"male",246,107,66,118,43,118,28,0,15
1293866,78,18,1935,10,"female",174,11,9,3,3,0,2,3,1
1293881,15,21,1998,9,"male",472,62,25,67,19,0,2,67,17
1293893,35,4,1978,6,"female",590,42,29,43,125,41,90,2,35
1293926,19,12,1994,1,"female",278,71,38,5,14,2,0,3,14
1293947,19,10,1994,4,"male",159,244,205,8,7,8,7,0,0
1293948,39,5,1974,11,"male",969,98,31,0,0,0,0,0,0
1293949,22,2,1991,1,"male",536,190,88,5,31,5,14,0,17
1293952,24,21,1989,7,"male",1132,277,88,0,0,0,0,0,0
1293995,93,1,1920,1,"male",1686,301,216,67,4,48,1,19,3
1294002,33,1,1980,1,"female",429,369,163,10,0,9,0,1,0
1294008,25,19,1988,5,"female",542,502,167,283,237,283,218,0,19
1294047,34,16,1979,5,"male",501,25,7,6,0,6,0,0,0
1294054,47,6,1966,5,"male",287,0,0,0,0,0,0,0,0
1294061,46,11,1967,11,"female",765,236,194,26,11,26,8,0,3
1294074,15,11,1998,8,"female",308,1,1,0,0,0,0,0,0
1294078,30,19,1983,8,"male",315,147,92,181,445,98,225,83,220
1294080,25,24,1988,6,"female",358,412,161,387,344,387,328,0,16
1294102,28,16,1985,8,"male",631,30,20,23,4,23,2,0,2
1294107,68,22,1945,10,"male",869,155,118,8,4,8,2,0,2
1294115,64,30,1949,4,NA,2213,32,17,15,26,9,18,6,8
1294122,25,11,1988,11,"male",604,191,146,16,27,14,21,2,6
1294130,64,5,1949,6,"female",293,125,40,121,1,121,0,0,1
1294131,66,12,1947,7,"male",590,32,15,22,7,1,2,21,5
1294156,103,20,1910,11,"female",1299,102,35,137,44,0,21,137,23
1294174,67,8,1946,12,"female",509,16,8,23,8,0,7,23,1
1294191,29,9,1984,10,"male",12,1,0,0,0,0,0,0,0
1294196,22,5,1991,1,"male",418,46,44,0,0,0,0,0,0
1294207,108,1,1905,1,"male",1562,248,38,3,4,0,4,3,0
1294226,56,11,1957,8,"male",690,80,41,23,15,23,7,0,8
1294230,100,20,1913,3,"female",169,13,11,66,1,66,1,0,0
1294242,72,15,1941,12,"male",1208,56,45,6,18,6,8,0,10
1294244,62,25,1951,6,"male",1769,8,4,0,0,0,0,0,0
1294246,108,1,1905,1,"male",6,27,23,599,25,598,12,1,13
1294269,23,26,1990,5,"male",464,110,36,26,208,14,148,12,60
1294282,33,26,1980,10,"male",437,39,26,51,64,51,45,0,19
1294317,28,5,1985,11,"male",299,27,11,32,44,32,24,0,20
1294429,18,20,1995,2,"male",500,92,52,0,0,0,0,0,0
1294443,43,23,1970,8,"female",287,41,24,13,10,13,9,0,1
1294454,21,6,1992,8,"female",485,75,54,19,64,19,59,0,5
1294462,32,28,1981,9,"male",524,179,26,85,2,85,1,0,1
1294464,24,24,1989,12,"female",364,1,1,0,1,0,0,0,1
1294474,54,1,1959,12,"male",74,1,1,0,0,0,0,0,0
1294482,30,26,1983,1,"male",663,263,243,7,11,7,10,0,1
1294494,25,14,1988,10,"female",1269,918,354,1384,6696,663,4105,721,2591
1294501,21,15,1992,2,"male",307,28,2,0,0,0,0,0,0
1294506,21,2,1992,2,"male",252,181,173,11,11,11,8,0,3
1294509,30,8,1983,3,"male",484,26,11,0,0,0,0,0,0
1294517,108,23,1905,2,"male",1136,153,88,0,5,0,5,0,0
1294541,33,1,1980,1,"male",622,139,75,166,6,133,2,33,4
1294546,51,28,1962,9,"female",1439,74,31,4858,1122,4858,712,0,410
1294568,60,16,1953,9,"male",224,7,6,36,3,36,0,0,3
1294615,23,20,1990,1,"female",329,146,81,86,56,55,43,31,13
1294634,16,1,1997,2,"male",113,3,2,0,0,0,0,0,0
1294635,26,2,1987,2,"male",575,0,0,0,0,0,0,0,0
1294638,28,23,1985,1,"male",78,23,22,15,1,0,1,15,0
1294689,38,11,1975,6,"male",873,157,128,60,17,60,10,0,7
1294698,13,6,2000,1,"male",171,128,105,12,0,0,0,12,0
1294711,26,13,1987,1,"male",258,180,155,1,31,0,23,1,8
1294714,62,22,1951,5,"male",1651,445,350,150,175,96,80,54,95
1294716,45,31,1968,5,"male",497,17,7,21,1,21,1,0,0
1294763,60,7,1953,11,"female",1762,23,14,8,12,8,11,0,1
1294765,21,12,1992,12,"male",368,545,514,3,15,3,9,0,6
1294784,17,20,1996,4,"male",350,401,351,5,33,4,20,1,13
1294789,26,1,1987,1,"male",431,68,62,1,0,1,0,0,0
1294804,29,16,1984,6,"male",191,37,32,331,65,331,28,0,37
1294808,54,28,1959,10,"male",1088,30,11,8,1,8,1,0,0
1294825,31,6,1982,6,"male",1327,86,40,1,2,1,2,0,0
1294846,19,3,1994,8,"male",28,91,82,2,22,2,20,0,2
1294873,33,19,1980,2,"male",363,23,21,2,0,0,0,2,0
1294877,23,1,1990,1,"male",42,14,12,0,0,0,0,0,0
1294913,31,4,1982,4,"male",432,159,114,13,0,6,0,7,0
1294918,51,23,1962,6,"female",149,44,29,86,18,0,5,86,13
1294928,15,25,1998,5,"male",217,23,10,0,1,0,1,0,0
1294935,24,19,1989,6,"female",395,112,78,19,16,7,13,12,3
1294962,61,10,1952,12,"male",5,143,140,123,107,109,76,14,31
1294965,65,22,1948,2,"female",394,70,17,1,3,0,3,1,0
1294990,19,21,1994,6,"male",109,41,18,0,0,0,0,0,0
1295042,67,6,1946,5,"male",208,532,306,277,11,277,7,0,4
1295056,75,15,1938,10,"male",839,30,18,0,0,0,0,0,0
1295060,19,16,1994,5,"female",575,325,230,17,7,17,6,0,1
1295072,27,7,1986,12,"male",302,20,13,9,2,0,1,9,1
1295088,19,8,1994,10,"female",922,802,360,5,42,5,21,0,21
1295095,43,21,1970,3,"female",340,156,95,158,34,140,21,18,13
1295123,23,12,1990,12,"male",76,93,80,76,52,76,34,0,18
1295124,15,12,1998,12,"male",683,93,72,4,0,0,0,4,0
1295144,21,1,1992,4,"male",26,0,0,0,0,0,0,0,0
1295174,25,4,1988,2,"male",574,591,327,61,26,0,6,61,20
1295206,22,25,1991,1,"male",247,181,87,69,73,69,62,0,11
1295211,54,5,1959,3,"female",677,97,49,45,59,39,49,6,10
1295251,64,28,1949,3,"female",576,35,29,0,0,0,0,0,0
1295255,36,10,1977,3,"female",157,35,24,3259,157,3259,68,0,89
1295260,23,19,1990,2,"male",451,205,118,0,32,0,27,0,5
1295284,18,1,1995,8,"female",1801,3237,411,1603,2694,530,1687,1073,1007
1295286,16,28,1997,11,"female",5,219,180,79,31,57,25,22,6
1295302,18,1,1995,9,"male",413,235,142,2,36,0,4,2,32
1295303,53,25,1960,3,"female",1141,97,29,48,149,47,71,1,78
1295320,48,20,1965,2,"female",334,380,319,1103,1634,1065,870,38,764
1295321,16,5,1997,1,"female",222,111,101,2,14,2,4,0,10
1295354,26,30,1987,1,"male",414,56,36,12,8,0,0,12,8
1295366,36,21,1977,8,"male",417,11,9,8,4,8,4,0,0
1295447,24,17,1989,8,"male",584,237,135,4,0,4,0,0,0
1295452,24,10,1989,1,"male",51,29,21,1,1,1,1,0,0
1295459,15,27,1998,6,"female",514,315,171,4,55,4,33,0,22
1295483,25,3,1988,7,"male",14,40,28,0,14,0,9,0,5
1295507,18,19,1995,2,"female",212,32,28,0,0,0,0,0,0
1295510,55,14,1958,11,"female",661,128,66,272,58,25,33,247,25
1295514,23,5,1990,3,"male",227,168,158,0,0,0,0,0,0
1295522,50,16,1963,1,"female",356,185,126,641,602,9,219,632,383
1295526,37,31,1976,5,"female",1421,71,19,17,52,15,22,2,30
1295533,23,16,1990,8,"male",549,25,18,0,1,0,0,0,1
1295578,19,6,1994,5,"female",589,2576,766,1197,1616,595,1418,602,198
1295583,25,1,1988,1,"male",133,0,0,0,0,0,0,0,0
1295590,35,6,1978,1,"male",86,34,33,369,15,369,5,0,10
1295593,36,18,1977,7,"male",608,23,13,1,0,1,0,0,0
1295619,21,27,1992,6,"female",764,448,119,5,17,5,17,0,0
1295645,37,25,1976,12,"female",391,39,19,56,26,56,4,0,22
1295652,22,6,1991,11,"female",134,29,21,74,28,74,25,0,3
1295672,42,13,1971,10,"male",197,3,2,4,3,0,0,4,3
1295713,23,15,1990,12,"male",585,343,309,0,25,0,22,0,3
1295716,25,1,1988,1,"male",42,3,2,2,3,2,3,0,0
1295718,40,31,1973,12,"male",262,49,44,24,1,24,1,0,0
1295728,55,23,1958,9,"female",1636,294,178,762,340,42,214,720,126
1295731,100,29,1913,12,"male",1216,39,15,27,39,27,34,0,5
1295779,18,4,1995,10,"female",571,189,76,169,56,116,24,53,32
1295785,48,28,1965,6,"female",1258,104,53,286,991,136,795,150,196
1295790,15,14,1998,8,"male",18,47,31,0,0,0,0,0,0
1295794,18,22,1995,11,"male",216,15,10,0,1,0,1,0,0
1295798,21,13,1992,2,"male",895,188,45,46,51,46,35,0,16
1295800,21,12,1992,12,"male",305,3,2,0,0,0,0,0,0
1295807,29,23,1984,10,"male",18,24,24,0,2,0,0,0,2
1295838,49,17,1964,5,"male",1083,39,21,40,10,40,3,0,7
1295860,44,9,1969,4,"male",1517,332,216,3,1,0,1,3,0
1295893,103,1,1910,7,"male",359,972,815,20,64,16,55,4,9
1295900,55,26,1958,8,"male",295,24,16,0,28,0,22,0,6
1295903,16,25,1997,4,"female",235,73,47,2,1,2,1,0,0
1295906,103,9,1910,12,"female",1370,35,10,3,1,0,0,3,1
1295926,20,12,1993,5,"male",489,111,68,1,2,1,2,0,0
1295961,16,22,1997,12,"female",204,72,56,2,1,0,1,2,0
1295973,69,6,1944,2,"male",852,232,46,4,20,0,2,4,18
1295975,100,12,1913,9,"male",559,207,129,773,345,773,291,0,54
1295985,38,18,1975,7,"male",295,205,174,152,147,152,116,0,31
1295990,25,8,1988,1,"female",23,2,1,26,237,26,184,0,53
1296003,23,22,1990,6,"male",535,95,51,7,4,5,3,2,1
1296024,97,10,1916,5,"male",263,141,134,140,109,140,73,0,36
1296042,26,5,1987,12,"female",289,34,27,1,0,0,0,1,0
1296069,25,2,1988,2,"female",245,80,30,128,68,0,19,128,49
1296073,102,7,1911,7,"male",1697,105,10,1,8,1,2,0,6
1296101,60,17,1953,2,"male",384,115,107,0,0,0,0,0,0
1296113,14,1,1999,1,"male",114,71,48,4,17,4,11,0,6
1296189,19,26,1994,8,"male",251,95,69,6,35,6,34,0,1
1296212,18,9,1995,2,"male",325,406,332,137,185,129,111,8,74
1296219,68,20,1945,4,"male",534,23,6,129,31,0,9,129,22
1296223,28,3,1985,9,"female",431,25,6,25,13,25,10,0,3
1296228,28,27,1985,2,"female",356,76,56,198,38,0,17,198,21
1296254,44,28,1969,6,"female",664,1232,440,1320,1518,882,1266,438,252
1296264,14,2,1999,3,"male",380,87,60,3,83,3,79,0,4
1296289,40,12,1973,11,"female",503,53,43,8,8,8,6,0,2
1296297,30,19,1983,11,"male",678,1,1,33,10,8,1,25,9
1296298,72,1,1941,4,"female",370,35,23,176,26,0,17,176,9
1296337,26,1,1987,1,"male",574,259,202,19,1,19,1,0,0
1296345,31,18,1982,2,"male",207,99,76,3,19,3,19,0,0
1296347,38,4,1975,5,"male",613,0,0,0,0,0,0,0,0
1296364,25,5,1988,5,"female",628,25,9,1,2,1,2,0,0
1296372,28,1,1985,12,"male",307,45,37,481,0,481,0,0,0
1296377,16,7,1997,11,"female",497,231,128,539,295,455,204,84,91
1296379,20,8,1993,10,"male",185,248,228,43,134,38,24,5,110
1296392,13,11,2000,10,"male",24,59,58,16,33,13,24,3,9
1296396,20,15,1993,10,"male",224,47,28,1,1,1,1,0,0
1296435,19,30,1994,1,"male",774,739,544,0,3,0,3,0,0
1296447,54,10,1959,1,"male",708,60,34,0,0,0,0,0,0
1296448,20,3,1993,7,"male",536,13,12,22,2,19,2,3,0
1296450,32,12,1981,9,"male",608,56,49,44,2,0,0,44,2
1296487,43,11,1970,10,"male",1551,132,45,0,0,0,0,0,0
1296495,19,12,1994,12,"male",356,9,4,9,0,0,0,9,0
1296573,14,16,1999,4,"male",482,29,20,1,3,1,0,0,3
1296574,25,11,1988,2,"female",295,24,19,22,19,22,17,0,2
1296586,36,7,1977,7,"female",477,2,2,0,0,0,0,0,0
1296604,17,30,1996,6,"male",322,16,13,3,0,3,0,0,0
1296628,26,19,1987,2,"female",503,136,89,390,67,390,26,0,41
1296646,13,30,2000,1,"male",8,123,106,59,55,59,26,0,29
1296655,17,21,1996,5,"male",102,80,63,1,0,1,0,0,0
1296659,29,11,1984,2,"female",326,67,29,761,915,294,131,467,784
1296665,103,21,1910,4,"male",1049,486,296,79,50,68,31,11,19
1296670,29,2,1984,3,"female",412,226,177,86,82,54,16,32,66
1296680,36,28,1977,6,"female",241,49,26,114,34,114,28,0,6
1296709,36,5,1977,5,"male",190,20,9,0,0,0,0,0,0
1296727,44,30,1969,9,"male",13,15,15,0,2,0,0,0,2
1296729,53,5,1960,12,"female",1375,25,10,13,62,12,24,1,38
1296734,68,21,1945,1,"female",1634,325,89,1,3,1,3,0,0
1296799,30,5,1983,2,"male",302,1,1,0,0,0,0,0,0
1296809,43,20,1970,7,"male",151,38,34,0,1,0,1,0,0
1296836,27,6,1986,1,"male",92,11,9,1,0,1,0,0,0
1296848,50,16,1963,10,"male",946,13,7,9,0,9,0,0,0
1296874,62,16,1951,8,"male",255,86,27,17,4,17,2,0,2
1296878,27,12,1986,9,"male",376,10,3,3,7,3,4,0,3
1296920,60,12,1953,8,"female",594,181,141,34,7,0,2,34,5
1296933,23,30,1990,5,"male",374,466,402,33,12,28,12,5,0
1296941,19,14,1994,3,"male",447,94,82,0,0,0,0,0,0
1296954,103,4,1910,3,"male",985,351,269,3,9,3,8,0,1
1296991,68,2,1945,12,"male",1075,217,109,1,23,1,20,0,3
1297000,37,10,1976,8,"male",573,65,51,658,9,658,4,0,5
1297069,15,23,1998,9,"female",116,51,35,1,0,1,0,0,0
1297076,21,5,1992,5,"male",486,108,65,0,8,0,1,0,7
1297083,75,24,1938,1,"female",1281,33,15,1,5,0,1,1,4
1297107,25,1,1988,4,"female",134,6,4,35,8,35,8,0,0
1297112,16,13,1997,5,"female",62,58,36,87,88,86,62,1,26
1297131,26,10,1987,5,"male",355,356,112,45,569,45,190,0,379
1297138,18,10,1995,10,"male",241,436,419,100,4,100,4,0,0
1297146,15,29,1998,6,"female",64,129,70,16,195,16,163,0,32
1297158,18,12,1995,12,"male",559,155,54,0,20,0,20,0,0
1297159,59,3,1954,12,"female",155,101,70,10,17,0,10,10,7
1297179,16,1,1997,9,"female",824,98,56,96,70,76,40,20,30
1297207,15,9,1998,3,"male",738,71,52,23,17,23,10,0,7
1297246,18,22,1995,9,"female",249,446,362,1309,1151,1189,878,120,273
1297260,25,1,1988,1,"male",7,0,0,4,1,4,1,0,0
1297272,16,5,1997,3,"female",1192,3817,1688,321,1428,161,939,160,489
1297280,16,9,1997,9,"female",143,324,194,1258,1640,1175,1070,83,570
1297295,24,21,1989,9,"male",198,26,16,0,0,0,0,0,0
1297309,27,14,1986,9,"female",586,692,534,613,762,603,602,10,160
1297324,26,2,1987,1,"male",262,46,26,8,4,8,4,0,0
1297334,19,23,1994,3,"female",368,227,97,56,5,56,2,0,3
1297361,16,17,1997,2,"male",331,187,95,2,20,2,20,0,0
1297384,50,2,1963,1,"female",469,44,27,286,68,286,64,0,4
1297391,47,13,1966,6,"male",447,26,20,12,1,12,0,0,1
1297401,20,11,1993,4,"female",313,112,42,0,0,0,0,0,0
1297451,63,5,1950,6,"female",566,144,33,1393,266,778,59,615,207
1297452,52,19,1961,5,"female",164,18,16,0,1,0,1,0,0
1297468,29,15,1984,1,"male",732,8,8,2,0,2,0,0,0
1297474,21,23,1992,7,"female",530,210,145,292,102,143,72,149,30
1297476,23,28,1990,2,"male",324,52,44,7,7,1,4,6,3
1297511,40,4,1973,11,"male",61,17,2,1,0,1,0,0,0
1297526,20,7,1993,4,"male",342,168,143,13,11,13,11,0,0
1297545,20,23,1993,3,"male",548,170,106,3,3,3,2,0,1
1297556,25,1,1988,8,"male",673,128,39,4,7,2,2,2,5
1297559,103,2,1910,9,"male",578,468,261,57,48,57,44,0,4
1297567,25,20,1988,12,"male",666,314,237,1,1,0,0,1,1
1297568,21,20,1992,1,"male",260,106,80,0,0,0,0,0,0
1297574,17,14,1996,5,"male",406,278,131,2205,279,2196,133,9,146
1297584,58,16,1955,9,"male",677,52,29,7,4,7,4,0,0
1297598,75,6,1938,10,"female",1788,179,110,165,89,155,41,10,48
1297608,108,25,1905,4,"female",158,70,40,32,18,32,7,0,11
1297616,25,1,1988,1,"male",26,9,9,0,0,0,0,0,0
1297633,26,1,1987,1,"male",237,57,46,7,1,7,1,0,0
1297637,62,30,1951,4,"male",1538,127,33,34,29,29,24,5,5
1297644,71,12,1942,1,"male",1280,114,68,477,40,67,27,410,13
1297678,25,4,1988,4,"male",341,29,26,3,1,3,1,0,0
1297710,29,22,1984,12,"male",565,17,11,0,0,0,0,0,0
1297711,38,10,1975,6,"male",813,86,59,2,0,0,0,2,0
1297713,103,23,1910,1,"female",1333,62,17,14,10,14,10,0,0
1297733,57,21,1956,4,"male",52,69,21,120,1,19,1,101,0
1297734,23,5,1990,5,"male",710,44,28,4,1,4,1,0,0
1297754,16,2,1997,1,"male",219,30,27,0,1,0,1,0,0
1297777,45,8,1968,1,"male",507,24,7,2,0,2,0,0,0
1297781,25,1,1988,1,"male",63,44,30,0,0,0,0,0,0
1297804,15,19,1998,10,"female",349,432,206,974,930,973,814,1,116
1297840,68,5,1945,4,"male",579,120,72,6,31,0,5,6,26
1297883,36,11,1977,3,"male",625,64,11,9,7,9,1,0,6
1297887,29,17,1984,11,"male",1054,94,37,28,5,28,5,0,0
1297893,58,22,1955,5,"male",928,76,52,2,2,0,0,2,2
1297913,18,21,1995,8,"male",707,91,66,0,1,0,0,0,1
1297917,43,25,1970,11,"male",97,289,284,36,1,36,1,0,0
1297956,25,1,1988,6,"male",569,190,148,40,17,36,17,4,0
1297965,26,30,1987,3,"male",252,55,34,7,2,7,2,0,0
1297985,113,18,1900,5,"male",1197,86,50,44,66,0,6,44,60
1297999,26,1,1987,7,"male",323,93,43,14,0,14,0,0,0
1298006,24,31,1989,7,"female",371,114,78,1,0,0,0,1,0
1298011,17,8,1996,8,"male",251,17,13,2,49,2,11,0,38
1298019,14,6,1999,4,"male",434,172,83,228,78,140,17,88,61
1298024,19,31,1994,7,"male",655,2066,1734,350,1233,1,589,349,644
1298027,42,1,1971,1,"female",55,29,20,22,13,1,9,21,4
1298089,26,29,1987,3,"male",16,0,0,0,0,0,0,0,0
1298120,47,10,1966,4,"male",208,468,77,17,318,11,173,6,145
1298122,63,2,1950,8,"female",1076,914,567,397,607,85,218,312,389
1298147,46,22,1967,11,"female",201,57,25,504,90,488,30,16,60
1298178,61,23,1952,10,"male",1736,608,253,501,1444,501,942,0,502
1298185,32,26,1981,10,"female",431,24,6,10,1,10,1,0,0
1298192,51,26,1962,7,"male",1167,45,22,0,0,0,0,0,0
1298201,108,1,1905,5,"female",878,355,306,2,1,0,1,2,0
1298218,29,30,1984,4,"male",596,65,48,24,13,24,4,0,9
1298229,18,21,1995,10,"male",290,130,89,5,0,5,0,0,0
1298242,26,18,1987,9,"male",845,0,0,0,0,0,0,0,0
1298258,19,27,1994,11,"female",456,3850,1311,4151,17117,3981,9370,170,7747
1298279,21,12,1992,5,"female",470,21,7,39,24,38,8,1,16
1298317,35,3,1978,5,"male",347,32,15,117,47,0,18,117,29
1298331,100,1,1913,1,"male",941,3865,413,1,7,0,7,1,0
1298332,19,10,1994,3,"male",148,165,150,0,0,0,0,0,0
1298333,26,11,1987,6,"male",106,0,0,1,0,0,0,1,0
1298343,40,25,1973,12,"male",231,48,39,21,9,21,0,0,9
1298356,14,3,1999,10,"female",472,381,200,156,73,156,46,0,27
1298387,22,10,1991,6,"female",214,11,6,0,0,0,0,0,0
1298392,25,28,1988,11,"male",243,51,12,3,2,3,2,0,0
1298395,62,23,1951,4,"female",820,22,6,62,3,0,1,62,2
1298435,17,27,1996,7,"male",488,54,23,2,0,2,0,0,0
1298441,27,12,1986,4,"male",93,66,38,7,14,0,6,7,8
1298490,16,28,1997,1,"female",721,303,204,1,0,1,0,0,0
1298491,37,25,1976,9,"female",170,247,178,917,2467,917,2065,0,402
1298501,16,15,1997,6,"female",14,99,54,67,80,62,80,5,0
1298516,48,10,1965,7,"male",177,79,49,0,0,0,0,0,0
1298517,25,18,1988,4,"male",186,2,1,12,4,12,0,0,4
1298524,20,1,1993,9,"female",280,1,0,1,2,0,0,1,2
1298578,31,30,1982,10,"female",590,12,3,12,10,12,8,0,2
1298586,27,12,1986,12,"male",549,329,173,9,9,9,5,0,4
1298602,19,27,1994,8,"male",135,516,448,68,124,68,116,0,8
1298604,14,9,1999,1,"male",13,38,34,4,3,0,0,4,3
1298611,33,10,1980,1,"male",473,63,46,2,4,0,4,2,0
1298622,26,6,1987,7,"female",670,410,176,1080,660,1077,471,3,189
1298656,44,2,1969,3,"male",509,93,75,153,7,153,7,0,0
1298668,73,3,1940,6,"male",1493,19,5,460,77,0,18,460,59
1298669,50,10,1963,9,"female",274,5,3,1,0,1,0,0,0
1298705,21,23,1992,6,"male",409,55,45,84,32,0,13,84,19
1298716,19,21,1994,5,"female",389,242,150,1848,1891,1215,1104,633,787
1298733,57,21,1956,2,"female",542,553,158,19,513,19,468,0,45
1298753,36,7,1977,10,"female",64,31,22,212,14,212,10,0,4
1298804,29,26,1984,12,"female",356,149,88,213,360,213,253,0,107
1298807,63,30,1950,1,"female",69,37,32,10,1,10,1,0,0
1298817,23,2,1990,12,"female",641,132,98,15,0,15,0,0,0
1298835,54,13,1959,11,"female",221,61,38,7,0,7,0,0,0
1298853,24,10,1989,10,"female",285,106,55,63,72,63,24,0,48
1298854,45,20,1968,9,"male",1749,36,6,5,0,5,0,0,0
1298869,22,13,1991,10,"male",299,111,63,4,5,4,5,0,0
1298896,33,9,1980,10,"male",187,137,92,1,1,1,1,0,0
1298898,17,14,1996,9,"male",378,112,59,1,13,0,3,1,10
1298937,108,21,1905,9,"male",845,248,136,7,1,7,1,0,0
1298945,18,6,1995,10,"female",366,566,142,500,422,238,80,262,342
1298971,62,17,1951,3,"male",406,27,6,2,1,1,1,1,0
1299041,23,8,1990,11,"male",523,425,148,99,490,96,372,3,118
1299046,29,5,1984,1,"male",471,58,41,220,1,220,1,0,0
1299058,29,26,1984,1,"female",236,28,8,0,0,0,0,0,0
1299135,15,5,1998,6,"male",554,285,224,35,52,0,15,35,37
1299147,16,2,1997,6,"male",477,424,310,2,1,2,1,0,0
1299180,36,23,1977,6,"female",417,126,85,81,50,81,35,0,15
1299182,22,1,1991,8,"female",408,197,90,0,1,0,1,0,0
1299187,16,13,1997,8,"female",569,756,271,74,406,74,321,0,85
1299188,39,19,1974,3,"female",728,20,11,23,1,23,1,0,0
1299253,20,12,1993,4,"male",338,2,2,6,1,0,0,6,1
1299275,51,1,1962,7,"female",458,3,2,0,0,0,0,0,0
1299284,19,30,1994,12,"female",4,4,4,0,0,0,0,0,0
1299297,41,28,1972,4,"female",614,306,221,185,140,185,113,0,27
1299304,93,2,1920,7,"female",2266,1064,445,104,12,24,9,80,3
1299309,18,1,1995,4,"female",159,909,373,117,206,82,178,35,28
1299323,72,18,1941,1,"female",21,14,13,10,0,0,0,10,0
1299359,48,20,1965,5,"female",498,282,257,610,139,610,105,0,34
1299408,21,10,1992,4,"male",285,91,48,0,2,0,1,0,1
1299410,49,22,1964,7,"female",319,53,24,1,37,1,20,0,17
1299436,53,24,1960,7,"male",234,90,76,7,22,7,15,0,7
1299446,25,1,1988,1,"male",82,122,60,0,2,0,0,0,2
1299454,18,12,1995,11,"male",274,61,42,0,0,0,0,0,0
1299479,20,11,1993,7,"male",268,13,8,40,24,39,15,1,9
1299487,20,12,1993,2,"male",266,156,114,167,2,167,2,0,0
1299538,22,22,1991,7,"male",419,710,656,685,133,403,74,282,59
1299547,108,14,1905,6,"male",1359,599,129,27,37,27,32,0,5
1299567,65,7,1948,3,"male",242,90,61,3,23,3,14,0,9
1299581,25,14,1988,11,"male",28,12,12,13,8,13,7,0,1
1299582,28,3,1985,2,"male",985,22,2,0,1,0,1,0,0
1299602,40,19,1973,11,"male",502,52,33,5,0,5,0,0,0
1299609,18,11,1995,11,"male",260,586,572,0,0,0,0,0,0
1299611,17,26,1996,12,"male",185,15,13,0,0,0,0,0,0
1299636,61,5,1952,1,"female",752,3,0,0,0,0,0,0,0
1299670,108,14,1905,2,"male",203,104,71,4,4,4,4,0,0
1299692,17,28,1996,2,"female",485,29,1,0,4,0,2,0,2
1299693,35,10,1978,10,"female",113,50,37,31,63,31,48,0,15
1299696,23,2,1990,1,"male",279,14,2,0,2,0,0,0,2
1299710,14,26,1999,2,"female",519,333,212,15,97,0,29,15,68
1299732,54,8,1959,11,"male",238,217,153,12,4,2,1,10,3
1299735,23,12,1990,3,"male",52,0,0,0,0,0,0,0,0
1299738,61,4,1952,6,"female",730,34,10,75,10,75,10,0,0
1299759,26,23,1987,3,"female",522,123,67,80,78,80,62,0,16
1299770,70,31,1943,7,"female",10,20,9,3,19,3,19,0,0
1299787,47,29,1966,3,"female",1481,244,91,49,93,19,35,30,58
1299823,25,23,1988,1,"male",189,0,0,0,0,0,0,0,0
1299837,110,14,1903,12,"female",2222,241,211,43,24,43,21,0,3
1299849,29,16,1984,10,"female",168,119,87,249,711,249,500,0,211
1299850,86,27,1927,9,"female",1750,84,21,3,16,0,13,3,3
1299861,18,28,1995,6,"female",119,8,7,0,0,0,0,0,0
1299865,19,1,1994,11,"female",303,186,85,952,363,305,175,647,188
1299869,33,29,1980,11,"male",60,6,5,15,1,0,0,15,1
1299870,17,22,1996,2,"male",331,43,40,0,1,0,0,0,1
1299892,27,12,1986,5,"male",434,74,46,16,4,16,4,0,0
1299907,43,2,1970,2,"female",184,11,6,24,0,0,0,24,0
1299941,20,2,1993,8,"male",75,17,16,0,1,0,1,0,0
1299948,81,23,1932,11,"female",1560,37,20,0,26,0,1,0,25
1299971,62,30,1951,1,"female",478,36,28,0,0,0,0,0,0
1299999,14,19,1999,12,"female",6,18,18,0,0,0,0,0,0
1300012,47,9,1966,8,"male",505,33,7,86,23,86,16,0,7
1300067,22,18,1991,8,"male",674,53,41,0,0,0,0,0,0
1300121,101,12,1912,12,"male",730,478,367,6,16,6,13,0,3
1300176,36,11,1977,1,"female",651,21,7,1,1,1,0,0,1
1300183,34,31,1979,12,"male",98,3,3,0,0,0,0,0,0
1300190,26,15,1987,7,"male",423,208,175,22,14,22,14,0,0
1300219,53,24,1960,10,"male",619,136,95,1,13,0,1,1,12
1300249,28,12,1985,5,"male",542,375,243,16,24,16,23,0,1
1300274,18,9,1995,5,"female",462,701,71,95,560,93,370,2,190
1300275,21,26,1992,1,"male",512,25,10,47,5,47,5,0,0
1300293,86,14,1927,8,"female",939,3387,662,12,1,8,1,4,0
1300295,15,17,1998,1,"female",292,132,58,25,1,25,1,0,0
1300334,81,10,1932,6,"female",452,29,23,2,1,0,0,2,1
1300342,60,12,1953,5,"female",417,16,16,19,3,0,0,19,3
1300361,31,21,1982,11,"male",925,175,104,7,1,0,0,7,1
1300401,50,23,1963,2,"female",455,37,26,996,233,232,59,764,174
1300411,17,29,1996,7,"male",181,101,72,11,0,10,0,1,0
1300438,25,20,1988,8,"male",564,359,245,38,14,38,12,0,2
1300499,22,26,1991,11,"female",278,215,125,1295,418,540,182,755,236
1300522,16,17,1997,7,"male",138,143,125,303,52,303,51,0,1
1300524,23,1,1990,7,"male",194,18,16,0,0,0,0,0,0
1300576,33,20,1980,4,"female",193,95,50,202,52,30,23,172,29
1300605,108,26,1905,8,"male",883,248,153,20,10,20,5,0,5
1300611,72,1,1941,3,"male",991,131,117,5,2,0,1,5,1
1300612,24,18,1989,8,"female",517,162,47,250,200,250,100,0,100
1300616,32,9,1981,5,"female",487,276,159,938,946,938,856,0,90
1300651,25,11,1988,12,"male",185,125,101,61,46,61,44,0,2
1300713,38,29,1975,7,"male",162,60,58,33,1,33,1,0,0
1300742,51,8,1962,6,"female",1620,265,147,305,125,31,32,274,93
1300769,52,20,1961,2,"female",375,43,34,760,87,408,34,352,53
1300794,38,23,1975,5,"male",388,125,92,18,0,15,0,3,0
1300844,37,9,1976,2,"male",398,63,49,0,0,0,0,0,0
1300847,20,3,1993,3,"male",1200,18,2,1,0,1,0,0,0
1300857,14,1,1999,1,"male",122,243,98,4,31,4,22,0,9
1300865,49,14,1964,1,"male",816,35,11,3,1,2,1,1,0
1300910,53,22,1960,12,"male",639,234,146,8,3,8,3,0,0
1300914,33,23,1980,11,"female",310,339,283,69,116,69,106,0,10
1300924,37,17,1976,11,"male",91,2,1,26,4,0,0,26,4
1300926,39,18,1974,11,"male",269,7,5,5,0,5,0,0,0
1300943,13,14,2000,4,"female",173,8,7,0,0,0,0,0,0
1300958,31,25,1982,2,"male",353,3,1,0,0,0,0,0,0
1300968,16,6,1997,6,"male",19,46,40,73,29,73,29,0,0
1300973,27,28,1986,5,"male",346,28,25,7,1,7,1,0,0
1301015,77,26,1936,8,"male",1658,284,82,0,18,0,3,0,15
1301075,33,6,1980,6,"male",497,11,11,10,3,10,2,0,1
1301079,17,7,1996,2,"female",107,109,48,1,41,1,39,0,2
1301090,17,20,1996,3,"female",341,203,100,18,1,0,1,18,0
1301097,65,23,1948,5,"male",272,65,52,159,82,157,32,2,50
1301106,47,5,1966,3,"male",293,17,6,3,0,3,0,0,0
1301165,29,23,1984,9,"male",456,176,147,0,0,0,0,0,0
1301188,53,14,1960,5,"male",443,88,27,12,30,12,13,0,17
1301225,21,1,1992,10,"male",1184,18,3,1,3,0,2,1,1
1301252,26,12,1987,10,"male",270,511,94,150,576,65,433,85,143
1301275,33,9,1980,12,"male",1729,118,30,8,7,8,5,0,2
1301280,31,18,1982,9,"male",832,34,21,5,2,0,1,5,1
1301284,25,28,1988,4,"female",397,488,441,24,22,24,17,0,5
1301291,74,12,1939,2,"male",2188,115,31,30,11,6,5,24,6
1301292,18,1,1995,1,"male",411,216,153,0,0,0,0,0,0
1301296,70,6,1943,11,"female",1054,82,42,1,0,0,0,1,0
1301319,27,3,1986,9,"female",209,6,2,1,23,1,4,0,19
1301330,24,9,1989,6,"male",350,319,204,5,10,5,6,0,4
1301349,14,10,1999,2,"female",497,259,219,28,0,13,0,15,0
1301354,21,28,1992,10,"male",651,16,11,1,1,1,1,0,0
1301393,54,14,1959,10,"female",75,25,20,36,15,1,9,35,6
1301427,47,14,1966,4,"female",541,383,207,775,61,775,52,0,9
1301429,58,27,1955,11,"male",70,12,9,0,3,0,0,0,3
1301438,32,9,1981,5,"male",151,26,24,28,28,28,18,0,10
1301443,33,15,1980,5,"male",126,28,14,2,3,2,3,0,0
1301457,21,15,1992,3,"male",404,54,42,1,1,0,0,1,1
1301459,16,2,1997,8,"male",215,26,20,15,1,15,1,0,0
1301474,19,1,1994,1,"male",750,1036,417,3,4,1,4,2,0
1301501,38,25,1975,9,"male",627,68,38,0,0,0,0,0,0
1301511,25,3,1988,9,"male",477,88,57,3,14,1,1,2,13
1301520,25,30,1988,10,"male",102,32,9,1,3,1,3,0,0
1301550,23,10,1990,4,"female",220,51,28,30,43,30,43,0,0
1301563,22,21,1991,7,"female",1588,777,461,277,339,167,259,110,80
1301567,26,14,1987,1,"male",150,3,2,0,0,0,0,0,0
1301588,69,8,1944,7,"male",1243,64,29,23,5,0,2,23,3
1301598,101,23,1912,5,"female",1694,1496,682,28,52,15,15,13,37
1301600,20,19,1993,1,"male",429,27,13,28,8,28,6,0,2
1301601,17,28,1996,3,"female",278,75,72,0,0,0,0,0,0
1301704,15,16,1998,5,"male",77,21,17,0,1,0,0,0,1
1301738,34,20,1979,4,"male",1419,98,37,6,0,6,0,0,0
1301743,63,4,1950,5,"male",9,9,6,0,0,0,0,0,0
1301788,43,27,1970,3,"male",856,514,149,1,1,0,0,1,1
1301824,23,1,1990,1,"male",87,32,29,0,6,0,6,0,0
1301845,33,28,1980,10,"male",91,17,4,2,0,2,0,0,0
1301873,20,28,1993,12,"male",267,291,272,0,4,0,4,0,0
1301922,32,12,1981,5,"female",209,2,1,0,0,0,0,0,0
1301924,65,28,1948,10,"male",1880,566,394,622,119,235,29,387,90
1301926,19,21,1994,12,"male",13,115,107,117,86,93,43,24,43
1301929,15,29,1998,10,"male",223,406,300,55,42,54,34,1,8
1301951,38,16,1975,11,"male",605,25,6,0,0,0,0,0,0
1301953,66,7,1947,4,"female",1988,47,8,37,8,35,5,2,3
1301970,64,31,1949,5,"male",1108,11,3,8,6,6,2,2,4
1301980,108,29,1905,4,"female",782,343,203,4,1,4,1,0,0
1301981,39,20,1974,6,"male",380,94,69,390,257,388,172,2,85
1301999,34,22,1979,4,"male",325,22,17,5,2,0,0,5,2
1302005,67,1,1946,6,"male",779,15,3,3,2,0,0,3,2
1302032,40,20,1973,8,"female",558,67,36,5,0,5,0,0,0
1302050,52,15,1961,5,"female",922,145,67,394,239,0,134,394,105
1302111,15,7,1998,4,"male",202,58,13,0,1,0,1,0,0
1302123,45,3,1968,2,"female",595,17,8,17,3,17,3,0,0
1302125,33,22,1980,9,"female",99,93,42,271,290,271,204,0,86
1302131,38,25,1975,5,"male",100,2,2,0,26,0,22,0,4
1302139,14,8,1999,6,"female",264,238,117,80,125,14,36,66,89
1302149,52,6,1961,9,"female",421,125,63,157,65,157,62,0,3
1302174,58,27,1955,1,"male",336,68,47,1,2,0,2,1,0
1302188,43,16,1970,3,"male",999,31,11,5,0,1,0,4,0
1302230,71,12,1942,9,"female",1173,70,32,2,6,0,2,2,4
1302234,19,16,1994,7,"male",288,131,77,15,15,8,13,7,2
1302245,14,2,1999,12,"female",242,73,47,40,71,40,23,0,48
1302253,50,21,1963,4,"female",1372,1258,564,326,566,15,245,311,321
1302274,34,26,1979,1,"male",379,71,48,89,76,89,75,0,1
1302292,33,12,1980,12,"male",483,57,47,16,10,16,7,0,3
1302293,17,28,1996,3,"male",545,266,40,24,0,0,0,24,0
1302313,37,25,1976,4,"male",413,80,53,71,25,30,15,41,10
1302319,27,13,1986,3,"female",842,290,109,246,252,172,151,74,101
1302321,14,3,1999,10,"male",269,73,59,1,0,0,0,1,0
1302329,20,24,1993,12,"male",138,27,22,0,0,0,0,0,0
1302347,34,3,1979,9,"female",368,448,323,224,984,210,778,14,206
1302357,31,12,1982,5,"female",468,116,52,5683,174,5471,97,212,77
1302378,15,29,1998,9,"female",138,104,51,333,148,333,132,0,16
1302382,88,25,1925,8,"male",674,668,565,204,179,204,129,0,50
1302391,18,27,1995,5,"male",558,492,316,43,68,26,61,17,7
1302403,21,1,1992,1,"male",193,19,18,0,0,0,0,0,0
1302407,31,14,1982,4,"male",187,96,68,22,36,14,23,8,13
1302419,93,28,1920,2,"male",566,179,140,23,15,0,2,23,13
1302451,16,8,1997,1,"female",215,19,8,120,99,120,71,0,28
1302485,14,31,1999,12,"male",278,102,54,1,0,1,0,0,0
1302513,19,25,1994,9,"female",3,18,18,58,12,58,11,0,1
1302527,27,10,1986,8,"female",252,368,44,14,82,14,28,0,54
1302532,23,21,1990,9,"female",465,858,648,500,658,104,329,396,329
1302535,105,29,1908,2,"male",1120,150,82,3,9,0,2,3,7
1302539,28,18,1985,4,"male",631,30,25,17,0,0,0,17,0
1302540,24,24,1989,11,"female",470,154,49,4,7,4,2,0,5
1302566,23,7,1990,12,"male",463,178,125,301,31,285,21,16,10
1302598,21,19,1992,1,"male",363,109,54,0,0,0,0,0,0
1302609,61,4,1952,7,"female",345,108,44,6,10,6,10,0,0
1302616,15,16,1998,3,"female",414,488,399,117,105,117,84,0,21
1302645,15,29,1998,8,"female",161,262,147,1,0,0,0,1,0
1302658,31,9,1982,2,"female",43,36,32,1,1,1,1,0,0
1302693,37,15,1976,2,"male",630,133,103,25,23,25,22,0,1
1302715,32,28,1981,2,"male",227,29,26,0,0,0,0,0,0
1302746,47,1,1966,9,"male",397,194,97,19,0,0,0,19,0
1302760,23,23,1990,3,"female",2016,467,266,654,425,641,407,13,18
1302765,49,10,1964,10,"female",362,42,26,290,53,276,37,14,16
1302768,44,11,1969,11,"female",803,59,30,274,23,93,12,181,11
1302775,22,12,1991,12,"male",183,330,276,12,33,11,29,1,4
1302776,42,4,1971,12,"female",361,124,102,62,83,56,44,6,39
1302790,15,14,1998,4,"male",32,2,2,0,0,0,0,0,0
1302793,25,2,1988,9,"male",955,471,326,647,852,647,757,0,95
1302815,24,15,1989,4,"male",371,555,424,4,4,4,3,0,1
1302823,20,25,1993,11,"female",33,21,13,45,17,45,12,0,5
1302837,16,15,1997,3,"male",259,9,5,0,1,0,0,0,1
1302860,57,24,1956,5,"male",1336,98,83,1,15,1,6,0,9
1302865,22,7,1991,10,"female",277,250,7,0,9,0,9,0,0
1302898,36,15,1977,11,"female",723,62,44,0,4,0,0,0,4
1302908,65,11,1948,2,"female",541,30,19,0,0,0,0,0,0
1302914,26,17,1987,6,"female",158,79,7,0,2,0,0,0,2
1302926,18,16,1995,2,"male",371,200,128,146,115,135,93,11,22
1302969,34,2,1979,2,"male",420,70,51,22,13,22,2,0,11
1302983,19,9,1994,1,"male",520,494,337,0,0,0,0,0,0
1302986,20,2,1993,6,"female",530,403,55,62,248,62,210,0,38
1302993,19,9,1994,2,"female",299,208,159,16,111,16,90,0,21
1303001,23,6,1990,6,"male",473,70,58,0,0,0,0,0,0
1303035,64,17,1949,10,"female",1712,201,128,209,203,82,73,127,130
1303068,60,26,1953,12,"female",1305,23,10,50,28,50,14,0,14
1303081,38,4,1975,9,"female",248,22,16,10,45,10,17,0,28
1303101,17,17,1996,8,"male",274,275,142,141,1,14,0,127,1
1303106,21,10,1992,12,"male",336,33,20,0,26,0,5,0,21
1303116,26,29,1987,7,"male",223,45,21,41,2,41,1,0,1
1303126,15,15,1998,3,"male",383,125,40,54,65,54,27,0,38
1303141,27,1,1986,2,"male",204,61,42,145,243,145,105,0,138
1303146,31,25,1982,2,"female",466,26,5,18,10,18,10,0,0
1303162,24,12,1989,1,"female",91,51,30,7,5,7,3,0,2
1303174,53,14,1960,12,"male",1529,55,33,1,21,1,17,0,4
1303180,27,24,1986,6,"female",544,3,1,17,5,17,5,0,0
1303193,16,13,1997,7,"male",519,91,76,0,0,0,0,0,0
1303272,19,1,1994,1,"male",334,75,60,0,0,0,0,0,0
1303301,26,1,1987,1,"female",368,105,60,0,3,0,2,0,1
1303302,23,25,1990,8,"female",113,14,11,2,0,2,0,0,0
1303321,44,15,1969,5,"male",308,24,24,0,0,0,0,0,0
1303325,14,20,1999,9,"male",237,147,119,0,3,0,0,0,3
1303334,31,24,1982,11,"female",353,0,0,0,0,0,0,0,0
1303346,16,16,1997,2,"male",264,0,0,0,0,0,0,0,0
1303356,15,9,1998,3,"female",13,195,165,452,237,451,221,1,16
1303373,53,15,1960,12,"male",18,17,17,1,0,0,0,1,0
1303397,34,6,1979,6,"male",976,1,1,0,0,0,0,0,0
1303423,20,2,1993,8,"male",281,17,10,29,3,29,3,0,0
1303444,43,31,1970,7,"male",686,23,8,0,3,0,2,0,1
1303453,25,15,1988,1,"female",214,31,17,0,0,0,0,0,0
1303457,33,21,1980,1,"female",590,11,7,21,7,21,1,0,6
1303460,36,1,1977,1,"male",124,3,3,0,0,0,0,0,0
1303504,40,25,1973,2,"female",802,99,42,1,0,0,0,1,0
1303536,46,14,1967,1,"male",507,25,12,52,23,26,5,26,18
1303569,16,22,1997,1,"female",112,209,158,59,7,59,3,0,4
1303577,23,2,1990,3,"male",140,91,58,3,13,3,2,0,11
1303635,25,28,1988,9,"male",558,16,9,4,13,1,9,3,4
1303666,53,21,1960,5,"female",1816,1837,1041,282,195,0,41,282,154
1303672,24,9,1989,6,"female",208,263,144,10,43,10,29,0,14
1303673,15,17,1998,8,"male",112,19,15,0,0,0,0,0,0
1303722,29,20,1984,2,"male",237,9,6,16,5,16,3,0,2
1303736,18,26,1995,6,"male",756,229,88,198,275,127,253,71,22
1303747,54,16,1959,7,"male",109,14,5,0,1,0,1,0,0
1303752,56,6,1957,2,"female",340,23,13,0,2,0,1,0,1
1303756,15,12,1998,10,"female",418,803,498,26,686,26,484,0,202
1303764,25,3,1988,9,"female",102,306,285,905,724,876,620,29,104
1303784,40,24,1973,3,"male",769,30,18,8,3,8,3,0,0
1303803,16,15,1997,6,"male",240,68,57,2,1,1,1,1,0
1303816,31,8,1982,5,"male",818,45,13,1,6,0,6,1,0
1303857,21,26,1992,11,"male",53,7,5,0,0,0,0,0,0
1303874,39,24,1974,8,"female",587,114,79,94,109,94,46,0,63
1303878,33,9,1980,11,"male",580,6,2,3,0,0,0,3,0
1303887,57,11,1956,10,"female",531,37,20,483,56,483,35,0,21
1303892,28,8,1985,2,"male",525,2,1,0,0,0,0,0,0
1303901,22,14,1991,10,"male",488,155,88,69,68,69,66,0,2
1303943,51,30,1962,4,"female",267,18,10,3,2,0,0,3,2
1303945,23,16,1990,1,"male",502,170,132,0,0,0,0,0,0
1303978,27,2,1986,9,"female",368,81,32,52,83,52,39,0,44
1303982,95,15,1918,12,"male",1249,405,292,1299,324,3,60,1296,264
1303996,20,11,1993,7,"female",526,4665,687,3360,7446,2911,7013,449,433
1304020,46,20,1967,3,"male",226,1,0,132,34,0,3,132,31
1304035,25,1,1988,9,"male",383,210,146,301,217,250,132,51,85
1304051,23,5,1990,5,"female",823,33,26,0,0,0,0,0,0
1304069,37,20,1976,5,"male",295,30,24,4,13,4,4,0,9
1304070,18,7,1995,12,"male",39,37,26,6,0,2,0,4,0
1304072,23,1,1990,1,"male",406,169,135,71,42,57,24,14,18
1304082,33,5,1980,5,"male",389,15,14,0,9,0,8,0,1
1304088,16,27,1997,11,"female",571,44,26,45,167,19,34,26,133
1304109,18,4,1995,2,"male",300,442,396,2,0,2,0,0,0
1304121,16,1,1997,1,"male",368,195,160,0,36,0,4,0,32
1304162,34,2,1979,10,"male",400,59,34,0,1,0,1,0,0
1304177,22,14,1991,3,"male",191,87,64,774,459,774,418,0,41
1304193,19,26,1994,1,"female",483,252,143,21,211,21,198,0,13
1304210,18,28,1995,12,"female",693,1067,596,132,340,132,272,0,68
1304234,28,23,1985,1,"male",896,66,41,0,0,0,0,0,0
1304238,18,30,1995,8,"male",492,285,153,2,11,2,5,0,6
1304252,16,20,1997,8,"male",90,70,45,5,4,2,0,3,4
1304288,45,19,1968,10,"male",384,62,44,157,14,157,11,0,3
1304300,108,19,1905,3,"male",1338,284,154,55,1,0,1,55,0
1304326,93,11,1920,5,"female",18,20,17,2,6,0,5,2,1
1304338,52,27,1961,4,"male",1027,149,64,34,20,34,7,0,13
1304353,23,1,1990,1,"male",304,71,57,0,10,0,10,0,0
1304360,20,22,1993,1,"female",773,411,136,58,79,58,72,0,7
1304389,24,20,1989,9,"male",372,176,152,38,6,38,4,0,2
1304392,108,1,1905,1,"male",251,33,30,60,1,60,1,0,0
1304437,33,4,1980,8,"male",23,13,10,1,8,1,4,0,4
1304446,20,30,1993,12,"female",669,3056,2184,0,578,0,515,0,63
1304480,20,17,1993,4,"male",23,70,61,78,46,78,39,0,7
1304533,62,10,1951,5,"female",1593,128,82,128,93,7,40,121,53
1304541,25,13,1988,11,"female",81,16,14,0,6,0,6,0,0
1304542,43,17,1970,7,"male",448,86,63,1,32,0,7,1,25
1304562,84,16,1929,7,"male",1337,78,27,13,13,0,9,13,4
1304578,34,24,1979,8,"male",275,41,18,0,0,0,0,0,0
1304645,69,15,1944,9,"female",1429,43,26,1343,63,0,34,1343,29
1304651,25,25,1988,2,"male",525,134,62,1,4,1,4,0,0
1304658,41,11,1972,5,"female",468,17,13,83,48,81,47,2,1
1304674,66,14,1947,5,"female",1665,165,73,15,7,9,2,6,5
1304678,64,29,1949,12,"male",1705,62,25,10,17,0,11,10,6
1304695,23,13,1990,5,"female",91,30,19,902,857,902,473,0,384
1304729,69,21,1944,10,"male",155,85,62,0,0,0,0,0,0
1304741,18,3,1995,10,"male",117,35,25,0,0,0,0,0,0
1304762,108,9,1905,6,"female",1264,186,24,97,119,13,42,84,77
1304792,63,4,1950,3,"female",973,102,67,142,106,109,61,33,45
1304814,25,5,1988,2,"male",434,62,38,3,2,3,2,0,0
1304829,67,19,1946,11,"male",1573,61,37,4,0,4,0,0,0
1304842,78,18,1935,4,"female",1199,16,14,27,0,0,0,27,0
1304851,87,25,1926,10,"male",807,194,92,31,101,2,44,29,57
1304856,18,23,1995,7,"male",527,198,51,90,260,90,259,0,1
1304860,24,1,1989,8,"male",272,13,11,0,0,0,0,0,0
1304894,70,30,1943,5,"male",730,89,44,0,0,0,0,0,0
1304900,14,28,1999,7,"male",12,0,0,0,0,0,0,0,0
1304910,21,7,1992,7,"female",609,385,315,38,116,38,87,0,29
1304920,18,29,1995,1,"female",352,366,132,951,144,868,133,83,11
1304933,16,4,1997,8,"female",433,34,17,4,11,4,10,0,1
1304968,20,8,1993,4,"male",146,47,45,47,57,47,27,0,30
1304976,27,6,1986,1,"male",821,336,251,0,3,0,2,0,1
1304979,35,27,1978,9,"female",380,15,10,2,1,2,0,0,1
1304984,39,20,1974,5,"male",141,0,0,0,0,0,0,0,0
1305026,29,25,1984,1,"male",133,2,1,0,10,0,8,0,2
1305027,33,5,1980,6,"female",166,491,260,48,96,0,61,48,35
1305083,18,11,1995,5,"female",442,1203,593,1893,4212,1836,3457,57,755
1305102,108,22,1905,3,"male",1442,880,448,95,74,78,47,17,27
1305109,57,25,1956,3,"female",668,92,35,1,44,0,35,1,9
1305130,75,29,1938,1,"female",208,19,14,0,0,0,0,0,0
1305132,23,4,1990,4,"male",947,166,89,75,0,68,0,7,0
1305141,103,8,1910,12,"male",1949,534,245,11,41,0,9,11,32
1305156,71,5,1942,11,"female",28,151,140,20,58,0,2,20,56
1305207,23,19,1990,10,"male",120,150,115,87,4,87,4,0,0
1305239,18,15,1995,1,"female",126,39,20,0,0,0,0,0,0
1305264,30,16,1983,11,"male",1222,175,70,3,9,3,9,0,0
1305293,42,5,1971,3,"female",282,37,30,829,117,829,73,0,44
1305301,21,26,1992,2,"female",472,215,66,117,154,101,99,16,55
1305302,39,2,1974,1,"male",79,8,7,20,12,0,7,20,5
1305308,14,4,1999,6,"female",415,357,186,1604,389,1575,242,29,147
1305309,18,22,1995,4,"female",71,8,7,799,1162,456,373,343,789
1305318,18,25,1995,6,"male",414,119,109,2,0,2,0,0,0
1305322,100,23,1913,4,"male",1969,207,119,42,6,36,4,6,2
1305401,56,20,1957,9,"male",155,20,20,3,0,3,0,0,0
1305403,32,20,1981,3,"male",142,84,69,0,0,0,0,0,0
1305406,21,14,1992,10,"female",375,508,37,24,334,24,269,0,65
1305409,28,5,1985,3,"male",508,25,14,1,1,1,1,0,0
1305415,31,1,1982,1,"female",310,2,2,1,1,1,0,0,1
1305518,33,24,1980,8,"female",177,64,8,0,1,0,0,0,1
1305537,57,10,1956,6,"female",1036,32,26,36,8,36,2,0,6
1305554,19,8,1994,12,"male",610,129,88,4,2,0,1,4,1
1305564,31,6,1982,4,"female",1563,454,282,88,275,40,227,48,48
1305595,17,4,1996,10,"male",768,423,193,41,44,41,43,0,1
1305596,35,26,1978,8,"male",340,126,86,33,46,0,22,33,24
1305632,29,21,1984,9,"female",554,83,32,45,117,9,58,36,59
1305633,30,11,1983,3,"male",881,215,101,7,34,3,16,4,18
1305636,20,25,1993,7,"male",54,10,10,85,1,0,0,85,1
1305645,38,18,1975,1,"female",320,75,36,28,8,28,3,0,5
1305662,57,12,1956,5,"male",345,4,3,0,0,0,0,0,0
1305689,29,17,1984,7,"male",331,47,39,1,1,1,1,0,0
1305694,15,18,1998,3,"male",825,445,316,40,13,20,5,20,8
1305710,16,10,1997,3,"male",427,257,201,7,1,7,1,0,0
1305756,49,14,1964,8,NA,2175,73,26,4,107,0,54,4,53
1305762,22,19,1991,3,"female",509,122,57,52,34,51,30,1,4
1305769,72,25,1941,1,"female",563,50,30,0,0,0,0,0,0
1305774,16,20,1997,9,"female",256,566,388,721,998,538,524,183,474
1305815,33,6,1980,5,"male",368,35,19,0,0,0,0,0,0
1305835,69,21,1944,10,"female",1317,9,4,0,0,0,0,0,0
1305844,20,4,1993,4,"male",444,84,69,0,0,0,0,0,0
1305848,20,28,1993,7,"female",486,56,6,4,0,4,0,0,0
1305857,25,17,1988,3,"male",60,8,8,0,0,0,0,0,0
1305876,20,12,1993,5,"male",45,250,185,123,68,123,64,0,4
1305920,19,27,1994,3,"male",256,75,65,12,22,12,18,0,4
1305923,60,13,1953,5,"male",203,65,53,506,297,0,73,506,224
1305924,23,23,1990,11,"female",542,31,11,1,8,1,5,0,3
1305929,66,10,1947,7,"female",1294,48,6,394,155,394,71,0,84
1305943,54,2,1959,3,"female",1243,173,127,377,72,354,29,23,43
1305961,44,5,1969,7,"male",419,61,45,1,2,1,0,0,2
1305969,68,9,1945,3,"male",243,113,45,0,2,0,2,0,0
1306010,35,31,1978,1,"male",77,2,2,3,0,3,0,0,0
1306050,15,18,1998,8,"male",296,23,21,0,0,0,0,0,0
1306098,60,10,1953,11,"female",860,53,37,1,0,1,0,0,0
1306106,29,1,1984,12,"female",698,28,23,33,23,30,6,3,17
1306109,53,29,1960,6,"female",1837,134,64,804,508,18,129,786,379
1306127,19,16,1994,11,"female",166,61,34,16,46,8,6,8,40
1306131,18,31,1995,7,"male",1022,1001,863,117,289,112,194,5,95
1306209,41,24,1972,12,"male",843,31,11,0,0,0,0,0,0
1306228,26,16,1987,11,"male",441,0,0,0,0,0,0,0,0
1306274,17,23,1996,6,"male",260,122,13,2,0,2,0,0,0
1306288,20,28,1993,9,"male",761,282,154,49,72,17,52,32,20
1306290,18,10,1995,1,"male",788,571,383,86,132,26,80,60,52
1306292,18,15,1995,8,"female",340,176,98,3288,1802,960,623,2328,1179
1306320,16,17,1997,8,"male",654,96,37,15,20,15,13,0,7
1306339,19,23,1994,11,"female",414,362,254,1353,1726,963,1030,390,696
1306364,103,4,1910,4,"male",765,1109,803,0,0,0,0,0,0
1306365,34,26,1979,10,"male",412,60,56,50,128,47,92,3,36
1306377,75,10,1938,10,"female",1048,151,95,205,235,0,142,205,93
1306404,66,21,1947,10,"female",1280,34,13,6,4,0,0,6,4
1306409,17,12,1996,4,"male",314,99,47,10,0,10,0,0,0
1306420,17,15,1996,11,"male",132,83,54,0,1,0,1,0,0
1306424,25,21,1988,8,"female",813,505,213,8,29,8,21,0,8
1306430,25,21,1988,9,"female",28,2,2,0,0,0,0,0,0
1306451,23,2,1990,10,"male",470,1,1,0,0,0,0,0,0
1306452,28,30,1985,9,"female",178,158,123,6,11,6,11,0,0
1306485,44,25,1969,12,"female",208,30,17,0,0,0,0,0,0
1306498,42,15,1971,4,"male",1029,527,341,72,157,72,108,0,49
1306502,53,25,1960,9,"female",114,56,19,49,97,0,12,49,85
1306513,34,17,1979,2,"female",337,87,44,41,140,5,91,36,49
1306520,23,3,1990,6,"male",601,552,404,12,29,7,14,5,15
1306529,33,23,1980,1,"male",342,308,213,0,0,0,0,0,0
1306533,24,25,1989,2,"male",395,42,28,12,19,0,10,12,9
1306539,16,18,1997,8,"female",270,184,70,0,3,0,0,0,3
1306550,21,15,1992,10,"male",749,309,96,178,193,160,134,18,59
1306598,88,29,1925,12,"female",1353,209,64,2,1,2,1,0,0
1306620,20,31,1993,3,"male",501,983,640,6112,1616,6112,1308,0,308
1306624,65,11,1948,10,"male",367,0,0,0,0,0,0,0,0
1306640,14,10,1999,3,"female",101,27,20,94,5,94,4,0,1
1306666,24,28,1989,9,"female",381,10,6,1,0,0,0,1,0
1306696,21,14,1992,11,"male",27,1,1,1,0,1,0,0,0
1306698,44,29,1969,7,"male",68,214,85,1,1,0,0,1,1
1306713,60,16,1953,7,"female",237,66,57,26,19,26,4,0,15
1306722,16,21,1997,3,"female",656,56,17,9,0,9,0,0,0
1306734,63,13,1950,10,"female",1492,34,16,0,5,0,2,0,3
1306764,23,7,1990,8,"male",529,892,744,97,68,97,63,0,5
1306815,46,2,1967,9,"male",206,85,41,0,0,0,0,0,0
1306824,19,5,1994,8,"male",243,456,393,9,0,9,0,0,0
1306829,65,1,1948,1,"male",430,28,22,0,0,0,0,0,0
1306832,14,3,1999,6,"male",74,97,54,2,2,0,0,2,2
1306840,79,3,1934,3,"male",1562,167,58,16,70,0,25,16,45
1306883,51,19,1962,7,"female",1003,25,11,62,284,41,88,21,196
1306884,14,18,1999,3,"male",19,295,256,8,8,3,4,5,4
1306905,18,6,1995,10,"male",55,2,1,4,3,4,3,0,0
1306934,14,13,1999,5,"male",100,33,26,2,9,2,8,0,1
1306942,36,4,1977,5,"male",339,178,77,375,310,375,278,0,32
1306968,29,25,1984,2,"male",422,16,2,0,0,0,0,0,0
1306993,73,13,1940,2,"male",779,257,117,10,3,0,1,10,2
1307021,24,11,1989,11,"male",718,228,187,0,0,0,0,0,0
1307078,47,22,1966,7,"female",251,71,58,47,26,47,21,0,5
1307125,66,17,1947,8,"male",1302,39,26,159,70,109,33,50,37
1307130,30,14,1983,12,"male",528,38,8,9,1,9,0,0,1
1307143,33,5,1980,5,"female",43,72,43,828,143,828,142,0,1
1307168,47,8,1966,4,"female",160,22,21,2,0,0,0,2,0
1307193,22,29,1991,9,"male",477,171,95,1,30,0,22,1,8
1307196,32,11,1981,5,"male",81,52,33,18,0,18,0,0,0
1307218,23,14,1990,11,"male",568,99,49,7,10,7,10,0,0
1307227,56,2,1957,4,"male",467,65,46,10,2,0,0,10,2
1307237,108,28,1905,4,"female",1176,67,49,46,64,3,32,43,32
1307240,31,14,1982,4,"male",29,26,26,1,4,1,3,0,1
1307252,47,20,1966,9,"male",611,99,46,2,13,2,10,0,3
1307276,17,17,1996,3,"male",207,140,118,1,2,1,2,0,0
1307282,23,26,1990,8,"male",184,84,51,48,44,1,13,47,31
1307294,52,11,1961,11,"male",368,26,13,20,5,20,2,0,3
1307314,20,19,1993,10,"female",242,250,94,1804,1191,1609,774,195,417
1307321,56,16,1957,9,"male",916,40,18,5,4,5,2,0,2
1307335,104,30,1909,12,"male",1474,1576,904,16,94,10,86,6,8
1307344,31,24,1982,6,"male",458,57,45,63,24,63,20,0,4
1307356,23,1,1990,9,"male",736,867,684,7151,5574,2452,1058,4699,4516
1307396,31,13,1982,4,"male",305,115,98,6,25,5,12,1,13
1307419,48,15,1965,3,"male",233,33,7,0,0,0,0,0,0
1307422,56,22,1957,11,"female",264,37,14,97,79,97,63,0,16
1307425,83,23,1930,11,"female",1030,357,135,29,29,29,16,0,13
1307428,63,15,1950,2,"female",1489,135,93,332,382,332,184,0,198
1307439,28,18,1985,6,"male",69,34,29,2,4,2,4,0,0
1307445,30,6,1983,3,"female",217,114,64,100,128,100,25,0,103
1307447,20,10,1993,6,"male",299,204,71,5,3,5,3,0,0
1307469,108,14,1905,11,"male",1463,506,119,77,32,4,18,73,14
1307471,16,3,1997,5,"male",637,1339,910,13,25,13,18,0,7
1307485,23,1,1990,1,"male",102,60,34,38,93,35,28,3,65
1307497,42,30,1971,10,"male",555,66,22,2,2,2,1,0,1
1307503,26,22,1987,7,"male",408,156,102,0,4,0,3,0,1
1307510,108,12,1905,7,"female",1271,406,202,7,4,0,0,7,4
1307524,96,5,1917,8,"female",2076,118,61,31,2,0,2,31,0
1307533,29,3,1984,5,"female",215,174,156,138,146,138,107,0,39
1307550,72,28,1941,3,"female",164,24,15,7,4,0,3,7,1
1307567,66,10,1947,9,"female",286,15,9,0,0,0,0,0,0
1307589,39,4,1974,11,"male",196,32,26,0,0,0,0,0,0
1307597,20,27,1993,7,"male",244,86,44,1,5,1,5,0,0
1307600,78,28,1935,8,"male",430,17,13,2,21,2,14,0,7
1307650,35,24,1978,12,"male",363,71,14,3,7,2,3,1,4
1307672,46,10,1967,7,"female",395,53,9,140,34,0,9,140,25
1307674,60,24,1953,9,"female",659,403,192,11,3,11,3,0,0
1307696,47,7,1966,1,"male",343,33,30,13,1,13,0,0,1
1307732,18,17,1995,8,"male",427,427,364,870,571,444,274,426,297
1307769,22,6,1991,8,"female",10,2,2,0,0,0,0,0,0
1307774,28,17,1985,8,"male",500,137,111,138,119,136,76,2,43
1307823,18,25,1995,3,"female",565,193,139,379,258,379,194,0,64
1307835,67,11,1946,10,"female",1440,92,56,44,5,24,5,20,0
1307837,38,15,1975,8,"male",28,22,19,36,3,36,3,0,0
1307840,28,15,1985,3,"male",100,5,4,18,6,18,0,0,6
1307850,18,23,1995,2,"male",402,614,551,2,3,2,3,0,0
1307859,33,22,1980,12,"male",299,49,33,0,5,0,1,0,4
1307868,47,10,1966,2,"female",804,62,31,4,1,4,1,0,0
1307882,31,15,1982,5,"male",349,2,1,1,0,0,0,1,0
1307886,15,18,1998,12,"female",53,19,13,0,0,0,0,0,0
1307929,16,11,1997,6,"female",340,257,194,24,5,23,3,1,2
1307970,57,23,1956,2,"female",1776,19,7,4,2,0,0,4,2
1307993,32,10,1981,9,"female",271,151,86,160,123,160,74,0,49
1308001,69,16,1944,10,"female",1141,37,25,85,2,0,1,85,1
1308029,28,30,1985,10,"female",478,21,4,0,0,0,0,0,0
1308087,20,2,1993,3,"female",1971,350,237,749,718,734,607,15,111
1308099,32,5,1981,6,"male",370,4,2,0,1,0,1,0,0
1308110,51,25,1962,4,"male",399,8,5,36,2,35,2,1,0
1308116,61,5,1952,8,"female",601,0,0,40,1,0,0,40,1
1308130,20,31,1993,5,"male",659,75,46,48,43,44,26,4,17
1308136,26,3,1987,9,"male",264,21,18,3,0,3,0,0,0
1308144,23,1,1990,1,"male",147,19,17,40,42,32,32,8,10
1308166,59,11,1954,9,"female",119,0,0,0,0,0,0,0,0
1308173,32,13,1981,1,"female",299,87,64,54,21,54,21,0,0
1308235,21,10,1992,12,"female",363,300,124,47,1,3,0,44,1
1308243,40,13,1973,7,"male",576,18,10,1,0,1,0,0,0
1308360,25,17,1988,2,"male",159,50,42,17,4,10,1,7,3
1308387,14,31,1999,1,"male",519,22,10,2,19,2,8,0,11
1308388,28,9,1985,3,"male",153,13,2,15,12,14,12,1,0
1308405,25,9,1988,1,"male",291,137,107,13,4,13,4,0,0
1308414,29,24,1984,8,"female",438,30,13,125,59,125,52,0,7
1308440,30,3,1983,2,"male",176,14,9,0,0,0,0,0,0
1308471,16,13,1997,9,"male",513,128,16,2,0,2,0,0,0
1308474,62,23,1951,1,"male",524,155,97,3,3,3,2,0,1
1308584,59,24,1954,8,"male",321,25,20,0,8,0,7,0,1
1308588,23,16,1990,4,"male",225,459,417,31,20,31,13,0,7
1308613,15,14,1998,7,"male",109,554,485,978,1478,441,646,537,832
1308623,35,16,1978,2,"female",386,34,24,58,0,58,0,0,0
1308629,52,31,1961,7,"female",633,120,72,122,109,23,12,99,97
1308631,50,1,1963,1,"male",149,3,3,1,1,1,1,0,0
1308646,16,4,1997,10,"male",266,189,94,11,24,11,24,0,0
1308727,51,1,1962,7,"female",99,53,22,3,7,3,7,0,0
1308729,108,26,1905,11,"female",1658,300,98,86,28,86,17,0,11
1308762,43,6,1970,3,"female",323,12,12,1,1,1,1,0,0
1308774,20,20,1993,11,"male",619,1842,384,0,2,0,2,0,0
1308801,16,27,1997,12,"male",257,19,14,3,16,0,10,3,6
1308816,16,10,1997,8,"male",197,113,107,1,9,1,6,0,3
1308817,19,12,1994,12,"male",623,89,56,14,7,4,4,10,3
1308861,17,17,1996,7,"male",31,34,22,0,1,0,1,0,0
1308913,26,12,1987,11,"male",1404,176,156,3,7,3,2,0,5
1308915,20,10,1993,1,"male",545,146,95,272,33,2,12,270,21
1308918,65,21,1948,5,"female",858,2490,996,3477,641,3247,472,230,169
1308930,62,10,1951,4,"female",1472,77,39,32,74,30,50,2,24
1308933,108,16,1905,6,"male",1148,689,153,0,0,0,0,0,0
1308970,110,17,1903,6,"female",1244,406,319,1340,468,1300,295,40,173
1308982,42,28,1971,4,"female",573,25,14,45,22,45,19,0,3
1309000,27,21,1986,4,"female",1478,178,130,169,384,166,201,3,183
1309007,34,28,1979,9,"male",318,78,44,33,44,33,41,0,3
1309022,27,15,1986,8,"male",748,76,72,5,11,5,10,0,1
1309025,64,11,1949,6,"female",46,4,4,0,0,0,0,0,0
1309037,59,29,1954,11,"male",786,35,32,0,3,0,0,0,3
1309060,19,9,1994,2,"male",420,82,59,0,1,0,1,0,0
1309074,26,13,1987,7,"female",457,114,47,0,0,0,0,0,0
1309104,23,4,1990,3,"male",410,124,100,88,1,88,1,0,0
1309117,52,14,1961,8,"male",819,3,0,0,0,0,0,0,0
1309124,18,8,1995,8,"female",64,4,3,3,0,3,0,0,0
1309167,23,29,1990,1,"female",450,116,17,12,3,12,2,0,1
1309170,22,19,1991,2,"female",556,34,21,39,3,3,1,36,2
1309217,37,26,1976,1,"male",819,0,0,0,0,0,0,0,0
1309231,28,4,1985,5,"female",407,593,448,25,12,25,12,0,0
1309236,17,18,1996,9,"male",1483,451,133,190,85,162,27,28,58
1309241,73,26,1940,12,"female",1700,23,7,2,1,2,1,0,0
1309248,57,4,1956,5,"female",537,144,109,269,31,0,19,269,12
1309267,18,23,1995,4,"male",969,0,0,0,0,0,0,0,0
1309290,40,7,1973,8,"female",480,36,18,60,50,60,39,0,11
1309299,82,6,1931,7,"male",1538,777,532,2,8,2,8,0,0
1309316,22,22,1991,6,"male",56,183,165,3,13,3,12,0,1
1309329,18,13,1995,4,"male",335,117,112,0,0,0,0,0,0
1309348,20,1,1993,1,"male",483,192,120,389,228,349,73,40,155
1309365,43,16,1970,6,"male",1372,56,21,53,1,43,0,10,1
1309380,108,10,1905,4,"male",1525,4061,2147,1,17,1,13,0,4
1309391,19,12,1994,2,"male",776,297,103,165,78,165,55,0,23
1309398,18,28,1995,4,"male",573,187,119,8,6,8,2,0,4
1309400,18,18,1995,10,"male",497,20,11,27,2,8,2,19,0
1309405,21,2,1992,9,"male",595,178,113,19,1,0,1,19,0
1309414,62,6,1951,5,"female",455,57,34,211,162,0,17,211,145
1309439,52,11,1961,12,"male",156,62,46,1,8,0,3,1,5
1309451,50,1,1963,8,"male",1943,2697,1024,598,296,465,126,133,170
1309470,63,23,1950,2,"female",30,29,26,611,32,0,3,611,29
1309517,18,8,1995,8,"male",49,73,50,3,12,3,9,0,3
1309536,15,8,1998,9,"male",155,204,177,0,0,0,0,0,0
1309606,23,8,1990,1,"female",268,44,29,1,4,1,4,0,0
1309611,18,8,1995,6,"male",208,24,20,2,4,0,2,2,2
1309633,28,24,1985,8,"female",226,40,28,28,8,28,8,0,0
1309677,28,25,1985,6,"male",79,39,38,0,1,0,1,0,0
1309681,18,18,1995,6,"male",351,179,137,1,0,0,0,1,0
1309695,101,2,1912,10,"male",1565,34,10,2,0,0,0,2,0
1309711,61,3,1952,8,"female",1685,17,9,8,1,8,1,0,0
1309715,24,26,1989,3,"female",1132,150,71,2,1,0,1,2,0
1309735,20,18,1993,5,"female",412,54,25,27,8,27,7,0,1
1309754,16,2,1997,3,"male",568,102,43,221,33,211,17,10,16
1309779,50,20,1963,11,"male",414,52,25,1,2,1,2,0,0
1309784,19,4,1994,7,"male",1024,140,56,18,1,18,1,0,0
1309786,31,2,1982,9,"female",1035,81,47,572,499,532,402,40,97
1309795,75,21,1938,5,"female",431,29,19,18,24,0,9,18,15
1309811,63,13,1950,10,"female",874,15,7,0,0,0,0,0,0
1309841,28,13,1985,4,"female",622,35,22,18,26,18,17,0,9
1309844,52,23,1961,6,"male",1244,45,20,3,1,3,1,0,0
1309940,19,19,1994,4,"female",478,81,27,1,0,1,0,0,0
1309962,56,2,1957,1,"female",34,32,27,162,35,0,13,162,22
1309964,43,24,1970,1,"female",395,1,1,0,0,0,0,0,0
1309980,51,16,1962,8,"female",257,24,11,17,2,17,2,0,0
1310006,50,2,1963,2,"female",939,27,14,63,40,54,39,9,1
1310017,59,22,1954,1,"male",648,101,53,6,13,0,4,6,9
1310018,30,11,1983,8,"male",276,140,94,57,63,57,53,0,10
1310034,29,10,1984,10,"male",374,594,497,26,20,26,20,0,0
1310063,37,23,1976,7,"male",73,46,37,0,0,0,0,0,0
1310064,16,10,1997,2,"female",485,422,17,88,192,54,140,34,52
1310075,19,14,1994,9,"female",381,495,394,1,1,0,1,1,0
1310078,74,25,1939,11,"male",1485,881,538,24,8,0,6,24,2
1310095,50,21,1963,4,"female",844,465,342,176,222,171,164,5,58
1310106,89,21,1924,12,"male",1749,141,82,51,0,20,0,31,0
1310108,23,1,1990,7,"male",121,51,32,37,2,37,2,0,0
1310127,69,11,1944,2,"female",2007,81,49,90,140,89,96,1,44
1310153,29,19,1984,7,"female",947,58,21,206,140,43,48,163,92
1310188,19,6,1994,12,"female",275,206,135,810,27,810,25,0,2
1310196,23,2,1990,11,"male",369,101,75,4,4,4,2,0,2
1310205,19,20,1994,7,"female",420,180,62,3,3,2,2,1,1
1310212,51,3,1962,12,"female",618,36,19,61,8,7,7,54,1
1310249,16,17,1997,7,"female",585,1075,661,620,935,620,662,0,273
1310283,62,5,1951,5,"male",1795,8,2,0,0,0,0,0,0
1310306,46,21,1967,9,"male",177,21,3,2,0,0,0,2,0
1310318,20,24,1993,1,"female",557,478,210,1651,1089,263,479,1388,610
1310349,36,1,1977,6,"male",189,71,58,0,0,0,0,0,0
1310351,15,13,1998,5,"male",286,328,166,27,7,27,5,0,2
1310370,77,21,1936,9,"female",203,39,21,7,4,0,0,7,4
1310417,27,18,1986,3,"female",763,108,93,106,37,54,26,52,11
1310421,21,2,1992,2,"male",271,41,26,3,0,3,0,0,0
1310430,29,10,1984,5,"male",416,147,117,217,158,184,77,33,81
1310433,19,7,1994,6,"female",209,276,59,358,921,251,434,107,487
1310452,108,16,1905,1,"female",65,137,125,296,15,235,12,61,3
1310453,61,25,1952,2,"male",558,140,129,12,3,0,0,12,3
1310460,30,25,1983,6,"male",788,53,14,0,2,0,1,0,1
1310466,57,13,1956,6,"female",376,77,60,3,11,0,8,3,3
1310469,23,20,1990,7,"male",480,187,89,36,19,36,13,0,6
1310478,30,4,1983,11,"female",448,148,116,111,9,105,8,6,1
1310519,43,6,1970,2,"female",319,37,19,129,20,3,1,126,19
1310532,31,20,1982,4,"male",185,171,118,33,113,33,79,0,34
1310537,16,10,1997,11,"male",42,530,507,215,339,215,238,0,101
1310563,13,11,2000,1,"female",260,393,322,2,9,2,4,0,5
1310573,21,7,1992,2,"male",811,61,32,6,11,6,9,0,2
1310585,54,25,1959,5,"female",698,67,21,73,24,73,15,0,9
1310598,45,21,1968,5,"male",274,2,1,0,0,0,0,0,0
1310629,16,27,1997,2,"female",1286,425,105,46,17,46,4,0,13
1310646,23,10,1990,1,"male",364,23,17,0,0,0,0,0,0
1310648,27,27,1986,2,"female",511,342,278,2118,967,2071,622,47,345
1310693,22,27,1991,8,"female",733,380,307,24,88,6,70,18,18
1310702,27,1,1986,8,"male",416,53,36,12,1,12,1,0,0
1310770,49,28,1964,10,"male",318,14,2,100,52,97,33,3,19
1310779,53,4,1960,4,"male",205,18,14,2,0,2,0,0,0
1310794,56,25,1957,1,"male",1470,64,28,16,6,16,3,0,3
1310809,26,23,1987,6,"female",789,621,307,422,924,422,794,0,130
1310824,18,23,1995,3,"female",295,765,497,1,102,1,99,0,3
1310827,19,30,1994,4,"male",329,53,42,0,1,0,1,0,0
1310845,21,28,1992,12,"male",540,86,66,12,0,12,0,0,0
1310859,45,12,1968,9,"male",679,24,14,11,10,11,10,0,0
1310860,17,17,1996,12,"male",567,76,45,2,0,0,0,2,0
1310867,16,24,1997,5,"female",182,577,440,194,120,111,99,83,21
1310966,65,21,1948,6,"male",709,75,49,43,6,4,1,39,5
1310982,16,21,1997,12,"male",251,642,248,794,669,794,500,0,169
1310999,42,12,1971,6,"female",494,22,12,65,20,60,6,5,14
1311023,16,1,1997,1,"male",57,44,37,0,0,0,0,0,0
1311048,32,13,1981,5,"male",620,1,1,0,1,0,0,0,1
1311059,62,21,1951,3,"female",1028,117,27,81,10,81,8,0,2
1311139,17,10,1996,8,"male",289,80,73,0,2,0,2,0,0
1311183,58,24,1955,9,"female",1246,1083,392,3098,3864,827,1439,2271,2425
1311203,74,21,1939,5,"female",1689,54,9,160,8,0,3,160,5
1311216,19,19,1994,11,"female",381,832,621,957,1258,836,756,121,502
1311275,46,19,1967,10,"female",558,459,328,219,251,78,163,141,88
1311280,19,3,1994,3,"male",14,0,0,0,0,0,0,0,0
1311295,31,21,1982,6,"female",322,254,88,477,593,477,438,0,155
1311301,38,4,1975,12,"male",341,220,66,0,5,0,0,0,5
1311312,23,2,1990,1,"female",723,317,195,154,233,121,104,33,129
1311316,26,1,1987,1,"male",542,95,85,0,0,0,0,0,0
1311328,52,28,1961,3,"female",786,31,16,180,4,180,3,0,1
1311332,47,4,1966,11,"female",524,214,134,242,112,170,40,72,72
1311349,65,26,1948,12,"female",968,60,4,0,0,0,0,0,0
1311351,26,9,1987,4,"male",869,101,81,4,0,0,0,4,0
1311356,91,21,1922,1,"female",444,85,68,332,37,332,30,0,7
1311365,21,16,1992,12,"female",1305,537,310,2237,469,2208,362,29,107
1311383,104,14,1909,3,"male",1564,63,25,0,0,0,0,0,0
1311397,15,15,1998,5,"female",562,1027,817,7616,6771,7578,4390,38,2381
1311415,19,29,1994,12,"male",546,129,108,0,0,0,0,0,0
1311436,20,30,1993,7,"male",372,61,23,1,0,1,0,0,0
1311483,35,19,1978,12,"female",361,207,136,72,172,72,81,0,91
1311532,43,10,1970,2,"male",120,130,87,14,23,14,20,0,3
1311534,31,11,1982,8,"male",115,23,5,14,11,14,6,0,5
1311540,30,10,1983,10,"male",235,77,27,2,28,2,28,0,0
1311573,38,30,1975,7,"female",439,109,43,3,21,3,8,0,13
1311574,51,4,1962,7,"male",777,94,39,97,53,28,39,69,14
1311581,36,29,1977,8,"male",261,2,2,0,0,0,0,0,0
1311584,43,1,1970,4,"male",507,30,23,10,2,10,0,0,2
1311602,24,1,1989,8,"male",177,33,28,8,0,8,0,0,0
1311606,20,31,1993,5,"male",164,87,73,0,0,0,0,0,0
1311644,58,18,1955,4,"male",581,144,95,10,49,0,11,10,38
1311679,15,8,1998,12,"male",153,15,12,4,2,4,1,0,1
1311685,103,24,1910,8,"male",860,554,299,12,4,12,2,0,2
1311694,18,1,1995,1,"male",101,59,48,13,1,13,1,0,0
1311697,26,22,1987,12,"female",280,173,17,1,0,1,0,0,0
1311699,23,3,1990,3,"male",471,46,38,251,98,251,77,0,21
1311701,71,30,1942,3,"male",937,16,8,0,0,0,0,0,0
1311702,18,23,1995,9,"female",41,759,80,137,976,137,815,0,161
1311708,19,7,1994,3,"male",564,212,203,4,1,0,1,4,0
1311717,18,18,1995,4,"male",127,2,1,0,3,0,3,0,0
1311731,79,17,1934,10,"male",10,24,22,6,9,3,5,3,4
1311745,14,5,1999,5,"male",18,155,113,57,109,31,74,26,35
1311767,77,13,1936,8,"male",2426,253,57,43,33,43,28,0,5
1311783,56,23,1957,3,"female",998,125,89,33,34,33,22,0,12
1311846,61,8,1952,6,"female",2288,79,43,533,609,0,446,533,163
1311868,35,24,1978,11,"male",508,107,29,170,171,159,39,11,132
1311877,16,15,1997,11,"male",303,22,13,91,6,84,5,7,1
1311899,47,30,1966,9,"male",1371,137,72,4,2,4,2,0,0
1311903,18,18,1995,11,"female",216,74,55,3,2,3,2,0,0
1311924,47,12,1966,7,"female",611,30,10,5,21,5,16,0,5
1311935,21,12,1992,2,"male",669,423,188,0,2,0,2,0,0
1311946,46,29,1967,8,"female",1295,50,20,93,63,34,28,59,35
1311947,47,31,1966,5,"female",723,141,88,105,18,53,9,52,9
1311952,19,20,1994,12,"male",133,16,13,1,1,0,1,1,0
1311965,108,31,1905,7,"male",153,588,581,4,170,4,149,0,21
1311966,21,12,1992,12,"male",131,28,24,0,1,0,1,0,0
1311992,16,14,1997,7,"female",776,2993,1681,768,3659,248,2211,520,1448
1312020,18,19,1995,3,"male",226,18,18,0,0,0,0,0,0
1312021,46,21,1967,6,"male",310,88,32,1,18,1,12,0,6
1312036,18,10,1995,8,"male",354,130,105,52,47,52,33,0,14
1312038,68,10,1945,2,"female",388,76,41,2,0,2,0,0,0
1312047,56,27,1957,2,"female",825,169,110,268,153,31,53,237,100
1312053,26,6,1987,8,"female",598,94,37,0,0,0,0,0,0
1312055,50,24,1963,3,"male",371,36,28,435,80,0,14,435,66
1312067,18,19,1995,8,"female",167,8,2,146,40,146,38,0,2
1312078,23,5,1990,12,"male",823,334,207,135,98,108,63,27,35
1312095,54,26,1959,2,"male",1783,125,94,7,25,3,12,4,13
1312106,32,16,1981,4,"female",425,30,26,0,8,0,8,0,0
1312117,67,2,1946,11,"female",1800,18,7,0,0,0,0,0,0
1312135,67,4,1946,11,"male",297,29,15,0,0,0,0,0,0
1312170,28,8,1985,6,"male",37,11,9,206,33,0,0,206,33
1312191,40,25,1973,7,"male",172,118,101,7,2,6,2,1,0
1312201,95,13,1918,10,"male",1469,25,12,341,125,5,57,336,68
1312207,61,8,1952,5,"male",1805,119,82,4,24,0,14,4,10
1312229,23,19,1990,9,"male",570,187,106,1,7,1,4,0,3
1312240,18,6,1995,6,"male",386,96,71,2,2,2,1,0,1
1312241,25,14,1988,10,"male",81,164,154,53,57,53,50,0,7
1312242,49,22,1964,11,"male",281,27,3,0,0,0,0,0,0
1312244,74,15,1939,5,"male",109,50,43,2,131,0,13,2,118
1312261,18,13,1995,10,"male",574,63,2,1,0,1,0,0,0
1312300,20,12,1993,12,"male",343,284,241,22,35,5,25,17,10
1312310,34,2,1979,4,"male",643,370,81,594,361,491,174,103,187
1312314,19,29,1994,9,"male",384,145,77,112,24,21,6,91,18
1312338,71,12,1942,3,"female",1382,55,35,45,6,0,2,45,4
1312353,49,24,1964,10,"female",1013,268,178,22,31,16,17,6,14
1312371,28,16,1985,8,"female",617,218,197,307,2,307,2,0,0
1312396,86,6,1927,2,"female",292,66,50,1,8,0,0,1,8
1312438,28,2,1985,2,"male",617,67,49,113,215,85,141,28,74
1312448,61,27,1952,6,"female",1506,355,158,153,42,2,17,151,25
1312481,27,13,1986,10,"male",614,84,38,71,18,71,17,0,1
1312504,74,13,1939,6,"female",1888,29,10,20,9,17,1,3,8
1312511,32,10,1981,10,"male",193,16,14,0,1,0,1,0,0
1312518,21,8,1992,10,"female",695,453,377,780,846,780,764,0,82
1312561,37,10,1976,12,"female",265,61,28,0,0,0,0,0,0
1312565,33,19,1980,5,"female",621,108,66,66,35,66,30,0,5
1312567,45,23,1968,7,"female",654,260,170,44,20,1,9,43,11
1312575,24,12,1989,6,"female",1330,724,256,740,594,695,378,45,216
1312584,43,25,1970,12,"male",361,11,9,102,127,0,5,102,122
1312596,25,20,1988,5,"female",611,284,93,73,84,28,51,45,33
1312610,23,7,1990,4,"female",416,1,1,0,0,0,0,0,0
1312638,18,26,1995,5,"female",220,135,67,10,16,10,9,0,7
1312656,64,25,1949,11,"male",1920,327,148,321,173,321,94,0,79
1312684,34,3,1979,6,"female",367,32,22,120,20,120,16,0,4
1312690,25,16,1988,5,"female",10,213,54,19,70,19,20,0,50
1312697,36,11,1977,7,"male",80,10,4,0,0,0,0,0,0
1312698,102,5,1911,2,"male",1569,3877,680,44,12,43,10,1,2
1312707,47,12,1966,5,"female",1186,96,25,432,324,388,158,44,166
1312713,85,17,1928,12,"male",1431,166,81,15,7,15,5,0,2
1312719,48,14,1965,8,"male",1064,132,38,0,0,0,0,0,0
1312740,45,8,1968,8,"male",119,9,5,18,1,18,1,0,0
1312766,62,1,1951,4,"female",1076,158,49,2,8,2,5,0,3
1312770,34,15,1979,4,"male",543,189,122,539,312,513,214,26,98
1312776,20,30,1993,9,"male",314,6,2,5,0,5,0,0,0
1312781,31,1,1982,6,"male",485,103,53,154,55,74,8,80,47
1312813,23,5,1990,8,"male",77,69,32,10,4,10,4,0,0
1312829,45,14,1968,8,"male",710,42,18,3,3,3,2,0,1
1312891,20,20,1993,5,"male",310,59,39,0,1,0,1,0,0
1312899,52,20,1961,4,"male",643,14,3,0,0,0,0,0,0
1312900,44,28,1969,6,"female",276,90,75,1713,1085,1713,721,0,364
1312940,21,25,1992,12,"male",249,113,85,3,5,3,4,0,1
1312963,52,12,1961,4,"male",182,1,1,0,0,0,0,0,0
1312968,32,19,1981,10,"female",445,228,148,1223,370,965,225,258,145
1312973,58,9,1955,3,"female",338,25,22,19,7,19,1,0,6
1312978,30,11,1983,4,"male",454,116,54,34,33,2,18,32,15
1312995,27,6,1986,3,"male",1511,312,200,514,332,514,252,0,80
1313013,64,24,1949,11,"female",991,86,41,20,9,20,5,0,4
1313016,53,22,1960,3,"female",858,253,62,43,15,43,11,0,4
1313073,68,5,1945,2,"male",278,63,43,1,0,1,0,0,0
1313074,23,25,1990,9,"female",108,257,158,2207,1302,2207,911,0,391
1313093,19,25,1994,5,"male",467,26,17,0,0,0,0,0,0
1313101,69,5,1944,8,"male",188,32,16,16,3,0,1,16,2
1313103,47,27,1966,2,"male",293,94,86,61,12,61,12,0,0
1313108,97,15,1916,11,"male",613,0,0,0,0,0,0,0,0
1313112,15,1,1998,2,"male",230,59,51,0,1,0,0,0,1
1313136,18,4,1995,6,"male",353,153,51,50,104,50,70,0,34
1313149,66,21,1947,11,"male",1884,123,66,27,5,0,2,27,3
1313157,72,4,1941,8,"male",924,181,125,4,22,0,12,4,10
1313162,52,13,1961,1,"female",999,223,72,58,109,2,77,56,32
1313167,18,11,1995,1,"female",642,201,116,20,0,20,0,0,0
1313183,21,17,1992,11,"male",673,211,139,1,2,0,1,1,1
1313193,18,14,1995,2,"female",731,202,45,7,5,7,1,0,4
1313203,19,9,1994,6,"male",184,198,93,7,3,7,3,0,0
1313209,29,11,1984,11,"male",401,0,0,0,0,0,0,0,0
1313254,26,11,1987,12,"male",532,75,61,1,3,1,3,0,0
1313260,64,15,1949,7,"female",1471,74,30,32,50,8,20,24,30
1313296,23,10,1990,10,"male",108,59,22,0,0,0,0,0,0
1313298,30,19,1983,5,"male",380,483,431,11,2,1,2,10,0
1313315,16,5,1997,3,"female",393,171,135,1,1,1,1,0,0
1313318,76,16,1937,11,"male",332,186,56,2,0,2,0,0,0
1313326,48,1,1965,2,"female",1487,28,17,83,62,75,48,8,14
1313335,17,7,1996,2,"male",308,14,10,4,0,4,0,0,0
1313337,16,23,1997,4,"male",367,67,52,0,0,0,0,0,0
1313342,77,12,1936,1,"male",1183,1403,710,344,1425,53,726,291,699
1313345,46,9,1967,7,"female",1286,774,572,491,1611,377,1152,114,459
1313368,20,3,1993,11,"female",497,250,36,421,36,419,24,2,12
1313385,49,21,1964,12,"male",494,142,90,3,0,3,0,0,0
1313394,23,21,1990,11,"male",647,163,106,5,5,5,4,0,1
1313450,24,3,1989,12,"female",345,508,262,1121,310,1121,207,0,103
1313471,31,5,1982,9,"male",762,85,57,7,1,0,1,7,0
1313488,29,2,1984,9,"female",581,110,67,142,121,139,74,3,47
1313490,24,15,1989,1,"male",299,116,85,11,16,10,1,1,15
1313584,25,20,1988,7,"male",139,56,33,15,2,15,2,0,0
1313620,23,12,1990,5,"male",214,146,139,0,21,0,15,0,6
1313634,21,26,1992,11,"male",303,17,17,0,0,0,0,0,0
1313649,14,4,1999,6,"female",198,123,61,50,100,45,52,5,48
1313653,32,7,1981,12,"male",419,0,0,0,0,0,0,0,0
1313685,44,8,1969,8,"male",462,102,39,304,146,260,66,44,80
1313709,32,2,1981,2,"male",622,44,21,0,0,0,0,0,0
1313714,63,4,1950,3,"female",2375,247,114,246,57,246,52,0,5
1313740,17,30,1996,8,"female",1096,615,276,977,847,29,402,948,445
1313756,61,1,1952,5,"female",117,14,10,22,9,1,4,21,5
1313764,52,25,1961,12,"male",12,0,0,0,0,0,0,0,0
1313770,21,1,1992,1,"male",245,43,36,6,1,2,1,4,0
1313772,32,28,1981,10,"female",264,47,30,3,6,0,3,3,3
1313775,52,23,1961,8,"female",1777,292,163,531,407,253,268,278,139
1313840,55,31,1958,8,"female",656,297,215,524,627,64,83,460,544
1313864,66,25,1947,2,"female",1161,173,61,24,12,11,5,13,7
1313897,66,29,1947,9,"female",1574,201,100,164,521,164,241,0,280
1313928,19,15,1994,7,"male",425,33,27,719,6,719,4,0,2
1313934,42,15,1971,12,"male",1175,75,10,15,39,15,30,0,9
1313948,34,29,1979,3,"male",37,60,49,0,11,0,3,0,8
1313958,69,12,1944,5,"female",379,67,26,102,52,5,27,97,25
1313977,29,2,1984,7,"female",163,6,6,38,0,0,0,38,0
1313982,45,27,1968,1,"male",574,130,79,1388,462,1388,372,0,90
1313989,74,3,1939,10,"female",1849,2123,422,662,583,642,520,20,63
1313992,15,11,1998,1,"male",283,407,227,18,58,17,29,1,29
1314003,60,1,1953,4,"male",78,2,0,10,9,10,9,0,0
1314022,23,6,1990,12,"male",141,4,2,0,0,0,0,0,0
1314025,26,16,1987,5,"male",348,890,784,2331,1072,2274,645,57,427
1314033,28,10,1985,6,"male",292,21,19,0,0,0,0,0,0
1314070,49,12,1964,3,"female",383,101,75,2,3,0,1,2,2
1314099,35,2,1978,1,"female",563,81,38,3,0,3,0,0,0
1314102,53,30,1960,8,"female",307,36,16,29,16,3,13,26,3
1314104,17,18,1996,12,"female",435,95,73,14,7,14,7,0,0
1314108,65,11,1948,1,"female",764,101,56,543,114,17,30,526,84
1314118,21,7,1992,7,"female",335,2,2,0,0,0,0,0,0
1314128,41,8,1972,4,"male",1335,76,27,0,1,0,0,0,1
1314134,37,3,1976,6,"female",715,60,28,54,33,54,31,0,2
1314160,18,4,1995,9,"female",561,1445,438,2,55,2,47,0,8
1314164,23,1,1990,1,"male",382,159,85,26,2,26,1,0,1
1314185,86,10,1927,5,"female",605,381,272,140,74,140,62,0,12
1314191,32,10,1981,11,"female",222,50,43,4,43,4,19,0,24
1314192,36,15,1977,2,"female",422,141,66,654,239,654,156,0,83
1314220,24,11,1989,4,"male",663,223,169,1,0,0,0,1,0
1314227,63,14,1950,3,"male",1757,109,45,21,0,19,0,2,0
1314249,21,30,1992,1,"female",656,281,153,50,102,0,51,50,51
1314256,41,2,1972,8,"female",2,3,1,1,35,1,27,0,8
1314301,16,28,1997,12,"female",231,116,4,12,1,12,0,0,1
1314304,16,15,1997,8,"male",574,502,453,9,10,9,7,0,3
1314373,24,2,1989,1,"female",461,211,192,21,0,21,0,0,0
1314374,21,19,1992,10,"male",450,223,134,42,14,42,14,0,0
1314387,16,4,1997,8,"male",226,41,25,16,1,16,0,0,1
1314412,46,20,1967,12,"male",620,25,18,0,5,0,3,0,2
1314417,70,10,1943,2,"female",1347,35,10,180,74,2,23,178,51
1314443,33,5,1980,8,"male",984,86,30,2,0,0,0,2,0
1314469,108,15,1905,6,"female",2051,372,224,257,335,194,289,63,46
1314485,108,25,1905,1,"male",980,281,213,20,13,20,10,0,3
1314501,46,20,1967,6,"female",1342,74,56,655,202,480,150,175,52
1314513,103,20,1910,6,"female",1820,289,44,5,5,0,1,5,4
1314526,28,27,1985,4,"male",246,39,23,9,0,9,0,0,0
1314544,18,15,1995,5,"male",33,10,8,0,0,0,0,0,0
1314551,14,13,1999,5,"female",195,224,74,20,28,17,18,3,10
1314554,45,17,1968,10,"female",529,71,34,26,11,0,5,26,6
1314563,24,15,1989,3,"male",895,368,267,0,1,0,1,0,0
1314574,18,2,1995,2,"male",129,431,382,6,7,0,0,6,7
1314582,28,11,1985,9,"male",5,0,0,10,4,10,4,0,0
1314593,32,29,1981,7,"female",349,41,27,0,1,0,0,0,1
1314603,108,16,1905,12,"female",1538,876,514,279,467,279,256,0,211
1314610,37,17,1976,12,"female",381,52,36,1,3,0,0,1,3
1314615,32,24,1981,9,"male",783,81,71,1,0,1,0,0,0
1314622,19,17,1994,1,"female",1101,4252,958,142,706,134,507,8,199
1314634,28,28,1985,1,"male",269,12,9,3,2,0,2,3,0
1314642,26,30,1987,6,"male",187,120,110,0,0,0,0,0,0
1314664,15,31,1998,10,"female",552,4373,1289,15,159,15,125,0,34
1314677,51,4,1962,11,"female",296,344,70,86,100,0,17,86,83
1314678,29,25,1984,11,"male",348,53,33,10,0,10,0,0,0
1314731,53,3,1960,12,"male",744,102,65,55,0,55,0,0,0
1314741,17,29,1996,2,"female",574,731,391,4,1,2,1,2,0
1314747,42,24,1971,7,"female",560,561,226,2081,267,2081,140,0,127
1314788,44,6,1969,1,"male",205,8,5,1,0,1,0,0,0
1314795,69,31,1944,12,"female",534,77,48,29,109,0,24,29,85
1314798,25,27,1988,2,"male",546,43,23,30,33,21,23,9,10
1314813,17,18,1996,12,"male",361,72,52,0,9,0,3,0,6
1314831,14,27,1999,10,"male",201,12,11,81,17,81,17,0,0
1314835,51,2,1962,8,"male",659,34,19,7,1,7,1,0,0
1314841,45,17,1968,10,"male",50,0,0,0,0,0,0,0,0
1314852,15,10,1998,7,"female",445,356,48,26,1,0,1,26,0
1314881,59,10,1954,12,"male",1444,44,23,0,0,0,0,0,0
1314949,26,1,1987,1,"male",619,6,5,0,0,0,0,0,0
1314971,31,27,1982,6,"male",405,54,28,18,23,0,4,18,19
1314981,66,20,1947,4,"male",1710,504,289,0,1,0,1,0,0
1315002,108,26,1905,4,"female",83,58,52,16,46,5,14,11,32
1315010,53,14,1960,5,"male",168,90,56,32,6,32,6,0,0
1315027,37,4,1976,8,"male",397,47,6,1,1,1,1,0,0
1315037,24,10,1989,1,"male",1571,1061,661,1,1439,0,318,1,1121
1315054,19,27,1994,1,"female",237,607,419,39,78,39,72,0,6
1315055,14,22,1999,1,"male",478,109,85,53,21,0,3,53,18
1315062,108,9,1905,11,"male",986,65,37,76,9,76,7,0,2
1315103,103,9,1910,12,"male",1188,260,186,27,101,27,60,0,41
1315134,23,15,1990,5,"male",96,151,106,172,78,4,21,168,57
1315166,29,22,1984,11,"female",374,84,45,52,39,52,34,0,5
1315168,34,6,1979,6,"female",1829,126,65,1622,449,1280,314,342,135
1315170,56,25,1957,7,"male",1080,177,112,4,0,0,0,4,0
1315180,42,28,1971,4,"female",415,90,63,1,2,1,2,0,0
1315185,19,15,1994,9,"female",1364,1551,639,417,677,166,380,251,297
1315190,21,1,1992,1,"male",178,159,119,0,1,0,0,0,1
1315193,23,1,1990,1,"male",121,171,153,108,65,85,51,23,14
1315218,44,17,1969,3,"male",644,57,37,0,7,0,3,0,4
1315224,40,4,1973,4,"male",294,379,277,42,115,41,105,1,10
1315231,56,4,1957,7,"female",1546,291,136,167,52,167,47,0,5
1315235,22,5,1991,3,"female",429,251,124,84,43,84,41,0,2
1315260,18,24,1995,11,"male",74,287,244,918,1004,861,441,57,563
1315295,16,1,1997,5,"female",424,484,282,186,57,55,21,131,36
1315303,23,7,1990,2,"male",975,231,193,7,1,7,0,0,1
1315304,21,1,1992,8,"female",1756,369,239,324,359,83,219,241,140
1315308,41,12,1972,5,"female",70,13,12,45,5,45,3,0,2
1315312,65,22,1948,11,"female",1759,114,41,32,12,5,6,27,6
1315330,20,19,1993,12,"male",857,567,353,508,228,245,135,263,93
1315335,55,2,1958,7,"male",1647,297,116,6,12,6,11,0,1
1315337,17,8,1996,8,"male",227,441,327,4,60,4,8,0,52
1315338,108,17,1905,9,"male",1258,1527,1144,1370,756,1370,577,0,179
1315339,51,29,1962,11,"female",496,90,67,46,230,0,20,46,210
1315340,21,17,1992,2,"male",409,15,10,0,0,0,0,0,0
1315350,15,23,1998,10,"female",314,1016,98,217,512,217,372,0,140
1315353,57,1,1956,5,"male",254,85,67,219,114,199,78,20,36
1315410,100,15,1913,6,"female",1758,101,62,114,64,95,38,19,26
1315420,20,23,1993,10,"male",402,160,98,0,0,0,0,0,0
1315421,55,17,1958,6,"male",620,13,6,2,0,2,0,0,0
1315446,29,1,1984,1,"male",717,1186,1054,338,47,338,38,0,9
1315452,70,13,1943,12,"female",205,23,11,17,0,17,0,0,0
1315471,33,10,1980,1,"male",321,215,200,0,5,0,4,0,1
1315477,50,1,1963,1,"male",712,81,38,11,3,11,2,0,1
1315487,44,18,1969,9,"male",1816,186,84,0,0,0,0,0,0
1315497,47,19,1966,4,"female",442,25,7,1,0,1,0,0,0
1315509,31,13,1982,11,"male",871,69,39,4,0,4,0,0,0
1315513,26,1,1987,1,"male",507,0,0,0,0,0,0,0,0
1315544,14,27,1999,4,"male",356,1047,917,1271,3154,1267,2743,4,411
1315548,19,29,1994,10,"male",179,579,511,842,600,429,461,413,139
1315551,15,28,1998,7,"male",242,118,117,0,25,0,23,0,2
1315564,24,12,1989,2,"male",1019,128,30,43,50,35,21,8,29
1315572,34,30,1979,8,"male",246,67,42,1,1,1,0,0,1
1315656,57,28,1956,8,"female",1913,163,89,350,330,123,167,227,163
1315675,25,1,1988,1,"female",243,9,3,1,0,1,0,0,0
1315696,32,28,1981,7,"male",718,12,10,0,0,0,0,0,0
1315727,30,10,1983,11,"male",1161,3,1,0,0,0,0,0,0
1315734,35,1,1978,2,"female",1166,63,26,72,51,72,32,0,19
1315768,108,8,1905,10,"female",975,158,107,74,72,0,39,74,33
1315774,30,14,1983,9,"female",366,159,133,16,1,4,1,12,0
1315782,23,19,1990,2,"male",23,0,0,0,0,0,0,0,0
1315805,17,10,1996,11,"female",881,9,4,0,0,0,0,0,0
1315836,16,6,1997,11,"female",180,32,29,9,3,9,3,0,0
1315894,26,1,1987,1,"male",651,234,146,26,10,26,2,0,8
1315964,41,17,1972,5,"female",179,42,33,10,6,0,1,10,5
1316033,48,24,1965,11,"female",658,9,6,0,0,0,0,0,0
1316041,24,27,1989,9,"male",624,390,262,1,23,1,14,0,9
1316071,16,22,1997,6,"female",340,103,70,196,103,196,67,0,36
1316080,47,1,1966,11,"female",643,50,26,400,295,82,104,318,191
1316082,31,4,1982,8,"male",64,45,36,16,114,16,91,0,23
1316088,75,2,1938,1,"male",842,248,182,0,0,0,0,0,0
1316102,66,19,1947,7,"male",1174,95,35,7,52,7,3,0,49
1316117,25,1,1988,1,"male",46,23,15,1,3,1,3,0,0
1316158,25,1,1988,1,"male",163,64,60,66,19,60,17,6,2
1316163,34,29,1979,4,"male",243,56,46,8,1,2,0,6,1
1316172,59,31,1954,5,"male",372,29,27,0,0,0,0,0,0
1316174,38,1,1975,11,"female",108,154,38,17,25,17,23,0,2
1316189,26,3,1987,10,"male",636,116,22,11,3,11,2,0,1
1316203,78,24,1935,11,"female",1596,106,43,19,130,0,111,19,19
1316232,21,8,1992,7,"male",272,30,25,0,0,0,0,0,0
1316243,22,24,1991,2,"male",334,250,172,17,26,16,12,1,14
1316271,63,24,1950,12,NA,2012,87,27,7,4,4,3,3,1
1316272,34,5,1979,5,"male",188,112,95,111,102,111,95,0,7
1316302,34,12,1979,5,"male",121,1,1,0,0,0,0,0,0
1316318,21,22,1992,6,"male",782,64,24,2,23,1,4,1,19
1316323,20,15,1993,9,"male",82,181,167,197,298,78,267,119,31
1316324,24,16,1989,9,"female",198,295,63,10,19,10,18,0,1
1316368,15,23,1998,8,"female",276,211,125,220,13,217,10,3,3
1316400,20,14,1993,12,"female",530,163,102,262,194,6,59,256,135
1316412,29,15,1984,6,"male",192,148,124,2,0,0,0,2,0
1316429,23,2,1990,2,"female",91,4,3,59,25,15,12,44,13
1316431,78,24,1935,9,"male",1552,22,9,0,0,0,0,0,0
1316450,22,1,1991,11,"female",565,424,190,2,27,2,18,0,9
1316452,14,22,1999,11,"female",12,106,17,3,28,3,27,0,1
1316477,35,16,1978,2,"female",1278,177,89,120,119,120,89,0,30
1316483,30,7,1983,5,"male",320,62,44,583,31,582,24,1,7
1316485,25,8,1988,9,"female",814,550,285,1868,2676,674,1319,1194,1357
1316503,48,31,1965,7,"male",1333,106,39,17,47,11,40,6,7
1316568,94,25,1919,12,"male",1743,295,186,41,5,19,1,22,4
1316569,25,6,1988,3,"female",1453,642,231,543,766,253,253,290,513
1316593,28,9,1985,8,"male",674,74,70,1,0,1,0,0,0
1316643,19,16,1994,9,"female",812,208,117,661,636,153,310,508,326
1316680,33,9,1980,7,"male",685,4,3,0,0,0,0,0,0
1316685,103,10,1910,3,"male",1334,438,200,48,36,48,13,0,23
1316690,14,8,1999,7,"female",5,60,33,42,45,42,45,0,0
1316711,70,21,1943,4,"female",897,151,53,19,122,15,50,4,72
1316721,108,14,1905,9,"male",2160,656,167,606,402,317,66,289,336
1316805,29,5,1984,7,"female",530,105,67,78,48,71,24,7,24
1316873,49,8,1964,10,"female",278,25,19,0,0,0,0,0,0
1316925,21,16,1992,6,"male",193,2,0,0,0,0,0,0,0
1316943,35,6,1978,11,"male",21,21,20,71,4,71,3,0,1
1317014,18,14,1995,11,"female",115,102,50,10,28,10,24,0,4
1317027,18,16,1995,10,"male",179,186,133,262,160,262,89,0,71
1317030,25,23,1988,10,"male",208,24,13,0,0,0,0,0,0
1317045,25,3,1988,4,"male",208,42,27,0,0,0,0,0,0
1317068,13,25,2000,7,"male",96,4,3,0,0,0,0,0,0
1317069,14,24,1999,1,"female",45,82,75,2,1,2,1,0,0
1317082,42,10,1971,9,"female",369,77,38,124,48,99,34,25,14
1317096,17,1,1996,8,"male",470,145,96,52,7,25,4,27,3
1317102,91,22,1922,2,"male",2081,230,123,10,23,7,12,3,11
1317126,24,31,1989,12,"male",403,108,64,443,792,442,735,1,57
1317163,108,1,1905,1,"male",2259,642,367,64,30,48,14,16,16
1317203,108,13,1905,5,"male",1468,903,307,1241,485,1216,437,25,48
1317228,23,12,1990,4,"male",799,212,88,22,8,14,3,8,5
1317258,18,20,1995,1,"male",382,576,433,10,19,4,12,6,7
1317261,55,30,1958,6,"female",800,120,59,165,230,165,153,0,77
1317269,33,25,1980,12,"male",169,9,6,2,9,2,7,0,2
1317288,38,27,1975,2,"female",368,214,177,13,2,0,1,13,1
1317295,35,5,1978,1,"female",914,281,161,54,157,51,63,3,94
1317296,21,21,1992,1,"male",157,404,235,125,58,125,11,0,47
1317344,44,15,1969,11,"male",314,0,0,5,0,5,0,0,0
1317355,77,24,1936,12,"male",1713,47,13,6,1,1,1,5,0
1317374,36,19,1977,4,"female",631,31,17,11,5,11,5,0,0
1317400,64,1,1949,5,"female",306,47,32,0,2,0,2,0,0
1317406,21,3,1992,3,"female",670,9,9,0,2,0,2,0,0
1317424,55,15,1958,9,"female",4,28,8,16,13,16,12,0,1
1317445,100,16,1913,5,"female",1870,29,23,0,2,0,1,0,1
1317455,25,29,1988,7,"male",209,93,21,1,7,1,7,0,0
1317474,18,15,1995,9,"female",443,1567,663,5620,20704,220,9694,5400,11010
1317475,17,18,1996,9,"female",410,44,24,1926,509,1881,329,45,180
1317541,45,16,1968,12,"female",316,280,147,174,355,5,163,169,192
1317549,31,27,1982,11,"male",97,170,74,46,204,46,184,0,20
1317575,20,1,1993,1,"male",452,266,93,34,20,34,16,0,4
1317669,18,30,1995,1,"male",263,21,19,0,0,0,0,0,0
1317693,16,20,1997,5,"female",478,118,75,489,567,336,288,153,279
1317735,23,25,1990,12,"male",1123,350,256,1,1,1,1,0,0
1317739,18,6,1995,1,"female",274,99,55,17,9,17,6,0,3
1317774,53,16,1960,11,"male",888,109,22,0,1,0,0,0,1
1317812,43,22,1970,2,"female",1266,485,157,151,71,67,46,84,25
1317841,17,21,1996,12,"male",320,101,40,19,9,5,7,14,2
1317849,30,20,1983,7,"male",310,13,2,0,0,0,0,0,0
1317854,28,26,1985,10,"male",427,184,169,7,3,7,2,0,1
1317855,60,25,1953,7,"male",393,54,38,9,21,0,11,9,10
1317863,56,24,1957,7,"male",739,99,44,17,0,10,0,7,0
1317889,97,3,1916,4,"male",903,296,68,183,362,0,175,183,187
1317911,46,18,1967,3,"male",1602,23,2,5,4,4,4,1,0
1317931,34,19,1979,1,"female",294,7,6,0,0,0,0,0,0
1317935,17,3,1996,7,"male",364,438,280,376,480,326,322,50,158
1317940,19,29,1994,9,"female",530,460,355,662,240,438,120,224,120
1317941,34,20,1979,11,"female",557,372,259,26,32,26,21,0,11
1317942,108,1,1905,2,"male",1021,759,420,25,21,8,4,17,17
1317946,15,12,1998,9,"female",322,540,463,87,70,87,65,0,5
1317970,33,25,1980,6,"male",1060,101,67,0,13,0,9,0,4
1317989,19,12,1994,12,"female",194,135,77,1,2,1,2,0,0
1317993,64,29,1949,8,"female",565,265,131,25,0,25,0,0,0
1318023,63,26,1950,1,"male",615,1388,656,145,259,0,31,145,228
1318029,46,18,1967,11,"male",621,7,4,1,1,1,1,0,0
1318046,38,1,1975,4,"male",174,40,25,19,11,19,3,0,8
1318049,17,4,1996,11,"male",198,45,15,9,1,8,0,1,1
1318062,22,20,1991,5,"female",508,128,65,51,646,40,471,11,175
1318095,29,23,1984,3,"male",395,51,36,0,0,0,0,0,0
1318134,54,28,1959,5,"female",852,43,17,18,19,18,16,0,3
1318137,29,17,1984,8,"male",402,7,2,0,0,0,0,0,0
1318151,108,12,1905,7,"male",242,182,136,87,3,69,3,18,0
1318181,25,17,1988,4,"female",612,264,185,453,678,453,662,0,16
1318196,53,18,1960,9,"female",988,151,126,361,275,24,143,337,132
1318207,51,1,1962,1,"male",1318,132,56,604,268,604,138,0,130
1318239,21,10,1992,7,"female",314,1,1,0,0,0,0,0,0
1318258,26,13,1987,10,"female",295,46,19,980,105,980,73,0,32
1318268,21,17,1992,10,"male",761,7,5,0,0,0,0,0,0
1318300,52,10,1961,12,"female",1114,107,36,371,107,0,34,371,73
1318327,42,26,1971,11,"male",203,0,0,13,0,0,0,13,0
1318354,103,9,1910,8,"male",1247,40,25,0,0,0,0,0,0
1318356,20,27,1993,9,"male",114,18,11,1,0,0,0,1,0
1318365,46,7,1967,10,"male",81,4,2,0,0,0,0,0,0
1318369,64,23,1949,11,"male",881,164,144,55,62,0,50,55,12
1318377,23,1,1990,2,"male",421,884,668,24,54,24,39,0,15
1318394,16,21,1997,1,"male",606,130,84,38,41,36,25,2,16
1318424,20,4,1993,12,"female",96,0,0,0,0,0,0,0,0
1318461,16,18,1997,4,"female",629,84,60,8,3,8,2,0,1
1318483,20,30,1993,10,"male",593,529,392,321,100,164,63,157,37
1318512,58,24,1955,4,"male",973,29,15,14,13,9,9,5,4
1318525,69,18,1944,9,"female",1671,53,31,1,0,0,0,1,0
1318547,21,18,1992,1,"male",355,188,163,1,6,1,6,0,0
1318554,33,3,1980,6,"male",457,129,30,1,12,1,8,0,4
1318565,29,11,1984,2,"male",202,7,7,0,0,0,0,0,0
1318596,73,9,1940,12,"male",980,34,16,16,3,10,1,6,2
1318599,31,19,1982,11,"male",405,142,88,1,10,1,5,0,5
1318613,26,1,1987,1,"female",467,0,0,0,0,0,0,0,0
1318637,19,7,1994,1,"male",632,101,38,0,0,0,0,0,0
1318680,18,24,1995,8,"male",523,94,37,4,4,4,4,0,0
1318683,43,1,1970,3,"female",223,13,10,2,25,1,17,1,8
1318712,20,14,1993,9,"female",25,4576,1710,1006,2293,299,1453,707,840
1318713,20,13,1993,7,"male",297,106,84,0,0,0,0,0,0
1318745,49,18,1964,8,"female",931,140,85,370,120,367,88,3,32
1318753,33,10,1980,11,"female",332,29,22,4,1,4,1,0,0
1318757,18,6,1995,2,"female",207,82,49,1024,458,632,183,392,275
1318792,82,27,1931,5,"male",1233,480,346,131,5,0,3,131,2
1318807,16,27,1997,12,"male",654,577,173,394,400,394,114,0,286
1318865,24,1,1989,4,"female",314,102,90,605,482,514,262,91,220
1318882,20,22,1993,11,"male",264,175,77,237,350,7,18,230,332
1318889,18,27,1995,11,"male",133,169,158,2,18,1,6,1,12
1318909,30,31,1983,8,"female",292,85,72,8,0,0,0,8,0
1318911,21,17,1992,9,"male",218,6,5,1,0,1,0,0,0
1318913,19,26,1994,7,"female",33,62,20,629,1077,555,338,74,739
1318944,53,23,1960,3,"female",403,302,262,17,23,17,11,0,12
1318971,44,17,1969,8,"male",696,130,82,203,295,170,173,33,122
1318998,39,23,1974,12,"male",187,19,16,1,0,0,0,1,0
1319001,21,12,1992,2,"female",1311,4211,1212,569,1277,422,304,147,973
1319011,21,2,1992,3,"female",355,3,2,0,0,0,0,0,0
1319021,15,28,1998,8,"female",887,2956,1248,56,275,50,190,6,85
1319044,85,30,1928,11,"male",695,1240,938,256,94,256,48,0,46
1319084,60,28,1953,8,"female",1020,34,22,0,2,0,1,0,1
1319125,50,8,1963,11,"male",771,28,6,0,0,0,0,0,0
1319126,34,11,1979,2,"male",100,56,43,27,16,27,6,0,10
1319148,14,7,1999,8,"male",442,76,40,26,0,0,0,26,0
1319152,108,15,1905,3,"male",1033,387,272,0,1,0,0,0,1
1319155,28,14,1985,12,"male",205,147,111,5,14,5,14,0,0
1319190,19,26,1994,6,"male",395,352,224,9,35,9,26,0,9
1319224,27,11,1986,11,"male",604,61,27,72,24,70,17,2,7
1319237,23,6,1990,9,"male",589,207,110,4,16,1,5,3,11
1319244,103,2,1910,2,"male",1081,213,102,10,3,10,0,0,3
1319254,28,22,1985,8,"male",448,193,169,14,0,14,0,0,0
1319256,19,14,1994,3,"male",511,45,22,0,0,0,0,0,0
1319263,21,27,1992,4,"male",778,375,205,0,27,0,23,0,4
1319301,25,21,1988,12,"female",257,15,10,283,12,283,11,0,1
1319342,25,7,1988,3,"male",31,25,14,13,27,13,19,0,8
1319344,53,14,1960,9,"female",564,213,159,788,211,45,32,743,179
1319373,56,11,1957,10,"male",510,1,1,0,0,0,0,0,0
1319376,25,1,1988,1,"female",29,422,68,310,1355,310,1167,0,188
1319390,103,20,1910,2,"female",353,63,30,4,12,4,8,0,4
1319419,55,2,1958,7,"male",847,3096,940,9,317,2,282,7,35
1319452,25,1,1988,1,"male",248,54,27,108,33,108,33,0,0
1319493,93,29,1920,2,"male",1520,60,19,66,15,49,6,17,9
1319501,24,7,1989,6,"male",272,270,239,11,4,11,4,0,0
1319505,19,13,1994,7,"male",346,81,51,41,64,40,53,1,11
1319506,22,1,1991,1,"female",496,290,240,0,0,0,0,0,0
1319534,53,4,1960,12,"female",137,36,23,28,22,0,1,28,21
1319556,16,18,1997,1,"female",231,70,61,2,1,2,0,0,1
1319559,20,10,1993,12,"male",265,71,49,1,10,1,3,0,7
1319561,22,8,1991,2,"male",289,238,18,0,3,0,3,0,0
1319567,54,14,1959,11,"female",758,45,33,22,42,22,27,0,15
1319579,59,27,1954,8,"female",637,60,53,70,41,0,13,70,28
1319592,19,7,1994,7,"female",639,427,227,16,20,16,18,0,2
1319600,27,12,1986,4,"female",107,40,16,7,4,7,3,0,1
1319624,32,3,1981,1,"male",285,5,3,146,2,146,1,0,1
1319667,53,10,1960,10,"female",468,60,32,15,83,15,67,0,16
1319677,27,5,1986,3,"male",1688,637,253,195,320,111,267,84,53
1319684,47,15,1966,7,"male",533,80,71,5,8,0,5,5,3
1319709,27,5,1986,9,"female",331,252,120,366,204,366,149,0,55
1319714,43,30,1970,5,"female",520,119,67,0,2,0,0,0,2
1319782,49,31,1964,10,"male",300,41,17,1,3,1,1,0,2
1319808,25,1,1988,5,"male",957,100,40,2400,1443,1364,734,1036,709
1319819,20,3,1993,3,"male",594,149,55,0,18,0,15,0,3
1319834,33,7,1980,4,"male",333,222,158,5,24,5,21,0,3
1319837,25,1,1988,1,"male",14,8,5,2,4,2,2,0,2
1319843,15,28,1998,5,"male",458,204,103,328,53,328,34,0,19
1319845,29,16,1984,1,"female",152,9,3,0,0,0,0,0,0
1319852,51,19,1962,3,"female",968,48,21,19,77,19,47,0,30
1319896,17,21,1996,1,"female",499,532,200,34,14,34,6,0,8
1319940,62,11,1951,6,"male",600,40,32,0,10,0,9,0,1
1319967,15,11,1998,10,"male",291,163,99,90,11,90,9,0,2
1319969,53,9,1960,4,"male",529,442,371,531,3,531,3,0,0
1319971,14,8,1999,5,"female",291,925,819,21,11,8,6,13,5
1319983,62,19,1951,3,"female",1101,67,43,28,5,0,2,28,3
1319984,24,12,1989,4,"female",558,180,102,51,41,51,36,0,5
1319995,27,12,1986,12,"male",289,71,30,22,29,21,15,1,14
1320002,18,10,1995,10,"female",109,27,22,2,3,2,3,0,0
1320008,72,27,1941,1,"female",1093,35,21,1,0,0,0,1,0
1320029,29,1,1984,2,"male",172,54,48,0,0,0,0,0,0
1320030,63,1,1950,10,"female",663,37,30,6,2,3,0,3,2
1320038,63,15,1950,6,"female",24,24,19,9,0,9,0,0,0
1320068,49,19,1964,9,"male",226,19,19,117,11,117,6,0,5
1320071,80,5,1933,3,"female",1607,96,49,7,6,0,2,7,4
1320085,17,6,1996,11,"male",241,340,295,132,65,7,7,125,58
1320131,27,30,1986,8,"male",761,71,29,8,104,3,73,5,31
1320139,64,1,1949,4,NA,2237,107,31,14,62,3,39,11,23
1320180,60,12,1953,10,"male",312,68,36,2,3,2,1,0,2
1320194,29,9,1984,2,"male",444,15,1,0,1,0,1,0,0
1320203,18,11,1995,10,"male",459,542,464,0,2,0,2,0,0
1320252,27,3,1986,2,"female",684,22,15,122,70,122,61,0,9
1320332,20,12,1993,12,"female",988,211,85,2,6,2,6,0,0
1320334,33,28,1980,3,"female",235,195,66,91,17,30,6,61,11
1320338,23,6,1990,4,"male",341,5,1,0,0,0,0,0,0
1320343,26,4,1987,3,"male",430,407,377,9,0,0,0,9,0
1320352,14,9,1999,7,"female",88,5,5,0,0,0,0,0,0
1320355,73,15,1940,11,"female",38,82,27,19,66,0,22,19,44
1320357,42,27,1971,9,"male",389,310,276,8,6,8,6,0,0
1320390,81,4,1932,3,"male",1733,110,74,0,1,0,0,0,1
1320402,15,9,1998,3,"female",431,674,229,21,355,21,167,0,188
1320414,31,4,1982,6,"female",567,100,29,6,7,5,4,1,3
1320464,77,23,1936,1,"female",1443,89,40,32,0,32,0,0,0
1320467,21,5,1992,2,"male",485,138,86,3,8,3,7,0,1
1320513,65,13,1948,6,"female",603,7,4,25,1,7,0,18,1
1320525,54,12,1959,9,"male",1130,98,73,17,16,15,10,2,6
1320535,93,20,1920,1,"male",1548,59,20,31,78,26,64,5,14
1320542,15,5,1998,5,"male",89,0,0,0,0,0,0,0,0
1320556,31,20,1982,3,"female",60,71,49,36,74,36,62,0,12
1320563,62,12,1951,2,"male",1145,218,81,11,12,9,4,2,8
1320567,53,26,1960,8,"male",21,22,14,37,10,37,10,0,0
1320590,39,28,1974,3,"female",341,42,23,58,58,58,57,0,1
1320594,103,16,1910,6,"male",861,218,94,0,1,0,1,0,0
1320615,20,22,1993,3,"female",621,210,63,38,85,38,85,0,0
1320627,23,10,1990,8,"male",1056,715,436,113,97,113,78,0,19
1320698,72,25,1941,5,"female",1650,77,20,3,5,0,2,3,3
1320716,33,26,1980,8,"male",129,2,2,0,0,0,0,0,0
1320729,63,18,1950,8,"male",1016,41,26,0,0,0,0,0,0
1320732,28,1,1985,11,"female",252,1,0,0,0,0,0,0,0
1320742,21,27,1992,9,"male",275,359,311,277,170,277,156,0,14
1320743,25,1,1988,1,"female",5,3,2,3,33,3,33,0,0
1320756,57,16,1956,7,"male",652,101,60,78,11,78,10,0,1
1320763,39,4,1974,7,"female",639,274,225,677,182,677,111,0,71
1320793,14,11,1999,1,"male",342,125,114,3,6,2,4,1,2
1320824,32,25,1981,7,"male",113,3,3,0,0,0,0,0,0
1320852,28,5,1985,9,"female",399,1,1,4,0,4,0,0,0
1320866,26,18,1987,12,"female",762,275,207,69,46,69,29,0,17
1320885,29,24,1984,11,"female",651,9,6,0,0,0,0,0,0
1320891,44,15,1969,11,"male",267,167,67,580,264,580,70,0,194
1320907,32,25,1981,5,"female",138,12,12,8,5,0,1,8,4
1320919,25,5,1988,6,"male",179,36,32,9,0,9,0,0,0
1320925,18,19,1995,2,"male",223,89,69,19,6,19,2,0,4
1320936,67,23,1946,10,"male",537,17,5,4,4,4,2,0,2
1320977,42,12,1971,6,"female",507,3,3,114,34,19,1,95,33
1320984,19,19,1994,6,"female",91,472,226,783,1137,740,748,43,389
1320997,100,6,1913,9,"male",1478,91,19,54,18,48,11,6,7
1321068,23,12,1990,12,"male",500,47,34,3,2,2,1,1,1
1321084,23,14,1990,5,"female",394,584,416,73,97,63,41,10,56
1321085,19,21,1994,3,"male",664,389,323,41,24,41,17,0,7
1321096,74,20,1939,9,"female",1416,20,8,6,16,4,12,2,4
1321146,23,3,1990,1,"male",646,117,78,263,151,263,147,0,4
1321167,20,29,1993,11,"male",659,471,340,58,43,33,20,25,23
1321200,44,12,1969,12,"female",343,8,8,9,2,9,2,0,0
1321204,30,30,1983,10,"male",23,18,15,0,1,0,1,0,0
1321233,62,1,1951,4,"male",33,0,0,0,0,0,0,0,0
1321242,61,24,1952,1,"female",1637,66,14,28,10,28,6,0,4
1321274,19,25,1994,1,"male",561,36,30,1,0,0,0,1,0
1321296,27,21,1986,11,"female",196,2,2,0,0,0,0,0,0
1321299,66,13,1947,6,"male",2067,43,15,25,2,25,1,0,1
1321308,29,5,1984,8,"male",2,0,0,0,0,0,0,0,0
1321331,23,5,1990,10,"male",392,83,37,0,0,0,0,0,0
1321336,47,14,1966,5,"female",586,21,15,0,8,0,6,0,2
1321356,49,3,1964,11,"male",306,37,18,20,6,20,5,0,1
1321359,106,20,1907,3,"male",626,161,137,30,34,30,28,0,6
1321369,23,28,1990,12,"female",526,565,234,179,111,177,103,2,8
1321385,52,15,1961,5,"female",321,113,75,2696,452,2696,404,0,48
1321396,55,24,1958,1,"male",845,178,133,367,226,367,97,0,129
1321418,102,1,1911,1,"male",941,151,135,550,470,549,286,1,184
1321521,16,3,1997,1,"male",592,131,30,42,69,15,37,27,32
1321555,13,1,2000,1,"male",52,1,1,0,0,0,0,0,0
1321564,22,14,1991,9,"female",514,19,8,242,534,238,70,4,464
1321567,38,16,1975,12,"male",9,0,0,0,0,0,0,0,0
1321574,15,29,1998,9,"female",596,4080,793,3306,3069,1898,741,1408,2328
1321585,50,6,1963,7,"male",962,101,43,78,98,3,71,75,27
1321588,22,2,1991,4,"male",244,33,16,10,3,9,2,1,1
1321593,48,19,1965,1,"female",537,1,0,0,0,0,0,0,0
1321610,58,26,1955,8,"female",631,108,56,57,83,45,55,12,28
1321611,30,12,1983,2,"male",158,81,65,2,8,2,0,0,8
1321671,22,16,1991,6,"female",666,168,61,8,38,8,20,0,18
1321679,26,23,1987,4,"male",500,235,193,422,167,422,167,0,0
1321697,35,22,1978,12,"male",619,5,5,0,1,0,1,0,0
1321724,28,17,1985,1,"male",163,9,4,0,0,0,0,0,0
1321730,17,4,1996,2,"male",307,238,179,398,20,0,3,398,17
1321751,102,3,1911,3,"female",1998,459,204,226,68,212,39,14,29
1321766,20,1,1993,11,"male",166,209,64,50,48,5,16,45,32
1321776,108,21,1905,11,"male",1371,731,514,9,33,0,28,9,5
1321779,62,8,1951,9,"female",561,86,59,10,9,1,4,9,5
1321799,33,10,1980,6,"male",190,18,17,4,0,4,0,0,0
1321812,27,1,1986,6,"male",175,28,11,1,4,1,4,0,0
1321814,42,13,1971,10,"male",317,15,9,29,19,29,16,0,3
1321822,46,17,1967,6,"male",668,14,9,29,7,29,7,0,0
1321824,13,2,2000,2,"male",208,14,11,474,10,35,9,439,1
1321839,53,1,1960,6,"male",709,60,41,2,9,0,7,2,2
1321844,52,29,1961,7,"female",120,67,36,211,109,208,77,3,32
1321876,26,16,1987,6,"male",267,127,59,20,38,20,34,0,4
1321878,23,16,1990,8,"female",61,4,3,5,0,5,0,0,0
1321960,18,24,1995,8,"female",48,2068,1137,1645,1178,1508,941,137,237
1321964,41,23,1972,6,"male",488,19,5,1,0,1,0,0,0
1321973,108,6,1905,6,"female",1026,4227,335,269,855,31,588,238,267
1321996,46,9,1967,6,"male",481,24,11,4,1,4,1,0,0
1322004,56,4,1957,11,"female",1384,57,18,237,258,228,143,9,115
1322007,35,26,1978,8,"female",1714,148,44,251,393,166,151,85,242
1322018,32,24,1981,7,"female",202,156,105,19,34,19,19,0,15
1322026,54,12,1959,2,"male",14,10,10,10,9,10,9,0,0
1322047,75,11,1938,10,"female",291,15,6,3,1,3,1,0,0
1322068,108,30,1905,1,"male",1575,669,138,1,10,1,8,0,2
1322077,31,29,1982,4,"male",321,520,379,25,68,25,17,0,51
1322095,108,10,1905,12,"male",1310,713,514,1,17,1,13,0,4
1322106,14,27,1999,11,"male",104,107,67,9,0,8,0,1,0
1322113,15,20,1998,11,"female",179,381,306,65,212,15,59,50,153
1322117,29,12,1984,3,"female",101,78,67,1,27,1,25,0,2
1322133,19,21,1994,9,"male",418,325,288,0,0,0,0,0,0
1322197,19,15,1994,1,"male",1134,31,8,0,0,0,0,0,0
1322200,18,11,1995,8,"male",89,25,19,14,4,14,3,0,1
1322222,26,3,1987,12,"female",469,100,35,26,48,14,30,12,18
1322252,23,18,1990,2,"female",114,5,5,2,0,2,0,0,0
1322259,40,14,1973,7,"female",547,15,7,0,0,0,0,0,0
1322286,18,21,1995,4,"male",155,154,99,52,83,9,22,43,61
1322292,23,17,1990,7,"male",1445,539,330,62,266,62,232,0,34
1322328,25,8,1988,8,"male",753,202,96,62,66,62,57,0,9
1322345,72,20,1941,8,"male",443,111,100,14,0,14,0,0,0
1322354,60,19,1953,9,NA,2301,103,35,32,27,31,16,1,11
1322356,21,8,1992,4,"female",194,82,44,5,68,5,58,0,10
1322380,21,28,1992,4,"male",594,126,81,1,0,1,0,0,0
1322395,51,7,1962,1,"male",219,16,12,827,29,827,15,0,14
1322423,18,31,1995,1,"male",350,68,44,3,2,3,2,0,0
1322424,25,1,1988,7,"female",290,225,87,650,470,353,192,297,278
1322481,38,1,1975,5,"male",23,33,22,40,70,14,12,26,58
1322487,59,19,1954,3,"female",1641,33,20,28,3,28,2,0,1
1322519,15,19,1998,6,"female",283,33,11,2,0,2,0,0,0
1322535,75,13,1938,10,"male",1481,11,4,2,2,0,1,2,1
1322556,23,9,1990,7,"male",1437,183,85,1,28,1,28,0,0
1322592,91,4,1922,6,"female",1558,179,97,1,2,0,0,1,2
1322619,20,28,1993,8,"male",297,35,19,0,12,0,7,0,5
1322633,19,1,1994,1,"male",72,10,8,11,0,11,0,0,0
1322638,22,3,1991,8,"male",53,215,207,170,281,73,115,97,166
1322641,39,3,1974,3,"male",274,4,3,5,3,5,3,0,0
1322650,21,1,1992,1,"male",168,57,49,0,75,0,34,0,41
1322659,21,5,1992,5,"male",325,310,275,12,14,12,13,0,1
1322684,25,3,1988,1,"male",1267,84,34,2,1,2,1,0,0
1322694,24,10,1989,10,"male",779,122,85,90,103,90,36,0,67
1322697,30,11,1983,2,"female",609,99,35,172,25,172,10,0,15
1322713,108,4,1905,7,"male",1127,180,133,32,90,30,80,2,10
1322716,56,20,1957,5,"female",424,57,39,25,28,25,15,0,13
1322722,23,7,1990,6,"female",277,72,22,0,0,0,0,0,0
1322740,46,19,1967,5,"male",526,13,3,0,8,0,5,0,3
1322756,16,1,1997,2,"female",293,40,33,608,26,527,14,81,12
1322783,24,7,1989,4,"female",772,428,197,575,200,575,122,0,78
1322797,23,1,1990,11,"male",678,164,130,13,12,13,11,0,1
1322798,25,17,1988,4,"male",257,31,8,0,0,0,0,0,0
1322829,25,25,1988,12,"male",532,91,52,45,81,45,72,0,9
1322873,18,26,1995,6,"female",892,601,556,243,119,9,33,234,86
1322890,22,13,1991,9,"male",214,199,58,6,0,1,0,5,0
1322909,90,6,1923,12,"male",1127,252,211,124,29,0,16,124,13
1322915,25,25,1988,11,"male",370,55,43,0,0,0,0,0,0
1322919,18,23,1995,12,"female",508,3917,1872,3664,3058,3228,2349,436,709
1322925,42,8,1971,1,"male",388,106,87,0,9,0,6,0,3
1322931,49,5,1964,9,"male",81,28,15,51,43,5,20,46,23
1322944,23,31,1990,12,"male",286,273,219,151,59,151,55,0,4
1322959,21,5,1992,5,"male",502,373,320,43,41,43,38,0,3
1322986,23,29,1990,11,"female",674,1251,449,187,877,187,636,0,241
1323001,14,17,1999,3,"female",241,112,69,80,44,76,38,4,6
1323014,103,12,1910,1,"female",1208,370,272,150,45,125,12,25,33
1323022,17,2,1996,1,"female",531,0,0,0,0,0,0,0,0
1323025,102,1,1911,1,"male",1246,637,533,70,44,70,35,0,9
1323044,27,2,1986,9,"male",643,72,64,3,11,3,8,0,3
1323059,21,13,1992,11,"male",207,146,18,4,14,4,12,0,2
1323067,46,6,1967,9,"female",546,190,168,793,448,791,340,2,108
1323068,27,29,1986,12,"male",518,279,7,0,0,0,0,0,0
1323078,25,1,1988,1,"male",244,1,0,0,0,0,0,0,0
1323079,43,8,1970,5,"male",990,54,45,0,3,0,2,0,1
1323085,18,27,1995,9,"male",730,579,407,368,155,368,120,0,35
1323158,40,16,1973,8,"male",408,55,43,63,6,39,3,24,3
1323185,62,17,1951,10,"female",1595,405,284,94,167,62,76,32,91
1323189,29,6,1984,3,"female",86,120,115,33,7,33,6,0,1
1323196,23,18,1990,5,"female",716,146,94,37,39,27,21,10,18
1323200,14,20,1999,8,"male",350,397,275,353,178,287,74,66,104
1323214,19,4,1994,12,"female",231,55,15,0,0,0,0,0,0
1323258,21,8,1992,11,"female",526,122,96,87,33,61,21,26,12
1323281,56,23,1957,6,"female",1348,44,20,5,47,4,24,1,23
1323308,21,25,1992,7,"female",317,43,6,0,0,0,0,0,0
1323326,28,1,1985,1,"male",27,13,11,1,0,1,0,0,0
1323371,56,9,1957,1,"female",1246,331,239,1653,544,1653,239,0,305
1323401,60,6,1953,11,"female",300,20,9,103,12,103,11,0,1
1323415,25,2,1988,1,"male",244,47,22,24,0,24,0,0,0
1323441,46,8,1967,11,"female",302,5,2,272,86,13,11,259,75
1323474,54,28,1959,12,"male",1034,19,6,0,0,0,0,0,0
1323503,30,21,1983,9,"male",215,326,304,4,15,4,7,0,8
1323518,16,15,1997,1,"male",232,82,56,4,1,4,0,0,1
1323520,18,17,1995,6,"female",613,1211,718,3842,1150,3777,763,65,387
1323631,44,28,1969,2,"male",743,28,18,30,5,30,3,0,2
1323658,66,1,1947,7,"female",599,37,16,94,21,81,15,13,6
1323665,53,9,1960,10,"female",1921,143,26,75,150,75,137,0,13
1323668,13,6,2000,2,"male",78,135,112,42,32,29,17,13,15
1323690,44,8,1969,6,"female",474,30,19,83,31,25,9,58,22
1323700,108,24,1905,10,"male",1363,253,162,50,44,1,19,49,25
1323702,16,16,1997,5,"male",399,532,305,221,420,62,218,159,202
1323717,52,2,1961,1,"female",878,107,74,131,121,0,37,131,84
1323737,19,1,1994,1,"male",671,54,23,5,10,5,9,0,1
1323740,72,15,1941,9,"female",317,60,42,442,218,363,84,79,134
1323743,20,6,1993,9,"male",388,118,63,24,4,0,1,24,3
1323754,66,23,1947,8,"female",963,42,20,1,43,0,29,1,14
1323763,23,3,1990,10,"male",569,19,7,0,0,0,0,0,0
1323771,50,21,1963,6,"female",614,82,54,230,319,0,51,230,268
1323772,35,1,1978,10,"female",437,92,55,16,5,0,0,16,5
1323778,23,19,1990,6,"male",216,25,4,0,0,0,0,0,0
1323822,34,5,1979,5,"male",300,137,77,0,33,0,17,0,16
1323848,46,13,1967,8,"male",400,92,66,0,0,0,0,0,0
1323862,34,4,1979,5,"female",349,911,38,3722,1091,3722,947,0,144
1323868,22,25,1991,11,"female",790,196,161,596,455,446,306,150,149
1323920,21,23,1992,1,"female",447,64,45,93,41,93,36,0,5
1323932,72,11,1941,7,"female",659,39,22,0,0,0,0,0,0
1323933,51,18,1962,2,"female",137,61,41,746,516,746,262,0,254
1323964,14,3,1999,6,"male",132,42,17,0,11,0,9,0,2
1323979,61,7,1952,4,"female",257,78,53,19,29,0,9,19,20
1323987,25,1,1988,1,"male",66,0,0,0,0,0,0,0,0
1324012,23,11,1990,10,"male",285,4478,275,1154,4371,426,3563,728,808
1324024,76,17,1937,1,"female",410,66,42,6,1,6,1,0,0
1324029,19,10,1994,1,"female",347,488,363,420,468,91,93,329,375
1324072,21,20,1992,10,"female",257,282,134,79,21,79,6,0,15
1324078,69,8,1944,5,"female",1733,182,87,60,73,32,34,28,39
1324082,49,9,1964,8,"female",306,81,59,134,23,62,21,72,2
1324100,17,20,1996,8,"male",270,148,116,2,0,2,0,0,0
1324126,44,1,1969,1,"male",512,5,3,0,0,0,0,0,0
1324131,30,12,1983,3,"female",1432,24,11,9,185,9,20,0,165
1324144,52,2,1961,5,"male",500,77,46,0,1,0,1,0,0
1324197,15,15,1998,2,"female",21,11,7,1,18,1,15,0,3
1324198,26,24,1987,9,"male",622,143,98,0,0,0,0,0,0
1324222,53,23,1960,10,"male",215,9,7,0,0,0,0,0,0
1324232,70,15,1943,1,"male",372,0,0,0,0,0,0,0,0
1324246,32,13,1981,12,"male",675,20,11,0,0,0,0,0,0
1324249,33,26,1980,5,"female",95,68,53,9,32,9,21,0,11
1324256,51,2,1962,5,"male",520,0,0,0,0,0,0,0,0
1324261,17,9,1996,9,"male",456,1124,1015,77,186,0,164,77,22
1324288,16,3,1997,9,"female",367,65,28,0,0,0,0,0,0
1324292,19,11,1994,7,"male",167,66,58,22,27,22,17,0,10
1324327,42,26,1971,5,"male",841,197,179,19,0,19,0,0,0
1324350,47,26,1966,4,"female",468,32,24,20,1,20,1,0,0
1324352,30,2,1983,1,"male",190,74,65,1,2,1,1,0,1
1324362,26,27,1987,7,"female",280,161,122,2,7,2,7,0,0
1324392,22,24,1991,2,"female",1841,993,375,635,865,593,399,42,466
1324403,65,31,1948,7,"female",235,3,1,0,0,0,0,0,0
1324404,46,8,1967,9,"female",1701,599,306,107,94,106,54,1,40
1324430,103,16,1910,10,"female",1239,177,83,10,7,10,7,0,0
1324465,30,26,1983,9,"male",536,196,154,25,32,3,16,22,16
1324512,53,15,1960,6,"female",659,259,150,0,1,0,1,0,0
1324525,18,12,1995,5,"male",660,148,68,0,1,0,1,0,0
1324529,19,27,1994,2,"male",419,233,134,161,3,161,1,0,2
1324535,19,13,1994,12,"female",779,400,188,80,219,30,100,50,119
1324536,26,4,1987,1,"male",495,157,85,45,25,44,13,1,12
1324538,108,28,1905,11,"male",11,172,138,28,64,0,17,28,47
1324549,25,1,1988,1,"male",89,28,19,86,40,86,30,0,10
1324577,57,17,1956,3,"male",53,414,333,1006,426,1006,291,0,135
1324664,34,29,1979,12,"female",242,417,97,156,86,156,68,0,18
1324668,92,1,1921,6,"female",1624,2022,619,350,114,8,35,342,79
1324677,108,5,1905,9,"female",18,8,6,1,0,1,0,0,0
1324707,53,6,1960,10,"male",305,12,12,0,0,0,0,0,0
1324738,47,5,1966,4,"male",788,28,11,20,3,20,1,0,2
1324783,53,14,1960,7,"female",488,57,34,46,5,11,3,35,2
1324794,29,4,1984,2,"male",239,16,12,0,0,0,0,0,0
1324795,36,22,1977,1,"male",146,66,56,16,35,16,33,0,2
1324817,20,15,1993,12,"female",608,247,203,354,325,291,205,63,120
1324818,30,26,1983,10,"female",572,166,87,416,188,404,80,12,108
1324836,26,2,1987,11,"female",1312,550,214,9,207,8,122,1,85
1324841,26,17,1987,2,"female",430,46,18,30,60,30,21,0,39
1324849,25,24,1988,3,"male",640,1,1,0,0,0,0,0,0
1324853,23,25,1990,6,"male",325,6,2,72,7,2,0,70,7
1324857,24,8,1989,6,"female",531,113,67,12,156,12,133,0,23
1324869,27,14,1986,6,"female",257,129,100,6,17,6,17,0,0
1324877,35,3,1978,5,"female",532,60,39,220,34,204,33,16,1
1324879,93,23,1920,10,"male",1653,779,384,115,164,0,55,115,109
1324890,95,12,1918,4,"male",525,271,240,182,113,50,53,132,60
1324917,22,9,1991,7,"female",772,88,13,0,15,0,11,0,4
1324926,103,20,1910,1,"male",1150,265,232,34,8,34,6,0,2
1324983,22,16,1991,1,"male",714,194,112,41,2,39,2,2,0
1324989,38,12,1975,3,"female",408,105,64,32,25,32,21,0,4
1325058,18,13,1995,12,"female",326,627,399,755,1762,672,1008,83,754
1325087,40,10,1973,11,"male",305,103,94,176,37,176,29,0,8
1325104,34,3,1979,9,"female",1415,278,47,200,62,200,46,0,16
1325105,18,12,1995,5,"male",396,345,125,46,52,24,25,22,27
1325128,103,22,1910,5,"female",3128,4658,972,929,2756,929,1193,0,1563
1325155,55,23,1958,3,"female",40,38,30,298,218,0,55,298,163
1325167,28,12,1985,8,"male",297,35,28,0,0,0,0,0,0
1325187,103,3,1910,3,"male",575,473,388,89,10,73,6,16,4
1325215,24,4,1989,8,"female",384,277,88,0,5,0,5,0,0
1325216,23,25,1990,11,"female",212,90,77,155,67,147,29,8,38
1325223,65,17,1948,5,"male",310,7,5,284,50,284,32,0,18
1325226,30,26,1983,9,"female",659,779,408,801,1467,98,539,703,928
1325233,18,12,1995,12,"male",249,41,29,31,38,29,24,2,14
1325246,18,13,1995,5,"male",329,108,16,688,7,615,5,73,2
1325297,47,7,1966,6,"female",369,39,28,827,288,0,62,827,226
1325323,26,12,1987,3,"male",483,14,11,0,2,0,2,0,0
1325332,17,12,1996,9,"male",569,159,81,1256,59,0,31,1256,28
1325352,22,29,1991,3,"male",228,23,20,12,7,12,5,0,2
1325379,23,11,1990,1,"male",514,212,124,4,22,4,10,0,12
1325400,18,10,1995,7,"female",200,226,26,1,49,1,15,0,34
1325412,20,22,1993,8,"male",1138,463,259,80,106,80,92,0,14
1325421,23,15,1990,8,"female",307,140,50,529,148,494,132,35,16
1325458,22,26,1991,9,"male",507,72,42,3,0,0,0,3,0
1325463,61,16,1952,9,"female",109,67,54,108,35,108,22,0,13
1325490,21,17,1992,7,"female",210,23,23,23,6,12,5,11,1
1325494,16,9,1997,1,"male",789,167,75,3,0,3,0,0,0
1325501,16,2,1997,5,"male",446,421,407,0,1,0,1,0,0
1325511,28,12,1985,12,"male",205,14,12,9,0,9,0,0,0
1325534,102,26,1911,12,"female",603,66,44,3,21,3,19,0,2
1325536,19,26,1994,9,"female",213,59,18,2157,501,197,156,1960,345
1325538,23,13,1990,8,"male",548,229,188,34,37,34,10,0,27
1325562,17,4,1996,1,"male",559,116,55,96,92,96,43,0,49
1325570,102,1,1911,1,"female",2360,121,115,277,247,78,138,199,109
1325575,47,13,1966,6,"male",718,28,14,77,0,54,0,23,0
1325579,25,26,1988,4,"male",166,94,21,0,0,0,0,0,0
1325584,19,21,1994,6,"male",304,14,9,10,1,10,1,0,0
1325592,23,25,1990,1,"male",374,62,53,0,3,0,2,0,1
1325603,15,15,1998,1,"female",53,86,72,3,3,3,3,0,0
1325639,23,9,1990,9,"male",146,45,24,3,1,3,1,0,0
1325722,30,12,1983,8,"female",1807,207,138,27,23,27,9,0,14
1325725,24,11,1989,11,"male",754,97,58,0,16,0,10,0,6
1325729,40,5,1973,6,"male",1058,22,1,2,1,2,1,0,0
1325732,18,5,1995,1,"male",50,38,20,0,8,0,4,0,4
1325740,18,27,1995,1,"female",702,1591,1027,345,223,345,216,0,7
1325780,56,17,1957,12,"female",395,35,15,0,1,0,1,0,0
1325815,36,4,1977,2,"male",502,43,21,0,6,0,6,0,0
1325819,27,8,1986,10,"male",654,124,92,0,1,0,0,0,1
1325828,16,7,1997,7,"male",236,2,2,0,0,0,0,0,0
1325832,23,4,1990,3,"female",67,1,1,0,0,0,0,0,0
1325836,27,16,1986,9,"male",5,32,24,0,9,0,0,0,9
1325840,99,2,1914,2,"male",221,1085,658,22,5,4,2,18,3
1325842,32,25,1981,6,"female",707,16,8,0,0,0,0,0,0
1325855,30,29,1983,3,"male",741,35,27,2,0,2,0,0,0
1325870,33,25,1980,7,"male",115,3,3,0,2,0,1,0,1
1325886,103,2,1910,2,"female",864,359,88,40,40,40,32,0,8
1325888,19,17,1994,5,"male",689,13,8,0,0,0,0,0,0
1325920,103,26,1910,4,"female",698,155,117,8,5,8,3,0,2
1325922,17,1,1996,3,"male",236,65,57,115,22,114,15,1,7
1325929,103,24,1910,8,"male",237,75,63,9,5,9,3,0,2
1325932,64,14,1949,5,"female",1537,96,68,55,87,49,62,6,25
1325951,48,26,1965,1,"male",950,61,29,16,2,0,0,16,2
1325952,20,18,1993,8,"male",211,171,127,7,3,7,2,0,1
1325957,23,28,1990,4,"male",818,296,127,0,5,0,2,0,3
1325969,19,30,1994,3,"male",370,153,121,10,15,10,12,0,3
1325973,17,24,1996,10,"male",184,32,22,0,0,0,0,0,0
1325985,15,30,1998,8,"female",223,433,285,643,197,614,68,29,129
1325989,45,15,1968,2,"male",581,3,1,0,1,0,0,0,1
1325993,19,10,1994,11,"female",244,86,33,70,5,70,5,0,0
1325996,26,1,1987,1,"male",357,60,23,5,48,5,46,0,2
1326001,108,12,1905,12,"female",1351,47,24,4,1,4,0,0,1
1326008,19,15,1994,9,"male",5,136,124,215,37,215,27,0,10
1326009,57,7,1956,11,"female",67,12,8,3,6,0,0,3,6
1326014,47,3,1966,10,"female",335,31,23,0,2,0,1,0,1
1326030,23,1,1990,1,"male",336,23,17,20,0,20,0,0,0
1326032,19,9,1994,6,"male",452,873,569,9,311,9,170,0,141
1326042,21,15,1992,11,"male",380,97,55,44,9,44,5,0,4
1326087,23,23,1990,7,"female",499,80,53,0,2,0,1,0,1
1326111,29,17,1984,1,"female",123,85,63,90,69,85,40,5,29
1326123,28,15,1985,5,"male",508,66,48,0,0,0,0,0,0
1326129,55,13,1958,10,"male",283,25,19,13,9,0,2,13,7
1326140,20,9,1993,10,"male",100,97,86,2,4,2,4,0,0
1326168,100,6,1913,1,"male",1238,190,143,7,18,0,9,7,9
1326174,24,1,1989,5,"male",662,406,145,97,102,97,85,0,17
1326212,23,11,1990,3,"male",341,59,30,2,8,1,7,1,1
1326217,24,29,1989,6,"male",41,41,21,56,38,41,25,15,13
1326227,19,14,1994,11,"male",356,216,88,5,0,5,0,0,0
1326275,16,27,1997,12,"female",586,311,122,323,578,265,432,58,146
1326304,56,13,1957,3,"male",2097,55,11,5,0,5,0,0,0
1326312,69,18,1944,8,"female",179,52,21,0,0,0,0,0,0
1326313,19,12,1994,7,"male",624,571,278,511,207,153,107,358,100
1326327,20,23,1993,11,"male",506,452,312,167,166,167,130,0,36
1326368,18,18,1995,12,"female",104,100,66,36,24,32,12,4,12
1326389,60,25,1953,6,"male",635,35,16,32,9,0,4,32,5
1326398,33,27,1980,10,"male",266,4792,42,177,1052,153,639,24,413
1326429,55,24,1958,8,"male",909,23,17,0,1,0,1,0,0
1326442,90,19,1923,2,"male",805,18,16,0,2,0,1,0,1
1326471,51,22,1962,7,"female",216,25,22,1464,78,0,5,1464,73
1326486,51,1,1962,12,"female",169,157,123,725,104,725,74,0,30
1326487,17,17,1996,11,"male",484,125,115,0,0,0,0,0,0
1326492,23,25,1990,11,"male",639,180,105,19,57,19,56,0,1
1326512,22,2,1991,7,"female",260,56,14,0,1,0,1,0,0
1326567,26,17,1987,4,"male",398,25,22,1,0,1,0,0,0
1326622,19,20,1994,8,"female",156,212,117,280,269,263,56,17,213
1326672,69,20,1944,5,"female",696,384,210,56,7,40,2,16,5
1326675,57,30,1956,3,"female",1349,90,38,179,212,174,55,5,157
1326682,75,22,1938,4,"male",221,111,87,105,12,0,2,105,10
1326690,24,29,1989,8,"male",33,12,9,2,5,2,5,0,0
1326691,18,1,1995,3,"female",420,12,8,0,0,0,0,0,0
1326696,21,24,1992,10,"male",292,72,67,11,2,2,0,9,2
1326737,49,11,1964,9,"female",2266,221,106,189,190,189,170,0,20
1326760,19,20,1994,10,"male",403,456,309,20,15,2,9,18,6
1326779,20,23,1993,5,"male",209,169,107,205,2,0,1,205,1
1326786,20,31,1993,5,"female",81,62,50,74,44,65,28,9,16
1326797,26,30,1987,10,"female",62,74,52,2,0,2,0,0,0
1326807,20,6,1993,10,"female",244,161,40,112,34,112,23,0,11
1326824,17,17,1996,3,"male",214,36,35,0,5,0,5,0,0
1326890,27,5,1986,3,"male",253,202,145,367,439,366,109,1,330
1326908,54,10,1959,8,"male",539,167,109,44,43,44,32,0,11
1326914,63,1,1950,1,"male",129,39,32,659,421,1,221,658,200
1326919,51,27,1962,9,"male",921,25,5,2,2,2,2,0,0
1326921,28,3,1985,9,"female",297,277,253,404,239,295,102,109,137
1326946,24,23,1989,1,"female",737,130,59,543,315,540,191,3,124
1326955,16,9,1997,8,"female",314,60,25,271,234,112,115,159,119
1326968,17,26,1996,2,"male",1172,229,196,10,5,10,4,0,1
1326984,18,22,1995,10,"female",503,107,46,0,5,0,2,0,3
1327005,46,2,1967,4,"male",334,0,0,0,0,0,0,0,0
1327006,103,27,1910,5,"male",632,360,62,20,6,20,6,0,0
1327012,68,10,1945,5,"female",130,102,87,220,238,220,229,0,9
1327016,27,8,1986,3,"male",110,11,11,0,1,0,0,0,1
1327078,50,3,1963,6,"male",235,1,0,0,0,0,0,0,0
1327108,23,11,1990,2,"male",631,1,1,0,0,0,0,0,0
1327180,41,14,1972,7,"female",657,32,16,7,2,0,1,7,1
1327183,71,1,1942,4,"female",1545,14,5,33,1,0,0,33,1
1327219,19,6,1994,9,"male",750,249,105,31,1,31,1,0,0
1327229,14,21,1999,12,"female",243,130,76,20,0,13,0,7,0
1327230,17,1,1996,3,"male",56,42,30,0,0,0,0,0,0
1327267,21,9,1992,10,"male",515,221,197,0,6,0,3,0,3
1327276,45,22,1968,2,"male",152,7,7,4,2,4,1,0,1
1327293,34,22,1979,3,"male",370,3,1,0,0,0,0,0,0
1327307,77,26,1936,4,"female",1064,173,143,50,21,46,13,4,8
1327313,108,4,1905,10,"male",1778,661,487,18,19,16,11,2,8
1327349,70,8,1943,11,"female",370,8,5,67,0,66,0,1,0
1327351,93,1,1920,7,"female",704,185,113,250,17,250,9,0,8
1327354,33,1,1980,1,"male",167,16,9,0,2,0,1,0,1
1327374,44,1,1969,3,"male",576,25,16,0,0,0,0,0,0
1327383,16,17,1997,8,"male",412,126,76,37,0,0,0,37,0
1327384,36,24,1977,1,"male",439,149,91,0,2,0,2,0,0
1327406,16,1,1997,1,"male",571,177,105,1,1,1,0,0,1
1327412,50,4,1963,2,"male",143,28,27,5,0,0,0,5,0
1327414,13,1,2000,1,"male",244,3,2,0,0,0,0,0,0
1327460,14,7,1999,11,"female",159,43,4,2,1,0,1,2,0
1327474,21,16,1992,7,"female",209,82,25,26,18,26,18,0,0
1327479,35,2,1978,2,"male",263,1,0,0,0,0,0,0,0
1327493,31,4,1982,4,"female",538,15,11,0,3,0,2,0,1
1327517,32,26,1981,11,"male",511,269,181,61,14,0,2,61,12
1327533,27,30,1986,5,"female",374,144,96,15,25,13,23,2,2
1327535,47,5,1966,4,"female",286,10,5,0,2,0,0,0,2
1327591,20,31,1993,10,"male",843,110,83,0,1,0,1,0,0
1327592,63,17,1950,7,"female",550,66,43,77,15,41,7,36,8
1327599,32,9,1981,1,"male",1367,538,520,0,1,0,0,0,1
1327650,22,19,1991,1,"female",597,271,173,0,15,0,13,0,2
1327651,32,23,1981,12,"male",630,86,53,0,1,0,1,0,0
1327677,19,20,1994,7,"male",408,2,1,3,12,3,6,0,6
1327679,29,20,1984,1,"female",469,12,6,0,0,0,0,0,0
1327688,21,9,1992,7,"female",1218,1704,372,1316,1872,1301,1617,15,255
1327689,36,20,1977,4,"female",263,118,71,0,2,0,2,0,0
1327690,42,9,1971,4,"male",701,1,0,0,0,0,0,0,0
1327709,23,11,1990,3,"male",325,90,56,16,15,16,8,0,7
1327720,30,13,1983,1,"male",481,237,168,1,4,1,3,0,1
1327726,41,18,1972,12,"male",120,68,65,65,5,0,3,65,2
1327738,41,14,1972,12,"male",520,19,12,7,4,0,3,7,1
1327744,37,6,1976,11,"male",10,0,0,0,0,0,0,0,0
1327753,29,20,1984,5,"female",574,91,84,11,8,11,8,0,0
1327758,103,5,1910,7,"male",1369,584,314,0,1,0,0,0,1
1327759,53,26,1960,8,"female",555,114,68,717,450,0,68,717,382
1327772,19,3,1994,3,"female",722,1787,519,16,92,14,78,2,14
1327779,18,29,1995,12,"male",174,305,237,107,339,107,269,0,70
1327780,100,7,1913,6,"female",465,96,49,17,9,17,9,0,0
1327800,36,4,1977,8,"male",704,66,45,115,129,0,15,115,114
1327814,27,28,1986,5,"male",398,103,67,142,145,114,116,28,29
1327830,30,26,1983,3,"female",124,9,4,23,12,23,2,0,10
1327832,103,14,1910,5,"male",986,1191,760,172,62,172,56,0,6
1327846,22,4,1991,9,"male",37,88,64,19,18,19,14,0,4
1327875,26,1,1987,1,"male",325,30,26,0,0,0,0,0,0
1327892,19,1,1994,12,"male",674,269,160,80,43,63,33,17,10
1327898,29,6,1984,8,"male",248,4,2,0,0,0,0,0,0
1327912,15,19,1998,12,"female",41,27,24,220,211,8,101,212,110
1327928,26,23,1987,3,"male",642,329,203,2,111,1,74,1,37
1327937,25,4,1988,12,"female",72,254,232,497,217,497,198,0,19
1327965,22,9,1991,11,"male",1198,490,359,10,9,6,5,4,4
1327975,63,1,1950,8,"female",1479,350,260,21,152,0,64,21,88
1327978,46,5,1967,10,"male",663,666,414,88,248,82,207,6,41
1327984,106,8,1907,6,"male",1284,399,218,2,0,0,0,2,0
1328023,52,28,1961,8,"male",346,56,40,3,10,3,10,0,0
1328028,64,19,1949,4,"male",669,7,7,1,1,0,0,1,1
1328049,27,11,1986,12,"female",302,126,81,82,172,50,80,32,92
1328052,30,11,1983,11,"male",88,63,59,3,0,3,0,0,0
1328061,84,26,1929,10,"female",934,44,34,117,24,0,21,117,3
1328068,22,29,1991,10,"male",115,1,0,4,1,4,0,0,1
1328088,32,27,1981,4,"male",669,137,115,49,70,41,41,8,29
1328159,18,22,1995,2,"male",24,29,10,7,17,6,7,1,10
1328204,62,27,1951,3,"female",195,31,19,50,3,50,1,0,2
1328216,63,31,1950,3,"female",2368,228,70,154,147,154,84,0,63
1328221,23,7,1990,11,"female",163,166,133,35,12,31,11,4,1
1328234,21,26,1992,7,"male",432,13,12,0,0,0,0,0,0
1328251,14,26,1999,7,"male",148,311,284,3,0,3,0,0,0
1328253,19,1,1994,7,"male",727,24,18,3,8,3,3,0,5
1328266,25,26,1988,6,"female",446,7,5,0,2,0,0,0,2
1328268,20,6,1993,6,"male",19,79,50,31,49,31,47,0,2
1328270,65,31,1948,8,"male",1602,75,35,80,274,15,60,65,214
1328285,57,9,1956,7,"female",835,102,56,163,179,163,139,0,40
1328292,17,31,1996,8,"female",494,191,65,322,201,322,160,0,41
1328342,18,1,1995,1,"female",819,74,52,1,1,1,1,0,0
1328358,63,22,1950,7,"female",671,164,154,0,0,0,0,0,0
1328368,53,20,1960,9,"female",112,22,21,1,5,0,1,1,4
1328385,25,16,1988,8,"male",732,137,89,20,3,20,2,0,1
1328388,20,4,1993,6,"male",56,150,149,12,15,12,5,0,10
1328409,56,8,1957,10,"female",80,17,13,8,0,0,0,8,0
1328420,14,16,1999,6,"female",411,165,142,1,112,1,28,0,84
1328445,26,10,1987,9,"female",57,71,6,0,0,0,0,0,0
1328483,15,27,1998,10,"male",568,331,218,134,74,84,48,50,26
1328534,23,17,1990,7,"male",300,201,95,0,0,0,0,0,0
1328549,17,9,1996,2,"female",263,88,55,1608,48,708,14,900,34
1328566,36,16,1977,9,"male",192,1,0,0,0,0,0,0,0
1328591,70,27,1943,12,"male",815,20,10,0,0,0,0,0,0
1328592,27,7,1986,4,"male",136,99,62,115,32,113,15,2,17
1328600,20,3,1993,3,"male",652,80,37,61,27,61,24,0,3
1328611,49,17,1964,10,"male",479,323,231,33,57,0,16,33,41
1328660,21,14,1992,10,"male",362,962,772,105,116,103,103,2,13
1328683,20,19,1993,1,"female",64,18,17,265,224,107,62,158,162
1328702,26,10,1987,5,"male",267,83,73,2,0,2,0,0,0
1328704,15,23,1998,4,"male",286,88,78,15,0,15,0,0,0
1328708,18,27,1995,11,"female",361,33,19,24,18,11,4,13,14
1328721,35,10,1978,11,"female",548,673,157,166,527,98,191,68,336
1328735,48,2,1965,12,"female",532,57,30,211,31,211,20,0,11
1328739,23,9,1990,1,"female",709,2015,707,890,1470,214,321,676,1149
1328748,32,5,1981,7,"female",254,30,16,14,5,14,3,0,2
1328751,33,25,1980,3,"male",580,29,18,0,2,0,1,0,1
1328776,19,2,1994,5,"female",245,29,18,157,48,0,1,157,47
1328786,63,11,1950,7,"male",1111,45,21,40,88,22,49,18,39
1328799,47,24,1966,6,"female",756,62,26,9,18,9,11,0,7
1328826,67,24,1946,12,"female",986,52,26,55,45,55,39,0,6
1328830,36,2,1977,2,"female",285,92,49,68,92,0,7,68,85
1328833,48,3,1965,7,"female",803,3,1,0,0,0,0,0,0
1328840,15,6,1998,12,"male",182,85,75,67,5,67,3,0,2
1328873,16,19,1997,8,"female",349,427,336,199,126,199,105,0,21
1328875,17,20,1996,9,"female",431,329,66,0,0,0,0,0,0
1328878,35,1,1978,11,"male",242,60,26,14,11,13,6,1,5
1328890,27,7,1986,11,"female",494,388,269,5016,2052,4957,1565,59,487
1328907,83,25,1930,6,"male",1732,192,82,3,3,3,2,0,1
1328910,62,25,1951,11,"female",1675,21,6,0,0,0,0,0,0
1328975,33,24,1980,10,"male",199,11,5,0,1,0,1,0,0
1328978,56,6,1957,2,"female",515,64,53,13,36,13,16,0,20
1328984,18,26,1995,2,"female",667,2200,1044,1,4,1,1,0,3
1328988,19,1,1994,3,"male",88,9,3,0,0,0,0,0,0
1329014,25,1,1988,1,"female",288,79,25,300,39,300,16,0,23
1329055,27,1,1986,7,"female",199,452,316,41,20,41,12,0,8
1329065,18,4,1995,6,"female",163,152,125,43,71,24,49,19,22
1329073,102,18,1911,11,"male",1205,58,47,0,0,0,0,0,0
1329105,93,30,1920,12,"male",730,702,291,74,63,40,30,34,33
1329126,108,16,1905,2,"female",1053,393,120,98,126,98,123,0,3
1329175,25,22,1988,3,"male",364,22,20,14,1,0,0,14,1
1329179,50,30,1963,11,"female",1869,1019,591,273,242,260,143,13,99
1329210,25,12,1988,1,"male",226,23,19,3,0,2,0,1,0
1329236,40,11,1973,8,"female",278,54,36,38,10,38,1,0,9
1329287,62,10,1951,5,"male",445,66,63,0,1,0,1,0,0
1329296,40,3,1973,9,"male",184,38,29,0,1,0,1,0,0
1329302,67,3,1946,9,"female",1185,65,36,319,130,16,62,303,68
1329306,27,23,1986,11,"female",411,43,34,12,23,9,7,3,16
1329349,23,1,1990,1,"male",70,40,24,8,2,8,2,0,0
1329365,18,14,1995,5,"male",120,64,26,0,0,0,0,0,0
1329387,23,1,1990,12,"female",105,3,2,17,7,5,7,12,0
1329402,22,9,1991,8,"male",673,59,52,6,0,0,0,6,0
1329403,23,24,1990,5,"male",520,148,57,36,50,36,40,0,10
1329435,103,3,1910,6,"male",323,157,112,21,28,21,27,0,1
1329467,60,2,1953,4,"female",1013,165,101,94,59,93,12,1,47
1329503,33,2,1980,4,"male",568,83,67,77,27,13,24,64,3
1329507,19,3,1994,10,"female",460,114,82,250,149,220,121,30,28
1329519,20,1,1993,1,"male",291,78,56,0,0,0,0,0,0
1329526,19,12,1994,4,"female",250,241,151,14,11,14,9,0,2
1329602,28,25,1985,5,"male",408,36,33,0,0,0,0,0,0
1329606,49,3,1964,9,"female",355,82,62,4,20,2,12,2,8
1329611,17,27,1996,2,"female",224,69,46,8,10,8,10,0,0
1329618,19,14,1994,5,"male",499,11,3,0,1,0,1,0,0
1329650,23,5,1990,6,"male",184,106,52,37,64,37,61,0,3
1329661,56,25,1957,12,"male",1199,101,29,33,67,33,36,0,31
1329665,42,5,1971,1,"male",277,85,64,212,25,11,5,201,20
1329668,112,1,1901,1,"male",1760,34,13,0,0,0,0,0,0
1329670,53,22,1960,11,"female",269,19,2,0,2,0,0,0,2
1329673,40,17,1973,10,"female",374,3,1,2,1,0,1,2,0
1329702,56,11,1957,12,"female",866,81,59,1,1,1,1,0,0
1329711,69,25,1944,6,"female",590,58,25,43,254,14,55,29,199
1329729,72,30,1941,9,"male",2233,69,12,1,1,0,0,1,1
1329733,26,25,1987,6,"male",269,5,4,0,0,0,0,0,0
1329736,26,29,1987,3,"male",431,185,154,2,11,2,11,0,0
1329738,15,1,1998,1,"male",21,72,68,5,13,5,7,0,6
1329754,23,21,1990,6,"female",227,32,24,0,0,0,0,0,0
1329774,72,2,1941,6,"male",1247,188,124,1477,16,0,2,1477,14
1329799,18,22,1995,5,"male",66,76,72,4,5,4,5,0,0
1329801,24,15,1989,2,"male",405,78,46,10,47,10,29,0,18
1329820,39,8,1974,7,"female",456,40,16,14,4,14,0,0,4
1329834,34,4,1979,11,"female",376,1,1,0,0,0,0,0,0
1329853,20,27,1993,5,"female",90,1,0,0,0,0,0,0,0
1329856,22,24,1991,12,"female",1440,227,76,1,5,1,3,0,2
1329871,84,29,1929,9,"male",1167,540,425,47,13,47,11,0,2
1329874,47,12,1966,10,"male",538,77,40,0,0,0,0,0,0
1329952,16,16,1997,6,"male",146,29,20,1,1,1,1,0,0
1329964,24,11,1989,8,"female",106,22,13,0,0,0,0,0,0
1329969,15,17,1998,9,"male",70,32,14,22,8,22,7,0,1
1329973,33,5,1980,8,"male",131,36,27,1,0,1,0,0,0
1329974,43,16,1970,9,"female",601,86,51,84,21,43,12,41,9
1330013,59,15,1954,2,"female",1523,44,7,7,4,0,3,7,1
1330018,28,14,1985,11,"male",27,2,2,12,4,0,0,12,4
1330021,65,17,1948,3,"male",1522,44,22,3,5,2,1,1,4
1330032,13,30,2000,8,"male",27,5,3,0,0,0,0,0,0
1330044,108,20,1905,12,"male",1300,81,46,0,1,0,0,0,1
1330045,18,20,1995,3,"male",837,385,263,2,3,2,0,0,3
1330050,21,12,1992,7,"female",1433,1007,699,691,395,174,183,517,212
1330065,18,7,1995,1,"male",202,3,0,1,0,0,0,1,0
1330131,103,6,1910,11,"male",671,387,257,60,26,60,25,0,1
1330143,40,1,1973,9,"male",1003,28,8,5,9,5,9,0,0
1330148,60,21,1953,3,"female",589,68,61,5,7,5,7,0,0
1330189,45,10,1968,5,"female",461,19,10,0,3,0,2,0,1
1330218,24,18,1989,7,"male",29,93,90,232,43,145,36,87,7
1330225,73,25,1940,10,"male",773,86,64,14,0,14,0,0,0
1330229,101,23,1912,9,"female",558,108,61,2,7,2,7,0,0
1330300,27,16,1986,11,"female",45,20,20,0,0,0,0,0,0
1330305,19,9,1994,10,"male",460,228,181,5,8,2,6,3,2
1330312,24,3,1989,8,"male",434,19,18,0,1,0,1,0,0
1330350,33,1,1980,1,"male",424,102,88,86,1,75,1,11,0
1330381,19,24,1994,12,"male",554,927,832,0,37,0,15,0,22
1330408,14,4,1999,5,"male",77,12,12,0,0,0,0,0,0
1330421,29,18,1984,5,"male",47,12,5,29,16,29,7,0,9
1330434,18,28,1995,10,"male",23,184,172,456,87,456,82,0,5
1330451,22,26,1991,11,"male",223,51,27,6,4,6,4,0,0
1330483,34,18,1979,10,"female",153,24,13,39,69,39,63,0,6
1330490,29,7,1984,7,"male",444,22,16,120,5,0,2,120,3
1330522,27,15,1986,4,"female",482,59,43,71,6,27,6,44,0
1330527,25,10,1988,8,"male",438,548,473,32,15,32,13,0,2
1330533,18,14,1995,2,"male",262,185,132,15,10,15,10,0,0
1330541,17,20,1996,6,"female",353,204,153,0,0,0,0,0,0
1330554,108,22,1905,8,"male",1477,189,49,66,104,4,22,62,82
1330568,27,3,1986,8,"male",600,119,104,2,0,2,0,0,0
1330569,61,4,1952,11,"male",112,44,30,17,4,17,4,0,0
1330573,20,5,1993,3,"male",661,395,228,111,81,0,13,111,68
1330583,43,2,1970,9,"female",714,431,245,1331,2457,216,642,1115,1815
1330593,40,7,1973,12,"female",174,71,60,521,98,521,76,0,22
1330625,56,28,1957,9,"male",572,80,39,0,0,0,0,0,0
1330628,34,6,1979,6,"male",694,203,126,89,1,89,1,0,0
1330658,22,25,1991,4,"female",254,185,69,3690,3741,744,1914,2946,1827
1330662,61,22,1952,6,"female",379,180,69,146,158,0,45,146,113
1330687,21,8,1992,4,"female",101,9,4,1,0,1,0,0,0
1330688,44,23,1969,9,"male",262,64,38,14,16,0,14,14,2
1330734,16,10,1997,10,"male",279,43,29,3,42,0,21,3,21
1330819,24,23,1989,2,"female",608,242,106,173,148,173,88,0,60
1330824,22,22,1991,9,"male",468,255,242,68,6,23,0,45,6
1330826,33,12,1980,1,"female",528,173,92,481,217,475,134,6,83
1330854,17,3,1996,8,"male",256,46,42,6,3,1,2,5,1
1330893,19,1,1994,1,"male",418,30,18,3,0,3,0,0,0
1330897,52,27,1961,4,"male",30,50,44,31,0,31,0,0,0
1330901,25,1,1988,5,"male",34,36,23,0,0,0,0,0,0
1330910,21,5,1992,12,"female",692,1,0,0,0,0,0,0,0
1330914,29,11,1984,11,"male",182,125,122,45,81,45,71,0,10
1330915,33,15,1980,8,"male",51,23,23,186,59,186,58,0,1
1330929,48,29,1965,10,"male",559,66,43,1,1,1,0,0,1
1330932,60,15,1953,6,"male",256,147,73,0,4,0,4,0,0
1330937,39,15,1974,10,"male",634,59,25,0,0,0,0,0,0
1330939,15,16,1998,11,"male",579,258,183,0,5,0,5,0,0
1330950,18,10,1995,10,"male",532,585,408,0,69,0,55,0,14
1330984,21,20,1992,6,"male",208,173,135,4,3,4,1,0,2
1331000,21,26,1992,11,"female",149,44,32,190,97,187,71,3,26
1331021,19,6,1994,7,"male",643,474,189,0,9,0,9,0,0
1331042,20,15,1993,7,"female",58,53,23,17,19,17,13,0,6
1331047,14,29,1999,7,"male",142,31,29,1,2,1,2,0,0
1331085,19,27,1994,5,"female",605,1357,309,727,932,207,354,520,578
1331100,52,25,1961,2,"female",271,42,32,67,96,55,57,12,39
1331120,35,15,1978,7,"male",413,25,22,190,184,189,167,1,17
1331122,19,5,1994,1,"female",576,233,94,299,91,279,58,20,33
1331128,19,5,1994,4,"female",303,167,77,37,64,37,37,0,27
1331149,19,26,1994,11,"female",273,493,266,140,39,24,23,116,16
1331159,17,5,1996,2,"male",195,63,48,11,3,11,3,0,0
1331161,22,19,1991,10,"male",157,40,34,1,1,1,0,0,1
1331194,13,14,2000,1,"male",299,88,62,13,11,13,8,0,3
1331203,36,25,1977,8,"female",435,74,34,178,24,178,9,0,15
1331204,31,30,1982,6,"male",311,128,117,26,16,26,15,0,1
1331209,42,26,1971,9,"male",265,30,24,0,0,0,0,0,0
1331211,19,1,1994,5,"male",17,67,60,470,547,428,403,42,144
1331214,31,2,1982,4,"male",293,74,26,2,0,2,0,0,0
1331271,20,3,1993,3,"female",636,36,12,0,1,0,1,0,0
1331285,24,4,1989,11,"male",18,9,8,0,0,0,0,0,0
1331286,15,31,1998,3,"male",571,355,197,5,20,5,15,0,5
1331300,25,14,1988,1,"male",431,156,156,0,0,0,0,0,0
1331301,22,22,1991,2,"male",243,180,143,61,120,38,44,23,76
1331307,43,14,1970,12,"male",174,4,3,9,0,0,0,9,0
1331308,20,10,1993,1,"male",879,395,130,263,355,263,331,0,24
1331338,69,13,1944,3,"male",1155,315,131,279,56,0,26,279,30
1331343,24,25,1989,8,"male",418,257,164,10,43,10,31,0,12
1331347,75,1,1938,1,"male",2428,113,6,9,2,9,2,0,0
1331355,54,1,1959,2,"male",313,1,1,1,0,1,0,0,0
1331380,19,10,1994,12,"male",224,162,122,101,58,101,54,0,4
1331420,54,20,1959,4,"male",231,10,5,0,0,0,0,0,0
1331453,19,24,1994,2,"male",334,84,34,18,11,18,10,0,1
1331455,64,31,1949,1,"female",995,220,94,63,452,0,242,63,210
1331457,20,18,1993,3,"female",466,230,36,7,27,5,24,2,3
1331470,21,31,1992,3,"male",536,131,125,114,7,0,0,114,7
1331486,15,9,1998,1,"male",138,26,18,278,1,278,1,0,0
1331499,40,3,1973,9,"female",906,217,155,332,191,332,159,0,32
1331522,17,2,1996,4,"male",330,20,20,0,1,0,1,0,0
1331526,24,7,1989,5,"female",551,270,140,175,315,175,233,0,82
1331531,56,17,1957,11,NA,2011,38,16,296,198,210,76,86,122
1331532,52,23,1961,9,"female",972,123,41,209,12,209,12,0,0
1331534,17,30,1996,7,"female",311,238,188,99,39,99,28,0,11
1331557,41,28,1972,9,"female",505,18,10,0,0,0,0,0,0
1331571,53,12,1960,8,"male",1085,117,58,1,17,1,11,0,6
1331599,51,13,1962,4,"male",222,41,26,2,7,2,5,0,2
1331616,28,3,1985,11,"female",457,19,5,12,1,11,1,1,0
1331627,20,18,1993,6,"female",334,651,83,22,182,19,146,3,36
1331640,62,22,1951,6,"female",592,159,57,95,242,29,88,66,154
1331643,48,24,1965,10,"female",1498,143,66,150,133,150,71,0,62
1331658,57,27,1956,4,"female",388,63,58,285,130,285,80,0,50
1331668,23,27,1990,7,"male",228,334,255,222,32,37,26,185,6
1331695,23,27,1990,8,"male",298,347,234,196,175,196,152,0,23
1331722,16,10,1997,10,"female",301,72,38,47,5,47,4,0,1
1331739,64,19,1949,3,"female",95,14,5,3,5,0,0,3,5
1331754,108,9,1905,2,"male",1408,995,540,14,7,0,7,14,0
1331769,23,14,1990,6,"male",227,47,26,41,34,12,25,29,9
1331774,23,7,1990,11,"male",372,741,517,5438,1438,5438,1183,0,255
1331805,54,25,1959,8,"female",94,34,28,54,10,42,6,12,4
1331845,60,1,1953,1,"male",393,12,12,33,108,0,16,33,92
1331846,60,1,1953,2,"female",474,92,64,0,0,0,0,0,0
1331858,25,20,1988,10,"male",82,1,1,0,0,0,0,0,0
1331870,15,7,1998,10,"male",116,19,12,0,0,0,0,0,0
1331880,16,30,1997,10,"male",496,198,146,3,2,0,2,3,0
1331885,51,7,1962,10,"male",440,6,5,0,0,0,0,0,0
1331924,53,17,1960,2,"male",146,107,73,19,129,19,69,0,60
1331939,62,11,1951,3,"male",1360,95,31,1,2,1,2,0,0
1331987,100,6,1913,3,"male",843,172,84,7,6,7,6,0,0
1331989,21,9,1992,6,"female",264,190,21,5,28,0,4,5,24
1332007,27,2,1986,2,"female",742,15,11,7,0,7,0,0,0
1332018,22,15,1991,5,"female",116,44,17,14,16,14,13,0,3
1332020,31,1,1982,12,"male",406,144,89,33,25,33,5,0,20
1332030,50,24,1963,12,"male",751,76,42,2,4,2,3,0,1
1332058,25,9,1988,4,"male",714,306,252,5,9,5,9,0,0
1332061,17,26,1996,4,"male",716,1219,643,1368,1042,985,720,383,322
1332078,70,26,1943,1,"female",119,21,16,0,1,0,1,0,0
1332086,38,14,1975,7,"female",185,32,18,10,50,10,35,0,15
1332103,113,21,1900,10,"female",1689,155,34,954,448,912,253,42,195
1332134,90,8,1923,12,"male",414,162,118,17,66,17,65,0,1
1332144,15,27,1998,2,"female",496,199,148,1,0,0,0,1,0
1332168,23,19,1990,3,"male",361,122,83,9,1,9,1,0,0
1332182,23,7,1990,7,"male",654,1629,1433,68,46,68,33,0,13
1332208,19,10,1994,12,"male",93,150,91,0,0,0,0,0,0
1332214,23,4,1990,3,"male",864,30,13,0,1,0,1,0,0
1332234,13,23,2000,5,"female",25,0,0,0,0,0,0,0,0
1332237,79,3,1934,9,"female",616,50,23,18,36,0,15,18,21
1332253,18,20,1995,5,"female",282,2,1,0,0,0,0,0,0
1332264,35,2,1978,4,"female",908,129,74,449,83,341,44,108,39
1332266,25,25,1988,5,"male",415,134,115,0,0,0,0,0,0
1332279,103,16,1910,9,"male",433,24,24,204,822,0,177,204,645
1332300,21,5,1992,4,"female",425,245,164,3,77,3,34,0,43
1332307,49,1,1964,8,"male",446,203,161,135,35,92,15,43,20
1332313,46,10,1967,6,"female",275,41,29,12,61,12,55,0,6
1332357,20,19,1993,5,"female",181,230,113,1731,2147,1731,2032,0,115
1332399,64,11,1949,6,"male",1364,95,60,1,1,1,1,0,0
1332401,27,13,1986,5,"female",85,28,18,31,193,31,140,0,53
1332413,39,11,1974,11,"male",169,83,73,0,0,0,0,0,0
1332487,26,15,1987,3,"male",1083,0,0,0,0,0,0,0,0
1332498,45,1,1968,1,"male",346,1,0,0,0,0,0,0,0
1332561,55,10,1958,8,"male",321,679,194,0,158,0,104,0,54
1332582,60,13,1953,2,"female",584,12,0,0,6,0,4,0,2
1332594,45,2,1968,4,"female",259,74,26,497,168,3,7,494,161
1332619,103,19,1910,6,"male",1188,424,199,32,23,22,13,10,10
1332638,27,7,1986,11,"female",139,108,91,7,20,0,4,7,16
1332642,33,6,1980,5,"female",929,15,9,0,0,0,0,0,0
1332654,29,1,1984,10,"female",308,86,44,176,117,1,68,175,49
1332660,44,18,1969,6,"male",519,96,56,13,1,0,1,13,0
1332661,24,2,1989,7,"male",420,147,78,0,0,0,0,0,0
1332672,30,18,1983,11,"male",579,361,338,0,4,0,3,0,1
1332692,17,30,1996,6,"male",143,164,91,8,0,6,0,2,0
1332717,15,8,1998,9,"male",413,331,209,96,1,75,1,21,0
1332728,19,3,1994,11,"male",268,54,48,2,3,0,0,2,3
1332729,14,11,1999,8,"female",101,473,255,862,1320,559,754,303,566
1332761,39,10,1974,7,"male",534,36,31,33,30,32,24,1,6
1332766,43,25,1970,3,"male",181,209,156,227,696,217,353,10,343
1332770,19,27,1994,9,"female",340,884,505,595,727,531,302,64,425
1332792,18,11,1995,3,"male",361,1750,603,6455,5105,359,1529,6096,3576
1332803,28,18,1985,9,"male",501,80,44,26,6,6,1,20,5
1332809,14,16,1999,11,"female",512,224,180,218,6,155,2,63,4
1332821,23,17,1990,6,"male",256,124,14,51,0,0,0,51,0
1332828,17,1,1996,4,"female",219,53,15,0,0,0,0,0,0
1332833,37,4,1976,1,"female",351,4,2,0,0,0,0,0,0
1332867,60,15,1953,1,"female",1526,105,48,156,127,21,65,135,62
1332896,25,23,1988,4,"male",141,19,13,3,2,0,1,3,1
1332900,63,10,1950,1,"male",312,6,4,33,0,28,0,5,0
1332968,21,26,1992,5,"female",351,56,40,40,8,31,1,9,7
1333008,103,31,1910,8,"female",505,1643,609,35,402,25,87,10,315
1333013,43,20,1970,3,"female",231,24,16,6,4,6,3,0,1
1333027,31,9,1982,12,"male",318,193,94,1,68,1,22,0,46
1333028,25,17,1988,8,"female",462,54,48,7,9,7,4,0,5
1333042,21,4,1992,12,"male",262,169,87,136,301,136,245,0,56
1333053,23,30,1990,6,"female",421,113,52,0,2,0,2,0,0
1333077,29,8,1984,4,"female",311,93,49,133,225,26,51,107,174
1333084,108,2,1905,8,"male",1462,384,246,50,60,6,17,44,43
1333092,79,11,1934,5,"female",144,19,9,5,3,0,0,5,3
1333094,24,12,1989,7,"male",187,7,7,1,0,1,0,0,0
1333095,16,16,1997,7,"male",114,12,8,5,1,3,0,2,1
1333104,39,18,1974,2,"male",645,30,28,0,12,0,9,0,3
1333109,25,4,1988,12,"female",278,16,10,17,8,17,8,0,0
1333111,23,13,1990,9,"male",95,25,22,4,2,0,1,4,1
1333120,103,2,1910,2,"male",792,152,105,9,9,2,7,7,2
1333125,101,2,1912,11,"female",995,39,19,5,6,5,5,0,1
1333135,47,12,1966,1,"male",476,50,38,3,0,3,0,0,0
1333148,25,25,1988,3,"female",51,20,14,18,38,18,35,0,3
1333149,24,30,1989,7,"male",313,1,0,0,0,0,0,0,0
1333176,21,18,1992,5,"male",1160,222,130,61,45,61,29,0,16
1333207,20,1,1993,9,"male",117,3,0,2,2,2,2,0,0
1333218,54,3,1959,2,"female",165,31,23,0,0,0,0,0,0
1333221,66,11,1947,10,"female",593,18,12,0,0,0,0,0,0
1333233,18,19,1995,7,"male",293,417,349,40,108,40,73,0,35
1333249,108,9,1905,3,"female",1740,102,50,24,139,12,77,12,62
1333257,23,25,1990,6,"male",688,226,113,1,38,1,29,0,9
1333308,24,5,1989,6,"female",230,15,4,0,0,0,0,0,0
1333343,20,18,1993,11,"male",309,6,6,18,0,13,0,5,0
1333371,28,18,1985,9,"female",408,254,66,30,96,16,33,14,63
1333403,29,24,1984,5,"male",1445,4,3,0,0,0,0,0,0
1333410,19,18,1994,10,"female",608,1441,604,1606,1104,1548,952,58,152
1333438,60,12,1953,9,"female",1112,63,39,209,91,30,44,179,47
1333451,19,24,1994,1,"female",612,411,293,1587,582,1292,511,295,71
1333474,72,17,1941,9,"male",1729,152,109,0,0,0,0,0,0
1333487,20,2,1993,4,"female",338,510,133,71,8,62,5,9,3
1333500,28,1,1985,7,"female",572,69,19,4,0,4,0,0,0
1333505,14,26,1999,5,"male",83,53,39,18,9,18,6,0,3
1333524,62,17,1951,2,"male",746,170,163,153,90,142,71,11,19
1333528,19,2,1994,3,"female",1455,612,189,60,63,30,30,30,33
1333543,42,18,1971,4,"male",188,5,5,0,0,0,0,0,0
1333551,44,31,1969,1,"male",610,44,10,46,0,46,0,0,0
1333557,24,1,1989,8,"male",489,391,297,0,1,0,0,0,1
1333564,19,1,1994,1,"male",113,20,19,5,1,5,1,0,0
1333577,108,25,1905,9,"female",1619,57,30,6,2,0,2,6,0
1333594,60,15,1953,9,"male",1640,239,65,120,97,117,41,3,56
1333595,25,22,1988,2,"male",12,2,2,13,1,13,1,0,0
1333623,19,9,1994,10,"female",539,67,38,6,3,1,3,5,0
1333658,41,28,1972,3,"male",223,220,73,41,4,41,3,0,1
1333672,18,25,1995,10,"male",517,207,190,0,0,0,0,0,0
1333682,25,16,1988,9,"male",226,205,88,0,0,0,0,0,0
1333702,49,16,1964,11,"male",1670,107,33,0,0,0,0,0,0
1333705,25,22,1988,1,"male",284,91,82,42,13,42,9,0,4
1333713,24,23,1989,10,"male",733,146,109,0,0,0,0,0,0
1333730,24,25,1989,4,"female",253,86,65,151,83,113,50,38,33
1333747,69,22,1944,8,"male",747,35,22,1,0,0,0,1,0
1333749,60,4,1953,2,"male",699,30,16,4,1,1,0,3,1
1333771,30,10,1983,7,"male",860,153,119,73,5,73,1,0,4
1333816,47,24,1966,2,"female",468,1414,205,332,617,148,136,184,481
1333843,23,1,1990,1,"male",159,66,19,5,82,0,45,5,37
1333847,102,28,1911,12,"female",778,138,72,14,5,2,0,12,5
1333899,25,22,1988,3,"male",813,15,9,0,1,0,0,0,1
1333953,16,28,1997,4,"male",96,98,72,16,2,16,2,0,0
1333959,103,1,1910,1,"male",782,295,105,9,19,0,2,9,17
1333976,26,9,1987,9,"male",131,46,35,2,7,2,4,0,3
1334019,24,2,1989,5,"female",732,288,200,49,42,15,36,34,6
1334071,69,8,1944,11,"male",1048,13,10,74,28,4,9,70,19
1334076,23,30,1990,6,"male",1890,696,430,132,85,118,61,14,24
1334088,14,4,1999,5,"male",364,67,21,4,0,4,0,0,0
1334092,68,2,1945,8,"male",112,47,16,85,11,85,10,0,1
1334093,56,15,1957,11,"male",538,47,26,750,152,750,108,0,44
1334100,18,14,1995,3,"male",209,215,167,259,124,259,67,0,57
1334105,18,5,1995,1,"male",532,254,216,10,14,9,5,1,9
1334116,19,16,1994,8,"male",213,67,35,84,141,12,96,72,45
1334136,17,30,1996,7,"female",248,12,11,0,7,0,7,0,0
1334151,33,12,1980,4,"male",297,0,0,0,0,0,0,0,0
1334191,29,30,1984,11,"female",318,52,25,31,49,21,20,10,29
1334196,102,1,1911,5,"female",1932,1012,500,394,269,110,128,284,141
1334198,21,18,1992,11,"female",371,776,486,176,94,176,83,0,11
1334200,17,16,1996,4,"male",584,246,163,0,0,0,0,0,0
1334251,61,9,1952,5,"female",44,133,125,783,390,749,286,34,104
1334257,46,27,1967,11,"male",160,6,6,0,0,0,0,0,0
1334291,25,1,1988,1,"male",217,73,68,0,0,0,0,0,0
1334306,52,10,1961,1,"male",1658,34,17,26,89,0,78,26,11
1334316,21,28,1992,10,"male",623,141,89,0,0,0,0,0,0
1334321,51,9,1962,10,"male",1234,633,477,284,378,221,211,63,167
1334333,83,12,1930,6,"male",82,95,58,3,6,3,6,0,0
1334354,36,24,1977,5,"female",273,46,22,299,187,13,151,286,36
1334371,18,10,1995,6,"male",244,8,8,1,0,0,0,1,0
1334382,44,21,1969,11,"male",163,10,10,0,0,0,0,0,0
1334440,14,1,1999,10,"female",65,122,20,0,0,0,0,0,0
1334449,44,9,1969,6,"male",462,57,34,0,1,0,1,0,0
1334453,52,7,1961,1,"female",1511,151,59,102,133,66,74,36,59
1334470,19,7,1994,11,"female",309,231,75,131,79,131,48,0,31
1334496,28,25,1985,4,"female",257,302,139,1070,1301,1070,1184,0,117
1334509,28,1,1985,1,"male",620,75,24,31,14,31,11,0,3
1334558,30,31,1983,5,"male",34,9,7,2,10,2,2,0,8
1334575,19,11,1994,12,"male",569,160,72,127,43,127,42,0,1
1334610,30,20,1983,5,"male",81,10,9,0,0,0,0,0,0
1334616,16,7,1997,10,"female",411,105,87,1464,714,1134,378,330,336
1334637,27,6,1986,2,"female",344,59,41,0,0,0,0,0,0
1334641,51,12,1962,10,"male",112,57,50,117,68,0,45,117,23
1334658,92,12,1921,6,"male",1014,396,105,124,122,0,45,124,77
1334663,13,11,2000,5,"male",85,11,5,0,0,0,0,0,0
1334679,25,14,1988,10,"male",540,6,0,0,0,0,0,0,0
1334681,43,4,1970,3,"female",308,23,12,3,3,3,3,0,0
1334691,15,4,1998,11,"male",419,66,43,1,0,0,0,1,0
1334697,34,2,1979,2,"male",51,3,3,1,1,1,1,0,0
1334700,16,7,1997,1,"male",745,715,405,278,90,278,50,0,40
1334719,31,14,1982,2,"male",604,164,144,0,17,0,17,0,0
1334731,27,1,1986,1,"male",355,12,10,0,1,0,0,0,1
1334753,21,16,1992,2,"male",650,57,32,1,1,1,1,0,0
1334780,53,1,1960,3,"female",986,46,19,4,9,0,1,4,8
1334792,29,24,1984,7,"female",518,8,7,0,0,0,0,0,0
1334820,41,22,1972,2,"female",501,224,190,710,679,536,276,174,403
1334839,18,12,1995,1,"female",382,1108,102,849,460,561,274,288,186
1334887,14,11,1999,10,"female",27,0,0,0,0,0,0,0,0
1334894,56,1,1957,1,"female",754,41,22,72,20,72,11,0,9
1334909,61,15,1952,11,"male",1417,26,9,2,4,1,3,1,1
1334946,63,9,1950,8,"male",530,1,0,0,0,0,0,0,0
1335005,20,2,1993,6,"female",676,591,408,458,1001,454,599,4,402
1335038,22,13,1991,5,"male",445,3,3,0,13,0,0,0,13
1335059,88,25,1925,12,"male",42,0,0,0,0,0,0,0,0
1335060,20,24,1993,6,"male",61,40,19,55,33,55,13,0,20
1335063,22,3,1991,4,"male",225,17,17,0,0,0,0,0,0
1335132,15,6,1998,12,"male",650,413,107,13,20,12,6,1,14
1335142,50,18,1963,5,"female",446,59,28,0,0,0,0,0,0
1335161,45,22,1968,3,"male",1262,174,97,0,2,0,1,0,1
1335175,61,7,1952,11,"male",285,5,5,5,0,0,0,5,0
1335218,33,9,1980,10,"female",332,5,1,0,0,0,0,0,0
1335244,56,9,1957,3,"male",665,96,78,2,0,2,0,0,0
1335254,58,17,1955,10,"male",250,21,10,3,1,0,1,3,0
1335272,21,17,1992,11,"male",340,21,15,0,0,0,0,0,0
1335273,35,18,1978,10,"male",485,190,166,43,30,27,14,16,16
1335279,18,16,1995,11,"male",595,19,8,2,1,0,0,2,1
1335283,65,28,1948,5,"female",1167,111,14,223,56,53,29,170,27
1335285,25,25,1988,12,"female",428,3,2,0,0,0,0,0,0
1335317,20,20,1993,7,"male",325,26,22,0,0,0,0,0,0
1335320,23,23,1990,2,"male",307,115,39,8,122,8,110,0,12
1335338,16,2,1997,3,"male",570,48,40,36,145,36,143,0,2
1335341,13,30,2000,5,"female",724,755,477,89,65,0,2,89,63
1335345,19,28,1994,9,"male",762,538,443,14,8,14,8,0,0
1335352,103,4,1910,1,"male",1002,1766,497,4189,2625,493,928,3696,1697
1335411,40,11,1973,10,"male",708,100,32,104,94,97,80,7,14
1335443,44,1,1969,1,"male",76,1,0,2,1,2,0,0,1
1335484,23,26,1990,1,"male",436,26,0,0,4,0,4,0,0
1335490,25,14,1988,7,"male",705,21,20,0,0,0,0,0,0
1335497,25,25,1988,5,"female",1693,493,75,135,70,135,60,0,10
1335499,50,3,1963,4,"male",1937,42,11,21,56,20,51,1,5
1335519,41,8,1972,8,"male",417,4,0,0,0,0,0,0,0
1335522,25,11,1988,1,"female",474,36,19,21,37,20,15,1,22
1335525,108,8,1905,8,"male",661,76,61,2,6,2,5,0,1
1335527,68,22,1945,1,"male",1406,153,57,180,222,0,37,180,185
1335530,18,26,1995,6,"male",307,22,20,0,1,0,1,0,0
1335531,21,18,1992,6,"female",509,0,0,1,0,1,0,0,0
1335548,17,14,1996,10,"female",188,181,159,9,77,7,50,2,27
1335574,74,25,1939,4,"male",1514,22,14,0,3,0,1,0,2
1335575,23,7,1990,1,"male",1237,66,24,4,12,4,9,0,3
1335609,16,8,1997,7,"male",438,133,97,17,10,0,0,17,10
1335620,14,16,1999,12,"female",203,108,64,16,9,4,0,12,9
1335628,30,18,1983,7,"male",396,142,66,24,0,0,0,24,0
1335631,18,1,1995,1,"male",495,72,44,0,0,0,0,0,0
1335645,67,12,1946,11,"male",897,35,8,3,5,3,3,0,2
1335706,33,1,1980,1,"male",726,60,7,1,0,1,0,0,0
1335723,19,29,1994,4,"female",140,189,60,149,35,116,20,33,15
1335741,20,7,1993,8,"male",946,249,185,0,5,0,0,0,5
1335748,27,9,1986,1,"male",455,103,81,21,1,21,1,0,0
1335757,21,23,1992,12,"male",257,45,19,0,0,0,0,0,0
1335780,25,15,1988,9,"female",726,68,45,0,1,0,0,0,1
1335822,26,1,1987,1,"male",346,7,3,0,0,0,0,0,0
1335826,64,6,1949,5,"female",487,73,19,211,141,1,27,210,114
1335853,103,31,1910,10,"male",1255,225,108,169,40,0,25,169,15
1335876,65,15,1948,2,"male",718,0,0,0,0,0,0,0,0
1335888,14,6,1999,7,"male",213,452,237,9,0,0,0,9,0
1335890,16,29,1997,10,"male",244,11,10,0,0,0,0,0,0
1335917,63,28,1950,10,"male",1207,32,15,0,0,0,0,0,0
1335928,63,18,1950,8,"male",580,49,33,12,7,1,2,11,5
1335968,27,3,1986,4,"male",1055,40,8,4,0,4,0,0,0
1335988,20,13,1993,4,"male",777,782,378,172,392,90,177,82,215
1336007,59,19,1954,12,"female",538,206,171,50,20,21,2,29,18
1336008,20,10,1993,10,"female",318,604,115,0,25,0,18,0,7
1336023,19,11,1994,11,"female",477,730,457,145,306,145,192,0,114
1336026,38,20,1975,2,"female",261,10,6,1,4,1,4,0,0
1336039,68,30,1945,4,"male",1834,159,97,64,78,0,28,64,50
1336052,24,24,1989,2,"male",2227,92,25,16,1,16,1,0,0
1336053,25,1,1988,1,"male",16,2,2,0,0,0,0,0,0
1336082,20,20,1993,4,"male",29,10,10,72,2,72,2,0,0
1336099,30,11,1983,11,"male",523,50,35,0,0,0,0,0,0
1336121,38,25,1975,10,"female",299,254,166,24,66,3,40,21,26
1336123,32,16,1981,5,"male",1240,4,1,0,0,0,0,0,0
1336133,19,1,1994,2,"male",410,981,741,34,169,4,136,30,33
1336134,108,1,1905,1,NA,2131,179,145,33,29,26,15,7,14
1336150,31,11,1982,3,"male",326,76,36,0,1,0,1,0,0
1336182,35,22,1978,11,"male",296,30,27,3,1,0,0,3,1
1336258,13,13,2000,3,"male",288,732,636,169,94,75,54,94,40
1336274,52,2,1961,11,"male",29,0,0,3,0,3,0,0,0
1336299,23,12,1990,12,"male",191,232,207,374,157,374,139,0,18
1336324,65,1,1948,3,"female",1230,81,44,481,118,0,48,481,70
1336355,26,27,1987,4,"female",398,68,44,20,71,20,38,0,33
1336356,21,5,1992,9,"female",17,7,6,0,0,0,0,0,0
1336361,53,28,1960,10,"female",1604,36,7,3,5,0,4,3,1
1336375,27,6,1986,6,"male",322,156,107,7,3,0,2,7,1
1336447,34,7,1979,7,"male",201,11,6,0,0,0,0,0,0
1336454,78,27,1935,8,"female",308,39,31,8,1,0,0,8,1
1336476,21,9,1992,8,"male",76,26,21,40,4,40,0,0,4
1336494,16,10,1997,7,"female",435,621,272,571,367,570,312,1,55
1336495,33,18,1980,9,"male",56,28,28,0,0,0,0,0,0
1336542,95,1,1918,1,"male",364,0,0,0,0,0,0,0,0
1336591,24,4,1989,3,"female",90,44,36,48,77,19,14,29,63
1336610,32,14,1981,12,"female",501,30,14,447,14,0,5,447,9
1336661,73,24,1940,7,"female",133,33,23,0,0,0,0,0,0
1336681,57,15,1956,7,"female",729,91,69,68,43,0,19,68,24
1336690,22,14,1991,2,"female",239,85,45,2,13,2,12,0,1
1336703,31,1,1982,8,"female",457,53,11,51,10,39,8,12,2
1336717,23,20,1990,11,"male",416,141,61,7,34,7,20,0,14
1336718,15,6,1998,4,"male",511,386,231,18,13,4,10,14,3
1336779,26,14,1987,6,"female",497,10,4,0,0,0,0,0,0
1336780,31,15,1982,1,"female",543,131,105,27,26,25,17,2,9
1336782,21,5,1992,8,"male",337,24,10,0,0,0,0,0,0
1336819,23,1,1990,10,"male",151,11,11,0,0,0,0,0,0
1336860,55,11,1958,12,"male",465,10,2,0,0,0,0,0,0
1336861,29,28,1984,8,"female",1849,716,269,1175,2336,849,1717,326,619
1336880,18,18,1995,9,"male",968,597,314,243,29,243,25,0,4
1336881,18,13,1995,9,"male",646,285,226,86,1,86,1,0,0
1336885,28,25,1985,5,"male",558,93,55,0,0,0,0,0,0
1336902,37,15,1976,11,"female",1539,197,88,86,111,74,79,12,32
1336904,14,17,1999,8,"female",1,2,2,0,0,0,0,0,0
1336905,40,1,1973,9,"male",774,14,3,0,0,0,0,0,0
1336939,25,2,1988,9,"male",305,159,129,3,2,2,2,1,0
1336946,23,15,1990,7,"female",1285,189,51,22,115,9,106,13,9
1336961,32,2,1981,10,"male",425,212,193,64,54,64,11,0,43
1336976,25,12,1988,1,"female",211,229,117,0,1,0,0,0,1
1336999,113,1,1900,1,"male",1391,315,168,16,18,16,14,0,4
1337013,66,25,1947,10,"male",408,71,44,18,4,18,1,0,3
1337018,20,1,1993,9,"male",419,184,153,27,26,16,11,11,15
1337051,70,7,1943,6,"female",272,14,12,2,2,0,0,2,2
1337058,68,17,1945,10,"male",1653,166,89,26,23,26,23,0,0
1337074,59,17,1954,6,"female",271,57,29,20,6,20,6,0,0
1337111,36,17,1977,9,"female",410,64,32,1,0,1,0,0,0
1337134,48,7,1965,9,"female",887,397,176,148,102,1,11,147,91
1337160,19,11,1994,2,"male",397,168,128,20,37,4,3,16,34
1337206,58,30,1955,5,"female",1786,990,565,176,150,171,77,5,73
1337224,26,15,1987,10,"male",505,111,66,0,0,0,0,0,0
1337240,21,11,1992,11,"male",290,61,50,0,0,0,0,0,0
1337260,50,2,1963,12,"female",268,69,37,27,79,27,63,0,16
1337269,67,2,1946,12,"female",620,68,62,24,34,3,8,21,26
1337291,18,20,1995,1,"male",326,26,11,0,0,0,0,0,0
1337295,57,15,1956,3,"female",1984,101,35,61,96,44,76,17,20
1337305,30,27,1983,6,"male",662,86,6,6,0,6,0,0,0
1337319,38,2,1975,3,NA,2162,244,100,2906,4993,1760,3126,1145,1867
1337339,25,3,1988,12,"male",321,81,26,0,0,0,0,0,0
1337361,22,15,1991,3,"male",93,66,58,2,1,2,1,0,0
1337370,68,24,1945,1,"male",608,1248,973,22,126,22,71,0,55
1337372,30,11,1983,2,"male",9,59,32,19,4,0,0,19,4
1337400,43,28,1970,8,"male",270,56,54,1,1,1,1,0,0
1337412,13,1,2000,6,"male",272,74,43,0,0,0,0,0,0
1337432,34,11,1979,1,"female",8,10,9,0,0,0,0,0,0
1337462,76,17,1937,10,"female",729,16,9,16,8,0,3,16,5
1337467,39,1,1974,1,"female",1608,23,18,37,27,37,7,0,20
1337509,27,8,1986,8,"male",420,15,10,0,3,0,0,0,3
1337524,30,16,1983,11,"female",447,104,66,184,35,184,31,0,4
1337542,69,1,1944,10,"female",1406,128,96,178,236,0,35,178,201
1337547,62,22,1951,8,"female",1297,126,93,345,106,93,41,252,65
1337579,18,5,1995,7,"male",22,0,0,0,0,0,0,0,0
1337580,26,24,1987,7,"male",30,39,19,13,17,11,7,2,10
1337661,18,25,1995,5,"female",40,46,17,6,14,6,11,0,3
1337684,71,3,1942,9,"female",1587,11,3,0,3,0,3,0,0
1337696,22,9,1991,1,"male",1046,25,7,0,0,0,0,0,0
1337709,30,3,1983,1,"male",887,42,34,8,4,2,4,6,0
1337738,98,17,1915,3,"male",997,697,547,7,2,3,1,4,1
1337760,19,18,1994,8,"female",222,177,119,608,398,603,312,5,86
1337779,14,26,1999,1,"female",226,20,15,11,6,9,3,2,3
1337787,16,15,1997,5,"male",388,230,111,43,19,41,3,2,16
1337842,18,16,1995,7,"female",450,165,20,111,19,111,15,0,4
1337853,22,18,1991,12,"female",927,609,443,1136,852,648,397,488,455
1337857,29,8,1984,2,"female",609,602,364,1445,603,171,62,1274,541
1337873,47,10,1966,10,"female",530,94,35,1604,2583,306,1917,1298,666
1337927,108,5,1905,1,"female",577,19,9,6,0,6,0,0,0
1337932,73,29,1940,4,"female",297,90,65,232,209,0,11,232,198
1337938,75,7,1938,5,"female",577,118,86,1384,40,0,4,1384,36
1337955,40,1,1973,9,"female",54,127,104,704,618,263,329,441,289
1337956,86,11,1927,9,"female",2074,251,113,23,67,23,35,0,32
1337960,62,20,1951,7,"male",656,35,25,6,9,0,5,6,4
1337962,17,20,1996,4,"female",1249,586,247,851,1263,475,557,376,706
1337975,18,4,1995,10,"female",495,814,665,412,192,147,84,265,108
1338000,90,16,1923,5,"male",1667,409,164,155,97,9,34,146,63
1338007,52,24,1961,1,"female",643,36,19,0,0,0,0,0,0
1338014,30,27,1983,7,"male",280,130,73,0,1,0,1,0,0
1338053,18,2,1995,2,"male",397,284,208,35,109,35,68,0,41
1338073,73,24,1940,3,"female",1233,198,77,384,430,337,125,47,305
1338083,21,21,1992,6,"female",311,15,10,3,0,1,0,2,0
1338093,60,27,1953,10,"female",505,137,76,117,139,117,86,0,53
1338111,35,17,1978,2,"female",239,7,6,0,0,0,0,0,0
1338128,113,1,1900,1,"female",1356,125,68,7,1,0,0,7,1
1338167,22,24,1991,8,"female",431,75,40,6,0,6,0,0,0
1338174,21,24,1992,11,"male",202,248,151,1989,1223,1018,794,971,429
1338214,26,22,1987,4,"female",73,24,9,1,0,1,0,0,0
1338274,91,30,1922,10,"male",159,591,443,93,39,17,33,76,6
1338280,63,16,1950,4,"female",283,35,17,1581,349,1581,236,0,113
1338304,37,29,1976,4,"female",313,33,23,132,37,132,32,0,5
1338312,16,16,1997,8,"male",142,105,100,8,1,8,1,0,0
1338328,22,20,1991,4,"female",1036,2014,152,118,3129,118,2865,0,264
1338337,45,3,1968,11,"male",244,273,228,29,44,14,26,15,18
1338347,30,4,1983,4,"male",130,19,18,0,0,0,0,0,0
1338348,16,14,1997,1,"female",344,82,17,0,3,0,3,0,0
1338376,46,22,1967,7,"female",1503,82,44,127,79,88,38,39,41
1338423,43,1,1970,1,"male",643,5,1,0,0,0,0,0,0
1338453,61,5,1952,7,"male",1164,172,65,4,5,2,3,2,2
1338458,30,26,1983,5,"male",313,2,2,48,30,31,12,17,18
1338461,21,13,1992,6,"female",73,2,1,10,7,10,5,0,2
1338472,61,3,1952,3,"female",770,8,7,0,0,0,0,0,0
1338499,30,25,1983,7,"male",1,0,0,0,0,0,0,0,0
1338523,106,3,1907,8,"male",1566,107,49,31,4,0,0,31,4
1338555,113,17,1900,8,"female",1573,227,118,193,76,187,47,6,29
1338585,21,4,1992,7,"female",1067,312,94,315,414,113,128,202,286
1338620,27,11,1986,11,"male",639,249,100,2,0,2,0,0,0
1338635,54,16,1959,1,"male",1171,47,13,3,2,0,2,3,0
1338651,19,4,1994,6,"female",951,1375,943,155,449,98,247,57,202
1338658,59,16,1954,10,"male",263,1,0,0,0,0,0,0,0
1338670,23,19,1990,1,"male",846,4260,1176,764,2050,629,712,135,1338
1338673,18,14,1995,10,"female",258,461,131,811,544,660,458,151,86
1338705,49,30,1964,5,"male",378,43,34,4,4,0,0,4,4
1338710,15,26,1998,1,"male",223,194,124,2,2,0,2,2,0
1338760,49,26,1964,1,"male",2204,147,64,151,81,61,38,90,43
1338786,16,5,1997,11,"male",715,74,42,118,6,21,5,97,1
1338798,33,17,1980,7,"male",334,164,38,1,4,1,1,0,3
1338805,18,28,1995,12,"female",604,425,189,1108,652,879,369,229,283
1338825,28,9,1985,2,"female",409,4,0,0,0,0,0,0,0
1338832,23,17,1990,7,"male",343,198,188,3,8,2,8,1,0
1338834,25,1,1988,1,"female",155,24,16,139,17,139,2,0,15
1338849,26,15,1987,3,"male",539,50,40,0,0,0,0,0,0
1338883,28,6,1985,5,"male",180,76,37,10,15,0,6,10,9
1338886,30,18,1983,5,"male",438,30,23,50,54,49,35,1,19
1338894,28,21,1985,8,"male",454,24,21,1,0,1,0,0,0
1338898,25,1,1988,8,"male",65,12,11,0,0,0,0,0,0
1338926,36,25,1977,7,"female",119,9,8,1,0,1,0,0,0
1338929,16,16,1997,10,"female",34,49,38,1,0,1,0,0,0
1338949,55,8,1958,6,"male",343,43,35,10,2,0,1,10,1
1338961,80,7,1933,4,"male",961,574,340,0,27,0,20,0,7
1338972,26,7,1987,7,"male",300,220,171,181,162,181,152,0,10
1338979,55,3,1958,3,"male",249,82,65,2,6,2,3,0,3
1339003,108,4,1905,2,"male",2009,249,101,35,43,0,3,35,40
1339027,108,16,1905,2,"male",193,184,52,265,106,265,103,0,3
1339042,58,2,1955,10,"female",667,54,33,4,15,0,3,4,12
1339048,28,27,1985,2,"male",67,70,69,0,0,0,0,0,0
1339114,15,20,1998,6,"female",285,16,1,2,1,2,0,0,1
1339115,24,12,1989,6,"male",292,2,2,2,0,0,0,2,0
1339123,39,16,1974,2,"male",436,16,12,1,9,1,9,0,0
1339127,20,23,1993,9,"male",695,100,62,0,0,0,0,0,0
1339161,28,5,1985,5,"male",77,12,12,0,0,0,0,0,0
1339171,30,14,1983,2,"female",175,453,383,149,414,149,280,0,134
1339247,18,29,1995,3,"female",227,314,104,355,410,355,249,0,161
1339282,32,1,1981,1,"male",605,42,32,7,0,7,0,0,0
1339284,21,7,1992,8,"female",570,0,0,0,0,0,0,0,0
1339285,28,6,1985,11,"male",18,58,52,1,1,1,0,0,1
1339295,51,16,1962,4,"male",395,44,28,2,3,2,3,0,0
1339307,54,10,1959,1,"male",313,156,125,20,22,0,2,20,20
1339322,48,8,1965,4,"male",1369,70,14,1,1,1,0,0,1
1339340,44,3,1969,2,"female",1744,181,92,99,104,62,90,37,14
1339345,21,26,1992,7,"male",420,182,67,23,49,23,30,0,19
1339384,108,7,1905,3,"male",1307,290,164,175,30,9,8,166,22
1339389,63,25,1950,4,"male",278,18,15,27,41,2,5,25,36
1339401,21,21,1992,3,"male",650,70,42,139,1,35,0,104,1
1339413,26,31,1987,12,"female",200,234,113,1197,830,1197,708,0,122
1339439,21,16,1992,6,"female",181,262,142,11,104,11,45,0,59
1339487,48,25,1965,1,"male",474,448,234,51,13,9,9,42,4
1339498,30,17,1983,4,"female",528,24,14,0,2,0,2,0,0
1339541,29,6,1984,4,"female",258,2,2,14,0,13,0,1,0
1339583,23,16,1990,8,"female",599,276,136,2,96,2,70,0,26
1339607,16,23,1997,4,"female",160,426,279,1994,745,1300,391,694,354
1339630,22,2,1991,11,"male",431,99,61,6,0,6,0,0,0
1339637,15,9,1998,4,"female",43,2112,222,1267,6336,598,1839,669,4497
1339649,15,10,1998,6,"female",743,363,165,6,23,4,15,2,8
1339694,62,1,1951,2,"male",679,12,11,1,0,1,0,0,0
1339706,17,1,1996,1,"male",101,47,32,0,1,0,1,0,0
1339707,53,18,1960,11,"female",437,472,439,71,6,54,5,17,1
1339734,48,16,1965,5,"female",580,133,80,165,189,21,49,144,140
1339768,41,3,1972,3,"female",280,46,26,198,71,198,64,0,7
1339772,19,22,1994,9,"male",343,37,25,0,0,0,0,0,0
1339781,48,3,1965,4,"female",362,103,93,36,8,0,2,36,6
1339804,58,19,1955,5,"female",166,16,13,4,7,0,3,4,4
1339823,16,25,1997,11,"male",487,26,17,42,31,42,22,0,9
1339838,32,28,1981,11,"male",1064,63,29,0,0,0,0,0,0
1339840,27,21,1986,3,"male",303,106,59,13,10,13,8,0,2
1339848,77,23,1936,9,"male",1451,521,365,280,128,4,85,276,43
1339888,24,27,1989,10,"male",245,331,269,0,6,0,5,0,1
1339899,44,16,1969,7,"female",598,155,70,60,119,44,75,16,44
1339904,16,25,1997,9,"male",622,67,53,0,5,0,5,0,0
1339936,22,23,1991,6,"male",435,103,83,0,7,0,1,0,6
1340057,76,13,1937,3,"male",1464,590,452,0,2,0,2,0,0
1340096,16,11,1997,3,"male",40,6,5,3,0,3,0,0,0
1340098,37,6,1976,6,"female",363,108,78,2,10,2,10,0,0
1340152,38,10,1975,10,"female",695,197,135,315,276,177,181,138,95
1340159,19,20,1994,8,"male",481,42,12,1,0,1,0,0,0
1340186,16,10,1997,10,"female",35,80,52,141,141,115,74,26,67
1340217,73,1,1940,1,"male",1053,341,147,5,45,0,26,5,19
1340245,20,12,1993,10,"male",593,663,560,1,1,1,0,0,1
1340296,22,14,1991,1,"male",177,11,11,12,1,9,1,3,0
1340297,28,25,1985,3,"female",805,376,302,730,226,648,110,82,116
1340304,14,8,1999,2,"female",224,86,85,40,33,39,28,1,5
1340309,45,9,1968,2,"male",263,133,54,1,44,1,31,0,13
1340327,68,27,1945,5,"male",732,889,519,567,345,567,335,0,10
1340347,33,14,1980,6,"male",231,92,57,88,60,88,44,0,16
1340376,57,8,1956,7,"male",388,217,61,5,9,4,2,1,7
1340377,28,7,1985,8,"female",43,19,15,1,4,1,3,0,1
1340391,27,1,1986,5,"female",392,81,46,448,78,448,57,0,21
1340404,57,8,1956,8,"male",1819,223,111,75,93,49,38,26,55
1340407,44,16,1969,10,"male",584,63,44,0,0,0,0,0,0
1340419,62,8,1951,5,"female",1757,111,55,18,20,18,16,0,4
1340455,43,25,1970,12,"female",85,9,4,13,42,12,25,1,17
1340488,18,6,1995,2,"female",391,2259,1415,1083,15731,1061,5860,22,9871
1340493,17,13,1996,6,"female",1104,4662,1391,108,2477,74,1512,34,965
1340534,16,13,1997,9,"male",1458,673,444,1,0,1,0,0,0
1340537,46,15,1967,12,"male",754,97,49,1,56,0,40,1,16
1340542,24,18,1989,3,"male",58,19,14,9,4,9,4,0,0
1340548,16,2,1997,2,"male",196,78,69,12,3,12,3,0,0
1340563,66,28,1947,6,"female",414,49,27,5,26,5,17,0,9
1340608,19,5,1994,7,"male",495,19,4,0,0,0,0,0,0
1340611,15,10,1998,11,"male",31,20,3,0,0,0,0,0,0
1340621,20,5,1993,11,"male",417,56,39,0,2,0,1,0,1
1340688,22,1,1991,8,"female",353,105,40,3,3,3,3,0,0
1340718,35,16,1978,11,"male",107,3,2,0,0,0,0,0,0
1340726,21,4,1992,7,"female",286,233,191,153,260,151,118,2,142
1340764,112,15,1901,1,"male",1218,63,19,53,2,53,2,0,0
1340830,56,17,1957,8,"male",350,167,115,3,40,3,40,0,0
1340834,32,19,1981,10,"female",704,105,49,0,0,0,0,0,0
1340837,27,2,1986,1,"female",781,363,278,5,7,5,1,0,6
1340852,13,6,2000,6,"male",455,66,55,159,23,159,20,0,3
1340858,16,18,1997,11,"male",794,1239,893,88,305,17,255,71,50
1340860,13,21,2000,2,"male",863,76,36,0,0,0,0,0,0
1340880,42,27,1971,4,"male",186,11,8,0,0,0,0,0,0
1340882,27,20,1986,5,"female",67,0,0,0,0,0,0,0,0
1340890,22,15,1991,2,"male",480,171,104,190,11,186,1,4,10
1340896,34,23,1979,9,"male",1810,112,45,0,17,0,4,0,13
1340902,22,24,1991,9,"male",505,183,91,0,1,0,0,0,1
1340905,62,13,1951,10,"female",30,18,15,4,4,0,2,4,2
1340923,46,15,1967,9,"female",1880,256,127,88,72,88,62,0,10
1340926,18,28,1995,4,"male",214,53,13,0,2,0,1,0,1
1340973,58,16,1955,3,"female",90,95,88,196,113,195,76,1,37
1340990,19,12,1994,4,"male",125,127,108,58,13,58,11,0,2
1341015,23,12,1990,12,"male",319,275,270,1,9,1,2,0,7
1341018,22,4,1991,7,"male",83,133,126,162,67,162,65,0,2
1341044,23,4,1990,11,"male",1706,660,276,370,919,266,564,104,355
1341062,20,23,1993,8,"male",209,76,76,1,0,0,0,1,0
1341077,28,6,1985,2,"male",727,436,312,348,206,348,76,0,130
1341081,37,13,1976,8,"female",661,80,32,65,448,64,253,1,195
1341092,46,10,1967,9,"male",242,34,24,11,11,11,6,0,5
1341098,49,10,1964,5,"male",499,488,427,3,5,0,5,3,0
1341107,25,4,1988,4,"male",303,209,94,0,0,0,0,0,0
1341158,40,8,1973,1,"male",367,2,2,0,0,0,0,0,0
1341159,54,29,1959,5,"female",527,25,13,0,0,0,0,0,0
1341160,32,19,1981,7,"female",507,33,24,20,27,20,25,0,2
1341180,32,19,1981,10,"male",1088,142,83,0,1,0,1,0,0
1341187,19,19,1994,8,"female",459,45,32,2,5,2,2,0,3
1341198,21,31,1992,12,"male",795,1449,1039,138,50,138,46,0,4
1341204,31,25,1982,10,"female",238,80,61,10,22,10,12,0,10
1341205,45,28,1968,10,"male",331,14,11,0,0,0,0,0,0
1341206,56,24,1957,9,"male",665,100,44,1,1,0,1,1,0
1341214,19,10,1994,6,"male",443,431,350,259,475,259,311,0,164
1341235,25,2,1988,2,"male",496,74,38,4,0,4,0,0,0
1341256,24,11,1989,1,"female",490,415,300,112,132,67,73,45,59
1341276,16,2,1997,6,"male",1058,5,5,0,0,0,0,0,0
1341286,77,30,1936,10,"female",994,29,20,21,2,8,0,13,2
1341296,18,21,1995,7,"male",244,261,178,1926,97,1926,59,0,38
1341313,15,15,1998,9,"male",224,415,88,2,3,0,1,2,2
1341328,14,22,1999,1,"female",52,1,0,0,3,0,1,0,2
1341364,18,1,1995,12,"male",237,139,107,100,2,100,0,0,2
1341371,22,19,1991,12,"male",177,50,30,0,0,0,0,0,0
1341372,15,14,1998,6,"male",459,896,647,43,63,38,10,5,53
1341388,18,26,1995,10,"male",192,12,8,83,8,79,5,4,3
1341395,25,15,1988,4,"male",164,0,0,0,0,0,0,0,0
1341399,36,28,1977,12,"male",13,21,17,28,17,28,15,0,2
1341447,64,21,1949,5,"male",218,1147,242,17,39,0,14,17,25
1341452,103,23,1910,9,"female",1026,2449,928,1,185,0,70,1,115
1341454,53,29,1960,7,"female",554,39,28,26,18,23,18,3,0
1341509,108,16,1905,12,"male",1854,314,119,54,4,54,2,0,2
1341514,38,14,1975,1,"male",817,6,4,0,0,0,0,0,0
1341520,14,28,1999,1,"female",442,423,291,201,44,200,30,1,14
1341528,65,4,1948,3,"female",1355,52,20,598,292,270,164,328,128
1341531,17,11,1996,9,"female",466,40,27,25,5,24,4,1,1
1341559,15,13,1998,10,"male",95,1,1,55,65,3,20,52,45
1341585,16,29,1997,9,"male",358,198,174,0,0,0,0,0,0
1341613,22,9,1991,8,"male",104,77,61,4,243,4,210,0,33
1341624,25,1,1988,1,"male",265,62,40,1,0,1,0,0,0
1341660,24,17,1989,8,"male",274,91,74,2,18,2,16,0,2
1341665,57,14,1956,10,"female",919,173,100,356,74,13,48,343,26
1341681,27,31,1986,8,"male",355,57,46,24,19,2,2,22,17
1341750,39,29,1974,9,"male",65,31,21,9,1,9,1,0,0
1341761,33,21,1980,11,"male",579,84,61,709,664,681,584,28,80
1341766,29,13,1984,8,"male",663,67,13,1,1,1,1,0,0
1341789,51,13,1962,1,"female",344,50,27,57,110,51,75,6,35
1341813,41,24,1972,11,"male",476,179,68,96,157,96,119,0,38
1341824,21,10,1992,11,"male",93,12,8,6,1,6,0,0,1
1341854,28,19,1985,1,"male",303,70,38,63,19,63,13,0,6
1341891,79,4,1934,3,"female",2135,214,98,183,91,173,62,10,29
1341896,22,5,1991,12,"male",418,8,3,0,0,0,0,0,0
1341898,18,15,1995,3,"male",370,7,6,8,5,0,4,8,1
1341903,37,12,1976,12,"female",296,27,12,23,5,23,5,0,0
1341909,20,20,1993,4,"female",409,51,34,0,0,0,0,0,0
1341928,21,29,1992,8,"male",391,80,60,202,5,202,3,0,2
1341930,43,3,1970,8,"male",271,62,44,7,7,0,0,7,7
1341935,19,24,1994,12,"male",1112,294,196,62,49,20,38,42,11
1341936,29,5,1984,2,"female",413,323,243,225,77,126,70,99,7
1341971,20,21,1993,11,"female",488,147,109,3,34,3,13,0,21
1341982,51,16,1962,1,"female",1796,117,43,3,4,0,0,3,4
1341994,18,10,1995,9,"male",11,95,75,93,184,12,101,81,83
1342038,23,1,1990,1,"male",688,506,313,45,48,41,33,4,15
1342040,35,9,1978,8,"female",371,102,74,0,6,0,5,0,1
1342084,26,14,1987,11,"male",480,202,176,2,1,0,1,2,0
1342087,15,6,1998,12,"male",342,978,806,89,35,89,13,0,22
1342102,47,1,1966,11,"female",602,90,78,32,50,0,29,32,21
1342109,28,14,1985,2,"male",310,52,44,3,0,0,0,3,0
1342124,34,15,1979,12,"male",167,115,88,24,26,9,17,15,9
1342132,56,18,1957,6,"female",224,60,36,2,7,0,2,2,5
1342135,108,11,1905,7,"male",1170,89,51,145,362,73,227,72,135
1342141,28,1,1985,8,"female",211,18,7,0,0,0,0,0,0
1342169,33,1,1980,1,"female",359,50,18,12,18,12,7,0,11
1342174,24,21,1989,5,"male",510,112,63,2,2,2,2,0,0
1342187,61,5,1952,6,"female",929,14,11,13,1,13,0,0,1
1342240,39,30,1974,7,"female",508,117,39,157,190,157,178,0,12
1342287,13,2,2000,5,"female",494,994,734,2237,5055,68,2400,2169,2655
1342289,18,10,1995,9,"male",194,1345,1163,18,59,18,35,0,24
1342296,59,8,1954,10,"male",10,0,0,0,0,0,0,0,0
1342327,41,22,1972,7,"female",700,235,151,1071,403,474,102,597,301
1342332,18,29,1995,9,"male",124,611,486,82,37,14,26,68,11
1342384,27,16,1986,5,"male",431,158,110,164,32,164,30,0,2
1342393,30,27,1983,1,"female",700,642,373,4188,3671,2084,2384,2104,1287
1342411,25,4,1988,10,"female",117,235,190,234,342,141,234,93,108
1342500,47,3,1966,3,"female",61,44,37,124,77,124,73,0,4
1342511,15,22,1998,9,"female",290,29,27,1,0,1,0,0,0
1342524,50,16,1963,1,"female",604,99,56,79,94,79,55,0,39
1342545,32,10,1981,4,"male",1989,93,27,274,151,156,75,118,76
1342553,13,24,2000,2,"male",119,112,36,1,2,1,2,0,0
1342555,26,3,1987,1,"male",403,152,104,11,36,11,21,0,15
1342566,27,1,1986,6,"male",434,6,2,0,0,0,0,0,0
1342603,18,8,1995,6,"male",34,38,37,9,1,3,1,6,0
1342616,14,31,1999,1,"male",78,27,22,3,0,3,0,0,0
1342623,21,29,1992,10,"female",426,2282,279,100,2128,12,1418,88,710
1342664,22,1,1991,2,"male",355,132,73,61,69,53,44,8,25
1342669,66,1,1947,6,"female",1258,34,14,10,24,6,18,4,6
1342734,21,7,1992,8,"female",533,458,259,91,91,80,71,11,20
1342736,18,28,1995,12,"male",181,106,100,5,2,5,2,0,0
1342749,20,6,1993,9,"female",22,15,6,10,16,10,15,0,1
1342771,71,1,1942,1,"female",580,52,33,183,39,0,19,183,20
1342787,28,12,1985,12,"female",274,328,225,187,318,187,272,0,46
1342799,15,21,1998,3,"male",243,225,116,34,8,34,8,0,0
1342832,24,21,1989,12,"female",1071,167,131,5,1,5,1,0,0
1342837,23,15,1990,10,"male",376,47,35,0,1,0,0,0,1
1342851,45,2,1968,9,"female",138,36,26,12,4,11,4,1,0
1342856,57,19,1956,5,"male",170,12,11,5,4,5,4,0,0
1342861,32,28,1981,10,"male",911,205,95,3,124,3,50,0,74
1342884,18,16,1995,11,"female",347,44,24,51,0,51,0,0,0
1342921,21,10,1992,11,"male",465,38,22,4,2,1,1,3,1
1342922,19,2,1994,4,"male",1099,16,11,0,0,0,0,0,0
1342953,56,12,1957,6,"female",187,209,100,0,1,0,1,0,0
1342963,67,18,1946,8,"male",533,3,2,0,0,0,0,0,0
1342967,25,21,1988,9,"male",191,46,38,0,0,0,0,0,0
1343002,18,24,1995,4,"male",986,134,83,1,5,1,5,0,0
1343015,24,6,1989,6,"male",789,389,307,12,2,0,0,12,2
1343021,41,26,1972,4,"female",645,136,81,47,6,36,3,11,3
1343028,18,18,1995,11,"male",391,283,204,1,5,1,3,0,2
1343041,28,6,1985,6,"male",186,80,75,4,2,4,2,0,0
1343075,21,1,1992,1,"male",162,23,17,24,0,6,0,18,0
1343083,31,20,1982,10,"male",97,34,25,0,0,0,0,0,0
1343090,14,4,1999,2,"male",340,162,80,56,19,10,13,46,6
1343119,46,17,1967,3,"female",1781,216,125,157,150,155,120,2,30
1343194,74,24,1939,2,"female",214,73,52,84,19,0,12,84,7
1343199,52,23,1961,2,"male",194,17,9,0,0,0,0,0,0
1343234,39,1,1974,4,"male",549,41,35,68,1,31,1,37,0
1343269,26,6,1987,7,"male",245,28,24,0,0,0,0,0,0
1343295,15,17,1998,5,"female",511,625,250,446,501,402,189,44,312
1343297,16,11,1997,3,"male",69,22,19,22,2,22,2,0,0
1343301,25,1,1988,5,"male",558,979,704,185,82,115,63,70,19
1343302,18,20,1995,1,"male",265,70,62,0,0,0,0,0,0
1343362,37,28,1976,12,"male",1413,1057,798,42,17,42,13,0,4
1343370,29,15,1984,10,"female",547,96,87,524,165,524,152,0,13
1343441,54,2,1959,6,"male",1532,99,72,26,13,0,5,26,8
1343455,67,9,1946,8,"male",92,1,1,0,0,0,0,0,0
1343477,68,13,1945,7,"female",538,394,216,252,644,252,571,0,73
1343493,33,12,1980,12,"male",274,7,4,1,0,1,0,0,0
1343494,20,30,1993,10,"female",168,201,44,0,0,0,0,0,0
1343510,23,12,1990,9,"female",399,75,70,484,96,16,17,468,79
1343537,63,16,1950,7,"female",285,45,26,7,0,3,0,4,0
1343542,29,26,1984,7,"male",208,278,275,94,43,94,40,0,3
1343559,20,12,1993,12,"female",102,259,97,16,55,16,31,0,24
1343588,20,17,1993,11,"male",278,19,12,34,0,1,0,33,0
1343617,24,10,1989,3,"male",271,53,46,0,2,0,2,0,0
1343619,30,2,1983,2,"male",2,9,7,4,12,0,2,4,10
1343661,23,22,1990,12,"female",555,486,242,478,424,403,137,75,287
1343670,22,3,1991,1,"male",367,98,79,12,6,12,0,0,6
1343682,55,1,1958,12,"female",1710,315,111,111,419,111,158,0,261
1343716,18,25,1995,6,"male",116,80,69,4,10,0,3,4,7
1343727,52,30,1961,3,"female",280,21,18,3,5,3,4,0,1
1343730,25,25,1988,10,"male",729,134,65,1,6,1,6,0,0
1343749,19,23,1994,7,"female",481,684,460,106,101,95,41,11,60
1343756,22,24,1991,10,"female",58,100,67,61,93,42,30,19,63
1343757,98,1,1915,1,"female",614,53,32,140,16,0,7,140,9
1343758,28,25,1985,5,"male",625,168,161,0,0,0,0,0,0
1343759,31,25,1982,1,"female",129,25,17,94,181,18,49,76,132
1343761,39,2,1974,7,"male",314,11,9,0,0,0,0,0,0
1343762,14,6,1999,9,"female",167,268,104,110,114,110,41,0,73
1343829,30,15,1983,8,"male",778,14,10,0,0,0,0,0,0
1343853,29,10,1984,11,"male",1147,986,716,65,61,65,51,0,10
1343883,20,24,1993,7,"female",377,718,522,2081,2241,2080,2148,1,93
1343892,28,9,1985,2,"female",450,128,58,4,4,4,4,0,0
1343904,25,1,1988,1,"male",141,49,47,0,0,0,0,0,0
1343915,15,10,1998,8,"female",280,529,341,2172,1227,1587,510,585,717
1343927,28,2,1985,2,"male",10,18,16,19,44,18,35,1,9
1343972,20,13,1993,10,"male",1034,3,1,3,1,0,0,3,1
1343990,107,28,1906,3,"female",1541,43,21,0,27,0,23,0,4
1343996,16,14,1997,10,"female",160,289,253,661,192,661,173,0,19
1344002,34,13,1979,4,"male",498,34,5,0,2,0,2,0,0
1344038,18,8,1995,10,"female",369,248,160,406,299,403,297,3,2
1344060,20,5,1993,10,"male",153,100,77,533,707,52,182,481,525
1344068,19,13,1994,11,"male",397,277,114,17,22,17,7,0,15
1344070,25,1,1988,1,"female",31,28,23,101,326,101,312,0,14
1344095,94,12,1919,6,NA,2214,430,241,119,27,88,19,31,8
1344119,24,26,1989,4,"male",282,71,40,457,19,22,10,435,9
1344152,42,11,1971,12,"male",257,11,11,27,18,9,13,18,5
1344165,33,1,1980,1,"male",507,7,4,240,12,240,1,0,11
1344213,39,6,1974,8,"male",1764,55,12,39,14,39,10,0,4
1344234,24,3,1989,7,"male",75,21,11,0,5,0,5,0,0
1344256,20,25,1993,12,"female",675,135,64,7,22,7,17,0,5
1344308,43,9,1970,4,"female",300,9,8,11,37,11,33,0,4
1344309,21,5,1992,7,"female",174,16,8,28,3,3,1,25,2
1344342,108,2,1905,4,"female",1431,748,311,72,43,19,25,53,18
1344357,27,5,1986,7,"male",306,302,261,515,313,436,99,79,214
1344368,52,2,1961,10,"male",873,23,12,104,30,104,24,0,6
1344423,37,7,1976,6,"male",462,6,6,0,0,0,0,0,0
1344437,21,7,1992,12,"female",106,41,32,1,3,1,0,0,3
1344445,32,14,1981,4,"male",417,0,0,0,0,0,0,0,0
1344451,63,17,1950,7,"male",960,141,90,22,67,0,31,22,36
1344474,20,19,1993,2,"male",278,129,112,26,14,26,12,0,2
1344484,28,11,1985,8,"male",158,15,14,0,0,0,0,0,0
1344486,26,4,1987,7,"male",570,115,57,31,0,31,0,0,0
1344491,28,17,1985,11,"male",408,62,6,25,7,25,5,0,2
1344492,77,21,1936,9,"female",635,141,118,51,29,51,25,0,4
1344519,50,14,1963,11,"female",432,585,94,13529,6287,13529,5856,0,431
1344521,56,10,1957,4,"female",313,65,29,359,231,15,155,344,76
1344578,17,14,1996,10,"female",383,140,123,37,93,30,72,7,21
1344581,73,15,1940,10,"female",1465,245,170,59,53,0,24,59,29
1344600,63,19,1950,8,"female",595,85,61,116,122,116,61,0,61
1344601,20,23,1993,3,"female",393,110,82,170,25,118,12,52,13
1344608,29,1,1984,8,"female",477,236,74,23,69,11,20,12,49
1344618,43,1,1970,5,"male",1062,29,21,0,4,0,4,0,0
1344664,67,5,1946,6,"male",1489,132,33,43,5,37,3,6,2
1344670,33,1,1980,1,"female",58,1,1,0,1,0,0,0,1
1344675,47,9,1966,10,"female",1465,125,64,129,67,129,51,0,16
1344735,31,17,1982,1,"female",653,266,90,312,350,285,91,27,259
1344738,31,31,1982,7,"male",34,0,0,0,0,0,0,0,0
1344744,30,10,1983,3,"female",181,18,14,107,1465,107,1279,0,186
1344746,34,27,1979,5,"female",1520,312,219,359,420,359,175,0,245
1344769,33,30,1980,7,"male",1022,13,8,1,0,1,0,0,0
1344771,79,21,1934,9,"female",767,58,43,7,2,7,1,0,1
1344804,36,24,1977,11,"male",166,56,47,2,2,0,2,2,0
1344807,20,3,1993,3,"male",760,170,143,0,50,0,44,0,6
1344826,19,24,1994,10,"male",239,160,132,0,0,0,0,0,0
1344831,17,22,1996,8,"female",107,236,198,360,149,359,71,1,78
1344853,19,3,1994,4,"male",312,116,106,59,5,59,5,0,0
1344880,50,12,1963,12,"female",821,880,332,419,548,350,274,69,274
1344895,48,30,1965,9,"female",407,48,35,9,2,9,1,0,1
1344925,22,3,1991,10,"female",330,278,94,48,57,47,48,1,9
1344929,29,14,1984,8,"male",355,132,105,93,56,93,56,0,0
1344931,31,19,1982,9,"female",443,84,27,1,5,1,5,0,0
1344932,32,4,1981,12,"female",323,126,70,365,1321,289,927,76,394
1344950,43,17,1970,9,"male",643,8,7,0,0,0,0,0,0
1344957,24,26,1989,2,"male",514,237,162,572,99,532,49,40,50
1344962,21,6,1992,11,"male",508,1,0,0,0,0,0,0,0
1344997,14,20,1999,7,"female",110,46,41,1,9,0,4,1,5
1345007,52,25,1961,4,"male",225,40,31,2,1,0,0,2,1
1345026,71,8,1942,9,"female",898,17,4,9,4,9,3,0,1
1345068,46,2,1967,9,"male",455,44,26,12,0,12,0,0,0
1345156,107,18,1906,5,"female",1548,378,139,558,376,410,326,148,50
1345176,16,14,1997,9,"male",492,662,546,309,22,309,15,0,7
1345238,108,8,1905,11,"female",1287,70,40,85,26,0,9,85,17
1345240,30,7,1983,6,"male",460,250,247,0,15,0,4,0,11
1345244,25,11,1988,11,"female",582,109,76,0,0,0,0,0,0
1345245,21,14,1992,2,"female",690,212,87,7,6,7,5,0,1
1345254,16,15,1997,7,"female",902,527,415,47,30,47,19,0,11
1345275,94,9,1919,3,"female",932,675,176,0,10,0,7,0,3
1345286,16,4,1997,2,"female",272,211,132,4,1,4,0,0,1
1345317,17,14,1996,12,"female",399,362,42,192,100,192,84,0,16
1345354,31,5,1982,12,"male",148,60,55,0,3,0,2,0,1
1345378,33,19,1980,9,"male",283,19,12,6,0,6,0,0,0
1345380,61,3,1952,5,"female",478,158,76,568,308,568,140,0,168
1345428,54,7,1959,1,"male",329,59,29,4,1,4,1,0,0
1345433,108,2,1905,7,"male",18,9,9,1,0,0,0,1,0
1345497,31,12,1982,7,"female",525,114,75,1,0,1,0,0,0
1345501,25,30,1988,1,"male",410,134,104,2,0,2,0,0,0
1345507,25,4,1988,5,"female",230,1,1,57,21,16,14,41,7
1345535,54,15,1959,6,"male",1187,47,17,0,0,0,0,0,0
1345545,19,7,1994,3,"male",811,76,26,15,13,0,4,15,9
1345547,34,31,1979,7,"male",590,19,12,0,0,0,0,0,0
1345565,27,17,1986,7,"male",193,54,39,1,0,1,0,0,0
1345568,108,10,1905,1,"male",2085,1042,467,0,2,0,1,0,1
1345587,43,16,1970,5,"male",637,381,321,57,39,2,10,55,29
1345615,57,23,1956,4,"female",1170,229,70,217,138,65,95,152,43
1345631,52,20,1961,3,"male",1603,115,58,94,27,94,20,0,7
1345647,33,9,1980,5,"male",242,41,30,0,0,0,0,0,0
1345675,19,17,1994,10,"female",122,114,89,6,2,5,1,1,1
1345696,23,2,1990,6,"male",549,656,473,227,132,227,116,0,16
1345709,15,22,1998,1,"female",34,67,38,30,20,30,18,0,2
1345710,88,24,1925,4,"male",23,120,115,44,19,0,14,44,5
1345739,18,23,1995,2,"female",896,76,38,818,658,818,622,0,36
1345751,13,4,2000,6,"female",820,1047,624,382,246,105,108,277,138
1345757,15,22,1998,8,"female",384,166,90,59,139,15,20,44,119
1345776,58,24,1955,4,"female",1558,304,173,402,479,387,252,15,227
1345802,25,23,1988,11,"male",518,60,19,94,88,94,68,0,20
1345808,113,21,1900,1,"female",1676,728,450,49,9,45,4,4,5
1345823,41,8,1972,7,"male",294,34,27,5,0,5,0,0,0
1345843,24,18,1989,11,"female",1080,446,171,72,52,33,25,39,27
1345847,18,22,1995,10,"male",215,5,3,3,0,3,0,0,0
1345904,33,25,1980,7,"male",391,29,12,27,34,27,29,0,5
1345930,39,1,1974,12,"male",442,181,122,110,152,110,99,0,53
1345931,62,12,1951,2,"female",1006,228,149,2790,1584,0,176,2790,1408
1345938,24,11,1989,6,"male",376,170,105,42,0,42,0,0,0
1345967,22,30,1991,11,"male",198,77,35,6,18,6,17,0,1
1345985,17,8,1996,5,"female",29,57,33,104,55,103,32,1,23
1345995,23,30,1990,10,"male",498,154,128,0,2,0,2,0,0
1346006,98,19,1915,2,"male",1586,562,281,124,108,123,76,1,32
1346007,74,18,1939,11,"female",360,45,33,0,3,0,2,0,1
1346073,31,1,1982,1,"male",404,30,28,0,2,0,1,0,1
1346088,22,1,1991,3,"male",302,130,107,0,4,0,2,0,2
1346090,40,13,1973,2,"male",461,22,12,0,7,0,1,0,6
1346099,37,24,1976,8,"male",524,25,12,372,27,348,21,24,6
1346102,20,2,1993,10,"male",462,395,293,48,16,48,16,0,0
1346179,27,6,1986,5,"female",392,229,202,70,123,29,83,41,40
1346185,33,4,1980,12,"female",599,144,127,527,398,438,258,89,140
1346187,58,14,1955,8,"female",1022,78,47,2141,1435,1741,177,400,1258
1346214,18,29,1995,7,"female",101,117,77,17,5,17,5,0,0
1346244,69,8,1944,9,"female",184,25,21,22,0,22,0,0,0
1346249,26,18,1987,3,"male",712,194,135,36,141,35,89,1,52
1346273,18,29,1995,11,"male",673,232,182,8,1,0,1,8,0
1346281,60,29,1953,10,"female",1609,505,139,110,118,76,99,34,19
1346315,18,12,1995,3,"male",339,59,38,13,8,13,8,0,0
1346325,20,22,1993,6,"male",603,238,166,56,48,56,48,0,0
1346330,41,3,1972,2,"female",500,63,27,385,443,68,140,317,303
1346335,25,2,1988,10,"male",417,236,173,36,82,36,63,0,19
1346346,21,28,1992,1,"male",140,7,6,212,146,1,40,211,106
1346347,30,5,1983,12,"male",71,30,27,5,0,0,0,5,0
1346371,38,17,1975,4,"male",642,90,71,0,8,0,1,0,7
1346408,72,3,1941,5,"female",859,439,299,361,212,361,104,0,108
1346416,39,22,1974,8,"male",743,130,26,2,1,2,1,0,0
1346426,21,16,1992,4,"male",386,369,341,28,7,28,7,0,0
1346427,69,29,1944,6,"female",444,9,2,0,2,0,0,0,2
1346436,55,25,1958,5,"female",1010,359,213,5,2,5,0,0,2
1346450,28,15,1985,10,"male",141,5,3,1,0,1,0,0,0
1346477,23,28,1990,10,"female",620,286,118,1,5,1,5,0,0
1346478,66,15,1947,12,"male",14,31,28,3,3,3,1,0,2
1346479,17,4,1996,5,"male",838,134,41,0,0,0,0,0,0
1346545,14,18,1999,5,"male",266,22,5,13,0,13,0,0,0
1346568,43,23,1970,6,"female",230,3,2,4,0,2,0,2,0
1346628,18,5,1995,7,"female",196,64,55,19,12,19,12,0,0
1346655,20,13,1993,4,"male",108,31,18,81,8,0,2,81,6
1346710,23,16,1990,8,"female",1432,4505,416,570,1019,340,866,230,153
1346719,21,16,1992,6,"male",437,23,16,0,14,0,7,0,7
1346720,14,14,1999,9,"male",139,91,82,43,0,2,0,41,0
1346751,42,22,1971,10,"male",162,30,16,14,5,14,5,0,0
1346762,29,10,1984,7,"male",534,2,0,0,0,0,0,0,0
1346771,51,17,1962,4,"female",55,30,22,67,26,67,20,0,6
1346783,40,10,1973,6,"female",312,169,101,371,233,371,70,0,163
1346822,41,7,1972,9,"male",464,33,4,7,22,7,13,0,9
1346823,22,26,1991,3,"male",228,257,189,188,390,188,295,0,95
1346825,15,23,1998,5,"male",167,306,289,30,35,0,22,30,13
1346843,30,4,1983,2,"male",199,81,69,44,0,44,0,0,0
1346850,38,8,1975,7,"male",271,20,15,2,0,2,0,0,0
1346857,108,18,1905,10,"male",1578,1403,921,486,276,50,79,436,197
1346878,108,9,1905,7,"male",928,207,84,40,12,12,6,28,6
1346882,28,20,1985,5,"male",552,67,42,3,75,2,35,1,40
1346883,51,13,1962,4,"female",541,0,0,0,0,0,0,0,0
1346896,24,7,1989,9,"female",1532,726,244,104,507,76,410,28,97
1346917,91,17,1922,9,"male",2197,937,497,62,12,32,4,30,8
1346941,25,1,1988,1,"female",482,8,5,28,9,28,9,0,0
1346948,21,5,1992,5,"female",241,48,34,0,0,0,0,0,0
1346958,56,22,1957,1,"male",440,35,28,2,2,0,0,2,2
1346983,18,1,1995,1,"female",124,2,1,2,0,2,0,0,0
1346986,26,1,1987,2,"female",289,35,20,0,0,0,0,0,0
1346987,66,1,1947,10,"male",1591,52,20,26,2,26,2,0,0
1346990,76,29,1937,1,"male",521,5,1,0,0,0,0,0,0
1347002,61,7,1952,12,"male",916,144,115,16,84,8,56,8,28
1347011,50,12,1963,5,"male",629,82,48,11,2,0,0,11,2
1347040,18,19,1995,1,"male",5,0,0,0,0,0,0,0,0
1347045,46,3,1967,6,"female",357,222,91,12,17,12,11,0,6
1347051,18,23,1995,5,"male",238,23,17,1,0,0,0,1,0
1347088,24,2,1989,8,"male",162,11,4,0,2,0,1,0,1
1347092,39,9,1974,6,"male",811,108,77,79,21,79,19,0,2
1347098,70,12,1943,11,"male",1558,107,70,33,19,15,8,18,11
1347120,14,6,1999,2,"male",620,62,53,2,3,2,3,0,0
1347140,21,12,1992,2,"male",38,191,73,10,40,10,38,0,2
1347167,42,10,1971,12,"male",587,98,58,42,28,42,25,0,3
1347175,49,21,1964,7,"female",158,12,9,410,8,0,0,410,8
1347180,23,6,1990,11,"male",449,1,1,34,23,0,4,34,19
1347185,35,20,1978,1,"male",42,64,35,253,222,249,117,4,105
1347226,54,25,1959,12,"female",490,25,9,136,82,136,37,0,45
1347239,58,9,1955,1,"female",1288,47,18,11,5,0,1,11,4
1347251,57,14,1956,5,"male",275,4,2,5,0,0,0,5,0
1347279,22,5,1991,11,"female",334,419,225,10,8,2,3,8,5
1347288,15,23,1998,8,"female",622,1923,879,43,4,43,1,0,3
1347289,17,23,1996,12,"male",513,257,210,8,53,8,36,0,17
1347295,66,19,1947,2,"male",1044,30,16,7,8,0,2,7,6
1347309,17,9,1996,8,"male",583,698,410,674,537,337,262,337,275
1347343,25,2,1988,2,"female",611,69,31,113,19,113,11,0,8
1347374,22,1,1991,1,"male",20,4,3,0,0,0,0,0,0
1347380,35,14,1978,2,"male",97,24,16,0,0,0,0,0,0
1347396,17,11,1996,3,"male",398,261,101,89,8,25,3,64,5
1347399,33,9,1980,3,"male",514,165,146,26,3,26,3,0,0
1347413,14,13,1999,7,"female",419,1290,796,50,66,50,47,0,19
1347419,30,15,1983,10,"male",422,17,5,0,1,0,0,0,1
1347422,20,9,1993,9,"female",1273,160,117,459,213,265,127,194,86
1347425,25,2,1988,7,"male",589,231,186,0,1,0,1,0,0
1347457,23,13,1990,11,"female",619,64,27,160,56,160,16,0,40
1347476,16,6,1997,5,"female",203,264,49,68,142,65,75,3,67
1347556,69,15,1944,2,"male",725,76,49,304,271,0,52,304,219
1347560,28,10,1985,6,"male",159,4,4,2,0,2,0,0,0
1347566,20,19,1993,3,"male",638,59,32,226,97,93,70,133,27
1347599,29,7,1984,3,"male",560,3,3,1,0,1,0,0,0
1347641,25,9,1988,7,"female",336,14,6,1372,26,1372,23,0,3
1347642,39,23,1974,4,"female",652,37,18,58,1,58,0,0,1
1347653,29,30,1984,7,"female",666,198,80,7,27,2,10,5,17
1347654,80,12,1933,8,"male",1264,81,39,117,14,21,6,96,8
1347658,16,12,1997,5,"female",498,372,225,303,261,303,167,0,94
1347693,22,8,1991,3,"female",178,313,249,283,171,1,58,282,113
1347699,44,11,1969,5,"male",604,305,252,91,133,91,130,0,3
1347707,16,12,1997,2,"female",431,266,47,8,14,8,7,0,7
1347721,63,24,1950,8,"male",1113,31,12,1,4,0,0,1,4
1347781,81,23,1932,4,"female",497,315,180,1813,563,1813,385,0,178
1347828,28,24,1985,3,"male",836,92,50,7,0,7,0,0,0
1347830,49,14,1964,2,"female",796,130,69,406,64,359,23,47,41
1347832,27,27,1986,4,"male",211,10,4,0,0,0,0,0,0
1347844,48,11,1965,10,"female",602,145,119,731,499,11,234,720,265
1347847,17,31,1996,1,"male",19,1,1,0,0,0,0,0,0
1347856,23,1,1990,1,"female",162,35,23,24,21,24,20,0,1
1347864,108,12,1905,9,"male",857,1288,816,7,63,7,49,0,14
1347883,60,1,1953,4,"male",640,48,25,0,0,0,0,0,0
1347894,14,11,1999,12,"female",216,993,294,368,307,147,82,221,225
1347929,43,24,1970,1,"male",696,36,22,23,101,21,83,2,18
1348000,17,24,1996,5,"male",321,47,44,35,7,33,5,2,2
1348002,29,6,1984,3,"male",104,2,1,0,0,0,0,0,0
1348006,20,2,1993,2,"male",188,168,81,382,701,382,532,0,169
1348013,22,2,1991,2,"male",625,87,24,0,1,0,1,0,0
1348027,16,2,1997,11,"male",519,107,61,17,3,0,1,17,2
1348031,16,23,1997,8,"male",86,242,208,209,128,55,44,154,84
1348065,108,31,1905,8,"male",1028,141,72,7,4,7,1,0,3
1348069,23,1,1990,1,"male",794,106,71,0,4,0,1,0,3
1348095,25,15,1988,7,"male",323,158,141,47,11,47,11,0,0
1348120,103,6,1910,10,"male",1341,275,24,2,14,0,5,2,9
1348137,55,24,1958,1,"female",262,165,80,171,118,171,75,0,43
1348138,31,14,1982,10,"male",729,8,1,0,2,0,1,0,1
1348156,24,10,1989,10,"female",447,11,6,1,29,1,15,0,14
1348183,26,30,1987,7,"male",703,129,71,23,4,20,3,3,1
1348205,31,22,1982,12,"male",474,659,600,69,99,69,51,0,48
1348208,29,10,1984,2,"male",1466,318,136,18,3,18,2,0,1
1348237,27,20,1986,7,"male",457,344,47,29,2,0,1,29,1
1348238,24,29,1989,6,"male",479,157,117,300,106,263,90,37,16
1348276,18,12,1995,12,"male",406,95,80,50,104,50,29,0,75
1348279,112,1,1901,1,"male",1935,95,56,0,55,0,41,0,14
1348289,19,14,1994,8,"female",195,33,10,24,1,24,0,0,1
1348301,39,20,1974,1,"female",389,5,5,0,0,0,0,0,0
1348305,46,1,1967,3,"female",1454,39,16,168,20,168,19,0,1
1348333,43,1,1970,1,"male",193,127,88,126,23,0,6,126,17
1348336,38,16,1975,2,"male",388,30,11,117,1,117,1,0,0
1348338,57,30,1956,11,"female",1726,1208,797,2103,1319,2103,921,0,398
1348361,53,25,1960,7,"male",1083,28,4,0,3,0,3,0,0
1348364,17,8,1996,1,"male",142,20,16,3,0,3,0,0,0
1348384,47,1,1966,5,"female",55,22,10,0,0,0,0,0,0
1348426,27,14,1986,7,"male",366,81,65,0,6,0,6,0,0
1348443,36,29,1977,12,"male",148,20,15,41,54,41,47,0,7
1348495,25,18,1988,8,"female",43,6,5,1,1,1,1,0,0
1348505,37,26,1976,8,"male",353,129,67,20,80,0,31,20,49
1348545,17,10,1996,5,"male",467,104,92,339,104,281,88,58,16
1348575,22,5,1991,5,"male",376,63,43,2,7,0,1,2,6
1348583,39,3,1974,11,"female",375,408,320,298,62,184,34,114,28
1348590,26,6,1987,4,"female",666,163,80,709,197,13,105,696,92
1348608,65,8,1948,6,"female",1725,25,7,0,3,0,0,0,3
1348610,103,16,1910,10,"female",476,195,93,10,6,10,6,0,0
1348614,30,7,1983,3,"female",331,3,1,0,6,0,4,0,2
1348615,34,16,1979,5,"male",78,19,18,2,1,0,1,2,0
1348644,21,14,1992,11,"female",243,400,103,78,193,78,164,0,29
1348653,14,21,1999,7,"male",95,54,48,0,0,0,0,0,0
1348668,101,25,1912,12,"male",230,61,45,37,30,37,30,0,0
1348687,21,29,1992,6,"female",295,122,41,13,100,13,65,0,35
1348697,23,5,1990,9,"male",389,0,0,0,0,0,0,0,0
1348702,17,19,1996,5,"male",376,109,97,13,0,1,0,12,0
1348722,29,20,1984,9,"male",254,84,46,56,176,6,117,50,59
1348745,46,14,1967,1,"male",281,26,24,9,3,9,3,0,0
1348746,34,12,1979,7,"female",179,135,55,316,106,316,49,0,57
1348758,31,16,1982,11,"male",275,95,65,8,5,1,5,7,0
1348760,36,20,1977,2,"male",320,32,10,9,5,6,2,3,3
1348786,59,5,1954,9,"male",479,40,28,0,9,0,5,0,4
1348811,32,19,1981,8,"female",1004,213,100,3216,3330,2749,2462,467,868
1348815,27,22,1986,8,"female",498,126,68,6,2,6,2,0,0
1348822,26,1,1987,4,"male",451,360,179,798,326,677,213,121,113
1348870,29,26,1984,12,"male",472,41,32,3,1,3,1,0,0
1348872,17,18,1996,2,"male",263,48,24,0,6,0,4,0,2
1348890,46,25,1967,3,"female",118,38,16,345,8,345,5,0,3
1348962,108,1,1905,1,"female",193,246,176,0,0,0,0,0,0
1348988,46,19,1967,5,"female",1906,278,136,248,170,248,163,0,7
1348999,27,23,1986,4,"male",268,38,34,49,54,0,17,49,37
1349021,17,12,1996,10,"male",401,216,52,9,4,0,1,9,3
1349023,22,10,1991,12,"male",280,137,111,67,36,0,24,67,12
1349033,64,13,1949,9,"female",596,46,38,81,50,0,25,81,25
1349038,23,17,1990,4,"female",114,35,23,62,30,21,19,41,11
1349043,45,19,1968,10,"female",699,142,77,11,7,11,5,0,2
1349044,49,5,1964,4,"male",836,205,129,5,2,2,1,3,1
1349052,101,21,1912,12,"male",64,14,13,0,0,0,0,0,0
1349067,14,6,1999,3,"male",71,250,226,3,6,3,2,0,4
1349080,19,18,1994,10,"male",825,95,91,3,0,0,0,3,0
1349083,24,2,1989,12,"female",422,201,40,371,63,261,47,110,16
1349108,33,24,1980,1,"male",32,44,40,13,16,13,15,0,1
1349109,15,4,1998,11,"female",440,222,78,93,32,93,31,0,1
1349140,22,25,1991,11,"male",274,60,43,12,0,12,0,0,0
1349154,18,3,1995,11,"male",663,230,176,2,0,2,0,0,0
1349159,24,31,1989,1,"male",525,26,0,0,0,0,0,0,0
1349170,20,3,1993,8,"male",810,172,91,100,86,100,74,0,12
1349180,14,3,1999,8,"male",98,85,66,48,32,45,27,3,5
1349200,16,18,1997,2,"male",87,82,63,10,4,3,2,7,2
1349226,54,12,1959,6,"male",635,51,11,1,5,0,2,1,3
1349228,19,6,1994,1,"male",741,457,332,0,5,0,5,0,0
1349232,27,20,1986,2,"male",719,35,15,0,2,0,2,0,0
1349233,28,7,1985,11,"male",250,20,1,5,0,5,0,0,0
1349241,17,12,1996,7,"male",243,56,42,0,0,0,0,0,0
1349255,70,21,1943,3,"female",497,30,28,130,77,0,6,130,71
1349262,24,1,1989,7,"male",552,236,173,94,8,94,8,0,0
1349282,83,1,1930,3,"male",287,83,69,0,5,0,5,0,0
1349321,66,2,1947,4,"male",531,33,14,33,9,33,7,0,2
1349341,67,13,1946,8,"male",938,148,75,76,46,0,14,76,32
1349342,51,29,1962,10,"male",391,250,220,56,20,0,7,56,13
1349346,26,1,1987,1,"male",258,28,23,0,0,0,0,0,0
1349349,33,31,1980,3,"male",288,235,209,544,83,541,37,3,46
1349358,103,23,1910,6,"male",466,217,172,33,55,33,26,0,29
1349381,26,21,1987,6,"male",823,54,13,0,0,0,0,0,0
1349394,36,28,1977,7,"female",322,217,134,4,0,4,0,0,0
1349420,17,3,1996,1,"female",464,41,26,0,0,0,0,0,0
1349421,37,3,1976,11,"male",501,44,30,10,3,0,1,10,2
1349457,17,3,1996,9,"female",634,334,223,1,0,1,0,0,0
1349462,25,1,1988,1,"male",148,4,4,111,0,111,0,0,0
1349512,23,1,1990,1,"male",164,35,27,6,0,0,0,6,0
1349513,57,28,1956,7,"male",272,55,4,0,10,0,2,0,8
1349538,60,1,1953,6,"female",710,88,55,58,3,0,0,58,3
1349588,58,23,1955,9,"male",1314,47,31,58,83,55,60,3,23
1349590,22,22,1991,9,"female",43,94,87,173,74,127,39,46,35
1349612,28,9,1985,11,"male",1182,501,358,113,74,113,73,0,1
1349613,36,28,1977,6,"male",563,1144,422,1322,359,1322,344,0,15
1349616,25,1,1988,4,"female",590,186,75,1,6,1,5,0,1
1349619,49,2,1964,2,"male",102,6,5,0,0,0,0,0,0
1349630,95,5,1918,6,"female",87,61,49,35,287,1,150,34,137
1349641,15,31,1998,7,"female",218,59,14,33,13,33,11,0,2
1349718,29,27,1984,11,"male",529,14,13,15,2,15,2,0,0
1349719,54,24,1959,9,"female",360,121,111,78,72,0,18,78,54
1349734,32,6,1981,4,"male",542,66,31,33,16,33,15,0,1
1349740,56,29,1957,3,"female",1944,407,240,958,893,489,414,469,479
1349746,27,17,1986,1,"male",512,0,0,0,0,0,0,0,0
1349752,43,13,1970,1,"male",261,93,65,153,75,152,57,1,18
1349754,29,24,1984,11,"male",272,33,17,1,0,1,0,0,0
1349767,27,9,1986,2,"male",248,49,46,1,2,0,0,1,2
1349775,17,20,1996,11,"female",266,196,107,55,38,55,22,0,16
1349784,14,5,1999,3,"female",566,52,31,2,2,0,0,2,2
1349800,108,22,1905,6,"male",1280,148,104,17,1,16,1,1,0
1349803,24,21,1989,10,"male",267,142,64,247,84,247,45,0,39
1349806,56,14,1957,5,"female",1779,13,7,8,2,8,2,0,0
1349814,54,3,1959,10,"male",2391,243,152,4,11,1,3,3,8
1349841,16,12,1997,5,"male",52,1,0,1,14,0,1,1,13
1349855,26,14,1987,4,"male",494,69,15,1,1,1,1,0,0
1349875,26,17,1987,5,"female",343,252,207,36,15,16,6,20,9
1349884,18,21,1995,9,"male",433,166,117,47,2,45,2,2,0
1349885,47,24,1966,11,"female",260,29,9,47,39,0,30,47,9
1349942,22,3,1991,3,"male",394,85,44,2,1,2,1,0,0
1349980,17,13,1996,7,"male",581,443,344,124,187,78,116,46,71
1349987,22,30,1991,12,"female",571,137,67,0,0,0,0,0,0
1349995,22,12,1991,10,"female",576,210,138,251,192,251,117,0,75
1350017,26,12,1987,12,"male",99,37,34,19,4,19,4,0,0
1350033,26,2,1987,11,"male",138,365,203,37,84,37,25,0,59
1350087,17,2,1996,5,"male",194,158,145,0,17,0,10,0,7
1350096,29,23,1984,9,"female",447,82,58,928,104,928,54,0,50
1350100,13,7,2000,8,"male",70,39,18,0,0,0,0,0,0
1350109,20,20,1993,5,"male",28,21,18,5,1,5,1,0,0
1350114,24,27,1989,5,"male",371,171,147,0,1,0,0,0,1
1350144,52,2,1961,2,"male",901,45,37,2,0,2,0,0,0
1350156,38,9,1975,6,"male",414,22,15,0,0,0,0,0,0
1350183,65,27,1948,12,"male",1693,206,104,416,162,319,121,97,41
1350188,22,15,1991,4,"male",534,187,117,0,1,0,1,0,0
1350232,53,13,1960,3,"female",611,26,10,2,0,0,0,2,0
1350243,18,1,1995,1,"female",467,107,67,2,9,0,7,2,2
1350249,30,9,1983,5,"female",249,111,91,22,34,17,17,5,17
1350252,37,13,1976,5,"female",666,157,50,7,4,0,0,7,4
1350267,18,10,1995,7,"male",185,47,32,13,1,13,1,0,0
1350272,61,29,1952,8,"female",507,52,40,42,1,42,1,0,0
1350283,17,9,1996,1,"female",116,20,7,156,81,154,34,2,47
1350290,27,8,1986,5,"male",1016,2,2,0,0,0,0,0,0
1350330,57,10,1956,7,"male",859,13,5,0,0,0,0,0,0
1350355,19,7,1994,7,"male",321,88,41,0,0,0,0,0,0
1350359,106,14,1907,6,"female",1971,370,240,408,451,249,185,159,266
1350378,52,17,1961,3,"male",875,1332,1011,141,207,107,95,34,112
1350389,15,9,1998,11,"female",19,4,4,1,3,1,3,0,0
1350393,24,18,1989,8,"female",410,147,124,19,38,19,26,0,12
1350407,103,15,1910,9,"male",905,364,282,0,3,0,3,0,0
1350413,20,21,1993,2,"female",546,569,472,397,204,339,146,58,58
1350416,15,1,1998,7,"male",146,25,21,224,15,220,4,4,11
1350417,19,28,1994,3,"female",488,177,80,12,26,10,13,2,13
1350418,15,23,1998,1,"female",720,104,43,95,176,95,106,0,70
1350423,18,7,1995,6,"female",288,220,98,90,46,63,17,27,29
1350430,16,22,1997,2,"female",859,1639,390,1828,2275,1086,1835,742,440
1350432,17,10,1996,5,"female",665,1184,809,207,796,207,679,0,117
1350456,15,4,1998,8,"male",348,45,4,52,10,49,6,3,4
1350497,46,14,1967,11,"female",489,443,133,814,145,814,107,0,38
1350501,19,23,1994,3,"male",1492,48,43,0,0,0,0,0,0
1350506,26,1,1987,1,"male",517,5,2,0,0,0,0,0,0
1350529,55,1,1958,4,"female",303,49,23,16,13,16,10,0,3
1350532,25,25,1988,5,"male",153,35,17,0,0,0,0,0,0
1350550,34,7,1979,11,"female",783,449,356,433,111,402,52,31,59
1350557,22,7,1991,10,"male",525,64,21,3,3,0,1,3,2
1350598,64,10,1949,10,"female",997,1,1,0,0,0,0,0,0
1350623,69,9,1944,10,"female",1772,114,26,111,126,109,76,2,50
1350631,14,9,1999,3,"male",66,121,56,666,9,153,3,513,6
1350667,53,23,1960,1,"female",318,67,45,28,48,28,48,0,0
1350689,26,3,1987,6,"female",290,26,15,29,11,29,10,0,1
1350692,68,9,1945,5,"male",1255,213,115,108,95,108,56,0,39
1350716,35,28,1978,4,"male",907,0,0,0,0,0,0,0,0
1350718,19,14,1994,3,"male",485,493,443,134,23,108,12,26,11
1350720,33,5,1980,2,"male",135,205,169,9,8,2,1,7,7
1350733,17,18,1996,12,"male",291,295,221,5,0,0,0,5,0
1350746,19,27,1994,3,"male",370,1,1,1,0,1,0,0,0
1350751,21,7,1992,2,"female",178,26,11,551,516,546,171,5,345
1350753,67,16,1946,9,"female",462,36,20,1,2,1,2,0,0
1350759,36,26,1977,12,"male",464,104,61,150,18,150,8,0,10
1350775,51,1,1962,1,"male",752,233,181,2,2,2,1,0,1
1350795,33,25,1980,12,"male",344,7,7,2,2,0,0,2,2
1350800,40,18,1973,4,"male",115,77,65,70,59,31,12,39,47
1350813,43,18,1970,6,"male",433,2,0,0,0,0,0,0,0
1350836,51,2,1962,8,"female",1603,48,22,469,162,258,95,211,67
1350845,18,26,1995,4,"male",397,722,634,31,23,31,17,0,6
1350848,19,9,1994,12,"male",149,180,71,45,69,12,28,33,41
1350913,24,24,1989,3,"male",377,0,0,0,0,0,0,0,0
1350919,45,18,1968,10,"female",534,4,2,0,0,0,0,0,0
1350938,89,8,1924,6,"male",641,17,13,0,0,0,0,0,0
1350961,31,13,1982,9,"male",110,138,93,8,6,0,0,8,6
1350965,19,15,1994,6,"male",612,140,124,19,7,19,7,0,0
1350968,19,6,1994,11,"female",602,686,258,377,1407,331,624,46,783
1351003,20,26,1993,12,"male",49,41,35,4,0,4,0,0,0
1351019,87,9,1926,4,"female",1348,22,7,0,0,0,0,0,0
1351035,64,16,1949,1,"male",1136,104,53,6,1,0,1,6,0
1351046,36,22,1977,12,"male",574,1,1,9,2,0,0,9,2
1351065,19,28,1994,11,"male",553,68,31,50,52,31,26,19,26
1351070,39,28,1974,3,"male",600,267,223,116,17,113,13,3,4
1351079,17,25,1996,6,"female",277,56,27,6,15,6,15,0,0
1351094,16,12,1997,10,"male",40,126,101,2,2,2,2,0,0
1351099,15,9,1998,3,"male",374,15,15,0,0,0,0,0,0
1351110,23,16,1990,8,"male",1088,302,228,1,18,1,14,0,4
1351113,34,22,1979,1,"female",374,74,59,7,5,7,5,0,0
1351135,108,12,1905,3,"female",247,365,106,13,6,13,6,0,0
1351142,54,25,1959,4,"male",444,428,365,15,12,0,7,15,5
1351149,34,8,1979,2,"male",67,44,22,69,98,69,84,0,14
1351162,30,19,1983,11,"female",430,140,80,510,678,510,401,0,277
1351171,25,2,1988,1,"male",198,92,80,10,7,0,5,10,2
1351179,20,5,1993,8,"male",477,133,94,0,0,0,0,0,0
1351189,17,11,1996,5,"male",261,264,164,1,0,0,0,1,0
1351203,19,31,1994,3,"male",509,254,92,6,14,4,5,2,9
1351214,20,1,1993,10,"female",593,426,294,17,68,17,34,0,34
1351224,43,26,1970,9,"male",312,2,2,0,0,0,0,0,0
1351228,63,7,1950,1,"male",23,26,21,10,16,10,9,0,7
1351230,27,28,1986,11,"female",365,31,21,11,4,0,0,11,4
1351231,31,7,1982,5,"female",1007,218,128,98,79,96,42,2,37
1351243,15,15,1998,6,"male",392,152,86,0,9,0,4,0,5
1351274,45,24,1968,4,"female",468,57,29,7,9,7,9,0,0
1351300,25,1,1988,1,"female",289,5,1,0,0,0,0,0,0
1351318,43,19,1970,12,"male",303,12,11,3,0,3,0,0,0
1351321,15,13,1998,4,"male",375,168,151,0,4,0,2,0,2
1351337,19,23,1994,3,"male",410,31,31,3,0,3,0,0,0
1351339,18,9,1995,4,"male",50,126,109,8,8,8,7,0,1
1351370,14,4,1999,1,"male",15,72,71,2,0,0,0,2,0
1351371,38,2,1975,11,"male",953,100,42,37,13,37,11,0,2
1351388,15,25,1998,7,"male",133,44,37,15,2,5,2,10,0
1351404,38,19,1975,5,"male",82,39,32,670,142,670,88,0,54
1351415,18,23,1995,10,"female",49,68,20,252,100,107,77,145,23
1351433,34,1,1979,9,"male",444,71,63,0,0,0,0,0,0
1351456,36,23,1977,4,"male",151,122,90,36,10,36,10,0,0
1351465,68,1,1945,1,"female",1228,599,374,606,195,192,167,414,28
1351485,68,28,1945,7,"male",947,470,302,3,37,3,22,0,15
1351503,31,12,1982,12,"male",871,120,75,2,0,0,0,2,0
1351549,20,2,1993,1,"male",120,42,30,0,0,0,0,0,0
1351553,17,9,1996,10,"female",699,338,282,1323,179,887,107,436,72
1351586,61,3,1952,12,"male",671,18,9,11,0,11,0,0,0
1351594,55,10,1958,9,"male",415,7,4,29,2,0,1,29,1
1351626,20,18,1993,7,"male",110,16,11,56,60,56,55,0,5
1351642,20,4,1993,2,"male",705,22,5,0,1,0,1,0,0
1351656,29,20,1984,5,"male",577,154,125,3,3,3,1,0,2
1351660,103,17,1910,12,"male",274,39,12,1,0,1,0,0,0
1351664,20,24,1993,9,"male",862,463,178,132,45,101,17,31,28
1351674,54,6,1959,3,"male",52,29,21,0,0,0,0,0,0
1351690,26,8,1987,9,"male",321,110,70,77,33,77,33,0,0
1351700,23,3,1990,4,"male",243,75,63,2,28,1,23,1,5
1351704,67,29,1946,7,"male",1335,67,6,0,41,0,8,0,33
1351707,43,1,1970,1,"male",424,3,3,3,0,3,0,0,0
1351738,15,25,1998,10,"male",148,46,43,0,0,0,0,0,0
1351759,59,26,1954,3,"male",807,269,209,6,34,6,9,0,25
1351762,113,15,1900,7,"female",1360,296,189,91,275,91,136,0,139
1351795,54,3,1959,6,"female",364,43,21,7,7,0,1,7,6
1351799,25,1,1988,1,"female",407,29,14,0,0,0,0,0,0
1351817,18,5,1995,4,"female",620,293,163,10,17,5,9,5,8
1351830,101,16,1912,4,"male",2151,341,241,0,4,0,4,0,0
1351831,39,21,1974,10,"male",603,71,26,0,0,0,0,0,0
1351840,21,5,1992,12,"male",424,157,119,49,11,49,10,0,1
1351842,57,28,1956,8,"female",468,8,1,0,0,0,0,0,0
1351861,26,9,1987,9,"female",51,109,100,8,84,7,59,1,25
1351877,72,3,1941,6,"female",479,57,36,4,1,2,1,2,0
1351884,106,1,1907,4,"male",279,439,339,134,149,125,144,9,5
1351915,30,17,1983,12,"male",191,119,47,30,1,30,1,0,0
1351933,61,10,1952,8,"female",229,95,66,5,26,5,18,0,8
1351959,21,23,1992,11,"female",459,40,22,25,0,20,0,5,0
1351968,61,6,1952,8,"male",2154,201,97,10,2,4,1,6,1
1351995,61,5,1952,5,"female",963,88,47,4,46,4,31,0,15
1352000,28,7,1985,8,"male",886,35,20,2,4,2,4,0,0
1352005,44,5,1969,5,"female",2230,42,25,18,50,18,47,0,3
1352009,103,29,1910,3,"male",549,1192,642,8963,1276,8747,1020,216,256
1352013,19,7,1994,9,"female",40,333,326,25,46,12,17,13,29
1352019,22,21,1991,5,"female",153,27,19,0,0,0,0,0,0
1352021,15,20,1998,4,"male",16,3,2,0,0,0,0,0,0
1352024,19,18,1994,10,"male",212,0,0,1,0,0,0,1,0
1352039,74,5,1939,4,"female",826,46,30,55,9,55,5,0,4
1352052,32,11,1981,5,"male",342,19,11,0,0,0,0,0,0
1352064,42,22,1971,12,"male",503,172,87,4,5,0,1,4,4
1352080,63,3,1950,7,"female",1670,25,14,1,1,1,1,0,0
1352091,46,25,1967,8,"female",538,414,225,105,19,3,3,102,16
1352111,35,8,1978,7,"female",25,28,7,0,0,0,0,0,0
1352113,62,3,1951,12,"female",740,38,2,0,0,0,0,0,0
1352123,25,26,1988,12,"male",1549,941,360,533,431,393,195,140,236
1352155,29,5,1984,10,"female",555,24,16,0,2,0,2,0,0
1352157,62,24,1951,7,"female",1362,123,31,9,21,9,21,0,0
1352194,21,24,1992,4,"female",403,31,25,0,0,0,0,0,0
1352217,25,10,1988,2,"female",381,153,37,340,251,269,109,71,142
1352228,28,1,1985,1,"male",138,32,24,3,13,3,6,0,7
1352245,41,30,1972,7,"female",1548,20,7,2330,512,1896,367,434,145
1352257,60,24,1953,9,"female",113,6,6,14,4,14,4,0,0
1352280,23,17,1990,8,"male",63,62,36,4,6,4,5,0,1
1352307,62,22,1951,1,"male",358,20,13,3,18,0,5,3,13
1352354,51,18,1962,2,"female",671,30,17,58,11,0,2,58,9
1352366,26,8,1987,5,"male",228,57,32,0,2,0,1,0,1
1352394,54,16,1959,12,"female",1084,163,76,56,130,14,79,42,51
1352399,108,21,1905,3,"female",844,182,105,140,217,107,115,33,102
1352452,15,23,1998,6,"male",608,200,167,0,0,0,0,0,0
1352490,19,30,1994,11,"male",156,173,128,9,5,6,1,3,4
1352509,24,5,1989,8,"female",337,211,56,24,9,1,5,23,4
1352525,68,4,1945,10,"male",529,15,8,0,0,0,0,0,0
1352563,15,22,1998,12,"female",213,224,56,64,145,60,87,4,58
1352565,30,15,1983,12,"male",84,152,109,0,0,0,0,0,0
1352569,38,16,1975,7,"male",177,174,13,1,5,1,5,0,0
1352575,31,14,1982,3,"female",1469,1206,614,19,290,19,214,0,76
1352577,22,21,1991,5,"male",538,444,252,2307,692,54,340,2253,352
1352600,22,10,1991,1,"female",427,481,138,425,526,425,307,0,219
1352621,25,20,1988,6,"female",509,241,110,58,238,29,91,29,147
1352641,35,28,1978,12,"male",19,2,2,2,1,2,0,0,1
1352664,24,19,1989,10,"female",1227,189,96,191,336,81,195,110,141
1352682,26,2,1987,2,"female",175,26,23,0,3,0,3,0,0
1352686,77,29,1936,6,"male",149,63,47,4,4,1,1,3,3
1352760,24,1,1989,3,"female",608,465,261,48,54,46,51,2,3
1352763,62,3,1951,8,"male",1831,192,102,407,15,407,9,0,6
1352766,41,27,1972,2,"male",402,78,64,9,10,9,9,0,1
1352782,44,22,1969,10,"male",863,125,71,37,14,37,13,0,1
1352821,113,12,1900,7,"male",1232,90,40,24,85,0,17,24,68
1352837,36,9,1977,8,"male",377,162,76,24,11,24,8,0,3
1352874,18,6,1995,1,"female",93,78,6,43,12,43,8,0,4
1352890,91,17,1922,11,"female",1340,4560,1040,67,206,67,182,0,24
1352922,45,28,1968,2,"female",1709,103,30,13,51,13,36,0,15
1352926,35,16,1978,6,"male",575,1,0,0,0,0,0,0,0
1352937,20,23,1993,2,"male",606,148,103,2,0,0,0,2,0
1352938,29,16,1984,8,"female",905,79,6,9,51,3,29,6,22
1352953,38,3,1975,8,"female",639,8,4,12,0,12,0,0,0
1352955,17,8,1996,5,"male",554,884,472,727,759,267,397,460,362
1352980,48,19,1965,3,"female",712,66,25,123,23,23,9,100,14
1352993,103,12,1910,7,"male",843,277,195,25,33,25,32,0,1
1353001,23,25,1990,1,"male",369,103,76,7,9,7,4,0,5
1353031,14,17,1999,4,"male",324,188,89,9,2,0,0,9,2
1353040,48,24,1965,3,"male",356,74,22,16,8,14,3,2,5
1353051,40,11,1973,10,"female",525,62,29,3556,1234,489,146,3067,1088
1353056,28,12,1985,12,"female",2252,150,88,639,627,419,446,220,181
1353062,38,3,1975,4,"female",450,111,83,22,123,4,64,18,59
1353069,48,13,1965,8,"female",404,105,27,50,44,50,19,0,25
1353076,17,9,1996,10,"male",545,100,4,33,5,33,5,0,0
1353108,64,26,1949,12,"female",464,163,83,36,12,0,3,36,9
1353127,67,29,1946,11,"female",1216,52,20,1,1,1,0,0,1
1353136,47,31,1966,12,"female",255,53,24,7,31,7,29,0,2
1353186,103,29,1910,1,"female",1433,344,149,16,8,16,2,0,6
1353187,22,10,1991,9,"female",744,443,365,99,9,23,3,76,6
1353220,58,1,1955,4,"female",1103,68,28,53,46,0,27,53,19
1353287,91,12,1922,6,"male",1225,1570,1201,9,38,9,29,0,9
1353294,29,14,1984,2,"male",77,123,36,17,0,17,0,0,0
1353296,23,21,1990,10,"male",573,176,94,97,127,97,38,0,89
1353297,65,31,1948,10,"female",207,115,62,24,28,0,13,24,15
1353349,54,12,1959,1,"female",250,42,25,157,127,0,20,157,107
1353350,15,15,1998,3,"male",124,6,2,0,0,0,0,0,0
1353355,19,28,1994,5,"female",320,13,2,6,0,6,0,0,0
1353363,27,20,1986,2,"female",405,74,42,0,7,0,5,0,2
1353377,19,5,1994,5,"female",962,3499,794,1451,2821,975,1416,476,1405
1353405,25,24,1988,12,"male",466,57,33,63,43,6,10,57,33
1353440,96,1,1917,12,"female",563,36,7,104,46,0,9,104,37
1353460,19,10,1994,6,"female",450,68,45,1172,218,987,130,185,88
1353461,54,3,1959,7,"female",211,54,38,18,4,0,1,18,3
1353467,45,10,1968,1,"female",316,68,48,15,6,15,6,0,0
1353472,16,6,1997,2,"male",77,154,105,39,238,9,111,30,127
1353479,22,13,1991,3,"male",557,92,43,28,23,27,12,1,11
1353499,18,15,1995,3,"female",231,319,115,10,80,10,51,0,29
1353508,59,15,1954,4,"male",466,32,25,1,2,1,2,0,0
1353517,31,13,1982,4,"female",96,61,29,393,81,393,58,0,23
1353558,22,22,1991,4,"female",177,229,104,9,38,6,8,3,30
1353603,41,2,1972,2,"male",300,52,47,0,0,0,0,0,0
1353607,26,21,1987,2,"female",171,177,60,120,99,115,91,5,8
1353611,66,14,1947,8,"female",723,31,15,76,34,76,33,0,1
1353626,68,15,1945,3,"female",1806,45,25,1,0,1,0,0,0
1353632,18,6,1995,6,"male",106,36,27,8,0,0,0,8,0
1353647,59,17,1954,12,"male",1851,332,121,187,485,147,306,40,179
1353648,14,17,1999,10,"male",20,70,8,7,9,1,7,6,2
1353653,29,21,1984,4,"male",515,152,80,31,34,31,34,0,0
1353655,34,29,1979,10,"male",596,86,38,13,1,13,1,0,0
1353661,34,6,1979,3,"male",366,33,21,0,0,0,0,0,0
1353693,80,14,1933,3,"female",787,562,125,11,54,11,53,0,1
1353694,19,2,1994,11,"female",196,295,50,124,55,124,46,0,9
1353697,20,24,1993,6,"female",686,1000,535,38,110,37,101,1,9
1353782,61,26,1952,7,"male",351,34,23,1,0,0,0,1,0
1353791,43,1,1970,3,"female",491,1,1,0,0,0,0,0,0
1353819,113,30,1900,1,"female",1219,198,89,138,155,120,144,18,11
1353840,67,22,1946,8,"female",1224,79,40,709,482,37,251,672,231
1353881,30,23,1983,8,"female",615,21,8,92,55,92,14,0,41
1353886,18,5,1995,7,"male",895,169,69,0,0,0,0,0,0
1353917,17,3,1996,9,"female",524,343,171,194,118,106,93,88,25
1353926,79,1,1934,1,"female",1840,147,57,48,10,48,10,0,0
1353930,22,11,1991,9,"male",127,81,49,9,36,0,9,9,27
1353945,23,1,1990,1,"male",435,0,0,0,0,0,0,0,0
1353951,40,28,1973,5,"male",12,6,6,0,0,0,0,0,0
1353952,32,10,1981,12,"male",335,30,17,1,0,1,0,0,0
1353979,30,28,1983,9,"female",430,26,10,34,1,34,1,0,0
1353981,16,28,1997,11,"male",181,453,383,75,48,25,39,50,9
1354005,21,11,1992,8,"male",219,53,46,5,1,5,1,0,0
1354006,20,20,1993,9,"male",440,309,144,169,87,147,43,22,44
1354014,18,30,1995,1,"female",193,17,13,7,1,6,1,1,0
1354038,65,29,1948,2,"female",220,24,20,23,13,0,0,23,13
1354050,93,7,1920,4,"male",1809,436,243,81,1123,1,327,80,796
1354073,18,8,1995,5,"female",793,1944,1193,488,291,488,193,0,98
1354091,21,6,1992,6,"male",330,106,75,44,11,44,10,0,1
1354103,14,9,1999,5,"male",449,349,191,34,1,34,1,0,0
1354107,65,20,1948,10,"female",938,86,54,704,119,0,25,704,94
1354115,40,9,1973,6,"male",947,86,29,0,3,0,1,0,2
1354209,60,26,1953,7,"female",689,28,3,4,16,0,4,4,12
1354215,53,29,1960,6,"male",1095,330,100,0,3,0,3,0,0
1354234,15,2,1998,3,"male",208,59,55,1,0,1,0,0,0
1354242,103,16,1910,10,"male",277,176,161,130,5,130,5,0,0
1354306,19,4,1994,11,"male",406,276,147,4,12,4,12,0,0
1354307,31,2,1982,12,"female",402,224,126,11,38,11,30,0,8
1354325,103,22,1910,3,"male",877,443,86,4,23,2,15,2,8
1354364,18,4,1995,10,"female",137,292,29,4,0,4,0,0,0
1354383,23,1,1990,1,"male",286,84,42,0,0,0,0,0,0
1354409,35,24,1978,9,"female",428,226,70,11,57,11,31,0,26
1354420,108,27,1905,2,"male",78,26,25,20,1,0,1,20,0
1354428,29,11,1984,7,"male",357,73,33,39,34,39,30,0,4
1354456,28,26,1985,6,"female",619,22,3,2,11,2,10,0,1
1354459,25,3,1988,10,"male",28,14,14,25,6,25,6,0,0
1354476,19,3,1994,12,"female",565,268,81,3,32,3,25,0,7
1354501,18,25,1995,8,"female",1915,544,237,44,79,44,31,0,48
1354538,24,3,1989,7,"male",160,48,31,8,20,8,4,0,16
1354544,51,27,1962,10,"male",1114,84,40,20,6,0,5,20,1
1354592,70,19,1943,9,"female",654,88,54,30,17,18,3,12,14
1354598,25,25,1988,1,"male",10,2,2,1,0,1,0,0,0
1354616,59,21,1954,10,"male",563,27,22,0,0,0,0,0,0
1354636,62,19,1951,3,"male",500,33,10,0,2,0,2,0,0
1354639,52,14,1961,2,"male",264,61,25,2,1,0,1,2,0
1354651,21,28,1992,2,"female",354,110,55,1218,2429,1204,774,14,1655
1354665,38,28,1975,8,"male",396,3,3,3,2,1,0,2,2
1354672,78,8,1935,9,"female",1578,187,63,1679,1719,0,465,1679,1254
1354681,68,26,1945,3,"male",430,474,299,221,139,162,45,59,94
1354711,26,1,1987,1,"male",564,24,13,0,0,0,0,0,0
1354731,67,30,1946,3,"female",1868,75,46,106,17,46,11,60,6
1354771,36,13,1977,4,"male",247,30,17,232,74,232,46,0,28
1354773,23,18,1990,3,"male",239,46,34,41,0,0,0,41,0
1354774,22,2,1991,7,"male",324,262,251,23,5,0,2,23,3
1354777,18,2,1995,3,"male",460,153,111,6,1,0,0,6,1
1354790,20,22,1993,4,"male",504,90,44,155,82,85,51,70,31
1354802,86,25,1927,5,"female",733,213,38,2,0,2,0,0,0
1354812,43,6,1970,4,"male",181,1,1,0,0,0,0,0,0
1354818,17,9,1996,10,"male",527,269,188,21,10,21,10,0,0
1354821,26,24,1987,7,"male",233,1,1,0,0,0,0,0,0
1354822,14,30,1999,6,"male",362,325,148,24,0,24,0,0,0
1354826,21,27,1992,9,"male",186,1,1,18,9,16,9,2,0
1354852,35,13,1978,11,"female",422,53,34,67,40,67,29,0,11
1354858,26,1,1987,1,"male",352,58,10,1,0,1,0,0,0
1354914,26,16,1987,6,"male",874,278,224,9,29,9,29,0,0
1354953,49,25,1964,3,"male",634,270,188,689,305,689,146,0,159
1354964,18,27,1995,6,"female",908,763,480,231,165,159,106,72,59
1354985,42,20,1971,2,"female",309,29,10,6,15,3,8,3,7
1355016,16,27,1997,4,"male",676,236,186,63,10,40,6,23,4
1355027,20,12,1993,2,"female",246,1015,710,908,1075,573,577,335,498
1355045,15,24,1998,3,"male",276,5,2,0,0,0,0,0,0
1355056,56,9,1957,1,"female",677,1700,58,0,0,0,0,0,0
1355100,24,10,1989,6,"female",719,61,30,0,1,0,0,0,1
1355129,69,29,1944,1,"female",2382,87,17,67,51,67,34,0,17
1355137,27,14,1986,8,"male",277,328,312,43,122,43,114,0,8
1355150,47,17,1966,2,"male",13,1,1,1,0,0,0,1,0
1355178,17,14,1996,9,"female",178,183,158,24,30,11,16,13,14
1355190,31,6,1982,3,"male",27,68,42,861,357,861,170,0,187
1355264,39,4,1974,4,"female",711,119,79,8,3,8,3,0,0
1355295,44,29,1969,9,"female",403,24,19,1,1,1,0,0,1
1355303,56,16,1957,1,"female",456,134,121,37,62,0,48,37,14
1355306,27,14,1986,2,"male",446,1150,860,914,832,914,827,0,5
1355320,52,9,1961,11,"female",2185,473,219,397,339,261,125,136,214
1355321,29,4,1984,1,"male",74,1,1,0,19,0,7,0,12
1355336,30,1,1983,2,"female",588,1138,540,9,102,9,92,0,10
1355348,20,10,1993,11,"female",673,296,165,81,264,15,143,66,121
1355414,46,20,1967,12,"male",323,21,12,0,0,0,0,0,0
1355435,64,24,1949,12,"female",101,16,12,26,1,0,0,26,1
1355452,66,26,1947,8,"male",1638,66,51,11,4,0,2,11,2
1355457,23,7,1990,1,"male",398,534,489,1,13,1,7,0,6
1355464,33,12,1980,6,"male",219,75,65,1,83,1,36,0,47
1355481,31,14,1982,10,"female",863,255,198,72,66,72,30,0,36
1355491,33,22,1980,6,"male",375,32,6,4,109,4,89,0,20
1355510,17,15,1996,11,"male",563,973,820,41,61,11,15,30,46
1355524,23,7,1990,8,"female",437,33,5,10,0,7,0,3,0
1355548,29,2,1984,1,"male",584,37,20,0,14,0,8,0,6
1355582,20,31,1993,12,"male",438,62,39,62,54,16,6,46,48
1355591,15,4,1998,7,"male",151,57,35,3,6,3,3,0,3
1355593,69,19,1944,9,"female",80,26,22,0,0,0,0,0,0
1355595,24,6,1989,11,"male",59,11,11,0,0,0,0,0,0
1355614,43,13,1970,11,"male",138,253,221,3,1,2,1,1,0
1355621,65,4,1948,4,"male",152,34,18,0,53,0,33,0,20
1355641,17,10,1996,1,"female",228,104,85,84,72,77,40,7,32
1355668,14,25,1999,9,"male",139,36,12,0,6,0,4,0,2
1355675,37,4,1976,5,"female",457,43,30,119,151,92,135,27,16
1355677,16,7,1997,6,"female",378,55,39,2,0,2,0,0,0
1355686,24,16,1989,5,"female",476,50,22,518,85,493,60,25,25
1355732,23,11,1990,2,"male",538,135,75,123,29,120,15,3,14
1355739,18,2,1995,6,"female",258,100,54,0,0,0,0,0,0
1355746,24,31,1989,7,"male",557,125,51,53,163,53,90,0,73
1355750,18,8,1995,4,"male",709,137,127,7,0,7,0,0,0
1355752,42,1,1971,3,"female",244,15,11,13,2,13,1,0,1
1355755,26,2,1987,3,"male",667,237,32,3,0,3,0,0,0
1355760,49,12,1964,6,"female",175,148,112,20,96,15,73,5,23
1355781,38,4,1975,11,"male",591,83,62,2,4,0,3,2,1
1355790,48,12,1965,9,"male",632,77,56,0,0,0,0,0,0
1355798,21,2,1992,7,"female",8,10,9,64,27,64,27,0,0
1355813,14,8,1999,12,"male",276,29,18,41,0,41,0,0,0
1355824,41,9,1972,11,"male",468,36,29,768,13,768,11,0,2
1355840,24,29,1989,8,"female",271,39,13,0,0,0,0,0,0
1355843,44,1,1969,7,"male",325,47,15,2,38,2,17,0,21
1355859,21,17,1992,4,"male",434,202,146,39,54,39,49,0,5
1355901,25,5,1988,3,"male",256,97,55,0,5,0,3,0,2
1355906,69,1,1944,1,"male",323,70,47,998,476,0,189,998,287
1355917,23,21,1990,7,"male",372,165,120,61,1,61,0,0,1
1355934,48,9,1965,2,"male",265,44,30,3,0,0,0,3,0
1355949,20,18,1993,1,"female",797,0,0,0,0,0,0,0,0
1355965,47,26,1966,3,"female",322,79,54,0,0,0,0,0,0
1355974,18,7,1995,9,"male",561,224,106,61,9,61,9,0,0
1355976,86,29,1927,10,"female",1202,63,33,80,23,0,0,80,23
1355988,14,21,1999,6,"male",211,62,51,0,1,0,1,0,0
1355995,103,2,1910,4,"male",736,255,97,36,26,36,16,0,10
1355997,21,7,1992,4,"male",305,1,1,0,0,0,0,0,0
1356001,51,6,1962,10,"male",222,159,132,125,95,100,17,25,78
1356033,103,26,1910,10,"female",855,142,30,2,8,2,6,0,2
1356044,28,8,1985,12,"male",27,5,4,129,27,129,26,0,1
1356077,48,18,1965,4,"female",262,23,13,2,4,0,2,2,2
1356084,108,4,1905,5,"male",2408,692,423,1195,556,332,358,863,198
1356088,29,20,1984,1,"male",409,104,23,0,0,0,0,0,0
1356090,18,29,1995,10,"male",317,79,37,1,0,0,0,1,0
1356098,36,15,1977,9,"female",529,94,41,41,5,41,3,0,2
1356099,22,5,1991,5,"male",179,14,10,0,0,0,0,0,0
1356115,23,6,1990,8,"male",10,3,1,0,0,0,0,0,0
1356121,15,6,1998,10,"male",462,43,20,0,1,0,1,0,0
1356136,19,18,1994,10,"male",295,97,82,9,2,9,1,0,1
1356141,15,4,1998,10,"female",149,21,9,34,2,11,1,23,1
1356183,22,22,1991,12,"male",675,495,268,60,4,60,4,0,0
1356193,26,20,1987,8,"female",275,27,12,16,8,4,1,12,7
1356203,34,26,1979,10,"male",145,114,102,21,38,13,34,8,4
1356208,21,23,1992,8,"female",267,633,136,140,14,140,13,0,1
1356213,22,15,1991,6,"female",486,43,20,11,16,11,10,0,6
1356247,23,24,1990,4,"male",257,63,38,9,63,9,44,0,19
1356269,108,22,1905,12,"female",1488,242,90,355,30,217,15,138,15
1356284,29,9,1984,3,"female",400,21,19,0,0,0,0,0,0
1356298,103,16,1910,8,"male",752,177,134,0,1,0,1,0,0
1356339,67,16,1946,9,"female",678,31,24,1,6,1,4,0,2
1356350,33,29,1980,7,"female",1538,221,115,268,605,244,541,24,64
1356371,17,25,1996,6,"male",51,127,115,8,1,8,1,0,0
1356377,15,24,1998,4,"male",89,516,381,6180,1779,1191,1453,4989,326
1356380,19,30,1994,9,"male",264,151,91,7,10,7,7,0,3
1356388,16,31,1997,7,"male",363,105,63,0,0,0,0,0,0
1356399,101,18,1912,10,"female",915,56,41,25,10,17,5,8,5
1356425,23,7,1990,1,"male",212,72,57,0,1,0,0,0,1
1356430,32,16,1981,5,"female",619,166,59,0,56,0,11,0,45
1356439,51,12,1962,9,"female",554,38,20,236,54,140,34,96,20
1356457,17,10,1996,2,"female",199,2,2,0,0,0,0,0,0
1356467,58,29,1955,3,"female",1663,75,39,325,452,301,339,24,113
1356489,25,13,1988,4,"female",847,11,7,0,0,0,0,0,0
1356516,28,13,1985,3,"male",790,76,49,1,19,1,19,0,0
1356525,47,5,1966,11,"male",316,94,53,14,16,1,6,13,10
1356531,14,27,1999,8,"male",4,13,13,8,10,8,8,0,2
1356571,64,3,1949,7,"male",519,99,77,23,5,0,1,23,4
1356574,21,20,1992,1,"male",171,257,123,0,9,0,6,0,3
1356587,21,22,1992,2,"male",460,718,619,95,133,95,127,0,6
1356603,15,14,1998,2,"male",179,1197,1116,158,137,148,125,10,12
1356615,22,25,1991,7,"male",458,91,62,2,1,2,1,0,0
1356619,58,14,1955,5,"male",278,15,9,0,1,0,0,0,1
1356639,16,6,1997,2,"male",324,72,63,0,0,0,0,0,0
1356648,18,27,1995,1,"male",171,96,37,79,77,79,59,0,18
1356673,53,14,1960,9,"male",719,4,4,1,1,1,1,0,0
1356695,21,17,1992,10,"female",8,5,5,4,4,4,4,0,0
1356698,16,18,1997,9,"male",380,68,26,24,0,4,0,20,0
1356703,50,17,1963,3,"female",707,205,75,26,81,1,33,25,48
1356710,22,11,1991,4,"male",394,2,1,0,0,0,0,0,0
1356725,18,1,1995,1,"female",12,0,0,31,22,30,9,1,13
1356728,32,5,1981,7,"female",634,24,15,25,3,23,3,2,0
1356745,19,16,1994,11,"male",442,925,825,237,375,137,93,100,282
1356808,67,3,1946,11,"female",1715,139,71,41,25,19,16,22,9
1356827,62,30,1951,11,"male",185,332,258,5,20,5,20,0,0
1356856,19,1,1994,1,"male",32,6,4,3,2,3,1,0,1
1356857,18,24,1995,11,"male",2,40,39,3,1,3,1,0,0
1356871,18,20,1995,11,"female",87,855,643,576,1620,576,1119,0,501
1356926,28,23,1985,6,"female",728,74,62,0,10,0,2,0,8
1356952,18,7,1995,12,"male",65,37,35,55,8,6,3,49,5
1356959,21,16,1992,4,"female",508,178,51,333,340,301,261,32,79
1356981,18,11,1995,8,"male",409,111,72,3,24,0,13,3,11
1357011,42,1,1971,9,"male",692,103,77,9,15,7,10,2,5
1357033,21,8,1992,8,"female",101,403,37,2275,5499,2275,5049,0,450
1357043,24,12,1989,4,"male",5,15,15,4,0,4,0,0,0
1357072,21,23,1992,3,"female",666,6,1,0,0,0,0,0,0
1357077,54,17,1959,3,"male",199,101,62,92,47,58,24,34,23
1357079,26,4,1987,10,"female",218,261,195,38,76,26,44,12,32
1357085,23,2,1990,9,"female",185,0,0,54,20,51,17,3,3
1357087,25,1,1988,4,"female",182,31,20,14,12,14,12,0,0
1357095,20,6,1993,8,"female",649,60,35,20,15,0,1,20,14
1357136,60,11,1953,1,"male",1568,256,150,17,12,12,4,5,8
1357166,21,3,1992,12,"male",225,89,65,20,36,20,30,0,6
1357178,94,9,1919,3,"female",1219,1072,294,1,5,0,3,1,2
1357203,34,27,1979,2,"female",454,49,28,166,250,166,250,0,0
1357209,23,15,1990,4,"male",192,54,50,5,9,1,6,4,3
1357264,47,28,1966,3,"male",181,9,8,1,1,1,1,0,0
1357273,108,11,1905,8,"male",1624,949,487,924,709,924,525,0,184
1357347,30,2,1983,10,"male",349,173,122,9,27,9,18,0,9
1357357,51,1,1962,1,"male",868,61,24,0,3,0,2,0,1
1357371,47,14,1966,9,"male",109,127,122,5,1,5,1,0,0
1357372,16,1,1997,8,"male",23,1,1,1,1,1,1,0,0
1357402,98,27,1915,10,"male",802,132,58,26,7,15,1,11,6
1357438,26,6,1987,3,"female",442,35,17,4,17,0,6,4,11
1357449,36,1,1977,10,"male",275,28,15,0,2,0,1,0,1
1357457,17,17,1996,7,"female",181,32,22,0,5,0,5,0,0
1357470,18,13,1995,5,"male",30,22,19,3,2,3,1,0,1
1357494,65,11,1948,3,"male",621,56,33,65,52,65,34,0,18
1357515,47,25,1966,6,"male",185,25,19,0,0,0,0,0,0
1357539,20,19,1993,1,"male",306,80,62,362,204,361,114,1,90
1357545,83,1,1930,10,"female",634,68,44,1,0,1,0,0,0
1357554,50,9,1963,2,"male",1401,87,33,11,1,0,1,11,0
1357582,37,29,1976,2,"female",878,2738,2021,6294,6258,2416,3845,3878,2413
1357601,15,26,1998,7,"female",241,242,148,2,11,0,1,2,10
1357607,23,1,1990,4,"female",298,31,20,163,123,31,30,132,93
1357624,73,4,1940,7,"female",819,35,23,0,7,0,1,0,6
1357631,38,15,1975,2,"male",235,94,20,38,23,38,17,0,6
1357669,32,19,1981,2,"female",411,66,46,53,3,53,2,0,1
1357672,31,28,1982,11,"female",133,133,41,236,466,236,250,0,216
1357674,25,15,1988,8,"male",298,296,205,8,10,5,5,3,5
1357683,25,1,1988,1,"male",221,48,34,0,0,0,0,0,0
1357698,20,19,1993,4,"male",437,223,168,2,2,2,2,0,0
1357701,26,1,1987,1,"male",320,70,19,3661,391,3661,320,0,71
1357705,17,26,1996,7,"female",416,161,115,4,89,0,65,4,24
1357719,40,27,1973,6,"female",511,465,340,56,21,56,16,0,5
1357733,30,8,1983,12,"male",600,2,0,0,0,0,0,0,0
1357758,19,17,1994,10,"male",711,314,114,1,1,1,1,0,0
1357774,18,6,1995,11,"male",178,239,150,5,6,5,5,0,1
1357776,55,30,1958,9,"female",842,154,76,613,195,119,48,494,147
1357785,37,1,1976,8,"female",208,262,171,26,35,16,13,10,22
1357800,16,22,1997,1,"female",202,97,69,113,8,112,8,1,0
1357805,68,24,1945,3,"male",1099,924,634,1061,594,1061,480,0,114
1357818,28,15,1985,1,"female",367,90,29,37,14,32,7,5,7
1357822,23,1,1990,1,"male",413,26,23,0,8,0,6,0,2
1357828,41,16,1972,8,"male",488,30,24,0,2,0,0,0,2
1357835,15,9,1998,3,"female",648,307,108,243,102,238,53,5,49
1357843,44,1,1969,1,"male",24,6,3,5,5,1,1,4,4
1357847,23,17,1990,9,"male",26,15,11,0,0,0,0,0,0
1357852,20,4,1993,9,"male",249,62,53,0,0,0,0,0,0
1357878,70,26,1943,7,"male",1356,37,20,125,30,35,14,90,16
1357885,16,5,1997,9,"male",150,45,33,0,7,0,2,0,5
1357895,16,27,1997,7,"male",325,85,34,1,1,1,1,0,0
1357911,28,24,1985,10,"male",397,64,38,10,41,10,33,0,8
1357913,23,13,1990,7,"female",147,99,74,138,185,129,76,9,109
1357922,21,17,1992,9,"female",230,71,34,0,0,0,0,0,0
1357943,54,20,1959,5,"female",824,374,68,0,24,0,20,0,4
1357963,48,23,1965,10,"male",266,1,1,0,0,0,0,0,0
1357973,15,12,1998,3,"male",9,0,0,0,0,0,0,0,0
1358031,43,28,1970,9,"male",411,59,55,0,0,0,0,0,0
1358044,59,18,1954,12,"male",1461,277,198,84,57,82,48,2,9
1358060,64,1,1949,9,"male",1601,37,14,7,2,0,2,7,0
1358070,86,18,1927,11,"female",1226,744,457,14,7,14,4,0,3
1358081,17,18,1996,11,"female",102,75,67,1,8,1,4,0,4
1358084,27,2,1986,3,"female",197,401,327,2264,1110,2242,587,22,523
1358088,31,10,1982,10,"male",12,5,5,7,3,7,0,0,3
1358097,27,20,1986,3,"male",182,468,358,0,8,0,0,0,8
1358166,24,19,1989,12,"male",724,173,90,12,9,12,5,0,4
1358188,44,20,1969,10,"male",74,10,8,0,0,0,0,0,0
1358191,63,25,1950,3,"female",274,13,5,4,0,2,0,2,0
1358240,30,3,1983,7,"male",166,156,148,3,1,3,1,0,0
1358250,52,1,1961,1,"male",40,291,269,42,1,0,1,42,0
1358254,43,1,1970,6,"female",629,73,34,39,31,39,23,0,8
1358264,33,24,1980,9,"female",51,48,38,126,60,126,60,0,0
1358293,24,5,1989,10,"female",165,553,491,203,60,112,20,91,40
1358328,21,25,1992,12,"male",258,277,231,20,17,20,14,0,3
1358354,25,31,1988,7,"male",468,66,29,8,1,8,1,0,0
1358359,23,8,1990,9,"male",294,162,94,70,32,23,5,47,27
1358371,55,8,1958,4,"male",653,112,61,163,120,163,36,0,84
1358379,51,30,1962,11,"male",642,210,30,53,226,12,143,41,83
1358406,23,25,1990,12,"male",210,114,94,2,0,2,0,0,0
1358428,19,25,1994,4,"female",1353,4598,2396,37,1486,37,1138,0,348
1358432,15,27,1998,7,"female",232,2,1,0,0,0,0,0,0
1358446,23,3,1990,1,"male",181,20,18,37,21,16,12,21,9
1358449,72,4,1941,5,"male",404,260,154,13,2,12,1,1,1
1358450,53,8,1960,8,"male",257,58,42,9,24,0,2,9,22
1358452,19,20,1994,1,"male",1200,623,336,17,3,2,2,15,1
1358465,58,16,1955,10,"female",922,40,24,13,15,0,11,13,4
1358483,24,5,1989,11,"male",513,0,0,0,0,0,0,0,0
1358487,26,11,1987,12,"female",243,268,241,174,741,172,398,2,343
1358521,38,21,1975,9,"male",863,180,102,20,3,20,3,0,0
1358523,25,5,1988,10,"female",1771,966,527,781,1278,196,829,585,449
1358532,20,6,1993,8,"female",179,761,39,299,217,9,143,290,74
1358553,21,15,1992,7,"male",548,1131,1061,89,50,34,42,55,8
1358596,22,14,1991,3,"male",307,92,61,9,14,3,12,6,2
1358604,74,8,1939,10,"male",644,21,7,0,0,0,0,0,0
1358629,64,14,1949,8,"female",186,51,25,1,2,1,2,0,0
1358646,68,28,1945,5,"male",524,28,12,0,0,0,0,0,0
1358653,16,16,1997,5,"male",120,200,51,943,2652,402,1104,541,1548
1358665,22,9,1991,10,"female",564,268,179,3,24,3,23,0,1
1358678,17,6,1996,12,"male",247,63,45,3,0,3,0,0,0
1358680,21,15,1992,4,"male",537,50,33,242,100,0,58,242,42
1358692,33,2,1980,11,"female",615,0,0,0,0,0,0,0,0
1358720,50,11,1963,1,"male",150,19,16,0,13,0,4,0,9
1358725,24,25,1989,12,"male",200,170,62,147,173,147,172,0,1
1358729,60,24,1953,9,"female",763,80,22,404,55,404,34,0,21
1358733,26,13,1987,5,"male",338,290,268,3,12,3,11,0,1
1358744,52,8,1961,3,"female",382,52,49,13,4,13,4,0,0
1358757,35,5,1978,9,"male",165,2,2,18,2,15,2,3,0
1358767,24,28,1989,8,"male",362,159,101,3,0,0,0,3,0
1358769,55,2,1958,3,"female",1621,70,42,1,0,1,0,0,0
1358847,18,24,1995,1,"male",163,188,132,8,7,3,5,5,2
1358867,20,2,1993,2,"male",110,90,47,8,2,0,0,8,2
1358873,22,15,1991,4,"female",446,101,47,0,0,0,0,0,0
1358879,18,8,1995,9,"male",318,217,189,9,6,1,6,8,0
1358890,33,20,1980,4,"male",246,15,4,3,18,3,8,0,10
1358897,108,1,1905,1,"male",1822,243,117,45,133,0,68,45,65
1358905,26,13,1987,8,"female",915,67,19,46,17,46,16,0,1
1358937,19,6,1994,5,"female",258,342,39,0,1,0,1,0,0
1358947,62,16,1951,9,"female",1753,73,12,0,0,0,0,0,0
1358987,44,21,1969,3,"male",291,126,54,650,256,650,207,0,49
1358991,21,19,1992,3,"male",461,60,19,8,5,8,5,0,0
1359012,34,5,1979,1,"male",683,68,20,12,33,12,12,0,21
1359019,27,4,1986,6,"male",203,109,87,1,0,1,0,0,0
1359027,35,26,1978,2,"male",603,48,32,85,60,81,44,4,16
1359048,24,10,1989,8,"male",1093,68,19,0,6,0,3,0,3
1359056,17,12,1996,4,"female",1351,1221,550,867,479,732,253,135,226
1359064,28,1,1985,1,"female",136,24,3,2,17,1,15,1,2
1359071,15,16,1998,8,"male",84,89,69,34,3,34,1,0,2
1359073,36,26,1977,8,"female",510,41,21,65,73,65,53,0,20
1359107,18,16,1995,4,"male",185,0,0,0,0,0,0,0,0
1359111,23,2,1990,10,"male",182,173,140,2,87,2,67,0,20
1359114,23,9,1990,9,"male",566,327,280,0,0,0,0,0,0
1359135,25,14,1988,4,"male",37,9,6,9,5,9,4,0,1
1359174,38,27,1975,11,"female",78,20,6,7,0,7,0,0,0
1359185,25,1,1988,1,"male",130,17,10,1,0,1,0,0,0
1359188,34,8,1979,11,"male",50,47,31,1,1,1,1,0,0
1359212,61,12,1952,10,"male",709,217,48,33,172,0,16,33,156
1359222,55,9,1958,5,"male",327,25,18,10,8,10,8,0,0
1359254,52,23,1961,2,"male",594,125,72,0,6,0,1,0,5
1359274,63,4,1950,3,"male",326,15,10,0,0,0,0,0,0
1359290,40,15,1973,3,"male",906,13,7,2,6,2,6,0,0
1359306,15,6,1998,7,"male",406,141,101,0,0,0,0,0,0
1359309,32,1,1981,1,"male",202,9,9,14,3,14,3,0,0
1359329,27,3,1986,9,"male",768,134,67,3,0,3,0,0,0
1359345,51,2,1962,10,"female",637,50,29,91,86,29,54,62,32
1359349,21,14,1992,7,"male",543,35,16,1,6,1,6,0,0
1359370,43,9,1970,9,"female",126,120,98,329,312,327,122,2,190
1359379,56,29,1957,12,"female",843,34,28,35,5,0,1,35,4
1359385,62,20,1951,10,"male",236,19,8,0,2,0,1,0,1
1359388,33,4,1980,4,"male",390,88,45,0,2,0,0,0,2
1359391,33,28,1980,3,"male",608,89,57,15,0,15,0,0,0
1359398,22,5,1991,5,"male",767,43,34,66,13,1,9,65,4
1359411,21,5,1992,8,"male",485,154,131,25,2,4,0,21,2
1359416,35,18,1978,10,"male",262,9,6,0,0,0,0,0,0
1359424,27,11,1986,4,"male",503,1,1,0,0,0,0,0,0
1359467,46,25,1967,5,"male",337,12,9,19,12,19,12,0,0
1359483,14,28,1999,11,"male",178,33,21,0,1,0,0,0,1
1359489,38,27,1975,8,"female",294,67,31,74,132,51,111,23,21
1359505,29,1,1984,2,"female",1224,116,47,27,41,27,17,0,24
1359513,22,22,1991,8,"female",462,116,71,6,40,6,29,0,11
1359532,50,10,1963,8,"male",1182,3482,1695,954,2906,17,1344,937,1562
1359554,100,27,1913,2,"male",1399,295,216,30,44,30,42,0,2
1359569,43,4,1970,6,"male",245,89,73,3,20,3,19,0,1
1359581,22,19,1991,4,"male",266,455,390,45,19,45,15,0,4
1359594,16,30,1997,5,"male",520,1596,1052,483,333,411,243,72,90
1359602,30,30,1983,10,"male",93,122,88,9,2,9,2,0,0
1359642,18,22,1995,7,"male",114,3,3,0,0,0,0,0,0
1359650,22,1,1991,1,"male",324,40,21,0,0,0,0,0,0
1359669,101,12,1912,1,"male",1336,288,241,0,1,0,1,0,0
1359685,68,5,1945,4,"male",711,28,17,0,6,0,2,0,4
1359693,43,2,1970,2,"male",524,64,56,25,5,25,3,0,2
1359717,32,15,1981,10,"female",370,68,60,3,0,3,0,0,0
1359721,67,17,1946,3,"female",1357,46,19,43,46,0,23,43,23
1359722,108,12,1905,3,"female",1040,305,161,78,49,78,43,0,6
1359779,18,14,1995,5,"male",564,237,208,7,52,2,12,5,40
1359792,53,3,1960,6,"female",1521,143,92,10,9,10,4,0,5
1359843,33,7,1980,8,"male",29,89,80,0,0,0,0,0,0
1359850,26,1,1987,1,"male",322,14,13,0,2,0,2,0,0
1359873,65,2,1948,8,"male",549,32,8,0,0,0,0,0,0
1359874,14,25,1999,6,"male",356,507,383,0,1,0,1,0,0
1359911,15,22,1998,6,"male",474,565,492,418,146,415,88,3,58
1359925,19,16,1994,4,"male",362,402,164,926,307,925,273,1,34
1359970,22,17,1991,12,"female",548,355,290,23,23,23,13,0,10
1359972,15,24,1998,5,"male",316,212,35,0,0,0,0,0,0
1359977,23,5,1990,5,"male",47,1,1,3,3,3,3,0,0
1359999,44,15,1969,2,"female",559,146,51,1,3,0,0,1,3
1360023,31,6,1982,7,"male",1225,140,57,29,115,29,48,0,67
1360024,21,18,1992,6,"female",260,35,11,0,0,0,0,0,0
1360039,49,10,1964,1,"female",621,62,42,385,775,32,571,353,204
1360054,18,20,1995,1,"male",202,519,384,34,55,20,21,14,34
1360076,23,28,1990,11,"male",272,28,18,0,0,0,0,0,0
1360093,103,1,1910,10,"male",787,49,33,0,6,0,2,0,4
1360106,78,30,1935,7,"female",1691,91,48,40,19,0,14,40,5
1360122,23,10,1990,12,"male",539,99,47,0,0,0,0,0,0
1360138,18,16,1995,5,"female",397,407,284,2,3,2,3,0,0
1360153,16,25,1997,5,"male",789,900,684,14,54,13,48,1,6
1360157,19,16,1994,5,"male",683,621,474,129,87,129,74,0,13
1360207,23,11,1990,3,"male",549,87,78,0,1,0,1,0,0
1360221,27,12,1986,12,"male",423,61,57,624,104,624,77,0,27
1360237,18,9,1995,3,"male",195,162,144,1499,696,1207,322,292,374
1360248,39,27,1974,4,"male",422,15,9,0,0,0,0,0,0
1360258,30,4,1983,8,"female",254,4,4,0,0,0,0,0,0
1360269,58,4,1955,12,"female",417,11,5,33,7,14,2,19,5
1360273,33,23,1980,1,"female",455,4,1,0,0,0,0,0,0
1360321,22,28,1991,2,"male",750,560,471,37,2,37,2,0,0
1360335,15,14,1998,8,"male",310,44,30,49,20,45,15,4,5
1360358,34,11,1979,3,"male",401,11,10,0,1,0,0,0,1
1360419,64,3,1949,3,"female",1315,190,47,103,9,103,6,0,3
1360436,19,17,1994,2,"male",426,109,95,7,0,0,0,7,0
1360449,33,1,1980,4,"female",573,128,43,0,1,0,1,0,0
1360458,20,1,1993,4,"male",285,0,0,0,0,0,0,0,0
1360497,62,6,1951,7,"female",243,34,19,0,0,0,0,0,0
1360532,21,14,1992,11,"male",234,43,13,0,0,0,0,0,0
1360540,25,24,1988,1,"male",400,187,134,29,29,29,21,0,8
1360603,21,28,1992,9,"female",438,1098,322,1367,5383,642,2792,725,2591
1360604,16,10,1997,2,"male",356,47,16,2,3,1,0,1,3
1360621,16,26,1997,9,"male",240,300,134,0,0,0,0,0,0
1360632,90,9,1923,11,"female",918,58,31,5,35,5,13,0,22
1360662,15,21,1998,4,"female",448,653,402,141,295,8,47,133,248
1360664,27,29,1986,10,"male",444,150,92,264,29,263,24,1,5
1360671,37,15,1976,3,"male",732,32,8,0,0,0,0,0,0
1360676,32,1,1981,2,"male",671,2,2,21,0,21,0,0,0
1360685,31,27,1982,6,"male",440,128,80,0,8,0,0,0,8
1360687,37,8,1976,9,"male",267,52,14,0,0,0,0,0,0
1360706,34,11,1979,11,"male",207,141,83,63,48,63,32,0,16
1360713,103,28,1910,2,"male",1102,239,127,122,57,92,28,30,29
1360720,30,8,1983,8,"male",648,439,305,0,28,0,19,0,9
1360725,18,20,1995,1,"male",288,175,113,5,7,0,0,5,7
1360743,48,13,1965,8,"female",524,143,90,14,5,0,2,14,3
1360745,19,8,1994,12,"female",225,691,500,705,974,605,809,100,165
1360760,90,21,1923,4,"male",283,163,142,5,26,0,15,5,11
1360762,20,15,1993,8,"male",131,45,21,175,85,175,77,0,8
1360805,19,18,1994,11,"male",249,159,106,0,3,0,0,0,3
1360806,33,10,1980,8,"male",363,2,1,0,0,0,0,0,0
1360821,14,5,1999,6,"male",6,28,28,52,4,28,2,24,2
1360823,47,28,1966,3,"male",292,1,1,0,0,0,0,0,0
1360841,65,2,1948,10,"female",686,40,23,4,32,0,20,4,12
1360879,16,22,1997,7,"male",147,0,0,0,0,0,0,0,0
1360903,70,18,1943,3,"male",1782,14,4,1,1,0,1,1,0
1360907,24,2,1989,2,"male",668,91,76,0,0,0,0,0,0
1360919,24,24,1989,5,"female",165,355,298,52,151,52,131,0,20
1360953,50,6,1963,1,"male",350,18,17,0,0,0,0,0,0
1360979,62,28,1951,6,"male",790,146,65,501,1126,501,554,0,572
1360994,71,18,1942,5,"male",614,50,22,2,3,0,3,2,0
1361027,70,1,1943,1,"male",991,525,285,20,1,0,1,20,0
1361034,16,27,1997,10,"female",210,286,102,2,92,2,43,0,49
1361037,25,1,1988,1,"male",105,1,0,0,0,0,0,0,0
1361077,23,7,1990,12,"male",41,1,1,0,0,0,0,0,0
1361089,38,24,1975,1,"female",191,37,33,18,11,18,11,0,0
1361098,33,6,1980,7,"male",545,63,38,160,7,160,7,0,0
1361122,19,14,1994,6,"male",59,40,31,0,0,0,0,0,0
1361127,98,25,1915,12,"female",1648,55,21,8,20,0,4,8,16
1361128,74,10,1939,4,"female",2342,282,76,233,156,0,94,233,62
1361152,55,27,1958,2,"male",1192,39,30,15,7,6,6,9,1
1361164,43,5,1970,3,"female",235,49,32,0,2,0,1,0,1
1361171,36,14,1977,2,"male",197,47,29,5,0,5,0,0,0
1361175,37,1,1976,4,"female",229,114,105,0,0,0,0,0,0
1361178,17,17,1996,11,"male",10,2,1,0,0,0,0,0,0
1361189,23,23,1990,11,"female",707,69,28,726,93,726,56,0,37
1361195,17,5,1996,4,"male",289,13,6,22,1,22,1,0,0
1361208,17,15,1996,9,"male",168,121,46,0,0,0,0,0,0
1361222,23,24,1990,8,"male",100,21,21,3,0,3,0,0,0
1361224,55,27,1958,12,"female",134,6,5,0,0,0,0,0,0
1361234,16,4,1997,5,"male",162,51,43,2,1,2,1,0,0
1361249,16,22,1997,5,"male",565,302,239,179,13,0,1,179,12
1361268,18,1,1995,3,"male",168,96,79,1725,1222,1725,1153,0,69
1361290,56,26,1957,2,"female",1385,70,18,186,22,186,16,0,6
1361308,21,18,1992,12,"male",425,919,847,0,0,0,0,0,0
1361353,23,7,1990,7,"female",329,49,42,16,0,16,0,0,0
1361372,34,1,1979,8,"male",547,48,36,4,8,4,5,0,3
1361383,19,5,1994,6,"male",108,62,25,1,0,1,0,0,0
1361416,23,4,1990,11,"male",605,0,0,0,0,0,0,0,0
1361424,16,16,1997,12,"male",379,312,242,0,0,0,0,0,0
1361427,21,30,1992,9,"male",222,1119,554,1893,3170,285,1153,1608,2017
1361499,23,13,1990,4,"male",429,6,6,1,0,0,0,1,0
1361503,23,14,1990,6,"female",317,352,303,17,12,11,4,6,8
1361522,61,26,1952,10,"male",1205,27,3,9,14,0,6,9,8
1361547,21,3,1992,2,"male",182,105,86,0,1,0,1,0,0
1361559,66,1,1947,12,"female",1186,213,62,132,26,132,13,0,13
1361572,21,13,1992,3,"male",590,986,566,302,100,7,29,295,71
1361616,23,1,1990,11,"male",369,284,186,20,0,0,0,20,0
1361641,16,9,1997,11,"male",438,65,43,0,0,0,0,0,0
1361670,61,1,1952,1,"male",611,58,53,0,1,0,1,0,0
1361678,36,8,1977,11,"female",495,27,12,4,0,4,0,0,0
1361699,28,13,1985,7,"male",786,209,119,41,72,24,17,17,55
1361703,113,14,1900,5,"male",1130,728,480,12,13,0,2,12,11
1361728,33,13,1980,5,"male",578,203,115,486,320,486,207,0,113
1361754,39,18,1974,8,"female",462,18,7,29,9,29,7,0,2
1361760,103,14,1910,2,"male",551,245,98,60,81,24,33,36,48
1361766,50,26,1963,5,"male",732,57,48,7,17,0,0,7,17
1361776,17,2,1996,3,"male",556,19,1,0,47,0,39,0,8
1361807,53,14,1960,1,"female",174,25,6,41,4,40,3,1,1
1361825,55,10,1958,5,"male",1123,45,26,10,1,0,0,10,1
1361829,70,16,1943,8,"female",299,8,4,3,5,3,5,0,0
1361846,17,15,1996,9,"male",381,158,92,7,8,1,3,6,5
1361859,33,5,1980,10,"female",31,23,15,4,12,4,2,0,10
1361863,23,6,1990,11,"male",897,1296,1110,0,2,0,1,0,1
1361868,53,3,1960,12,"female",1573,54,23,61,20,61,16,0,4
1361893,55,25,1958,4,"female",1547,430,115,12,78,3,43,9,35
1361952,100,6,1913,8,"male",2437,373,176,2,2,2,1,0,1
1361958,34,7,1979,10,"male",418,33,22,0,0,0,0,0,0
1361986,35,1,1978,4,"male",309,246,219,77,72,77,52,0,20
1361988,26,5,1987,5,"female",246,65,35,287,66,287,61,0,5
1361995,20,29,1993,6,"female",195,1,1,3,0,3,0,0,0
1361996,39,23,1974,12,"female",1124,116,106,8,6,0,4,8,2
1362007,21,10,1992,1,"male",867,743,316,31,40,30,21,1,19
1362030,73,7,1940,12,"female",403,83,65,90,58,1,44,89,14
1362074,59,5,1954,7,"female",398,227,39,0,45,0,9,0,36
1362084,19,9,1994,9,"male",509,139,73,10,3,10,3,0,0
1362085,18,20,1995,12,"female",231,15,4,51,8,51,8,0,0
1362101,22,18,1991,3,"male",271,5,5,0,0,0,0,0,0
1362102,30,1,1983,1,"male",33,30,19,269,31,269,23,0,8
1362113,22,22,1991,5,"female",306,193,121,19,28,19,23,0,5
1362144,16,22,1997,3,"male",650,456,231,19,70,15,27,4,43
1362193,108,26,1905,11,"female",170,62,29,222,58,11,24,211,34
1362198,23,15,1990,2,"female",599,55,10,1,0,1,0,0,0
1362207,21,25,1992,12,"male",89,14,6,0,0,0,0,0,0
1362209,23,30,1990,5,"male",436,93,66,0,1,0,1,0,0
1362217,103,15,1910,9,"male",1474,637,370,54,79,54,43,0,36
1362232,47,2,1966,11,"female",136,11,11,0,0,0,0,0,0
1362239,27,18,1986,1,"male",380,109,33,67,6,54,2,13,4
1362296,49,20,1964,5,"male",703,129,83,9,0,0,0,9,0
1362314,18,27,1995,9,"male",104,139,112,7,15,7,14,0,1
1362325,101,23,1912,10,"female",1482,386,208,155,244,3,55,152,189
1362337,57,2,1956,7,"male",342,23,13,0,1,0,0,0,1
1362420,43,19,1970,3,"female",302,20,16,42,16,42,12,0,4
1362425,65,15,1948,4,"male",872,28,19,3,0,0,0,3,0
1362449,16,15,1997,8,"male",295,514,295,121,121,58,110,63,11
1362451,68,20,1945,2,"male",860,430,314,0,0,0,0,0,0
1362477,23,14,1990,9,"male",790,173,107,4,54,4,20,0,34
1362485,24,24,1989,3,"male",1427,1210,604,15,293,15,138,0,155
1362487,18,1,1995,1,"male",31,83,57,25,2,0,1,25,1
1362571,22,2,1991,8,"female",348,91,28,0,0,0,0,0,0
1362572,20,30,1993,8,"male",581,293,213,6,0,0,0,6,0
1362584,15,16,1998,7,"male",327,2,2,1,2,0,0,1,2
1362586,45,19,1968,5,"female",381,0,0,0,0,0,0,0,0
1362614,40,3,1973,3,"male",201,103,88,153,120,152,39,1,81
1362632,103,29,1910,5,"female",1426,144,49,9,1,4,1,5,0
1362652,25,16,1988,6,"female",208,47,12,108,91,108,55,0,36
1362660,15,9,1998,9,"female",14,155,23,3,14,3,5,0,9
1362678,29,3,1984,10,"female",784,89,46,87,91,81,45,6,46
1362693,53,19,1960,8,"female",571,139,113,1041,241,1,42,1040,199
1362725,23,7,1990,1,"male",663,157,77,0,30,0,30,0,0
1362735,108,20,1905,3,"male",228,13,10,1,1,0,0,1,1
1362784,57,16,1956,5,"male",126,77,68,7,25,7,22,0,3
1362789,62,18,1951,1,"female",955,115,67,16,18,0,10,16,8
1362800,67,7,1946,12,"female",1639,73,20,9,18,0,13,9,5
1362815,97,30,1916,12,"male",575,288,235,53,125,0,24,53,101
1362816,16,11,1997,8,"male",406,909,634,117,169,95,90,22,79
1362822,24,11,1989,1,"female",467,325,101,49,146,43,43,6,103
1362853,33,6,1980,9,"male",835,60,22,2,1,2,0,0,1
1362882,15,1,1998,5,"male",176,83,55,46,31,36,24,10,7
1362883,108,1,1905,1,"male",1636,198,93,57,70,1,22,56,48
1362886,48,13,1965,5,"male",270,131,97,10,20,3,12,7,8
1362895,23,11,1990,6,"male",263,9,6,11,0,0,0,11,0
1362905,53,19,1960,12,"female",332,61,57,173,4,91,4,82,0
1362911,25,1,1988,1,"female",19,15,12,0,0,0,0,0,0
1362934,29,28,1984,2,"female",309,62,51,10,4,10,4,0,0
1362968,68,25,1945,1,"male",1324,261,152,4,3,2,1,2,2
1362984,28,8,1985,6,"male",23,19,18,1,0,1,0,0,0
1362986,29,30,1984,6,"male",1,5,5,3,0,3,0,0,0
1362992,22,8,1991,4,"female",303,186,125,21,11,11,6,10,5
1363038,37,21,1976,5,"male",514,13,5,0,0,0,0,0,0
1363039,52,15,1961,3,"female",2067,228,145,115,216,87,152,28,64
1363045,17,10,1996,4,"male",643,149,71,0,0,0,0,0,0
1363063,21,26,1992,2,"female",215,1,1,5,0,5,0,0,0
1363093,18,13,1995,3,"male",240,39,30,0,7,0,1,0,6
1363133,67,20,1946,3,"female",957,127,94,476,304,0,116,476,188
1363148,14,15,1999,11,"male",386,48,24,21,2,5,2,16,0
1363150,19,28,1994,12,"male",293,80,66,1,0,1,0,0,0
1363152,21,18,1992,11,"male",55,112,102,17,0,0,0,17,0
1363153,41,4,1972,3,"female",673,137,96,1402,92,1402,68,0,24
1363229,93,14,1920,11,"male",1411,252,145,13,294,13,268,0,26
1363241,33,4,1980,9,"female",504,65,26,9,40,9,40,0,0
1363247,50,4,1963,8,"male",1385,63,21,3,1,0,0,3,1
1363272,18,19,1995,6,"male",493,51,44,2,0,0,0,2,0
1363281,27,28,1986,10,"female",241,70,33,11,19,11,18,0,1
1363282,28,18,1985,9,"female",532,446,328,157,307,118,132,39,175
1363300,21,4,1992,7,"female",232,102,70,21,2,21,1,0,1
1363308,108,10,1905,12,"female",498,934,359,67,26,67,25,0,1
1363324,29,21,1984,8,"male",697,13,9,0,0,0,0,0,0
1363348,29,27,1984,5,"female",370,318,144,1179,498,281,262,898,236
1363386,18,21,1995,5,"male",852,153,82,510,203,402,132,108,71
1363430,58,4,1955,6,"male",482,45,32,0,0,0,0,0,0
1363436,18,3,1995,4,"female",138,246,50,33,39,33,39,0,0
1363476,22,11,1991,11,"female",890,1,1,0,0,0,0,0,0
1363479,18,1,1995,1,"male",239,9,5,0,0,0,0,0,0
1363557,34,10,1979,10,"female",391,67,53,25,30,16,21,9,9
1363563,66,5,1947,3,"female",1053,262,90,156,28,132,19,24,9
1363576,16,16,1997,3,"male",78,151,136,38,24,38,16,0,8
1363581,24,11,1989,8,"male",171,53,46,3,2,0,1,3,1
1363584,29,16,1984,5,"male",278,95,27,91,71,60,40,31,31
1363585,65,4,1948,7,"male",950,46,29,17,17,17,13,0,4
1363587,30,2,1983,1,"male",277,39,34,4,1,4,1,0,0
1363591,63,2,1950,10,"female",117,45,28,379,90,0,44,379,46
1363607,100,13,1913,12,"female",1188,161,36,450,224,429,126,21,98
1363633,28,6,1985,9,"female",75,0,0,0,0,0,0,0,0
1363636,25,19,1988,12,"male",664,302,88,24,494,9,424,15,70
1363643,63,30,1950,8,"male",1290,52,31,19,18,19,12,0,6
1363660,68,18,1945,3,"female",496,23,10,1,3,0,1,1,2
1363669,18,3,1995,4,"female",435,262,99,4,44,4,41,0,3
1363677,103,6,1910,1,"male",1237,527,232,12,35,11,33,1,2
1363679,15,24,1998,6,"male",21,27,14,1,5,1,2,0,3
1363690,42,16,1971,6,"female",413,17,14,1,0,1,0,0,0
1363705,64,15,1949,12,"female",967,152,74,279,139,24,82,255,57
1363716,40,22,1973,2,"male",296,98,76,1,0,0,0,1,0
1363732,103,1,1910,6,"male",681,274,178,140,173,105,71,35,102
1363739,60,18,1953,11,"female",281,178,101,33,64,0,24,33,40
1363754,24,30,1989,7,"male",967,10,8,0,1,0,1,0,0
1363841,45,3,1968,2,"male",1175,101,1,1,8,1,5,0,3
1363858,16,1,1997,1,"male",465,142,57,183,249,1,15,182,234
1363860,43,3,1970,3,"male",215,155,133,69,27,69,22,0,5
1363920,46,7,1967,8,"female",483,19,11,114,21,113,17,1,4
1363921,52,11,1961,7,"female",366,5,5,0,1,0,1,0,0
1363959,48,21,1965,1,"male",732,532,128,42,90,31,24,11,66
1363961,23,10,1990,6,"male",608,100,59,4,3,0,0,4,3
1363965,33,6,1980,2,"male",300,58,52,1,0,0,0,1,0
1364002,17,2,1996,3,"male",298,50,34,54,2,12,1,42,1
1364052,28,16,1985,1,"male",559,64,33,0,0,0,0,0,0
1364076,17,27,1996,12,"female",287,1356,789,261,211,85,105,176,106
1364081,61,21,1952,1,"male",436,33,12,60,31,1,19,59,12
1364095,14,25,1999,5,"female",515,91,64,2,6,0,3,2,3
1364102,97,23,1916,7,"female",1206,60,38,755,155,655,72,100,83
1364121,17,5,1996,9,"male",606,208,124,3,0,3,0,0,0
1364132,60,30,1953,9,"female",627,118,76,588,442,588,210,0,232
1364148,55,25,1958,5,"female",1301,13,1,29,12,29,12,0,0
1364155,50,9,1963,12,"female",726,44,29,89,29,52,21,37,8
1364156,83,1,1930,4,"male",1891,124,73,27,25,22,13,5,12
1364179,73,13,1940,10,"female",22,11,7,2,0,1,0,1,0
1364206,21,23,1992,9,"male",1464,380,146,60,89,60,66,0,23
1364216,47,22,1966,9,"female",395,44,26,0,0,0,0,0,0
1364238,85,28,1928,2,"male",2023,122,83,40,52,23,33,17,19
1364308,33,12,1980,11,"female",313,152,75,163,226,163,159,0,67
1364318,16,8,1997,2,"male",529,77,31,1091,901,447,62,644,839
1364321,36,3,1977,10,"male",294,43,31,3,2,3,0,0,2
1364332,16,17,1997,9,"female",442,708,425,370,677,364,513,6,164
1364350,17,4,1996,10,"male",150,5,2,0,0,0,0,0,0
1364362,113,24,1900,1,"male",1203,27,14,47,7,34,3,13,4
1364372,23,23,1990,10,"male",122,92,88,2,0,0,0,2,0
1364383,49,13,1964,3,"female",1561,44,27,214,79,214,34,0,45
1364405,19,20,1994,3,"male",326,335,284,1,0,0,0,1,0
1364421,16,13,1997,2,"female",338,346,176,56,28,16,10,40,18
1364448,15,12,1998,1,"male",303,207,142,3,135,0,52,3,83
1364462,40,13,1973,8,"female",402,74,50,5,21,5,12,0,9
1364471,50,2,1963,3,"male",829,105,66,1,0,1,0,0,0
1364498,33,3,1980,11,"male",184,41,32,20,12,1,2,19,10
1364551,29,13,1984,10,"female",1315,222,95,244,40,234,16,10,24
1364552,20,14,1993,11,"male",483,243,216,3,0,0,0,3,0
1364588,25,26,1988,5,"female",1100,98,35,151,34,110,30,41,4
1364616,23,12,1990,9,"female",620,409,202,65,73,65,61,0,12
1364630,45,7,1968,8,"female",1670,262,111,458,1875,314,361,144,1514
1364632,20,17,1993,5,"male",210,90,76,3,0,3,0,0,0
1364653,42,30,1971,10,"male",612,63,19,0,0,0,0,0,0
1364727,18,2,1995,9,"female",391,262,174,237,33,236,33,1,0
1364732,19,29,1994,4,"male",582,94,81,0,1,0,1,0,0
1364735,20,15,1993,3,"female",528,237,157,29,30,29,28,0,2
1364786,39,22,1974,12,"male",194,167,132,667,591,588,368,79,223
1364792,106,6,1907,5,"male",2025,131,58,16,10,1,6,15,4
1364799,48,22,1965,7,"female",325,42,30,9,16,0,2,9,14
1364800,21,30,1992,8,"male",137,48,20,43,49,43,35,0,14
1364820,23,11,1990,2,"female",240,40,11,241,265,0,112,241,153
1364823,26,3,1987,1,"female",371,620,547,0,0,0,0,0,0
1364825,15,11,1998,7,"female",309,27,21,2,5,2,2,0,3
1364832,21,14,1992,1,"male",240,0,0,0,0,0,0,0,0
1364857,23,8,1990,5,"male",330,115,89,19,15,19,10,0,5
1364863,42,9,1971,11,"male",524,70,41,0,0,0,0,0,0
1364866,36,12,1977,10,"male",670,80,44,180,81,180,68,0,13
1364868,33,17,1980,9,"female",437,18,7,7,0,7,0,0,0
1364878,17,5,1996,3,"female",179,1130,9,3,53,3,44,0,9
1364887,16,19,1997,9,"female",214,41,34,0,2,0,2,0,0
1364938,63,9,1950,1,"male",402,71,63,2,5,0,1,2,4
1364949,32,3,1981,10,"male",249,15,12,0,1,0,0,0,1
1364977,49,1,1964,9,"male",1601,26,8,0,1,0,1,0,0
1364980,17,8,1996,9,"female",757,2600,1148,165,183,104,149,61,34
1364988,51,11,1962,12,"female",181,27,24,17,6,17,4,0,2
1365051,84,24,1929,5,"female",1116,146,120,11,38,11,32,0,6
1365053,23,1,1990,1,"female",544,78,12,0,7,0,3,0,4
1365082,73,24,1940,9,"female",846,38,12,64,9,0,3,64,6
1365103,20,11,1993,4,"male",265,132,99,18,8,17,3,1,5
1365154,37,2,1976,1,"male",359,134,98,16,12,12,12,4,0
1365182,68,15,1945,7,"female",894,37,5,1,1,1,1,0,0
1365183,16,30,1997,11,"male",637,333,199,2,0,2,0,0,0
1365187,45,3,1968,2,"male",379,9,8,0,1,0,0,0,1
1365213,47,6,1966,6,"female",1259,443,372,533,625,293,313,240,312
1365214,23,17,1990,3,"male",326,336,212,131,13,111,3,20,10
1365249,36,18,1977,2,"female",333,25,14,45,2,45,1,0,1
1365250,29,12,1984,9,"male",814,97,30,0,1,0,1,0,0
1365262,44,26,1969,12,"female",527,193,102,13,9,0,5,13,4
1365265,48,20,1965,10,"male",111,53,52,493,13,493,9,0,4
1365286,33,4,1980,9,"female",497,53,46,0,1,0,1,0,0
1365313,62,27,1951,11,"female",919,241,87,61,130,57,111,4,19
1365328,17,14,1996,4,"female",499,205,135,384,53,179,14,205,39
1365353,108,24,1905,2,"female",2251,102,75,299,214,35,127,264,87
1365355,15,8,1998,4,"male",548,141,99,0,3,0,0,0,3
1365374,18,6,1995,4,"male",602,176,83,7,6,7,6,0,0
1365439,22,14,1991,2,"male",74,108,99,103,62,103,32,0,30
1365449,22,22,1991,8,"male",187,135,69,353,77,177,28,176,49
1365463,22,16,1991,12,"male",456,8,8,46,5,46,4,0,1
1365481,64,8,1949,6,"male",1102,74,57,75,110,51,25,24,85
1365488,53,23,1960,1,"male",146,20,17,0,0,0,0,0,0
1365489,21,1,1992,8,"female",360,10,3,0,0,0,0,0,0
1365504,79,29,1934,4,"male",1019,104,56,64,109,59,89,5,20
1365517,20,5,1993,3,"female",53,85,77,129,492,127,308,2,184
1365530,103,16,1910,7,"male",1327,194,124,69,4,39,1,30,3
1365570,14,25,1999,3,"male",404,147,135,0,0,0,0,0,0
1365572,46,16,1967,12,"female",1234,56,30,372,440,63,123,309,317
1365576,19,17,1994,10,"female",502,423,112,498,934,46,711,452,223
1365577,25,7,1988,9,"male",796,29,12,9,1,9,0,0,1
1365583,23,17,1990,11,"female",108,34,27,1,0,1,0,0,0
1365595,28,2,1985,9,"female",165,13,10,4,1,0,0,4,1
1365629,19,2,1994,9,"male",382,41,22,0,0,0,0,0,0
1365640,31,1,1982,12,"male",249,5,3,0,0,0,0,0,0
1365650,48,13,1965,9,"male",743,7,4,0,0,0,0,0,0
1365651,47,11,1966,5,"male",135,6,6,2,1,0,0,2,1
1365666,30,25,1983,12,"male",956,188,145,23,4,17,3,6,1
1365703,39,27,1974,5,"female",553,16,11,32,2,32,0,0,2
1365712,17,29,1996,12,"male",129,1469,1430,1154,202,921,154,233,48
1365746,29,10,1984,8,"male",329,15,10,0,0,0,0,0,0
1365777,56,17,1957,4,"male",1366,278,180,574,534,521,302,53,232
1365779,38,30,1975,9,"male",371,76,35,2,11,2,9,0,2
1365782,33,13,1980,6,"male",298,99,60,134,154,134,92,0,62
1365783,26,2,1987,10,"male",608,118,99,5,9,5,2,0,7
1365801,103,27,1910,9,"male",1209,714,196,13,19,13,13,0,6
1365831,19,12,1994,5,"male",329,215,114,120,157,2,86,118,71
1365859,37,5,1976,5,"female",353,72,42,371,241,357,177,14,64
1365871,21,14,1992,6,"male",311,238,124,349,240,332,137,17,103
1365903,16,5,1997,3,"male",240,1430,1226,1333,614,1310,505,23,109
1365907,24,18,1989,11,"male",275,91,58,0,0,0,0,0,0
1365910,18,14,1995,12,"male",224,53,34,117,0,117,0,0,0
1365913,50,17,1963,5,"male",260,51,36,0,0,0,0,0,0
1365918,45,3,1968,3,"male",809,11,5,0,0,0,0,0,0
1365920,61,28,1952,8,"male",656,28,20,9,4,7,3,2,1
1365937,25,9,1988,10,"male",135,142,125,2,41,2,33,0,8
1365940,80,25,1933,10,"female",817,28,4,0,0,0,0,0,0
1365942,23,12,1990,12,"male",585,133,85,16,33,16,20,0,13
1365961,22,27,1991,11,"male",1006,267,191,8,6,2,1,6,5
1365971,49,24,1964,1,"female",1628,185,153,1616,498,1449,139,167,359
1365975,49,3,1964,9,"male",820,272,196,182,126,182,98,0,28
1365982,69,25,1944,2,"female",207,98,76,144,15,144,12,0,3
1365994,51,18,1962,10,"male",1832,144,85,184,55,175,14,9,41
1366006,18,11,1995,7,"female",234,166,60,463,581,56,379,407,202
1366025,18,5,1995,2,"male",419,221,194,13,3,13,3,0,0
1366039,62,14,1951,7,"female",2217,126,18,71,12,38,5,33,7
1366054,19,24,1994,5,"male",136,372,352,403,359,245,141,158,218
1366073,19,14,1994,1,"male",406,129,90,62,42,62,35,0,7
1366076,33,4,1980,8,"female",401,2,2,0,0,0,0,0,0
1366081,66,5,1947,1,"male",1489,69,4,0,0,0,0,0,0
1366119,107,1,1906,12,"female",1505,200,89,80,150,77,105,3,45
1366157,62,28,1951,1,"female",798,39,26,1,2,0,0,1,2
1366220,54,31,1959,7,"male",1024,7,5,2,82,0,64,2,18
1366239,34,23,1979,8,"male",1509,247,76,2,43,1,1,1,42
1366293,21,17,1992,10,"male",474,269,197,10,122,9,37,1,85
1366318,56,2,1957,2,"male",556,54,39,51,5,0,2,51,3
1366328,20,17,1993,3,"male",283,128,84,14,4,14,2,0,2
1366337,16,18,1997,6,"female",473,16,12,0,0,0,0,0,0
1366359,14,3,1999,1,"female",4,8,7,4,1,0,0,4,1
1366420,62,5,1951,7,"male",282,63,32,2,0,2,0,0,0
1366477,23,1,1990,1,"male",1104,1036,746,6,41,6,25,0,16
1366488,20,26,1993,11,"female",901,4106,398,40,71,40,67,0,4
1366492,25,8,1988,7,"male",721,40,29,0,6,0,6,0,0
1366510,25,1,1988,1,"male",93,50,34,6,1,6,1,0,0
1366575,52,10,1961,2,"male",555,89,79,137,21,137,14,0,7
1366576,16,27,1997,8,"male",374,401,243,9,23,0,13,9,10
1366594,50,14,1963,6,"male",1435,196,52,0,0,0,0,0,0
1366607,103,22,1910,11,"female",1053,244,87,3,1,3,1,0,0
1366638,108,21,1905,9,"female",1813,142,83,10,3,4,1,6,2
1366680,25,2,1988,11,"male",371,41,14,0,0,0,0,0,0
1366695,24,11,1989,1,"male",71,1,1,0,3,0,0,0,3
1366698,21,4,1992,3,"male",253,245,139,1,23,1,21,0,2
1366705,25,12,1988,6,"male",317,34,28,0,3,0,2,0,1
1366733,19,1,1994,1,"male",213,73,67,4,3,2,2,2,1
1366747,33,4,1980,4,"male",364,237,129,9,13,9,5,0,8
1366771,24,10,1989,11,"female",393,31,19,7,17,7,8,0,9
1366788,51,20,1962,8,"male",475,300,242,97,100,25,11,72,89
1366795,18,21,1995,10,"male",169,124,45,19,2,18,2,1,0
1366797,18,1,1995,1,"female",364,157,40,0,4,0,4,0,0
1366799,60,14,1953,9,"female",234,14,12,0,0,0,0,0,0
1366810,56,1,1957,7,"male",294,205,65,196,182,33,45,163,137
1366863,26,25,1987,9,"male",279,76,41,34,10,34,9,0,1
1366865,68,29,1945,10,"male",1453,283,157,11,70,11,60,0,10
1366873,20,16,1993,3,"female",65,40,31,794,262,764,170,30,92
1366880,25,11,1988,9,"female",166,327,210,194,108,194,68,0,40
1366894,72,28,1941,5,"female",1573,227,130,316,57,269,35,47,22
1366905,22,21,1991,1,"male",116,285,139,65,103,65,100,0,3
1366912,16,7,1997,11,"male",201,151,105,11,34,6,14,5,20
1366937,48,5,1965,1,"female",288,27,23,3,7,0,3,3,4
1366964,29,7,1984,7,"female",442,75,60,19,22,19,21,0,1
1366967,35,10,1978,2,"male",496,92,56,0,50,0,40,0,10
1366968,38,1,1975,12,"female",557,3,1,0,0,0,0,0,0
1366972,18,8,1995,12,"male",602,726,655,4,46,3,23,1,23
1366984,38,5,1975,1,"male",239,547,440,163,333,163,262,0,71
1366989,15,4,1998,3,"female",677,679,65,58,28,58,26,0,2
1367006,23,17,1990,8,"male",422,2072,1919,78,841,78,815,0,26
1367015,13,3,2000,1,"male",153,65,45,0,7,0,5,0,2
1367023,73,17,1940,10,"female",301,59,42,19,89,0,29,19,60
1367027,21,19,1992,1,"male",388,287,169,14,2,14,2,0,0
1367055,16,25,1997,8,"male",251,67,51,0,0,0,0,0,0
1367094,90,20,1923,6,"male",1594,14,10,0,6,0,1,0,5
1367139,21,6,1992,5,"female",270,229,12,0,0,0,0,0,0
1367142,26,3,1987,11,"male",207,121,105,10,6,10,3,0,3
1367177,28,10,1985,12,"male",230,261,230,0,2,0,1,0,1
1367181,95,8,1918,8,"male",1555,150,65,202,184,99,91,103,93
1367200,27,11,1986,7,"male",574,63,52,111,87,59,60,52,27
1367223,57,4,1956,3,"female",1985,217,121,16,14,0,11,16,3
1367239,14,3,1999,7,"male",152,101,85,10,0,9,0,1,0
1367263,20,20,1993,7,"female",400,171,131,0,5,0,1,0,4
1367301,19,30,1994,6,"male",353,314,202,17,5,17,4,0,1
1367335,51,9,1962,4,"male",896,207,76,0,0,0,0,0,0
1367340,65,19,1948,1,"male",1458,32,21,3,3,3,1,0,2
1367347,62,9,1951,3,"female",1809,246,146,489,435,488,204,1,231
1367391,43,10,1970,7,"female",460,70,48,18,4,2,0,16,4
1367447,23,5,1990,11,"female",39,18,15,5,10,5,7,0,3
1367462,32,30,1981,10,"female",104,97,91,118,96,4,58,114,38
1367478,64,2,1949,12,"male",307,21,20,0,0,0,0,0,0
1367486,17,3,1996,12,"female",595,391,176,0,0,0,0,0,0
1367529,17,9,1996,9,"female",217,1089,743,1,14,1,3,0,11
1367535,21,1,1992,1,"female",380,386,52,56,356,56,295,0,61
1367544,28,11,1985,9,"male",239,66,44,4,15,4,7,0,8
1367547,64,1,1949,7,"female",2136,320,213,35,131,29,57,6,74
1367571,16,17,1997,8,"male",484,215,99,2,409,2,402,0,7
1367574,18,8,1995,8,"male",546,671,546,32,15,31,14,1,1
1367621,21,1,1992,1,"male",589,215,83,16,64,1,14,15,50
1367657,63,11,1950,8,"female",684,28,3,0,0,0,0,0,0
1367682,62,28,1951,4,"female",664,25,17,378,4,362,4,16,0
1367691,14,19,1999,5,"female",23,16,6,5,8,5,6,0,2
1367734,20,3,1993,6,"male",8,116,111,11,7,0,6,11,1
1367735,63,21,1950,4,"female",350,6,2,3,1,0,1,3,0
1367768,51,6,1962,1,"female",727,54,34,12,17,0,4,12,13
1367787,19,24,1994,6,"male",348,121,84,329,314,327,199,2,115
1367797,24,15,1989,1,"male",636,91,76,0,0,0,0,0,0
1367798,30,1,1983,11,"male",382,0,0,0,0,0,0,0,0
1367829,41,9,1972,8,"female",498,185,100,1633,763,1633,714,0,49
1367873,17,27,1996,8,"male",344,452,221,13,119,13,55,0,64
1367900,23,24,1990,6,"female",146,69,31,216,77,216,71,0,6
1367929,15,23,1998,9,"female",91,273,178,16,0,16,0,0,0
1367937,97,18,1916,4,"female",1169,723,374,2,23,2,12,0,11
1367966,46,12,1967,2,"female",297,442,331,71,13,0,8,71,5
1367969,18,21,1995,6,"female",163,291,49,0,7,0,6,0,1
1367979,15,5,1998,3,"female",585,81,9,61,11,57,11,4,0
1368054,31,7,1982,7,"female",950,64,29,367,101,367,52,0,49
1368074,24,5,1989,6,"male",139,177,123,431,336,396,194,35,142
1368076,15,1,1998,1,"female",552,58,27,0,0,0,0,0,0
1368102,108,30,1905,7,"male",38,82,71,264,278,264,258,0,20
1368131,21,2,1992,3,"female",1033,70,31,32,234,19,40,13,194
1368155,53,29,1960,3,"female",1054,55,36,4,2,4,2,0,0
1368167,67,25,1946,5,"female",36,42,11,33,31,32,23,1,8
1368174,59,23,1954,3,"female",297,7,5,1,3,0,1,1,2
1368193,35,9,1978,3,"male",502,263,156,44,11,3,7,41,4
1368242,35,2,1978,11,"female",133,804,443,477,901,477,489,0,412
1368250,36,26,1977,7,"male",298,39,30,0,0,0,0,0,0
1368252,68,28,1945,1,"male",1772,38,8,1,1,0,0,1,1
1368258,21,25,1992,2,"female",314,200,138,538,286,538,117,0,169
1368276,21,7,1992,10,"male",867,378,316,1,11,1,10,0,1
1368307,20,26,1993,12,"male",16,7,7,9,8,9,8,0,0
1368360,65,24,1948,1,"female",1006,108,57,52,12,6,6,46,6
1368370,53,17,1960,9,"female",959,38,27,11,5,8,2,3,3
1368372,18,4,1995,1,"female",337,332,126,6,56,6,51,0,5
1368384,25,27,1988,6,"male",438,119,69,15,16,15,11,0,5
1368423,22,1,1991,1,"male",564,194,160,2,2,2,2,0,0
1368433,61,30,1952,3,"female",317,31,12,335,35,0,9,335,26
1368444,103,15,1910,9,"male",1162,128,100,2,1,1,0,1,1
1368458,18,25,1995,1,"male",416,171,110,190,1,0,1,190,0
1368467,31,20,1982,4,"male",303,2,2,0,0,0,0,0,0
1368496,25,22,1988,8,"female",828,21,9,188,294,149,23,39,271
1368550,26,3,1987,3,"male",630,39,28,0,2,0,2,0,0
1368580,19,6,1994,7,"female",210,24,10,12,20,12,19,0,1
1368584,108,8,1905,2,"female",312,398,163,48,104,48,100,0,4
1368603,24,9,1989,8,"male",555,242,46,12,0,0,0,12,0
1368605,23,15,1990,11,"male",268,203,150,56,24,56,19,0,5
1368621,63,18,1950,11,"female",1606,321,217,111,69,66,29,45,40
1368627,15,21,1998,12,"male",1003,338,184,0,0,0,0,0,0
1368628,14,27,1999,12,"female",459,82,37,87,18,58,15,29,3
1368656,18,15,1995,10,"female",414,274,113,3,0,3,0,0,0
1368677,14,25,1999,4,"female",501,115,81,4,0,4,0,0,0
1368703,27,8,1986,1,"male",188,48,44,137,31,137,22,0,9
1368711,24,3,1989,4,"male",710,77,47,0,0,0,0,0,0
1368712,22,16,1991,4,"female",625,71,34,17,37,17,30,0,7
1368735,25,15,1988,3,"male",586,106,51,10,1,10,1,0,0
1368736,68,29,1945,7,"male",91,16,11,87,20,87,2,0,18
1368740,65,8,1948,9,"female",652,39,4,0,0,0,0,0,0
1368744,35,18,1978,10,"male",467,68,46,160,125,134,95,26,30
1368764,26,11,1987,10,"female",308,3,0,0,0,0,0,0,0
1368774,89,19,1924,2,"female",1440,298,131,1144,1015,1127,904,17,111
1368781,41,15,1972,9,"female",745,70,50,52,19,30,9,22,10
1368784,50,6,1963,7,"female",286,53,36,91,160,91,112,0,48
1368814,46,5,1967,6,"male",90,19,16,3,5,3,3,0,2
1368818,17,27,1996,12,"male",301,164,127,22,2,22,2,0,0
1368828,34,23,1979,12,"male",217,9,1,1,0,1,0,0,0
1368836,23,9,1990,2,"female",1435,385,257,110,69,106,38,4,31
1368843,49,6,1964,6,"female",100,47,24,0,0,0,0,0,0
1368849,17,3,1996,10,"male",178,36,14,1,0,1,0,0,0
1368874,17,24,1996,1,"female",482,915,586,1322,830,479,121,843,709
1368895,45,27,1968,6,"male",547,5,4,0,1,0,1,0,0
1368908,21,14,1992,12,"female",919,2,2,0,0,0,0,0,0
1368925,17,22,1996,7,"male",651,277,172,699,218,555,90,144,128
1368966,18,15,1995,4,"female",195,1,1,1,1,1,1,0,0
1368976,22,10,1991,8,"male",385,1349,803,353,504,333,222,20,282
1368981,36,29,1977,6,"female",381,185,133,68,23,19,3,49,20
1369000,35,14,1978,9,"female",800,331,79,1630,1431,1386,602,244,829
1369005,16,11,1997,9,"female",300,349,84,676,554,673,537,3,17
1369019,66,22,1947,8,"female",555,317,144,472,303,472,290,0,13
1369030,20,11,1993,9,"male",807,38,21,0,17,0,15,0,2
1369035,26,1,1987,1,"male",440,307,256,145,10,145,10,0,0
1369059,23,9,1990,6,"female",108,101,67,1,0,0,0,1,0
1369079,24,10,1989,1,"female",392,94,45,266,369,114,161,152,208
1369080,26,17,1987,10,"male",1305,3,3,4,0,0,0,4,0
1369100,18,30,1995,8,"male",466,248,186,33,1,33,1,0,0
1369123,32,1,1981,1,"male",216,9,6,0,0,0,0,0,0
1369126,18,29,1995,7,"female",240,1269,616,712,3072,526,2733,186,339
1369141,19,5,1994,11,"female",364,86,41,12,0,1,0,11,0
1369151,37,11,1976,10,"male",448,41,16,0,84,0,40,0,44
1369158,25,5,1988,5,"male",148,1,0,0,0,0,0,0,0
1369183,47,14,1966,7,"male",111,5,2,5,34,0,31,5,3
1369192,20,15,1993,8,"male",548,861,771,4,6,4,3,0,3
1369209,18,12,1995,10,"male",28,0,0,1,1,1,1,0,0
1369217,51,24,1962,6,"male",159,65,52,166,87,166,74,0,13
1369234,16,20,1997,11,"male",381,9,2,0,0,0,0,0,0
1369239,59,21,1954,4,"male",1384,108,78,1,0,0,0,1,0
1369246,39,25,1974,7,"female",560,775,159,256,213,45,125,211,88
1369264,64,28,1949,7,"female",888,70,29,6,23,0,13,6,10
1369284,33,12,1980,4,"male",48,67,65,124,119,124,116,0,3
1369321,73,7,1940,10,"male",554,2,1,0,0,0,0,0,0
1369335,27,2,1986,7,"female",192,18,9,9,13,8,6,1,7
1369337,65,29,1948,11,"female",484,179,60,33,36,33,24,0,12
1369346,20,1,1993,5,"male",109,42,24,0,0,0,0,0,0
1369354,25,11,1988,6,"female",288,87,62,6,37,6,23,0,14
1369361,45,31,1968,5,"female",1833,91,56,59,73,5,65,54,8
1369385,32,13,1981,4,"male",884,27,16,1,4,1,4,0,0
1369400,18,23,1995,2,"male",263,96,63,10,1,10,1,0,0
1369409,33,21,1980,4,"female",27,126,10,274,986,187,705,87,281
1369414,68,14,1945,2,"male",321,11,9,24,3,0,2,24,1
1369459,19,27,1994,1,"female",188,374,339,13,5,13,0,0,5
1369495,23,24,1990,11,"male",571,336,234,8,2,0,1,8,1
1369502,35,6,1978,8,"female",128,136,106,81,467,81,397,0,70
1369522,30,12,1983,8,"male",398,33,15,0,0,0,0,0,0
1369530,25,1,1988,1,"female",255,9,7,0,0,0,0,0,0
1369547,44,13,1969,4,"female",1756,197,125,24,206,24,166,0,40
1369575,16,10,1997,8,"female",879,208,92,0,0,0,0,0,0
1369578,29,2,1984,6,"male",631,90,44,12,15,11,10,1,5
1369587,43,2,1970,3,"female",1313,164,73,564,267,563,209,1,58
1369595,18,18,1995,7,"male",615,214,161,146,85,146,66,0,19
1369596,35,15,1978,4,"female",308,29,13,126,72,126,56,0,16
1369611,56,25,1957,5,"male",640,15,3,1,1,0,0,1,1
1369655,30,17,1983,12,"male",414,175,61,61,10,1,4,60,6
1369656,14,10,1999,12,"female",279,955,371,1931,1255,813,541,1118,714
1369683,66,14,1947,4,"male",117,33,9,0,0,0,0,0,0
1369684,21,25,1992,9,"female",343,4,4,10,2,2,1,8,1
1369724,59,4,1954,10,"female",1515,70,15,2,8,0,3,2,5
1369726,19,19,1994,2,"male",1055,322,121,12,75,12,47,0,28
1369734,64,4,1949,9,"male",1779,30,24,4,0,0,0,4,0
1369746,22,1,1991,1,"female",322,0,0,0,0,0,0,0,0
1369773,19,10,1994,10,"female",397,169,51,1,1,1,0,0,1
1369782,19,24,1994,2,"male",171,225,145,158,575,110,385,48,190
1369811,16,4,1997,2,"female",589,119,58,449,378,10,119,439,259
1369816,27,16,1986,8,"female",324,95,68,22,12,0,6,22,6
1369817,22,14,1991,11,"female",369,7,5,11,1,10,1,1,0
1369838,33,1,1980,1,"male",340,7,7,0,0,0,0,0,0
1369848,44,4,1969,4,"male",617,77,40,0,23,0,4,0,19
1369856,17,20,1996,4,"female",115,186,149,62,98,62,85,0,13
1369860,24,9,1989,6,"male",282,1,0,0,0,0,0,0,0
1369881,50,7,1963,9,"female",762,18,3,15,37,8,20,7,17
1369894,51,23,1962,3,"male",1803,56,30,20,20,20,13,0,7
1369902,24,1,1989,2,"female",162,0,0,0,0,0,0,0,0
1369904,23,21,1990,1,"male",177,21,21,0,1,0,1,0,0
1369909,14,25,1999,6,"male",692,252,206,7,0,7,0,0,0
1369928,36,26,1977,10,"female",25,19,19,22,15,22,9,0,6
1369963,31,1,1982,1,"male",325,86,51,31,39,31,39,0,0
1369977,21,30,1992,9,"male",1124,201,107,11,6,11,6,0,0
1370008,20,24,1993,8,"female",309,630,338,165,376,164,316,1,60
1370013,26,4,1987,7,"male",332,372,263,127,4,127,4,0,0
1370022,14,13,1999,6,"male",148,27,18,141,45,141,36,0,9
1370027,13,22,2000,2,"male",73,75,45,98,11,97,10,1,1
1370037,55,16,1958,6,"male",481,227,103,2,8,2,6,0,2
1370043,46,18,1967,4,"male",988,184,92,0,0,0,0,0,0
1370050,43,1,1970,9,"male",1073,55,30,0,3,0,2,0,1
1370067,59,22,1954,3,"male",431,84,28,0,0,0,0,0,0
1370068,17,30,1996,3,"male",591,76,58,4,0,4,0,0,0
1370070,26,24,1987,8,"female",891,481,229,2143,2275,1443,2068,700,207
1370105,26,1,1987,1,"male",511,47,43,17,3,17,2,0,1
1370134,45,18,1968,9,"female",300,31,27,4,5,4,5,0,0
1370140,50,3,1963,10,"male",369,42,25,161,21,161,19,0,2
1370146,28,4,1985,4,"male",117,28,13,432,28,432,19,0,9
1370159,28,5,1985,7,"male",333,12,10,55,12,46,12,9,0
1370164,27,15,1986,6,"male",695,159,127,3,0,3,0,0,0
1370172,18,15,1995,10,"male",303,186,56,29,7,5,1,24,6
1370196,33,3,1980,8,"female",448,7,0,2,5,2,5,0,0
1370224,23,27,1990,5,"female",219,142,34,0,15,0,3,0,12
1370226,64,2,1949,5,"male",810,189,129,71,53,20,14,51,39
1370289,49,5,1964,10,"female",375,73,39,1,17,1,17,0,0
1370293,25,18,1988,12,"female",51,24,23,103,69,100,61,3,8
1370294,83,5,1930,3,"female",611,135,61,16,53,16,25,0,28
1370302,32,9,1981,6,"male",357,9,3,4,3,0,0,4,3
1370304,34,5,1979,10,"male",347,132,127,0,0,0,0,0,0
1370306,102,11,1911,6,"female",1508,908,360,410,742,309,464,101,278
1370312,69,18,1944,6,"male",433,23,2,0,0,0,0,0,0
1370317,29,2,1984,3,"male",462,0,0,0,0,0,0,0,0
1370341,23,8,1990,6,"female",659,514,332,370,21,201,8,169,13
1370362,42,30,1971,4,"male",443,196,153,1419,1127,1419,805,0,322
1370400,31,1,1982,10,"female",319,304,258,225,72,225,38,0,34
1370411,24,11,1989,4,"female",650,162,90,634,379,123,128,511,251
1370421,108,13,1905,7,"male",975,140,44,0,19,0,16,0,3
1370438,47,26,1966,6,"female",964,18,16,12,3,1,1,11,2
1370489,21,3,1992,11,"male",152,73,68,8,2,8,0,0,2
1370493,57,24,1956,1,"male",377,38,22,239,32,0,21,239,11
1370506,50,18,1963,7,"male",663,26,11,0,0,0,0,0,0
1370507,43,20,1970,10,"female",300,31,18,38,48,38,41,0,7
1370511,66,30,1947,3,"female",432,21,13,0,0,0,0,0,0
1370549,29,28,1984,4,"female",447,98,73,34,17,34,11,0,6
1370562,20,17,1993,3,"male",191,25,2,1,0,1,0,0,0
1370591,20,8,1993,8,"male",460,430,187,122,18,0,1,122,17
1370593,15,6,1998,3,"female",390,862,298,889,807,726,784,163,23
1370601,66,2,1947,6,"female",571,4,3,0,0,0,0,0,0
1370607,39,15,1974,5,"female",397,2049,768,9410,12443,9410,9530,0,2913
1370663,55,31,1958,3,"male",50,2,2,0,0,0,0,0,0
1370690,103,13,1910,11,"female",654,420,199,141,179,39,102,102,77
1370733,36,19,1977,10,"male",408,19,14,13,0,0,0,13,0
1370736,51,23,1962,12,"male",544,28,15,23,21,21,14,2,7
1370737,30,13,1983,3,"male",824,711,135,80,3,80,2,0,1
1370747,28,16,1985,11,"female",290,23,14,0,0,0,0,0,0
1370768,31,23,1982,3,"female",1229,979,707,321,214,321,186,0,28
1370888,52,3,1961,3,"male",369,36,10,227,0,11,0,216,0
1370925,25,1,1988,1,"male",477,24,11,2,2,2,2,0,0
1370944,38,14,1975,6,"male",192,5,4,6,3,6,2,0,1
1370988,20,8,1993,11,"female",143,116,87,11,23,11,21,0,2
1370995,23,27,1990,1,"male",581,71,31,10,12,4,6,6,6
1370998,23,18,1990,5,"male",523,263,62,7,0,7,0,0,0
1371026,23,8,1990,7,"male",203,10,4,3,0,0,0,3,0
1371039,22,9,1991,8,"female",491,31,13,20,3,20,1,0,2
1371064,21,19,1992,9,"male",310,279,170,138,32,138,28,0,4
1371065,108,3,1905,1,"male",1485,84,31,2,23,2,16,0,7
1371076,31,10,1982,8,"male",619,73,37,0,0,0,0,0,0
1371077,34,16,1979,1,"female",181,16,7,1,3,0,1,1,2
1371093,94,9,1919,9,"female",1912,266,154,112,138,99,93,13,45
1371126,43,27,1970,2,"male",139,82,38,548,141,548,86,0,55
1371151,45,30,1968,1,"female",532,45,29,455,89,43,59,412,30
1371155,51,11,1962,7,"female",294,108,61,113,14,113,8,0,6
1371179,19,31,1994,1,"male",87,41,37,38,22,7,1,31,21
1371185,33,24,1980,3,"male",497,76,58,1,2,1,0,0,2
1371186,34,11,1979,2,"female",506,12,5,10,12,7,7,3,5
1371194,15,21,1998,10,"female",650,2640,912,36,210,28,133,8,77
1371232,33,14,1980,2,"female",186,110,89,0,1,0,0,0,1
1371245,21,3,1992,5,"female",83,246,63,2691,2187,2090,1713,601,474
1371277,26,1,1987,1,"male",325,32,26,0,0,0,0,0,0
1371282,93,24,1920,1,"female",16,571,22,266,342,4,172,262,170
1371318,48,28,1965,4,"female",355,68,37,16,0,0,0,16,0
1371323,43,15,1970,11,"female",2276,1238,717,1097,2825,236,543,861,2282
1371328,15,31,1998,12,"female",293,392,286,54,0,35,0,19,0
1371340,23,19,1990,1,"male",138,20,14,34,1,34,1,0,0
1371342,25,21,1988,6,"female",96,77,50,27,137,27,93,0,44
1371381,17,29,1996,12,"male",77,0,0,2,1,2,1,0,0
1371401,67,4,1946,10,"female",689,314,180,1414,208,0,75,1414,133
1371432,35,30,1978,11,"female",661,308,199,36,318,11,122,25,196
1371448,38,2,1975,7,"male",616,146,87,134,104,134,50,0,54
1371463,51,28,1962,3,"male",525,6,5,0,1,0,1,0,0
1371494,19,7,1994,1,"female",660,818,443,571,486,571,370,0,116
1371503,20,1,1993,9,"male",134,177,91,80,0,80,0,0,0
1371511,22,22,1991,7,"female",575,232,137,3,0,3,0,0,0
1371557,21,5,1992,5,"male",345,167,50,15,14,14,7,1,7
1371567,36,29,1977,12,"female",122,153,130,155,79,155,68,0,11
1371569,27,6,1986,9,"female",457,102,71,238,116,238,54,0,62
1371577,31,15,1982,7,"male",200,209,176,52,15,52,8,0,7
1371578,20,5,1993,1,"male",327,220,177,1,0,1,0,0,0
1371609,16,6,1997,8,"male",7,9,8,4,0,4,0,0,0
1371632,25,1,1988,1,"female",254,14,9,0,0,0,0,0,0
1371651,21,3,1992,7,"male",452,99,52,31,16,31,16,0,0
1371657,29,30,1984,10,"female",934,248,122,240,334,240,192,0,142
1371731,22,2,1991,4,"male",154,1,0,0,3,0,0,0,3
1371735,18,8,1995,8,"female",150,170,130,944,561,944,532,0,29
1371739,39,11,1974,12,"female",29,212,145,8091,6730,3181,2457,4910,4273
1371792,29,3,1984,4,"male",434,51,46,0,11,0,8,0,3
1371797,34,24,1979,7,"female",173,33,25,51,1,51,0,0,1
1371798,45,27,1968,8,"female",1827,210,99,329,176,297,116,32,60
1371805,31,4,1982,7,"male",11,0,0,0,0,0,0,0,0
1371864,21,6,1992,5,"male",108,123,100,2,9,2,8,0,1
1371882,100,22,1913,9,"male",1707,733,434,49,103,23,50,26,53
1371885,28,10,1985,11,"male",200,0,0,0,0,0,0,0,0
1371889,22,23,1991,8,"female",806,13,9,5,2,0,0,5,2
1371905,43,12,1970,12,"female",217,143,128,973,0,973,0,0,0
1371922,49,26,1964,9,"male",1608,74,62,16,63,0,49,16,14
1371925,22,29,1991,6,"female",432,1086,598,44,212,26,107,18,105
1371931,36,3,1977,11,"male",261,101,65,61,18,32,15,29,3
1371959,58,14,1955,8,"female",738,111,22,11,3,0,2,11,1
1371970,33,15,1980,8,"female",246,37,20,3,1,3,1,0,0
1371975,27,3,1986,7,"male",328,279,205,33,14,33,11,0,3
1371988,20,21,1993,8,"female",686,523,402,712,27,711,12,1,15
1372023,53,1,1960,11,"female",725,49,22,584,167,580,93,4,74
1372028,113,1,1900,1,"male",2246,237,134,51,192,33,165,18,27
1372043,108,5,1905,9,"female",2155,985,269,20,155,20,87,0,68
1372047,18,29,1995,1,"male",96,159,115,61,23,61,20,0,3
1372089,50,26,1963,1,"male",301,27,19,0,0,0,0,0,0
1372108,34,27,1979,8,"female",434,48,27,0,0,0,0,0,0
1372118,43,16,1970,6,"male",363,189,150,723,191,220,130,503,61
1372130,47,2,1966,12,"female",52,40,27,16,31,0,3,16,28
1372175,24,5,1989,3,"female",255,49,40,0,10,0,0,0,10
1372186,108,22,1905,5,"female",1324,89,23,16,35,16,19,0,16
1372206,24,7,1989,9,"male",361,71,65,6,9,3,1,3,8
1372222,25,16,1988,1,"female",158,148,90,74,48,29,29,45,19
1372227,19,3,1994,9,"male",581,125,68,69,52,36,22,33,30
1372248,48,10,1965,3,"female",1752,92,23,233,297,233,221,0,76
1372250,21,13,1992,2,"female",1345,810,181,72,189,65,165,7,24
1372279,58,8,1955,1,"female",644,5,1,0,0,0,0,0,0
1372318,21,13,1992,11,"female",260,311,241,13,1,13,1,0,0
1372319,20,7,1993,12,"male",236,126,82,60,65,60,43,0,22
1372323,42,6,1971,1,"female",40,45,44,242,302,242,219,0,83
1372349,57,15,1956,2,"female",153,195,164,1905,309,0,103,1905,206
1372359,20,21,1993,12,"male",476,7,3,0,0,0,0,0,0
1372365,21,22,1992,9,"male",1049,233,153,74,125,69,90,5,35
1372375,43,13,1970,3,"female",339,110,66,69,29,69,18,0,11
1372387,102,20,1911,9,"male",305,137,121,24,35,24,25,0,10
1372406,23,22,1990,11,"male",356,21,7,0,0,0,0,0,0
1372407,32,3,1981,4,"female",1087,1200,744,19,33,19,29,0,4
1372418,17,10,1996,2,"female",109,78,46,32,21,32,20,0,1
1372433,21,17,1992,4,"male",549,127,110,10,8,10,8,0,0
1372450,27,25,1986,12,"male",539,332,303,0,7,0,0,0,7
1372453,47,1,1966,5,"female",194,37,12,252,25,248,24,4,1
1372577,35,13,1978,6,"female",553,216,92,52,71,5,30,47,41
1372643,94,8,1919,12,"male",2000,299,117,166,240,1,169,165,71
1372646,18,26,1995,5,"male",412,418,255,186,196,72,86,114,110
1372658,27,11,1986,7,"male",689,106,73,2,1,2,1,0,0
1372734,17,30,1996,11,"male",586,305,145,9,3,0,0,9,3
1372746,48,24,1965,6,"female",445,47,23,136,159,136,115,0,44
1372774,61,21,1952,7,"female",666,50,18,12,5,12,4,0,1
1372783,39,25,1974,5,"female",516,1,0,0,0,0,0,0,0
1372784,19,26,1994,9,"male",473,401,300,97,119,87,48,10,71
1372794,40,26,1973,10,"female",208,371,167,31,55,31,51,0,4
1372815,25,24,1988,9,"female",198,58,37,9,17,9,16,0,1
1372843,55,30,1958,6,"male",1603,1475,182,1592,685,1512,460,80,225
1372858,14,17,1999,11,"male",311,391,353,1,0,1,0,0,0
1372868,22,11,1991,11,"male",408,372,221,172,130,171,119,1,11
1372885,18,10,1995,12,"male",250,365,291,821,374,598,285,223,89
1372919,19,6,1994,9,"male",543,272,144,4,22,0,4,4,18
1372930,60,2,1953,2,"male",1706,82,25,77,3,77,0,0,3
1372931,24,4,1989,2,"female",98,97,65,0,0,0,0,0,0
1372937,21,3,1992,9,"female",101,93,65,2,35,2,34,0,1
1372951,51,7,1962,9,"male",363,34,21,8,9,8,7,0,2
1372972,19,1,1994,5,"male",728,74,41,0,0,0,0,0,0
1372976,31,25,1982,10,"female",333,99,70,0,0,0,0,0,0
1372989,38,1,1975,1,"male",186,48,1,0,0,0,0,0,0
1372993,49,20,1964,9,"male",2076,28,16,1,1,1,0,0,1
1373003,68,12,1945,2,"female",230,68,22,266,426,266,215,0,211
1373055,21,28,1992,12,"female",202,247,72,7,22,7,19,0,3
1373063,20,22,1993,12,"male",121,102,85,7,1,7,1,0,0
1373071,55,24,1958,3,"male",69,26,15,1,0,0,0,1,0
1373083,16,11,1997,4,"female",225,85,55,9,127,9,107,0,20
1373127,16,22,1997,2,"male",249,451,217,6,10,6,8,0,2
1373129,15,7,1998,11,"male",583,704,598,1,1,0,0,1,1
1373146,26,5,1987,12,"male",497,0,0,1,0,1,0,0,0
1373164,103,9,1910,8,"female",571,164,112,68,65,9,50,59,15
1373170,17,31,1996,12,"male",686,242,88,9,0,9,0,0,0
1373178,93,12,1920,9,"male",202,25,22,10,13,0,6,10,7
1373184,49,27,1964,8,"male",1464,12,8,3,0,0,0,3,0
1373218,83,20,1930,5,"male",438,177,172,8,2,8,0,0,2
1373256,33,24,1980,8,"female",208,70,50,112,50,58,30,54,20
1373267,24,15,1989,4,"male",374,624,549,143,364,143,282,0,82
1373278,17,15,1996,1,"male",1420,176,34,24,9,2,3,22,6
1373312,55,2,1958,1,"female",847,198,67,11,58,9,23,2,35
1373319,21,4,1992,4,"male",250,269,244,28,25,25,21,3,4
1373334,25,30,1988,10,"male",12,22,11,0,0,0,0,0,0
1373337,45,2,1968,11,"male",394,54,41,56,45,56,43,0,2
1373338,19,1,1994,8,"male",110,129,94,1,1,0,1,1,0
1373339,15,23,1998,8,"female",195,218,75,19,31,19,30,0,1
1373343,15,2,1998,1,"male",237,767,597,1919,595,1686,479,233,116
1373348,33,8,1980,10,"female",362,129,111,7,41,1,32,6,9
1373370,13,19,2000,6,"female",31,178,73,0,0,0,0,0,0
1373378,28,22,1985,10,"male",423,3,3,4,2,0,0,4,2
1373387,57,8,1956,5,"female",861,121,71,162,93,162,72,0,21
1373392,32,29,1981,3,"male",132,8,5,3,4,3,4,0,0
1373409,25,1,1988,1,"male",245,0,0,0,0,0,0,0,0
1373439,34,10,1979,2,"female",1916,93,33,123,58,123,40,0,18
1373451,19,6,1994,3,"male",510,817,653,341,313,172,55,169,258
1373480,18,19,1995,10,"male",395,245,173,266,134,244,111,22,23
1373482,73,28,1940,1,"female",247,0,0,0,0,0,0,0,0
1373498,26,17,1987,3,"male",587,63,35,13,20,13,19,0,1
1373542,54,5,1959,5,"female",295,27,15,20,15,1,6,19,9
1373556,24,17,1989,7,"male",594,93,52,7,1,7,1,0,0
1373563,18,16,1995,1,"male",204,66,29,0,0,0,0,0,0
1373571,26,15,1987,10,"male",360,64,32,21,3,21,3,0,0
1373614,47,27,1966,12,"male",285,111,105,2,1,0,1,2,0
1373618,25,1,1988,1,"male",111,57,28,81,56,81,35,0,21
1373626,23,23,1990,6,"female",257,302,66,315,282,0,210,315,72
1373629,74,29,1939,3,"male",1789,69,23,0,0,0,0,0,0
1373660,18,15,1995,11,"female",431,201,106,283,131,88,46,195,85
1373707,22,2,1991,7,"male",420,50,39,1,0,1,0,0,0
1373714,20,18,1993,2,"male",305,83,60,2,0,0,0,2,0
1373715,26,29,1987,8,"male",316,181,147,12,5,12,5,0,0
1373802,23,1,1990,1,"male",142,5,4,1,0,1,0,0,0
1373827,16,9,1997,12,"female",861,118,45,413,103,54,40,359,63
1373843,17,21,1996,11,"male",314,200,166,9,20,8,10,1,10
1373868,45,18,1968,9,"male",531,101,48,464,281,464,203,0,78
1373890,47,3,1966,3,"female",224,106,27,536,77,536,54,0,23
1373896,67,19,1946,1,"male",380,114,76,12,36,1,11,11,25
1373934,44,27,1969,6,"female",243,148,79,176,114,1,22,175,92
1373939,30,5,1983,1,"female",871,680,233,7654,2478,6654,1365,1000,1113
1373957,22,31,1991,1,"male",146,4,3,0,0,0,0,0,0
1373968,28,20,1985,10,"male",56,70,53,2,0,2,0,0,0
1373972,26,27,1987,3,"female",558,102,47,145,17,68,7,77,10
1373975,13,27,2000,4,"female",137,274,79,2,24,2,22,0,2
1373982,56,10,1957,9,"male",595,261,160,277,132,277,48,0,84
1373999,33,22,1980,4,"female",449,183,125,127,221,53,130,74,91
1374019,57,17,1956,5,"female",628,75,38,9,0,9,0,0,0
1374035,28,9,1985,9,"male",1076,130,44,310,282,310,231,0,51
1374046,30,20,1983,7,"female",417,221,177,758,322,216,162,542,160
1374054,26,30,1987,12,"female",552,167,41,7,7,0,4,7,3
1374062,52,16,1961,12,"female",985,87,47,190,18,90,5,100,13
1374082,32,15,1981,1,"male",314,54,36,102,216,68,181,34,35
1374145,89,5,1924,8,"female",872,86,27,51,62,51,60,0,2
1374184,30,23,1983,3,"male",194,63,14,39,25,38,9,1,16
1374191,43,7,1970,9,"male",768,213,77,5,32,5,21,0,11
1374213,41,11,1972,4,"female",405,10,10,1,1,0,1,1,0
1374230,20,2,1993,8,"male",624,206,186,31,9,31,8,0,1
1374252,20,21,1993,1,"female",304,63,16,54,2,49,1,5,1
1374282,34,20,1979,5,"male",399,68,42,22,0,22,0,0,0
1374290,24,7,1989,3,"male",326,433,261,31,18,22,2,9,16
1374305,35,13,1978,3,"female",409,108,19,226,275,222,41,4,234
1374312,23,3,1990,8,"female",120,125,35,134,393,58,192,76,201
1374439,49,19,1964,12,"male",830,269,168,1,2,1,0,0,2
1374452,20,17,1993,10,"female",48,462,190,37,200,35,158,2,42
1374466,21,14,1992,11,"male",433,1,0,0,0,0,0,0,0
1374474,31,9,1982,9,"female",227,86,39,44,65,44,57,0,8
1374523,18,7,1995,8,"male",360,487,334,685,15,685,8,0,7
1374535,60,25,1953,8,"female",571,22,10,0,0,0,0,0,0
1374548,48,1,1965,10,"male",493,45,11,3,5,0,3,3,2
1374562,39,26,1974,4,"male",753,110,32,7,3,7,3,0,0
1374612,22,9,1991,9,"male",463,142,85,0,0,0,0,0,0
1374634,20,15,1993,9,"male",317,102,52,5,0,0,0,5,0
1374635,18,20,1995,9,"female",351,1111,620,0,120,0,83,0,37
1374647,65,12,1948,2,"female",1653,98,70,76,27,75,22,1,5
1374650,102,20,1911,9,"male",709,341,186,137,5,137,5,0,0
1374686,18,10,1995,10,"female",330,69,45,40,42,40,41,0,1
1374698,108,16,1905,11,"female",711,1450,366,67,20,0,16,67,4
1374729,24,8,1989,7,"female",577,101,32,3,0,3,0,0,0
1374761,18,6,1995,8,"male",79,135,100,387,145,221,93,166,52
1374826,26,2,1987,1,"male",274,191,170,5,1,5,0,0,1
1374871,17,30,1996,7,"male",223,75,67,11,0,11,0,0,0
1374933,53,5,1960,6,"female",467,16,12,7,0,0,0,7,0
1374939,33,2,1980,8,"female",900,84,35,145,28,145,20,0,8
1374996,19,24,1994,1,"female",357,400,108,611,287,121,125,490,162
1375002,14,9,1999,4,"female",451,367,251,613,374,355,217,258,157
1375046,32,15,1981,10,"male",229,84,55,42,29,39,16,3,13
1375063,63,22,1950,5,"female",484,1489,702,5000,3298,5000,3009,0,289
1375091,21,31,1992,8,"male",773,740,612,80,116,80,94,0,22
1375110,26,16,1987,6,"male",549,303,283,0,0,0,0,0,0
1375114,25,8,1988,8,"female",27,23,9,1,3,1,1,0,2
1375118,71,10,1942,9,"male",193,178,134,748,91,655,72,93,19
1375132,35,8,1978,4,"female",487,73,34,18,7,4,2,14,5
1375135,78,10,1935,1,"female",1002,369,113,42,1,36,1,6,0
1375148,21,3,1992,5,"male",23,0,0,0,0,0,0,0,0
1375161,16,20,1997,8,"female",109,93,12,3,0,3,0,0,0
1375163,23,17,1990,12,"male",25,18,16,2,3,2,3,0,0
1375197,33,20,1980,2,"male",1182,230,112,40,1,37,0,3,1
1375222,14,4,1999,4,"male",95,16,15,0,1,0,1,0,0
1375243,98,26,1915,12,"female",1665,204,91,163,123,163,119,0,4
1375246,54,23,1959,4,"male",1061,144,101,15,6,15,4,0,2
1375248,58,16,1955,11,"male",453,10,0,0,0,0,0,0,0
1375249,21,28,1992,5,"female",539,205,50,104,114,104,64,0,50
1375274,19,20,1994,2,"male",183,143,60,2,25,2,23,0,2
1375283,23,1,1990,2,"male",160,104,74,34,0,1,0,33,0
1375304,62,28,1951,5,"male",1875,159,86,0,1,0,0,0,1
1375337,53,23,1960,4,"male",176,44,19,105,79,105,26,0,53
1375353,56,16,1957,8,"male",76,30,24,12,6,10,2,2,4
1375366,52,30,1961,6,"male",1566,144,8,0,1,0,0,0,1
1375370,103,3,1910,7,"female",653,427,234,547,277,547,142,0,135
1375398,108,29,1905,12,"male",1008,345,170,10,239,10,225,0,14
1375468,28,15,1985,3,"female",529,101,40,34,12,34,10,0,2
1375474,19,3,1994,3,"male",1251,434,280,1044,1299,930,999,114,300
1375513,13,1,2000,5,"female",175,39,25,149,39,149,28,0,11
1375527,18,5,1995,5,"male",31,199,88,38,57,34,20,4,37
1375539,21,7,1992,12,"male",329,71,16,4,6,4,2,0,4
1375543,44,10,1969,3,"male",512,38,8,0,0,0,0,0,0
1375550,70,4,1943,2,"female",1811,28,11,24,0,24,0,0,0
1375552,24,19,1989,6,"male",191,29,20,10,0,10,0,0,0
1375575,35,13,1978,1,"male",334,158,94,7,26,7,20,0,6
1375581,56,20,1957,8,"female",467,47,16,332,263,225,124,107,139
1375629,14,3,1999,2,"male",330,8,6,1,0,0,0,1,0
1375640,28,1,1985,1,"male",290,43,20,5,5,5,4,0,1
1375678,37,14,1976,4,"male",184,11,6,0,1,0,1,0,0
1375688,108,12,1905,6,"female",1270,142,37,311,102,3,77,308,25
1375724,26,1,1987,11,"male",503,70,35,0,0,0,0,0,0
1375731,20,11,1993,11,"male",244,3,1,3,0,3,0,0,0
1375735,15,11,1998,2,"male",386,296,261,49,87,35,78,14,9
1375787,83,5,1930,4,"male",85,19,15,1,0,1,0,0,0
1375789,24,5,1989,1,"male",176,11,9,11,7,7,5,4,2
1375796,26,10,1987,10,"male",328,43,7,5,8,1,6,4,2
1375806,25,27,1988,9,"male",1168,117,38,9,10,0,0,9,10
1375849,19,29,1994,12,"male",569,138,75,27,42,27,39,0,3
1375870,29,16,1984,1,"female",441,68,52,78,52,74,28,4,24
1375883,15,27,1998,5,"female",206,61,46,16,0,0,0,16,0
1375909,108,23,1905,9,"female",163,11,9,0,3,0,0,0,3
1375931,14,17,1999,9,"female",304,75,59,8,10,0,0,8,10
1375958,25,1,1988,1,"male",265,72,62,1,0,1,0,0,0
1375970,56,20,1957,4,"female",294,32,21,0,1,0,0,0,1
1375991,26,14,1987,7,"male",437,67,41,207,59,207,48,0,11
1375997,75,11,1938,7,"male",909,110,74,336,66,0,10,336,56
1376003,33,15,1980,11,"male",248,21,16,194,5,194,4,0,1
1376005,54,3,1959,4,"female",93,22,18,9,32,9,18,0,14
1376014,28,3,1985,11,"female",209,90,76,5,5,5,3,0,2
1376024,27,27,1986,8,"female",678,44,3,0,5,0,5,0,0
1376080,20,9,1993,6,"male",402,175,88,25,26,25,16,0,10
1376090,50,11,1963,7,"male",238,8,5,0,0,0,0,0,0
1376108,65,10,1948,8,"female",418,22,9,45,62,26,42,19,20
1376116,39,7,1974,5,"male",491,91,64,0,0,0,0,0,0
1376128,17,17,1996,1,"female",476,20,14,112,49,92,46,20,3
1376136,36,15,1977,11,"male",1249,218,78,3,67,3,55,0,12
1376160,39,24,1974,10,"male",637,42,35,0,0,0,0,0,0
1376161,37,20,1976,8,"female",210,159,143,919,119,919,76,0,43
1376169,16,7,1997,5,"female",487,578,393,1,7,1,6,0,1
1376175,40,1,1973,12,"male",388,40,40,0,1,0,1,0,0
1376190,25,1,1988,1,"female",78,150,34,6,28,6,24,0,4
1376192,18,8,1995,7,"male",293,264,165,4,36,3,28,1,8
1376213,108,23,1905,4,"female",354,181,98,7,15,7,4,0,11
1376222,28,20,1985,6,"male",65,15,10,75,4,75,4,0,0
1376249,20,10,1993,1,"male",96,17,13,3,0,3,0,0,0
1376257,72,18,1941,6,"female",468,40,26,0,0,0,0,0,0
1376272,25,1,1988,7,"female",257,78,46,10,17,10,16,0,1
1376300,45,13,1968,5,"male",261,51,27,257,91,257,83,0,8
1376321,56,1,1957,1,"female",207,79,64,719,296,719,226,0,70
1376354,23,31,1990,10,"male",79,32,19,26,31,26,31,0,0
1376438,26,1,1987,1,"male",560,137,93,4,2,3,0,1,2
1376449,69,17,1944,12,"male",375,1,1,0,0,0,0,0,0
1376477,16,25,1997,1,"male",909,935,646,254,392,29,183,225,209
1376499,53,13,1960,10,"female",2159,440,218,897,289,864,157,33,132
1376508,19,18,1994,7,"female",136,46,37,2040,1444,1118,636,922,808
1376513,16,28,1997,6,"male",383,1661,903,20,136,12,128,8,8
1376521,16,24,1997,7,"female",650,408,257,1719,658,1708,216,11,442
1376525,25,6,1988,1,"male",130,52,20,0,0,0,0,0,0
1376530,52,10,1961,4,"female",324,210,75,292,74,292,28,0,46
1376532,18,18,1995,6,"male",659,325,198,0,1,0,0,0,1
1376567,24,9,1989,9,"male",433,70,35,1,1,1,0,0,1
1376591,23,14,1990,6,"female",220,31,27,13,0,0,0,13,0
1376607,25,8,1988,8,"male",286,47,33,0,1,0,1,0,0
1376629,35,8,1978,12,"female",469,191,110,1956,2143,1846,1705,110,438
1376637,21,6,1992,10,"male",369,172,108,5,0,5,0,0,0
1376679,46,9,1967,9,"male",53,93,55,43,47,43,41,0,6
1376681,23,24,1990,3,"female",617,54,35,216,96,180,59,36,37
1376714,56,7,1957,4,"male",1032,75,47,13,24,0,0,13,24
1376735,19,7,1994,8,"male",411,66,52,2,0,0,0,2,0
1376768,24,10,1989,6,"female",681,74,48,23,87,23,52,0,35
1376772,56,1,1957,6,"female",1280,31,12,632,539,448,168,184,371
1376826,36,18,1977,11,"male",518,33,19,27,7,0,5,27,2
1376832,18,15,1995,3,"male",36,5,3,0,0,0,0,0,0
1376838,26,5,1987,3,"male",399,22,12,0,0,0,0,0,0
1376868,31,23,1982,8,"male",207,189,97,0,9,0,6,0,3
1376891,61,26,1952,9,"female",649,24,8,83,11,0,4,83,7
1376917,25,14,1988,8,"female",192,24,16,102,37,102,25,0,12
1376921,34,2,1979,6,"female",668,61,26,62,27,62,22,0,5
1376936,23,31,1990,8,"male",376,68,43,0,0,0,0,0,0
1376940,18,20,1995,1,"male",211,3,1,1,1,1,1,0,0
1376944,26,23,1987,9,"female",530,407,300,1,0,1,0,0,0
1377004,15,18,1998,8,"male",816,318,184,0,2,0,2,0,0
1377023,33,12,1980,4,"female",361,56,25,18,2,0,0,18,2
1377028,21,7,1992,12,"female",597,281,75,91,140,91,110,0,30
1377045,80,26,1933,2,"female",1651,91,54,83,34,80,20,3,14
1377057,61,26,1952,10,"male",192,118,60,646,369,0,71,646,298
1377062,42,5,1971,4,"female",623,38,28,31,20,16,10,15,10
1377083,14,4,1999,5,"female",204,64,45,1,1,0,0,1,1
1377085,15,16,1998,11,"female",678,1024,611,217,461,197,262,20,199
1377097,16,24,1997,7,"male",751,26,13,1,1,0,1,1,0
1377131,19,2,1994,5,"male",559,739,449,178,163,53,99,125,64
1377138,79,14,1934,8,"female",13,26,17,14,14,0,1,14,13
1377157,68,22,1945,10,"female",1432,25,18,11,7,0,0,11,7
1377162,71,14,1942,7,"female",696,38,23,1,1,0,0,1,1
1377183,29,1,1984,1,"male",81,4,1,1,0,0,0,1,0
1377229,66,5,1947,12,"female",1132,139,96,355,185,0,114,355,71
1377245,83,3,1930,9,"female",832,41,13,1,3,0,1,1,2
1377266,103,27,1910,5,"male",8,56,44,0,2,0,1,0,1
1377269,65,21,1948,3,"female",169,14,6,17,2,0,0,17,2
1377295,65,26,1948,9,"female",913,54,21,3,12,3,6,0,6
1377296,18,14,1995,12,"male",601,21,12,0,0,0,0,0,0
1377297,34,19,1979,1,"male",436,8,7,3,14,0,1,3,13
1377298,16,6,1997,9,"male",494,329,246,0,5,0,1,0,4
1377315,22,28,1991,3,"female",54,17,9,5,3,0,3,5,0
1377342,18,9,1995,12,"male",526,18,15,0,0,0,0,0,0
1377360,17,6,1996,11,"male",325,264,214,0,0,0,0,0,0
1377364,54,12,1959,8,"female",423,117,69,9,74,9,53,0,21
1377388,17,22,1996,3,"female",256,59,41,304,195,279,139,25,56
1377395,31,12,1982,6,"male",20,116,108,28,34,22,18,6,16
1377435,27,1,1986,10,"female",489,5,4,0,0,0,0,0,0
1377477,39,2,1974,2,"male",315,108,29,2061,2031,2061,1233,0,798
1377509,108,24,1905,4,"male",191,448,367,3,1,3,1,0,0
1377523,33,8,1980,5,"female",243,25,19,0,0,0,0,0,0
1377531,16,17,1997,6,"male",1127,164,113,30,23,27,8,3,15
1377532,26,7,1987,1,"male",68,14,13,12,0,12,0,0,0
1377535,24,20,1989,4,"male",283,410,84,33,5,33,4,0,1
1377538,54,25,1959,11,"female",879,139,78,7,8,7,3,0,5
1377591,31,12,1982,1,"male",488,104,9,0,3,0,1,0,2
1377613,35,3,1978,10,"female",63,87,82,70,75,2,17,68,58
1377629,17,17,1996,9,"female",697,945,575,43,44,23,25,20,19
1377654,67,1,1946,6,"female",1307,73,41,0,5,0,5,0,0
1377655,24,16,1989,9,"female",136,11,6,6,1,6,1,0,0
1377662,100,2,1913,5,"female",1202,203,115,102,32,101,24,1,8
1377679,15,10,1998,1,"female",708,1040,528,167,195,167,123,0,72
1377722,31,12,1982,12,"female",571,10,8,2,0,0,0,2,0
1377726,18,7,1995,10,"male",653,1515,838,133,338,133,323,0,15
1377733,49,23,1964,1,"female",1477,209,81,126,83,42,55,84,28
1377781,15,23,1998,4,"male",134,41,35,0,0,0,0,0,0
1377802,58,23,1955,1,"female",80,20,18,41,9,39,6,2,3
1377837,22,17,1991,4,"male",557,85,30,14,13,14,4,0,9
1377874,19,8,1994,7,"male",499,31,25,4,2,4,2,0,0
1377899,22,24,1991,10,"male",23,4,3,2,2,2,2,0,0
1377912,22,5,1991,5,"male",419,114,84,18,4,18,4,0,0
1377928,101,29,1912,7,"female",722,161,69,2,0,2,0,0,0
1377960,17,29,1996,9,"female",540,2,2,1,0,0,0,1,0
1377964,19,5,1994,7,"male",102,105,97,0,0,0,0,0,0
1377994,24,7,1989,5,"male",551,19,6,1,0,0,0,1,0
1378025,20,29,1993,11,"female",378,722,454,2227,899,2169,628,58,271
1378068,33,12,1980,3,"female",545,83,51,142,15,142,15,0,0
1378079,19,4,1994,9,"male",20,9,7,0,0,0,0,0,0
1378081,32,3,1981,7,"male",192,118,84,4,12,4,4,0,8
1378086,23,15,1990,3,"male",629,100,81,5,0,5,0,0,0
1378087,18,20,1995,9,"male",186,83,74,0,2,0,1,0,1
1378089,22,20,1991,7,"male",1615,296,140,63,26,54,3,9,23
1378106,26,15,1987,10,"male",320,276,170,15,80,4,15,11,65
1378116,29,5,1984,2,"male",310,203,150,649,255,649,186,0,69
1378130,18,27,1995,1,"male",346,53,40,2,0,2,0,0,0
1378143,37,28,1976,6,"female",299,194,64,827,491,827,411,0,80
1378154,29,28,1984,8,"male",743,117,34,25,1,25,1,0,0
1378198,16,27,1997,10,"male",288,188,99,40,19,40,16,0,3
1378199,63,25,1950,9,"female",109,12,12,2,0,2,0,0,0
1378203,26,1,1987,1,"female",624,42,39,30,10,30,7,0,3
1378227,24,6,1989,6,"male",120,16,13,7,2,5,2,2,0
1378228,16,21,1997,10,"male",484,855,693,81,40,25,27,56,13
1378229,19,24,1994,9,"male",76,115,66,0,0,0,0,0,0
1378237,32,8,1981,5,"male",287,0,0,0,0,0,0,0,0
1378249,44,30,1969,9,"male",0,0,0,2,3,0,3,2,0
1378271,16,27,1997,7,"female",186,195,116,44,160,44,153,0,7
1378291,17,19,1996,7,"male",1118,111,60,0,2,0,1,0,1
1378292,18,25,1995,1,"male",498,153,24,0,0,0,0,0,0
1378293,16,31,1997,10,"male",281,90,29,9,1,9,1,0,0
1378296,98,11,1915,5,"female",1560,345,241,156,78,143,60,13,18
1378315,17,24,1996,10,"female",233,18,12,0,0,0,0,0,0
1378351,22,23,1991,4,"female",1987,265,125,838,1142,201,574,637,568
1378356,62,8,1951,9,"female",1047,57,17,70,5,0,1,70,4
1378382,36,31,1977,12,"male",232,52,43,20,7,20,1,0,6
1378434,21,6,1992,6,"male",510,416,301,83,10,83,9,0,1
1378437,23,29,1990,6,"female",700,75,55,2,2,0,2,2,0
1378449,22,23,1991,5,"female",585,292,157,1578,838,899,428,679,410
1378473,19,8,1994,8,"male",494,586,499,1,2,1,2,0,0
1378491,17,8,1996,7,"female",398,8,4,0,1,0,1,0,0
1378539,30,16,1983,1,"male",786,71,20,8,10,8,8,0,2
1378605,15,13,1998,4,"male",219,116,78,10,4,4,4,6,0
1378634,24,23,1989,3,"male",7,12,11,17,51,17,49,0,2
1378647,29,11,1984,10,"male",354,67,59,14,2,14,2,0,0
1378663,39,10,1974,4,"male",530,198,125,1604,622,1604,539,0,83
1378682,54,3,1959,10,"male",472,33,19,0,4,0,2,0,2
1378710,23,9,1990,6,"female",17,229,193,376,389,200,338,176,51
1378726,52,27,1961,8,"female",443,201,82,1298,329,556,53,742,276
1378741,42,24,1971,4,"female",538,43,26,134,14,134,12,0,2
1378754,28,15,1985,1,"male",411,13,6,2,0,0,0,2,0
1378756,71,22,1942,2,"male",678,30,26,0,0,0,0,0,0
1378762,40,2,1973,6,"male",1042,81,39,0,0,0,0,0,0
1378766,54,29,1959,12,"male",852,59,39,0,23,0,15,0,8
1378768,20,5,1993,10,"male",87,9,8,1,3,1,2,0,1
1378779,33,1,1980,1,"male",35,16,11,44,0,44,0,0,0
1378783,17,15,1996,3,"male",105,31,30,0,0,0,0,0,0
1378790,21,1,1992,1,"male",104,122,110,6,0,6,0,0,0
1378800,17,8,1996,12,"female",64,259,56,4,44,4,22,0,22
1378816,29,29,1984,10,"male",502,28,13,0,0,0,0,0,0
1378843,18,15,1995,9,"male",285,508,363,444,134,444,116,0,18
1378848,67,25,1946,9,"male",497,259,120,300,60,23,8,277,52
1378853,15,18,1998,5,"male",308,95,84,0,0,0,0,0,0
1378861,60,21,1953,12,"male",62,19,16,10,2,10,2,0,0
1378862,53,15,1960,10,"female",950,182,125,38,73,38,67,0,6
1378876,18,23,1995,5,"female",571,2459,364,2,3,2,3,0,0
1378934,43,24,1970,4,"female",64,8,8,1,3,1,2,0,1
1378964,94,22,1919,9,"female",2261,98,29,730,435,18,270,712,165
1378965,27,21,1986,11,"female",153,53,45,42,7,12,2,30,5
1378982,19,4,1994,3,"female",242,220,48,65,104,65,60,0,44
1378983,77,19,1936,10,"female",992,63,26,65,127,5,57,60,70
1378998,37,13,1976,4,"male",332,100,46,4,61,0,2,4,59
1379001,49,15,1964,2,"male",1054,60,24,26,0,26,0,0,0
1379018,21,11,1992,8,"male",291,105,66,0,9,0,5,0,4
1379032,20,23,1993,1,"female",1170,183,120,2109,1942,1500,748,609,1194
1379049,38,17,1975,7,"male",513,61,39,1,13,0,10,1,3
1379084,63,17,1950,8,"female",761,52,33,114,52,0,11,114,41
1379117,22,25,1991,8,"male",24,0,0,0,0,0,0,0,0
1379122,33,20,1980,4,"male",586,46,27,0,0,0,0,0,0
1379131,24,15,1989,6,"female",1448,2436,650,2,16,2,15,0,1
1379138,37,10,1976,6,"male",1134,99,43,6,7,0,4,6,3
1379143,31,29,1982,3,"female",363,33,17,0,0,0,0,0,0
1379145,20,8,1993,11,"male",504,87,62,0,8,0,1,0,7
1379160,18,12,1995,5,"male",74,74,66,2,1,2,1,0,0
1379187,38,28,1975,7,"male",489,89,46,36,5,14,3,22,2
1379191,17,11,1996,11,"female",41,32,27,0,7,0,5,0,2
1379199,29,7,1984,3,"female",236,213,110,362,106,362,84,0,22
1379211,31,16,1982,11,"male",338,28,15,14,15,9,5,5,10
1379270,21,9,1992,11,"male",156,266,243,1028,520,1028,498,0,22
1379277,23,14,1990,11,"male",232,45,25,24,2,24,2,0,0
1379291,25,9,1988,8,"male",125,87,74,28,154,20,105,8,49
1379294,63,1,1950,1,"male",880,80,27,13,17,3,7,10,10
1379302,74,30,1939,9,"female",1642,153,92,151,18,85,11,66,7
1379331,17,16,1996,7,"female",668,1921,368,2147,1402,1893,1083,254,319
1379338,66,15,1947,12,"female",673,21,18,22,12,2,9,20,3
1379343,19,21,1994,2,"male",405,192,147,8,11,8,6,0,5
1379346,23,31,1990,12,"female",410,2,2,0,0,0,0,0,0
1379380,67,4,1946,10,"female",1902,60,9,5,5,5,5,0,0
1379418,22,14,1991,9,"male",529,96,42,41,2,33,1,8,1
1379424,42,6,1971,6,"female",1454,283,164,956,317,804,191,152,126
1379430,17,21,1996,10,"female",310,382,263,13,3,0,2,13,1
1379451,18,1,1995,11,"female",441,6,2,0,0,0,0,0,0
1379455,28,16,1985,7,"male",415,0,0,20,0,18,0,2,0
1379472,103,3,1910,2,"male",1090,154,85,19,10,19,10,0,0
1379477,57,12,1956,10,"female",117,54,38,69,23,69,18,0,5
1379478,33,18,1980,6,"male",858,309,262,60,163,60,156,0,7
1379484,36,19,1977,2,"male",363,203,155,38,75,38,13,0,62
1379489,24,18,1989,12,"male",293,844,198,51,2,51,0,0,2
1379490,19,17,1994,10,"male",188,913,773,155,77,155,53,0,24
1379505,62,28,1951,7,"female",666,74,31,36,49,3,24,33,25
1379529,103,1,1910,1,"male",1072,712,679,25,33,18,27,7,6
1379556,22,25,1991,4,"male",580,193,102,12,0,12,0,0,0
1379576,20,3,1993,4,"female",228,5,3,3,0,0,0,3,0
1379580,58,26,1955,9,"female",1532,37,12,70,43,4,12,66,31
1379582,18,12,1995,12,"female",459,194,109,0,0,0,0,0,0
1379639,15,25,1998,1,"male",714,322,179,62,31,1,4,61,27
1379641,47,9,1966,9,"female",280,709,623,656,191,656,156,0,35
1379649,32,3,1981,1,"male",64,12,10,0,4,0,0,0,4
1379683,21,29,1992,7,"male",628,505,359,156,284,145,224,11,60
1379718,100,7,1913,2,"female",1561,310,119,233,203,233,180,0,23
1379727,15,27,1998,6,"male",336,25,18,27,14,27,6,0,8
1379750,29,1,1984,1,"female",203,462,400,190,334,76,217,114,117
1379769,41,17,1972,12,"female",88,201,91,320,97,147,34,173,63
1379773,25,8,1988,3,"male",405,62,52,0,2,0,2,0,0
1379778,22,16,1991,6,"male",20,6,2,0,0,0,0,0,0
1379785,49,30,1964,9,"female",1908,369,182,367,1015,350,556,17,459
1379795,25,1,1988,1,"female",180,19,13,2,3,2,3,0,0
1379806,33,1,1980,1,"male",70,19,16,0,0,0,0,0,0
1379819,17,28,1996,8,"male",614,69,51,6,29,5,19,1,10
1379861,29,20,1984,11,"male",512,121,90,35,33,21,32,14,1
1379864,31,19,1982,12,"male",189,169,106,7,1,0,0,7,1
1379868,24,23,1989,3,"male",542,233,199,9,1,9,1,0,0
1379880,20,26,1993,9,"male",255,38,12,0,0,0,0,0,0
1379884,20,30,1993,4,"male",618,16,9,0,3,0,3,0,0
1379885,23,8,1990,3,"male",214,400,223,1,2,1,0,0,2
1379942,25,5,1988,5,"male",153,107,79,3,3,3,3,0,0
1379947,35,13,1978,2,"female",288,101,87,360,136,360,91,0,45
1379959,96,6,1917,2,"male",868,146,130,2,16,2,14,0,2
1379976,33,23,1980,12,"male",491,100,74,0,0,0,0,0,0
1379983,30,16,1983,7,"male",351,23,21,0,5,0,3,0,2
1380012,108,15,1905,3,"male",1384,2511,1459,759,875,759,668,0,207
1380014,19,3,1994,11,"female",1387,2780,551,266,818,266,741,0,77
1380022,100,14,1913,9,"male",47,207,139,17,27,17,24,0,3
1380028,29,18,1984,12,"male",34,35,34,90,8,90,8,0,0
1380050,19,5,1994,8,"male",869,94,54,5,67,0,11,5,56
1380051,49,13,1964,7,"female",308,21,17,88,28,88,14,0,14
1380057,26,12,1987,9,"male",39,35,23,0,0,0,0,0,0
1380069,29,1,1984,1,"male",538,81,50,0,3,0,2,0,1
1380092,38,8,1975,11,"male",271,21,12,0,4,0,2,0,2
1380113,23,4,1990,12,"male",246,97,37,27,24,27,18,0,6
1380116,13,18,2000,10,"male",14,1,1,0,0,0,0,0,0
1380122,45,4,1968,4,"female",287,29,24,19,13,19,11,0,2
1380140,23,2,1990,4,"female",484,251,182,61,70,43,63,18,7
1380171,19,21,1994,10,"female",385,104,59,38,26,0,6,38,20
1380211,18,4,1995,3,"female",575,791,341,11,480,5,379,6,101
1380217,31,13,1982,4,"male",658,5,4,1,0,1,0,0,0
1380233,68,19,1945,1,"female",968,46,28,38,4,2,3,36,1
1380277,27,3,1986,9,"female",954,366,153,5,52,5,47,0,5
1380296,41,11,1972,6,"male",57,9,8,111,26,111,16,0,10
1380350,31,19,1982,11,"male",312,136,109,1,0,1,0,0,0
1380366,63,25,1950,8,"male",602,30,21,75,4,75,4,0,0
1380370,19,2,1994,5,"male",83,14,13,0,0,0,0,0,0
1380446,26,1,1987,1,"male",345,107,36,23,0,23,0,0,0
1380464,38,8,1975,8,"male",504,54,28,235,20,40,15,195,5
1380484,32,5,1981,1,"female",144,15,6,2,1,2,1,0,0
1380502,88,15,1925,3,"female",2033,115,36,173,317,0,59,173,258
1380519,18,25,1995,11,"male",334,60,37,0,0,0,0,0,0
1380538,47,12,1966,8,"female",249,76,58,1,1,0,0,1,1
1380539,35,2,1978,2,"male",262,38,27,8,4,8,4,0,0
1380543,25,1,1988,1,"male",191,28,8,2,15,2,12,0,3
1380560,59,16,1954,6,"female",448,186,143,1048,457,0,178,1048,279
1380577,24,1,1989,1,"male",41,2,1,0,0,0,0,0,0
1380583,35,29,1978,4,"male",163,20,14,1,0,0,0,1,0
1380588,34,23,1979,6,"male",131,43,25,2,10,2,7,0,3
1380613,47,13,1966,1,"male",471,35,21,41,11,41,10,0,1
1380616,29,12,1984,4,"male",264,31,23,15,0,15,0,0,0
1380638,16,10,1997,11,"female",123,1,1,22,0,22,0,0,0
1380642,19,13,1994,5,"male",21,27,19,9,3,9,3,0,0
1380647,23,30,1990,10,"male",269,134,76,87,126,87,72,0,54
1380670,17,20,1996,4,"male",496,107,79,403,11,403,6,0,5
1380683,45,24,1968,5,"male",1221,187,81,4,1,1,1,3,0
1380685,35,20,1978,7,"male",491,3,2,0,0,0,0,0,0
1380701,29,13,1984,4,"female",954,10,6,7,10,7,5,0,5
1380709,18,7,1995,3,"female",900,720,197,427,301,324,93,103,208
1380712,19,23,1994,1,"male",493,811,708,229,215,217,180,12,35
1380760,62,6,1951,1,"female",917,161,83,119,205,0,64,119,141
1380811,26,27,1987,4,"female",616,520,284,17,90,17,74,0,16
1380830,37,15,1976,8,"male",394,77,46,52,44,52,11,0,33
1380836,29,27,1984,6,"male",306,71,70,3,0,2,0,1,0
1380838,21,7,1992,3,"male",49,0,0,0,0,0,0,0,0
1380872,102,22,1911,12,"female",879,229,24,46,28,46,26,0,2
1380874,25,19,1988,8,"male",196,40,40,5,0,3,0,2,0
1380888,19,30,1994,12,"female",559,519,131,351,1068,40,346,311,722
1380895,15,9,1998,3,"female",116,581,325,506,324,282,120,224,204
1380943,56,13,1957,7,"male",1748,67,23,48,15,19,6,29,9
1380955,107,24,1906,10,"male",1513,419,263,0,3,0,0,0,3
1380956,41,3,1972,7,"male",520,174,97,0,8,0,4,0,4
1380957,20,5,1993,8,"female",253,230,73,2078,178166,1982,138561,96,39605
1380994,20,7,1993,9,"male",325,8,6,0,0,0,0,0,0
1380999,30,26,1983,11,"male",334,49,24,5,2,5,2,0,0
1381009,103,13,1910,8,"male",802,91,28,15,11,15,9,0,2
1381037,21,14,1992,11,"male",170,32,28,5,12,0,8,5,4
1381068,28,30,1985,12,"male",534,104,54,19,1,19,1,0,0
1381093,53,18,1960,4,"male",502,176,121,210,172,210,102,0,70
1381097,108,22,1905,6,"male",1496,628,341,223,126,28,40,195,86
1381127,31,7,1982,6,"male",310,25,23,0,0,0,0,0,0
1381131,56,29,1957,4,"female",200,48,33,230,272,230,229,0,43
1381135,20,10,1993,2,"male",531,26,10,4,1,4,0,0,1
1381138,56,20,1957,7,"male",1307,104,25,1,9,1,9,0,0
1381172,17,22,1996,4,"female",307,156,69,129,70,129,49,0,21
1381177,27,26,1986,3,"male",288,12,7,1,0,0,0,1,0
1381225,16,26,1997,3,"male",337,106,66,175,138,98,66,77,72
1381247,69,5,1944,5,"female",376,11,5,3,4,0,1,3,3
1381262,18,4,1995,6,"female",282,234,37,2,7,2,5,0,2
1381278,24,11,1989,4,"female",798,110,2,8,20,8,17,0,3
1381306,34,28,1979,3,"female",1978,154,80,537,330,473,273,64,57
1381309,19,16,1994,1,"female",239,83,68,117,90,1,41,116,49
1381359,23,4,1990,8,"male",358,39,36,5,2,5,1,0,1
1381360,103,24,1910,11,"female",1843,236,114,23,10,21,5,2,5
1381376,44,2,1969,2,"female",301,122,67,1457,1074,27,392,1430,682
1381379,19,1,1994,1,"female",113,22,13,99,50,87,27,12,23
1381380,15,25,1998,8,"female",434,903,623,1229,1018,687,567,542,451
1381411,25,7,1988,11,"female",97,133,114,527,124,527,112,0,12
1381434,42,24,1971,12,"female",400,222,114,487,574,487,126,0,448
1381436,51,7,1962,4,"male",1420,530,397,187,43,80,26,107,17
1381438,16,28,1997,10,"male",130,84,66,0,0,0,0,0,0
1381445,31,31,1982,8,"male",36,17,16,4,3,4,3,0,0
1381448,35,8,1978,3,"female",246,16,6,16,21,16,12,0,9
1381462,64,2,1949,6,"female",238,29,24,28,9,28,8,0,1
1381467,27,3,1986,8,"male",374,128,38,16,14,3,13,13,1
1381500,25,17,1988,5,"male",636,85,60,0,0,0,0,0,0
1381519,64,19,1949,11,"male",39,48,7,0,22,0,22,0,0
1381529,18,15,1995,3,"male",635,193,60,36,8,8,2,28,6
1381538,42,7,1971,7,"male",982,299,135,197,47,173,7,24,40
1381550,52,31,1961,12,"female",74,31,20,14,55,14,26,0,29
1381557,19,26,1994,1,"male",410,372,224,16,13,16,7,0,6
1381597,31,23,1982,6,"female",225,86,47,232,170,232,149,0,21
1381603,58,7,1955,4,"male",548,211,138,10,1,10,1,0,0
1381621,26,1,1987,10,"male",610,177,57,12,27,6,8,6,19
1381635,25,11,1988,9,"female",187,1065,978,1218,1296,686,634,532,662
1381638,100,1,1913,1,"female",1860,204,57,1,1,0,0,1,1
1381658,48,17,1965,7,"female",789,1800,1125,1165,1430,4,248,1161,1182
1381665,23,27,1990,9,"male",20,1,1,0,0,0,0,0,0
1381691,38,1,1975,6,"male",622,62,20,16,12,16,10,0,2
1381700,25,6,1988,8,"male",508,265,156,5,1,5,0,0,1
1381734,15,16,1998,3,"male",245,339,310,0,0,0,0,0,0
1381749,16,23,1997,11,"female",258,43,25,0,56,0,25,0,31
1381761,14,3,1999,6,"male",149,27,13,6,7,6,6,0,1
1381793,18,1,1995,6,"female",152,228,38,1,4,1,4,0,0
1381818,21,15,1992,6,"male",80,0,0,29,4,19,1,10,3
1381821,25,17,1988,9,"male",1359,610,338,0,22,0,14,0,8
1381831,30,4,1983,6,"male",213,37,25,3,2,3,2,0,0
1381846,14,15,1999,11,"female",304,325,255,36,28,2,5,34,23
1381849,28,26,1985,10,"male",539,46,40,1,2,1,0,0,2
1381854,28,1,1985,5,"male",607,179,89,11,6,11,6,0,0
1381859,108,30,1905,12,"female",722,331,165,3,3,3,1,0,2
1382021,46,29,1967,1,"female",917,120,76,0,0,0,0,0,0
1382053,19,20,1994,1,"male",328,188,175,84,8,19,3,65,5
1382085,36,25,1977,4,"male",299,22,20,4,4,4,4,0,0
1382091,27,15,1986,4,"male",383,74,23,10,14,10,14,0,0
1382146,26,7,1987,12,"female",329,33,12,241,25,241,17,0,8
1382167,25,8,1988,4,"male",374,51,39,0,1,0,1,0,0
1382197,21,25,1992,8,"male",381,77,38,6,12,6,2,0,10
1382211,20,1,1993,9,"male",527,2712,2289,2,317,2,218,0,99
1382241,73,21,1940,1,"female",1091,15,14,2,2,0,2,2,0
1382275,20,20,1993,5,"female",116,14,6,754,440,753,372,1,68
1382296,52,20,1961,9,"female",1015,118,65,323,331,304,103,19,228
1382322,21,17,1992,11,"male",9,7,4,4,3,4,3,0,0
1382337,19,19,1994,3,"female",1571,713,164,140,458,119,164,21,294
1382340,19,7,1994,4,"female",1552,1401,319,714,28053,346,18648,368,9405
1382390,15,4,1998,3,"female",220,281,108,10,56,10,20,0,36
1382392,30,5,1983,9,"male",731,72,21,24,1,24,1,0,0
1382409,26,8,1987,2,"male",612,210,188,77,20,77,19,0,1
1382461,13,11,2000,6,"female",203,14,13,0,0,0,0,0,0
1382482,17,11,1996,10,"male",423,144,109,0,0,0,0,0,0
1382492,25,13,1988,5,"male",399,9,3,0,0,0,0,0,0
1382493,66,9,1947,10,"male",538,39,36,1,5,0,2,1,3
1382522,21,18,1992,4,"female",702,5,4,0,0,0,0,0,0
1382532,43,22,1970,2,"male",233,51,27,1,0,1,0,0,0
1382540,17,10,1996,5,"female",1038,1567,513,2042,3116,1593,1769,449,1347
1382542,54,17,1959,9,"male",575,1,1,0,0,0,0,0,0
1382559,48,1,1965,9,"female",209,67,50,75,101,75,99,0,2
1382572,61,29,1952,6,"female",1062,74,60,9,0,9,0,0,0
1382580,58,27,1955,1,"female",1642,79,58,614,131,0,73,614,58
1382606,24,26,1989,4,"male",176,48,17,1,0,1,0,0,0
1382643,28,16,1985,1,"male",267,58,46,172,35,159,8,13,27
1382663,19,23,1994,2,"female",680,1297,172,2083,3048,2049,2431,34,617
1382673,27,19,1986,1,"male",385,44,38,6,7,1,3,5,4
1382684,26,10,1987,9,"male",282,70,43,210,30,208,29,2,1
1382714,38,16,1975,1,"male",20,13,13,5,2,5,2,0,0
1382721,37,20,1976,12,"female",219,65,57,592,535,592,284,0,251
1382722,16,25,1997,5,"female",446,67,30,9,5,9,2,0,3
1382739,18,10,1995,1,"male",537,187,102,216,112,19,42,197,70
1382747,17,20,1996,9,"male",158,227,196,747,181,270,108,477,73
1382754,98,9,1915,1,"male",1071,90,42,1,5,0,2,1,3
1382785,100,1,1913,1,"male",2461,206,114,11,52,1,22,10,30
1382786,23,21,1990,5,"male",554,232,188,3,9,3,8,0,1
1382797,21,5,1992,12,"female",417,354,273,318,185,24,90,294,95
1382806,58,26,1955,3,"female",1694,82,14,117,24,108,22,9,2
1382848,19,8,1994,1,"female",303,45,29,45,12,21,6,24,6
1382855,27,9,1986,3,"male",133,71,21,0,0,0,0,0,0
1382856,33,19,1980,5,"female",607,46,26,39,2,39,2,0,0
1382860,15,22,1998,5,"male",661,388,225,23,0,23,0,0,0
1382883,47,5,1966,9,"male",444,181,61,2,2,2,0,0,2
1382885,24,7,1989,8,"male",333,23,12,18,17,18,3,0,14
1382890,25,21,1988,4,"female",302,59,45,1,0,1,0,0,0
1382979,47,12,1966,9,"male",521,40,15,30,2,30,1,0,1
1383015,31,12,1982,2,"female",282,252,156,215,272,51,66,164,206
1383035,22,23,1991,9,"male",544,324,270,230,285,195,113,35,172
1383065,15,1,1998,4,"male",430,15,10,1,0,0,0,1,0
1383071,16,13,1997,1,"male",183,8,8,1,0,1,0,0,0
1383072,31,23,1982,6,"female",374,35,21,0,2,0,2,0,0
1383097,27,12,1986,9,"female",578,66,41,4,38,4,22,0,16
1383101,35,20,1978,1,"male",506,133,71,44,17,29,11,15,6
1383116,46,21,1967,7,"male",561,9,9,0,0,0,0,0,0
1383153,48,29,1965,12,"male",176,15,4,2,7,1,5,1,2
1383155,36,11,1977,11,"male",445,47,36,0,15,0,10,0,5
1383189,26,6,1987,6,"female",379,154,51,2,4,2,3,0,1
1383208,24,20,1989,1,"male",360,103,31,2082,124,1910,79,172,45
1383221,23,29,1990,5,"female",584,139,79,206,13,58,8,148,5
1383239,21,18,1992,1,"male",936,33,28,27,1,0,0,27,1
1383248,67,6,1946,7,"male",668,45,18,370,31,0,18,370,13
1383272,21,1,1992,9,"male",207,337,235,0,1,0,0,0,1
1383276,19,21,1994,6,"male",348,1,1,0,0,0,0,0,0
1383279,22,21,1991,1,"male",11,0,0,0,0,0,0,0,0
1383290,18,10,1995,3,"male",442,127,99,0,1,0,0,0,1
1383304,18,31,1995,12,"female",53,43,18,2,5,2,2,0,3
1383316,44,6,1969,2,"male",672,69,54,0,0,0,0,0,0
1383346,19,2,1994,1,"male",429,115,90,0,101,0,17,0,84
1383378,59,19,1954,11,"male",1586,253,40,132,286,0,28,132,258
1383387,37,25,1976,6,"male",386,180,170,0,0,0,0,0,0
1383396,37,2,1976,9,"female",1788,204,139,337,374,321,201,16,173
1383400,24,25,1989,2,"female",1286,303,90,317,395,66,89,251,306
1383403,33,5,1980,12,"female",160,62,46,662,199,27,114,635,85
1383408,56,21,1957,6,"female",773,286,78,99,380,0,72,99,308
1383417,14,24,1999,4,"male",653,279,129,0,8,0,3,0,5
1383438,23,6,1990,10,"male",344,123,96,9,8,9,8,0,0
1383452,32,4,1981,10,"female",350,36,23,0,0,0,0,0,0
1383455,30,28,1983,2,"male",473,170,97,417,343,288,206,129,137
1383469,30,7,1983,3,"male",742,77,56,0,5,0,5,0,0
1383476,66,18,1947,5,"female",230,35,13,11,5,11,3,0,2
1383484,17,21,1996,10,"female",133,51,45,60,28,60,24,0,4
1383515,19,5,1994,12,"male",294,832,566,168,349,165,244,3,105
1383568,21,14,1992,2,"male",292,171,144,1,0,1,0,0,0
1383584,66,27,1947,3,"female",75,13,7,170,61,0,50,170,11
1383601,103,12,1910,12,"female",1196,1129,717,135,101,125,92,10,9
1383603,15,26,1998,5,"male",79,34,25,4,20,4,13,0,7
1383623,30,4,1983,4,"female",216,258,117,1,10,1,3,0,7
1383633,51,14,1962,1,"female",1259,284,118,21,25,21,17,0,8
1383637,14,21,1999,7,"male",430,402,318,260,5,145,1,115,4
1383646,34,17,1979,7,"male",400,98,76,360,98,356,69,4,29
1383661,16,22,1997,5,"female",255,64,53,664,188,549,85,115,103
1383663,103,28,1910,2,"female",911,20,17,77,33,70,22,7,11
1383678,23,16,1990,4,"female",204,201,60,33,10,33,2,0,8
1383688,70,5,1943,8,"male",588,76,50,170,32,0,8,170,24
1383692,71,3,1942,9,"male",1591,31,14,0,0,0,0,0,0
1383695,18,8,1995,2,"male",575,48,23,21,31,0,22,21,9
1383700,20,22,1993,8,"male",685,37,30,0,1,0,0,0,1
1383714,27,11,1986,11,"female",700,147,66,1,2,1,0,0,2
1383744,42,24,1971,3,"male",675,34,26,0,5,0,3,0,2
1383764,32,13,1981,12,"male",14,10,10,0,0,0,0,0,0
1383775,16,4,1997,4,"male",452,277,191,3,0,3,0,0,0
1383780,57,10,1956,10,"female",231,123,98,3326,2453,0,98,3326,2355
1383825,28,16,1985,4,"male",750,160,92,2,2,2,0,0,2
1383829,44,16,1969,8,"male",465,105,34,0,0,0,0,0,0
1383833,23,1,1990,1,"male",240,21,20,6,0,6,0,0,0
1383838,20,1,1993,5,"female",212,141,88,305,356,250,224,55,132
1383898,33,10,1980,4,"male",1028,396,260,3,18,3,16,0,2
1383909,32,23,1981,11,"male",269,77,76,215,27,215,26,0,1
1383913,19,20,1994,7,"male",163,150,131,140,112,59,59,81,53
1383923,76,24,1937,2,"female",1366,35,13,9,3,0,0,9,3
1383924,16,21,1997,1,"male",356,72,50,51,56,51,54,0,2
1383926,98,21,1915,9,"female",19,17,15,3,7,3,7,0,0
1383931,70,2,1943,3,"male",974,13,9,4,17,4,2,0,15
1383933,47,3,1966,7,"male",397,95,11,1,0,0,0,1,0
1383941,67,15,1946,7,"male",1832,115,42,4,0,4,0,0,0
1383950,47,27,1966,5,"male",422,102,83,2,1,0,0,2,1
1383973,66,23,1947,12,"female",2127,95,60,874,186,874,41,0,145
1383976,33,1,1980,1,"male",129,48,44,6,23,6,18,0,5
1383997,16,28,1997,10,"female",497,805,611,481,217,87,127,394,90
1384013,108,20,1905,5,"male",1323,329,263,67,12,67,12,0,0
1384042,59,12,1954,3,"female",538,450,373,0,0,0,0,0,0
1384058,22,5,1991,3,"male",462,125,33,0,0,0,0,0,0
1384085,25,1,1988,1,"male",19,24,20,42,18,42,15,0,3
1384110,18,25,1995,3,"female",354,323,78,5,2,5,1,0,1
1384162,27,4,1986,12,"female",162,29,13,0,0,0,0,0,0
1384163,18,4,1995,5,"male",221,661,629,306,124,306,77,0,47
1384192,15,8,1998,11,"female",511,782,469,429,368,267,191,162,177
1384204,34,4,1979,1,"female",437,294,195,2,1,2,1,0,0
1384206,17,21,1996,5,"male",581,368,150,0,46,0,27,0,19
1384228,33,10,1980,10,"female",247,115,77,31,29,31,26,0,3
1384229,19,20,1994,4,"male",134,80,75,0,1,0,0,0,1
1384233,37,3,1976,1,"male",539,3,3,4,1,4,0,0,1
1384280,66,26,1947,3,"male",1618,37,27,4,1,4,1,0,0
1384313,60,12,1953,9,"male",706,11,8,10,0,0,0,10,0
1384314,103,13,1910,12,"female",703,1338,541,0,0,0,0,0,0
1384325,20,11,1993,7,"male",411,252,207,0,0,0,0,0,0
1384327,21,27,1992,3,"male",221,246,72,1,66,1,27,0,39
1384330,25,3,1988,2,"male",298,394,180,95,139,70,69,25,70
1384385,31,11,1982,2,"female",219,21,11,0,0,0,0,0,0
1384399,57,31,1956,5,"female",288,26,8,3,3,0,2,3,1
1384432,18,21,1995,7,"male",518,1584,1103,4,13,4,11,0,2
1384454,43,15,1970,3,"male",1842,143,71,319,244,252,167,67,77
1384501,16,3,1997,1,"male",185,107,103,2,0,2,0,0,0
1384530,20,18,1993,10,"male",139,11,11,0,0,0,0,0,0
1384571,50,9,1963,8,"male",43,0,0,0,0,0,0,0,0
1384573,35,17,1978,2,"male",337,84,27,25,65,25,27,0,38
1384595,44,1,1969,3,"female",293,33,19,2,0,2,0,0,0
1384602,28,10,1985,3,"male",568,95,78,0,20,0,14,0,6
1384636,26,10,1987,11,"male",323,55,33,14,3,14,1,0,2
1384653,20,7,1993,6,"female",677,671,420,1296,1641,455,447,841,1194
1384697,26,25,1987,12,"female",489,130,93,0,9,0,4,0,5
1384731,15,3,1998,7,"male",504,193,150,105,134,68,33,37,101
1384746,20,28,1993,4,"male",364,39,23,6,0,6,0,0,0
1384748,47,29,1966,1,"male",69,16,13,0,0,0,0,0,0
1384786,16,1,1997,5,"male",159,556,411,17,87,17,31,0,56
1384831,25,29,1988,12,"male",232,118,104,4,2,3,1,1,1
1384843,29,24,1984,4,"male",229,11,9,0,0,0,0,0,0
1384875,59,4,1954,4,"female",257,27,22,11,2,2,1,9,1
1384897,26,5,1987,6,"female",796,210,132,2,1,0,1,2,0
1384921,28,14,1985,10,"male",351,23,15,30,0,30,0,0,0
1384923,29,5,1984,7,"female",29,15,14,2,4,2,3,0,1
1384944,18,16,1995,2,"male",508,1188,1057,22,18,22,12,0,6
1384950,37,4,1976,4,"male",167,38,11,23,2,23,2,0,0
1384953,17,31,1996,5,"male",293,31,18,2,3,2,1,0,2
1384962,30,10,1983,6,"male",406,63,34,2,0,2,0,0,0
1384977,32,28,1981,4,"male",222,19,8,0,2,0,1,0,1
1384993,25,8,1988,2,"male",282,72,3,0,0,0,0,0,0
1385000,53,15,1960,7,"male",339,8,0,1,0,0,0,1,0
1385005,59,21,1954,2,"male",220,8,2,0,0,0,0,0,0
1385031,48,25,1965,2,"female",382,16,5,2,3,0,0,2,3
1385045,52,19,1961,11,"female",2277,147,90,588,260,294,163,294,97
1385047,25,5,1988,7,"male",220,130,105,6,117,6,93,0,24
1385048,19,21,1994,4,"female",382,722,327,323,176,323,146,0,30
1385052,16,8,1997,5,"male",45,1850,123,561,3885,414,2325,147,1560
1385054,22,18,1991,3,"female",75,43,28,6,2,6,1,0,1
1385055,26,1,1987,1,"male",326,222,198,18,10,18,10,0,0
1385062,16,29,1997,7,"female",145,350,213,975,1253,212,497,763,756
1385076,103,18,1910,3,"male",533,187,77,28,0,10,0,18,0
1385101,40,19,1973,1,"female",53,84,73,132,169,49,149,83,20
1385103,33,26,1980,12,"male",119,24,23,46,0,0,0,46,0
1385153,40,10,1973,2,"female",400,38,16,1,0,1,0,0,0
1385154,63,27,1950,9,"female",156,4,3,19,11,1,5,18,6
1385168,98,29,1915,8,"female",510,72,53,25,20,25,20,0,0
1385181,18,7,1995,7,"male",1199,11,9,0,0,0,0,0,0
1385187,22,1,1991,1,"male",513,1088,1020,0,0,0,0,0,0
1385199,108,16,1905,2,"female",441,382,166,316,163,316,160,0,3
1385209,15,5,1998,6,"male",270,1079,847,50,109,19,69,31,40
1385233,43,11,1970,2,"female",810,279,147,910,374,857,151,53,223
1385240,65,14,1948,10,"male",728,11,7,21,8,0,1,21,7
1385243,21,29,1992,8,"female",446,1,0,1,1,1,1,0,0
1385253,63,2,1950,11,"male",239,0,0,0,0,0,0,0,0
1385266,37,27,1976,8,"female",1648,32,10,0,0,0,0,0,0
1385318,46,14,1967,6,"male",593,28,5,0,3,0,0,0,3
1385359,16,18,1997,11,"female",472,6,4,1,0,1,0,0,0
1385362,32,21,1981,2,"female",352,66,32,10,39,5,28,5,11
1385363,29,10,1984,12,"female",443,2,2,0,0,0,0,0,0
1385390,56,1,1957,10,"female",778,123,101,48,83,0,19,48,64
1385426,55,15,1958,10,"male",195,86,35,34,42,34,34,0,8
1385464,17,6,1996,6,"female",732,2712,522,588,1896,469,764,119,1132
1385473,66,25,1947,10,"female",408,30,15,0,0,0,0,0,0
1385485,32,27,1981,11,"male",402,213,99,0,0,0,0,0,0
1385488,24,4,1989,4,"female",18,15,15,4,10,4,8,0,2
1385489,16,9,1997,10,"male",531,247,166,18,0,18,0,0,0
1385524,44,20,1969,4,"female",430,183,113,2235,1253,2143,895,92,358
1385527,27,2,1986,7,"male",129,141,62,0,2,0,2,0,0
1385555,104,8,1909,12,"female",1354,94,37,93,57,90,37,3,20
1385567,69,2,1944,10,"female",506,54,23,32,114,29,49,3,65
1385572,46,15,1967,2,"male",1094,96,9,33,22,33,10,0,12
1385577,19,7,1994,1,"male",228,9,2,17,1,0,1,17,0
1385586,19,8,1994,3,"female",357,23,12,1,0,1,0,0,0
1385601,23,11,1990,4,"male",182,83,45,22,13,22,13,0,0
1385613,19,3,1994,7,"male",38,50,48,12,5,12,5,0,0
1385645,20,14,1993,11,"male",311,445,345,53,109,53,67,0,42
1385649,23,22,1990,5,"male",419,10,4,0,1,0,1,0,0
1385669,41,24,1972,9,"male",658,152,78,21,3,21,2,0,1
1385711,23,25,1990,3,"female",652,15,9,0,0,0,0,0,0
1385717,14,12,1999,12,"female",265,347,63,0,0,0,0,0,0
1385811,19,1,1994,8,"male",122,62,50,0,0,0,0,0,0
1385824,21,8,1992,3,"female",339,148,29,37,75,33,73,4,2
1385849,15,1,1998,1,"male",13,7,5,0,0,0,0,0,0
1385864,49,5,1964,12,"male",1322,2,1,0,0,0,0,0,0
1385881,29,25,1984,4,"male",396,102,68,117,66,106,54,11,12
1385889,19,10,1994,9,"female",5,4,4,112,36,61,25,51,11
1385895,17,23,1996,9,"male",149,28,22,2,4,2,3,0,1
1385897,34,16,1979,1,"male",340,95,6,11,9,11,8,0,1
1385909,17,20,1996,10,"male",157,23,12,0,0,0,0,0,0
1385912,50,4,1963,1,"male",1191,96,37,32,0,32,0,0,0
1385913,73,22,1940,8,"male",73,0,0,0,0,0,0,0,0
1385915,17,5,1996,2,"male",206,27,22,25,5,1,0,24,5
1385981,16,22,1997,8,"male",420,77,70,0,0,0,0,0,0
1385982,28,27,1985,7,"female",1173,302,74,341,2665,97,1490,244,1175
1385999,52,7,1961,2,"female",190,1,1,1,0,0,0,1,0
1386002,20,1,1993,1,"male",129,36,34,0,0,0,0,0,0
1386006,84,20,1929,7,"female",253,109,71,563,240,559,124,4,116
1386012,20,2,1993,2,"female",295,550,286,851,1323,611,666,240,657
1386015,27,11,1986,6,"female",389,141,84,55,123,45,57,10,66
1386039,17,27,1996,8,"male",91,60,54,0,0,0,0,0,0
1386046,16,1,1997,1,"male",101,59,11,10,0,10,0,0,0
1386050,20,21,1993,8,"male",16,7,3,1,1,1,0,0,1
1386052,16,5,1997,5,"female",236,613,536,649,865,347,640,302,225
1386056,23,7,1990,7,"male",82,1,1,2,0,1,0,1,0
1386061,66,18,1947,11,"male",785,62,45,0,0,0,0,0,0
1386070,51,1,1962,8,"female",759,40,22,112,44,22,4,90,40
1386073,24,18,1989,12,"female",164,192,177,87,51,87,39,0,12
1386076,30,12,1983,11,"female",208,698,191,438,400,168,84,270,316
1386082,23,20,1990,1,"male",136,170,156,53,37,38,35,15,2
1386088,27,25,1986,10,"female",390,47,34,93,21,68,11,25,10
1386126,45,3,1968,12,"male",252,3,3,1,0,0,0,1,0
1386136,13,28,2000,3,"female",153,242,203,191,79,48,29,143,50
1386168,21,23,1992,1,"male",213,19,9,11,8,6,1,5,7
1386179,103,31,1910,12,"female",34,78,77,42,44,42,40,0,4
1386185,49,15,1964,12,"female",479,30,22,1,4,1,2,0,2
1386192,15,5,1998,12,"male",409,237,176,10,12,0,4,10,8
1386249,14,15,1999,2,"male",255,21,11,0,2,0,0,0,2
1386265,64,4,1949,9,"male",1452,16,5,0,0,0,0,0,0
1386283,102,1,1911,9,"female",541,345,173,1,0,1,0,0,0
1386285,50,6,1963,4,"male",586,122,58,2032,158,2032,114,0,44
1386345,16,20,1997,12,"female",220,183,56,75,1,50,0,25,1
1386390,103,15,1910,12,"female",907,241,121,0,13,0,3,0,10
1386391,63,26,1950,4,"female",530,69,32,72,155,70,67,2,88
1386412,71,7,1942,3,"female",884,27,17,0,3,0,2,0,1
1386477,108,20,1905,1,"female",646,18,13,1,1,0,0,1,1
1386507,33,17,1980,8,"male",387,1,1,1,2,1,2,0,0
1386520,42,2,1971,2,"male",1458,40,13,1,1,1,1,0,0
1386526,94,17,1919,3,"female",1038,68,25,0,0,0,0,0,0
1386573,53,14,1960,4,"male",722,255,197,1,0,1,0,0,0
1386581,25,10,1988,1,"male",377,101,90,16,17,12,15,4,2
1386607,30,29,1983,10,"male",455,163,119,21,25,21,25,0,0
1386628,16,13,1997,2,"male",81,89,66,45,67,45,60,0,7
1386668,17,14,1996,4,"female",505,71,43,41,29,23,25,18,4
1386687,26,17,1987,12,"male",98,20,20,49,70,49,36,0,34
1386694,16,2,1997,7,"female",217,51,41,9,1,0,0,9,1
1386729,23,14,1990,7,"male",378,239,225,3,0,3,0,0,0
1386770,16,4,1997,12,"female",598,670,224,1063,513,144,197,919,316
1386791,108,20,1905,11,"female",884,605,128,38,238,38,198,0,40
1386800,15,17,1998,8,"male",217,1,0,0,0,0,0,0,0
1386847,44,15,1969,11,"female",437,130,104,69,201,6,133,63,68
1386848,100,9,1913,11,"male",1860,233,128,236,336,150,255,86,81
1386874,17,1,1996,4,"male",937,549,253,2,44,2,40,0,4
1386921,29,13,1984,2,"female",494,39,33,0,0,0,0,0,0
1386939,26,13,1987,6,"male",33,12,9,0,0,0,0,0,0
1386943,22,7,1991,9,"male",608,219,48,0,0,0,0,0,0
1386986,51,10,1962,10,"female",270,74,39,315,201,315,107,0,94
1387010,97,8,1916,4,"female",444,51,16,22,32,22,12,0,20
1387015,66,6,1947,2,"male",864,6,4,0,0,0,0,0,0
1387018,25,21,1988,4,"female",376,19,8,4,7,4,7,0,0
1387028,24,18,1989,4,"male",452,52,32,0,0,0,0,0,0
1387033,41,5,1972,11,"male",14,25,20,0,2,0,0,0,2
1387075,45,4,1968,4,"male",163,6,4,0,0,0,0,0,0
1387095,35,21,1978,6,"female",1373,36,14,336,170,336,108,0,62
1387104,37,30,1976,7,"male",493,135,77,0,0,0,0,0,0
1387125,17,29,1996,8,"male",535,704,459,44,103,20,59,24,44
1387127,23,13,1990,2,"male",417,469,424,0,0,0,0,0,0
1387136,28,1,1985,12,"female",147,10,8,211,12,211,1,0,11
1387186,60,28,1953,5,"male",302,15,13,3,2,3,2,0,0
1387196,21,7,1992,7,"female",81,92,66,25,7,25,7,0,0
1387225,20,15,1993,5,"female",286,250,47,9,8,9,7,0,1
1387238,58,23,1955,1,"female",283,61,38,322,88,0,16,322,72
1387275,108,29,1905,12,"male",248,103,80,40,13,1,8,39,5
1387290,25,30,1988,3,"male",430,51,48,0,2,0,0,0,2
1387293,50,21,1963,5,"male",376,19,6,0,0,0,0,0,0
1387325,72,23,1941,3,"male",619,69,34,23,0,0,0,23,0
1387341,35,30,1978,9,"female",121,184,174,92,229,92,204,0,25
1387342,35,28,1978,2,"male",468,0,0,0,0,0,0,0,0
1387346,43,17,1970,7,"male",1556,70,40,0,4,0,2,0,2
1387354,53,19,1960,10,"male",599,24,6,22,11,1,4,21,7
1387355,65,24,1948,10,"male",1416,11,7,24,9,0,6,24,3
1387402,43,18,1970,1,"female",76,29,26,29,5,29,3,0,2
1387403,18,17,1995,10,"male",84,41,30,23,14,23,12,0,2
1387411,53,10,1960,4,"female",974,514,202,12,1,11,0,1,1
1387415,113,3,1900,8,"female",1662,162,99,172,110,167,78,5,32
1387421,60,24,1953,1,"female",61,24,19,40,18,40,2,0,16
1387423,24,7,1989,3,"female",556,4,4,86,51,86,43,0,8
1387425,53,4,1960,9,"male",232,52,30,362,205,362,135,0,70
1387428,33,17,1980,3,"female",73,82,61,57,101,57,65,0,36
1387461,54,14,1959,12,"male",86,72,63,142,10,142,6,0,4
1387465,76,25,1937,4,"male",1744,23,8,1,2,0,2,1,0
1387492,108,24,1905,1,"female",1064,2746,169,2,43,0,19,2,24
1387547,34,29,1979,12,"male",258,1,1,0,0,0,0,0,0
1387571,17,1,1996,1,"female",173,98,76,86,90,83,19,3,71
1387585,66,14,1947,8,"female",201,25,15,201,235,0,87,201,148
1387616,26,1,1987,1,"male",576,200,61,1,5,1,2,0,3
1387651,77,19,1936,10,"female",629,74,37,97,155,0,13,97,142
1387677,22,16,1991,5,"male",297,132,83,78,20,78,13,0,7
1387691,32,18,1981,9,"female",228,12,7,2,16,2,15,0,1
1387697,61,8,1952,2,"female",635,10,6,2,0,0,0,2,0
1387720,54,7,1959,11,"male",777,41,15,6,7,6,7,0,0
1387751,29,24,1984,1,"female",528,38,25,86,34,84,29,2,5
1387805,24,14,1989,8,"male",498,344,221,5,0,5,0,0,0
1387826,35,3,1978,11,"female",2286,278,94,365,619,290,470,75,149
1387858,96,1,1917,10,NA,2181,437,68,1010,1934,570,1108,440,826
1387860,17,15,1996,6,"female",147,38,32,0,1,0,0,0,1
1387863,23,3,1990,12,"male",372,5,4,0,0,0,0,0,0
1387877,68,17,1945,6,"male",984,25,11,61,3,0,3,61,0
1387880,16,23,1997,5,"male",580,895,541,74,77,22,38,52,39
1387883,103,26,1910,8,"male",1678,450,103,122,136,113,50,9,86
1387894,14,7,1999,8,"male",143,97,80,6,11,6,10,0,1
1387895,22,28,1991,10,"female",321,144,79,128,170,54,24,74,146
1387908,54,4,1959,6,"male",2235,43,29,11,1,11,1,0,0
1387911,29,1,1984,6,"male",654,266,169,4,5,4,4,0,1
1387937,21,11,1992,10,"female",210,345,224,482,536,134,323,348,213
1387942,19,14,1994,12,"male",415,385,344,0,0,0,0,0,0
1387963,108,25,1905,6,"male",1558,285,99,26,47,22,23,4,24
1387966,64,6,1949,6,"male",913,118,80,14,10,14,10,0,0
1387993,44,8,1969,2,"male",828,77,71,0,5,0,1,0,4
1388000,27,4,1986,4,"male",507,432,304,188,114,188,95,0,19
1388050,50,30,1963,12,"male",578,43,28,32,12,32,8,0,4
1388080,93,30,1920,1,"male",1787,397,260,34,92,10,30,24,62
1388085,57,25,1956,1,"female",1345,7,3,0,0,0,0,0,0
1388093,20,2,1993,9,"female",232,500,181,146,765,118,470,28,295
1388117,64,23,1949,12,"female",759,601,444,11,47,11,47,0,0
1388118,25,23,1988,3,"male",302,306,263,46,74,46,52,0,22
1388126,37,28,1976,1,"male",211,191,170,0,0,0,0,0,0
1388156,25,1,1988,1,"male",31,11,11,0,0,0,0,0,0
1388159,92,23,1921,3,"male",913,508,73,66,21,66,21,0,0
1388194,66,26,1947,10,"male",426,54,26,1,2,0,0,1,2
1388202,55,4,1958,12,"female",168,19,10,7,14,7,11,0,3
1388228,13,23,2000,6,"male",110,1,1,404,1,0,0,404,1
1388232,31,19,1982,3,"male",316,54,51,328,17,0,4,328,13
1388235,16,14,1997,6,"male",557,254,188,35,31,32,6,3,25
1388272,13,13,2000,6,"male",135,7,6,0,0,0,0,0,0
1388325,52,12,1961,7,"male",1726,85,26,14,11,13,9,1,2
1388336,14,2,1999,7,"female",304,18,9,0,7,0,1,0,6
1388337,15,25,1998,3,"female",405,299,234,113,24,113,10,0,14
1388348,47,13,1966,12,"male",708,85,43,159,451,49,371,110,80
1388358,28,19,1985,5,"male",281,1,0,0,0,0,0,0,0
1388364,60,6,1953,5,"female",1746,46,6,165,34,0,9,165,25
1388370,28,3,1985,2,"male",756,1,1,0,0,0,0,0,0
1388382,31,17,1982,8,"male",477,231,123,34,3,34,0,0,3
1388431,25,26,1988,11,"female",575,137,40,21,28,21,11,0,17
1388453,23,19,1990,6,"male",510,49,11,3,0,0,0,3,0
1388473,30,10,1983,2,"male",1200,90,46,19,6,19,4,0,2
1388476,30,20,1983,4,"male",1115,640,342,410,728,278,293,132,435
1388497,43,20,1970,8,"male",1194,29,14,0,0,0,0,0,0
1388512,50,31,1963,8,"female",1375,68,40,225,141,0,20,225,121
1388536,50,24,1963,9,"female",184,61,31,688,356,3,15,685,341
1388560,67,25,1946,7,"female",1334,20,9,206,10,40,6,166,4
1388561,21,5,1992,12,"female",466,73,40,1,0,1,0,0,0
1388579,29,25,1984,1,"female",277,2,1,1,0,1,0,0,0
1388589,18,9,1995,1,"male",1021,505,313,28,3,28,2,0,1
1388595,22,21,1991,4,"female",365,152,88,27,32,27,30,0,2
1388597,17,1,1996,2,"male",576,64,52,0,10,0,6,0,4
1388600,103,14,1910,4,"male",920,226,129,3,1,3,1,0,0
1388606,16,16,1997,12,"male",466,722,373,57,122,57,78,0,44
1388611,39,27,1974,11,"female",959,36,20,2,0,0,0,2,0
1388639,48,4,1965,4,"male",33,34,32,18,13,18,13,0,0
1388678,39,18,1974,10,"male",359,0,0,0,0,0,0,0,0
1388702,14,31,1999,3,"female",580,87,38,108,10,14,3,94,7
1388709,22,7,1991,9,"male",642,101,66,1,0,1,0,0,0
1388722,28,1,1985,1,"male",504,91,73,6,3,6,0,0,3
1388731,54,23,1959,2,"male",423,36,7,4,42,2,32,2,10
1388733,19,1,1994,1,"male",57,11,11,40,1,40,0,0,1
1388771,75,15,1938,7,"male",2326,101,14,111,5,68,2,43,3
1388784,31,4,1982,4,"male",475,88,82,18,22,11,19,7,3
1388785,49,10,1964,5,"female",173,0,0,0,1,0,0,0,1
1388802,22,21,1991,5,"female",314,305,275,4,4,0,0,4,4
1388806,59,15,1954,4,"female",164,6,4,0,0,0,0,0,0
1388813,19,1,1994,1,"male",20,1,1,6,2,1,0,5,2
1388844,27,26,1986,6,"male",43,9,9,0,0,0,0,0,0
1388849,25,20,1988,12,"male",425,188,114,12,1,12,0,0,1
1388857,17,1,1996,10,"female",176,239,64,37,71,34,45,3,26
1388884,55,7,1958,10,"male",989,125,37,37,150,37,115,0,35
1388898,33,18,1980,2,"male",635,75,18,5,1,5,1,0,0
1388924,20,1,1993,11,"male",255,16,13,0,0,0,0,0,0
1388940,18,26,1995,1,"male",278,96,61,3,0,0,0,3,0
1388973,46,4,1967,7,"female",902,20,15,19,2,19,1,0,1
1389001,69,28,1944,11,"male",423,63,50,88,14,0,2,88,12
1389037,27,8,1986,5,"male",506,16,13,0,0,0,0,0,0
1389050,17,8,1996,3,"female",495,45,33,26,0,0,0,26,0
1389081,15,18,1998,8,"female",11,0,0,0,0,0,0,0,0
1389100,18,10,1995,6,"female",408,276,137,1,2,1,0,0,2
1389144,29,28,1984,10,"female",1344,764,188,42,91,24,50,18,41
1389148,41,9,1972,5,"male",539,82,61,853,435,843,233,10,202
1389206,60,1,1953,1,"male",643,595,408,34,10,0,3,34,7
1389218,31,20,1982,7,"male",833,110,86,0,19,0,2,0,17
1389227,36,27,1977,10,"male",442,29,10,3,8,3,8,0,0
1389229,38,10,1975,1,"female",380,15,7,95,70,83,38,12,32
1389234,56,29,1957,8,"female",2376,55,49,446,219,0,67,446,152
1389260,25,13,1988,11,"male",49,2,0,0,0,0,0,0,0
1389266,41,13,1972,11,"male",99,5,5,11,0,0,0,11,0
1389279,61,1,1952,11,"male",693,39,15,204,62,22,41,182,21
1389283,42,27,1971,9,"male",223,118,57,1783,370,1783,305,0,65
1389304,18,24,1995,6,"male",747,1169,853,22,14,22,14,0,0
1389330,16,4,1997,11,"female",534,506,331,1412,1734,1412,951,0,783
1389341,21,21,1992,3,"male",340,126,106,6,19,0,1,6,18
1389353,93,8,1920,3,"female",484,229,148,7,6,7,6,0,0
1389381,33,13,1980,1,"male",445,49,40,19,4,19,3,0,1
1389396,19,3,1994,8,"male",359,75,32,22,0,0,0,22,0
1389424,15,26,1998,1,"female",357,931,266,667,412,667,261,0,151
1389439,43,17,1970,1,"male",801,6,6,0,1,0,1,0,0
1389458,30,16,1983,8,"male",245,110,38,9,1,9,1,0,0
1389459,60,30,1953,9,"female",632,83,30,2,5,0,2,2,3
1389463,23,13,1990,4,"female",382,1,1,0,0,0,0,0,0
1389471,30,25,1983,4,"male",557,172,94,63,170,63,170,0,0
1389493,64,6,1949,6,"male",1743,58,13,5,2,0,1,5,1
1389499,68,4,1945,1,"male",1655,67,53,13,0,0,0,13,0
1389511,61,28,1952,3,"female",1103,30,16,4,0,0,0,4,0
1389539,19,4,1994,5,"female",246,232,170,20,34,12,27,8,7
1389542,66,5,1947,5,"female",1916,26,7,0,1,0,0,0,1
1389546,36,21,1977,2,"female",494,103,50,157,68,0,0,157,68
1389589,25,10,1988,3,"male",688,17,13,6,7,6,7,0,0
1389594,25,6,1988,7,"male",293,482,209,321,131,313,120,8,11
1389610,23,8,1990,8,"female",55,3,3,0,0,0,0,0,0
1389640,74,9,1939,9,"male",73,30,29,1,1,1,1,0,0
1389660,19,14,1994,9,"female",640,764,398,318,585,261,299,57,286
1389682,38,14,1975,10,"female",58,61,46,17,28,17,28,0,0
1389683,27,2,1986,3,"female",488,97,68,2,5,2,0,0,5
1389692,32,3,1981,10,"male",368,89,49,41,2,41,1,0,1
1389694,16,13,1997,4,"male",108,248,205,59,23,0,13,59,10
1389699,56,17,1957,3,"male",1231,102,31,7,10,7,5,0,5
1389711,16,14,1997,10,"male",487,686,615,93,71,93,70,0,1
1389722,34,12,1979,3,"male",708,402,183,8,85,8,42,0,43
1389730,21,23,1992,7,"male",391,50,41,3,0,2,0,1,0
1389742,53,15,1960,1,"female",668,115,75,1,30,1,23,0,7
1389767,50,5,1963,7,"male",245,32,24,4,2,4,2,0,0
1389770,22,4,1991,4,"female",763,1,1,0,0,0,0,0,0
1389772,100,25,1913,11,"male",936,58,47,10,5,0,4,10,1
1389813,57,11,1956,9,"male",377,174,75,4,1,4,0,0,1
1389851,43,10,1970,3,"female",389,18,8,200,97,0,42,200,55
1389879,26,1,1987,1,"male",78,22,19,0,0,0,0,0,0
1389916,93,25,1920,5,"male",353,202,165,0,4,0,4,0,0
1389918,16,18,1997,5,"female",242,817,635,136,74,136,62,0,12
1389970,68,28,1945,8,"male",66,77,75,65,96,65,88,0,8
1389972,108,3,1905,6,"male",1106,280,186,154,159,153,135,1,24
1389977,18,1,1995,8,"male",21,31,29,1,2,1,2,0,0
1389978,13,4,2000,2,"male",329,412,160,4,1,0,0,4,1
1389980,29,18,1984,9,"male",403,118,110,3,4,3,2,0,2
1390003,29,2,1984,9,"male",324,0,0,0,0,0,0,0,0
1390006,21,24,1992,4,"female",429,416,238,27,26,27,26,0,0
1390022,17,12,1996,1,"male",338,49,21,0,0,0,0,0,0
1390024,39,11,1974,12,"female",1692,115,79,41,124,41,111,0,13
1390034,16,24,1997,6,"female",480,57,30,10,4,10,1,0,3
1390035,20,23,1993,4,"female",613,424,141,49,4,49,4,0,0
1390079,33,6,1980,10,"male",252,109,62,127,40,54,5,73,35
1390083,39,21,1974,1,"male",463,110,89,7,0,7,0,0,0
1390085,19,26,1994,12,"female",437,515,306,312,164,312,127,0,37
1390119,52,1,1961,4,"male",219,37,36,19,10,19,8,0,2
1390157,15,3,1998,10,"female",519,115,68,10,11,0,2,10,9
1390167,42,21,1971,3,"female",242,82,64,84,53,84,36,0,17
1390175,108,17,1905,1,"female",1899,269,37,118,76,13,30,105,46
1390181,37,18,1976,5,"male",219,28,20,12,8,0,8,12,0
1390183,24,2,1989,6,"male",576,19,19,0,0,0,0,0,0
1390211,23,18,1990,4,"male",305,275,214,349,324,79,146,270,178
1390231,59,24,1954,5,"female",284,50,37,0,1,0,0,0,1
1390233,25,4,1988,1,"female",161,0,0,0,0,0,0,0,0
1390239,38,29,1975,11,"female",66,81,25,79,27,79,26,0,1
1390245,61,7,1952,12,"female",1928,59,22,80,13,1,0,79,13
1390251,16,23,1997,6,"male",509,1357,1168,652,94,8,13,644,81
1390260,38,18,1975,11,"female",524,72,45,193,203,193,193,0,10
1390267,51,15,1962,4,"female",453,110,69,28,11,0,7,28,4
1390285,19,24,1994,7,"male",708,145,96,0,7,0,5,0,2
1390286,34,3,1979,10,"male",314,29,22,0,2,0,0,0,2
1390307,31,7,1982,2,"female",412,219,135,211,111,211,94,0,17
1390333,61,10,1952,5,"male",627,23,12,0,1,0,1,0,0
1390336,61,9,1952,6,"female",307,63,27,31,23,22,8,9,15
1390362,20,17,1993,12,"male",194,97,62,111,52,77,25,34,27
1390363,23,7,1990,2,"male",357,3,2,0,0,0,0,0,0
1390379,18,11,1995,6,"male",265,27,15,0,8,0,7,0,1
1390381,33,29,1980,11,"female",1383,478,213,97,253,97,233,0,20
1390402,42,6,1971,7,"female",1267,61,47,8,10,0,3,8,7
1390407,25,8,1988,12,"female",1792,478,288,901,1009,878,744,23,265
1390455,61,12,1952,4,"female",242,72,35,3,3,2,2,1,1
1390456,56,4,1957,1,"female",860,287,164,1992,538,1992,206,0,332
1390505,19,5,1994,5,"male",677,8,7,30,8,0,5,30,3
1390519,46,3,1967,4,"male",103,19,15,18,10,18,9,0,1
1390527,29,15,1984,11,"female",311,68,46,30,2,30,0,0,2
1390546,29,19,1984,4,"male",2205,343,139,0,0,0,0,0,0
1390548,22,22,1991,6,"male",249,21,13,2,0,2,0,0,0
1390571,51,15,1962,12,"male",399,69,51,7,8,1,2,6,6
1390582,63,7,1950,5,"female",194,112,41,73,30,1,12,72,18
1390590,37,28,1976,10,"male",239,85,77,19,1,19,1,0,0
1390592,93,19,1920,12,"female",709,197,116,1,10,1,4,0,6
1390607,17,1,1996,9,"male",153,21,15,0,0,0,0,0,0
1390643,24,11,1989,12,"male",320,33,12,0,0,0,0,0,0
1390654,42,29,1971,3,"female",265,19,17,34,17,34,17,0,0
1390680,25,29,1988,5,"female",264,347,283,216,246,142,107,74,139
1390683,42,22,1971,1,"male",253,21,19,20,8,9,1,11,7
1390700,103,31,1910,12,"male",966,243,86,1,7,1,7,0,0
1390716,32,7,1981,4,"male",311,107,103,23,0,23,0,0,0
1390732,13,6,2000,3,"male",319,179,110,878,153,842,126,36,27
1390740,61,2,1952,8,"female",662,834,451,586,1219,224,620,362,599
1390760,27,5,1986,7,"female",1554,512,346,50,159,27,99,23,60
1390784,66,8,1947,3,"female",1757,143,124,815,1512,61,657,754,855
1390792,24,12,1989,12,"male",25,37,36,0,1,0,1,0,0
1390796,15,7,1998,6,"female",349,243,179,0,54,0,53,0,1
1390807,29,28,1984,6,"female",531,482,291,122,102,122,73,0,29
1390859,30,3,1983,9,"female",552,198,89,532,252,532,192,0,60
1390925,14,21,1999,9,"male",433,316,205,47,57,1,12,46,45
1390973,24,24,1989,1,"male",71,62,62,0,0,0,0,0,0
1390976,64,27,1949,11,"female",1332,210,59,607,300,607,183,0,117
1390983,43,29,1970,5,"male",45,141,96,1474,394,371,251,1103,143
1391004,32,1,1981,5,"female",522,66,14,0,2,0,1,0,1
1391023,60,29,1953,11,"female",506,61,47,8,3,0,0,8,3
1391026,49,2,1964,5,"female",2044,41,22,10,35,9,25,1,10
1391031,17,29,1996,2,"male",1141,869,639,1660,1425,1498,894,162,531
1391040,27,1,1986,11,"male",355,130,105,1,0,1,0,0,0
1391045,19,4,1994,8,"male",537,1113,1005,24,44,1,41,23,3
1391056,25,22,1988,5,"male",1250,359,166,0,0,0,0,0,0
1391065,38,27,1975,7,"female",274,474,417,249,46,227,6,22,40
1391070,17,2,1996,9,"female",28,67,47,16,6,16,3,0,3
1391089,54,7,1959,11,"female",1838,248,184,1645,1498,0,668,1645,830
1391100,38,15,1975,8,"female",542,227,191,261,219,244,107,17,112
1391106,16,7,1997,11,"male",336,1768,1132,1326,1394,835,875,491,519
1391124,69,31,1944,5,"female",1671,69,34,2,3,2,1,0,2
1391141,25,18,1988,5,"male",585,82,4,2,50,0,28,2,22
1391151,99,2,1914,4,"female",950,56,32,124,30,124,22,0,8
1391158,34,17,1979,3,"female",220,61,33,4,20,4,20,0,0
1391182,48,25,1965,11,"male",314,51,43,9,7,9,4,0,3
1391196,52,27,1961,9,"male",298,0,0,9,0,0,0,9,0
1391197,20,11,1993,1,"female",100,13,8,0,0,0,0,0,0
1391223,47,27,1966,12,"male",163,40,27,15,5,15,5,0,0
1391232,20,7,1993,11,"male",319,129,44,11,2,11,2,0,0
1391248,30,12,1983,2,"male",654,50,42,0,19,0,7,0,12
1391257,15,22,1998,8,"female",264,185,122,288,74,288,58,0,16
1391270,65,8,1948,6,"female",18,27,22,513,204,0,56,513,148
1391282,18,9,1995,8,"female",243,164,60,116,15,116,10,0,5
1391306,18,20,1995,6,"female",34,202,35,2,38,2,38,0,0
1391351,18,2,1995,3,"female",405,84,53,44,48,41,27,3,21
1391367,22,16,1991,10,"male",549,62,52,20,5,20,5,0,0
1391428,51,30,1962,5,"male",509,18,17,0,2,0,0,0,2
1391439,48,13,1965,7,"female",170,13,7,1,2,1,2,0,0
1391473,49,23,1964,7,"female",596,23,17,4,0,4,0,0,0
1391479,28,5,1985,10,"female",244,197,113,1195,486,1195,416,0,70
1391505,67,24,1946,11,"female",87,20,20,16,37,16,24,0,13
1391506,23,1,1990,3,"female",422,153,80,82,222,77,137,5,85
1391521,51,14,1962,11,"female",668,13,8,18,16,18,14,0,2
1391532,68,12,1945,1,"male",446,124,8,14,3,14,3,0,0
1391561,19,4,1994,1,"male",110,73,65,0,0,0,0,0,0
1391622,18,5,1995,4,"male",1233,279,147,0,6,0,1,0,5
1391636,17,1,1996,1,"female",637,1589,601,312,208,111,105,201,103
1391640,47,21,1966,6,"male",955,67,23,90,84,90,72,0,12
1391654,16,4,1997,6,"male",400,43,29,7,0,7,0,0,0
1391661,24,2,1989,12,"male",48,101,92,55,41,55,33,0,8
1391706,21,10,1992,1,"male",366,44,38,0,0,0,0,0,0
1391710,52,12,1961,9,"male",320,7,5,2,3,2,2,0,1
1391716,18,10,1995,11,"female",24,81,59,52,99,23,31,29,68
1391751,34,28,1979,2,"male",391,20,12,3,0,3,0,0,0
1391798,92,28,1921,6,"female",1491,12,11,45,6,29,0,16,6
1391817,22,28,1991,8,"male",524,83,32,9,0,0,0,9,0
1391818,60,6,1953,11,"female",844,138,85,98,72,5,29,93,43
1391822,39,2,1974,11,"female",581,46,28,1,2,1,2,0,0
1391856,25,1,1988,1,"male",269,36,22,1,6,1,6,0,0
1391861,32,24,1981,5,"male",430,27,12,15,26,15,26,0,0
1391871,57,10,1956,11,"male",416,35,21,0,0,0,0,0,0
1391925,17,7,1996,11,"female",530,237,37,2,0,2,0,0,0
1391928,26,20,1987,6,"male",493,283,238,4,1,4,1,0,0
1391946,16,9,1997,10,"male",544,18,11,6,2,0,0,6,2
1391947,33,12,1980,9,"male",82,103,91,0,2,0,0,0,2
1391955,87,14,1926,11,"male",419,26,26,0,0,0,0,0,0
1391957,21,18,1992,8,"female",294,115,67,25,14,25,9,0,5
1391978,37,25,1976,11,"male",91,29,22,15,0,15,0,0,0
1392014,23,29,1990,8,"male",245,55,27,0,1,0,1,0,0
1392020,50,15,1963,9,"female",1136,101,50,978,264,978,210,0,54
1392034,34,4,1979,1,"male",127,9,9,2,1,2,1,0,0
1392046,18,30,1995,7,"female",121,853,590,298,1635,298,1124,0,511
1392079,41,17,1972,8,"female",552,168,86,990,238,990,213,0,25
1392080,22,3,1991,10,"male",541,118,97,0,0,0,0,0,0
1392082,64,1,1949,9,"female",1596,77,10,46,84,3,61,43,23
1392088,23,24,1990,6,"male",758,155,103,3,1,2,1,1,0
1392098,34,20,1979,7,"female",4,5,5,2,3,2,3,0,0
1392100,43,21,1970,2,"male",603,16,7,0,0,0,0,0,0
1392135,18,12,1995,11,"female",14,652,312,2083,2104,693,1241,1390,863
1392144,39,12,1974,6,"female",2259,294,207,76,87,74,70,2,17
1392148,44,28,1969,6,"female",223,42,25,132,7,41,6,91,1
1392196,23,6,1990,4,"male",296,304,249,67,178,33,104,34,74
1392206,19,6,1994,6,"female",163,496,197,184,139,157,96,27,43
1392212,51,10,1962,1,"male",320,22,6,0,0,0,0,0,0
1392233,18,26,1995,1,"male",70,89,85,0,3,0,2,0,1
1392295,63,7,1950,7,"male",568,22,19,4,3,3,1,1,2
1392298,14,20,1999,11,"female",245,1094,720,0,0,0,0,0,0
1392306,68,7,1945,6,"male",1046,58,27,10,10,10,3,0,7
1392329,53,5,1960,5,"female",1467,30,14,172,30,172,6,0,24
1392331,70,25,1943,7,"female",61,27,23,58,28,9,13,49,15
1392358,18,6,1995,7,"female",400,448,206,272,301,57,121,215,180
1392370,17,28,1996,8,"female",586,660,56,10849,5122,10849,4692,0,430
1392371,21,22,1992,3,"female",475,342,169,3,25,3,22,0,3
1392373,28,2,1985,3,"male",340,63,17,21,8,21,8,0,0
1392386,48,22,1965,7,"male",132,5,1,1,3,1,2,0,1
1392388,39,24,1974,5,"female",526,65,29,41,21,12,16,29,5
1392405,58,2,1955,9,"male",1164,61,13,0,6,0,4,0,2
1392406,29,10,1984,6,"male",345,26,13,0,0,0,0,0,0
1392425,25,1,1988,1,"male",232,104,62,148,46,148,32,0,14
1392432,52,8,1961,3,"male",603,120,97,160,168,1,47,159,121
1392438,19,16,1994,1,"female",330,163,141,37,15,37,10,0,5
1392439,18,26,1995,2,"male",480,51,37,0,0,0,0,0,0
1392458,21,15,1992,7,"female",450,1082,424,54,298,54,159,0,139
1392517,18,29,1995,9,"male",406,1035,860,48,11,22,11,26,0
1392613,93,21,1920,4,"female",939,191,95,1,20,1,5,0,15
1392672,86,26,1927,9,"male",1838,167,79,69,166,0,71,69,95
1392679,15,11,1998,1,"male",407,110,98,528,2,528,1,0,1
1392680,58,18,1955,5,"female",473,75,46,17,13,0,12,17,1
1392714,46,16,1967,3,"male",142,10,9,0,0,0,0,0,0
1392744,15,27,1998,2,"male",258,238,149,0,0,0,0,0,0
1392768,38,6,1975,3,"male",76,15,8,1,0,1,0,0,0
1392774,24,28,1989,9,"female",1643,323,213,741,767,265,388,476,379
1392808,31,18,1982,9,"male",134,10,9,2,1,2,1,0,0
1392820,58,16,1955,3,"female",184,3120,957,3194,3318,79,1870,3115,1448
1392832,21,23,1992,5,"female",607,342,74,45,31,45,30,0,1
1392847,16,31,1997,5,"male",655,196,151,61,19,61,3,0,16
1392864,93,28,1920,2,"male",1560,207,105,1856,1303,55,616,1801,687
1392870,60,21,1953,12,"male",638,21,13,24,29,2,14,22,15
1392875,25,1,1988,1,"male",224,8,7,3,3,3,3,0,0
1392936,19,1,1994,1,"male",259,47,28,0,7,0,6,0,1
1392938,28,3,1985,10,"male",120,0,0,0,0,0,0,0,0
1392950,71,4,1942,3,"female",871,33,8,13,13,0,13,13,0
1392951,60,23,1953,9,"female",1643,60,29,157,38,94,18,63,20
1392965,15,26,1998,12,"female",680,212,127,867,10,867,8,0,2
1392988,21,16,1992,3,"male",503,24,17,1,1,0,0,1,1
1393015,35,5,1978,5,"female",542,27,15,71,86,48,32,23,54
1393023,20,1,1993,10,"male",363,1206,579,567,899,48,381,519,518
1393053,51,12,1962,7,"male",15,12,9,11,16,0,5,11,11
1393064,31,3,1982,4,"male",331,150,125,2,2,0,0,2,2
1393102,62,13,1951,1,"female",278,112,86,73,116,0,35,73,81
1393108,54,29,1959,6,"male",1758,19,10,1,6,1,6,0,0
1393147,42,12,1971,4,"female",364,22,12,130,85,0,2,130,83
1393169,83,6,1930,7,"male",2124,2191,894,30,75,30,68,0,7
1393170,57,20,1956,12,"male",497,59,47,70,13,25,12,45,1
1393176,52,16,1961,5,"female",231,111,68,116,119,1,52,115,67
1393180,33,1,1980,1,"male",1257,33,2,2,1,1,1,1,0
1393187,43,30,1970,6,"male",103,4,1,5,1,5,0,0,1
1393189,52,2,1961,2,"male",390,70,38,0,7,0,4,0,3
1393222,20,10,1993,1,"female",548,609,160,3,128,3,99,0,29
1393234,27,3,1986,5,"female",123,108,69,0,5,0,4,0,1
1393287,67,6,1946,6,"male",466,60,50,0,0,0,0,0,0
1393300,18,3,1995,9,"male",256,14,11,0,0,0,0,0,0
1393311,41,30,1972,9,"female",163,107,93,15,40,15,35,0,5
1393332,34,8,1979,8,"female",405,44,33,1,0,1,0,0,0
1393369,25,5,1988,3,"male",525,14,14,0,0,0,0,0,0
1393407,16,25,1997,9,"female",64,181,140,359,383,359,349,0,34
1393408,26,3,1987,10,"female",381,354,200,3,35,3,29,0,6
1393411,25,8,1988,6,"male",206,38,29,4,1,0,1,4,0
1393420,21,7,1992,4,"male",129,17,17,0,1,0,1,0,0
1393429,108,7,1905,12,"male",1224,95,9,32,5,4,2,28,3
1393462,20,1,1993,1,"male",24,13,13,3,1,3,1,0,0
1393473,22,19,1991,4,"male",618,60,40,0,3,0,2,0,1
1393565,19,6,1994,7,"male",173,280,178,24,23,24,11,0,12
1393575,20,19,1993,9,"male",510,22,13,33,2,2,0,31,2
1393593,58,1,1955,4,"female",441,44,32,0,0,0,0,0,0
1393625,68,29,1945,12,"female",1327,29,7,55,40,1,6,54,34
1393633,17,10,1996,8,"male",912,63,19,0,0,0,0,0,0
1393640,60,6,1953,6,"male",1058,16,8,0,0,0,0,0,0
1393642,35,3,1978,1,"female",518,74,53,4,46,0,32,4,14
1393658,31,8,1982,4,"female",467,60,30,112,35,112,34,0,1
1393671,41,11,1972,2,"female",15,34,1,2,0,2,0,0,0
1393677,25,9,1988,1,"female",281,289,162,122,8,122,6,0,2
1393682,18,28,1995,3,"female",581,3,3,0,0,0,0,0,0
1393700,48,27,1965,8,"female",485,1,1,18,0,0,0,18,0
1393716,28,12,1985,12,"female",204,13,12,229,21,229,17,0,4
1393739,15,20,1998,6,"female",434,349,281,57,120,57,112,0,8
1393853,103,22,1910,5,"male",505,71,59,1,0,1,0,0,0
1393870,46,1,1967,1,"male",617,60,32,129,78,122,25,7,53
1393877,27,12,1986,5,"male",536,174,147,2,0,0,0,2,0
1393886,19,12,1994,7,"female",202,342,148,189,884,189,725,0,159
1393904,19,27,1994,10,"female",586,17,8,1,2,0,1,1,1
1393924,52,12,1961,5,"male",368,31,7,0,0,0,0,0,0
1393929,49,12,1964,5,"female",960,262,90,2515,904,1003,683,1512,221
1393964,35,10,1978,3,"female",218,164,156,96,8,31,3,65,5
1393965,33,7,1980,11,"male",196,95,58,2,0,1,0,1,0
1393974,59,9,1954,11,"male",1154,61,20,8,13,8,13,0,0
1393987,15,2,1998,7,"female",31,46,35,29,17,29,14,0,3
1393998,17,8,1996,3,"male",456,134,87,0,0,0,0,0,0
1394055,37,30,1976,3,"female",161,152,84,741,652,741,514,0,138
1394057,54,3,1959,8,"male",459,224,179,5,1,5,1,0,0
1394061,103,16,1910,3,"male",1471,366,120,123,148,57,86,66,62
1394079,28,26,1985,6,"male",742,1,0,0,0,0,0,0,0
1394092,60,18,1953,7,"female",401,19,10,0,0,0,0,0,0
1394151,70,20,1943,10,"male",1668,18,2,1,4,0,3,1,1
1394167,16,31,1997,12,"male",343,46,34,34,0,34,0,0,0
1394184,63,9,1950,4,"male",1060,37,27,11,4,11,4,0,0
1394204,40,13,1973,10,"male",112,0,0,0,0,0,0,0,0
1394248,23,8,1990,1,"male",375,199,78,0,2,0,1,0,1
1394249,49,4,1964,3,"female",163,69,38,54,30,0,9,54,21
1394266,19,2,1994,12,"female",239,28,22,0,0,0,0,0,0
1394275,16,11,1997,6,"female",38,238,150,111,64,109,35,2,29
1394301,36,7,1977,7,"male",427,14,8,0,0,0,0,0,0
1394302,23,2,1990,2,"male",242,43,32,20,1,0,0,20,1
1394322,80,29,1933,12,"female",268,30,14,0,0,0,0,0,0
1394327,59,7,1954,1,"female",266,14,14,1,0,1,0,0,0
1394335,18,8,1995,10,"male",191,330,141,0,2,0,1,0,1
1394342,77,26,1936,3,"male",954,21,6,25,20,1,6,24,14
1394360,102,17,1911,7,"male",1218,819,585,28,103,28,99,0,4
1394405,28,27,1985,6,"male",467,26,17,0,0,0,0,0,0
1394437,15,26,1998,3,"male",653,488,300,115,9,115,8,0,1
1394440,21,20,1992,7,"male",263,162,135,1,23,1,16,0,7
1394445,16,18,1997,9,"male",220,141,106,12,63,12,29,0,34
1394462,17,10,1996,7,"male",235,226,201,43,0,43,0,0,0
1394473,22,26,1991,1,"female",629,326,210,765,327,463,166,302,161
1394480,50,11,1963,8,"female",626,250,75,295,242,261,193,34,49
1394482,59,10,1954,4,"female",919,74,31,467,221,3,92,464,129
1394552,69,23,1944,1,"female",829,57,42,2,3,0,3,2,0
1394578,18,7,1995,12,"male",271,173,100,143,53,3,21,140,32
1394579,27,22,1986,1,"female",670,400,232,529,440,81,198,448,242
1394618,60,26,1953,1,"male",740,65,16,14,15,14,14,0,1
1394627,22,12,1991,3,"female",429,1393,96,686,1964,434,782,252,1182
1394641,23,24,1990,7,"male",575,1,1,0,0,0,0,0,0
1394652,58,26,1955,10,"female",166,88,65,347,142,0,19,347,123
1394662,30,29,1983,1,"male",23,14,12,63,10,54,8,9,2
1394686,55,23,1958,12,"male",485,90,38,61,40,0,20,61,20
1394695,64,25,1949,8,"male",1638,55,33,8,0,8,0,0,0
1394735,19,2,1994,10,"male",163,4,2,2,0,2,0,0,0
1394738,51,21,1962,9,"female",406,80,34,21,26,21,15,0,11
1394771,32,15,1981,9,"female",386,87,75,618,1007,462,518,156,489
1394783,45,5,1968,7,"female",366,32,22,100,92,100,87,0,5
1394787,31,17,1982,7,"female",50,111,84,6,21,6,14,0,7
1394809,31,23,1982,6,"male",243,289,179,83,3,2,1,81,2
1394810,56,15,1957,2,"male",326,3,1,0,0,0,0,0,0
1394820,16,22,1997,1,"male",197,100,75,1,0,1,0,0,0
1394842,21,28,1992,7,"male",441,579,516,312,240,48,143,264,97
1394892,54,15,1959,3,"female",208,34,25,291,33,0,7,291,26
1394906,23,17,1990,3,"male",264,52,43,0,14,0,14,0,0
1394922,27,28,1986,3,"male",809,161,79,0,2,0,1,0,1
1394924,24,25,1989,11,"male",423,76,20,19,3,19,2,0,1
1394942,18,22,1995,3,"male",593,255,169,0,1,0,1,0,0
1394954,48,6,1965,2,"female",182,7,6,0,0,0,0,0,0
1394971,20,22,1993,8,"male",415,52,4,0,0,0,0,0,0
1394973,31,26,1982,6,"female",585,127,117,149,115,129,80,20,35
1394996,15,2,1998,2,"male",131,93,71,25,14,0,1,25,13
1395046,15,11,1998,8,"female",247,1733,29,427,660,427,603,0,57
1395047,26,12,1987,8,"male",471,198,93,0,0,0,0,0,0
1395062,43,6,1970,6,"male",197,158,88,1,0,1,0,0,0
1395080,44,12,1969,12,"male",908,123,49,48,18,4,1,44,17
1395122,38,26,1975,7,"male",1018,471,217,16,1,3,0,13,1
1395156,21,23,1992,11,"male",1177,110,82,11,0,0,0,11,0
1395173,46,26,1967,10,"male",86,6,5,0,0,0,0,0,0
1395175,32,16,1981,3,"female",1125,129,73,22,14,19,7,3,7
1395209,59,10,1954,6,"female",1082,19,9,0,0,0,0,0,0
1395215,23,1,1990,1,"male",624,94,49,0,1,0,1,0,0
1395242,14,19,1999,1,"female",528,866,391,39,409,3,205,36,204
1395247,39,29,1974,10,"female",516,6,6,14,0,14,0,0,0
1395267,32,6,1981,3,"female",385,231,82,286,7,82,4,204,3
1395274,37,18,1976,3,"male",420,4,0,0,1,0,1,0,0
1395342,23,26,1990,10,"female",379,895,103,319,947,319,773,0,174
1395344,26,7,1987,4,"male",570,84,31,87,175,46,62,41,113
1395361,68,8,1945,2,"male",1382,531,306,17,55,16,40,1,15
1395362,41,15,1972,6,"male",362,120,58,324,60,324,53,0,7
1395395,108,16,1905,1,"male",1039,68,46,330,43,250,37,80,6
1395404,55,29,1958,8,"female",506,137,99,1128,283,1128,228,0,55
1395453,20,27,1993,11,"male",405,195,190,3,0,3,0,0,0
1395458,22,11,1991,3,"male",279,118,112,0,0,0,0,0,0
1395478,31,9,1982,2,"female",551,25,16,1,7,1,6,0,1
1395482,49,10,1964,7,"female",416,83,26,58,35,58,20,0,15
1395499,28,25,1985,12,"male",446,23,19,334,273,129,238,205,35
1395507,18,22,1995,9,"male",296,185,155,0,0,0,0,0,0
1395569,22,5,1991,10,"male",239,162,147,0,0,0,0,0,0
1395571,19,11,1994,10,"female",291,248,215,254,131,253,116,1,15
1395598,27,27,1986,10,"female",772,31,15,1,0,1,0,0,0
1395609,67,23,1946,1,"male",743,20,11,0,0,0,0,0,0
1395613,26,12,1987,6,"male",328,308,206,431,472,431,392,0,80
1395619,30,8,1983,12,"male",217,31,18,17,9,17,9,0,0
1395623,60,10,1953,3,"female",1864,65,35,54,91,52,55,2,36
1395639,24,29,1989,4,"male",594,183,125,3,7,3,4,0,3
1395642,17,22,1996,8,"female",137,184,95,133,404,105,66,28,338
1395647,23,4,1990,5,"male",734,12,4,0,0,0,0,0,0
1395662,73,17,1940,4,"female",349,26,25,0,0,0,0,0,0
1395711,21,18,1992,1,"male",267,98,65,0,1,0,0,0,1
1395716,17,6,1996,10,"male",416,152,100,218,100,217,87,1,13
1395727,52,3,1961,2,"male",576,29,4,0,4,0,2,0,2
1395738,91,10,1922,4,"male",1583,429,246,14,18,5,17,9,1
1395742,19,5,1994,7,"male",387,129,92,0,1,0,1,0,0
1395768,43,31,1970,1,"female",1486,231,116,158,286,140,106,18,180
1395778,15,10,1998,1,"male",970,1216,797,124,610,74,268,50,342
1395786,26,17,1987,10,"male",454,3,2,0,0,0,0,0,0
1395796,23,21,1990,9,"male",457,32,24,0,8,0,6,0,2
1395801,39,7,1974,5,"male",207,48,41,3,17,3,10,0,7
1395804,32,22,1981,11,"male",320,29,21,0,0,0,0,0,0
1395839,43,8,1970,4,"male",36,3,3,0,0,0,0,0,0
1395855,61,11,1952,7,"male",1573,87,59,0,0,0,0,0,0
1395867,33,30,1980,5,"female",1519,224,63,205,32,205,25,0,7
1395874,108,3,1905,11,"male",952,475,341,119,75,111,36,8,39
1395876,21,3,1992,3,"male",353,112,98,0,0,0,0,0,0
1395882,55,6,1958,6,"male",1009,37,8,1,0,0,0,1,0
1395902,15,22,1998,5,"female",434,211,117,431,375,363,93,68,282
1395930,19,12,1994,5,"female",586,1159,810,2,0,2,0,0,0
1395944,53,24,1960,3,"male",595,357,278,123,65,120,57,3,8
1395977,98,10,1915,2,"male",1484,204,83,14,32,14,29,0,3
1395990,20,10,1993,5,"female",184,1,0,0,0,0,0,0,0
1396004,60,5,1953,10,"female",450,84,38,522,41,0,2,522,39
1396028,30,3,1983,3,"female",665,61,25,70,5,70,5,0,0
1396058,29,23,1984,11,"male",702,2,2,12,8,0,2,12,6
1396074,29,8,1984,12,"female",462,30,18,0,0,0,0,0,0
1396111,108,6,1905,8,"female",2238,317,160,317,125,316,107,1,18
1396112,24,3,1989,6,"male",232,92,47,361,81,361,42,0,39
1396176,18,25,1995,3,"male",296,85,57,0,1,0,1,0,0
1396212,21,5,1992,1,"male",286,212,170,1,3,1,3,0,0
1396239,22,21,1991,10,"female",458,237,206,191,150,2,40,189,110
1396249,54,7,1959,1,"female",284,59,42,60,17,3,5,57,12
1396325,18,29,1995,1,"male",345,146,100,1999,345,1999,327,0,18
1396358,87,4,1926,7,"male",1621,1759,1153,437,198,317,170,120,28
1396394,19,17,1994,6,"female",242,694,213,278,469,278,371,0,98
1396396,72,21,1941,8,"female",1144,65,39,226,119,0,59,226,60
1396405,21,2,1992,10,"female",535,0,0,0,0,0,0,0,0
1396408,27,27,1986,1,"male",158,14,9,156,32,44,11,112,21
1396427,20,3,1993,12,"male",360,398,280,11,3,0,1,11,2
1396444,28,6,1985,1,"male",539,35,23,13,0,8,0,5,0
1396450,17,26,1996,12,"female",39,1,1,6,2,6,2,0,0
1396485,103,6,1910,9,"female",696,1938,358,17,147,17,111,0,36
1396502,37,20,1976,10,"female",74,19,11,86,69,86,65,0,4
1396576,23,1,1990,1,"female",293,20,7,0,0,0,0,0,0
1396578,99,7,1914,4,"female",745,307,142,13,6,13,6,0,0
1396587,15,3,1998,5,"female",345,892,620,87,370,48,273,39,97
1396599,15,1,1998,2,"male",205,1102,705,3514,2344,1127,1183,2387,1161
1396608,22,1,1991,3,"male",232,45,37,1,0,1,0,0,0
1396610,35,13,1978,12,"female",744,204,127,239,175,239,162,0,13
1396617,20,12,1993,8,"female",539,19,13,27,21,3,14,24,7
1396628,57,13,1956,6,"female",1651,65,30,84,31,84,24,0,7
1396632,34,12,1979,2,"male",443,249,213,19,19,0,5,19,14
1396648,19,8,1994,10,"male",239,38,20,0,2,0,1,0,1
1396674,107,13,1906,2,"male",9,22,16,104,32,0,26,104,6
1396679,75,24,1938,9,"female",1250,28,16,29,30,0,9,29,21
1396693,16,28,1997,12,"male",549,484,330,0,0,0,0,0,0
1396709,47,29,1966,5,"female",151,24,12,121,4,121,3,0,1
1396710,24,6,1989,7,"female",298,286,31,2,5,2,5,0,0
1396733,16,20,1997,8,"female",283,135,95,151,21,143,15,8,6
1396760,16,19,1997,8,"female",617,1406,782,1565,665,600,317,965,348
1396764,15,3,1998,1,"male",95,49,45,2,0,2,0,0,0
1396847,19,24,1994,4,"male",709,2180,1506,15,539,15,424,0,115
1396874,59,24,1954,4,"female",214,14,13,12,1,12,1,0,0
1396903,25,1,1988,1,"male",148,51,40,0,0,0,0,0,0
1396970,34,29,1979,1,"male",339,31,12,1,2,1,1,0,1
1396975,58,11,1955,3,"female",1453,229,183,311,276,44,171,267,105
1396978,50,20,1963,9,"female",163,240,107,1866,2395,47,1464,1819,931
1396981,100,27,1913,10,"female",1227,1077,347,1550,1098,1550,887,0,211
1396987,62,25,1951,3,"male",227,41,24,49,6,0,1,49,5
1396996,61,9,1952,2,"male",196,34,28,37,22,0,3,37,19
1397003,31,20,1982,1,"male",233,109,89,1,0,1,0,0,0
1397007,103,21,1910,3,"female",1791,143,71,653,22,0,9,653,13
1397024,17,2,1996,2,"male",405,13,13,3,0,0,0,3,0
1397041,21,2,1992,2,"female",372,254,170,1,1,1,1,0,0
1397048,20,14,1993,5,"male",264,133,124,8,0,1,0,7,0
1397053,15,24,1998,4,"male",525,327,227,0,0,0,0,0,0
1397060,22,1,1991,3,"male",648,50,24,67,3,1,2,66,1
1397067,25,21,1988,2,"female",445,92,30,257,71,257,19,0,52
1397087,42,8,1971,10,"female",447,60,19,86,49,86,36,0,13
1397130,19,23,1994,12,"male",62,77,65,132,143,120,84,12,59
1397141,43,29,1970,9,"female",518,8,4,0,0,0,0,0,0
1397144,57,19,1956,11,"female",1347,34,21,5,7,4,6,1,1
1397167,53,9,1960,1,"female",1078,129,87,730,248,730,114,0,134
1397169,108,4,1905,11,"female",1311,26,14,99,23,99,21,0,2
1397180,28,1,1985,10,"female",517,24,10,2,2,0,0,2,2
1397193,53,1,1960,2,"male",929,39,28,31,18,9,10,22,8
1397197,26,22,1987,5,"female",1093,399,75,125,158,125,131,0,27
1397217,24,8,1989,6,"male",35,4,2,0,0,0,0,0,0
1397219,17,26,1996,2,"male",504,63,34,1,1,1,1,0,0
1397224,48,23,1965,5,"female",4,55,34,96,53,96,25,0,28
1397233,28,5,1985,5,"female",522,263,224,36,148,9,118,27,30
1397272,24,15,1989,5,"male",282,158,133,0,16,0,6,0,10
1397314,32,11,1981,3,"male",344,1,1,0,0,0,0,0,0
1397322,26,28,1987,9,"female",101,13,10,0,7,0,5,0,2
1397326,17,13,1996,12,"female",251,435,344,981,790,633,474,348,316
1397328,22,8,1991,12,"male",676,209,79,53,11,1,5,52,6
1397353,51,22,1962,6,"male",357,65,42,4,3,4,3,0,0
1397363,30,9,1983,1,"male",475,131,21,196,76,189,75,7,1
1397367,18,6,1995,2,"male",39,172,163,77,4,77,4,0,0
1397389,25,21,1988,8,"male",292,134,121,0,0,0,0,0,0
1397393,16,16,1997,5,"female",472,658,403,352,602,333,463,19,139
1397399,60,23,1953,8,"female",608,38,25,27,22,27,22,0,0
1397402,89,29,1924,4,"female",2318,368,234,281,166,246,123,35,43
1397403,14,27,1999,9,"female",171,189,64,41,69,41,65,0,4
1397407,28,10,1985,11,"female",4,0,0,2,1,2,0,0,1
1397429,25,1,1988,1,"female",126,1,1,0,0,0,0,0,0
1397432,23,12,1990,5,"female",164,183,27,2,66,2,61,0,5
1397458,21,7,1992,4,"male",303,24,10,1,0,1,0,0,0
1397462,44,11,1969,1,"male",231,795,682,80,16,23,4,57,12
1397463,19,13,1994,2,"male",316,2,0,5,2,5,2,0,0
1397467,27,15,1986,5,"female",203,31,21,0,0,0,0,0,0
1397476,49,21,1964,12,"male",963,316,226,2,2,0,1,2,1
1397485,17,8,1996,2,"male",171,22,19,1,1,1,1,0,0
1397508,27,17,1986,2,"female",242,169,129,330,1893,0,794,330,1099
1397510,21,9,1992,8,"female",859,138,69,44,157,24,106,20,51
1397543,49,22,1964,10,"male",1075,1,1,0,0,0,0,0,0
1397569,19,1,1994,11,"male",749,94,80,7,0,4,0,3,0
1397578,52,6,1961,1,"male",1834,96,39,63,37,36,12,27,25
1397587,71,4,1942,8,"female",1149,45,29,3,41,0,29,3,12
1397604,52,9,1961,6,"male",929,79,32,0,0,0,0,0,0
1397643,23,20,1990,6,"female",434,354,193,286,619,245,316,41,303
1397649,26,3,1987,3,"female",85,541,402,332,689,294,230,38,459
1397676,20,7,1993,5,"male",313,0,0,0,0,0,0,0,0
1397700,28,14,1985,5,"male",562,73,52,44,10,44,6,0,4
1397704,18,13,1995,5,"male",584,203,146,1,6,1,3,0,3
1397705,34,31,1979,8,"female",472,265,67,11,8,11,6,0,2
1397716,33,3,1980,2,"female",445,98,20,107,320,107,256,0,64
1397722,24,3,1989,9,"female",674,143,80,108,54,108,35,0,19
1397743,25,4,1988,9,"female",644,13,9,1,2,1,1,0,1
1397801,17,31,1996,7,"female",352,1047,411,10489,8515,10316,7343,173,1172
1397813,26,16,1987,8,"male",120,80,71,28,57,28,30,0,27
1397815,14,17,1999,5,"female",454,462,224,567,370,56,210,511,160
1397833,15,3,1998,8,"female",522,559,226,502,1348,123,248,379,1100
1397854,33,27,1980,10,"male",643,54,19,3,23,3,3,0,20
1397860,18,5,1995,6,"female",218,510,313,177,139,74,106,103,33
1397877,41,26,1972,10,"female",184,53,47,70,25,55,2,15,23
1397937,35,17,1978,8,"female",749,1898,305,80,229,52,170,28,59
1397953,23,30,1990,10,"female",213,147,146,0,0,0,0,0,0
1397985,23,3,1990,3,"female",605,28,23,2,5,0,2,2,3
1398004,50,20,1963,3,"male",1145,342,245,17,18,17,11,0,7
1398053,28,11,1985,11,"female",362,66,43,3,3,1,2,2,1
1398063,28,1,1985,1,"male",272,77,55,0,3,0,3,0,0
1398066,46,11,1967,1,"male",1135,31,13,0,0,0,0,0,0
1398084,35,3,1978,9,"female",519,128,104,212,149,14,91,198,58
1398089,61,9,1952,6,"male",259,166,90,3947,913,0,143,3947,770
1398094,43,18,1970,7,"female",305,28,18,1324,1028,128,87,1196,941
1398096,24,9,1989,9,"female",371,72,27,1,1,1,1,0,0
1398103,54,24,1959,6,"female",268,43,33,337,59,337,41,0,18
1398118,50,17,1963,7,"female",1880,682,490,149,91,146,64,3,27
1398135,49,15,1964,4,"male",240,53,38,6,3,4,2,2,1
1398154,16,4,1997,11,"female",24,24,16,4,6,4,6,0,0
1398204,15,12,1998,2,"male",616,147,111,1,0,0,0,1,0
1398229,19,28,1994,10,"male",429,96,72,490,198,440,184,50,14
1398234,68,20,1945,4,"male",33,1,0,0,0,0,0,0,0
1398246,23,19,1990,7,"female",93,173,117,341,293,161,77,180,216
1398251,32,2,1981,3,"male",248,153,134,67,24,67,17,0,7
1398266,58,18,1955,4,"female",224,38,31,145,46,0,28,145,18
1398268,52,12,1961,4,"male",490,200,18,143,38,143,16,0,22
1398289,24,13,1989,2,"female",5,1,1,18,4,0,2,18,2
1398290,19,25,1994,3,"male",267,620,571,1,5,1,5,0,0
1398301,31,17,1982,9,"female",398,235,191,38,117,28,20,10,97
1398323,25,7,1988,5,"female",255,204,133,9,65,0,8,9,57
1398351,17,22,1996,4,"male",567,78,14,5,0,5,0,0,0
1398363,27,26,1986,11,"female",332,25,10,0,1,0,1,0,0
1398389,21,26,1992,9,"male",211,25,10,7,0,7,0,0,0
1398421,18,1,1995,1,"male",383,70,62,151,84,95,18,56,66
1398448,25,1,1988,10,"male",100,14,11,16,23,16,5,0,18
1398460,51,20,1962,5,"female",184,49,34,51,1,51,1,0,0
1398461,27,8,1986,1,"male",80,50,45,0,0,0,0,0,0
1398493,40,23,1973,4,"female",376,95,39,20,212,19,52,1,160
1398516,76,26,1937,1,"female",675,40,24,244,16,244,11,0,5
1398559,20,14,1993,3,"male",473,43,18,33,10,33,2,0,8
1398565,15,22,1998,7,"male",468,99,78,6,4,6,2,0,2
1398603,41,20,1972,3,"male",213,20,13,11,6,11,5,0,1
1398625,108,21,1905,12,"female",923,152,120,59,32,11,15,48,17
1398638,46,22,1967,1,"male",153,25,16,28,0,28,0,0,0
1398646,15,8,1998,5,"female",163,183,167,4,3,4,2,0,1
1398656,37,1,1976,1,"male",174,23,14,5,4,5,4,0,0
1398660,64,4,1949,9,"female",1252,12,7,1,0,0,0,1,0
1398661,23,1,1990,6,"male",13,77,71,2,4,2,1,0,3
1398677,17,18,1996,11,"female",86,59,29,2,21,2,16,0,5
1398689,37,27,1976,11,"female",647,89,62,11,306,11,256,0,50
1398712,28,7,1985,6,"male",224,0,0,0,0,0,0,0,0
1398723,110,4,1903,10,"male",1311,243,203,21,28,8,15,13,13
1398724,15,5,1998,8,"male",94,4,1,3,2,0,1,3,1
1398730,24,26,1989,10,"female",282,40,27,10,11,10,5,0,6
1398734,32,29,1981,4,"male",333,80,60,4,4,3,3,1,1
1398768,23,2,1990,2,"male",343,277,211,1449,1174,305,378,1144,796
1398783,41,10,1972,3,"male",654,125,78,11,30,0,17,11,13
1398802,30,21,1983,9,"male",225,140,96,0,3,0,3,0,0
1398813,55,8,1958,11,"male",668,34,30,0,0,0,0,0,0
1398833,39,13,1974,5,"male",132,40,36,43,2,43,2,0,0
1398882,23,10,1990,9,"female",393,7,5,0,0,0,0,0,0
1398915,42,10,1971,1,"male",937,42,21,170,188,126,163,44,25
1398917,46,11,1967,1,"male",418,57,51,37,35,1,4,36,31
1398937,32,1,1981,1,"male",668,55,48,12,0,12,0,0,0
1398981,57,2,1956,10,"male",1222,126,67,4,3,3,1,1,2
1398987,20,9,1993,2,"male",481,119,46,4,5,4,3,0,2
1399086,57,29,1956,2,"male",1198,69,36,29,17,29,17,0,0
1399117,16,11,1997,5,"male",489,78,57,10,9,10,5,0,4
1399121,42,22,1971,4,"male",472,19,10,3,2,3,1,0,1
1399142,13,16,2000,7,"male",48,300,283,9,0,0,0,9,0
1399144,21,7,1992,8,"male",236,81,28,0,1,0,0,0,1
1399155,14,9,1999,7,"female",473,230,53,23,4,23,4,0,0
1399181,46,1,1967,6,"male",251,7,6,0,0,0,0,0,0
1399190,40,13,1973,1,"female",289,67,50,44,6,0,5,44,1
1399217,56,1,1957,1,"male",379,23,9,0,0,0,0,0,0
1399233,51,15,1962,8,"male",1592,186,77,65,25,65,10,0,15
1399252,25,5,1988,5,"female",479,599,551,0,0,0,0,0,0
1399260,14,16,1999,5,"male",168,53,30,0,0,0,0,0,0
1399262,20,26,1993,1,"male",230,92,56,7,10,7,8,0,2
1399273,53,2,1960,10,"male",807,32,18,0,0,0,0,0,0
1399314,37,22,1976,7,"female",910,418,267,0,0,0,0,0,0
1399331,55,28,1958,11,"female",500,53,37,1,14,0,5,1,9
1399333,35,27,1978,5,"male",64,32,23,1,0,1,0,0,0
1399355,108,1,1905,4,"female",1892,24,15,0,2,0,2,0,0
1399360,18,30,1995,3,"male",80,251,194,63,508,63,305,0,203
1399384,55,8,1958,10,"female",804,55,33,74,17,2,4,72,13
1399392,28,19,1985,2,"male",302,4,3,0,0,0,0,0,0
1399406,26,1,1987,1,"female",173,186,162,193,203,141,175,52,28
1399437,27,10,1986,12,"male",405,231,110,9,22,2,11,7,11
1399439,20,1,1993,12,"male",268,1155,392,183,247,183,190,0,57
1399450,56,2,1957,5,"male",266,34,17,0,0,0,0,0,0
1399459,19,23,1994,6,"male",547,101,49,865,3,103,0,762,3
1399475,18,12,1995,8,"male",94,94,43,215,6,159,2,56,4
1399497,30,10,1983,10,"male",1388,395,142,68,2099,17,847,51,1252
1399523,42,20,1971,6,"female",440,50,16,3,1,3,1,0,0
1399551,54,12,1959,3,"male",181,39,14,0,0,0,0,0,0
1399588,25,18,1988,9,"female",801,271,207,2,1,1,0,1,1
1399596,19,22,1994,2,"male",330,243,97,3,42,3,32,0,10
1399597,20,3,1993,12,"female",520,11,3,16,0,8,0,8,0
1399607,46,11,1967,7,"male",723,21,7,0,4,0,3,0,1
1399644,20,5,1993,3,"male",474,121,77,0,2,0,0,0,2
1399647,61,27,1952,8,"female",667,11,5,1,0,0,0,1,0
1399712,23,28,1990,4,"male",511,527,466,3,14,1,4,2,10
1399721,47,22,1966,7,"male",278,77,62,0,3,0,3,0,0
1399753,15,22,1998,8,"male",123,48,40,16,22,13,17,3,5
1399782,32,10,1981,12,"male",92,26,24,1,0,1,0,0,0
1399804,27,29,1986,1,"male",587,996,919,0,20,0,11,0,9
1399818,53,1,1960,1,"male",110,15,8,110,41,110,32,0,9
1399828,37,20,1976,9,"male",365,48,36,44,8,37,8,7,0
1399845,58,26,1955,7,"male",814,80,21,15,6,15,6,0,0
1399855,21,30,1992,6,"female",244,125,76,2,0,2,0,0,0
1399863,23,4,1990,11,"male",263,68,54,1,7,0,2,1,5
1399888,60,10,1953,4,"female",508,146,93,1315,206,0,38,1315,168
1399898,19,28,1994,6,"female",129,4181,27,31,673,26,583,5,90
1399923,42,16,1971,10,"male",89,46,37,15,11,15,11,0,0
1399947,61,21,1952,6,"male",522,50,42,136,3,0,2,136,1
1399960,18,26,1995,7,"female",171,511,213,7,46,5,9,2,37
1399963,108,15,1905,9,"male",967,480,231,4,7,0,1,4,6
1399982,33,27,1980,6,"male",142,257,227,24,58,24,46,0,12
1400003,20,11,1993,11,"male",23,40,29,4,8,0,2,4,6
1400005,22,12,1991,10,"female",673,775,465,21,242,21,192,0,50
1400021,18,18,1995,12,"male",401,53,33,7,7,7,6,0,1
1400064,21,28,1992,3,"male",146,82,25,35,50,35,31,0,19
1400099,14,10,1999,12,"male",222,230,142,16,6,7,1,9,5
1400126,58,25,1955,5,"female",1282,32,20,235,3,0,2,235,1
1400181,108,7,1905,8,"female",816,263,153,292,41,0,15,292,26
1400188,55,15,1958,8,"female",691,131,91,79,33,79,11,0,22
1400204,53,23,1960,6,"male",238,332,262,31,5,31,0,0,5
1400214,92,26,1921,5,"male",125,102,95,10,32,10,9,0,23
1400251,17,21,1996,12,"male",847,374,150,0,1,0,1,0,0
1400262,28,1,1985,1,"male",15,8,4,8,4,8,3,0,1
1400274,43,10,1970,3,"female",1775,524,246,618,445,618,297,0,148
1400314,21,2,1992,2,"male",149,240,224,47,36,47,34,0,2
1400320,18,1,1995,1,"male",328,238,150,1,2,1,1,0,1
1400334,55,23,1958,11,"female",602,57,41,52,96,52,41,0,55
1400342,26,30,1987,1,"female",466,97,43,9,40,8,12,1,28
1400352,49,7,1964,10,"male",193,1,1,1,0,0,0,1,0
1400364,59,18,1954,7,"male",89,18,11,4,8,0,1,4,7
1400369,20,29,1993,9,"male",68,185,183,11,0,11,0,0,0
1400380,23,1,1990,1,"male",215,39,30,1,1,0,0,1,1
1400417,19,6,1994,8,"female",373,147,86,44,36,44,19,0,17
1400445,27,28,1986,11,"female",819,219,72,48,111,37,57,11,54
1400494,76,20,1937,6,"female",10,77,60,40,66,33,12,7,54
1400495,68,26,1945,6,"female",327,9,2,6,2,0,1,6,1
1400499,27,31,1986,5,"male",345,123,45,917,132,0,91,917,41
1400514,18,29,1995,4,"male",489,352,281,84,29,42,23,42,6
1400566,89,24,1924,3,NA,1832,103,23,52,0,0,0,52,0
1400578,33,1,1980,1,"male",286,130,103,23,24,0,2,23,22
1400614,61,14,1952,4,"female",589,22,10,8,8,8,8,0,0
1400616,25,9,1988,5,"female",643,245,176,352,495,242,215,110,280
1400638,57,2,1956,2,"male",538,25,24,9,0,9,0,0,0
1400640,35,17,1978,10,"male",268,47,39,77,5,77,5,0,0
1400660,21,27,1992,12,"male",361,5,1,0,3,0,0,0,3
1400674,13,3,2000,4,"female",210,80,61,3,7,3,4,0,3
1400678,29,25,1984,10,"male",830,116,96,49,9,49,8,0,1
1400681,67,7,1946,4,"female",521,261,233,597,70,0,9,597,61
1400702,24,15,1989,5,"female",639,296,66,4,12,4,10,0,2
1400749,24,1,1989,1,"male",7,3,3,1,0,1,0,0,0
1400753,19,9,1994,3,"male",925,674,291,0,3,0,3,0,0
1400761,22,22,1991,6,"male",563,161,74,6,15,5,4,1,11
1400787,50,27,1963,10,"male",1566,86,25,33,12,33,5,0,7
1400814,17,12,1996,2,"male",238,78,30,28,47,28,45,0,2
1400815,20,5,1993,8,"female",292,278,121,100,86,100,60,0,26
1400816,41,3,1972,4,"female",154,33,20,11,36,10,15,1,21
1400821,46,7,1967,1,"male",300,55,49,71,1,71,1,0,0
1400829,54,28,1959,12,"female",496,76,47,305,81,21,28,284,53
1400888,61,1,1952,6,"female",1735,76,38,35,72,29,31,6,41
1400908,28,15,1985,12,"male",367,64,52,1,0,1,0,0,0
1400934,65,22,1948,11,"male",187,38,25,46,2,0,1,46,1
1401011,102,11,1911,11,"female",465,29,23,14,22,6,18,8,4
1401016,20,21,1993,10,"male",493,1342,412,896,825,831,423,65,402
1401034,39,15,1974,11,"female",642,20,14,52,55,49,41,3,14
1401038,14,14,1999,2,"female",360,1196,832,851,499,851,432,0,67
1401045,26,15,1987,3,"male",438,55,15,27,2,27,2,0,0
1401064,26,25,1987,7,"male",293,143,46,86,69,86,31,0,38
1401075,31,25,1982,7,"male",256,54,31,0,0,0,0,0,0
1401088,23,1,1990,1,"male",689,498,441,362,49,362,49,0,0
1401101,17,11,1996,11,"male",304,93,83,0,17,0,10,0,7
1401126,18,31,1995,10,"male",460,1,0,0,0,0,0,0,0
1401195,59,4,1954,8,"male",635,17,1,2,17,1,7,1,10
1401196,18,15,1995,5,"female",433,419,141,3783,1065,296,289,3487,776
1401225,50,4,1963,4,"female",634,87,64,22,10,22,5,0,5
1401280,50,5,1963,10,"female",556,68,57,14,34,14,27,0,7
1401291,56,15,1957,11,"female",2074,297,202,179,91,0,50,179,41
1401298,29,14,1984,5,"male",178,78,57,2,5,2,5,0,0
1401313,34,5,1979,12,"male",745,5,2,0,0,0,0,0,0
1401345,18,6,1995,6,"male",194,16,10,1,1,1,1,0,0
1401348,30,15,1983,9,"female",263,14,11,5,1,0,0,5,1
1401367,23,8,1990,5,"male",253,174,158,60,48,60,45,0,3
1401397,33,4,1980,12,"male",160,5,2,10,4,8,2,2,2
1401413,31,21,1982,3,"male",316,7,5,0,1,0,0,0,1
1401418,28,4,1985,8,"female",635,142,52,0,0,0,0,0,0
1401430,17,16,1996,6,"female",169,222,115,3,1,3,1,0,0
1401445,56,7,1957,9,"female",207,14,7,56,14,0,3,56,11
1401449,65,8,1948,6,"male",1577,48,28,16,30,16,28,0,2
1401456,44,17,1969,12,"male",168,22,10,4,0,4,0,0,0
1401464,26,27,1987,4,"female",95,2,0,9,0,9,0,0,0
1401473,23,30,1990,6,"female",341,185,127,195,49,4,26,191,23
1401475,19,4,1994,8,"female",160,9,6,1,0,1,0,0,0
1401487,23,17,1990,10,"male",600,149,125,0,0,0,0,0,0
1401489,18,3,1995,10,"male",16,2,0,0,0,0,0,0,0
1401509,22,7,1991,5,"female",452,11,10,13,0,0,0,13,0
1401513,23,11,1990,7,"female",220,24,15,20,1,0,0,20,1
1401515,51,24,1962,6,"male",453,64,39,0,0,0,0,0,0
1401560,27,10,1986,7,"male",177,5,3,5,0,5,0,0,0
1401639,22,4,1991,7,"female",237,1,1,2,0,2,0,0,0
1401644,24,2,1989,2,"male",498,58,22,0,13,0,13,0,0
1401648,23,15,1990,12,"male",332,299,197,20,28,16,19,4,9
1401679,24,30,1989,6,"female",203,30,24,0,0,0,0,0,0
1401681,24,22,1989,3,"male",297,11,10,1,0,0,0,1,0
1401686,23,30,1990,10,"male",536,665,337,23,139,20,54,3,85
1401688,15,27,1998,1,"male",303,578,336,309,197,268,147,41,50
1401710,24,25,1989,12,"male",185,13,10,49,22,49,21,0,1
1401724,22,16,1991,7,"female",521,62,51,24,17,24,5,0,12
1401742,23,2,1990,11,"male",69,62,38,5,13,0,1,5,12
1401744,14,12,1999,4,"male",278,79,60,0,1,0,0,0,1
1401759,17,10,1996,12,"male",108,21,13,15,5,14,5,1,0
1401763,42,5,1971,6,"female",19,19,14,0,0,0,0,0,0
1401769,16,15,1997,5,"female",820,25,7,66,21,0,12,66,9
1401786,21,9,1992,3,"female",383,270,129,65,24,60,20,5,4
1401837,25,19,1988,3,"female",1683,287,97,2004,1125,1251,701,753,424
1401838,16,5,1997,7,"female",491,3357,1842,1414,1529,727,1037,687,492
1401840,18,1,1995,1,"male",180,172,139,952,190,952,185,0,5
1401884,22,1,1991,1,"male",246,363,272,28,0,28,0,0,0
1401939,52,2,1961,7,"female",1363,195,90,220,123,220,65,0,58
1401959,20,8,1993,6,"male",428,156,120,4,1,1,0,3,1
1401988,23,1,1990,1,"male",369,16,11,4,4,4,4,0,0
1402000,25,16,1988,4,"male",1394,574,367,32,86,27,68,5,18
1402011,22,14,1991,9,"male",465,123,55,1,8,0,8,1,0
1402014,58,31,1955,10,"male",1057,2786,2092,114,304,114,294,0,10
1402036,56,8,1957,1,"female",338,49,27,164,200,0,84,164,116
1402057,39,2,1974,12,"male",261,69,66,22,1,22,1,0,0
1402068,23,24,1990,10,"male",887,107,88,0,6,0,5,0,1
1402078,63,27,1950,9,"male",1754,121,54,178,220,8,104,170,116
1402080,58,28,1955,7,"female",1851,55,23,41,51,27,16,14,35
1402089,28,14,1985,8,"male",455,18,16,54,5,54,3,0,2
1402105,31,22,1982,4,"male",752,37,20,20,10,20,9,0,1
1402117,37,6,1976,2,"female",423,1,1,0,0,0,0,0,0
1402119,17,13,1996,9,"male",931,29,17,16,18,10,9,6,9
1402121,83,28,1930,11,"male",1028,718,507,212,142,211,93,1,49
1402140,26,27,1987,6,"female",117,26,13,0,0,0,0,0,0
1402157,20,17,1993,12,"male",790,1129,616,903,374,903,344,0,30
1402163,38,1,1975,1,"male",484,75,37,2,1,2,1,0,0
1402177,19,11,1994,1,"female",741,329,148,35,74,35,54,0,20
1402181,90,30,1923,3,"female",2098,474,251,127,183,111,87,16,96
1402199,17,13,1996,9,"female",141,95,81,79,39,4,19,75,20
1402200,51,27,1962,8,"female",90,25,19,33,11,33,9,0,2
1402213,22,13,1991,8,"female",185,26,14,1,0,1,0,0,0
1402223,28,12,1985,8,"female",110,41,22,3,3,2,3,1,0
1402236,19,27,1994,8,"male",268,6,3,0,10,0,10,0,0
1402274,52,22,1961,2,"female",230,14,12,3,1,0,0,3,1
1402286,69,24,1944,7,"male",1024,42,9,10,4,0,0,10,4
1402313,36,15,1977,8,"male",58,9,9,0,0,0,0,0,0
1402315,15,16,1998,5,"female",130,1,0,1,0,1,0,0,0
1402317,18,4,1995,6,"male",185,132,123,96,88,82,25,14,63
1402332,26,30,1987,12,"male",931,135,92,6,34,5,21,1,13
1402333,19,6,1994,1,"male",564,623,522,9,3,9,2,0,1
1402358,16,3,1997,1,"female",59,20,19,0,13,0,9,0,4
1402368,48,14,1965,2,"male",55,47,46,38,17,38,7,0,10
1402373,20,2,1993,3,"male",202,406,375,0,0,0,0,0,0
1402380,18,11,1995,1,"male",355,433,295,7,3,7,3,0,0
1402407,44,22,1969,2,"male",1425,41,31,61,98,61,67,0,31
1402414,108,1,1905,2,"female",175,53,30,5,4,5,2,0,2
1402440,17,14,1996,7,"male",453,20,8,0,2,0,0,0,2
1402443,19,11,1994,1,"male",301,247,89,84,85,71,46,13,39
1402450,55,5,1958,1,"female",1156,225,143,605,754,601,443,4,311
1402473,20,6,1993,8,"male",431,170,138,144,9,144,6,0,3
1402487,50,13,1963,4,"male",291,59,31,1,10,0,6,1,4
1402488,37,29,1976,8,"female",255,17,6,53,6,18,1,35,5
1402504,32,19,1981,4,"male",728,51,25,0,0,0,0,0,0
1402535,51,13,1962,9,"female",1397,168,93,991,551,712,385,279,166
1402541,52,8,1961,9,"female",635,14,12,4,0,4,0,0,0
1402579,23,20,1990,7,"male",722,536,381,151,0,127,0,24,0
1402580,18,20,1995,6,"female",462,267,45,2,164,2,126,0,38
1402608,26,26,1987,12,"male",914,472,329,1,1,1,1,0,0
1402613,31,22,1982,10,"male",283,175,119,32,12,32,10,0,2
1402675,35,5,1978,5,"female",479,30,13,5,2,5,1,0,1
1402703,61,9,1952,6,"male",156,34,14,29,42,0,12,29,30
1402731,31,18,1982,8,"female",150,29,22,50,31,50,21,0,10
1402733,20,18,1993,12,"female",723,1389,434,14,22,14,19,0,3
1402742,15,26,1998,7,"female",408,589,219,2,9,0,3,2,6
1402767,95,26,1918,3,"male",72,30,25,38,79,0,53,38,26
1402770,21,6,1992,5,"female",299,34,8,23,16,23,15,0,1
1402773,21,1,1992,1,"female",70,78,60,17,71,17,68,0,3
1402778,63,21,1950,12,"male",931,41,15,5,0,0,0,5,0
1402814,31,1,1982,1,"female",19,1,1,4,6,0,2,4,4
1402820,30,13,1983,2,"male",532,9,6,11,16,11,14,0,2
1402839,25,20,1988,4,"female",555,52,30,19,9,19,1,0,8
1402877,18,27,1995,3,"female",877,610,477,16,12,16,12,0,0
1402899,18,12,1995,10,"male",416,229,168,3,1,3,1,0,0
1402929,31,28,1982,2,"female",1720,645,368,481,853,177,683,304,170
1402930,51,24,1962,1,"male",349,207,69,33,9,26,7,7,2
1402962,18,27,1995,7,"male",344,173,72,7,0,7,0,0,0
1402965,27,18,1986,11,"female",544,79,51,0,1,0,0,0,1
1402973,26,1,1987,1,"male",36,25,24,1,0,1,0,0,0
1402975,56,2,1957,5,"female",1352,97,60,108,261,65,197,43,64
1402978,23,15,1990,7,"female",143,62,40,92,6,89,5,3,1
1402989,36,8,1977,8,"male",603,82,45,0,0,0,0,0,0
1403018,14,8,1999,5,"male",203,598,421,70,54,70,50,0,4
1403021,31,22,1982,8,"male",347,95,76,4,0,4,0,0,0
1403025,19,22,1994,12,"female",816,217,112,139,232,86,117,53,115
1403037,50,7,1963,10,"female",153,110,53,241,267,125,120,116,147
1403056,30,30,1983,7,"male",168,97,91,63,15,63,15,0,0
1403061,22,19,1991,1,"male",312,6,6,0,0,0,0,0,0
1403063,81,22,1932,8,"female",1416,271,185,1186,467,0,187,1186,280
1403074,16,27,1997,12,"male",438,181,139,0,1,0,0,0,1
1403081,48,28,1965,2,"male",368,44,31,1,2,0,1,1,1
1403104,89,8,1924,9,"female",1439,72,34,13,4,0,1,13,3
1403130,22,13,1991,5,"male",108,18,16,0,0,0,0,0,0
1403146,55,5,1958,11,"male",1883,185,112,0,0,0,0,0,0
1403185,20,25,1993,11,"male",735,41,31,3,0,0,0,3,0
1403195,40,25,1973,1,"male",312,27,2,2,0,2,0,0,0
1403198,34,6,1979,12,"male",607,18,12,92,8,92,8,0,0
1403208,27,15,1986,11,"female",291,146,124,0,0,0,0,0,0
1403224,23,21,1990,5,"female",195,121,55,2,3,0,2,2,1
1403261,13,16,2000,5,"male",101,8,6,1,2,1,2,0,0
1403315,27,28,1986,3,"male",530,1,1,0,0,0,0,0,0
1403322,24,12,1989,8,"male",183,189,96,1,3,1,2,0,1
1403336,14,28,1999,8,"female",194,114,88,64,21,64,9,0,12
1403404,17,16,1996,2,"male",1553,1167,425,22,15,1,9,21,6
1403408,23,7,1990,7,"male",4,20,14,1,1,1,1,0,0
1403427,24,4,1989,3,"male",619,125,63,9,17,0,11,9,6
1403429,59,25,1954,7,"female",53,61,58,42,31,3,12,39,19
1403446,108,1,1905,1,"female",891,22,12,0,0,0,0,0,0
1403454,26,7,1987,5,"male",97,42,36,0,2,0,2,0,0
1403460,18,21,1995,12,"male",354,42,23,2747,5,28,0,2719,5
1403479,50,15,1963,5,"male",1871,52,21,0,4,0,0,0,4
1403507,36,9,1977,4,"male",271,154,112,19,0,19,0,0,0
1403533,14,4,1999,11,"male",247,69,60,8,7,0,3,8,4
1403541,55,24,1958,6,"female",2061,198,62,134,76,55,59,79,17
1403547,71,1,1942,3,"male",196,301,236,1,3,1,0,0,3
1403558,19,3,1994,1,"male",433,136,91,1,53,1,5,0,48
1403559,18,5,1995,5,"male",295,67,60,1,1,1,1,0,0
1403564,14,6,1999,11,"male",196,120,83,281,113,80,42,201,71
1403584,29,28,1984,2,"male",439,25,0,0,2,0,2,0,0
1403594,52,3,1961,1,"female",254,80,54,121,57,121,37,0,20
1403613,36,6,1977,6,"male",145,107,29,0,0,0,0,0,0
1403630,53,2,1960,2,"male",1045,19,8,0,0,0,0,0,0
1403664,23,10,1990,8,"male",183,55,36,12,8,6,5,6,3
1403669,49,29,1964,6,"male",437,145,110,0,7,0,0,0,7
1403678,25,26,1988,11,"male",1421,252,111,13,5,9,4,4,1
1403726,23,2,1990,10,"male",552,12,10,16,1,9,1,7,0
1403730,34,6,1979,4,"female",119,41,22,126,26,126,20,0,6
1403738,36,9,1977,9,"male",543,97,83,33,30,33,22,0,8
1403759,39,1,1974,4,"male",742,55,17,0,0,0,0,0,0
1403771,35,5,1978,9,"female",31,6,6,0,0,0,0,0,0
1403780,28,1,1985,1,"female",181,9,6,0,0,0,0,0,0
1403829,25,18,1988,4,"male",18,0,0,0,0,0,0,0,0
1403845,19,16,1994,3,"female",537,94,48,18,2,18,1,0,1
1403868,32,20,1981,11,"female",487,3,2,0,0,0,0,0,0
1403879,16,6,1997,1,"male",415,133,83,0,0,0,0,0,0
1403889,108,1,1905,5,"male",25,54,40,14,6,14,6,0,0
1403891,47,12,1966,12,"female",187,12,3,4,5,4,5,0,0
1403897,49,29,1964,10,"female",1095,194,53,729,1226,698,802,31,424
1403936,35,2,1978,4,"male",567,34,14,41,40,41,36,0,4
1403953,26,3,1987,10,"male",440,27,6,0,1,0,1,0,0
1403958,23,4,1990,8,"female",63,29,11,169,260,169,181,0,79
1403959,56,2,1957,9,"male",1482,27,6,15,31,5,16,10,15
1403971,16,7,1997,8,"female",475,11,4,0,0,0,0,0,0
1404002,47,21,1966,6,"female",297,123,39,242,209,242,183,0,26
1404045,29,10,1984,3,"female",150,32,23,1,2,1,1,0,1
1404065,48,22,1965,10,"female",647,37,26,54,34,54,31,0,3
1404082,34,3,1979,6,"male",1153,170,84,24,1,13,1,11,0
1404097,15,23,1998,9,"male",421,549,473,2,0,2,0,0,0
1404177,19,23,1994,4,"male",427,224,177,100,16,60,9,40,7
1404225,14,12,1999,5,"female",171,337,55,57,52,8,15,49,37
1404234,37,10,1976,8,"female",551,14,6,10,5,10,4,0,1
1404280,23,5,1990,11,"female",18,33,30,1,4,1,4,0,0
1404288,19,1,1994,1,"male",158,4,4,0,0,0,0,0,0
1404300,41,30,1972,6,"female",1129,21,9,1,0,1,0,0,0
1404326,43,31,1970,12,"female",724,55,49,9,2,8,2,1,0
1404373,48,30,1965,4,"female",334,50,15,45,68,43,29,2,39
1404379,21,4,1992,5,"male",402,100,45,25,5,14,3,11,2
1404417,22,3,1991,9,"male",262,49,33,1,0,1,0,0,0
1404431,21,17,1992,3,"male",563,394,297,79,59,79,42,0,17
1404473,28,2,1985,10,"male",846,178,107,0,0,0,0,0,0
1404483,103,4,1910,12,"female",781,291,55,4,5,4,5,0,0
1404510,59,19,1954,6,"male",90,0,0,0,0,0,0,0,0
1404521,22,5,1991,5,"male",153,401,392,0,0,0,0,0,0
1404532,27,7,1986,2,"male",785,184,177,4,0,0,0,4,0
1404546,51,18,1962,2,"male",746,54,20,2,0,0,0,2,0
1404563,17,11,1996,4,"male",414,217,147,1287,111,1287,69,0,42
1404576,23,1,1990,1,"female",206,5,3,0,0,0,0,0,0
1404597,18,9,1995,9,"female",484,2086,1391,2,25,2,18,0,7
1404625,17,10,1996,9,"male",292,80,52,14,4,0,4,14,0
1404677,27,8,1986,6,"male",289,35,19,11,4,0,1,11,3
1404679,18,19,1995,7,"female",467,647,499,683,129,294,92,389,37
1404689,26,2,1987,2,"male",538,24,4,2,14,2,1,0,13
1404725,26,25,1987,9,"male",158,2,1,0,0,0,0,0,0
1404779,26,27,1987,8,"female",1054,676,395,74,179,74,136,0,43
1404800,102,1,1911,1,"male",415,185,52,74,324,74,159,0,165
1404806,33,22,1980,10,"male",466,33,24,0,0,0,0,0,0
1404837,23,20,1990,11,"female",601,278,168,111,79,85,33,26,46
1404845,45,22,1968,2,"female",497,77,60,0,34,0,7,0,27
1404850,34,26,1979,5,"male",523,29,14,5,6,0,0,5,6
1404856,23,20,1990,9,"male",85,74,59,0,0,0,0,0,0
1404867,27,19,1986,11,"female",334,116,69,321,517,291,240,30,277
1404880,62,2,1951,5,"female",671,10,3,0,0,0,0,0,0
1404883,18,18,1995,2,"male",506,158,151,3,1,0,0,3,1
1404895,15,26,1998,11,"female",434,67,42,6,4,0,1,6,3
1404903,39,3,1974,2,"female",316,12,9,142,253,142,188,0,65
1404909,18,1,1995,3,"female",212,1114,469,835,2654,835,1763,0,891
1404940,51,9,1962,12,"female",241,72,65,1,0,0,0,1,0
1404961,30,15,1983,4,"male",523,228,40,1,1,1,1,0,0
1404963,34,3,1979,4,"male",726,29,16,99,96,99,51,0,45
1404979,33,1,1980,1,"male",762,0,0,0,0,0,0,0,0
1405006,51,3,1962,3,"male",122,1,1,74,14,0,0,74,14
1405019,58,4,1955,10,"female",2192,10,3,9,6,0,6,9,0
1405061,21,3,1992,3,"male",529,85,76,25,15,25,11,0,4
1405064,49,5,1964,5,"male",91,58,31,5,0,4,0,1,0
1405072,28,30,1985,9,"male",1498,14,5,0,0,0,0,0,0
1405092,53,30,1960,1,"male",850,37,21,2,8,2,4,0,4
1405099,23,18,1990,9,"male",350,122,111,0,0,0,0,0,0
1405107,28,29,1985,8,"female",243,362,251,811,581,640,420,171,161
1405110,54,12,1959,9,"male",580,201,161,137,30,130,21,7,9
1405118,20,14,1993,1,"male",715,206,69,7,7,2,4,5,3
1405128,22,7,1991,4,"male",166,53,37,42,19,39,11,3,8
1405172,20,23,1993,12,"female",502,176,116,93,126,69,88,24,38
1405193,94,19,1919,6,"male",1152,482,374,32,27,32,20,0,7
1405199,44,15,1969,7,"female",191,98,30,232,68,13,38,219,30
1405210,74,14,1939,9,"male",677,5,1,0,0,0,0,0,0
1405215,52,14,1961,7,"female",16,2,2,37,15,37,7,0,8
1405263,19,20,1994,6,"male",67,19,16,11,1,2,0,9,1
1405300,54,7,1959,9,"male",1758,72,42,99,16,78,11,21,5
1405318,39,11,1974,2,"female",325,10,8,43,46,43,21,0,25
1405319,29,31,1984,12,"female",701,209,128,260,246,260,125,0,121
1405356,14,20,1999,3,"male",134,13,11,2,0,2,0,0,0
1405371,104,1,1909,1,"male",46,45,35,0,1,0,1,0,0
1405400,33,30,1980,12,"female",398,241,191,6,9,6,4,0,5
1405444,23,15,1990,11,"male",308,123,85,43,34,22,27,21,7
1405453,68,1,1945,1,"female",271,77,21,0,1,0,0,0,1
1405454,30,8,1983,3,"female",320,32,23,45,15,34,10,11,5
1405464,24,21,1989,7,"male",409,51,40,0,2,0,1,0,1
1405494,16,26,1997,2,"female",856,309,158,684,917,173,348,511,569
1405515,39,8,1974,11,"female",496,16,8,67,33,67,30,0,3
1405558,18,24,1995,6,"female",294,360,280,128,133,20,53,108,80
1405567,26,18,1987,12,"male",742,1773,1152,58,208,3,101,55,107
1405599,54,28,1959,10,"male",212,81,49,115,56,115,52,0,4
1405604,18,3,1995,11,"male",792,477,325,0,1,0,1,0,0
1405605,15,12,1998,12,"male",217,23,22,3,0,3,0,0,0
1405616,38,15,1975,2,"female",522,49,29,29,26,18,7,11,19
1405617,30,28,1983,4,"female",480,105,72,55,45,55,33,0,12
1405634,24,12,1989,6,"male",218,37,19,65,1,65,0,0,1
1405637,14,5,1999,3,"male",232,72,24,12,7,12,5,0,2
1405640,51,17,1962,3,"female",1159,145,96,24,58,4,24,20,34
1405662,24,29,1989,11,"female",336,54,27,1,0,1,0,0,0
1405664,21,23,1992,2,"male",604,356,324,4,1,4,1,0,0
1405705,20,31,1993,7,"male",623,91,29,2,3,2,1,0,2
1405718,50,29,1963,7,"male",259,8,2,0,1,0,1,0,0
1405734,18,4,1995,8,"male",299,39,33,0,0,0,0,0,0
1405788,48,21,1965,6,"male",638,58,40,9,5,9,3,0,2
1405803,14,22,1999,2,"male",204,6,6,0,0,0,0,0,0
1405844,26,22,1987,10,"female",96,262,91,85,170,40,103,45,67
1405861,39,1,1974,3,"female",648,17,5,19,12,14,5,5,7
1405862,31,24,1982,1,"female",1294,259,145,874,369,719,214,155,155
1405873,40,8,1973,3,"male",323,36,18,86,74,86,51,0,23
1405900,21,5,1992,8,"male",162,103,74,0,0,0,0,0,0
1405905,43,30,1970,5,"male",464,141,86,0,2,0,2,0,0
1405915,40,20,1973,4,"female",221,19,9,4,18,4,15,0,3
1405916,52,11,1961,2,"female",257,54,31,134,50,0,46,134,4
1405917,31,4,1982,12,"male",413,26,23,3,0,3,0,0,0
1405926,53,27,1960,4,"female",377,255,172,14,182,14,144,0,38
1405938,49,28,1964,2,"male",122,2,0,0,0,0,0,0,0
1405946,39,29,1974,6,"female",787,106,63,105,291,105,251,0,40
1405949,16,17,1997,7,"male",135,51,30,1,2,1,2,0,0
1406006,30,22,1983,2,"female",311,209,182,214,10,214,5,0,5
1406016,33,23,1980,12,"male",270,92,38,112,6,112,5,0,1
1406019,14,27,1999,9,"male",29,32,22,1,1,1,0,0,1
1406021,19,21,1994,7,"female",389,796,560,0,11,0,8,0,3
1406041,81,6,1932,6,"male",495,25,24,0,1,0,0,0,1
1406053,22,21,1991,10,"female",705,113,90,182,4,182,4,0,0
1406056,43,21,1970,1,"female",153,82,29,447,93,2,39,445,54
1406058,18,20,1995,11,"female",376,124,57,0,0,0,0,0,0
1406067,15,22,1998,10,"male",773,255,115,15,31,9,20,6,11
1406080,36,4,1977,9,"female",487,258,75,8,5,8,4,0,1
1406098,24,27,1989,12,"male",241,151,137,10,0,4,0,6,0
1406122,34,15,1979,10,"female",177,98,45,4,21,4,21,0,0
1406149,45,18,1968,12,"male",411,15,6,4,2,0,1,4,1
1406184,33,11,1980,10,"female",564,45,32,24,23,11,17,13,6
1406192,22,29,1991,10,"female",327,1,1,53,5,0,0,53,5
1406197,79,23,1934,9,"female",1029,61,21,116,27,0,15,116,12
1406202,30,19,1983,12,"male",90,31,19,26,24,26,22,0,2
1406223,25,12,1988,8,"male",874,168,104,6,1,0,0,6,1
1406233,13,3,2000,9,"female",119,272,159,1047,1366,460,821,587,545
1406241,19,6,1994,5,"male",801,278,193,306,67,306,46,0,21
1406289,43,10,1970,1,"male",231,62,56,3,0,3,0,0,0
1406292,17,23,1996,6,"male",137,21,19,49,29,48,12,1,17
1406297,77,27,1936,7,"male",1644,41,13,1,0,1,0,0,0
1406307,18,8,1995,2,"male",347,1048,909,129,133,129,93,0,40
1406316,55,25,1958,1,"female",554,43,38,267,141,241,93,26,48
1406318,19,16,1994,1,"male",127,99,73,57,16,57,13,0,3
1406322,19,15,1994,12,"female",396,363,84,203,364,121,281,82,83
1406339,51,1,1962,7,"female",1458,197,108,87,132,57,90,30,42
1406376,56,9,1957,9,"female",1786,276,169,667,281,667,232,0,49
1406384,23,22,1990,4,"male",341,52,32,3,0,1,0,2,0
1406407,14,18,1999,11,"female",299,199,76,19,25,19,25,0,0
1406433,60,30,1953,11,"male",924,31,20,54,11,44,10,10,1
1406450,36,26,1977,8,"male",1297,103,40,2,1,2,1,0,0
1406458,16,10,1997,2,"male",156,146,79,81,34,81,34,0,0
1406463,30,4,1983,5,"male",386,1,0,0,0,0,0,0,0
1406464,39,20,1974,12,"male",42,1,0,0,0,0,0,0,0
1406488,33,22,1980,8,"female",351,49,26,125,38,125,30,0,8
1406534,19,17,1994,6,"male",9,8,4,3,2,3,2,0,0
1406561,26,23,1987,6,"female",123,163,101,883,268,624,119,259,149
1406585,23,31,1990,10,"male",40,39,19,54,25,9,15,45,10
1406600,21,12,1992,8,"male",371,19,16,187,4,0,1,187,3
1406624,28,16,1985,2,"male",361,108,103,0,1,0,0,0,1
1406632,44,25,1969,9,"female",420,297,259,65,336,42,262,23,74
1406678,62,19,1951,12,"female",979,113,34,5,10,3,6,2,4
1406696,53,27,1960,11,"female",47,30,16,204,123,204,90,0,33
1406733,24,4,1989,10,"female",793,1405,787,243,421,116,294,127,127
1406755,48,20,1965,1,"male",1961,82,33,0,1,0,0,0,1
1406757,103,1,1910,1,"male",1615,25,20,6,0,6,0,0,0
1406761,23,24,1990,11,"male",826,600,373,0,3,0,2,0,1
1406768,23,26,1990,5,"male",422,9,6,33,44,0,2,33,42
1406801,18,4,1995,8,"male",531,4,2,0,0,0,0,0,0
1406832,15,27,1998,11,"male",624,61,49,7,6,7,1,0,5
1406839,23,11,1990,4,"male",165,15,15,0,0,0,0,0,0
1406854,102,5,1911,1,"male",565,7,2,1,2,1,2,0,0
1406859,42,27,1971,10,"female",424,89,68,130,92,128,58,2,34
1406862,17,19,1996,6,"male",257,484,326,707,74,602,46,105,28
1406890,38,28,1975,6,"female",419,88,67,13,79,11,22,2,57
1406895,58,23,1955,1,"female",1673,275,179,434,378,396,163,38,215
1406911,61,24,1952,10,"male",961,5,3,0,0,0,0,0,0
1406950,32,13,1981,2,"male",574,153,102,1,0,1,0,0,0
1406954,45,12,1968,4,"male",652,2,1,0,1,0,1,0,0
1406995,56,7,1957,2,"female",441,71,41,85,51,0,14,85,37
1407002,113,27,1900,8,"female",1139,293,155,432,605,0,115,432,490
1407007,26,28,1987,6,"male",177,363,289,1,0,1,0,0,0
1407080,47,11,1966,9,"female",146,45,33,52,14,41,7,11,7
1407083,13,17,2000,1,"female",373,51,44,291,43,272,43,19,0
1407105,55,6,1958,5,"female",707,149,107,2,26,0,5,2,21
1407124,37,22,1976,4,"male",117,96,82,380,1,380,1,0,0
1407127,25,15,1988,6,"male",178,133,87,9,20,9,17,0,3
1407148,48,14,1965,2,"female",203,31,26,1,0,1,0,0,0
1407156,46,8,1967,12,"female",311,21,7,305,14,305,12,0,2
1407157,14,5,1999,10,"male",280,92,76,33,10,25,3,8,7
1407165,18,25,1995,10,"male",288,42,40,5,0,5,0,0,0
1407170,19,4,1994,10,"male",714,351,195,10,65,2,15,8,50
1407172,33,4,1980,3,"female",412,7,5,0,69,0,59,0,10
1407189,44,30,1969,6,"female",1389,487,290,3442,1872,2553,1511,889,361
1407204,63,16,1950,8,"male",923,266,201,39,237,6,47,33,190
1407225,21,28,1992,12,"male",24,143,122,29,119,29,71,0,48
1407241,18,31,1995,1,"female",230,281,147,207,236,207,158,0,78
1407257,22,30,1991,10,"male",194,110,106,2,2,0,1,2,1
1407260,57,2,1956,1,"male",44,89,30,58,134,35,85,23,49
1407272,37,10,1976,9,"male",1050,18,9,3,11,0,6,3,5
1407294,35,4,1978,9,"female",556,516,313,135,159,131,127,4,32
1407395,42,1,1971,1,"male",259,184,152,1,16,1,16,0,0
1407417,69,28,1944,12,"male",194,7,7,1,2,1,2,0,0
1407424,14,26,1999,3,"female",1024,77,46,5,3,5,3,0,0
1407426,23,17,1990,7,"female",1408,498,274,17,1,0,0,17,1
1407454,14,19,1999,10,"female",459,329,255,1413,364,1376,221,37,143
1407511,22,23,1991,6,"female",563,115,58,75,14,75,7,0,7
1407537,27,18,1986,12,"female",302,1,1,1,0,1,0,0,0
1407556,19,30,1994,1,"male",622,142,52,0,0,0,0,0,0
1407560,46,2,1967,1,"male",505,122,10,7,9,1,4,6,5
1407608,52,5,1961,10,"female",766,17,7,0,0,0,0,0,0
1407609,28,5,1985,9,"male",43,70,62,1,62,1,36,0,26
1407622,23,23,1990,2,"male",20,271,254,531,299,239,285,292,14
1407659,38,5,1975,2,"male",355,166,35,21,10,21,5,0,5
1407669,14,10,1999,12,"female",214,603,178,20,8,1,0,19,8
1407689,18,7,1995,11,"female",445,303,102,1,5,1,5,0,0
1407702,47,1,1966,12,"male",181,55,39,2,3,0,2,2,1
1407707,35,22,1978,1,"male",263,79,49,24,22,0,7,24,15
1407732,26,1,1987,1,"male",579,119,91,0,0,0,0,0,0
1407777,18,17,1995,10,"male",169,83,47,2,22,2,17,0,5
1407792,26,17,1987,8,"male",200,55,44,6,1,6,1,0,0
1407831,23,6,1990,10,"male",422,4047,1097,66,54,32,46,34,8
1407838,108,10,1905,10,"female",1175,371,158,42,122,6,49,36,73
1407842,26,28,1987,4,"male",795,228,167,346,629,264,374,82,255
1407854,18,16,1995,9,"male",338,178,78,0,0,0,0,0,0
1407897,17,15,1996,2,"male",248,86,82,25,1,25,0,0,1
1407902,102,16,1911,1,"male",131,64,55,0,0,0,0,0,0
1407914,29,21,1984,1,"male",217,13,11,0,4,0,3,0,1
1407921,19,27,1994,9,"female",408,332,126,147,301,96,77,51,224
1407923,17,17,1996,3,"male",326,177,133,97,33,97,28,0,5
1407925,77,4,1936,4,"female",966,419,289,706,259,706,191,0,68
1407976,40,10,1973,10,"male",237,45,16,9,11,9,11,0,0
1407978,66,11,1947,3,"male",402,167,88,0,2,0,2,0,0
1408018,21,3,1992,4,"male",131,1,1,0,2,0,0,0,2
1408027,24,19,1989,12,"male",268,4,4,0,0,0,0,0,0
1408129,53,30,1960,3,"female",202,60,29,205,2,205,0,0,2
1408171,74,21,1939,2,"female",1444,18,4,1,11,0,9,1,2
1408188,49,10,1964,10,"female",119,102,49,8,32,8,28,0,4
1408211,22,3,1991,3,"male",352,30,11,1,0,1,0,0,0
1408219,15,25,1998,3,"male",189,380,310,3,12,1,3,2,9
1408225,108,31,1905,8,"male",613,158,127,6,4,6,3,0,1
1408243,27,17,1986,8,"male",353,180,155,16,52,10,16,6,36
1408244,19,4,1994,4,"female",260,71,62,41,5,41,5,0,0
1408254,23,3,1990,4,"female",235,81,71,233,216,233,216,0,0
1408263,20,21,1993,9,"male",105,11,10,0,0,0,0,0,0
1408275,52,17,1961,12,"female",487,37,23,117,42,117,35,0,7
1408279,19,15,1994,7,"male",229,84,48,21,13,11,4,10,9
1408281,19,7,1994,11,"male",327,347,305,17,0,17,0,0,0
1408301,15,9,1998,6,"male",575,234,170,19,15,14,14,5,1
1408347,22,13,1991,8,"female",121,90,51,134,105,134,41,0,64
1408355,16,10,1997,1,"female",233,358,64,177,95,77,34,100,61
1408380,62,26,1951,1,"male",154,1,1,1,0,0,0,1,0
1408389,33,1,1980,1,"male",47,88,79,15,62,15,29,0,33
1408407,49,5,1964,11,"male",1128,30,26,6,2,6,1,0,1
1408420,21,12,1992,2,"male",157,0,0,0,0,0,0,0,0
1408437,91,9,1922,3,"female",1254,215,124,450,208,168,91,282,117
1408466,33,9,1980,1,"male",308,79,76,0,21,0,10,0,11
1408513,64,30,1949,11,"male",587,225,184,39,79,39,26,0,53
1408515,18,20,1995,7,"female",92,13,4,33,32,12,1,21,31
1408526,48,25,1965,1,"female",576,91,56,379,66,138,39,241,27
1408531,27,8,1986,9,"female",131,104,80,25,99,25,77,0,22
1408547,94,31,1919,12,"male",632,1055,709,3223,1812,3223,1537,0,275
1408548,23,16,1990,1,"male",461,74,29,0,44,0,33,0,11
1408553,29,1,1984,6,"male",670,171,127,6,10,0,2,6,8
1408556,27,1,1986,1,"male",521,131,56,0,0,0,0,0,0
1408560,18,15,1995,12,"female",438,3547,1205,1337,2011,1278,1053,59,958
1408607,18,23,1995,3,"male",432,173,103,2,0,2,0,0,0
1408633,14,28,1999,11,"female",273,21,9,1,0,1,0,0,0
1408635,57,20,1956,3,"male",226,81,67,4,8,4,8,0,0
1408644,19,21,1994,9,"female",277,1085,951,1268,672,1232,303,36,369
1408647,25,13,1988,10,"female",286,394,206,369,424,368,217,1,207
1408658,66,5,1947,7,"female",238,25,11,0,0,0,0,0,0
1408673,31,12,1982,11,"female",240,257,177,367,224,1,49,366,175
1408700,54,18,1959,11,"male",81,16,13,2,1,0,0,2,1
1408719,108,16,1905,2,"female",462,160,43,0,1,0,1,0,0
1408731,31,30,1982,1,"male",2374,264,96,316,209,109,34,207,175
1408748,16,5,1997,11,"female",14,18,10,6,9,6,6,0,3
1408749,49,25,1964,3,"female",958,528,345,298,515,298,469,0,46
1408765,16,13,1997,1,"male",447,425,387,76,16,0,10,76,6
1408807,72,25,1941,8,"female",1489,82,45,680,180,0,50,680,130
1408836,45,4,1968,10,"female",594,50,34,94,9,94,3,0,6
1408857,25,5,1988,1,"male",554,309,95,29,116,29,110,0,6
1408869,70,25,1943,8,"male",1513,28,17,10,6,7,3,3,3
1408894,38,5,1975,5,"male",403,189,165,0,4,0,3,0,1
1408899,50,8,1963,8,"female",193,42,35,149,1,4,0,145,1
1408919,62,21,1951,9,"male",884,47,16,55,12,7,3,48,9
1408937,57,9,1956,6,"female",881,192,111,257,85,257,79,0,6
1408950,23,18,1990,2,"female",502,100,59,1,2,0,1,1,1
1409027,25,20,1988,5,"male",123,205,193,35,8,35,6,0,2
1409045,19,19,1994,7,"male",343,15,13,0,0,0,0,0,0
1409049,57,27,1956,11,"female",1634,424,122,302,73,302,25,0,48
1409050,27,8,1986,5,"female",367,65,38,0,0,0,0,0,0
1409071,55,18,1958,9,"female",39,22,17,1,11,0,3,1,8
1409072,32,20,1981,1,"male",89,100,84,7,2,0,2,7,0
1409084,62,16,1951,6,"female",565,11,7,38,23,31,10,7,13
1409087,20,12,1993,8,"male",7,13,12,1,0,1,0,0,0
1409117,61,3,1952,11,"female",501,48,42,100,88,0,23,100,65
1409149,53,2,1960,4,"female",104,9,8,0,0,0,0,0,0
1409160,19,30,1994,11,"male",555,36,31,18,15,18,4,0,11
1409198,20,28,1993,5,"female",417,290,187,292,292,201,178,91,114
1409253,22,20,1991,3,"female",963,199,89,0,1,0,1,0,0
1409268,38,10,1975,11,"male",28,10,10,55,13,55,13,0,0
1409367,19,23,1994,8,"male",276,419,326,71,111,71,101,0,10
1409376,36,10,1977,8,"female",69,3,2,13,11,13,11,0,0
1409405,26,18,1987,10,"male",642,133,127,33,3,33,1,0,2
1409464,19,28,1994,6,"male",384,94,65,31,2,31,2,0,0
1409524,23,6,1990,2,"female",126,13,9,438,143,438,44,0,99
1409540,108,17,1905,6,"male",996,367,253,862,754,550,442,312,312
1409594,18,21,1995,6,"female",331,660,505,21,41,21,34,0,7
1409612,19,24,1994,11,"male",462,212,29,4,48,4,30,0,18
1409622,19,11,1994,5,"female",267,299,213,37,3,20,2,17,1
1409645,15,13,1998,7,"male",224,167,129,20,11,20,9,0,2
1409699,49,28,1964,9,"female",1960,310,216,584,730,571,550,13,180
1409702,18,7,1995,7,"male",1223,214,195,13,3,13,3,0,0
1409738,24,1,1989,4,"male",353,86,57,7,1,7,1,0,0
1409777,62,30,1951,1,"male",493,24,9,0,0,0,0,0,0
1409789,19,2,1994,6,"male",388,289,191,1,0,1,0,0,0
1409806,17,7,1996,5,"female",209,74,54,4,9,4,6,0,3
1409824,33,5,1980,8,"female",440,58,36,0,0,0,0,0,0
1409829,27,26,1986,5,"female",867,127,65,36,24,13,18,23,6
1409837,70,12,1943,7,"female",919,66,22,63,16,52,7,11,9
1409852,43,8,1970,1,"male",253,20,12,0,0,0,0,0,0
1409853,47,1,1966,8,"male",417,114,70,3,2,3,2,0,0
1409858,62,20,1951,10,"female",1171,20,6,15,7,10,3,5,4
1409936,19,31,1994,5,"female",1042,592,350,403,356,35,291,368,65
1409968,51,9,1962,3,"female",1513,32,13,25,10,11,2,14,8
1409983,22,23,1991,5,"female",364,1741,1333,67,227,31,56,36,171
1409992,33,19,1980,9,"male",257,62,43,0,0,0,0,0,0
1410007,23,20,1990,6,"male",116,41,20,7,1,7,1,0,0
1410025,45,13,1968,5,"female",982,162,100,133,110,129,79,4,31
1410095,60,19,1953,5,"male",340,5,4,0,2,0,2,0,0
1410103,44,10,1969,3,"male",1516,114,72,6,10,6,9,0,1
1410119,84,3,1929,7,NA,2214,254,82,18,23,10,4,8,19
1410156,33,11,1980,9,"female",94,8,7,91,6,91,6,0,0
1410162,58,4,1955,9,"female",650,30,13,249,44,0,32,249,12
1410177,16,1,1997,7,"female",361,359,157,184,170,79,31,105,139
1410194,23,7,1990,7,"male",188,54,37,1,9,0,8,1,1
1410203,21,8,1992,3,"male",690,292,200,0,4,0,4,0,0
1410222,19,17,1994,2,"female",617,151,95,137,161,6,69,131,92
1410258,16,26,1997,8,"female",242,80,49,31,81,31,54,0,27
1410270,31,12,1982,5,"male",526,102,85,11,8,0,5,11,3
1410275,14,25,1999,4,"female",358,265,110,178,133,172,87,6,46
1410321,17,14,1996,12,"male",438,426,241,141,130,138,64,3,66
1410326,14,17,1999,2,"male",186,80,51,1,0,1,0,0,0
1410331,113,29,1900,3,"female",1564,153,47,84,157,84,131,0,26
1410335,24,4,1989,11,"male",841,650,522,68,86,34,17,34,69
1410351,19,9,1994,9,"male",222,3847,259,278,2145,2,1447,276,698
1410352,27,1,1986,1,"male",312,59,55,6,2,6,1,0,1
1410357,18,26,1995,7,"male",625,353,307,6,2,6,2,0,0
1410379,32,29,1981,3,"male",7,15,14,6,3,6,3,0,0
1410389,15,1,1998,2,"female",272,69,48,28,3,28,3,0,0
1410391,39,5,1974,11,"male",631,37,30,0,0,0,0,0,0
1410410,19,15,1994,10,"female",557,155,90,9,26,7,12,2,14
1410444,27,24,1986,5,"male",11,16,13,1,0,1,0,0,0
1410452,23,1,1990,1,"male",512,135,63,3,1,2,0,1,1
1410453,44,12,1969,4,"female",375,6,4,7,0,7,0,0,0
1410457,15,8,1998,2,"male",264,25,18,3,0,0,0,3,0
1410465,49,7,1964,1,"female",708,84,46,6,19,6,19,0,0
1410479,58,22,1955,5,"male",857,79,12,0,0,0,0,0,0
1410508,68,9,1945,3,"male",2156,39,17,0,0,0,0,0,0
1410523,14,31,1999,1,"female",41,531,410,547,540,299,212,248,328
1410537,22,4,1991,4,"male",77,12,2,0,0,0,0,0,0
1410547,53,3,1960,1,"female",369,28,21,25,54,25,27,0,27
1410553,31,1,1982,12,"female",380,0,0,0,0,0,0,0,0
1410555,53,9,1960,12,"female",1689,1168,1014,1261,2890,1208,2015,53,875
1410570,25,2,1988,7,"male",382,177,94,77,78,77,51,0,27
1410578,23,7,1990,8,"male",1398,71,18,0,1,0,0,0,1
1410610,50,15,1963,3,"male",637,32,19,25,14,23,10,2,4
1410615,64,26,1949,7,"male",1753,35,17,27,60,27,43,0,17
1410638,70,20,1943,10,"female",324,23,17,8,0,0,0,8,0
1410639,16,14,1997,9,"female",84,1,1,0,0,0,0,0,0
1410643,67,24,1946,1,"female",899,185,159,46,71,6,27,40,44
1410646,52,26,1961,4,"male",293,39,19,1,0,1,0,0,0
1410669,26,22,1987,12,"male",168,2,0,0,0,0,0,0,0
1410686,65,9,1948,5,"male",2270,26,8,5,18,0,15,5,3
1410708,36,5,1977,9,"male",669,91,66,1,3,0,1,1,2
1410719,20,22,1993,2,"female",991,1488,929,2287,2014,2215,1225,72,789
1410731,47,3,1966,10,"male",485,332,246,670,447,286,88,384,359
1410734,27,12,1986,1,"female",718,209,37,38,7,38,4,0,3
1410753,17,6,1996,7,"female",279,2536,178,377,2158,377,1913,0,245
1410761,20,21,1993,4,"male",295,33,29,2,10,2,8,0,2
1410773,44,12,1969,10,"female",621,38,11,16,25,16,21,0,4
1410835,27,26,1986,12,"male",559,89,80,14,9,4,4,10,5
1410864,53,10,1960,2,"male",15,1,1,0,0,0,0,0,0
1410873,19,19,1994,5,"male",560,307,268,1,16,1,16,0,0
1410902,18,4,1995,6,"male",480,1392,954,96,86,96,72,0,14
1410910,91,10,1922,4,"male",707,112,76,603,16,7,2,596,14
1410943,27,15,1986,10,"male",328,73,30,3,1,0,1,3,0
1410974,47,10,1966,10,"female",909,170,88,93,36,85,22,8,14
1410975,66,18,1947,4,"female",660,32,13,127,93,91,57,36,36
1410990,17,13,1996,8,"female",174,37,18,38,7,38,3,0,4
1411001,18,11,1995,5,"male",472,83,50,0,0,0,0,0,0
1411014,48,17,1965,10,"male",689,662,148,0,3,0,3,0,0
1411015,19,7,1994,1,"female",717,492,322,0,13,0,8,0,5
1411031,52,6,1961,1,"female",513,44,26,2,10,2,3,0,7
1411042,25,1,1988,1,"male",182,37,12,7,6,7,6,0,0
1411049,39,1,1974,10,"male",559,9,4,9,6,7,4,2,2
1411071,19,1,1994,1,"male",245,8,8,0,4,0,1,0,3
1411083,25,18,1988,11,"female",359,125,65,433,836,429,679,4,157
1411093,37,1,1976,1,"male",257,48,43,0,2,0,0,0,2
1411107,34,27,1979,4,"male",538,1093,900,10,8,10,8,0,0
1411112,44,23,1969,11,"male",337,11,5,70,7,70,6,0,1
1411120,65,7,1948,7,"female",652,51,25,0,4,0,4,0,0
1411176,22,1,1991,6,"male",150,251,224,24,16,24,9,0,7
1411212,41,20,1972,12,"male",189,60,26,8,49,8,30,0,19
1411241,53,27,1960,3,"male",726,19,9,40,0,0,0,40,0
1411246,16,30,1997,6,"male",68,86,75,0,2,0,0,0,2
1411247,18,17,1995,8,"female",261,381,137,904,1044,894,592,10,452
1411252,19,14,1994,4,"male",607,227,126,0,1,0,0,0,1
1411260,15,10,1998,1,"male",417,246,89,221,222,42,107,179,115
1411296,29,13,1984,5,"male",755,20,4,0,0,0,0,0,0
1411307,20,21,1993,9,"male",247,146,96,4,0,4,0,0,0
1411313,19,14,1994,6,"female",589,1437,313,576,392,427,215,149,177
1411338,23,24,1990,4,"male",600,193,131,109,22,109,18,0,4
1411359,22,3,1991,11,"female",496,76,41,532,79,532,57,0,22
1411371,32,22,1981,10,"female",548,85,42,58,36,15,18,43,18
1411373,20,6,1993,12,"male",138,33,9,156,15,6,3,150,12
1411390,53,13,1960,3,"male",485,112,54,4,0,4,0,0,0
1411402,33,9,1980,4,"male",317,107,59,4,1,4,1,0,0
1411408,48,5,1965,1,"male",1242,148,44,51,231,51,177,0,54
1411413,108,1,1905,1,"male",1759,86,69,14,10,14,10,0,0
1411485,42,24,1971,2,"male",174,52,36,9,8,9,8,0,0
1411491,47,16,1966,3,"female",370,66,29,9,18,0,7,9,11
1411497,65,23,1948,5,"male",408,400,315,38,11,0,3,38,8
1411520,28,12,1985,12,"female",1687,43,35,119,121,110,95,9,26
1411529,50,17,1963,1,"female",1177,174,90,170,34,158,9,12,25
1411548,43,23,1970,7,"male",428,46,39,0,2,0,0,0,2
1411600,23,21,1990,2,"male",220,201,170,49,26,49,26,0,0
1411603,68,6,1945,2,"female",1554,1822,618,23,57,23,38,0,19
1411620,29,1,1984,10,"male",362,37,27,18,0,12,0,6,0
1411637,23,26,1990,8,"female",80,914,607,4068,2834,3788,2294,280,540
1411648,21,11,1992,11,"male",513,290,125,368,572,91,110,277,462
1411710,15,8,1998,8,"male",435,246,184,0,0,0,0,0,0
1411725,18,9,1995,12,"male",250,12,7,0,0,0,0,0,0
1411727,49,19,1964,7,"male",421,31,19,0,0,0,0,0,0
1411728,20,26,1993,5,"female",471,115,69,0,0,0,0,0,0
1411741,32,1,1981,4,"female",47,94,58,211,133,211,70,0,63
1411764,24,15,1989,2,"male",601,893,660,67,155,67,134,0,21
1411771,31,2,1982,2,"male",443,28,3,0,0,0,0,0,0
1411777,37,26,1976,11,"male",415,254,209,279,75,271,26,8,49
1411782,34,27,1979,4,"female",172,91,62,47,30,45,28,2,2
1411842,19,27,1994,7,"female",504,952,284,263,750,263,679,0,71
1411859,53,1,1960,4,"male",214,472,203,0,0,0,0,0,0
1411861,21,25,1992,7,"male",462,116,73,17,14,4,9,13,5
1411869,26,26,1987,4,"male",367,104,85,17,0,17,0,0,0
1411897,21,15,1992,2,"male",142,48,38,2,0,2,0,0,0
1411900,59,1,1954,11,"female",673,13,11,32,21,0,0,32,21
1411915,33,27,1980,8,"male",285,158,75,72,9,26,6,46,3
1411916,91,23,1922,10,"male",832,293,232,0,0,0,0,0,0
1411963,48,7,1965,9,"female",1308,364,227,461,423,405,194,56,229
1411983,25,5,1988,5,NA,1534,40,13,3,4,2,2,1,2
1411998,43,14,1970,1,"female",371,93,42,233,118,0,71,233,47
1412005,103,26,1910,1,"female",1505,533,322,1354,485,546,293,808,192
1412026,33,1,1980,12,"male",46,75,73,6,18,6,10,0,8
1412027,102,19,1911,12,"male",1230,220,131,15,0,6,0,9,0
1412092,25,30,1988,12,"male",251,38,38,3,14,3,11,0,3
1412095,14,19,1999,11,"male",266,0,0,0,0,0,0,0,0
1412103,16,18,1997,2,"female",139,28,21,8,0,0,0,8,0
1412104,36,12,1977,9,"male",505,88,55,156,105,151,69,5,36
1412152,15,8,1998,7,"female",192,16,9,42,19,27,6,15,13
1412159,34,22,1979,11,"male",392,2634,2201,4202,2458,1736,1684,2466,774
1412207,29,7,1984,8,"female",28,42,17,594,221,474,89,120,132
1412232,20,5,1993,3,"male",287,213,150,4,8,0,7,4,1
1412233,22,8,1991,12,"female",454,150,99,2066,358,2066,244,0,114
1412251,25,22,1988,9,"female",354,9,8,189,2,189,2,0,0
1412283,31,12,1982,12,"male",222,90,48,2,18,2,9,0,9
1412285,29,27,1984,6,"female",491,72,31,43,11,43,8,0,3
1412349,16,20,1997,12,"female",908,240,165,151,121,123,99,28,22
1412354,27,31,1986,8,"male",1611,391,158,59,30,59,12,0,18
1412375,70,3,1943,11,"female",775,30,17,37,19,0,5,37,14
1412377,56,29,1957,5,"male",46,136,53,98,136,70,83,28,53
1412382,43,24,1970,10,"male",188,16,5,9,1,9,1,0,0
1412408,21,21,1992,9,"female",741,1049,568,1493,1190,27,710,1466,480
1412419,21,14,1992,1,"female",1519,1731,305,187,562,28,403,159,159
1412425,40,18,1973,12,"male",116,47,26,19,1,10,0,9,1
1412429,20,31,1993,10,"female",48,56,27,109,31,109,24,0,7
1412430,23,11,1990,10,"male",730,503,381,7,1,7,1,0,0
1412445,25,1,1988,1,"male",99,14,11,1,0,1,0,0,0
1412467,28,18,1985,3,"male",167,102,55,0,0,0,0,0,0
1412474,61,30,1952,1,"male",766,59,34,3,4,0,0,3,4
1412494,50,27,1963,1,"male",490,59,28,2,0,0,0,2,0
1412495,26,1,1987,2,"male",442,271,173,6,12,5,4,1,8
1412498,14,1,1999,7,"male",154,16,12,3,0,0,0,3,0
1412499,23,21,1990,4,"female",599,681,292,79,482,79,331,0,151
1412511,15,12,1998,8,"male",148,51,16,1,0,1,0,0,0
1412512,33,7,1980,12,"male",1298,8,5,6,0,0,0,6,0
1412520,36,6,1977,9,"male",40,0,0,0,0,0,0,0,0
1412546,29,28,1984,8,"female",683,0,0,0,0,0,0,0,0
1412548,19,12,1994,12,"male",490,52,43,0,0,0,0,0,0
1412549,46,14,1967,4,"female",936,62,19,690,118,690,84,0,34
1412570,24,23,1989,9,"male",799,22,14,19,3,10,2,9,1
1412579,19,7,1994,4,"female",11,2,2,0,0,0,0,0,0
1412626,52,30,1961,5,"male",107,0,0,0,0,0,0,0,0
1412639,27,18,1986,8,"male",260,6,5,0,0,0,0,0,0
1412690,31,4,1982,2,"female",394,77,42,0,0,0,0,0,0
1412701,34,29,1979,9,"female",448,126,94,16,13,16,9,0,4
1412712,18,1,1995,12,"male",698,71,50,3,0,3,0,0,0
1412746,52,28,1961,11,"male",567,9,5,0,0,0,0,0,0
1412782,44,6,1969,6,"female",369,85,49,254,21,254,19,0,2
1412801,47,14,1966,6,"male",31,59,58,3,2,0,2,3,0
1412824,23,1,1990,1,"male",222,242,73,0,2,0,2,0,0
1412840,28,28,1985,1,"female",343,279,247,0,4,0,2,0,2
1412849,44,4,1969,9,"male",766,383,137,229,352,219,177,10,175
1412866,36,3,1977,5,"male",471,158,144,601,540,216,349,385,191
1412886,27,20,1986,5,"male",145,22,17,4,0,4,0,0,0
1412896,33,7,1980,7,"female",639,43,16,19,9,0,5,19,4
1412900,46,16,1967,11,"male",182,12,11,0,0,0,0,0,0
1412925,28,24,1985,12,"male",293,258,255,4,7,0,4,4,3
1412928,23,5,1990,6,"male",202,147,87,306,60,188,6,118,54
1412960,60,22,1953,4,"male",435,1,0,0,0,0,0,0,0
1412961,28,6,1985,11,"male",291,101,74,76,43,54,25,22,18
1412999,22,9,1991,5,"male",496,102,92,1,1,1,0,0,1
1413003,34,21,1979,1,"male",179,23,5,0,0,0,0,0,0
1413012,17,26,1996,12,"female",562,3032,330,1166,1862,389,539,777,1323
1413016,26,29,1987,8,"female",146,180,159,14,6,11,4,3,2
1413042,26,10,1987,1,"male",1108,243,93,66,7,66,6,0,1
1413049,22,5,1991,8,"male",588,382,318,7,3,4,2,3,1
1413125,34,4,1979,11,"male",738,11,3,1,0,1,0,0,0
1413147,27,26,1986,8,"male",544,132,60,6,1,6,0,0,1
1413169,65,11,1948,11,"female",1598,34,17,0,0,0,0,0,0
1413183,61,2,1952,8,"male",722,83,64,0,0,0,0,0,0
1413186,17,11,1996,3,"male",480,135,77,3,1,3,1,0,0
1413218,23,1,1990,1,"female",245,14,10,34,2,0,2,34,0
1413220,17,20,1996,9,"male",509,1005,850,1,0,0,0,1,0
1413221,26,26,1987,7,"male",366,165,149,664,112,664,98,0,14
1413282,41,1,1972,8,"male",598,90,61,25,49,25,29,0,20
1413311,34,18,1979,11,"female",16,75,33,83,24,63,13,20,11
1413315,18,29,1995,5,"female",248,47,28,612,266,0,30,612,236
1413321,26,12,1987,8,"female",1733,657,301,891,1529,368,888,523,641
1413337,30,1,1983,1,"male",430,90,89,5,1,5,1,0,0
1413349,52,18,1961,6,"female",954,130,75,80,1,1,1,79,0
1413365,28,14,1985,3,"male",478,212,149,0,2,0,2,0,0
1413373,20,29,1993,3,"male",163,337,151,70,25,66,25,4,0
1413390,71,12,1942,8,"female",562,37,28,0,22,0,10,0,12
1413400,14,26,1999,9,"female",110,263,138,127,46,127,27,0,19
1413436,72,8,1941,10,"male",1192,152,129,221,58,221,31,0,27
1413459,28,19,1985,1,"female",861,10,5,0,0,0,0,0,0
1413472,67,24,1946,8,"female",205,40,20,81,10,81,9,0,1
1413486,51,7,1962,4,"male",1204,27,20,2,0,1,0,1,0
1413511,32,23,1981,8,"female",428,1421,23,69,376,12,223,57,153
1413536,51,16,1962,10,"female",1629,164,31,46,30,46,29,0,1
1413551,49,18,1964,7,"female",391,46,28,6,0,5,0,1,0
1413560,33,7,1980,1,"male",202,4,0,0,0,0,0,0,0
1413582,20,27,1993,5,"female",696,329,128,24,55,24,27,0,28
1413604,21,20,1992,8,"male",28,27,24,26,15,26,8,0,7
1413611,48,21,1965,3,"female",421,155,117,19,26,0,6,19,20
1413660,66,4,1947,11,"male",1699,38,15,425,499,67,142,358,357
1413672,43,13,1970,10,"female",154,98,85,1402,220,1402,108,0,112
1413760,38,28,1975,12,"female",284,143,51,17,14,17,10,0,4
1413768,27,12,1986,12,"female",598,454,106,304,167,304,129,0,38
1413823,57,1,1956,6,"male",624,15,10,8,7,0,1,8,6
1413827,15,12,1998,8,"female",767,225,164,86,83,80,63,6,20
1413855,15,10,1998,1,"female",518,600,222,702,617,269,365,433,252
1413899,18,12,1995,3,"male",644,770,674,106,388,103,139,3,249
1413910,35,15,1978,10,"female",56,48,21,2,7,2,4,0,3
1413923,18,27,1995,9,"male",468,668,430,23,93,23,57,0,36
1413955,18,20,1995,3,"male",325,1,0,0,0,0,0,0,0
1413985,77,5,1936,4,"female",128,54,46,2,0,2,0,0,0
1413999,43,17,1970,9,"female",212,67,41,0,0,0,0,0,0
1414008,20,3,1993,12,"female",223,12,10,1,0,1,0,0,0
1414028,20,10,1993,3,"female",483,183,73,12,0,12,0,0,0
1414032,37,16,1976,5,"female",436,356,186,20,43,4,18,16,25
1414063,63,24,1950,12,"male",1250,105,48,28,12,15,9,13,3
1414097,16,22,1997,1,"male",27,28,28,1,3,1,3,0,0
1414110,18,13,1995,4,"male",6,4,4,0,0,0,0,0,0
1414126,33,16,1980,9,"male",101,42,26,8,29,8,8,0,21
1414130,16,3,1997,3,"female",156,102,93,120,8,120,6,0,2
1414140,20,18,1993,8,"male",568,265,241,11,8,11,2,0,6
1414141,32,9,1981,9,"female",740,97,48,56,113,24,30,32,83
1414151,108,6,1905,5,"male",858,729,626,60,18,60,16,0,2
1414188,53,28,1960,5,"female",892,74,38,200,63,9,27,191,36
1414191,32,1,1981,1,"male",219,7,7,4,1,0,1,4,0
1414203,68,30,1945,8,"male",1503,54,37,55,120,55,74,0,46
1414204,24,4,1989,8,"male",1492,306,227,31,43,31,34,0,9
1414213,23,25,1990,11,"male",762,697,678,0,1,0,1,0,0
1414217,20,10,1993,2,"female",28,4,1,0,1,0,0,0,1
1414220,22,17,1991,3,"male",148,49,44,0,1,0,1,0,0
1414221,17,22,1996,4,"male",279,48,35,2,0,2,0,0,0
1414224,25,21,1988,7,"male",630,43,32,175,11,175,11,0,0
1414289,48,29,1965,4,"female",571,67,57,418,61,39,11,379,50
1414360,51,25,1962,11,"female",510,463,218,3884,2283,3884,1313,0,970
1414361,20,2,1993,9,"male",1482,142,11,2,4,0,0,2,4
1414372,34,19,1979,7,"male",101,32,22,4,4,4,4,0,0
1414388,57,31,1956,3,"male",648,0,0,0,0,0,0,0,0
1414409,65,8,1948,9,"male",1089,104,52,76,79,40,14,36,65
1414432,23,10,1990,1,"male",289,25,23,13,6,13,6,0,0
1414437,48,2,1965,7,"male",485,166,86,15,27,15,18,0,9
1414475,43,19,1970,6,"female",215,31,23,7,14,0,1,7,13
1414495,17,4,1996,9,"male",353,93,59,1,5,1,2,0,3
1414505,15,12,1998,9,"male",350,222,185,1,0,1,0,0,0
1414518,22,21,1991,9,"female",584,63,38,4,35,4,34,0,1
1414522,43,14,1970,10,"male",937,36,18,14,91,0,25,14,66
1414527,56,25,1957,9,"male",1596,129,72,4,2,4,2,0,0
1414573,60,17,1953,10,"male",108,26,19,34,12,0,3,34,9
1414592,15,21,1998,2,"male",247,254,206,134,15,129,6,5,9
1414604,19,12,1994,8,"male",331,131,106,15,96,15,67,0,29
1414620,61,22,1952,8,"female",840,118,69,0,3,0,3,0,0
1414635,25,1,1988,1,"male",91,12,12,2,0,2,0,0,0
1414650,19,14,1994,9,"female",416,624,360,62,317,62,270,0,47
1414670,52,22,1961,9,"male",260,34,29,1011,61,0,29,1011,32
1414715,21,16,1992,8,"male",527,107,67,15,0,15,0,0,0
1414716,18,23,1995,11,"male",391,304,159,5,6,5,6,0,0
1414720,16,8,1997,5,"male",78,26,26,15,0,0,0,15,0
1414787,64,19,1949,12,"male",347,18,12,0,0,0,0,0,0
1414791,21,28,1992,2,"female",613,139,105,104,65,97,45,7,20
1414816,53,10,1960,8,"male",921,104,19,1,7,1,6,0,1
1414825,62,24,1951,6,"male",2078,45,17,0,0,0,0,0,0
1414834,29,6,1984,6,"female",564,134,50,193,304,177,186,16,118
1414841,55,24,1958,5,"male",1215,488,184,18,44,15,24,3,20
1414855,102,11,1911,11,"female",644,205,42,12,28,12,22,0,6
1414861,38,19,1975,3,"male",139,114,85,19,64,19,48,0,16
1414881,42,14,1971,4,"female",8,55,52,15,17,15,14,0,3
1414958,18,5,1995,9,"male",205,64,51,0,0,0,0,0,0
1415021,103,16,1910,6,"male",303,105,88,3,0,3,0,0,0
1415050,15,22,1998,3,"female",353,953,767,891,540,891,446,0,94
1415074,50,21,1963,8,"male",790,46,15,1,0,1,0,0,0
1415088,40,26,1973,8,"male",1201,43,22,8,8,8,6,0,2
1415114,64,9,1949,10,"male",832,384,332,38,195,10,115,28,80
1415116,62,18,1951,6,"male",152,44,39,1,2,0,0,1,2
1415149,28,12,1985,6,"female",1081,404,260,533,343,266,237,267,106
1415151,19,11,1994,11,"male",116,0,0,0,0,0,0,0,0
1415176,75,27,1938,9,"male",764,137,109,11,237,11,122,0,115
1415195,54,29,1959,11,"female",1739,314,65,9,2,7,1,2,1
1415210,58,28,1955,9,"male",824,104,46,0,0,0,0,0,0
1415233,82,13,1931,12,"female",1088,56,34,48,6,0,3,48,3
1415237,19,10,1994,2,"male",252,0,0,0,0,0,0,0,0
1415249,21,12,1992,5,"female",417,101,30,167,148,167,143,0,5
1415254,56,1,1957,7,"male",929,331,99,0,104,0,73,0,31
1415256,60,23,1953,11,"male",876,240,154,8,5,0,0,8,5
1415264,24,17,1989,2,"female",90,220,163,278,398,259,189,19,209
1415298,33,1,1980,1,"female",680,191,68,4,1,0,1,4,0
1415309,21,9,1992,8,"male",583,380,209,23,10,23,9,0,1
1415312,22,5,1991,10,"female",425,291,148,1728,437,1612,286,116,151
1415313,16,22,1997,1,"male",1240,224,115,1,3,0,2,1,1
1415337,26,2,1987,3,"male",103,0,0,0,0,0,0,0,0
1415345,56,21,1957,11,"female",422,20,16,2,0,1,0,1,0
1415347,15,4,1998,10,"male",50,74,66,5,1,0,0,5,1
1415381,24,10,1989,12,"male",243,165,143,26,6,26,4,0,2
1415388,16,17,1997,7,"female",176,66,39,17,0,17,0,0,0
1415411,18,4,1995,2,"male",415,67,45,33,6,32,6,1,0
1415426,40,21,1973,12,"female",513,26,15,41,50,32,44,9,6
1415431,39,21,1974,12,"female",680,125,77,1442,1177,46,477,1396,700
1415462,21,15,1992,12,"male",336,40,24,26,14,26,14,0,0
1415469,27,9,1986,4,"male",67,23,17,0,4,0,1,0,3
1415498,24,17,1989,7,"female",400,571,362,1184,1138,466,756,718,382
1415531,47,4,1966,4,"male",1006,22,8,0,0,0,0,0,0
1415540,22,12,1991,9,"female",137,40,30,9,125,9,44,0,81
1415543,23,1,1990,2,"male",528,5,4,1,0,0,0,1,0
1415572,44,2,1969,2,"male",195,18,7,22,12,22,3,0,9
1415623,38,15,1975,9,"male",472,544,506,1,0,1,0,0,0
1415649,72,17,1941,8,"male",1723,48,22,1,3,0,3,1,0
1415651,28,10,1985,1,"male",989,704,647,5,0,5,0,0,0
1415661,14,16,1999,8,"female",367,93,25,0,0,0,0,0,0
1415686,32,1,1981,5,"male",378,33,8,1,2,1,2,0,0
1415725,19,5,1994,10,"male",329,262,119,35,10,35,3,0,7
1415732,25,9,1988,7,"female",691,336,219,5,8,5,6,0,2
1415738,50,12,1963,12,"male",520,7,4,0,0,0,0,0,0
1415743,30,5,1983,5,"male",340,117,43,199,160,74,33,125,127
1415788,28,21,1985,5,"male",339,434,388,46,11,1,4,45,7
1415822,19,6,1994,1,"male",541,227,82,2,14,2,14,0,0
1415836,35,2,1978,5,"male",702,38,19,1,3,1,1,0,2
1415856,21,30,1992,4,"female",319,144,121,11,46,11,44,0,2
1415868,15,11,1998,1,"female",592,421,343,181,95,63,65,118,30
1415870,26,16,1987,5,"male",417,51,40,1,0,1,0,0,0
1415952,25,14,1988,8,"female",170,76,56,23,75,17,41,6,34
1415959,16,20,1997,11,"female",330,358,248,0,3,0,1,0,2
1415971,18,12,1995,9,"female",108,18,10,19,61,19,41,0,20
1415973,15,10,1998,2,"female",463,151,114,121,358,101,203,20,155
1416030,27,6,1986,9,"female",906,76,27,165,98,165,37,0,61
1416049,23,30,1990,8,"male",957,192,152,0,6,0,5,0,1
1416059,100,4,1913,9,"female",1772,636,327,1092,635,405,563,687,72
1416094,15,15,1998,9,"female",475,105,17,2,0,0,0,2,0
1416098,18,8,1995,4,"male",562,31,30,3,0,3,0,0,0
1416131,18,2,1995,5,"male",596,67,22,4,0,4,0,0,0
1416149,64,29,1949,12,"female",1546,37,7,2,2,2,2,0,0
1416166,68,22,1945,2,"female",492,17,14,0,0,0,0,0,0
1416168,31,17,1982,4,"male",226,73,50,0,2,0,2,0,0
1416182,25,30,1988,4,"male",108,3,2,0,0,0,0,0,0
1416187,40,7,1973,5,"male",1002,23,8,5,21,5,13,0,8
1416207,30,22,1983,10,"male",322,242,52,45,11,0,6,45,5
1416208,75,2,1938,11,"male",678,11,6,0,0,0,0,0,0
1416248,23,13,1990,11,"female",307,222,121,3,11,3,6,0,5
1416271,108,25,1905,11,"female",2150,176,96,43,46,13,36,30,10
1416281,17,10,1996,6,"male",411,191,148,1,11,0,9,1,2
1416286,50,17,1963,5,"male",731,4,3,4,4,4,4,0,0
1416296,37,9,1976,5,"male",304,345,293,22,130,22,83,0,47
1416319,31,23,1982,10,"male",19,27,13,1,9,0,5,1,4
1416349,25,5,1988,2,"female",381,385,334,246,139,246,108,0,31
1416352,108,14,1905,10,"male",931,414,306,43,13,0,4,43,9
1416357,61,28,1952,2,"female",630,79,56,632,63,84,40,548,23
1416362,15,24,1998,7,"female",188,469,227,37,137,37,93,0,44
1416364,46,13,1967,3,"male",232,105,97,0,1,0,0,0,1
1416373,16,7,1997,9,"female",238,760,188,1404,1194,1237,637,167,557
1416402,28,31,1985,7,"male",412,70,45,26,3,26,3,0,0
1416411,44,9,1969,9,"female",502,37,25,99,94,7,59,92,35
1416417,24,4,1989,7,"female",240,137,40,386,143,386,85,0,58
1416422,17,19,1996,1,"female",556,2302,835,249,371,145,106,104,265
1416493,28,1,1985,1,"male",45,16,13,10,4,3,0,7,4
1416512,18,24,1995,4,"male",194,7,7,9,6,8,5,1,1
1416529,31,20,1982,5,"male",653,3,1,0,2,0,0,0,2
1416563,27,16,1986,11,"male",528,177,159,149,25,149,16,0,9
1416566,61,21,1952,4,"male",1519,43,16,7,31,7,17,0,14
1416568,26,26,1987,11,"male",532,37,24,10,0,0,0,10,0
1416574,31,18,1982,5,"male",294,63,46,117,14,117,11,0,3
1416582,14,27,1999,7,"female",64,73,67,124,90,71,53,53,37
1416583,30,18,1983,2,"male",563,261,237,10,4,0,0,10,4
1416618,26,30,1987,3,"female",789,44,41,0,0,0,0,0,0
1416638,27,27,1986,5,"male",272,0,0,0,0,0,0,0,0
1416651,18,8,1995,3,"male",19,77,72,2,1,2,1,0,0
1416668,18,21,1995,1,"female",568,416,276,31,2,0,0,31,2
1416691,25,26,1988,8,"female",72,1261,122,2,12,2,3,0,9
1416698,33,25,1980,1,"female",374,30,13,0,5,0,1,0,4
1416700,33,9,1980,7,"male",901,53,9,18,56,18,46,0,10
1416705,26,1,1987,1,"male",210,15,14,12,7,9,3,3,4
1416708,44,20,1969,4,"male",360,60,38,437,25,0,3,437,22
1416718,46,10,1967,1,"female",367,91,76,2,78,2,12,0,66
1416781,43,12,1970,12,"female",490,19,18,12,3,0,1,12,2
1416785,78,31,1935,7,"male",517,3,3,0,0,0,0,0,0
1416791,19,7,1994,5,"male",192,10,3,20,6,0,1,20,5
1416808,25,27,1988,5,"male",223,85,55,0,3,0,0,0,3
1416829,17,24,1996,2,"male",342,274,247,16,8,3,8,13,0
1416868,57,11,1956,10,"female",427,23,13,1,0,0,0,1,0
1416879,18,25,1995,1,"female",350,500,48,148,222,148,165,0,57
1416888,93,12,1920,2,"male",421,127,50,3,25,0,7,3,18
1416892,22,31,1991,10,"male",946,13,1,0,0,0,0,0,0
1416902,24,2,1989,12,"male",542,132,89,0,5,0,0,0,5
1416903,13,24,2000,4,"female",367,49,23,1,0,1,0,0,0
1416906,25,11,1988,11,"female",199,19,6,547,138,547,102,0,36
1416907,28,13,1985,3,"female",286,669,403,482,1195,482,1074,0,121
1416921,16,19,1997,11,"male",273,146,118,0,0,0,0,0,0
1416939,16,20,1997,1,"male",242,141,119,5,4,5,4,0,0
1416955,65,18,1948,8,"male",636,17,9,8,16,8,15,0,1
1416969,16,6,1997,2,"female",532,259,43,0,3,0,0,0,3
1417024,21,2,1992,3,"female",1369,3716,596,221,1726,204,1177,17,549
1417031,36,20,1977,3,"female",598,1,1,26,6,4,0,22,6
1417052,31,11,1982,11,"female",661,491,268,707,123,707,120,0,3
1417094,45,23,1968,5,"female",1784,102,44,310,176,211,111,99,65
1417112,20,21,1993,11,"female",156,64,61,7,1,7,1,0,0
1417153,16,15,1997,3,"male",328,157,154,0,0,0,0,0,0
1417157,42,2,1971,11,"male",502,211,124,54,7,54,7,0,0
1417182,61,12,1952,7,"male",657,732,601,1684,3010,737,1430,947,1580
1417214,17,15,1996,12,"female",23,149,120,2,25,1,10,1,15
1417231,32,19,1981,8,"female",72,1,1,91,0,91,0,0,0
1417232,19,24,1994,8,"male",311,179,166,33,40,33,32,0,8
1417239,32,3,1981,9,"male",339,135,127,1,1,1,0,0,1
1417257,43,1,1970,1,"female",153,51,33,5,2,5,1,0,1
1417262,48,28,1965,6,"male",298,12,7,23,12,0,1,23,11
1417281,103,24,1910,3,"male",354,73,41,0,1,0,0,0,1
1417283,20,25,1993,1,"female",644,162,155,0,0,0,0,0,0
1417300,49,29,1964,6,"female",1584,187,100,750,352,667,185,83,167
1417306,40,29,1973,5,"male",434,11,5,6,5,6,4,0,1
1417328,88,29,1925,7,"male",923,30,14,17,10,16,1,1,9
1417334,23,27,1990,11,"male",50,13,6,0,0,0,0,0,0
1417347,53,21,1960,9,"female",422,10,9,0,0,0,0,0,0
1417354,72,4,1941,6,"male",1621,128,93,9,61,3,28,6,33
1417402,40,1,1973,1,"male",107,0,0,0,0,0,0,0,0
1417404,19,9,1994,7,"male",261,100,50,12,14,12,12,0,2
1417437,64,24,1949,9,"male",1667,502,30,8,0,8,0,0,0
1417474,27,18,1986,11,"male",96,130,108,1,1,1,0,0,1
1417515,57,10,1956,10,"female",920,203,113,2049,3123,25,786,2024,2337
1417517,15,7,1998,8,"female",203,288,76,1,11,0,8,1,3
1417520,43,22,1970,6,"female",405,158,111,69,98,68,78,1,20
1417526,16,13,1997,6,"female",621,1001,644,485,872,380,438,105,434
1417528,14,5,1999,3,"male",273,97,47,1,0,0,0,1,0
1417536,24,16,1989,6,"male",172,43,36,1,0,1,0,0,0
1417538,19,29,1994,7,"female",392,1525,971,835,1082,575,629,260,453
1417539,22,7,1991,10,"male",160,0,0,0,0,0,0,0,0
1417546,45,16,1968,9,"female",442,42,35,10,20,0,13,10,7
1417552,58,24,1955,6,"female",78,50,33,356,95,1,17,355,78
1417561,23,1,1990,7,"male",2,64,57,18,1,18,1,0,0
1417562,64,15,1949,2,"female",158,37,20,3,0,3,0,0,0
1417589,103,10,1910,7,"male",152,208,184,33,2,33,1,0,1
1417615,52,27,1961,1,"male",15,14,9,2,0,0,0,2,0
1417619,21,24,1992,6,"male",645,157,38,0,0,0,0,0,0
1417664,15,3,1998,9,"female",91,30,23,84,40,84,21,0,19
1417671,54,31,1959,3,"male",1287,36,23,0,0,0,0,0,0
1417689,21,19,1992,4,"male",164,108,59,0,1,0,1,0,0
1417709,108,14,1905,6,"male",540,244,187,27,3,27,2,0,1
1417715,22,17,1991,11,"male",600,59,27,0,5,0,4,0,1
1417730,26,10,1987,2,"female",597,6,2,0,3,0,3,0,0
1417741,37,26,1976,10,"female",192,79,62,265,19,246,9,19,10
1417748,18,24,1995,3,"male",186,213,188,21,71,0,23,21,48
1417757,29,11,1984,11,"male",460,295,272,1,3,0,1,1,2
1417758,31,28,1982,3,"male",219,48,15,32,49,32,40,0,9
1417763,51,18,1962,12,"male",165,30,26,0,0,0,0,0,0
1417768,45,25,1968,9,"female",1698,95,39,411,213,408,83,3,130
1417792,17,12,1996,4,"female",434,3813,1936,1281,3005,1255,1390,26,1615
1417800,19,1,1994,1,"male",734,15,6,3,0,0,0,3,0
1417843,18,1,1995,1,"female",0,0,0,0,0,0,0,0,0
1417859,23,14,1990,12,"male",1410,27,19,0,0,0,0,0,0
1417860,42,14,1971,2,"female",154,10,6,46,0,9,0,37,0
1417893,59,10,1954,6,"female",1385,65,25,55,16,13,11,42,5
1417922,52,8,1961,10,"female",285,89,72,231,133,231,124,0,9
1417926,21,1,1992,1,"female",482,60,29,4,6,4,3,0,3
1417938,51,3,1962,5,"male",301,0,0,0,0,0,0,0,0
1417958,14,21,1999,2,"female",361,140,124,2,0,0,0,2,0
1417969,21,5,1992,6,"female",253,82,62,61,31,2,10,59,21
1417979,21,7,1992,2,"female",451,116,60,0,0,0,0,0,0
1417982,39,25,1974,5,"female",720,68,43,202,75,66,34,136,41
1417990,37,3,1976,3,"male",634,148,85,0,0,0,0,0,0
1417997,21,8,1992,7,"male",195,213,139,4,10,4,8,0,2
1418004,15,18,1998,8,"male",464,160,137,0,5,0,2,0,3
1418007,59,11,1954,7,"female",1213,440,186,21,34,21,34,0,0
1418014,18,24,1995,1,"female",327,286,208,195,506,194,360,1,146
1418029,57,20,1956,3,"female",1363,54,39,47,8,47,8,0,0
1418034,21,27,1992,10,"male",502,247,111,7,13,7,9,0,4
1418065,61,16,1952,10,"male",19,7,7,1,2,0,1,1,1
1418072,18,1,1995,6,"female",370,442,313,6,13,6,12,0,1
1418112,55,6,1958,10,"female",1437,62,28,65,114,0,18,65,96
1418119,35,25,1978,9,"male",260,186,51,112,32,0,10,112,22
1418136,55,8,1958,8,"male",1380,4,3,3,0,3,0,0,0
1418146,64,20,1949,4,"female",2163,90,48,20,0,0,0,20,0
1418180,57,24,1956,7,"female",447,92,54,0,1,0,1,0,0
1418194,22,1,1991,9,"female",331,332,274,51,62,4,17,47,45
1418201,32,2,1981,4,"male",317,45,42,20,2,20,2,0,0
1418211,20,21,1993,5,"female",610,552,287,2,0,0,0,2,0
1418214,15,7,1998,1,"male",553,6,3,0,0,0,0,0,0
1418215,36,16,1977,3,"male",677,58,33,0,0,0,0,0,0
1418228,14,19,1999,3,"male",475,44,32,0,0,0,0,0,0
1418233,27,13,1986,10,"female",426,75,33,822,253,18,88,804,165
1418237,58,13,1955,4,"female",1949,109,35,14,56,4,34,10,22
1418242,19,24,1994,7,"female",502,239,60,1,1,1,0,0,1
1418251,18,5,1995,2,"male",46,174,165,41,31,41,11,0,20
1418261,22,1,1991,1,"male",1326,144,63,2,11,2,4,0,7
1418291,68,5,1945,6,"male",1121,502,268,244,12,244,12,0,0
1418304,16,21,1997,8,"female",209,1339,669,461,1219,461,1118,0,101
1418313,49,1,1964,3,"female",381,80,40,9,13,0,2,9,11
1418331,21,5,1992,8,"female",302,16,3,58,401,58,288,0,113
1418340,67,22,1946,9,"female",254,12,1,4,0,4,0,0,0
1418367,23,26,1990,4,"male",411,71,24,3,24,3,22,0,2
1418373,17,3,1996,5,"male",197,27,17,0,0,0,0,0,0
1418401,17,20,1996,5,"female",563,1193,292,1842,2873,1777,2284,65,589
1418410,13,27,2000,2,"male",224,142,71,6,1,6,1,0,0
1418411,16,2,1997,1,"male",512,1051,192,0,7,0,5,0,2
1418432,17,14,1996,9,"female",426,73,46,944,148,924,93,20,55
1418438,15,30,1998,3,"male",397,416,332,104,5,104,5,0,0
1418449,35,30,1978,9,"female",464,73,57,269,126,238,34,31,92
1418481,49,18,1964,8,"female",145,70,43,9,28,9,10,0,18
1418498,27,5,1986,4,"male",557,2,0,0,0,0,0,0,0
1418500,44,1,1969,1,"male",43,6,4,0,0,0,0,0,0
1418525,23,14,1990,8,"male",392,83,39,40,12,39,8,1,4
1418550,49,30,1964,4,"female",1682,54,22,9,6,9,3,0,3
1418559,27,19,1986,10,"male",685,71,18,2,0,2,0,0,0
1418573,18,7,1995,3,"male",193,246,145,3721,634,3685,434,36,200
1418596,29,1,1984,12,"male",127,32,14,0,1,0,1,0,0
1418606,28,19,1985,8,"male",274,35,11,0,0,0,0,0,0
1418660,24,7,1989,4,"female",437,176,70,11,51,11,47,0,4
1418695,50,19,1963,11,"male",300,2,1,0,1,0,0,0,1
1418709,41,31,1972,3,"female",109,36,19,121,77,121,54,0,23
1418713,28,25,1985,11,"male",262,156,61,8,0,8,0,0,0
1418730,38,5,1975,3,"female",50,44,40,129,40,129,39,0,1
1418747,23,6,1990,1,"female",455,136,65,26,69,26,67,0,2
1418810,16,23,1997,3,"male",940,68,35,7,22,0,8,7,14
1418838,17,1,1996,4,"female",94,12,11,10,0,10,0,0,0
1418866,31,10,1982,2,"male",586,36,32,3,0,3,0,0,0
1418867,58,16,1955,9,"male",2268,17,6,34,13,34,4,0,9
1418881,16,2,1997,6,"male",435,277,72,8,95,8,51,0,44
1418889,33,4,1980,7,"male",498,25,19,0,1,0,1,0,0
1418894,22,13,1991,11,"female",412,1,1,0,1,0,0,0,1
1418909,16,1,1997,1,"male",25,28,20,15,3,15,3,0,0
1418914,25,17,1988,1,"male",77,319,303,41,121,41,117,0,4
1418915,25,1,1988,1,"male",210,65,43,5,33,5,32,0,1
1418918,28,2,1985,7,"male",278,56,27,1,6,1,6,0,0
1418935,20,27,1993,11,"female",78,31,27,3,1,3,0,0,1
1418936,17,23,1996,12,"female",305,116,73,60,23,60,18,0,5
1418947,39,18,1974,3,"male",300,200,108,2,0,2,0,0,0
1418971,33,1,1980,10,"male",582,6,0,0,0,0,0,0,0
1418990,19,22,1994,6,"male",26,14,12,7,0,7,0,0,0
1419006,18,15,1995,1,"male",275,97,38,1,4,1,2,0,2
1419047,37,28,1976,11,"male",649,27,23,8,0,8,0,0,0
1419074,30,10,1983,1,"female",384,168,104,1739,1282,1739,1198,0,84
1419078,103,4,1910,4,"male",187,75,53,1,5,0,2,1,3
1419081,45,10,1968,3,"female",402,50,19,0,0,0,0,0,0
1419083,40,4,1973,3,"female",673,46,33,76,43,76,33,0,10
1419091,28,15,1985,10,"male",297,82,58,37,40,3,7,34,33
1419108,60,22,1953,4,"female",1340,35,31,95,34,95,34,0,0
1419175,21,18,1992,6,"male",743,271,78,8,1,7,1,1,0
1419184,46,27,1967,5,"male",1111,45,21,153,15,153,8,0,7
1419203,20,2,1993,9,"male",1077,130,81,1,41,1,23,0,18
1419212,15,21,1998,9,"male",194,42,37,0,0,0,0,0,0
1419243,28,15,1985,11,"male",120,37,7,11,4,11,3,0,1
1419261,18,14,1995,3,"male",275,54,32,0,0,0,0,0,0
1419264,23,3,1990,9,"female",352,50,29,100,299,100,227,0,72
1419265,38,14,1975,6,"male",513,33,16,3,11,3,7,0,4
1419270,17,25,1996,1,"female",372,279,188,42,13,0,0,42,13
1419281,16,1,1997,2,"male",219,140,119,1,20,1,14,0,6
1419292,70,1,1943,11,"female",125,13,8,2,2,2,2,0,0
1419305,50,17,1963,12,"male",1065,146,60,2,0,2,0,0,0
1419321,94,21,1919,12,"male",1558,191,88,16,89,16,70,0,19
1419338,63,9,1950,9,"male",489,28,19,2,2,2,2,0,0
1419344,25,13,1988,11,"male",184,39,31,0,0,0,0,0,0
1419347,23,10,1990,1,"female",1109,467,269,0,1,0,1,0,0
1419356,108,2,1905,10,"female",1600,596,352,19,189,19,186,0,3
1419389,26,17,1987,12,"male",117,10,8,16,66,16,58,0,8
1419393,17,13,1996,9,"male",214,113,97,0,2,0,2,0,0
1419411,51,16,1962,11,"male",341,49,41,15,16,15,7,0,9
1419438,24,1,1989,1,"male",550,148,97,0,5,0,5,0,0
1419459,20,16,1993,6,"male",488,542,472,117,23,116,13,1,10
1419502,20,16,1993,1,"male",244,97,53,0,2,0,2,0,0
1419503,62,28,1951,10,"female",1608,79,59,88,26,88,17,0,9
1419518,32,20,1981,3,"female",96,8,5,2,0,2,0,0,0
1419553,23,19,1990,4,"male",259,49,15,0,5,0,4,0,1
1419734,100,2,1913,5,"female",1900,534,277,31,11,31,9,0,2
1419736,40,31,1973,8,"male",206,1,1,2,0,2,0,0,0
1419742,75,29,1938,8,"male",627,41,28,5,8,0,6,5,2
1419745,23,24,1990,6,"male",577,363,304,286,103,64,81,222,22
1419747,20,14,1993,5,"female",146,75,56,0,0,0,0,0,0
1419765,15,17,1998,10,"female",484,129,69,90,339,90,205,0,134
1419799,19,1,1994,1,"male",420,68,35,0,0,0,0,0,0
1419804,17,24,1996,5,"male",10,6,2,1,0,1,0,0,0
1419811,20,13,1993,11,"male",19,26,22,15,9,15,8,0,1
1419864,60,11,1953,11,"female",842,18,17,19,0,1,0,18,0
1419880,59,1,1954,9,"female",1714,150,71,76,47,76,46,0,1
1419881,29,4,1984,10,"male",1043,91,55,3,0,3,0,0,0
1419889,21,5,1992,10,"male",61,22,17,5,1,5,1,0,0
1419920,14,29,1999,4,"female",287,441,196,38,107,38,53,0,54
1419922,60,19,1953,6,"male",582,15,11,3,0,3,0,0,0
1419929,74,11,1939,9,"female",156,19,12,2,2,0,1,2,1
1419945,35,6,1978,6,"female",489,740,495,1713,809,1233,618,480,191
1419967,55,12,1958,10,"female",931,74,20,6,27,0,10,6,17
1419975,54,5,1959,2,"female",419,52,33,0,1,0,1,0,0
1419990,36,25,1977,12,"male",619,15,11,40,11,5,9,35,2
1419994,21,1,1992,7,"female",566,353,263,691,154,543,80,148,74
1420003,55,23,1958,8,"female",1125,473,145,709,548,56,223,653,325
1420032,44,25,1969,5,"female",1579,394,232,348,552,11,270,337,282
1420050,25,1,1988,1,"male",295,5,4,12,10,12,10,0,0
1420058,25,1,1988,1,"male",25,0,0,0,0,0,0,0,0
1420070,23,30,1990,5,"male",391,274,206,47,142,47,136,0,6
1420071,21,2,1992,2,"female",643,255,183,1,0,0,0,1,0
1420094,44,28,1969,11,"male",732,25,9,9,5,9,2,0,3
1420101,60,30,1953,5,"male",512,151,85,7,5,7,4,0,1
1420110,108,18,1905,8,"male",209,143,103,15,13,14,7,1,6
1420136,19,17,1994,1,"male",177,1290,1136,846,2789,119,929,727,1860
1420141,18,26,1995,6,"male",152,188,158,14,4,14,4,0,0
1420142,35,2,1978,8,"male",26,23,19,22,0,22,0,0,0
1420221,45,7,1968,4,"male",1487,227,59,278,224,278,210,0,14
1420228,21,17,1992,1,"male",483,202,133,3,83,3,65,0,18
1420296,33,8,1980,1,"female",155,573,258,215,209,206,162,9,47
1420306,20,5,1993,2,"male",479,47,34,48,4,45,3,3,1
1420339,23,20,1990,5,"male",560,845,767,6,76,6,42,0,34
1420348,22,1,1991,11,"female",241,311,106,125,90,106,77,19,13
1420391,16,25,1997,8,"male",309,780,673,795,189,795,178,0,11
1420404,31,1,1982,4,"male",437,5,4,299,174,60,120,239,54
1420433,16,11,1997,9,"male",457,55,28,3,4,0,3,3,1
1420435,15,23,1998,9,"female",294,551,341,5,2,5,0,0,2
1420467,28,11,1985,6,"male",997,134,115,2,0,2,0,0,0
1420473,32,28,1981,10,"female",437,241,64,105,373,105,203,0,170
1420492,60,29,1953,9,"female",730,120,41,97,247,0,46,97,201
1420516,72,31,1941,1,"female",2064,105,45,81,87,80,77,1,10
1420554,15,31,1998,7,"female",134,115,41,504,1107,441,675,63,432
1420577,32,24,1981,9,"male",256,8,6,35,2,0,2,35,0
1420590,19,14,1994,6,"male",413,355,274,131,108,131,71,0,37
1420595,17,9,1996,3,"female",33,257,27,14,22,14,19,0,3
1420616,18,10,1995,2,"male",165,62,24,1,0,1,0,0,0
1420618,24,2,1989,7,"male",398,71,45,3,2,0,0,3,2
1420642,17,1,1996,1,"female",93,72,45,2037,2236,578,428,1459,1808
1420645,19,28,1994,4,"male",352,336,234,11,0,0,0,11,0
1420710,46,20,1967,4,"male",352,1,0,0,1,0,0,0,1
1420712,56,18,1957,2,"female",1255,31,20,210,19,0,1,210,18
1420721,43,20,1970,1,"male",298,6,3,0,0,0,0,0,0
1420730,71,1,1942,12,"female",1477,5,1,0,0,0,0,0,0
1420735,26,21,1987,3,"male",180,0,0,2,0,2,0,0,0
1420736,58,27,1955,10,"female",244,39,20,193,57,1,20,192,37
1420738,32,14,1981,8,"female",709,23,14,16,1,15,1,1,0
1420743,36,15,1977,8,"female",376,63,54,304,83,304,69,0,14
1420792,18,9,1995,10,"male",368,20,15,45,0,0,0,45,0
1420802,28,9,1985,1,"female",310,148,113,43,79,43,56,0,23
1420860,20,5,1993,1,"male",113,79,45,2351,1501,2311,1157,40,344
1420870,31,7,1982,7,"female",306,106,75,0,0,0,0,0,0
1420915,31,24,1982,4,"female",442,82,65,0,10,0,10,0,0
1420929,23,2,1990,12,"male",286,171,124,6,2,6,2,0,0
1420937,103,15,1910,3,"male",1165,263,98,0,1,0,1,0,0
1420952,23,1,1990,1,"male",111,93,83,3,5,3,5,0,0
1421010,20,15,1993,9,"male",540,41,28,2,0,2,0,0,0
1421020,28,8,1985,4,"male",112,54,27,2,0,2,0,0,0
1421023,20,12,1993,7,"male",602,189,159,4,14,4,10,0,4
1421025,19,29,1994,8,"male",8,204,140,111,242,111,217,0,25
1421027,28,23,1985,3,"female",360,257,103,308,372,308,368,0,4
1421070,17,19,1996,5,"female",868,122,29,4,12,4,3,0,9
1421090,23,24,1990,3,"female",361,1,0,0,0,0,0,0,0
1421117,34,15,1979,4,"male",565,98,82,4,0,4,0,0,0
1421128,53,20,1960,7,"male",1487,388,73,27,44,27,34,0,10
1421131,28,13,1985,6,"female",100,0,0,3,1,3,1,0,0
1421135,65,15,1948,1,"male",1324,38,13,4,3,1,1,3,2
1421176,59,25,1954,1,"female",618,6,3,1,0,1,0,0,0
1421193,16,7,1997,10,"male",151,12,6,0,0,0,0,0,0
1421199,34,16,1979,8,"female",23,8,6,83,32,80,16,3,16
1421203,18,11,1995,5,"male",387,326,84,131,57,57,20,74,37
1421207,19,1,1994,1,"male",80,66,32,323,145,323,93,0,52
1421225,18,21,1995,6,"male",224,21,20,5,0,5,0,0,0
1421231,20,3,1993,10,"male",52,1,0,0,0,0,0,0,0
1421232,27,2,1986,4,"male",126,724,698,905,973,905,882,0,91
1421249,34,14,1979,4,"male",696,199,120,2,9,2,6,0,3
1421280,67,23,1946,10,"female",980,178,138,3223,1065,265,256,2958,809
1421295,18,18,1995,6,"male",84,33,19,6,0,0,0,6,0
1421303,27,14,1986,10,"male",505,4,2,0,0,0,0,0,0
1421308,90,5,1923,6,"male",2060,76,35,0,0,0,0,0,0
1421350,108,26,1905,4,"male",1663,344,70,1,12,0,11,1,1
1421360,19,19,1994,2,"male",309,47,37,1,1,0,0,1,1
1421380,29,27,1984,7,"male",521,54,24,10,0,10,0,0,0
1421409,21,3,1992,7,"male",178,253,206,183,73,183,58,0,15
1421458,14,12,1999,1,"male",226,35,29,0,0,0,0,0,0
1421532,18,12,1995,11,"female",572,140,83,1,11,1,6,0,5
1421537,67,28,1946,5,"female",572,92,33,44,35,7,21,37,14
1421572,52,9,1961,5,"female",575,101,47,351,126,0,55,351,71
1421604,20,1,1993,4,"male",57,49,20,5,16,5,5,0,11
1421617,61,15,1952,5,"female",1102,69,38,11,22,6,5,5,17
1421653,39,14,1974,1,"male",114,10,5,1,0,1,0,0,0
1421656,24,1,1989,1,"male",616,0,0,0,0,0,0,0,0
1421678,26,31,1987,12,"female",349,51,28,4,1,0,1,4,0
1421721,38,16,1975,7,"female",506,122,60,369,259,81,87,288,172
1421739,54,9,1959,7,"male",414,297,197,658,628,657,372,1,256
1421742,108,25,1905,1,"male",623,1017,865,278,96,34,6,244,90
1421762,113,7,1900,6,"female",1707,82,47,25,26,0,16,25,10
1421794,70,14,1943,10,"male",1646,105,68,87,169,42,57,45,112
1421806,35,31,1978,12,"male",280,92,42,811,113,45,45,766,68
1421820,14,30,1999,6,"male",295,59,5,0,1,0,0,0,1
1421836,22,5,1991,6,"female",473,66,49,4,10,4,7,0,3
1421879,15,22,1998,7,"male",826,84,54,14,2,14,2,0,0
1421884,18,22,1995,4,"female",283,160,66,52,13,50,5,2,8
1421906,46,8,1967,11,"female",1559,419,273,776,408,776,264,0,144
1421912,56,10,1957,4,"female",1985,107,71,318,40,3,27,315,13
1421934,23,15,1990,7,"male",599,108,67,2,2,2,1,0,1
1421938,25,7,1988,12,"female",619,211,147,5,0,1,0,4,0
1421941,19,28,1994,2,"male",686,120,23,62,2,62,1,0,1
1422008,26,26,1987,2,"male",307,132,74,71,32,71,23,0,9
1422009,22,14,1991,1,"male",341,57,45,6,10,6,2,0,8
1422036,33,3,1980,3,"male",749,40,12,26,41,26,36,0,5
1422043,33,7,1980,4,"male",515,145,80,63,51,63,37,0,14
1422078,36,16,1977,6,"male",729,30,9,1,11,0,5,1,6
1422083,50,31,1963,7,"female",540,20,11,99,29,99,11,0,18
1422103,18,6,1995,7,"female",557,250,102,40,95,19,20,21,75
1422122,58,10,1955,10,"male",544,118,110,8,4,3,4,5,0
1422147,21,1,1992,12,"male",555,38,23,13,1,0,1,13,0
1422160,20,3,1993,5,"male",649,399,272,14,19,12,2,2,17
1422169,22,3,1991,3,"female",39,656,298,166,377,79,167,87,210
1422187,18,8,1995,1,"male",529,40,28,13,1,13,0,0,1
1422220,21,30,1992,4,"male",60,36,25,2,25,2,25,0,0
1422248,44,19,1969,5,"female",416,33,30,0,0,0,0,0,0
1422263,24,10,1989,1,"male",70,59,49,65,12,65,5,0,7
1422294,23,1,1990,12,"male",1187,221,105,3,23,3,19,0,4
1422296,108,1,1905,1,"male",19,13,11,0,0,0,0,0,0
1422365,99,25,1914,9,"female",973,126,108,127,329,127,266,0,63
1422370,39,25,1974,3,"male",358,27,5,0,0,0,0,0,0
1422391,42,11,1971,10,"female",571,50,32,16,35,1,4,15,31
1422393,40,4,1973,5,"female",635,219,113,8,4,8,3,0,1
1422405,26,23,1987,12,"male",22,21,6,3,0,3,0,0,0
1422410,23,3,1990,3,"male",266,55,44,17,4,0,0,17,4
1422424,37,26,1976,11,"male",694,59,33,3,51,3,30,0,21
1422449,14,23,1999,3,"male",284,118,51,1,1,1,0,0,1
1422477,28,25,1985,4,"male",433,21,16,68,11,68,9,0,2
1422499,26,18,1987,8,"male",532,131,118,59,0,59,0,0,0
1422519,19,16,1994,4,"female",938,69,59,511,66,509,61,2,5
1422528,19,21,1994,11,"male",408,239,162,123,129,47,86,76,43
1422544,36,16,1977,1,"female",171,130,89,67,56,67,17,0,39
1422555,23,12,1990,12,"female",436,54,30,3,11,0,1,3,10
1422578,43,8,1970,7,"male",483,120,112,1,25,0,14,1,11
1422579,33,8,1980,1,"male",281,20,17,3,1,3,0,0,1
1422603,26,12,1987,8,"male",661,1,0,0,0,0,0,0,0
1422620,35,27,1978,9,"female",47,89,35,74,62,74,53,0,9
1422632,63,25,1950,8,"male",1390,113,55,5,7,5,5,0,2
1422637,103,8,1910,8,"female",468,173,44,1,3,1,3,0,0
1422676,27,17,1986,10,"female",244,128,71,12,5,12,5,0,0
1422680,28,1,1985,1,"male",204,59,55,8,1,1,1,7,0
1422697,21,6,1992,6,"male",495,254,187,1,1,1,1,0,0
1422700,15,26,1998,3,"male",220,116,57,1,0,1,0,0,0
1422703,56,8,1957,1,"female",412,32,26,7,11,0,10,7,1
1422738,20,17,1993,8,"female",331,156,57,19,2,3,0,16,2
1422756,18,15,1995,6,"male",294,46,25,2,4,0,0,2,4
1422769,26,9,1987,9,"female",864,265,135,288,124,241,51,47,73
1422775,31,2,1982,2,"male",434,243,235,12,25,12,25,0,0
1422810,17,29,1996,11,"male",437,375,247,117,36,107,27,10,9
1422828,48,9,1965,3,"male",226,77,73,51,3,0,1,51,2
1422833,18,17,1995,1,"male",707,31,28,1,0,0,0,1,0
1422836,36,20,1977,6,"female",701,42,30,288,134,142,95,146,39
1422896,20,12,1993,9,"male",405,982,713,2124,1506,2124,905,0,601
1422901,98,25,1915,12,"female",1394,570,189,125,147,0,77,125,70
1422912,103,28,1910,4,"female",861,139,100,1279,41,1279,41,0,0
1422915,14,3,1999,5,"male",104,79,53,2,0,2,0,0,0
1422937,63,16,1950,10,"female",310,248,53,351,232,179,74,172,158
1422996,20,25,1993,12,"male",1597,1044,524,32,291,26,248,6,43
1422997,16,26,1997,3,"female",125,657,546,1561,710,1561,454,0,256
1423032,58,1,1955,11,"male",104,7,3,1,0,1,0,0,0
1423041,59,23,1954,12,"male",1835,182,83,0,11,0,8,0,3
1423042,20,29,1993,3,"female",1519,2669,940,769,1354,211,1003,558,351
1423052,23,20,1990,7,"female",21,11,7,1,1,0,1,1,0
1423064,108,24,1905,9,"male",122,66,42,55,18,55,12,0,6
1423091,16,8,1997,8,"male",242,32,14,0,3,0,3,0,0
1423108,15,3,1998,6,"female",500,4,2,0,0,0,0,0,0
1423140,61,25,1952,10,"male",173,84,62,46,102,46,38,0,64
1423144,23,12,1990,4,"female",462,18,5,13,17,13,17,0,0
1423153,21,15,1992,4,"male",342,40,11,2,0,2,0,0,0
1423156,13,20,2000,8,"male",672,96,39,0,0,0,0,0,0
1423181,70,15,1943,6,"male",1444,50,21,242,48,66,23,176,25
1423187,17,31,1996,1,"male",840,14,9,0,0,0,0,0,0
1423193,15,13,1998,8,"male",351,1037,903,616,281,616,249,0,32
1423204,20,1,1993,1,"male",32,156,149,269,71,268,71,1,0
1423248,108,10,1905,12,"male",222,28,27,22,0,4,0,18,0
1423269,28,29,1985,8,"female",429,107,59,38,19,38,14,0,5
1423270,14,24,1999,1,"male",517,74,66,14,1,0,1,14,0
1423291,18,27,1995,7,"male",1405,31,22,6,4,5,0,1,4
1423293,60,12,1953,4,"male",1515,123,74,1,3,0,3,1,0
1423321,22,14,1991,6,"female",271,241,108,127,265,51,98,76,167
1423329,22,15,1991,9,"female",50,37,16,0,3,0,3,0,0
1423339,108,18,1905,1,"male",46,4,3,0,0,0,0,0,0
1423340,15,1,1998,12,"male",224,131,48,111,24,25,13,86,11
1423343,71,16,1942,4,"male",702,59,42,4,0,0,0,4,0
1423344,20,12,1993,8,"male",820,652,564,13,12,13,10,0,2
1423373,108,29,1905,1,"male",1080,985,637,1203,187,380,123,823,64
1423380,50,6,1963,3,"male",215,73,69,93,353,93,231,0,122
1423383,53,1,1960,7,"male",543,178,115,94,100,0,43,94,57
1423391,18,18,1995,2,"male",236,113,93,0,0,0,0,0,0
1423398,28,1,1985,10,"female",219,5,4,0,0,0,0,0,0
1423406,25,18,1988,11,"male",987,325,170,2,2,2,2,0,0
1423433,103,6,1910,8,"female",359,706,418,5,2,5,1,0,1
1423442,24,4,1989,9,"male",475,186,98,144,0,120,0,24,0
1423527,41,22,1972,12,"male",330,65,1,1,42,0,5,1,37
1423535,21,11,1992,2,"female",580,124,66,0,3,0,3,0,0
1423536,27,26,1986,2,"male",385,31,13,0,0,0,0,0,0
1423574,29,27,1984,7,"female",110,41,25,57,15,57,11,0,4
1423578,30,8,1983,10,"male",414,28,14,10,5,6,3,4,2
1423608,29,28,1984,9,"male",276,41,30,0,0,0,0,0,0
1423646,31,13,1982,12,"male",248,1,0,0,0,0,0,0,0
1423662,99,3,1914,8,"female",2822,599,16,47,94,47,79,0,15
1423665,18,22,1995,11,"female",1465,1074,204,0,12,0,8,0,4
1423688,30,18,1983,11,"male",454,31,6,2,12,2,11,0,1
1423692,16,24,1997,6,"male",89,18,18,0,39,0,12,0,27
1423732,34,1,1979,1,"female",385,18,11,21,4,21,4,0,0
1423777,36,24,1977,2,"male",429,70,49,5,0,5,0,0,0
1423800,106,24,1907,11,"male",1327,87,43,38,13,26,7,12,6
1423802,22,23,1991,9,"male",246,79,60,26,59,26,27,0,32
1423803,27,9,1986,9,"male",407,27,12,15,9,0,0,15,9
1423809,15,10,1998,10,"male",24,31,23,12,5,12,4,0,1
1423823,32,16,1981,3,"male",1731,46,18,3,1,3,1,0,0
1423836,19,8,1994,7,"male",373,3,1,7,4,7,3,0,1
1423839,28,2,1985,2,"male",78,66,18,0,1,0,1,0,0
1423845,67,5,1946,12,"female",1842,57,28,317,60,313,44,4,16
1423853,24,15,1989,4,"male",690,178,70,40,4,40,4,0,0
1423862,43,28,1970,11,"female",457,282,192,768,290,171,34,597,256
1423874,73,8,1940,8,"male",1193,98,43,8,5,8,5,0,0
1423878,45,22,1968,9,"male",635,72,55,100,12,100,6,0,6
1423891,18,21,1995,5,"female",529,200,115,353,120,340,69,13,51
1423902,25,28,1988,8,"female",692,224,150,28,73,25,36,3,37
1423936,21,26,1992,7,"male",416,107,75,0,3,0,2,0,1
1423943,15,25,1998,7,"male",358,148,123,1,0,0,0,1,0
1423953,23,25,1990,12,"female",482,11,9,2,0,0,0,2,0
1423979,72,4,1941,4,"male",1511,441,84,11,23,11,22,0,1
1424036,18,24,1995,1,"female",229,132,91,6,4,1,1,5,3
1424043,46,22,1967,10,"male",83,9,8,0,0,0,0,0,0
1424107,17,17,1996,2,"male",433,102,99,322,4,14,3,308,1
1424168,51,19,1962,5,"female",385,174,130,23,329,23,121,0,208
1424189,43,1,1970,2,"male",1739,31,13,0,0,0,0,0,0
1424204,16,18,1997,2,"male",653,154,48,87,105,87,103,0,2
1424207,15,4,1998,6,"male",402,31,20,5,1,1,1,4,0
1424218,18,11,1995,12,"male",343,32,20,3,0,3,0,0,0
1424248,22,15,1991,2,"female",198,0,0,7,6,7,6,0,0
1424251,19,1,1994,8,"male",175,189,23,0,0,0,0,0,0
1424256,41,24,1972,5,"male",889,275,193,27,156,27,131,0,25
1424262,15,23,1998,2,"female",410,281,193,88,117,3,18,85,99
1424285,62,20,1951,1,"female",320,132,70,3,5,0,0,3,5
1424317,62,13,1951,2,"female",32,15,13,0,0,0,0,0,0
1424346,23,10,1990,3,"male",147,6,3,5,2,1,0,4,2
1424410,98,30,1915,11,"female",1328,27,16,135,12,2,0,133,12
1424414,91,21,1922,11,"male",189,276,170,44,35,42,32,2,3
1424438,24,9,1989,9,"male",214,38,19,0,2,0,1,0,1
1424487,36,23,1977,10,"male",759,68,42,15,15,15,14,0,1
1424489,17,5,1996,7,"female",713,702,352,2721,593,2682,229,39,364
1424506,28,20,1985,1,"female",280,13,10,9,9,2,0,7,9
1424527,16,18,1997,1,"male",194,1,0,0,0,0,0,0,0
1424538,19,2,1994,5,"female",334,469,119,189,129,189,83,0,46
1424557,40,1,1973,4,"male",381,24,11,845,272,539,205,306,67
1424566,61,11,1952,3,"male",995,100,91,238,16,4,13,234,3
1424599,73,25,1940,1,"male",1498,83,31,0,0,0,0,0,0
1424634,18,12,1995,10,"female",239,2227,1144,1201,10905,1110,6620,91,4285
1424637,93,9,1920,8,"female",1726,114,15,42,11,4,6,38,5
1424719,14,7,1999,3,"male",363,103,81,32,3,32,0,0,3
1424721,19,17,1994,11,"male",120,87,37,5,16,5,8,0,8
1424742,16,22,1997,5,"female",489,453,340,69,410,44,323,25,87
1424753,18,6,1995,6,"male",308,321,160,10,0,10,0,0,0
1424766,20,5,1993,4,"male",360,60,43,9,3,0,0,9,3
1424787,83,15,1930,3,"female",61,23,18,0,10,0,9,0,1
1424808,18,28,1995,7,"male",718,122,16,0,0,0,0,0,0
1424828,59,24,1954,4,"female",81,17,10,98,23,0,17,98,6
1424842,50,25,1963,7,"male",242,43,11,3,0,3,0,0,0
1424844,63,24,1950,3,"male",1159,117,46,5,6,3,4,2,2
1424858,56,8,1957,7,"male",1057,82,46,0,0,0,0,0,0
1424860,100,2,1913,10,"female",1599,467,328,50,92,0,16,50,76
1424987,33,4,1980,3,"male",562,35,27,40,1,40,1,0,0
1425047,18,27,1995,6,"female",139,337,129,14,26,4,19,10,7
1425075,18,23,1995,6,"male",105,66,55,0,0,0,0,0,0
1425141,46,31,1967,5,"male",217,62,54,140,12,0,9,140,3
1425145,23,29,1990,4,"female",759,428,239,1,5,1,5,0,0
1425194,26,1,1987,7,"male",663,29,17,1,1,1,1,0,0
1425197,35,13,1978,3,"male",318,213,145,148,46,148,39,0,7
1425205,55,23,1958,9,"female",1011,100,84,202,21,202,12,0,9
1425208,62,17,1951,11,"female",1264,117,29,586,295,84,156,502,139
1425225,20,12,1993,8,"male",261,108,100,4,1,4,1,0,0
1425229,51,17,1962,3,"female",1963,111,62,1751,982,1047,715,704,267
1425230,14,12,1999,4,"female",95,19,6,70,63,0,38,70,25
1425233,50,30,1963,7,"female",733,215,120,131,114,131,105,0,9
1425265,18,5,1995,9,"female",800,716,455,796,1328,193,576,603,752
1425271,19,6,1994,2,"female",551,27,6,367,19,364,14,3,5
1425288,24,15,1989,11,"female",219,4587,583,2776,6652,171,4245,2605,2407
1425300,19,10,1994,11,"male",303,127,48,67,303,67,277,0,26
1425341,74,4,1939,10,"female",424,83,76,14,7,1,2,13,5
1425397,19,13,1994,1,"female",21,27,21,229,367,154,128,75,239
1425398,56,5,1957,1,"male",1458,93,32,81,81,81,12,0,69
1425416,21,14,1992,6,"male",58,341,300,83,477,83,373,0,104
1425435,41,14,1972,4,"male",771,0,0,0,0,0,0,0,0
1425458,38,31,1975,8,"male",1366,131,84,7,3,5,2,2,1
1425470,64,22,1949,11,"female",1624,193,85,26,12,8,7,18,5
1425495,42,17,1971,8,"female",231,29,17,192,4,192,4,0,0
1425512,34,3,1979,1,"female",467,257,125,270,333,253,223,17,110
1425557,35,27,1978,12,"female",203,116,60,386,170,386,151,0,19
1425571,33,25,1980,5,"female",595,15,10,0,1,0,1,0,0
1425587,18,5,1995,7,"male",381,12,5,53,6,53,1,0,5
1425599,28,16,1985,9,"female",299,22,10,0,0,0,0,0,0
1425618,108,1,1905,4,"female",1628,256,111,188,97,0,25,188,72
1425632,14,25,1999,7,"male",62,40,33,11,0,7,0,4,0
1425642,23,14,1990,4,"male",378,2,2,0,0,0,0,0,0
1425656,57,18,1956,10,"male",1581,35,14,7,5,5,3,2,2
1425657,27,20,1986,8,"female",224,45,30,481,45,0,20,481,25
1425728,71,14,1942,2,"female",1343,55,16,95,22,95,14,0,8
1425755,35,24,1978,2,"male",324,16,7,0,0,0,0,0,0
1425834,58,18,1955,2,"female",436,87,49,618,203,0,27,618,176
1425841,39,6,1974,8,"male",675,31,16,5,5,5,2,0,3
1425883,30,31,1983,5,"male",795,259,104,11,74,11,26,0,48
1425932,23,4,1990,5,"male",1454,183,77,15,4,7,2,8,2
1425934,37,5,1976,5,"female",1340,436,273,2336,1611,1912,1064,424,547
1425953,21,1,1992,7,"female",415,423,117,122,45,48,12,74,33
1425990,28,5,1985,11,"female",213,208,161,594,475,594,371,0,104
1426009,78,15,1935,10,"female",1609,191,78,1119,103,0,62,1119,41
1426018,45,14,1968,8,"female",174,80,39,5,39,5,33,0,6
1426023,17,28,1996,6,"male",461,202,126,0,1,0,1,0,0
1426037,32,12,1981,5,"male",617,103,72,0,0,0,0,0,0
1426052,49,5,1964,5,"male",142,29,11,21,20,0,3,21,17
1426059,27,13,1986,1,"female",334,154,93,109,77,0,6,109,71
1426085,19,4,1994,10,"male",168,51,34,14,68,14,2,0,66
1426098,33,17,1980,9,"female",257,80,61,10,15,0,1,10,14
1426099,79,14,1934,11,"female",631,41,33,91,8,0,2,91,6
1426103,17,1,1996,1,"female",605,1684,463,326,276,156,116,170,160
1426115,24,13,1989,2,"female",278,220,119,48,18,30,6,18,12
1426125,24,22,1989,10,"male",114,5,3,42,34,42,32,0,2
1426135,37,19,1976,8,"male",633,46,39,1,0,0,0,1,0
1426143,33,20,1980,4,"male",353,161,100,1,14,1,9,0,5
1426155,17,1,1996,1,"male",366,156,102,8,1,1,0,7,1
1426192,22,12,1991,10,"male",472,190,122,5,22,2,5,3,17
1426203,28,5,1985,5,"male",416,16,12,0,0,0,0,0,0
1426218,23,1,1990,1,"male",289,9,9,10,3,7,2,3,1
1426247,66,9,1947,12,"male",1515,82,36,0,4,0,1,0,3
1426254,18,10,1995,12,"male",110,115,103,2,0,1,0,1,0
1426275,27,27,1986,3,"female",36,44,21,450,78,450,26,0,52
1426317,21,3,1992,11,"male",614,24,20,3,1,3,1,0,0
1426326,46,28,1967,1,"male",1414,164,72,2,4,2,4,0,0
1426329,81,29,1932,6,"male",1461,26,16,6,3,0,1,6,2
1426330,55,25,1958,9,"female",185,75,50,8,26,0,15,8,11
1426339,18,12,1995,7,"male",496,150,119,0,17,0,16,0,1
1426347,16,18,1997,10,"male",327,31,9,8,4,0,0,8,4
1426349,13,2,2000,1,"female",176,551,403,265,492,173,223,92,269
1426353,21,8,1992,3,"male",262,22,18,2,0,2,0,0,0
1426368,103,23,1910,10,"female",1373,308,100,2,20,2,16,0,4
1426370,20,26,1993,3,"male",219,283,254,19,97,3,32,16,65
1426421,32,15,1981,7,"female",541,34,16,17,10,17,7,0,3
1426476,33,1,1980,1,"female",1558,31,11,1043,302,1042,140,1,162
1426478,56,17,1957,4,"male",90,12,9,9,8,9,3,0,5
1426482,18,1,1995,4,"male",97,15,12,0,0,0,0,0,0
1426483,32,2,1981,5,"male",401,81,59,18,27,16,22,2,5
1426490,42,3,1971,3,"male",263,4,1,0,0,0,0,0,0
1426506,19,23,1994,10,"male",85,96,44,48,109,43,63,5,46
1426524,14,14,1999,2,"male",143,295,272,49,14,49,8,0,6
1426563,16,5,1997,7,"female",533,230,118,131,67,57,56,74,11
1426576,34,13,1979,11,"female",852,259,181,530,409,184,247,346,162
1426610,19,11,1994,4,"male",178,109,79,1,31,1,23,0,8
1426668,28,31,1985,8,"female",30,233,221,96,29,96,16,0,13
1426724,30,3,1983,3,"female",508,149,141,0,0,0,0,0,0
1426743,24,24,1989,5,"male",325,205,11,46,455,20,354,26,101
1426745,108,16,1905,10,"male",182,475,465,0,0,0,0,0,0
1426764,21,23,1992,7,"male",405,130,13,0,1,0,1,0,0
1426793,24,5,1989,1,"female",503,23,5,0,1,0,0,0,1
1426794,50,20,1963,11,"male",356,88,54,50,4,49,0,1,4
1426795,28,26,1985,6,"male",802,0,0,0,0,0,0,0,0
1426814,24,7,1989,11,"female",401,70,12,0,0,0,0,0,0
1426852,24,30,1989,4,"male",44,59,36,636,570,636,462,0,108
1426875,41,4,1972,6,"male",362,28,17,0,0,0,0,0,0
1426876,43,19,1970,3,"male",121,0,0,0,0,0,0,0,0
1426900,33,16,1980,8,"male",13,6,4,0,0,0,0,0,0
1426906,23,10,1990,5,"male",443,45,34,0,0,0,0,0,0
1426914,47,15,1966,6,"male",610,31,17,1,0,1,0,0,0
1426936,17,14,1996,2,"male",808,297,188,1,0,0,0,1,0
1426945,26,5,1987,10,"male",318,66,49,1,0,1,0,0,0
1426955,34,25,1979,3,"female",329,74,55,2,13,2,13,0,0
1426965,17,10,1996,11,"male",36,169,142,461,162,461,76,0,86
1426969,21,24,1992,4,"male",819,86,40,0,0,0,0,0,0
1426973,43,20,1970,3,"female",108,14,8,124,3,124,3,0,0
1426978,15,29,1998,4,"male",181,199,103,173,23,173,21,0,2
1426981,63,11,1950,2,"female",216,69,41,578,133,578,54,0,79
1427003,41,6,1972,10,"male",288,8,7,1,7,1,5,0,2
1427016,15,6,1998,3,"female",349,195,61,181,285,121,194,60,91
1427019,16,4,1997,4,"male",602,423,234,19,58,19,54,0,4
1427034,20,21,1993,4,"male",530,185,118,216,147,216,134,0,13
1427065,18,15,1995,12,"female",2,19,15,93,102,0,14,93,88
1427071,33,26,1980,9,"male",75,63,53,7,10,7,4,0,6
1427073,67,13,1946,10,"male",322,75,28,8,20,4,12,4,8
1427083,18,5,1995,3,"male",356,374,319,0,0,0,0,0,0
1427092,108,28,1905,2,"male",1647,216,99,26,11,0,1,26,10
1427162,25,1,1988,1,"male",135,102,99,0,23,0,16,0,7
1427167,28,2,1985,12,"male",265,14,13,25,5,25,5,0,0
1427171,15,14,1998,1,"female",201,181,67,2084,364,2084,252,0,112
1427181,23,30,1990,4,"female",85,60,25,0,0,0,0,0,0
1427207,44,30,1969,7,"male",32,1,0,0,0,0,0,0,0
1427216,57,16,1956,12,"female",1259,79,52,132,32,18,11,114,21
1427232,16,19,1997,11,"male",657,206,58,112,9,112,8,0,1
1427233,50,1,1963,11,"male",452,22,6,3,2,0,0,3,2
1427286,39,25,1974,12,"female",186,73,31,1,2,1,2,0,0
1427300,17,13,1996,2,"female",169,32,15,2,2,2,2,0,0
1427308,26,17,1987,8,"male",818,498,429,5,1,5,1,0,0
1427343,49,3,1964,8,"male",393,8,6,0,0,0,0,0,0
1427355,108,6,1905,9,"female",1121,117,21,1,5,1,5,0,0
1427356,17,16,1996,5,"male",536,263,157,0,3,0,3,0,0
1427363,64,17,1949,10,"male",1286,166,69,4,23,4,21,0,2
1427376,48,10,1965,12,"female",638,40,27,113,67,113,57,0,10
1427378,67,6,1946,4,"female",551,25,10,0,0,0,0,0,0
1427426,103,1,1910,1,"female",1201,156,116,4,3,3,3,1,0
1427457,26,11,1987,5,"female",288,88,75,9,36,9,20,0,16
1427462,76,23,1937,12,"male",1566,106,45,117,45,117,12,0,33
1427463,40,23,1973,5,"male",680,140,79,0,64,0,28,0,36
1427488,29,21,1984,9,"male",1052,106,66,163,6,163,6,0,0
1427497,20,7,1993,12,"male",148,9,5,0,0,0,0,0,0
1427520,54,19,1959,2,"male",531,104,89,5,0,5,0,0,0
1427522,20,12,1993,9,"female",452,250,65,21,100,21,78,0,22
1427545,21,28,1992,12,"female",23,0,0,62,2,4,0,58,2
1427564,25,6,1988,4,"female",146,29,20,2,2,2,2,0,0
1427567,40,7,1973,9,"male",644,79,20,10,2,10,2,0,0
1427582,53,21,1960,5,"male",240,4,4,3,0,3,0,0,0
1427609,30,2,1983,11,"male",402,130,87,316,59,241,41,75,18
1427614,18,18,1995,2,"male",194,42,35,1,0,1,0,0,0
1427638,26,25,1987,8,"male",604,65,44,1,3,1,3,0,0
1427641,28,17,1985,4,"male",541,4,4,0,4,0,1,0,3
1427642,45,18,1968,11,"female",538,64,28,0,0,0,0,0,0
1427644,56,26,1957,3,"male",877,24,17,109,49,109,27,0,22
1427665,74,28,1939,5,"male",1303,416,342,3,5,3,2,0,3
1427674,39,21,1974,4,"male",844,12,8,0,1,0,1,0,0
1427680,57,4,1956,1,"female",1618,48,17,18,11,17,6,1,5
1427686,37,30,1976,9,"male",617,57,28,20,27,20,12,0,15
1427707,38,11,1975,10,"male",156,71,47,838,343,838,193,0,150
1427765,28,26,1985,11,"male",347,71,61,3,1,3,1,0,0
1427823,27,10,1986,10,"female",433,549,372,26,231,26,220,0,11
1427837,26,11,1987,12,"male",575,24,16,0,0,0,0,0,0
1427872,20,13,1993,9,"male",620,382,250,0,1,0,0,0,1
1427876,17,1,1996,1,"male",465,0,0,0,0,0,0,0,0
1427879,55,29,1958,9,"male",860,151,71,273,393,137,233,136,160
1427880,26,1,1987,1,"female",216,79,65,349,117,349,112,0,5
1427886,15,1,1998,4,"male",370,510,331,2,0,2,0,0,0
1427900,29,12,1984,1,"female",503,66,29,179,175,178,113,1,62
1427927,18,16,1995,8,"male",248,166,129,5,10,5,4,0,6
1427928,14,20,1999,9,"female",71,513,109,42,289,40,233,2,56
1427948,20,10,1993,5,"female",270,196,70,117,115,117,52,0,63
1427962,63,2,1950,4,"male",1979,122,59,5,81,4,62,1,19
1427978,32,4,1981,4,"male",1009,86,37,44,10,44,10,0,0
1427991,14,3,1999,3,"female",149,324,261,655,120,655,116,0,4
1428006,21,15,1992,2,"female",637,327,118,140,113,140,109,0,4
1428051,59,24,1954,7,"male",1272,66,31,1,1,1,1,0,0
1428052,18,1,1995,9,"female",332,112,97,150,191,128,143,22,48
1428053,20,12,1993,11,"female",72,90,85,15,19,15,14,0,5
1428058,63,13,1950,10,"female",465,94,48,37,46,0,11,37,35
1428064,21,10,1992,10,"male",532,240,185,0,0,0,0,0,0
1428081,27,8,1986,10,"male",813,117,51,1,2,1,2,0,0
1428084,77,12,1936,3,"female",314,18,5,59,1,59,0,0,1
1428092,16,15,1997,5,"male",230,150,102,0,0,0,0,0,0
1428103,47,15,1966,8,"female",515,70,13,0,0,0,0,0,0
1428110,19,18,1994,11,"male",456,883,682,26,74,17,52,9,22
1428111,18,16,1995,5,"male",285,116,85,21,5,21,5,0,0
1428113,61,18,1952,10,"male",458,233,211,17,128,0,15,17,113
1428132,19,13,1994,6,"male",14,15,8,0,0,0,0,0,0
1428136,17,18,1996,7,"male",407,32,29,12,14,1,1,11,13
1428153,31,30,1982,7,"male",1058,168,127,5,16,2,15,3,1
1428159,51,26,1962,5,"female",668,1,0,0,0,0,0,0,0
1428161,33,18,1980,6,"male",151,18,9,0,0,0,0,0,0
1428175,29,21,1984,12,"female",1419,105,58,164,159,46,107,118,52
1428191,21,23,1992,7,"male",330,174,136,60,220,55,93,5,127
1428192,40,6,1973,12,"female",336,9,8,0,0,0,0,0,0
1428212,35,21,1978,3,"male",225,13,10,19,3,19,3,0,0
1428214,19,26,1994,6,"male",336,146,88,31,15,31,9,0,6
1428233,19,13,1994,3,"male",194,30,24,0,0,0,0,0,0
1428263,31,1,1982,9,"male",483,48,19,10,27,6,15,4,12
1428264,14,6,1999,7,"male",245,40,22,3,0,3,0,0,0
1428312,39,13,1974,12,"male",283,30,5,0,1,0,1,0,0
1428333,30,13,1983,3,"male",297,2,1,0,0,0,0,0,0
1428344,43,2,1970,2,"female",649,4,2,0,0,0,0,0,0
1428378,33,27,1980,12,"female",342,19,12,0,0,0,0,0,0
1428379,73,6,1940,12,"male",1168,54,21,0,0,0,0,0,0
1428382,101,19,1912,9,"male",737,163,102,279,59,0,32,279,27
1428399,19,17,1994,2,"male",89,26,16,17,3,17,3,0,0
1428412,14,29,1999,3,"male",14,11,11,35,1,0,0,35,1
1428430,27,18,1986,8,"female",389,79,66,13,3,13,3,0,0
1428440,20,20,1993,5,"male",203,12,7,0,1,0,1,0,0
1428449,94,20,1919,11,"male",768,194,129,17,14,10,8,7,6
1428473,28,25,1985,10,"male",482,82,60,28,6,26,5,2,1
1428477,69,13,1944,12,"female",159,5,4,0,0,0,0,0,0
1428478,21,16,1992,2,"female",237,75,41,10,12,10,10,0,2
1428539,17,1,1996,1,"male",28,142,142,35,7,35,7,0,0
1428551,16,10,1997,5,"male",615,107,62,5,0,5,0,0,0
1428572,29,15,1984,3,"male",397,128,78,64,145,64,84,0,61
1428574,23,22,1990,8,"male",356,105,55,3,5,0,0,3,5
1428586,25,8,1988,3,"male",161,37,25,49,3,49,3,0,0
1428620,21,19,1992,6,"male",322,721,592,64,14,59,11,5,3
1428656,46,17,1967,1,"female",945,226,142,60,176,31,144,29,32
1428657,37,9,1976,1,"male",740,8,2,0,0,0,0,0,0
1428665,16,16,1997,5,"male",204,49,39,0,22,0,11,0,11
1428667,19,1,1994,3,"male",314,214,107,7,4,0,3,7,1
1428694,21,22,1992,5,"female",233,59,42,1,1,0,0,1,1
1428708,43,29,1970,6,"male",177,3,2,0,0,0,0,0,0
1428743,58,29,1955,10,"female",1888,133,80,618,278,571,167,47,111
1428745,21,15,1992,7,"male",603,127,106,7,0,7,0,0,0
1428751,67,17,1946,6,"female",443,89,65,17,14,1,10,16,4
1428775,25,8,1988,8,"male",608,136,106,0,10,0,8,0,2
1428787,24,7,1989,5,"female",134,61,41,37,1,37,1,0,0
1428818,23,3,1990,3,"female",552,650,460,17,8,17,7,0,1
1428841,23,4,1990,7,"male",361,401,316,543,170,0,115,543,55
1428850,26,30,1987,5,"male",383,39,29,0,0,0,0,0,0
1428901,23,23,1990,1,"female",293,0,0,0,0,0,0,0,0
1428902,50,21,1963,10,"female",391,38,26,36,56,3,23,33,33
1428924,31,30,1982,5,"male",1171,331,148,21,11,7,2,14,9
1428950,17,20,1996,9,"male",414,461,427,37,3,0,3,37,0
1428973,18,27,1995,3,"male",286,847,735,78,409,78,255,0,154
1428994,29,20,1984,3,"male",456,49,17,0,10,0,4,0,6
1429000,14,6,1999,7,"male",42,27,25,24,6,24,6,0,0
1429043,65,1,1948,11,"male",1881,144,10,5,13,5,13,0,0
1429068,36,14,1977,9,"female",19,35,11,2,3,2,2,0,1
1429085,31,15,1982,1,"female",1513,111,45,1484,1629,839,1152,645,477
1429087,19,9,1994,7,"male",713,585,389,253,259,152,23,101,236
1429098,15,7,1998,4,"female",469,2397,510,2065,1489,2027,1109,38,380
1429105,25,9,1988,6,"male",414,248,173,83,73,79,45,4,28
1429139,66,6,1947,11,"male",1335,175,124,43,23,21,12,22,11
1429170,24,9,1989,9,"male",715,210,119,40,33,23,16,17,17
1429173,15,10,1998,2,"male",509,652,256,388,863,193,646,195,217
1429176,24,21,1989,8,"male",763,117,53,1,0,1,0,0,0
1429186,56,22,1957,7,"female",357,29,21,0,0,0,0,0,0
1429211,23,29,1990,3,"male",253,145,95,0,6,0,4,0,2
1429227,23,28,1990,11,"male",296,132,117,14,3,0,1,14,2
1429236,29,26,1984,11,"male",486,77,63,1,0,0,0,1,0
1429244,18,12,1995,6,"male",121,118,99,49,27,49,8,0,19
1429251,22,5,1991,6,"female",555,26,17,0,6,0,3,0,3
1429268,18,28,1995,4,"male",690,190,111,0,3,0,0,0,3
1429291,18,11,1995,10,"male",655,745,399,16,17,4,5,12,12
1429305,32,31,1981,12,"female",327,52,23,8,0,5,0,3,0
1429308,46,6,1967,5,"male",508,8,3,4,0,4,0,0,0
1429312,65,26,1948,5,"male",66,8,4,2,3,0,2,2,1
1429321,17,14,1996,8,"male",453,124,94,34,0,0,0,34,0
1429349,39,23,1974,7,"male",145,47,44,7,0,7,0,0,0
1429353,37,26,1976,11,"female",523,56,25,253,164,191,90,62,74
1429366,55,12,1958,12,"male",809,15,7,1,2,1,2,0,0
1429384,47,7,1966,11,"female",177,38,25,8,0,8,0,0,0
1429390,22,1,1991,1,"male",67,18,13,0,0,0,0,0,0
1429424,43,27,1970,1,"male",984,246,175,0,26,0,24,0,2
1429457,67,16,1946,3,"male",191,30,9,0,0,0,0,0,0
1429485,18,2,1995,9,"female",629,376,205,566,570,347,294,219,276
1429515,29,1,1984,5,"male",60,15,15,1,0,1,0,0,0
1429527,19,19,1994,3,"female",330,672,350,1037,1339,168,301,869,1038
1429541,23,3,1990,5,"female",690,154,35,0,0,0,0,0,0
1429563,20,29,1993,1,"male",147,64,20,93,124,93,54,0,70
1429597,19,17,1994,12,"male",144,38,18,1,3,1,2,0,1
1429598,17,13,1996,12,"male",260,219,143,209,47,167,33,42,14
1429600,29,15,1984,12,"female",73,6,6,0,0,0,0,0,0
1429606,21,6,1992,12,"male",629,213,160,2,1,1,1,1,0
1429625,16,17,1997,3,"female",691,509,74,0,4,0,4,0,0
1429635,17,27,1996,8,"male",424,190,151,55,63,55,24,0,39
1429647,20,21,1993,12,"male",770,117,72,39,23,0,12,39,11
1429672,22,21,1991,11,"male",626,120,75,80,9,79,9,1,0
1429680,19,26,1994,3,"male",444,128,83,7,0,0,0,7,0
1429692,28,22,1985,1,"male",805,45,39,0,0,0,0,0,0
1429742,25,8,1988,8,"female",413,14,14,5,2,5,2,0,0
1429764,37,26,1976,1,"male",475,10,8,157,16,157,14,0,2
1429769,38,22,1975,9,"female",1724,5,5,4,40,3,38,1,2
1429773,34,8,1979,3,"female",170,2,2,18,8,18,7,0,1
1429778,40,12,1973,1,"female",174,29,18,37,19,37,17,0,2
1429804,19,13,1994,6,"female",517,216,20,3,35,3,29,0,6
1429809,22,1,1991,2,"male",147,1,1,1,0,0,0,1,0
1429817,15,26,1998,2,"female",150,191,85,13,25,9,18,4,7
1429831,29,16,1984,11,"female",63,106,99,2,1,1,0,1,1
1429837,31,22,1982,5,"female",2152,620,360,469,752,188,306,281,446
1429846,52,12,1961,6,"female",392,30,23,1486,554,1486,173,0,381
1429867,14,2,1999,7,"male",359,104,70,57,9,57,5,0,4
1429876,32,6,1981,4,"male",1120,2694,1105,3,38,3,33,0,5
1429910,18,15,1995,9,"female",667,1162,329,10762,11783,6669,6630,4093,5153
1429916,24,15,1989,7,"male",5,4,4,0,0,0,0,0,0
1429922,18,21,1995,7,"male",28,1,1,0,0,0,0,0,0
1429927,47,7,1966,9,"female",186,26,20,13,37,13,27,0,10
1430015,44,1,1969,6,"male",507,92,48,2,4,0,4,2,0
1430027,48,24,1965,12,"female",272,20,6,169,38,0,26,169,12
1430056,19,18,1994,10,"male",366,18,14,3,3,3,3,0,0
1430076,18,22,1995,11,"male",759,2,2,0,0,0,0,0,0
1430096,21,20,1992,9,"female",279,130,93,0,0,0,0,0,0
1430109,21,29,1992,7,"male",421,9,6,0,0,0,0,0,0
1430111,42,3,1971,5,"male",195,2,2,0,0,0,0,0,0
1430175,17,4,1996,10,"female",472,844,538,496,297,496,265,0,32
1430180,23,1,1990,1,"female",506,1,1,2,1,2,1,0,0
1430183,23,17,1990,8,"male",490,552,472,26,58,26,40,0,18
1430221,37,20,1976,11,"male",614,491,319,338,1368,332,1250,6,118
1430237,23,7,1990,6,"male",121,31,17,15,5,15,4,0,1
1430239,25,25,1988,5,"male",489,0,0,0,0,0,0,0,0
1430267,68,3,1945,8,"male",573,659,434,258,189,258,179,0,10
1430288,20,29,1993,11,"female",199,238,171,712,314,617,159,95,155
1430307,21,19,1992,3,"female",550,373,147,68,129,49,35,19,94
1430313,103,28,1910,5,"male",72,22,15,5,4,5,4,0,0
1430316,30,27,1983,1,"male",206,0,0,0,0,0,0,0,0
1430390,17,10,1996,5,"male",119,5,4,0,0,0,0,0,0
1430427,34,22,1979,7,"male",92,92,89,1,0,1,0,0,0
1430448,61,5,1952,8,"female",904,64,27,41,8,0,0,41,8
1430458,65,22,1948,4,"female",1496,104,15,115,39,14,17,101,22
1430478,108,1,1905,1,"male",1734,58,23,28,10,3,7,25,3
1430507,21,7,1992,1,"male",431,49,30,48,9,48,8,0,1
1430524,19,30,1994,5,"male",42,80,73,58,102,30,58,28,44
1430544,36,20,1977,4,"male",303,25,21,49,0,24,0,25,0
1430583,102,2,1911,4,"female",833,1765,506,356,2065,356,1387,0,678
1430616,39,17,1974,8,"female",422,61,33,0,9,0,3,0,6
1430639,47,24,1966,10,"male",855,85,28,56,84,0,9,56,75
1430694,41,27,1972,11,"male",456,34,14,4,6,4,4,0,2
1430696,52,30,1961,12,"female",1525,78,36,42,86,42,39,0,47
1430699,24,15,1989,7,"male",142,1,0,0,0,0,0,0,0
1430703,13,3,2000,5,"female",111,271,214,14,2,11,0,3,2
1430725,65,19,1948,9,"male",1093,30,13,0,0,0,0,0,0
1430786,19,25,1994,11,"female",206,338,160,785,729,755,240,30,489
1430792,20,28,1993,3,"male",422,219,188,0,0,0,0,0,0
1430801,19,25,1994,5,"male",600,492,360,211,210,127,187,84,23
1430802,17,24,1996,11,"male",732,1,1,0,0,0,0,0,0
1430829,94,20,1919,10,"female",163,167,113,0,1,0,1,0,0
1430832,63,22,1950,3,"female",299,147,103,35,94,0,34,35,60
1430848,18,12,1995,5,"male",797,1081,715,167,71,0,30,167,41
1430853,27,8,1986,5,"male",5,0,0,2,0,2,0,0,0
1430882,47,25,1966,8,"male",457,684,587,44,49,23,30,21,19
1430946,36,1,1977,10,"male",412,275,153,7,1,7,1,0,0
1430960,25,16,1988,7,"male",500,310,149,4,10,4,9,0,1
1430983,72,11,1941,2,"male",575,5,3,2,0,2,0,0,0
1430984,26,10,1987,5,"male",543,574,460,124,42,124,32,0,10
1430987,27,3,1986,1,"male",22,0,0,0,2,0,2,0,0
1430990,17,29,1996,2,"female",291,33,26,1,0,1,0,0,0
1431046,52,20,1961,5,"male",780,78,19,1,37,0,14,1,23
1431060,17,5,1996,4,"male",0,0,0,0,0,0,0,0,0
1431070,65,7,1948,9,"male",1073,99,53,54,60,54,40,0,20
1431078,28,1,1985,3,"male",322,17,15,1,10,1,7,0,3
1431110,61,17,1952,4,"male",559,4,3,0,0,0,0,0,0
1431113,18,4,1995,2,"female",34,30,28,289,211,250,134,39,77
1431122,37,24,1976,1,"female",281,69,45,112,41,111,33,1,8
1431142,25,4,1988,5,"male",356,43,32,36,1,36,1,0,0
1431179,51,6,1962,2,"female",342,9,7,5,0,4,0,1,0
1431211,46,7,1967,6,"male",338,77,32,173,28,147,23,26,5
1431233,23,17,1990,11,"male",577,96,49,70,76,70,26,0,50
1431245,69,5,1944,7,"male",1021,8,4,2,68,0,28,2,40
1431254,31,5,1982,5,"male",476,490,414,0,0,0,0,0,0
1431283,30,4,1983,6,"female",379,301,227,740,306,740,104,0,202
1431293,16,17,1997,11,"female",196,227,120,944,452,641,369,303,83
1431309,21,28,1992,1,"female",754,210,93,78,57,56,27,22,30
1431336,56,5,1957,10,"female",230,92,60,56,11,53,1,3,10
1431352,49,27,1964,1,"female",482,49,13,33,4,0,0,33,4
1431354,49,28,1964,11,"male",492,38,30,418,15,0,13,418,2
1431374,18,29,1995,3,"male",193,77,67,3,0,2,0,1,0
1431381,22,21,1991,2,"male",416,328,300,22,23,6,10,16,13
1431418,31,11,1982,3,"female",512,52,15,2,17,1,11,1,6
1431462,28,25,1985,11,"female",530,15,6,0,0,0,0,0,0
1431473,32,25,1981,9,"male",416,70,41,0,0,0,0,0,0
1431487,46,4,1967,8,"female",1332,42,14,12,23,12,18,0,5
1431505,65,18,1948,6,"female",1699,81,48,1281,424,8,221,1273,203
1431519,34,9,1979,2,"female",376,381,313,427,586,338,250,89,336
1431531,21,7,1992,3,"female",931,5,5,1,1,0,1,1,0
1431539,84,23,1929,4,"female",2352,134,85,50,54,50,30,0,24
1431572,30,4,1983,7,"female",880,295,171,24,67,24,62,0,5
1431573,105,15,1908,8,"male",454,138,53,0,0,0,0,0,0
1431583,64,7,1949,2,"male",1783,83,21,82,62,2,26,80,36
1431584,22,22,1991,5,"male",122,64,54,2,0,2,0,0,0
1431586,75,19,1938,10,"male",764,17,5,0,0,0,0,0,0
1431606,55,2,1958,5,"male",272,24,11,0,0,0,0,0,0
1431611,46,1,1967,1,"male",57,22,22,4,2,4,2,0,0
1431620,65,2,1948,10,"female",978,59,22,12,32,11,9,1,23
1431643,18,17,1995,8,"male",125,153,1,4,20,0,15,4,5
1431654,14,14,1999,9,"female",179,335,213,46,77,19,12,27,65
1431672,19,31,1994,7,"male",477,240,75,27,27,27,26,0,1
1431673,61,26,1952,11,"female",1761,89,37,195,6,168,2,27,4
1431674,53,6,1960,10,"female",689,184,59,10,10,9,0,1,10
1431682,65,20,1948,11,"male",622,14,9,1,0,0,0,1,0
1431684,16,4,1997,10,"male",21,52,38,5,2,5,2,0,0
1431705,44,16,1969,8,"male",500,47,34,1,3,0,1,1,2
1431708,18,25,1995,7,"male",574,119,36,0,0,0,0,0,0
1431715,56,1,1957,1,"male",497,4,1,3,0,3,0,0,0
1431741,30,6,1983,5,"female",277,317,271,7,12,7,8,0,4
1431753,27,16,1986,12,"female",375,183,76,0,0,0,0,0,0
1431773,26,1,1987,1,"male",417,18,13,3,0,3,0,0,0
1431786,40,8,1973,12,"female",261,1,1,4,2,4,1,0,1
1431788,45,10,1968,10,"male",197,57,41,0,0,0,0,0,0
1431830,25,7,1988,10,"female",385,253,174,225,82,225,71,0,11
1431874,24,11,1989,7,"female",462,199,107,0,22,0,1,0,21
1431904,15,13,1998,9,"male",261,171,62,603,356,125,175,478,181
1431908,100,28,1913,12,"male",1723,524,138,116,399,104,265,12,134
1431942,77,25,1936,7,"male",987,33,15,0,0,0,0,0,0
1431950,18,21,1995,9,"female",295,203,92,159,261,127,187,32,74
1431951,22,23,1991,2,"male",639,152,141,8,4,0,1,8,3
1431955,14,14,1999,10,"female",123,535,325,24,173,24,122,0,51
1431969,38,4,1975,2,"male",496,8,8,0,0,0,0,0,0
1432020,53,10,1960,8,"female",1650,54,32,729,124,158,17,571,107
1432030,56,17,1957,11,"female",904,46,18,0,0,0,0,0,0
1432049,15,10,1998,8,"male",28,67,65,0,0,0,0,0,0
1432080,23,25,1990,12,"male",194,79,68,0,0,0,0,0,0
1432110,20,10,1993,2,"male",817,121,73,2,1,2,1,0,0
1432134,49,28,1964,5,"female",218,2,2,22,2,0,0,22,2
1432135,69,8,1944,12,"female",1640,234,130,327,80,282,41,45,39
1432136,19,10,1994,10,"male",274,146,88,1,10,1,8,0,2
1432163,26,14,1987,7,"male",203,77,41,117,52,117,49,0,3
1432172,34,30,1979,12,"male",1003,318,155,42,40,42,33,0,7
1432194,24,18,1989,10,"female",432,7,5,0,0,0,0,0,0
1432216,56,14,1957,9,"female",1066,31,22,4,3,4,3,0,0
1432219,21,2,1992,4,"male",400,239,125,308,530,147,400,161,130
1432222,71,6,1942,3,"female",368,46,40,81,8,0,5,81,3
1432225,17,19,1996,1,"male",480,273,232,50,37,25,16,25,21
1432271,20,2,1993,1,"male",135,17,16,0,1,0,1,0,0
1432310,22,17,1991,6,"male",2313,354,135,0,0,0,0,0,0
1432313,60,9,1953,12,"male",585,224,107,115,364,0,111,115,253
1432320,64,2,1949,11,"male",47,14,8,4,0,3,0,1,0
1432324,19,28,1994,7,"male",385,321,179,27,42,27,41,0,1
1432335,28,12,1985,12,"female",249,12,11,0,1,0,0,0,1
1432351,52,7,1961,10,"female",619,44,30,99,173,1,73,98,100
1432355,18,10,1995,1,"male",291,345,297,41,0,8,0,33,0
1432357,26,6,1987,5,"male",353,280,188,506,100,506,65,0,35
1432362,27,22,1986,10,"male",759,231,163,0,0,0,0,0,0
1432395,75,12,1938,4,"female",312,32,14,5,0,5,0,0,0
1432403,55,10,1958,10,"female",960,60,45,266,105,259,81,7,24
1432423,25,3,1988,7,"male",518,234,198,0,0,0,0,0,0
1432425,42,23,1971,10,"female",312,31,25,13,1,13,0,0,1
1432460,49,6,1964,4,"female",116,13,9,2,0,2,0,0,0
1432467,25,7,1988,7,"female",694,1,1,21,8,21,8,0,0
1432469,63,12,1950,12,"female",135,26,21,18,105,18,48,0,57
1432480,19,13,1994,10,"male",437,1452,1066,46,61,46,28,0,33
1432486,47,13,1966,1,"male",696,184,130,37,8,37,3,0,5
1432520,53,1,1960,1,"male",20,0,0,0,0,0,0,0,0
1432534,21,22,1992,11,"male",273,12,11,0,0,0,0,0,0
1432535,65,3,1948,5,"male",1075,62,24,27,38,27,15,0,23
1432590,18,7,1995,2,"male",65,47,34,0,2,0,0,0,2
1432601,18,10,1995,10,"male",387,270,205,24,21,3,10,21,11
1432626,16,24,1997,3,"male",632,739,439,74,204,20,65,54,139
1432629,18,22,1995,11,"female",241,28,27,6,6,6,4,0,2
1432686,28,20,1985,10,"male",358,34,29,0,3,0,2,0,1
1432691,100,17,1913,7,"male",108,29,25,32,26,32,15,0,11
1432695,68,14,1945,6,"male",23,55,50,67,71,1,61,66,10
1432702,21,26,1992,12,"male",11,6,6,0,0,0,0,0,0
1432711,15,12,1998,8,"male",151,23,23,6,0,6,0,0,0
1432733,31,1,1982,6,"female",314,147,100,52,86,52,63,0,23
1432744,18,18,1995,3,"male",228,742,640,44,84,1,35,43,49
1432786,69,29,1944,5,"male",740,26,15,3,1,3,0,0,1
1432823,56,11,1957,4,"female",548,80,72,116,241,0,95,116,146
1432852,66,15,1947,9,"female",1065,50,25,0,0,0,0,0,0
1432855,16,8,1997,1,"male",559,346,302,309,142,182,67,127,75
1432860,112,1,1901,8,"male",1719,136,97,43,19,41,16,2,3
1432903,30,7,1983,6,"female",367,6,5,22,1,22,0,0,1
1432921,34,27,1979,8,"male",415,92,77,4,2,4,1,0,1
1432928,16,7,1997,5,"male",329,27,20,3,0,3,0,0,0
1432936,30,12,1983,12,"female",173,22,18,0,20,0,4,0,16
1432944,19,28,1994,12,"female",500,7,3,0,0,0,0,0,0
1432946,37,2,1976,12,"male",441,47,43,7,23,7,5,0,18
1432952,28,7,1985,8,"male",363,112,95,0,0,0,0,0,0
1432973,108,21,1905,10,"male",24,5,2,0,0,0,0,0,0
1432980,13,24,2000,3,"male",49,4,4,1,2,1,2,0,0
1433026,25,14,1988,9,"female",363,68,68,0,0,0,0,0,0
1433029,30,19,1983,10,"male",406,71,53,1,0,1,0,0,0
1433054,15,3,1998,12,"male",528,87,32,45,19,45,17,0,2
1433055,15,8,1998,1,"male",370,1981,1752,12,13,0,4,12,9
1433057,56,24,1957,8,"female",1474,1401,777,5710,6290,128,3615,5582,2675
1433076,63,18,1950,6,"male",1183,1632,907,40,48,29,27,11,21
1433078,73,18,1940,12,"male",494,148,69,3,2,0,0,3,2
1433082,15,20,1998,4,"female",375,627,289,156,82,36,42,120,40
1433087,15,25,1998,3,"female",177,1147,862,3314,3183,1031,1366,2283,1817
1433089,28,21,1985,3,"male",242,74,70,15,2,15,2,0,0
1433123,29,2,1984,11,"male",27,13,11,4,2,4,2,0,0
1433132,60,23,1953,8,"male",318,466,294,32,18,3,12,29,6
1433135,28,1,1985,2,"male",433,178,90,4,4,2,2,2,2
1433137,103,21,1910,10,"female",1763,433,273,364,125,67,48,297,77
1433157,37,25,1976,3,"male",386,38,19,123,113,123,64,0,49
1433168,53,21,1960,5,"male",359,12,7,0,0,0,0,0,0
1433200,22,26,1991,9,"male",190,270,121,335,76,335,71,0,5
1433237,50,14,1963,10,"female",202,29,10,1,5,1,5,0,0
1433260,30,13,1983,9,"male",322,10,9,2,2,0,0,2,2
1433286,40,10,1973,11,"female",466,13,2,0,0,0,0,0,0
1433316,53,22,1960,4,"female",535,101,68,67,32,0,2,67,30
1433333,50,15,1963,12,"male",903,52,17,5,3,5,2,0,1
1433334,35,25,1978,7,"male",457,84,57,36,31,36,29,0,2
1433354,33,31,1980,12,"male",545,132,68,14,128,0,50,14,78
1433374,33,11,1980,9,"male",406,55,45,3,1,3,1,0,0
1433381,103,7,1910,9,"female",559,154,36,7,17,7,13,0,4
1433413,33,13,1980,5,"female",416,4,2,0,0,0,0,0,0
1433443,26,23,1987,3,"male",587,83,59,5,0,1,0,4,0
1433561,18,25,1995,9,"male",104,52,47,4,0,4,0,0,0
1433592,53,28,1960,12,"female",1798,315,125,74,166,74,73,0,93
1433609,16,21,1997,7,"female",381,1,0,0,0,0,0,0,0
1433611,20,14,1993,12,"male",688,2596,1127,804,1259,52,721,752,538
1433620,63,3,1950,2,"male",83,102,68,268,0,268,0,0,0
1433623,21,6,1992,5,"female",242,119,8,1,0,1,0,0,0
1433655,17,20,1996,9,"male",455,122,111,0,0,0,0,0,0
1433700,45,4,1968,9,"male",147,106,84,0,0,0,0,0,0
1433730,19,2,1994,2,"female",590,584,176,57,116,46,85,11,31
1433732,35,15,1978,9,"male",518,30,11,27,5,27,4,0,1
1433733,32,18,1981,5,"female",246,92,41,47,51,33,21,14,30
1433765,44,1,1969,11,"female",443,28,14,6,7,6,7,0,0
1433769,46,14,1967,3,"male",513,2,0,0,0,0,0,0,0
1433794,17,6,1996,3,"male",507,424,353,38,1,38,1,0,0
1433799,32,30,1981,1,"male",569,182,88,0,1,0,1,0,0
1433835,24,13,1989,5,"male",356,14,6,2,0,0,0,2,0
1433852,39,2,1974,9,"female",1641,166,83,4978,4709,4752,1741,226,2968
1433883,107,18,1906,6,"male",233,76,55,2,1,2,1,0,0
1433884,44,4,1969,1,"female",872,82,47,99,2,99,2,0,0
1433922,26,28,1987,10,"male",736,154,57,146,111,130,67,16,44
1433932,24,28,1989,11,"female",222,47,8,28,8,12,4,16,4
1434014,63,31,1950,12,"male",715,59,29,20,125,0,25,20,100
1434034,23,21,1990,1,"male",310,204,201,9,3,7,1,2,2
1434048,51,29,1962,6,"female",113,316,53,526,306,142,195,384,111
1434077,23,16,1990,10,"male",238,131,96,16,8,0,4,16,4
1434091,59,30,1954,3,"male",149,97,68,38,74,38,51,0,23
1434103,58,15,1955,3,"male",293,2,2,5,1,5,0,0,1
1434107,48,21,1965,2,"female",184,98,60,36,66,35,42,1,24
1434117,22,7,1991,6,"male",308,579,374,282,183,217,107,65,76
1434132,108,24,1905,12,"female",299,91,76,69,53,69,33,0,20
1434138,24,24,1989,11,"male",243,58,34,4,39,4,36,0,3
1434144,94,19,1919,5,"male",323,70,53,7,11,7,6,0,5
1434155,15,1,1998,4,"male",221,275,165,14,0,12,0,2,0
1434160,47,10,1966,3,"female",793,13,7,1,7,1,7,0,0
1434204,66,19,1947,2,"female",1574,36,18,16,6,0,2,16,4
1434213,46,12,1967,3,"male",745,36,31,2,0,0,0,2,0
1434231,53,28,1960,5,"female",978,122,96,10,28,7,16,3,12
1434244,70,12,1943,2,"male",584,7,4,0,0,0,0,0,0
1434254,32,28,1981,12,"male",100,63,50,15,4,15,4,0,0
1434295,16,14,1997,1,"female",914,2469,1001,468,216,125,110,343,106
1434311,20,13,1993,12,"male",773,69,27,0,0,0,0,0,0
1434329,100,21,1913,12,"male",795,355,291,167,74,167,72,0,2
1434342,37,25,1976,3,"female",545,123,35,608,202,411,102,197,100
1434356,22,5,1991,5,"male",14,14,9,3,0,3,0,0,0
1434360,63,4,1950,5,"male",1034,36,18,4,11,4,6,0,5
1434385,49,29,1964,11,"male",861,2,1,0,0,0,0,0,0
1434393,28,30,1985,1,"female",377,53,23,17,0,17,0,0,0
1434411,23,9,1990,9,"male",505,817,770,501,89,501,78,0,11
1434415,26,17,1987,2,"male",369,177,156,183,100,183,93,0,7
1434423,103,11,1910,9,"female",374,100,45,12,53,12,50,0,3
1434456,46,27,1967,12,"female",420,71,62,40,11,40,8,0,3
1434523,56,24,1957,5,"male",760,20,5,196,27,118,15,78,12
1434526,20,1,1993,1,"male",535,2,2,0,0,0,0,0,0
1434535,28,15,1985,12,"male",857,6,0,0,0,0,0,0,0
1434540,21,21,1992,6,"male",115,106,83,10,21,10,20,0,1
1434558,27,24,1986,3,"male",385,92,78,8,32,8,26,0,6
1434563,63,30,1950,5,"female",308,160,140,948,371,948,182,0,189
1434571,33,1,1980,1,"male",29,27,21,0,1,0,1,0,0
1434595,62,16,1951,7,"male",1425,103,19,8,9,8,4,0,5
1434604,32,17,1981,11,"female",371,43,29,18,19,18,6,0,13
1434611,67,19,1946,9,"female",1440,41,9,9,0,0,0,9,0
1434641,21,21,1992,11,"male",438,646,278,109,215,109,73,0,142
1434651,103,15,1910,1,"female",356,104,82,2,3,2,3,0,0
1434656,96,15,1917,6,"male",1429,317,125,54,43,53,29,1,14
1434690,37,8,1976,2,"female",311,21,10,0,0,0,0,0,0
1434692,23,2,1990,2,"male",406,88,74,9,9,0,2,9,7
1434726,54,21,1959,10,"male",621,254,179,17,47,16,28,1,19
1434760,35,7,1978,5,"female",538,43,15,277,167,200,60,77,107
1434766,23,25,1990,6,"male",633,166,129,4,0,4,0,0,0
1434774,25,29,1988,2,"male",232,1,1,2,1,2,1,0,0
1434780,64,30,1949,4,"female",361,7,7,11,0,11,0,0,0
1434793,34,27,1979,6,"female",270,164,119,20,12,18,7,2,5
1434811,66,1,1947,8,"female",510,11,11,16,7,0,0,16,7
1434849,20,21,1993,7,"female",1308,1055,163,130,833,60,312,70,521
1434861,24,17,1989,8,"female",517,20,8,7,16,7,15,0,1
1434876,59,20,1954,7,"female",1316,84,56,1,40,0,20,1,20
1434885,108,25,1905,7,"female",409,215,106,180,182,76,47,104,135
1434920,18,23,1995,2,"female",403,34,20,2,3,2,3,0,0
1434941,51,11,1962,4,"female",391,3279,1115,1383,1926,1265,637,118,1289
1434952,21,26,1992,2,"female",51,198,145,1686,809,1686,462,0,347
1434989,52,23,1961,11,"female",565,145,77,94,67,89,34,5,33
1435053,37,28,1976,1,"male",224,62,54,50,2,50,0,0,2
1435099,69,25,1944,10,"female",471,80,39,31,7,0,5,31,2
1435129,20,24,1993,7,"female",405,17,13,14,4,0,2,14,2
1435141,18,22,1995,2,"female",645,329,226,11,1,0,1,11,0
1435158,63,17,1950,10,"female",530,36,24,0,0,0,0,0,0
1435160,35,28,1978,10,"male",552,72,66,0,5,0,5,0,0
1435172,22,11,1991,11,"male",673,6,4,1,1,0,1,1,0
1435195,39,14,1974,2,"female",378,99,52,61,16,61,15,0,1
1435210,80,5,1933,6,"female",109,81,67,184,2,183,1,1,1
1435213,27,14,1986,12,"female",382,297,216,161,390,96,60,65,330
1435215,29,26,1984,4,"male",66,129,109,111,37,111,34,0,3
1435228,34,3,1979,8,"male",421,53,42,303,93,292,59,11,34
1435242,59,1,1954,9,"male",1699,120,61,61,13,60,6,1,7
1435252,24,26,1989,6,"male",521,371,345,9,0,9,0,0,0
1435255,20,25,1993,2,"male",257,137,84,1,0,0,0,1,0
1435262,28,18,1985,4,"male",269,15,7,1,9,1,9,0,0
1435268,18,21,1995,7,"female",289,512,82,0,13,0,6,0,7
1435283,24,6,1989,9,"male",11,23,17,1,2,1,2,0,0
1435307,33,25,1980,8,"male",763,92,36,0,0,0,0,0,0
1435329,24,8,1989,7,"male",231,323,143,3,0,3,0,0,0
1435345,19,14,1994,11,"male",494,57,42,0,0,0,0,0,0
1435382,69,9,1944,9,"female",354,82,16,0,0,0,0,0,0
1435403,46,10,1967,5,"female",459,310,154,134,66,0,15,134,51
1435422,51,6,1962,10,"male",347,30,27,20,1,0,0,20,1
1435433,14,7,1999,8,"female",203,1530,595,17,570,17,472,0,98
1435445,30,10,1983,9,"male",822,35,10,21,61,21,60,0,1
1435450,14,23,1999,1,"male",433,228,132,5,4,0,2,5,2
1435453,54,18,1959,12,"female",795,142,40,157,53,0,44,157,9
1435461,67,22,1946,5,"female",1938,59,36,108,8,0,2,108,6
1435469,16,25,1997,5,"female",285,115,46,0,1,0,1,0,0
1435477,22,2,1991,2,"female",418,205,132,0,0,0,0,0,0
1435481,55,13,1958,10,"male",1720,221,139,443,232,441,177,2,55
1435513,37,18,1976,12,"male",635,42,8,12,12,12,11,0,1
1435533,74,16,1939,10,"female",537,317,222,98,36,0,6,98,30
1435572,24,10,1989,12,"female",731,213,141,53,19,53,16,0,3
1435598,47,1,1966,7,"male",1058,21,14,18,12,18,8,0,4
1435611,22,18,1991,3,"female",258,161,56,0,1,0,1,0,0
1435615,46,1,1967,7,"female",529,119,93,210,87,210,71,0,16
1435624,35,6,1978,8,"male",464,1490,1459,4,0,2,0,2,0
1435650,102,28,1911,11,"male",1505,285,180,75,36,75,23,0,13
1435663,18,22,1995,6,"male",831,229,142,20,28,20,8,0,20
1435665,63,1,1950,7,"male",312,706,321,141,49,0,14,141,35
1435682,66,6,1947,7,"male",1706,26,13,0,0,0,0,0,0
1435704,100,25,1913,3,"male",1060,552,417,578,298,578,268,0,30
1435745,108,28,1905,3,"male",909,161,115,30,12,0,3,30,9
1435749,31,5,1982,6,"female",385,77,31,40,2,40,2,0,0
1435751,19,2,1994,2,"male",413,279,215,345,176,343,141,2,35
1435759,42,15,1971,11,"male",410,64,43,0,15,0,3,0,12
1435762,24,17,1989,10,"male",527,27,9,4,12,4,1,0,11
1435764,13,5,2000,5,"male",70,63,50,0,0,0,0,0,0
1435768,25,20,1988,2,"female",397,9,9,0,3,0,1,0,2
1435777,17,7,1996,10,"female",256,140,79,309,481,124,273,185,208
1435785,18,5,1995,11,"female",139,3080,278,106,769,59,544,47,225
1435821,23,12,1990,6,"male",419,43,27,3,4,3,4,0,0
1435860,33,12,1980,12,"male",149,106,103,1,5,1,4,0,1
1435861,58,11,1955,2,"female",1511,208,144,1477,752,1387,379,90,373
1435879,18,15,1995,8,"male",57,56,44,4,3,4,1,0,2
1435888,16,22,1997,12,"male",73,1,1,0,0,0,0,0,0
1435938,36,25,1977,8,"female",318,32,27,25,0,25,0,0,0
1435951,22,1,1991,1,"male",340,177,64,3,14,3,14,0,0
1435970,21,17,1992,4,"male",25,0,0,0,0,0,0,0,0
1436034,25,20,1988,4,"male",204,54,42,4,0,4,0,0,0
1436052,29,11,1984,9,"male",61,107,93,0,3,0,3,0,0
1436077,19,26,1994,6,"male",438,160,91,1,50,1,33,0,17
1436096,20,7,1993,4,"male",693,10,8,1,6,0,0,1,6
1436116,14,10,1999,8,"male",179,8,8,0,0,0,0,0,0
1436193,64,28,1949,9,"male",2208,15,3,0,0,0,0,0,0
1436200,25,11,1988,4,"male",136,59,29,4,6,3,2,1,4
1436221,20,14,1993,4,"female",596,29,18,233,244,233,86,0,158
1436232,25,8,1988,6,"male",1039,101,41,0,0,0,0,0,0
1436246,21,11,1992,11,"female",983,212,133,267,399,3,215,264,184
1436276,19,15,1994,5,"male",450,404,297,0,2,0,1,0,1
1436296,53,25,1960,12,"male",367,10,5,0,0,0,0,0,0
1436305,22,9,1991,2,"female",489,333,195,4,10,4,10,0,0
1436311,33,26,1980,3,"female",349,0,0,0,0,0,0,0,0
1436312,46,4,1967,8,"male",460,71,17,8,23,0,16,8,7
1436339,36,6,1977,6,"female",281,65,57,65,10,65,10,0,0
1436344,35,6,1978,12,"male",2143,141,59,12,34,12,29,0,5
1436399,100,7,1913,9,"female",1439,305,203,1031,381,1031,270,0,111
1436417,39,5,1974,5,"male",733,126,57,3,2,3,2,0,0
1436420,38,14,1975,3,"female",150,90,41,22,3,22,2,0,1
1436434,14,31,1999,5,"male",173,54,43,0,0,0,0,0,0
1436470,31,4,1982,2,"male",858,316,202,0,0,0,0,0,0
1436477,35,1,1978,11,"male",100,19,16,0,0,0,0,0,0
1436523,17,14,1996,9,"female",677,394,170,852,816,285,362,567,454
1436536,41,4,1972,1,"male",238,2,1,0,0,0,0,0,0
1436537,53,8,1960,7,"female",1064,62,29,0,0,0,0,0,0
1436557,56,18,1957,6,"female",324,133,122,282,22,282,13,0,9
1436567,28,16,1985,6,"female",555,270,158,53,66,50,27,3,39
1436583,54,17,1959,7,"male",82,62,43,27,35,27,33,0,2
1436584,35,23,1978,4,"male",220,0,0,0,0,0,0,0,0
1436595,21,24,1992,3,"male",365,20,16,4,0,0,0,4,0
1436604,69,31,1944,1,"male",150,24,20,4,1,0,0,4,1
1436613,15,19,1998,7,"male",565,481,383,51,145,7,72,44,73
1436685,41,5,1972,3,"male",666,87,63,99,21,43,13,56,8
1436687,42,20,1971,4,"male",586,294,36,48,29,48,29,0,0
1436710,63,28,1950,5,"female",963,42,21,177,17,0,0,177,17
1436716,59,25,1954,4,"female",1766,36,18,44,46,44,41,0,5
1436720,67,26,1946,7,"female",258,32,29,19,6,0,0,19,6
1436737,31,16,1982,5,"male",490,43,40,58,61,55,49,3,12
1436760,18,15,1995,12,"male",210,55,36,72,71,72,40,0,31
1436810,29,3,1984,7,"male",253,27,11,3,0,3,0,0,0
1436814,49,10,1964,12,"female",599,33,14,2,0,0,0,2,0
1436846,25,25,1988,7,"female",907,7,3,0,0,0,0,0,0
1436848,27,10,1986,12,"male",1303,464,208,16,29,16,13,0,16
1436866,22,2,1991,8,"male",425,531,418,4,6,0,3,4,3
1436890,24,8,1989,1,"female",93,68,53,32,29,3,8,29,21
1436909,24,25,1989,1,"female",781,109,53,74,99,57,59,17,40
1436933,56,8,1957,12,"female",1930,88,52,7,68,0,19,7,49
1437001,47,13,1966,10,"male",783,50,11,0,0,0,0,0,0
1437033,22,22,1991,5,"female",524,719,524,219,816,49,439,170,377
1437054,48,7,1965,9,"female",267,57,40,9,0,9,0,0,0
1437060,17,15,1996,3,"male",538,36,6,0,1,0,1,0,0
1437070,24,3,1989,1,"female",522,115,69,15,19,15,13,0,6
1437129,21,9,1992,11,"male",620,207,147,5,1,4,1,1,0
1437133,52,20,1961,7,"male",301,66,19,33,67,33,43,0,24
1437186,65,27,1948,8,"female",1213,260,25,1,1,1,1,0,0
1437227,33,13,1980,12,"female",1487,288,178,520,251,502,143,18,108
1437236,58,6,1955,12,"female",879,75,40,96,35,0,13,96,22
1437329,42,14,1971,3,"male",619,38,20,1,1,1,1,0,0
1437341,25,6,1988,9,"male",39,1,0,1,0,1,0,0,0
1437359,17,28,1996,2,"female",249,208,34,9,14,8,5,1,9
1437387,18,14,1995,8,"male",192,385,141,0,0,0,0,0,0
1437392,17,22,1996,4,"female",137,181,83,1247,818,829,606,418,212
1437407,50,18,1963,11,"male",340,24,9,2,6,2,6,0,0
1437412,15,8,1998,9,"female",94,87,35,1,17,0,3,1,14
1437420,26,3,1987,3,"male",11,0,0,0,0,0,0,0,0
1437422,35,26,1978,1,"female",429,59,30,2,26,2,18,0,8
1437426,17,19,1996,7,"male",100,110,30,3,0,3,0,0,0
1437434,45,27,1968,8,"female",555,69,34,4,6,0,0,4,6
1437436,85,1,1928,2,"female",186,13,9,4,2,4,1,0,1
1437443,18,19,1995,5,"female",304,58,28,0,0,0,0,0,0
1437460,19,13,1994,9,"female",797,155,36,0,1,0,1,0,0
1437476,15,8,1998,8,"male",476,530,342,342,375,138,181,204,194
1437507,33,25,1980,5,"male",301,21,11,14,22,14,18,0,4
1437554,25,17,1988,10,"female",805,51,37,0,0,0,0,0,0
1437566,33,27,1980,4,"female",792,127,92,90,122,68,68,22,54
1437582,21,10,1992,1,"male",351,19,10,0,2,0,2,0,0
1437611,34,23,1979,5,"male",734,28,14,1,0,1,0,0,0
1437614,19,31,1994,7,"female",507,291,232,0,0,0,0,0,0
1437662,52,10,1961,2,"male",1069,27,21,0,0,0,0,0,0
1437673,45,20,1968,2,"male",785,42,32,24,18,16,15,8,3
1437689,25,5,1988,1,"male",194,27,0,0,0,0,0,0,0
1437706,25,5,1988,2,"female",726,94,54,180,90,175,73,5,17
1437732,27,24,1986,9,"male",1057,88,70,7,1,7,1,0,0
1437743,21,28,1992,6,"female",284,56,20,0,0,0,0,0,0
1437747,63,21,1950,1,"female",115,22,17,9,1,0,1,9,0
1437760,55,6,1958,9,"female",2081,85,55,206,79,75,50,131,29
1437784,14,20,1999,4,"female",710,704,405,514,512,370,236,144,276
1437786,29,25,1984,9,"female",304,61,21,18,6,5,6,13,0
1437805,46,4,1967,3,"female",251,11,10,66,33,0,5,66,28
1437818,17,14,1996,2,"female",172,254,34,233,356,164,300,69,56
1437821,49,10,1964,9,"female",333,161,51,91,19,91,14,0,5
1437850,93,5,1920,1,"female",2271,46,25,15,7,15,4,0,3
1437855,100,2,1913,6,"female",1746,588,157,101,47,101,37,0,10
1437858,25,30,1988,5,"male",1345,396,255,33,54,12,23,21,31
1437876,15,15,1998,5,"female",718,296,186,0,0,0,0,0,0
1437880,20,4,1993,6,"female",381,173,94,16,5,16,2,0,3
1437903,36,8,1977,11,"male",655,96,75,16,51,16,44,0,7
1437906,42,8,1971,12,"female",989,104,64,26,274,26,190,0,84
1437908,60,6,1953,12,"female",331,140,97,384,51,383,14,1,37
1437922,60,11,1953,12,"female",703,424,262,380,27,344,7,36,20
1437931,19,27,1994,6,"male",1583,393,274,1,2,1,2,0,0
1437936,26,7,1987,7,"female",726,22,19,7,4,5,4,2,0
1437956,25,19,1988,12,"female",610,381,317,1,5,1,5,0,0
1437974,20,21,1993,6,"female",495,0,0,0,0,0,0,0,0
1437977,18,16,1995,7,"female",743,1503,1261,112,482,20,396,92,86
1437981,49,5,1964,12,"male",779,84,28,0,3,0,0,0,3
1438010,22,12,1991,9,"male",235,109,95,0,0,0,0,0,0
1438011,14,15,1999,11,"female",78,624,414,844,148,834,113,10,35
1438016,23,14,1990,1,"male",299,166,145,1098,3,1098,2,0,1
1438023,37,29,1976,9,"female",269,79,50,63,72,56,59,7,13
1438034,54,1,1959,1,"male",171,2,2,166,83,38,26,128,57
1438039,30,21,1983,3,"male",409,97,65,562,362,562,333,0,29
1438065,108,15,1905,11,"male",924,740,474,25,1,0,1,25,0
1438121,19,1,1994,1,"male",887,1315,1037,357,607,357,447,0,160
1438128,33,9,1980,4,"female",842,0,0,0,0,0,0,0,0
1438140,18,4,1995,6,"male",402,279,169,58,34,58,28,0,6
1438155,59,7,1954,1,"male",1131,58,38,13,15,0,7,13,8
1438179,61,23,1952,3,"female",200,25,23,0,0,0,0,0,0
1438183,68,14,1945,8,"female",829,94,54,10,40,10,23,0,17
1438204,49,17,1964,5,"female",652,108,72,6,25,5,7,1,18
1438227,25,1,1988,1,"male",65,15,12,0,0,0,0,0,0
1438229,66,18,1947,7,"female",1828,334,200,142,498,5,271,137,227
1438237,37,29,1976,8,"male",713,33,17,31,48,4,33,27,15
1438248,24,8,1989,10,"male",547,24,11,6,3,0,0,6,3
1438263,18,1,1995,1,"male",387,27,23,1,0,1,0,0,0
1438277,83,8,1930,5,"male",412,92,79,21,24,21,14,0,10
1438304,17,1,1996,1,"male",58,15,12,0,0,0,0,0,0
1438335,18,7,1995,2,"female",274,38,13,0,2,0,0,0,2
1438347,39,21,1974,12,"male",347,508,378,2,5,2,4,0,1
1438355,25,21,1988,2,"female",710,28,21,14,0,14,0,0,0
1438356,54,14,1959,7,"male",1281,102,30,38,46,38,16,0,30
1438358,33,29,1980,1,"male",700,133,42,1,19,0,9,1,10
1438395,65,11,1948,9,"male",1391,34,6,8,3,7,2,1,1
1438408,29,28,1984,2,"male",365,32,2,0,2,0,2,0,0
1438475,34,25,1979,6,"male",441,40,20,0,0,0,0,0,0
1438525,69,17,1944,10,"male",1149,70,33,0,0,0,0,0,0
1438526,24,24,1989,4,"female",788,186,118,220,274,219,182,1,92
1438527,17,17,1996,2,"female",524,130,104,0,0,0,0,0,0
1438550,21,24,1992,4,"female",296,65,40,0,40,0,18,0,22
1438572,14,6,1999,7,"male",104,502,471,0,23,0,1,0,22
1438595,24,27,1989,3,"female",1419,398,39,7,25,7,9,0,16
1438616,18,22,1995,2,"male",167,106,94,0,0,0,0,0,0
1438620,30,20,1983,9,"female",107,40,23,13,5,1,2,12,3
1438643,25,31,1988,1,"male",419,58,33,4,6,2,4,2,2
1438699,29,26,1984,10,"female",299,48,31,226,209,221,120,5,89
1438723,16,14,1997,11,"female",429,415,255,1190,2133,884,1659,306,474
1438725,33,28,1980,9,"female",476,30,15,114,60,113,24,1,36
1438730,66,23,1947,7,"female",214,6,5,12,3,12,0,0,3
1438732,42,19,1971,9,"female",98,12,6,0,0,0,0,0,0
1438775,18,19,1995,12,"male",603,865,152,11,42,11,35,0,7
1438781,102,11,1911,2,"male",1184,476,190,0,2,0,1,0,1
1438795,20,26,1993,8,"male",376,63,40,2,3,2,1,0,2
1438802,27,22,1986,3,"male",645,248,148,5,56,5,53,0,3
1438829,25,20,1988,2,"female",182,270,199,37,261,37,86,0,175
1438844,64,17,1949,4,"male",660,712,359,1174,428,45,216,1129,212
1438859,43,13,1970,5,"male",770,12,8,1,0,0,0,1,0
1438860,18,14,1995,3,"male",594,357,241,6,2,0,2,6,0
1438880,39,29,1974,9,"male",932,127,65,0,0,0,0,0,0
1438897,28,13,1985,11,"female",515,129,91,230,75,230,54,0,21
1438899,57,15,1956,2,"male",1165,246,153,99,89,94,32,5,57
1438917,23,5,1990,9,"male",258,44,4,3,4,0,1,3,3
1438941,18,11,1995,1,"male",589,18,11,0,2,0,1,0,1
1438951,17,15,1996,5,"male",690,222,105,8,1,8,1,0,0
1438955,19,31,1994,7,"male",111,248,226,35,11,5,4,30,7
1438957,31,15,1982,8,"male",568,36,24,1,4,1,2,0,2
1438997,53,26,1960,1,"male",668,19,14,3,4,1,0,2,4
1439002,17,5,1996,8,"male",927,165,99,7,13,7,11,0,2
1439022,31,4,1982,4,"female",488,102,54,27,13,27,10,0,3
1439048,39,11,1974,9,"male",1025,48,18,4,14,4,14,0,0
1439055,33,12,1980,4,"male",437,78,38,1,36,1,35,0,1
1439106,24,4,1989,1,"female",470,69,32,85,52,85,49,0,3
1439118,29,20,1984,9,"male",303,251,174,193,69,83,22,110,47
1439128,108,12,1905,2,"male",871,769,468,98,202,1,69,97,133
1439131,32,1,1981,1,"male",220,18,17,25,3,25,2,0,1
1439149,18,30,1995,9,"male",364,270,194,295,312,295,305,0,7
1439182,16,17,1997,8,"male",520,245,221,716,172,218,57,498,115
1439199,15,29,1998,5,"male",306,53,22,7,1,7,1,0,0
1439205,24,22,1989,8,"male",264,53,36,1,0,1,0,0,0
1439214,45,25,1968,9,"female",122,64,47,10,5,10,4,0,1
1439245,21,20,1992,11,"female",1016,328,196,31,1,31,1,0,0
1439253,19,24,1994,5,"female",540,1591,290,291,507,291,371,0,136
1439259,103,26,1910,6,"male",274,30,1,0,0,0,0,0,0
1439278,17,24,1996,9,"male",546,420,253,45,16,45,4,0,12
1439280,16,20,1997,9,"male",27,123,109,5,5,0,2,5,3
1439305,26,15,1987,10,"male",337,218,123,93,119,93,68,0,51
1439315,59,26,1954,11,"female",1213,127,47,10,93,10,69,0,24
1439334,16,19,1997,10,"male",175,170,151,5,28,5,24,0,4
1439335,44,4,1969,7,"male",722,4,0,14,0,14,0,0,0
1439347,24,3,1989,1,"male",352,109,44,3,1,3,0,0,1
1439350,14,21,1999,12,"male",265,106,57,0,2,0,2,0,0
1439406,67,1,1946,9,"male",1572,64,42,5,1,2,1,3,0
1439408,56,13,1957,6,"male",877,77,41,36,25,36,5,0,20
1439416,46,29,1967,4,"female",361,25,15,276,103,276,49,0,54
1439452,88,9,1925,8,"female",1601,72,51,3,4,0,1,3,3
1439458,23,30,1990,12,"female",263,283,169,7,15,7,12,0,3
1439463,17,7,1996,7,"female",516,35,14,1,5,1,1,0,4
1439471,15,9,1998,10,"female",379,123,84,698,97,663,69,35,28
1439484,15,2,1998,1,"male",845,149,114,0,0,0,0,0,0
1439501,21,25,1992,12,"male",549,312,258,135,34,112,18,23,16
1439525,21,5,1992,7,"female",448,106,22,5,19,5,19,0,0
1439552,22,31,1991,3,"female",743,88,42,45,43,45,38,0,5
1439560,32,15,1981,12,"male",394,19,6,0,0,0,0,0,0
1439594,113,8,1900,10,"female",1131,803,236,1,58,0,17,1,41
1439596,71,15,1942,7,"male",1597,776,687,61,4,31,2,30,2
1439606,43,15,1970,8,"male",530,43,40,0,0,0,0,0,0
1439608,25,12,1988,9,"female",374,148,95,23,13,8,4,15,9
1439641,47,8,1966,1,"female",776,10,6,2,4,2,4,0,0
1439643,21,5,1992,9,"male",304,59,43,0,0,0,0,0,0
1439694,102,1,1911,1,"male",950,43,18,0,0,0,0,0,0
1439717,40,23,1973,7,"male",233,6,4,0,0,0,0,0,0
1439723,39,22,1974,3,"male",353,65,29,8,1,8,1,0,0
1439799,37,17,1976,10,"female",356,195,144,122,59,122,36,0,23
1439822,23,19,1990,4,"male",822,2,2,0,0,0,0,0,0
1439823,27,30,1986,8,"female",1785,225,153,248,81,187,40,61,41
1439827,23,10,1990,7,"male",241,164,119,1,1,0,1,1,0
1439848,22,13,1991,4,"female",357,554,384,1192,1563,1179,1432,13,131
1439905,30,9,1983,2,"male",483,1,0,0,0,0,0,0,0
1439916,39,2,1974,2,"male",526,4297,1279,787,2855,786,1302,1,1553
1439921,20,3,1993,11,"male",472,1901,1491,208,447,208,338,0,109
1439929,25,10,1988,5,"female",301,6,6,1,0,1,0,0,0
1439952,21,8,1992,7,"female",669,16,9,0,0,0,0,0,0
1439956,15,5,1998,7,"male",435,9,5,2,0,0,0,2,0
1439969,49,27,1964,9,"male",58,1,1,2,0,2,0,0,0
1439994,53,31,1960,3,"male",543,22,15,4,5,4,3,0,2
1440004,17,2,1996,6,"male",229,341,121,41,50,41,42,0,8
1440013,30,13,1983,8,"male",530,140,74,20,9,20,9,0,0
1440036,78,11,1935,11,"male",1703,134,37,0,0,0,0,0,0
1440037,58,5,1955,11,"female",1798,106,63,110,48,0,8,110,40
1440047,70,28,1943,2,"female",71,12,6,42,51,0,1,42,50
1440086,44,11,1969,4,"male",265,15,3,1,7,1,0,0,7
1440116,20,1,1993,1,"male",654,26,9,10,2,10,1,0,1
1440119,43,20,1970,4,"female",854,149,87,2,5,0,1,2,4
1440143,15,14,1998,1,"female",430,216,136,2595,381,2477,239,118,142
1440166,50,10,1963,5,"male",182,109,76,0,1,0,1,0,0
1440196,71,13,1942,7,"female",136,28,5,9,0,0,0,9,0
1440210,24,1,1989,5,"male",113,56,53,0,0,0,0,0,0
1440217,55,9,1958,9,"female",200,70,47,74,15,74,14,0,1
1440227,32,7,1981,8,"male",265,48,39,0,0,0,0,0,0
1440247,32,23,1981,2,"female",376,207,112,1050,507,269,212,781,295
1440251,59,24,1954,9,"female",448,120,93,168,62,81,36,87,26
1440254,24,27,1989,4,"male",586,151,98,134,19,134,19,0,0
1440256,27,22,1986,5,"male",932,187,109,20,1,20,1,0,0
1440266,24,31,1989,12,"male",344,10,6,0,4,0,3,0,1
1440268,32,27,1981,6,"female",449,228,168,418,66,406,22,12,44
1440275,23,10,1990,10,"female",467,19,10,5,3,5,3,0,0
1440298,23,12,1990,2,"male",424,157,125,9,6,9,4,0,2
1440299,55,23,1958,6,"female",628,42,13,11,0,0,0,11,0
1440304,29,21,1984,7,"male",289,212,99,5,94,0,0,5,94
1440306,28,20,1985,10,"male",193,97,70,1,2,1,2,0,0
1440318,53,15,1960,6,"male",93,25,24,140,15,140,12,0,3
1440322,20,31,1993,5,"female",1015,1655,339,82,228,34,177,48,51
1440331,63,29,1950,7,"male",1583,111,38,8,8,0,3,8,5
1440333,23,18,1990,4,"male",233,104,49,20,33,1,14,19,19
1440351,20,26,1993,4,"male",390,79,53,0,0,0,0,0,0
1440363,19,3,1994,3,"male",567,800,727,5,19,5,17,0,2
1440373,74,17,1939,9,"male",607,32,26,1,3,0,1,1,2
1440377,23,14,1990,11,"female",593,977,758,1597,3363,1393,2713,204,650
1440410,18,25,1995,8,"male",523,317,171,560,428,182,203,378,225
1440431,17,18,1996,5,"male",660,1119,844,822,456,822,410,0,46
1440444,52,4,1961,6,"male",1397,61,39,28,49,16,21,12,28
1440459,44,1,1969,12,"male",344,75,74,0,0,0,0,0,0
1440501,15,11,1998,12,"female",298,122,87,46,36,0,18,46,18
1440505,108,5,1905,4,"male",970,91,48,1,5,0,0,1,5
1440510,22,1,1991,1,"female",517,101,52,31,9,31,9,0,0
1440517,24,26,1989,11,"male",399,63,43,7,8,0,2,7,6
1440543,21,27,1992,8,"male",640,301,226,33,5,1,3,32,2
1440560,106,7,1907,7,"male",209,780,667,450,317,450,202,0,115
1440580,18,5,1995,5,"male",46,193,189,71,22,71,20,0,2
1440617,17,16,1996,9,"male",545,123,91,1,0,0,0,1,0
1440624,46,17,1967,7,"female",346,94,63,100,69,20,25,80,44
1440633,31,25,1982,12,"female",1066,212,146,70,53,70,50,0,3
1440660,29,19,1984,11,"male",348,115,71,58,59,58,58,0,1
1440671,55,22,1958,12,"female",1468,92,48,973,282,973,219,0,63
1440680,21,9,1992,7,"female",85,29,16,11,2,11,1,0,1
1440690,42,30,1971,6,"male",699,21,13,14,21,14,21,0,0
1440817,49,1,1964,1,"female",177,36,18,258,55,258,38,0,17
1440862,23,14,1990,10,"female",546,38,26,2,42,2,30,0,12
1440866,74,30,1939,10,"female",417,111,55,1,1,1,1,0,0
1440879,21,10,1992,10,"male",605,52,36,67,31,67,26,0,5
1440882,70,11,1943,6,"female",215,79,34,21,1,5,1,16,0
1440894,25,6,1988,2,"female",484,580,126,661,687,300,552,361,135
1440978,61,14,1952,3,"female",534,21,19,10,3,0,1,10,2
1440980,62,12,1951,12,"female",1083,76,30,179,53,22,2,157,51
1441035,15,4,1998,10,"male",398,626,299,105,165,88,134,17,31
1441066,67,10,1946,7,"male",635,9,4,1,17,0,1,1,16
1441108,14,26,1999,3,"male",90,37,31,1,0,1,0,0,0
1441111,20,6,1993,1,"male",943,36,26,17,0,0,0,17,0
1441126,33,1,1980,1,"male",264,3,2,0,0,0,0,0,0
1441131,31,6,1982,10,"male",301,1,0,0,0,0,0,0,0
1441134,21,25,1992,6,"female",161,39,17,0,0,0,0,0,0
1441149,70,7,1943,10,"male",574,55,30,56,3,54,2,2,1
1441166,23,12,1990,1,"female",266,17,6,4,3,4,0,0,3
1441170,23,8,1990,2,"male",645,722,471,48,2,5,0,43,2
1441171,17,10,1996,10,"male",541,4,3,0,0,0,0,0,0
1441181,14,10,1999,5,"female",321,659,325,106,167,80,85,26,82
1441196,40,25,1973,11,"male",489,22,14,7,0,7,0,0,0
1441258,54,10,1959,8,"male",1013,130,55,17,0,11,0,6,0
1441271,16,9,1997,9,"female",555,222,126,2,1,2,1,0,0
1441289,65,13,1948,8,"male",1138,211,169,131,48,2,17,129,31
1441305,25,1,1988,1,"male",0,0,0,5,2,5,0,0,2
1441319,38,7,1975,8,"female",328,33,18,0,6,0,3,0,3
1441324,22,3,1991,10,"female",334,189,74,71,101,57,62,14,39
1441344,65,16,1948,2,"female",1050,51,39,377,40,377,28,0,12
1441370,28,16,1985,4,"male",310,91,82,11,5,1,0,10,5
1441413,18,24,1995,3,"female",249,98,95,13,55,13,32,0,23
1441445,23,1,1990,4,"male",298,0,0,0,0,0,0,0,0
1441479,18,1,1995,9,"female",244,206,81,256,67,102,52,154,15
1441502,65,10,1948,11,"male",765,1774,622,1682,953,1441,327,241,626
1441504,102,29,1911,9,"female",1429,121,62,4,2,0,0,4,2
1441515,25,19,1988,8,"female",380,115,73,23,17,17,8,6,9
1441519,50,22,1963,8,"male",542,45,22,7,4,6,1,1,3
1441522,18,26,1995,6,"female",50,1702,339,256,507,83,340,173,167
1441531,23,5,1990,3,"male",607,304,177,0,1,0,0,0,1
1441539,52,9,1961,8,"female",1717,100,61,5,28,5,15,0,13
1441547,20,25,1993,10,"male",17,41,36,0,0,0,0,0,0
1441549,54,18,1959,1,"male",548,95,47,127,64,127,42,0,22
1441603,30,20,1983,4,"male",417,85,72,42,4,42,2,0,2
1441620,21,3,1992,3,"male",120,152,145,100,4,100,4,0,0
1441658,25,10,1988,4,"male",220,13,8,0,0,0,0,0,0
1441676,21,18,1992,10,"female",38,25,11,2,1,2,1,0,0
1441690,19,9,1994,1,"male",291,150,67,26,25,26,25,0,0
1441697,18,3,1995,9,"female",516,123,3,18,9,18,6,0,3
1441731,108,5,1905,11,"female",1563,205,49,60,35,60,11,0,24
1441762,41,29,1972,7,"female",162,41,37,76,36,76,15,0,21
1441792,20,16,1993,4,"male",570,430,266,1,1,1,0,0,1
1441800,24,27,1989,2,"male",580,117,84,15,14,0,0,15,14
1441803,27,16,1986,7,"female",220,285,188,1,19,1,11,0,8
1441812,22,25,1991,8,"male",499,59,38,1,11,1,8,0,3
1441817,41,15,1972,11,"male",500,51,40,0,0,0,0,0,0
1441866,70,5,1943,3,"female",1901,39,11,125,268,124,171,1,97
1441872,35,21,1978,10,"male",39,13,12,158,17,157,6,1,11
1441885,66,6,1947,1,"female",1644,214,82,507,296,460,204,47,92
1441912,53,20,1960,2,"male",641,88,26,2,7,2,4,0,3
1441935,25,1,1988,1,"male",21,0,0,0,0,0,0,0,0
1441948,28,24,1985,3,"female",282,80,30,28,11,14,10,14,1
1441963,25,13,1988,8,"female",500,155,66,0,0,0,0,0,0
1441971,44,2,1969,12,"female",229,17,5,127,829,127,598,0,231
1441976,21,7,1992,9,"female",489,19,6,96,41,13,9,83,32
1441987,68,15,1945,2,"male",243,42,29,7,5,2,0,5,5
1441988,67,5,1946,5,"female",1600,66,21,20,39,20,27,0,12
1442008,57,12,1956,3,"male",744,26,14,4,2,4,2,0,0
1442027,20,1,1993,1,"male",31,28,28,49,8,49,8,0,0
1442050,41,16,1972,5,"female",73,12,10,1,7,0,6,1,1
1442122,36,22,1977,3,"female",2141,135,54,755,486,732,214,23,272
1442189,51,25,1962,3,"male",652,50,31,14,0,14,0,0,0
1442198,49,7,1964,5,"male",527,23,9,0,0,0,0,0,0
1442205,35,22,1978,2,"male",617,38,30,2,0,2,0,0,0
1442256,21,15,1992,6,"female",76,38,30,2,2,2,1,0,1
1442272,16,12,1997,5,"female",90,4,0,0,0,0,0,0,0
1442286,24,10,1989,10,"male",406,131,84,12,3,12,3,0,0
1442313,77,23,1936,9,"male",1566,52,25,0,4,0,1,0,3
1442341,17,4,1996,7,"female",476,44,15,0,0,0,0,0,0
1442344,21,16,1992,4,"female",475,57,28,21,5,19,5,2,0
1442375,25,27,1988,10,"female",145,36,29,7,4,6,3,1,1
1442379,50,9,1963,8,"female",1550,94,40,12,163,12,108,0,55
1442413,25,1,1988,9,"male",141,151,74,25,21,25,19,0,2
1442426,18,17,1995,8,"female",652,318,28,0,8,0,3,0,5
1442462,24,19,1989,2,"female",290,210,163,63,169,63,160,0,9
1442471,66,18,1947,8,"female",596,82,59,171,91,0,36,171,55
1442476,22,29,1991,10,"male",2,25,22,0,0,0,0,0,0
1442477,21,14,1992,2,"male",363,369,224,11,26,11,16,0,10
1442489,26,21,1987,8,"male",575,396,311,109,27,109,27,0,0
1442513,18,14,1995,8,"male",679,259,180,5,519,5,404,0,115
1442532,108,16,1905,10,"male",114,23,20,8,8,0,2,8,6
1442535,53,30,1960,8,"male",365,68,57,0,18,0,6,0,12
1442539,19,1,1994,6,"female",1449,3275,936,416,2665,179,1302,237,1363
1442541,21,6,1992,6,"female",423,449,169,2,27,2,22,0,5
1442550,46,30,1967,4,"male",633,275,177,521,363,521,271,0,92
1442551,24,25,1989,9,"male",567,93,57,4,2,4,2,0,0
1442565,20,18,1993,8,"male",1340,2004,267,2,17,2,13,0,4
1442577,33,27,1980,3,"female",486,342,156,1196,904,1196,767,0,137
1442590,84,31,1929,7,"female",95,29,22,67,1,0,0,67,1
1442607,57,8,1956,3,"male",1064,138,64,97,49,97,19,0,30
1442611,25,13,1988,12,"male",616,149,136,0,0,0,0,0,0
1442623,53,7,1960,9,"female",1387,27,22,5,4,0,3,5,1
1442645,37,26,1976,7,"female",353,87,39,1,7,1,4,0,3
1442690,17,15,1996,7,"female",513,108,60,4,5,4,3,0,2
1442694,18,1,1995,1,"female",277,354,300,31,9,31,9,0,0
1442713,65,9,1948,10,"female",421,38,32,3,13,1,6,2,7
1442723,18,23,1995,4,"male",145,3,2,0,0,0,0,0,0
1442724,16,5,1997,7,"female",354,216,200,613,62,554,35,59,27
1442730,68,15,1945,7,"male",950,45,40,2,0,0,0,2,0
1442736,33,13,1980,5,"male",313,40,10,66,74,66,15,0,59
1442746,55,16,1958,9,"male",765,223,189,11,10,6,6,5,4
1442766,25,1,1988,1,"female",218,0,0,0,0,0,0,0,0
1442767,23,21,1990,10,"female",501,812,309,768,528,373,332,395,196
1442771,18,4,1995,5,"female",655,731,273,8,10,8,9,0,1
1442796,23,11,1990,4,"male",416,66,51,0,12,0,6,0,6
1442813,22,30,1991,8,"female",235,148,85,14,2,8,2,6,0
1442845,20,15,1993,4,"female",1514,546,271,0,0,0,0,0,0
1442894,31,8,1982,11,"male",275,40,30,7,3,7,3,0,0
1442915,16,10,1997,10,"female",284,488,336,2070,1328,1155,1142,915,186
1442921,60,21,1953,8,"male",1165,52,37,1,36,1,34,0,2
1442934,15,17,1998,7,"male",127,172,148,205,125,180,118,25,7
1442955,19,17,1994,2,"male",648,126,89,7,1,7,1,0,0
1442960,25,7,1988,11,"male",443,229,151,1,2,1,2,0,0
1442962,18,5,1995,8,"female",635,637,333,346,298,346,189,0,109
1442973,113,16,1900,2,"female",1624,65,39,12,16,2,9,10,7
1442980,37,13,1976,6,"male",429,1,1,5,6,5,6,0,0
1442994,21,15,1992,4,"male",141,30,13,0,0,0,0,0,0
1443011,15,26,1998,5,"female",988,328,77,584,726,500,233,84,493
1443040,35,28,1978,11,"female",621,15,9,22,6,0,0,22,6
1443057,31,1,1982,1,"female",80,1,1,9,8,9,6,0,2
1443076,41,13,1972,1,"female",98,54,40,16,23,10,16,6,7
1443077,21,1,1992,4,"female",487,20,13,0,1,0,1,0,0
1443079,23,1,1990,1,"male",489,9,8,0,0,0,0,0,0
1443082,24,12,1989,10,"female",377,812,205,8,65,8,51,0,14
1443107,80,3,1933,3,"female",154,45,34,38,6,0,0,38,6
1443114,15,5,1998,10,"male",242,468,352,262,179,250,78,12,101
1443124,32,4,1981,2,"male",219,0,0,1,1,0,1,1,0
1443133,19,20,1994,5,"female",179,98,81,2,1,0,0,2,1
1443135,34,27,1979,9,"female",354,23,18,44,28,39,23,5,5
1443171,65,6,1948,4,"female",1235,34,25,0,0,0,0,0,0
1443213,17,3,1996,11,"male",469,76,70,16,2,0,0,16,2
1443217,15,7,1998,4,"female",17,47,40,0,0,0,0,0,0
1443253,84,19,1929,4,"female",1770,47,18,8,0,7,0,1,0
1443265,42,30,1971,11,"female",500,28,14,1,0,1,0,0,0
1443281,16,14,1997,9,"male",573,123,90,18,17,18,17,0,0
1443297,21,8,1992,12,"female",75,23,13,11,0,11,0,0,0
1443306,15,8,1998,1,"male",514,239,118,83,15,83,15,0,0
1443331,25,8,1988,8,"male",188,66,50,1,6,1,2,0,4
1443345,23,6,1990,6,"male",534,85,61,2,3,0,1,2,2
1443352,19,2,1994,11,"male",93,103,89,1,1,1,1,0,0
1443366,91,17,1922,8,"male",949,1661,900,68,23,13,21,55,2
1443395,22,16,1991,12,"male",37,94,77,219,267,214,77,5,190
1443401,55,13,1958,4,"female",272,55,31,728,175,728,86,0,89
1443409,17,10,1996,5,"female",484,71,29,2,5,2,1,0,4
1443410,45,1,1968,7,"female",254,99,69,16,8,0,0,16,8
1443429,55,12,1958,9,"female",772,0,0,11,0,0,0,11,0
1443444,53,12,1960,11,"female",291,28,21,50,4,50,3,0,1
1443447,24,26,1989,2,"male",921,215,47,11,1,10,1,1,0
1443455,31,10,1982,8,"male",604,126,70,1,7,1,5,0,2
1443463,18,28,1995,9,"male",427,166,48,423,95,35,37,388,58
1443466,17,16,1996,6,"male",607,74,58,0,6,0,4,0,2
1443483,32,4,1981,5,"male",113,12,9,0,0,0,0,0,0
1443489,75,1,1938,6,"female",1370,557,225,7484,3483,269,1196,7215,2287
1443529,67,16,1946,10,"male",1406,283,197,16,95,4,21,12,74
1443541,18,17,1995,7,"male",29,26,22,1,1,1,1,0,0
1443542,18,16,1995,12,"female",374,323,94,876,221,876,188,0,33
1443568,23,1,1990,1,"male",146,13,6,3,2,3,2,0,0
1443584,15,4,1998,4,"male",206,73,69,4,0,0,0,4,0
1443618,30,15,1983,1,"male",82,18,8,131,2,131,2,0,0
1443623,23,7,1990,6,"male",281,87,50,4,0,4,0,0,0
1443642,60,24,1953,9,"female",1339,36,19,19,31,19,29,0,2
1443662,15,4,1998,10,"female",1095,4233,1329,1042,1491,735,616,307,875
1443672,31,11,1982,7,"male",234,85,72,2,0,2,0,0,0
1443687,19,11,1994,9,"female",241,345,254,0,0,0,0,0,0
1443691,69,16,1944,12,"female",219,5,3,0,0,0,0,0,0
1443716,26,9,1987,10,"female",646,429,320,18,9,18,9,0,0
1443741,16,31,1997,10,"female",986,864,739,514,419,410,122,104,297
1443751,17,28,1996,2,"male",385,11,10,0,0,0,0,0,0
1443758,20,18,1993,8,"female",603,297,169,904,1668,265,551,639,1117
1443765,25,8,1988,8,"male",238,40,31,0,0,0,0,0,0
1443771,19,22,1994,6,"male",397,233,179,1,1,1,1,0,0
1443781,108,18,1905,7,"male",176,925,907,1158,538,1158,267,0,271
1443788,51,17,1962,3,"male",425,11,2,5,1,5,1,0,0
1443791,31,24,1982,3,"male",259,214,163,0,0,0,0,0,0
1443792,42,14,1971,3,"female",755,422,346,101,209,89,183,12,26
1443796,19,7,1994,2,"female",295,326,104,22,34,7,28,15,6
1443801,16,19,1997,12,"male",524,304,154,6,30,0,21,6,9
1443802,53,10,1960,12,"female",308,89,63,34,16,0,8,34,8
1443806,16,1,1997,1,"male",96,259,209,86,15,0,0,86,15
1443817,37,10,1976,12,"female",234,154,122,13,10,13,3,0,7
1443828,73,7,1940,8,"male",1212,81,50,7,75,2,62,5,13
1443857,19,16,1994,7,"female",341,62,46,0,1,0,1,0,0
1443870,20,7,1993,11,"female",508,2583,646,5025,5969,134,2471,4891,3498
1443898,55,3,1958,3,"female",108,66,33,47,40,38,11,9,29
1443903,19,30,1994,3,"female",420,76,61,64,42,14,5,50,37
1443906,35,1,1978,5,"female",212,11,4,0,0,0,0,0,0
1443924,67,15,1946,8,"male",2319,61,21,42,42,11,16,31,26
1443926,23,23,1990,4,"female",468,201,103,0,3,0,3,0,0
1443936,66,7,1947,8,"male",541,16,10,637,78,0,19,637,59
1443970,63,10,1950,2,"female",583,239,190,30,23,0,3,30,20
1443973,45,28,1968,10,"female",2018,426,321,275,1434,183,1013,92,421
1443982,29,22,1984,4,"female",427,258,149,408,145,352,49,56,96
1443993,50,14,1963,8,"female",1743,28,21,22,6,14,2,8,4
1443996,22,21,1991,3,"female",536,219,123,445,371,78,111,367,260
1444007,47,19,1966,3,"male",2276,77,37,12,5,0,3,12,2
1444008,71,19,1942,8,"female",563,607,292,58,97,58,79,0,18
1444032,27,28,1986,4,"male",522,64,10,1,0,0,0,1,0
1444038,83,2,1930,8,"male",1525,340,188,18,23,18,22,0,1
1444058,15,1,1998,1,"female",133,393,69,55,31,55,11,0,20
1444082,51,28,1962,10,"male",746,70,47,3,22,3,10,0,12
1444084,58,22,1955,4,"female",89,70,42,117,12,0,4,117,8
1444096,23,28,1990,10,"male",806,109,74,0,11,0,0,0,11
1444173,19,4,1994,7,"female",349,648,139,278,268,273,267,5,1
1444186,23,26,1990,9,"female",345,421,218,275,218,0,33,275,185
1444189,68,9,1945,5,"male",893,18,15,100,194,0,16,100,178
1444200,60,2,1953,4,"female",876,11,3,6,0,0,0,6,0
1444216,50,17,1963,2,"male",528,69,44,265,63,83,37,182,26
1444234,26,2,1987,1,"male",1069,97,48,0,1,0,1,0,0
1444260,17,11,1996,11,"male",660,30,13,2,1,2,1,0,0
1444352,67,17,1946,10,"female",131,122,112,134,119,134,100,0,19
1444391,15,9,1998,4,"male",722,476,302,22,0,22,0,0,0
1444398,64,30,1949,5,"female",1171,20,10,17,1,1,0,16,1
1444400,18,19,1995,5,"male",1193,448,161,26,18,26,13,0,5
1444408,26,1,1987,1,"male",296,43,40,0,0,0,0,0,0
1444425,23,15,1990,12,"male",59,168,129,24,24,22,24,2,0
1444429,103,17,1910,12,"female",993,299,141,121,58,11,35,110,23
1444436,27,11,1986,4,"female",511,52,13,29,0,29,0,0,0
1444475,71,19,1942,12,"male",558,29,16,17,0,0,0,17,0
1444477,88,11,1925,1,"male",1770,45,22,0,7,0,6,0,1
1444522,32,7,1981,8,"male",647,19,14,24,19,24,14,0,5
1444529,31,7,1982,12,"female",1323,870,372,4,55,4,26,0,29
1444537,25,20,1988,5,"male",493,146,97,0,10,0,4,0,6
1444557,14,1,1999,9,"male",367,195,141,63,19,63,6,0,13
1444565,16,13,1997,8,"male",112,60,54,9,12,4,2,5,10
1444567,47,2,1966,7,"male",368,79,54,0,15,0,5,0,10
1444578,29,21,1984,5,"female",80,25,20,1751,451,1717,409,34,42
1444583,18,14,1995,5,"male",283,83,41,11,1,11,1,0,0
1444588,30,26,1983,9,"male",220,1,0,5,5,1,1,4,4
1444596,23,31,1990,12,"male",528,82,45,7,3,0,2,7,1
1444628,33,1,1980,1,"male",242,18,12,3,2,3,2,0,0
1444634,27,24,1986,5,"male",255,156,120,1,0,1,0,0,0
1444642,15,5,1998,5,"male",310,131,72,311,42,311,40,0,2
1444684,27,24,1986,12,"female",16,77,55,319,177,278,153,41,24
1444690,20,6,1993,9,"female",325,81,48,4,0,4,0,0,0
1444693,16,25,1997,11,"male",441,224,106,29,17,29,17,0,0
1444730,62,1,1951,6,"female",1957,335,232,618,656,41,167,577,489
1444734,23,1,1990,3,"male",44,38,28,20,4,20,4,0,0
1444777,27,13,1986,3,"male",761,207,151,34,76,30,54,4,22
1444798,58,18,1955,10,"female",207,53,27,309,145,309,116,0,29
1444832,77,4,1936,4,"female",584,95,54,211,29,0,9,211,20
1444835,67,15,1946,10,"male",180,21,21,0,2,0,2,0,0
1444847,108,15,1905,9,"female",793,255,99,29,3,29,3,0,0
1444874,65,24,1948,10,"female",489,46,32,118,53,118,41,0,12
1444890,28,28,1985,11,"male",252,70,44,0,0,0,0,0,0
1444898,35,19,1978,12,"male",452,23,10,0,0,0,0,0,0
1444935,17,30,1996,12,"female",313,194,126,225,293,225,271,0,22
1444943,55,22,1958,11,"female",1409,191,113,148,142,33,66,115,76
1444951,19,5,1994,5,"male",536,94,24,0,2,0,2,0,0
1444970,24,17,1989,12,"female",443,164,114,9,5,0,4,9,1
1445005,14,20,1999,10,"female",232,2697,479,1021,1869,90,1293,931,576
1445009,53,1,1960,8,"female",440,17,2,0,0,0,0,0,0
1445016,68,29,1945,11,"female",970,562,199,83,391,83,259,0,132
1445018,25,19,1988,1,"male",52,5,5,1,9,1,1,0,8
1445030,68,2,1945,11,"male",1318,29,2,0,0,0,0,0,0
1445053,21,2,1992,4,"female",484,108,72,6,1,6,1,0,0
1445068,49,6,1964,8,"female",1523,405,233,1015,410,579,168,436,242
1445089,21,24,1992,4,"male",295,18,12,4,31,4,12,0,19
1445101,62,5,1951,10,"male",1090,366,290,17,49,0,23,17,26
1445107,59,31,1954,5,"female",1505,217,89,8,401,6,238,2,163
1445125,76,17,1937,8,"female",599,43,28,52,30,52,20,0,10
1445129,53,16,1960,12,"male",915,775,542,289,945,289,610,0,335
1445130,47,2,1966,8,"female",1694,331,125,504,1086,396,776,108,310
1445131,39,23,1974,9,"male",307,17,8,6,1,6,1,0,0
1445166,17,4,1996,2,"male",19,3,3,139,33,139,29,0,4
1445171,26,30,1987,5,"female",395,314,170,2583,1229,599,125,1984,1104
1445208,15,6,1998,7,"female",53,191,166,30,8,30,4,0,4
1445224,24,7,1989,7,"female",396,284,240,777,423,777,382,0,41
1445272,66,9,1947,11,"male",741,159,116,0,0,0,0,0,0
1445308,24,23,1989,3,"female",488,20,13,14,30,13,28,1,2
1445330,30,11,1983,8,"female",31,1,0,0,0,0,0,0,0
1445331,69,9,1944,12,"female",320,37,28,3,37,3,32,0,5
1445336,14,1,1999,11,"male",96,93,70,757,41,430,30,327,11
1445353,68,16,1945,11,"female",1460,88,21,3,0,3,0,0,0
1445415,42,18,1971,8,"female",493,8,4,0,0,0,0,0,0
1445445,22,12,1991,3,"male",89,28,21,34,15,0,4,34,11
1445452,18,24,1995,11,"female",131,132,125,45,66,22,17,23,49
1445460,18,18,1995,8,"female",54,63,34,25,16,25,10,0,6
1445469,94,7,1919,5,"male",1055,71,26,0,0,0,0,0,0
1445473,21,28,1992,1,"female",671,238,45,107,114,106,104,1,10
1445482,39,7,1974,2,"female",675,57,23,127,84,127,78,0,6
1445507,28,3,1985,9,"male",569,92,39,18,23,0,8,18,15
1445517,40,8,1973,5,"male",179,0,0,0,0,0,0,0,0
1445558,25,16,1988,4,"male",559,288,187,79,13,79,11,0,2
1445577,18,6,1995,10,"male",395,25,14,6,5,0,5,6,0
1445578,15,11,1998,6,"female",655,3742,2009,347,3477,347,2723,0,754
1445600,22,25,1991,4,"male",717,280,143,36,7,34,7,2,0
1445614,96,28,1917,3,"male",2157,204,122,69,79,0,53,69,26
1445628,58,22,1955,9,"male",481,13,11,0,0,0,0,0,0
1445651,32,6,1981,6,"male",292,187,115,0,0,0,0,0,0
1445653,64,7,1949,9,"female",196,204,118,185,367,0,77,185,290
1445655,15,25,1998,3,"female",218,322,213,479,290,258,154,221,136
1445664,13,15,2000,4,"male",380,252,194,1,2,0,2,1,0
1445666,14,22,1999,4,"male",478,214,102,0,3,0,1,0,2
1445670,22,20,1991,2,"male",316,8,6,2,2,2,2,0,0
1445693,23,1,1990,10,"female",388,1140,639,6940,3123,65,986,6875,2137
1445714,40,25,1973,12,"female",197,15,8,22,23,22,19,0,4
1445718,20,18,1993,4,"female",106,77,58,3830,1136,3830,697,0,439
1445721,15,3,1998,4,"female",600,79,54,5,0,4,0,1,0
1445776,60,2,1953,5,"female",229,54,33,4,0,0,0,4,0
1445797,27,31,1986,12,"male",406,202,34,2,9,0,7,2,2
1445798,15,24,1998,11,"male",95,11,6,6,7,6,6,0,1
1445804,23,1,1990,9,"male",502,91,44,0,0,0,0,0,0
1445819,32,28,1981,10,"female",473,13,5,3,2,3,2,0,0
1445840,24,30,1989,11,"female",224,72,46,51,38,51,35,0,3
1445843,93,3,1920,9,"female",244,179,141,0,7,0,3,0,4
1445847,63,2,1950,12,"male",1223,492,388,165,242,165,185,0,57
1445860,20,10,1993,3,"female",1278,829,544,1214,1839,484,1155,730,684
1445913,28,18,1985,3,"male",576,66,48,46,2,4,0,42,2
1445924,24,5,1989,4,"female",1205,397,206,753,216,210,137,543,79
1445931,63,9,1950,5,"female",717,141,29,3,6,1,6,2,0
1445950,82,8,1931,3,"female",988,351,99,510,432,482,344,28,88
1445957,43,10,1970,11,"female",599,116,47,1467,417,0,88,1467,329
1445977,28,25,1985,2,"male",826,2,0,50,8,0,0,50,8
1445979,27,13,1986,3,"male",821,88,35,3,4,2,1,1,3
1446033,31,10,1982,6,"female",235,693,12,327,1407,284,432,43,975
1446046,15,18,1998,9,"female",547,260,166,481,253,166,157,315,96
1446057,18,14,1995,6,"male",223,21,10,2,0,2,0,0,0
1446067,18,11,1995,6,"male",182,993,671,70,378,61,291,9,87
1446081,40,13,1973,6,"female",596,15,8,26,29,26,11,0,18
1446107,14,23,1999,9,"male",92,115,85,226,96,97,42,129,54
1446118,108,21,1905,11,"male",893,2049,719,1297,902,1297,650,0,252
1446119,56,29,1957,7,"female",797,14,11,0,1,0,1,0,0
1446131,34,25,1979,1,"female",157,172,142,0,1,0,1,0,0
1446197,105,2,1908,5,NA,2025,411,230,40,2,0,2,40,0
1446210,24,23,1989,6,"female",167,131,111,41,56,41,55,0,1
1446216,27,5,1986,3,"female",475,21,14,4,25,4,21,0,4
1446278,15,25,1998,1,"female",145,103,54,371,401,371,302,0,99
1446280,18,3,1995,9,"female",500,406,187,184,206,184,169,0,37
1446288,43,14,1970,1,"male",137,35,28,2,0,2,0,0,0
1446337,45,5,1968,1,"male",384,29,20,1,6,0,0,1,6
1446376,23,2,1990,4,"female",1755,1574,956,208,490,83,268,125,222
1446393,18,6,1995,1,"male",402,70,6,213,1,213,1,0,0
1446406,18,2,1995,10,"female",240,441,306,41,140,41,110,0,30
1446422,68,27,1945,5,"female",285,36,26,11,1,0,1,11,0
1446446,37,1,1976,1,"female",763,7,4,22,3,22,3,0,0
1446448,22,12,1991,4,"female",192,234,74,214,176,47,35,167,141
1446449,49,16,1964,7,"female",889,34,13,27,12,27,12,0,0
1446460,16,17,1997,4,"male",676,122,85,14,25,11,18,3,7
1446461,38,1,1975,10,"female",619,3,2,6,4,6,2,0,2
1446462,32,25,1981,5,"female",777,185,83,1,1,1,1,0,0
1446471,16,9,1997,8,"male",232,208,117,0,3,0,0,0,3
1446501,25,17,1988,1,"male",254,3,3,1,0,1,0,0,0
1446541,60,5,1953,11,"male",1078,146,28,35,37,27,14,8,23
1446554,36,29,1977,12,"female",10,47,33,0,0,0,0,0,0
1446558,32,13,1981,11,"male",629,114,77,13,1,13,1,0,0
1446587,24,26,1989,4,"male",319,156,137,55,68,55,30,0,38
1446601,14,31,1999,5,"male",118,4,3,0,0,0,0,0,0
1446610,43,5,1970,1,"male",424,4,4,0,0,0,0,0,0
1446631,56,16,1957,3,"male",605,105,91,0,0,0,0,0,0
1446641,108,5,1905,8,"female",1194,449,224,22,14,0,7,22,7
1446668,56,22,1957,9,"male",423,59,56,11,10,6,5,5,5
1446697,27,11,1986,7,"male",433,131,107,1,2,0,0,1,2
1446698,37,17,1976,5,"female",204,34,29,9,17,9,12,0,5
1446700,18,8,1995,8,"female",387,154,109,27,1,0,0,27,1
1446725,54,26,1959,3,"female",422,41,28,150,12,22,9,128,3
1446749,28,4,1985,4,"male",201,33,9,0,2,0,2,0,0
1446780,72,26,1941,2,"male",396,61,28,1,5,0,3,1,2
1446813,16,19,1997,2,"female",282,112,69,4,5,0,3,4,2
1446835,31,8,1982,6,"male",497,732,657,117,17,0,13,117,4
1446843,42,6,1971,8,"female",1066,131,85,95,29,8,16,87,13
1446846,22,11,1991,11,"male",1053,55,24,8,27,8,19,0,8
1446860,23,8,1990,11,"male",158,40,10,296,92,296,67,0,25
1446921,25,23,1988,11,"female",367,9,8,53,1,51,1,2,0
1446949,18,4,1995,1,"male",670,110,75,0,0,0,0,0,0
1446976,25,22,1988,4,"male",1340,840,123,60,36,57,26,3,10
1446993,23,6,1990,6,"male",437,908,681,60,270,60,242,0,28
1447005,27,17,1986,3,"male",1096,846,654,49,144,49,136,0,8
1447059,16,14,1997,6,"male",242,159,111,0,7,0,7,0,0
1447071,53,20,1960,9,"female",1417,27,18,0,0,0,0,0,0
1447110,15,26,1998,8,"male",464,59,47,1,6,1,4,0,2
1447118,23,18,1990,5,"male",287,173,99,1,1,0,1,1,0
1447125,21,21,1992,5,"male",446,99,23,17,1,17,1,0,0
1447127,54,5,1959,4,"female",355,125,99,20,7,20,4,0,3
1447144,21,17,1992,12,"male",341,89,59,13,11,0,2,13,9
1447154,26,1,1987,3,"female",407,147,33,53,77,53,68,0,9
1447174,47,18,1966,2,"male",435,59,36,0,0,0,0,0,0
1447175,19,7,1994,11,"male",316,335,90,0,0,0,0,0,0
1447211,28,16,1985,7,"female",354,144,96,1,51,1,41,0,10
1447234,47,14,1966,3,"male",354,338,262,0,4,0,3,0,1
1447258,30,28,1983,9,"male",597,150,93,3,8,1,8,2,0
1447293,31,9,1982,5,"male",425,137,22,1,35,0,16,1,19
1447295,19,27,1994,1,"female",467,162,111,118,204,76,95,42,109
1447297,46,17,1967,9,"male",287,231,113,136,28,75,15,61,13
1447309,66,20,1947,6,"female",395,138,104,386,391,1,107,385,284
1447319,18,9,1995,5,"male",521,525,448,3,16,3,15,0,1
1447331,60,9,1953,7,"female",659,32,11,0,1,0,1,0,0
1447345,79,7,1934,2,"male",1785,34,15,17,0,17,0,0,0
1447357,52,11,1961,8,"female",492,83,40,3,2,0,1,3,1
1447363,32,1,1981,11,"male",311,128,107,1,1,1,0,0,1
1447403,22,17,1991,5,"male",289,70,56,0,0,0,0,0,0
1447409,26,21,1987,7,"male",503,86,54,15,0,15,0,0,0
1447423,26,1,1987,1,"male",344,121,99,167,69,167,24,0,45
1447431,29,22,1984,8,"female",257,78,44,4,6,4,5,0,1
1447443,103,2,1910,9,"male",919,70,44,20,53,20,36,0,17
1447457,23,1,1990,11,"male",162,106,102,11,20,1,5,10,15
1447464,13,12,2000,2,"male",152,284,250,11,8,11,8,0,0
1447493,25,5,1988,3,"male",35,86,75,184,145,175,82,9,63
1447495,94,1,1919,4,"female",813,3929,2195,795,2409,574,1685,221,724
1447503,31,16,1982,11,"male",65,146,108,1,4,1,4,0,0
1447523,19,3,1994,10,"male",145,0,0,10,0,4,0,6,0
1447565,60,10,1953,8,"female",1570,116,38,121,43,116,17,5,26
1447584,20,6,1993,5,"female",773,305,154,707,1210,162,309,545,901
1447609,20,18,1993,8,"male",619,79,52,2,8,2,4,0,4
1447621,53,31,1960,10,"female",117,36,25,10,5,7,2,3,3
1447636,17,4,1996,11,"male",685,12,3,11,4,0,3,11,1
1447651,17,25,1996,10,"female",220,65,30,0,1,0,1,0,0
1447685,61,20,1952,12,"female",888,272,186,419,167,419,112,0,55
1447691,29,27,1984,2,"male",450,65,37,0,0,0,0,0,0
1447701,54,18,1959,3,"male",1130,66,25,11,34,9,16,2,18
1447732,113,20,1900,3,"male",2226,133,78,0,0,0,0,0,0
1447739,19,3,1994,6,"male",270,127,50,9,2,9,0,0,2
1447741,23,11,1990,10,"female",377,99,41,90,160,90,124,0,36
1447752,103,4,1910,11,"male",1265,853,659,35,73,30,42,5,31
1447852,14,16,1999,6,"male",106,403,369,16,6,13,2,3,4
1447897,29,29,1984,12,"female",469,197,123,225,246,221,93,4,153
1447906,24,19,1989,8,"male",334,65,29,1,21,1,13,0,8
1447913,17,1,1996,1,"male",91,33,30,1,6,1,3,0,3
1447954,17,5,1996,7,"male",763,208,114,2,1,2,0,0,1
1447989,29,13,1984,3,"male",361,21,8,40,13,0,1,40,12
1448003,24,5,1989,5,"male",391,35,28,0,6,0,2,0,4
1448025,76,28,1937,7,"male",1406,50,21,0,0,0,0,0,0
1448028,20,10,1993,2,"male",297,315,276,0,0,0,0,0,0
1448037,30,24,1983,5,"female",257,82,51,3,1,3,0,0,1
1448060,20,17,1993,8,"male",415,25,12,3,1,2,0,1,1
1448064,72,16,1941,6,"female",1329,7,4,3,2,2,0,1,2
1448088,41,17,1972,3,"female",932,118,66,504,152,504,83,0,69
1448090,108,12,1905,10,"female",1296,226,93,865,326,464,144,401,182
1448109,19,8,1994,8,"female",247,271,142,140,79,134,53,6,26
1448110,21,30,1992,9,"male",49,25,12,93,57,93,54,0,3
1448126,25,1,1988,1,"male",270,20,13,113,5,113,4,0,1
1448155,22,15,1991,4,"female",483,23,2,2,0,2,0,0,0
1448170,48,12,1965,10,"male",69,12,2,0,0,0,0,0,0
1448245,35,20,1978,12,"male",653,93,43,14,8,14,4,0,4
1448256,40,13,1973,3,"female",95,25,7,141,28,141,18,0,10
1448263,19,19,1994,3,"female",434,199,108,219,54,214,31,5,23
1448272,18,11,1995,6,"female",287,763,389,1936,2643,261,981,1675,1662
1448274,100,9,1913,11,"female",1445,86,42,1785,193,1785,123,0,70
1448341,26,10,1987,5,"female",229,299,154,39,43,39,37,0,6
1448342,15,15,1998,2,"male",194,88,68,2,4,2,4,0,0
1448396,69,28,1944,11,"female",2172,117,89,175,20,60,5,115,15
1448411,77,25,1936,5,"female",1750,222,87,240,204,18,58,222,146
1448415,25,5,1988,8,"male",338,207,173,54,22,6,12,48,10
1448455,31,27,1982,9,"male",297,123,91,3,5,3,5,0,0
1448461,24,10,1989,5,"male",189,154,92,85,89,85,39,0,50
1448491,28,29,1985,9,"male",571,110,87,0,1,0,1,0,0
1448535,36,24,1977,1,"male",10,5,4,0,0,0,0,0,0
1448561,20,29,1993,12,"male",371,3,3,0,0,0,0,0,0
1448578,82,11,1931,1,"female",809,43,32,1,0,0,0,1,0
1448640,49,25,1964,6,"male",1607,305,201,140,282,140,206,0,76
1448641,45,12,1968,4,"male",501,9,7,0,0,0,0,0,0
1448651,61,16,1952,7,"male",1096,25,7,7,3,1,1,6,2
1448652,35,24,1978,8,"female",1181,262,74,131,179,126,76,5,103
1448674,23,7,1990,11,"male",401,243,189,59,84,56,40,3,44
1448680,73,20,1940,12,"male",485,115,97,65,95,65,93,0,2
1448757,20,24,1993,4,"male",758,303,225,0,1,0,0,0,1
1448771,34,12,1979,1,"male",782,12,6,0,0,0,0,0,0
1448784,55,16,1958,9,NA,2028,92,24,16,34,16,19,0,15
1448785,59,7,1954,10,"female",417,47,43,66,20,0,15,66,5
1448798,108,23,1905,6,"male",30,234,229,209,144,202,80,7,64
1448799,27,29,1986,6,"female",374,35,28,7,3,0,0,7,3
1448804,27,6,1986,6,"male",290,288,143,25,84,1,69,24,15
1448809,47,26,1966,5,"female",1054,143,57,179,109,31,31,148,78
1448812,50,14,1963,6,"female",107,15,15,9,1,9,1,0,0
1448829,37,5,1976,11,"male",843,6,4,0,0,0,0,0,0
1448859,26,6,1987,11,"male",520,433,357,79,18,54,6,25,12
1448873,46,11,1967,7,"female",814,130,57,1,2,1,2,0,0
1448884,15,11,1998,12,"male",308,1049,525,57,107,57,85,0,22
1448905,27,29,1986,9,"male",477,368,285,317,743,62,556,255,187
1448930,39,1,1974,12,"female",300,50,38,99,50,99,48,0,2
1448944,16,22,1997,4,"female",209,255,154,377,56,377,54,0,2
1448945,103,20,1910,6,"female",489,67,40,39,74,39,33,0,41
1448958,92,17,1921,6,"male",1607,110,39,21,59,21,27,0,32
1448971,20,10,1993,12,"female",39,289,278,928,236,817,124,111,112
1448979,18,22,1995,11,"female",403,174,88,52,10,37,8,15,2
1448980,18,1,1995,1,"female",268,83,34,1,0,0,0,1,0
1449001,103,12,1910,12,"female",764,1421,839,1817,930,2,178,1815,752
1449008,18,12,1995,6,"male",64,33,14,8,1,8,1,0,0
1449028,108,12,1905,10,"male",1360,510,290,171,141,0,58,171,83
1449030,22,7,1991,5,"male",556,298,195,0,1,0,1,0,0
1449046,72,17,1941,2,"female",1514,78,48,83,43,64,9,19,34
1449064,29,1,1984,4,"male",355,2,1,0,0,0,0,0,0
1449082,26,24,1987,3,"female",241,221,74,10,10,10,9,0,1
1449115,25,19,1988,7,"male",338,102,100,15,2,10,1,5,1
1449153,25,23,1988,6,"female",504,13,8,23,2,17,2,6,0
1449161,51,25,1962,2,"male",1794,54,19,52,58,48,13,4,45
1449179,15,23,1998,12,"female",1168,1854,833,4981,3050,2300,1286,2681,1764
1449187,27,20,1986,3,"female",288,33,27,212,42,0,7,212,35
1449189,61,5,1952,1,"female",1016,33,16,1,17,0,5,1,12
1449243,33,15,1980,3,"male",108,140,121,273,187,273,171,0,16
1449252,34,10,1979,12,"female",8,4,4,3,0,3,0,0,0
1449265,24,10,1989,1,"male",357,201,183,98,2,98,1,0,1
1449307,66,4,1947,10,"male",800,238,164,238,127,238,97,0,30
1449319,23,1,1990,1,"female",599,935,292,1389,860,1389,644,0,216
1449360,20,30,1993,9,"female",232,57,4,8,1,8,1,0,0
1449379,33,8,1980,8,"male",158,150,132,540,8,540,6,0,2
1449396,98,18,1915,6,"male",269,189,160,0,0,0,0,0,0
1449413,32,28,1981,10,"male",522,155,46,24,85,24,66,0,19
1449449,103,21,1910,7,"female",814,1057,468,3474,1151,3474,1034,0,117
1449453,19,25,1994,6,"male",230,486,362,24,35,24,32,0,3
1449462,18,5,1995,11,"female",195,1456,686,1572,1516,1541,605,31,911
1449467,20,18,1993,1,"female",399,124,61,53,59,31,37,22,22
1449470,25,13,1988,10,"male",530,57,32,51,11,51,3,0,8
1449471,96,21,1917,10,"female",1787,109,51,58,48,58,26,0,22
1449502,103,3,1910,11,"female",476,122,42,0,28,0,7,0,21
1449509,37,26,1976,8,"female",340,78,43,1,2,1,2,0,0
1449522,42,20,1971,2,"male",832,88,10,0,0,0,0,0,0
1449548,84,1,1929,3,"male",1010,223,112,12,8,6,5,6,3
1449560,108,1,1905,1,"male",1443,114,83,187,61,0,20,187,41
1449594,55,1,1958,1,"female",362,167,101,846,301,31,140,815,161
1449615,29,1,1984,12,"female",326,68,43,177,196,177,168,0,28
1449621,83,9,1930,7,"male",1692,136,34,0,1,0,1,0,0
1449625,72,18,1941,5,"female",1456,47,19,0,0,0,0,0,0
1449662,41,18,1972,12,"female",294,72,24,2,0,2,0,0,0
1449670,22,29,1991,3,"male",314,155,91,48,88,5,10,43,78
1449675,66,16,1947,10,"female",1785,313,210,317,377,315,255,2,122
1449689,58,12,1955,7,NA,1980,60,22,25,15,21,3,4,12
1449702,34,11,1979,11,"male",563,26,5,99,31,99,7,0,24
1449732,36,22,1977,9,"female",327,6,5,4,2,0,0,4,2
1449742,42,21,1971,12,"female",87,43,8,379,306,379,293,0,13
1449744,24,10,1989,3,"male",299,91,68,0,0,0,0,0,0
1449750,36,7,1977,2,"male",218,73,38,1,2,1,1,0,1
1449756,17,10,1996,5,"female",209,19,10,0,1,0,0,0,1
1449760,51,28,1962,5,"male",828,123,9,215,141,40,91,175,50
1449761,56,1,1957,9,"male",521,37,16,1,0,1,0,0,0
1449773,66,9,1947,4,"male",779,38,20,108,3,0,1,108,2
1449777,18,24,1995,7,"female",658,271,126,67,30,9,15,58,15
1449783,49,24,1964,8,"female",1048,50,26,37,4,0,2,37,2
1449795,18,17,1995,2,"male",454,82,13,0,0,0,0,0,0
1449823,65,29,1948,6,"male",245,50,28,15,30,0,12,15,18
1449827,22,1,1991,1,"male",33,22,19,0,2,0,2,0,0
1449847,93,2,1920,6,"male",543,49,29,0,0,0,0,0,0
1449852,44,8,1969,5,"female",1707,96,30,269,115,181,52,88,63
1449861,43,8,1970,4,"male",143,9,1,4,1,0,0,4,1
1449870,24,28,1989,8,"female",320,17,2,0,0,0,0,0,0
1449897,36,11,1977,8,"male",473,73,43,4,5,3,3,1,2
1449903,24,12,1989,8,"male",300,107,89,25,1,25,1,0,0
1449924,31,17,1982,1,"female",290,50,28,178,77,0,50,178,27
1449930,73,7,1940,9,"female",54,51,10,17,46,17,45,0,1
1449934,68,9,1945,7,"male",63,10,9,24,41,0,18,24,23
1449954,18,15,1995,9,"female",110,354,288,633,660,219,493,414,167
1449996,35,17,1978,4,"male",79,8,7,8,8,8,4,0,4
1450029,63,1,1950,1,"male",914,95,62,3,1,3,0,0,1
1450093,113,29,1900,10,"male",1902,794,161,297,264,245,145,52,119
1450119,22,11,1991,1,"male",33,264,241,193,17,193,8,0,9
1450150,21,9,1992,9,"male",711,247,195,4,0,4,0,0,0
1450177,29,10,1984,9,"male",1502,249,113,3,0,3,0,0,0
1450186,19,22,1994,5,"female",849,748,505,178,456,41,355,137,101
1450212,18,10,1995,8,"male",653,319,208,24,12,24,8,0,4
1450222,52,5,1961,10,"female",411,56,26,77,80,0,21,77,59
1450237,29,9,1984,6,"male",93,41,29,57,63,8,3,49,60
1450247,21,24,1992,6,"male",349,104,85,2,5,2,0,0,5
1450302,38,8,1975,9,"male",121,77,64,8,5,8,5,0,0
1450306,14,12,1999,10,"female",319,108,68,0,0,0,0,0,0
1450333,35,15,1978,6,"male",329,58,43,29,3,15,1,14,2
1450343,17,13,1996,7,"male",1117,220,94,76,47,73,14,3,33
1450376,19,3,1994,3,"male",474,172,99,0,4,0,3,0,1
1450390,24,27,1989,1,"male",302,186,174,3,5,3,2,0,3
1450430,21,22,1992,12,"male",650,7,2,0,1,0,1,0,0
1450465,23,8,1990,7,"female",943,34,27,0,20,0,17,0,3
1450470,103,30,1910,11,"female",521,239,111,27,457,27,425,0,32
1450482,55,13,1958,10,"female",317,4,4,11,1,11,0,0,1
1450483,18,24,1995,11,"female",197,145,115,28,39,24,20,4,19
1450519,27,27,1986,9,"male",479,335,308,2,2,2,2,0,0
1450528,38,17,1975,1,"male",357,2,1,15,1,15,1,0,0
1450609,36,21,1977,6,"male",493,60,32,59,82,59,81,0,1
1450632,20,28,1993,12,"female",836,70,36,0,0,0,0,0,0
1450660,22,4,1991,3,"male",247,50,25,130,63,68,32,62,31
1450669,19,2,1994,11,"female",104,155,103,150,256,8,149,142,107
1450693,15,2,1998,8,"male",226,6,5,0,0,0,0,0,0
1450712,26,2,1987,10,"male",278,650,310,8802,1332,8571,921,231,411
1450718,22,19,1991,12,"male",671,1533,967,809,5895,683,2593,126,3302
1450722,108,5,1905,5,"female",461,584,162,35,28,35,25,0,3
1450746,71,13,1942,1,"male",1503,33,20,18,8,18,8,0,0
1450857,48,25,1965,2,"female",48,33,28,124,198,62,113,62,85
1450870,48,12,1965,6,"male",90,3,3,0,0,0,0,0,0
1450915,54,12,1959,11,"female",747,88,48,29,6,29,2,0,4
1450920,26,14,1987,2,"male",280,2,0,0,0,0,0,0,0
1450942,26,28,1987,4,"male",470,44,16,9,11,6,9,3,2
1450943,30,21,1983,6,"female",156,54,30,23,7,0,2,23,5
1450976,17,28,1996,12,"male",602,90,68,28,4,28,3,0,1
1450992,21,19,1992,1,"female",439,71,35,33,9,4,2,29,7
1450997,16,7,1997,7,"male",376,117,99,7,5,7,4,0,1
1451007,30,19,1983,1,"male",444,0,0,0,0,0,0,0,0
1451016,15,3,1998,3,"female",271,330,74,1,0,0,0,1,0
1451027,27,1,1986,6,"male",1598,594,151,9,0,9,0,0,0
1451029,15,18,1998,11,"male",57,82,54,29,14,29,7,0,7
1451037,19,22,1994,4,"female",82,171,152,17,29,17,27,0,2
1451050,18,26,1995,6,"female",717,809,354,2015,1459,1851,446,164,1013
1451054,19,27,1994,11,"male",430,199,139,28,31,28,16,0,15
1451057,25,6,1988,6,"male",234,1,1,2,0,2,0,0,0
1451132,18,19,1995,5,"male",931,841,654,2,2,2,2,0,0
1451146,25,20,1988,9,"female",289,207,85,19,9,16,4,3,5
1451179,54,12,1959,9,"female",394,38,21,4,1,1,1,3,0
1451187,46,9,1967,7,"female",1169,812,318,191,428,181,201,10,227
1451202,71,16,1942,12,"male",182,2,1,0,5,0,1,0,4
1451213,38,19,1975,10,"male",368,0,0,0,0,0,0,0,0
1451220,19,21,1994,11,"male",342,63,56,63,12,44,5,19,7
1451227,25,29,1988,10,"female",73,460,31,3,60,3,27,0,33
1451257,33,10,1980,10,"male",0,0,0,0,0,0,0,0,0
1451333,25,10,1988,11,"male",413,6,6,239,1,0,1,239,0
1451342,108,29,1905,12,"female",1506,824,392,709,424,40,140,669,284
1451353,22,14,1991,12,"male",648,67,62,11,3,4,2,7,1
1451354,41,9,1972,6,"female",604,11,3,21,2,21,2,0,0
1451366,20,5,1993,11,"female",1576,772,518,336,400,74,129,262,271
1451381,21,17,1992,4,"female",527,178,38,0,83,0,23,0,60
1451391,18,19,1995,6,"male",309,272,255,14,8,14,5,0,3
1451412,19,20,1994,8,"male",157,31,22,0,0,0,0,0,0
1451425,23,11,1990,6,"female",322,0,0,0,0,0,0,0,0
1451446,16,27,1997,1,"male",26,6,4,1,1,0,1,1,0
1451516,14,19,1999,5,"female",293,41,14,0,3,0,3,0,0
1451520,19,1,1994,1,"male",31,49,43,4,4,4,0,0,4
1451542,108,10,1905,1,"female",1291,3403,314,123,381,123,324,0,57
1451575,56,28,1957,10,"male",253,72,46,1,6,1,6,0,0
1451576,55,8,1958,2,"male",215,42,38,6,0,3,0,3,0
1451593,64,20,1949,1,"male",156,0,0,9,0,0,0,9,0
1451595,25,21,1988,12,"female",745,116,63,8,2,6,1,2,1
1451613,25,24,1988,5,"male",639,111,96,2,0,0,0,2,0
1451618,19,17,1994,1,"female",559,23,12,0,0,0,0,0,0
1451625,15,4,1998,9,"male",447,8,7,4,3,4,3,0,0
1451647,68,17,1945,12,"male",1738,18,11,0,0,0,0,0,0
1451648,24,21,1989,5,"male",430,7,7,0,2,0,2,0,0
1451657,14,18,1999,1,"male",496,104,43,0,4,0,4,0,0
1451742,18,2,1995,12,"male",34,22,18,0,0,0,0,0,0
1451753,18,18,1995,1,"male",600,7,2,1,2,0,2,1,0
1451764,21,30,1992,8,"male",405,235,136,10,29,10,29,0,0
1451775,21,5,1992,1,"male",473,300,221,1,3,1,2,0,1
1451793,34,21,1979,12,"female",229,37,13,364,92,364,35,0,57
1451797,60,21,1953,12,"male",1830,393,176,1444,786,13,353,1431,433
1451807,17,22,1996,3,"female",1312,729,341,2669,2998,1915,1420,754,1578
1451813,24,29,1989,8,"female",62,14,13,0,0,0,0,0,0
1451816,18,5,1995,1,"male",562,351,302,2,0,0,0,2,0
1451825,58,1,1955,2,"female",1490,152,70,418,744,9,504,409,240
1451834,15,8,1998,1,"female",504,278,154,0,9,0,1,0,8
1451858,18,20,1995,1,"female",339,165,95,271,326,71,238,200,88
1451894,25,26,1988,11,"male",266,0,0,0,0,0,0,0,0
1451905,25,19,1988,9,"female",362,26,7,0,0,0,0,0,0
1451908,74,15,1939,12,"female",1756,40,21,12,7,0,0,12,7
1451950,31,22,1982,7,"female",538,16,7,0,1,0,0,0,1
1451975,71,6,1942,1,"male",1391,35,7,1,1,1,1,0,0
1451994,36,5,1977,2,"male",242,28,18,0,2,0,2,0,0
1452025,44,11,1969,6,"female",1777,126,83,327,148,327,51,0,97
1452030,17,3,1996,3,"female",889,359,166,297,318,120,107,177,211
1452042,65,6,1948,3,"male",112,43,34,1,1,0,0,1,1
1452060,20,9,1993,9,"female",103,7,7,0,0,0,0,0,0
1452082,108,6,1905,10,"male",501,1221,816,111,294,111,282,0,12
1452083,32,6,1981,10,"male",425,74,58,0,49,0,42,0,7
1452086,25,2,1988,9,"male",303,19,13,0,0,0,0,0,0
1452093,48,7,1965,12,"male",882,108,46,6,1,5,1,1,0
1452119,20,8,1993,1,"male",500,66,10,11,25,11,15,0,10
1452145,33,27,1980,7,"female",650,11,5,0,0,0,0,0,0
1452161,68,22,1945,12,"female",480,1342,977,2002,2702,2000,2043,2,659
1452166,101,5,1912,4,"male",2026,388,293,22,8,21,6,1,2
1452198,69,3,1944,7,"male",671,20,15,8,5,8,4,0,1
1452199,17,17,1996,8,"female",99,24,9,80,15,45,13,35,2
1452224,76,21,1937,11,"male",564,70,43,15,37,0,13,15,24
1452239,20,30,1993,9,"female",269,13,4,589,551,589,274,0,277
1452281,108,2,1905,5,"male",1123,323,266,1,5,0,4,1,1
1452297,68,1,1945,12,"male",48,261,228,43,28,0,19,43,9
1452308,61,28,1952,9,"male",673,175,28,486,93,19,65,467,28
1452310,56,4,1957,10,"female",804,111,86,283,82,0,11,283,71
1452316,27,9,1986,11,"female",254,23,9,0,0,0,0,0,0
1452324,22,5,1991,5,"male",743,61,29,1,0,1,0,0,0
1452330,18,5,1995,2,"male",726,259,129,26,82,26,69,0,13
1452337,14,20,1999,2,"female",134,206,131,21,71,17,51,4,20
1452359,24,9,1989,8,"male",249,37,21,2,0,0,0,2,0
1452367,17,4,1996,11,"male",595,42,17,16,22,4,12,12,10
1452385,23,19,1990,9,"male",848,1100,381,735,807,711,229,24,578
1452388,50,23,1963,6,"female",524,28,15,8,0,6,0,2,0
1452402,71,27,1942,3,"female",1041,42,28,0,0,0,0,0,0
1452405,64,14,1949,10,"male",579,26,13,8,5,0,1,8,4
1452413,66,24,1947,4,"male",1404,62,33,5,20,2,12,3,8
1452418,29,1,1984,5,"male",263,53,12,0,4,0,4,0,0
1452429,17,7,1996,10,"male",441,257,228,4,1,4,1,0,0
1452434,64,6,1949,10,"female",579,98,46,119,84,15,44,104,40
1452443,31,22,1982,12,"female",281,101,86,73,35,73,25,0,10
1452450,68,13,1945,9,"female",1362,104,52,7,36,1,23,6,13
1452451,22,15,1991,11,"male",121,55,44,10,13,10,13,0,0
1452513,56,3,1957,2,"male",1161,81,41,15,36,4,18,11,18
1452528,39,2,1974,5,"female",477,34,21,9,10,9,9,0,1
1452543,31,1,1982,1,"male",546,2,0,0,0,0,0,0,0
1452551,23,1,1990,7,"female",124,15,8,1,0,1,0,0,0
1452558,48,19,1965,9,"male",506,302,161,8936,4133,8934,3279,2,854
1452582,28,9,1985,7,"male",913,5,2,20,6,20,6,0,0
1452587,108,31,1905,7,"female",1157,45,26,71,12,0,0,71,12
1452632,31,11,1982,6,"male",540,112,67,1,0,1,0,0,0
1452683,21,1,1992,7,"female",634,787,329,1169,1777,944,1499,225,278
1452704,25,1,1988,9,"female",51,46,40,18,16,18,16,0,0
1452741,23,22,1990,1,"male",443,41,4,0,0,0,0,0,0
1452758,47,1,1966,5,"female",727,344,146,220,67,202,50,18,17
1452779,61,10,1952,12,"male",14,27,11,2,13,2,12,0,1
1452801,23,1,1990,1,"male",218,0,0,0,0,0,0,0,0
1452813,35,27,1978,9,"male",275,7,1,6,6,6,6,0,0
1452828,103,15,1910,3,"male",1018,279,90,2,1,2,1,0,0
1452831,28,4,1985,6,"female",1214,322,139,21,17,18,12,3,5
1452847,57,8,1956,7,"male",559,43,30,43,20,0,18,43,2
1452854,22,14,1991,1,"male",685,174,111,0,2,0,2,0,0
1452857,38,23,1975,11,"female",211,125,106,7,17,7,12,0,5
1452899,21,4,1992,4,"male",221,15,9,0,1,0,1,0,0
1452903,17,26,1996,8,"male",659,152,100,1,1,1,1,0,0
1452920,56,7,1957,10,"male",871,66,35,2,15,2,3,0,12
1452940,25,5,1988,2,"female",32,5,3,3,5,3,5,0,0
1452965,19,14,1994,8,"male",420,232,187,89,5,89,3,0,2
1452972,25,1,1988,4,"male",53,123,68,172,123,0,45,172,78
1452977,100,5,1913,3,"male",1809,224,111,270,171,270,127,0,44
1453003,25,1,1988,1,"male",50,10,10,1,2,1,2,0,0
1453011,71,16,1942,8,"male",1269,20,9,0,3,0,3,0,0
1453023,56,14,1957,8,"male",975,130,5,17,339,17,260,0,79
1453033,18,5,1995,9,"male",475,315,234,186,115,186,102,0,13
1453041,15,17,1998,7,"female",238,23,20,10,0,10,0,0,0
1453059,19,4,1994,4,"male",0,0,0,1,1,1,1,0,0
1453069,19,17,1994,2,"male",472,52,35,0,1,0,1,0,0
1453076,15,15,1998,1,"female",384,496,298,210,161,0,67,210,94
1453079,18,17,1995,7,"male",122,86,71,39,13,39,10,0,3
1453080,16,16,1997,4,"male",442,204,178,35,6,35,6,0,0
1453105,23,18,1990,9,"female",343,534,214,25,734,25,475,0,259
1453140,18,8,1995,6,"male",102,313,280,149,25,149,21,0,4
1453158,75,2,1938,7,"male",1022,62,33,49,23,0,3,49,20
1453187,14,20,1999,3,"female",137,79,46,67,3,67,3,0,0
1453205,43,28,1970,8,"male",951,2,1,0,0,0,0,0,0
1453210,18,20,1995,10,"female",202,185,153,18,10,1,5,17,5
1453216,103,10,1910,1,"male",377,243,114,308,73,308,65,0,8
1453224,20,20,1993,8,"female",641,293,204,47,231,40,159,7,72
1453243,23,26,1990,9,"male",141,120,72,4,21,3,11,1,10
1453255,23,5,1990,4,"male",328,124,94,8,1,8,1,0,0
1453272,26,7,1987,12,"female",239,57,33,228,110,228,107,0,3
1453297,25,15,1988,12,"male",398,60,48,3,1,3,1,0,0
1453301,23,22,1990,4,"male",47,11,7,3,2,3,2,0,0
1453316,26,18,1987,8,"female",278,17,8,59,7,30,4,29,3
1453326,54,22,1959,3,"female",253,24,15,29,66,27,48,2,18
1453327,19,27,1994,3,"male",193,72,30,1,0,1,0,0,0
1453348,29,15,1984,11,"male",295,48,45,3,1,3,1,0,0
1453374,76,17,1937,1,"male",1944,36,20,57,27,0,12,57,15
1453391,16,25,1997,2,"male",476,453,392,46,22,17,4,29,18
1453413,20,10,1993,7,"male",285,6,3,0,0,0,0,0,0
1453436,25,29,1988,8,"male",666,210,153,2,0,2,0,0,0
1453438,85,15,1928,2,"male",535,164,113,0,0,0,0,0,0
1453444,59,10,1954,10,"female",243,183,93,602,168,600,145,2,23
1453456,59,24,1954,6,"female",2161,84,61,31,26,0,12,31,14
1453471,20,21,1993,3,"female",97,291,125,10,89,10,88,0,1
1453472,17,26,1996,1,"male",536,231,73,72,78,14,33,58,45
1453496,100,1,1913,1,"male",621,46,25,0,0,0,0,0,0
1453511,105,8,1908,11,NA,1357,252,163,162,46,136,29,26,17
1453516,23,26,1990,7,"male",493,48,29,1,6,1,0,0,6
1453529,66,11,1947,7,"male",1656,36,8,1,1,0,0,1,1
1453540,35,4,1978,12,"male",712,29,22,36,8,0,7,36,1
1453550,32,16,1981,3,"male",296,53,33,5,0,5,0,0,0
1453555,24,31,1989,12,"female",326,256,103,282,264,282,247,0,17
1453561,19,4,1994,4,"female",178,27,11,0,0,0,0,0,0
1453568,16,3,1997,12,"female",571,840,455,495,787,494,572,1,215
1453607,24,7,1989,9,"male",445,102,77,0,6,0,4,0,2
1453633,16,27,1997,5,"male",599,64,18,0,0,0,0,0,0
1453651,31,27,1982,10,"male",140,30,15,0,0,0,0,0,0
1453664,23,17,1990,11,"female",11,59,53,4,17,4,15,0,2
1453677,50,19,1963,2,"female",897,221,89,23,12,23,6,0,6
1453678,103,1,1910,7,"male",597,801,625,0,0,0,0,0,0
1453680,18,11,1995,8,"female",442,83,27,4,13,0,7,4,6
1453694,51,8,1962,7,"female",133,49,28,184,106,0,72,184,34
1453695,32,13,1981,4,"male",518,303,214,10,54,10,49,0,5
1453717,19,10,1994,4,"female",449,391,253,15,5,0,0,15,5
1453720,108,17,1905,5,"male",233,81,59,0,0,0,0,0,0
1453722,69,20,1944,5,"male",1271,53,35,11,5,11,4,0,1
1453752,16,26,1997,9,"male",1008,168,105,0,0,0,0,0,0
1453795,48,20,1965,1,"male",2255,471,248,82,174,24,115,58,59
1453827,23,26,1990,3,"female",673,182,91,304,226,300,141,4,85
1453829,48,29,1965,12,"male",1190,48,24,0,3,0,3,0,0
1453840,19,12,1994,11,"male",571,2011,334,9,959,5,465,4,494
1453882,18,8,1995,1,"male",527,659,538,3,2,1,2,2,0
1453905,26,1,1987,1,"male",40,52,24,0,1,0,1,0,0
1453917,18,29,1995,10,"male",596,289,186,0,0,0,0,0,0
1453932,45,30,1968,5,"male",280,43,27,4,6,3,4,1,2
1453954,24,3,1989,2,"male",508,5,0,0,0,0,0,0,0
1453969,100,18,1913,5,"female",2173,483,238,88,9,72,2,16,7
1453994,32,5,1981,7,"male",218,110,101,0,0,0,0,0,0
1454065,19,15,1994,4,"male",756,136,110,6,5,0,2,6,3
1454069,24,7,1989,7,"male",299,71,28,0,0,0,0,0,0
1454092,27,25,1986,8,"male",96,28,16,1,0,1,0,0,0
1454100,61,22,1952,4,"female",731,84,44,3,11,0,5,3,6
1454112,43,12,1970,4,"female",216,160,76,110,63,98,48,12,15
1454144,100,27,1913,2,"male",899,58,35,0,0,0,0,0,0
1454217,59,22,1954,12,"female",990,22,8,1,1,0,1,1,0
1454228,21,6,1992,2,"female",139,500,151,779,986,777,411,2,575
1454235,16,17,1997,8,"male",453,525,470,3,0,0,0,3,0
1454236,87,18,1926,1,"male",1666,53,12,0,2,0,2,0,0
1454246,31,21,1982,8,"female",663,126,55,73,102,71,99,2,3
1454330,19,16,1994,8,"female",235,557,253,2023,746,1324,363,699,383
1454343,44,26,1969,11,"female",488,117,69,2,12,0,11,2,1
1454366,21,16,1992,4,"male",65,65,49,1,10,1,5,0,5
1454375,64,8,1949,11,"female",309,67,56,295,57,0,17,295,40
1454390,15,25,1998,1,"male",340,0,0,0,0,0,0,0,0
1454402,24,29,1989,1,"male",17,0,0,0,0,0,0,0,0
1454403,71,30,1942,4,"female",1893,320,105,169,256,155,135,14,121
1454408,31,11,1982,3,"male",111,11,7,17,2,0,0,17,2
1454461,69,17,1944,10,"male",661,443,256,54,219,42,141,12,78
1454468,108,25,1905,7,"female",1269,873,291,156,34,139,16,17,18
1454509,31,11,1982,8,"male",274,31,18,13,30,1,12,12,18
1454543,20,11,1993,5,"male",294,25,3,16,14,16,13,0,1
1454570,21,2,1992,9,"female",423,282,91,71,160,71,63,0,97
1454583,30,1,1983,6,"male",591,155,132,8,19,8,19,0,0
1454594,33,15,1980,6,"female",1209,76,23,56,72,56,62,0,10
1454602,14,13,1999,7,"male",582,44,38,8,4,6,1,2,3
1454608,38,13,1975,2,"female",164,19,14,10,4,10,2,0,2
1454645,56,8,1957,1,"male",740,10,2,0,0,0,0,0,0
1454669,34,1,1979,1,"male",771,70,40,1,2,1,1,0,1
1454670,55,6,1958,12,"male",607,9,1,17,5,17,4,0,1
1454672,25,29,1988,8,"male",239,200,170,214,55,214,39,0,16
1454694,50,11,1963,9,"female",1636,78,41,675,511,235,330,440,181
1454695,58,18,1955,3,"female",145,141,106,36,9,0,1,36,8
1454699,46,23,1967,5,"female",816,28,27,105,13,105,5,0,8
1454704,27,6,1986,12,"male",67,34,13,14,0,14,0,0,0
1454707,19,5,1994,4,"female",651,62,48,0,0,0,0,0,0
1454739,44,2,1969,10,"male",278,30,28,15,8,15,7,0,1
1454744,27,24,1986,7,"male",249,27,18,0,3,0,1,0,2
1454774,20,6,1993,12,"male",791,40,28,14,4,14,3,0,1
1454784,98,11,1915,6,"male",1331,137,54,449,113,449,102,0,11
1454791,87,8,1926,1,"male",610,1277,924,156,292,0,113,156,179
1454803,36,31,1977,3,"female",524,49,17,33,29,21,15,12,14
1454806,65,1,1948,6,"female",1539,18,10,94,12,3,0,91,12
1454859,25,11,1988,9,"male",64,43,36,2,6,2,6,0,0
1454915,29,15,1984,10,"male",608,125,82,5,6,5,5,0,1
1454917,32,22,1981,11,"male",409,135,102,14,3,14,2,0,1
1454920,15,8,1998,10,"male",284,126,74,490,398,394,202,96,196
1454935,20,15,1993,7,"male",823,136,123,43,5,43,5,0,0
1454961,32,24,1981,10,"female",453,65,34,37,109,37,98,0,11
1454970,54,8,1959,2,"female",379,236,174,1,4,1,4,0,0
1455008,20,15,1993,7,"male",506,311,79,181,16,61,8,120,8
1455027,26,23,1987,4,"female",725,265,143,1664,611,994,290,670,321
1455054,55,23,1958,5,"female",1134,87,49,96,74,96,49,0,25
1455063,29,26,1984,4,"female",896,629,190,1321,621,1321,312,0,309
1455106,65,25,1948,8,"female",1946,194,106,483,155,454,106,29,49
1455118,45,16,1968,6,"male",576,67,39,0,0,0,0,0,0
1455152,18,2,1995,6,"male",140,132,59,17,36,17,28,0,8
1455154,35,23,1978,3,"male",456,97,62,88,27,88,6,0,21
1455180,21,24,1992,5,"female",682,1742,747,513,1805,38,608,475,1197
1455191,42,26,1971,10,"female",444,92,65,56,52,56,49,0,3
1455204,22,8,1991,7,"male",150,23,22,0,0,0,0,0,0
1455216,98,6,1915,4,"female",264,90,44,38,52,35,6,3,46
1455250,38,14,1975,6,"male",110,29,21,2,2,2,2,0,0
1455276,52,23,1961,5,"male",77,0,0,0,0,0,0,0,0
1455287,103,15,1910,8,"male",767,100,43,73,3,47,2,26,1
1455317,48,2,1965,12,"female",741,75,36,37,31,37,22,0,9
1455323,68,20,1945,4,"male",1005,980,642,25,68,25,49,0,19
1455325,27,30,1986,4,"male",914,215,88,26,100,26,91,0,9
1455332,33,1,1980,1,"male",807,802,565,440,698,333,391,107,307
1455341,40,8,1973,10,"male",27,45,37,7,14,7,12,0,2
1455349,36,20,1977,2,"male",347,43,20,0,45,0,32,0,13
1455373,26,15,1987,5,"male",348,3,0,2,0,2,0,0,0
1455378,15,12,1998,8,"male",146,114,91,2,1,2,0,0,1
1455393,19,16,1994,10,"female",268,503,264,7,5,7,0,0,5
1455395,19,10,1994,12,"male",255,118,79,41,17,38,16,3,1
1455397,18,30,1995,5,"male",18,55,52,8,7,7,2,1,5
1455416,25,24,1988,5,"female",439,25,6,0,0,0,0,0,0
1455423,54,12,1959,5,"female",485,125,80,89,84,88,67,1,17
1455441,64,9,1949,5,"female",1337,86,40,88,7,88,1,0,6
1455443,25,12,1988,1,"female",423,24,14,6,18,6,18,0,0
1455455,20,1,1993,12,"male",420,178,112,24,19,24,14,0,5
1455459,73,13,1940,2,"female",1554,47,19,0,0,0,0,0,0
1455467,27,1,1986,2,"female",429,69,50,6,18,6,15,0,3
1455473,45,1,1968,10,"female",500,32,16,5,19,0,5,5,14
1455474,34,31,1979,7,"female",442,22,8,47,3,47,3,0,0
1455496,39,27,1974,3,"male",633,96,81,34,29,28,17,6,12
1455527,18,29,1995,4,"female",183,20,6,0,2,0,2,0,0
1455534,21,4,1992,5,"male",531,300,232,0,0,0,0,0,0
1455580,42,26,1971,8,"male",490,132,59,5,5,1,1,4,4
1455589,17,15,1996,5,"male",293,42,33,0,3,0,2,0,1
1455595,55,19,1958,4,"female",649,83,25,42,1,5,0,37,1
1455632,23,17,1990,1,"female",510,44,17,5,9,1,3,4,6
1455655,63,24,1950,2,"female",416,25,12,21,2,21,2,0,0
1455658,58,29,1955,4,"female",472,182,87,92,139,0,40,92,99
1455676,22,12,1991,7,"male",187,257,248,89,4,89,2,0,2
1455683,21,10,1992,11,"male",360,362,332,44,32,44,25,0,7
1455688,47,1,1966,1,"male",324,49,38,2,19,2,17,0,2
1455697,18,7,1995,7,"female",195,94,38,81,32,81,29,0,3
1455698,47,25,1966,12,"female",485,212,115,548,13,0,2,548,11
1455759,16,14,1997,11,"female",510,114,72,16,34,9,18,7,16
1455762,14,29,1999,8,"female",100,252,211,27,87,27,76,0,11
1455785,50,28,1963,6,"female",789,67,13,23,18,13,15,10,3
1455805,17,3,1996,1,"male",466,28,17,0,2,0,2,0,0
1455848,25,1,1988,1,"male",43,1,1,0,0,0,0,0,0
1455850,19,28,1994,4,"male",774,657,571,2,23,2,15,0,8
1455853,57,15,1956,9,"male",230,323,151,16,9,6,4,10,5
1455854,19,17,1994,3,"female",433,115,86,168,181,147,90,21,91
1455905,14,3,1999,5,"female",76,242,40,13,7,2,4,11,3
1455913,15,2,1998,10,"female",324,306,235,31,0,27,0,4,0
1455928,49,28,1964,2,"female",238,26,16,26,0,17,0,9,0
1455950,58,12,1955,5,"female",97,28,17,5,14,5,12,0,2
1455954,21,3,1992,3,"female",140,26,16,0,0,0,0,0,0
1456035,20,12,1993,3,"male",1131,464,68,11,28,7,15,4,13
1456043,29,11,1984,12,"male",31,41,39,5,4,5,4,0,0
1456045,21,31,1992,8,"female",1684,4080,278,27,446,17,260,10,186
1456056,33,25,1980,7,"male",284,15,15,0,1,0,0,0,1
1456140,39,21,1974,10,"male",511,30,3,26,11,5,8,21,3
1456199,34,5,1979,12,"male",340,45,32,0,1,0,0,0,1
1456216,67,24,1946,1,"female",933,42,26,250,7,0,5,250,2
1456235,17,4,1996,6,"female",351,758,563,31,14,27,11,4,3
1456266,19,6,1994,4,"male",104,490,362,10,37,10,26,0,11
1456268,29,21,1984,4,"male",158,50,41,1,0,1,0,0,0
1456277,19,19,1994,5,"male",291,244,203,0,2,0,2,0,0
1456285,31,15,1982,2,"female",358,114,60,6,47,6,44,0,3
1456288,52,9,1961,6,"male",85,14,11,2,0,2,0,0,0
1456299,24,25,1989,4,"male",202,25,11,1,0,1,0,0,0
1456300,29,6,1984,2,"male",114,22,21,5,0,5,0,0,0
1456313,32,27,1981,7,"male",643,0,0,0,0,0,0,0,0
1456321,34,3,1979,3,"male",473,90,43,4,7,4,6,0,1
1456323,60,13,1953,3,"female",1062,99,37,383,50,380,10,3,40
1456337,58,15,1955,8,"female",904,274,211,8,47,8,30,0,17
1456338,25,1,1988,1,"male",441,205,194,0,1,0,0,0,1
1456404,60,19,1953,7,"female",95,0,0,0,0,0,0,0,0
1456420,71,12,1942,11,"female",412,55,39,244,72,0,19,244,53
1456439,17,18,1996,8,"female",214,15,10,16,0,0,0,16,0
1456468,28,29,1985,8,"male",286,220,156,63,48,63,37,0,11
1456535,23,16,1990,8,"male",892,164,99,12,62,10,47,2,15
1456545,56,7,1957,8,"female",947,62,44,7,1,7,1,0,0
1456548,71,5,1942,2,"female",1005,101,69,63,70,0,44,63,26
1456557,21,16,1992,2,"male",446,691,521,3067,348,3058,271,9,77
1456586,25,11,1988,11,"male",103,24,21,0,7,0,4,0,3
1456603,31,14,1982,10,"male",34,94,86,1,0,1,0,0,0
1456627,65,28,1948,10,"female",245,50,42,13,26,13,10,0,16
1456672,41,17,1972,5,"male",535,2,0,0,0,0,0,0,0
1456698,101,21,1912,9,"female",704,118,28,66,56,37,15,29,41
1456710,15,13,1998,3,"male",424,144,95,0,10,0,4,0,6
1456712,15,15,1998,10,"male",88,64,62,3,2,3,2,0,0
1456765,24,21,1989,11,"male",434,1,0,1,0,0,0,1,0
1456768,35,20,1978,7,"male",409,420,399,11,0,0,0,11,0
1456825,17,22,1996,4,"female",632,456,120,3,3,0,1,3,2
1456832,28,1,1985,4,"male",236,7,4,138,11,10,0,128,11
1456837,57,17,1956,2,"female",738,62,30,0,0,0,0,0,0
1456890,33,1,1980,8,"male",47,525,506,6119,1439,6119,1323,0,116
1456899,20,9,1993,3,"male",207,14,6,6,0,6,0,0,0
1456919,51,29,1962,8,"female",1497,167,88,72,21,6,15,66,6
1456921,18,9,1995,8,"male",23,2,2,2,1,0,0,2,1
1456953,63,9,1950,4,"male",530,0,0,0,0,0,0,0,0
1456982,32,5,1981,12,"male",121,87,55,23,2,13,1,10,1
1456995,32,18,1981,11,"male",58,3,3,1,0,1,0,0,0
1457020,17,21,1996,4,"female",171,602,336,357,277,357,140,0,137
1457028,22,26,1991,7,"male",343,67,42,0,0,0,0,0,0
1457040,50,27,1963,5,"male",474,79,30,17,10,4,1,13,9
1457042,21,26,1992,9,"female",300,111,62,0,0,0,0,0,0
1457049,29,26,1984,4,"male",71,6,6,0,0,0,0,0,0
1457084,24,5,1989,4,"male",664,1059,920,189,12,138,11,51,1
1457099,108,21,1905,12,"male",18,60,59,24,3,0,1,24,2
1457100,15,28,1998,3,"female",628,517,164,5,1,0,0,5,1
1457125,66,16,1947,10,"male",1204,18,9,1,2,1,2,0,0
1457137,18,28,1995,1,"male",969,26,25,1,4,0,2,1,2
1457152,26,8,1987,6,"female",504,83,63,55,0,55,0,0,0
1457163,68,10,1945,5,"male",1161,921,342,263,536,10,178,253,358
1457171,21,22,1992,4,"female",310,48,40,13,8,13,5,0,3
1457204,28,18,1985,8,"male",432,37,31,0,1,0,1,0,0
1457216,69,29,1944,10,"female",236,3,3,75,0,75,0,0,0
1457230,20,13,1993,9,"female",645,1743,437,111,436,50,177,61,259
1457257,18,9,1995,9,"female",484,361,172,1230,764,1230,505,0,259
1457263,41,3,1972,12,"male",2081,148,23,0,2,0,1,0,1
1457268,47,11,1966,1,"female",271,139,43,32,12,0,0,32,12
1457308,44,15,1969,4,"female",221,3,2,4,0,4,0,0,0
1457311,103,26,1910,4,"male",1337,81,48,53,64,5,33,48,31
1457315,20,1,1993,1,"female",28,31,9,0,1,0,1,0,0
1457320,32,18,1981,10,"female",293,86,69,355,73,322,45,33,28
1457354,14,21,1999,8,"female",327,156,124,1,1,0,0,1,1
1457358,15,28,1998,2,"male",489,195,147,4,5,1,2,3,3
1457395,64,5,1949,2,"female",1734,78,53,59,95,9,52,50,43
1457418,19,10,1994,2,"female",413,291,219,47,68,18,51,29,17
1457420,108,6,1905,2,"female",47,54,45,69,135,0,48,69,87
1457425,42,27,1971,10,"male",662,38,28,97,39,97,34,0,5
1457457,60,11,1953,6,"female",283,65,55,69,172,0,35,69,137
1457489,94,13,1919,3,"male",37,28,26,2,2,0,0,2,2
1457494,20,7,1993,9,"male",568,299,177,0,0,0,0,0,0
1457505,75,3,1938,1,"male",1046,120,71,42,37,0,18,42,19
1457506,19,30,1994,11,"male",164,12,12,2,2,0,2,2,0
1457514,36,11,1977,3,"female",460,96,49,1168,195,1168,174,0,21
1457518,44,22,1969,5,"male",124,49,39,7,5,7,3,0,2
1457530,16,12,1997,5,"male",19,2,2,0,0,0,0,0,0
1457547,16,27,1997,9,"female",342,103,74,36,218,22,172,14,46
1457587,23,1,1990,1,"male",367,125,88,0,0,0,0,0,0
1457610,60,20,1953,8,"female",159,7,5,1,1,0,0,1,1
1457629,24,18,1989,10,"male",569,22,15,15,1,11,1,4,0
1457633,14,13,1999,3,"male",61,4,4,0,0,0,0,0,0
1457640,63,26,1950,8,"male",844,83,38,18,30,7,12,11,18
1457652,31,2,1982,1,"male",250,143,58,232,144,232,99,0,45
1457691,40,5,1973,8,"female",237,184,154,304,205,304,121,0,84
1457695,65,3,1948,1,"female",174,34,27,547,290,510,230,37,60
1457701,42,27,1971,7,"male",265,39,32,98,47,24,25,74,22
1457717,30,11,1983,4,"male",262,179,140,141,4,141,2,0,2
1457724,73,23,1940,8,"female",221,51,9,40,9,40,8,0,1
1457731,74,22,1939,6,"male",1753,89,86,43,64,4,42,39,22
1457777,27,15,1986,9,"female",850,198,84,41,44,41,39,0,5
1457785,20,5,1993,5,"female",423,746,530,752,1087,321,547,431,540
1457818,100,21,1913,10,"female",1835,206,74,139,54,139,35,0,19
1457829,59,6,1954,7,"male",44,10,8,17,8,0,5,17,3
1457841,34,27,1979,6,"male",634,57,34,108,49,108,26,0,23
1457849,26,28,1987,7,"male",19,1,1,0,0,0,0,0,0
1457875,53,20,1960,10,"male",424,104,87,26,7,26,7,0,0
1457893,27,18,1986,11,"female",341,142,66,6,22,6,20,0,2
1457948,19,1,1994,1,"male",306,30,19,11,0,0,0,11,0
1457968,47,30,1966,11,"female",362,304,238,0,0,0,0,0,0
1458002,22,29,1991,7,"female",406,148,87,220,60,219,52,1,8
1458012,68,26,1945,11,"female",1619,487,107,11,16,11,10,0,6
1458021,46,11,1967,4,"male",897,399,156,44,221,44,189,0,32
1458031,64,31,1949,1,"female",371,148,67,6,77,1,44,5,33
1458063,41,29,1972,2,"female",52,39,33,35,31,0,15,35,16
1458096,108,1,1905,1,"male",204,259,169,141,37,14,6,127,31
1458099,51,12,1962,3,"female",353,128,127,10,3,0,1,10,2
1458118,56,28,1957,4,"male",1558,65,23,2,3,2,1,0,2
1458165,40,27,1973,9,"male",118,75,67,0,0,0,0,0,0
1458171,70,26,1943,1,"female",838,37,26,39,3,0,0,39,3
1458179,54,11,1959,9,"male",1509,120,34,2,2,2,2,0,0
1458206,29,3,1984,12,"male",218,50,40,45,41,45,38,0,3
1458233,70,22,1943,3,"female",173,13,13,32,68,23,49,9,19
1458260,24,22,1989,11,"male",263,29,11,0,0,0,0,0,0
1458262,20,9,1993,9,"male",547,195,106,0,0,0,0,0,0
1458272,14,9,1999,6,"female",251,831,617,300,138,300,108,0,30
1458288,57,7,1956,8,"male",784,40,29,8,1,0,1,8,0
1458290,24,11,1989,6,"female",597,159,72,0,0,0,0,0,0
1458309,21,8,1992,9,"female",729,264,172,587,301,326,168,261,133
1458337,19,10,1994,8,"male",396,251,127,55,6,0,0,55,6
1458342,15,17,1998,2,"male",596,393,219,111,60,111,60,0,0
1458345,56,1,1957,1,"male",48,18,16,42,17,0,15,42,2
1458346,23,9,1990,8,"male",464,1059,851,90,184,44,164,46,20
1458354,27,9,1986,11,"male",136,32,28,13,3,13,1,0,2
1458400,36,13,1977,11,"male",475,108,91,31,5,29,3,2,2
1458413,29,19,1984,5,"male",447,335,273,12,1,12,1,0,0
1458420,19,1,1994,4,"female",147,69,54,2,0,0,0,2,0
1458427,44,16,1969,3,"female",303,2,0,0,0,0,0,0,0
1458441,17,7,1996,7,"female",609,1627,437,852,754,0,148,852,606
1458527,16,25,1997,1,"male",265,207,98,28,20,28,19,0,1
1458551,36,13,1977,8,"female",125,50,43,99,106,99,99,0,7
1458562,64,2,1949,9,"male",331,73,5,5,4,5,3,0,1
1458575,49,16,1964,7,"male",622,136,89,287,150,287,109,0,41
1458581,34,5,1979,8,"female",418,102,61,3,0,0,0,3,0
1458611,20,27,1993,10,"female",523,1076,138,675,3267,245,1267,430,2000
1458615,27,15,1986,12,"female",709,158,78,422,318,422,264,0,54
1458617,108,7,1905,3,"female",1576,573,264,188,31,185,4,3,27
1458626,20,11,1993,8,"female",692,89,28,27,18,27,18,0,0
1458635,15,4,1998,7,"female",382,326,190,12,8,12,7,0,1
1458639,108,25,1905,6,"male",1338,70,28,1,3,0,0,1,3
1458720,101,10,1912,8,"male",400,13,8,26,21,1,10,25,11
1458722,19,7,1994,9,"male",428,663,499,427,1208,417,839,10,369
1458727,20,28,1993,11,"male",567,282,235,0,0,0,0,0,0
1458733,18,19,1995,4,"male",168,22,8,12,1,5,0,7,1
1458738,52,12,1961,10,"female",798,31,6,71,27,71,24,0,3
1458744,62,25,1951,5,"female",677,244,170,44,62,0,5,44,57
1458749,17,25,1996,10,"female",555,907,345,244,104,179,46,65,58
1458752,28,7,1985,3,"female",182,24,9,8,3,8,0,0,3
1458753,108,14,1905,12,"male",1185,524,210,102,65,76,29,26,36
1458761,16,30,1997,7,"male",860,726,414,16,28,16,21,0,7
1458767,51,19,1962,5,"male",242,34,27,18,33,18,14,0,19
1458802,18,20,1995,12,"male",28,1,0,0,0,0,0,0,0
1458803,53,25,1960,4,"male",1512,441,253,44,46,13,18,31,28
1458825,21,5,1992,1,"female",68,807,430,365,2153,46,1014,319,1139
1458826,96,27,1917,7,"female",1874,379,184,76,83,5,37,71,46
1458888,31,12,1982,1,"male",343,38,33,0,1,0,0,0,1
1458902,25,26,1988,4,"female",189,47,41,12,9,12,8,0,1
1458907,83,16,1930,10,"male",966,731,598,3,23,3,23,0,0
1458921,31,31,1982,3,"male",341,56,54,8,0,0,0,8,0
1458940,26,1,1987,8,"male",285,2,1,0,0,0,0,0,0
1458954,108,23,1905,11,"male",83,37,32,4,2,4,2,0,0
1458961,19,26,1994,10,"male",478,69,55,22,28,20,5,2,23
1458975,24,20,1989,10,"male",550,96,56,21,69,20,10,1,59
1458985,42,23,1971,9,"female",551,88,26,102,134,102,51,0,83
1459008,16,15,1997,1,"male",360,346,234,0,29,0,25,0,4
1459010,37,9,1976,10,"male",392,3,2,0,0,0,0,0,0
1459013,101,14,1912,4,"female",363,1750,618,31,23,31,20,0,3
1459019,19,14,1994,12,"male",372,291,94,17,7,9,0,8,7
1459020,19,23,1994,6,"male",185,67,50,0,1,0,0,0,1
1459055,63,13,1950,10,"male",1161,20,11,0,0,0,0,0,0
1459075,15,2,1998,10,"male",38,71,52,18,2,18,2,0,0
1459084,19,12,1994,1,"female",33,3,3,1,0,1,0,0,0
1459113,31,25,1982,3,"male",417,175,79,29,78,29,49,0,29
1459138,20,23,1993,10,"female",8,1,1,0,0,0,0,0,0
1459167,17,8,1996,6,"male",851,341,134,1,3,0,1,1,2
1459200,32,24,1981,10,"male",480,383,168,141,193,130,133,11,60
1459208,25,1,1988,1,"male",88,110,82,48,38,48,35,0,3
1459224,15,20,1998,3,"female",615,488,207,107,12,107,10,0,2
1459232,20,16,1993,12,"male",745,973,554,1254,742,460,171,794,571
1459252,58,1,1955,8,"male",931,52,32,3,76,2,30,1,46
1459269,59,17,1954,5,"male",1689,273,86,109,114,98,71,11,43
1459281,15,28,1998,6,"female",276,374,238,36,7,36,6,0,1
1459313,27,18,1986,4,"female",273,61,26,0,2,0,2,0,0
1459334,20,9,1993,12,"female",715,418,260,228,127,210,116,18,11
1459342,31,12,1982,1,"female",81,41,26,178,85,178,78,0,7
1459359,57,16,1956,3,"male",59,6,3,0,0,0,0,0,0
1459373,19,14,1994,2,"male",158,83,48,9,8,9,3,0,5
1459386,22,21,1991,12,"male",202,230,154,29,29,29,12,0,17
1459402,55,30,1958,7,"male",1359,106,54,8,10,8,10,0,0
1459431,50,7,1963,9,"female",866,130,62,822,1285,822,1133,0,152
1459444,18,1,1995,6,"male",15,65,58,379,371,264,206,115,165
1459451,19,19,1994,3,"male",309,422,407,0,11,0,11,0,0
1459455,42,11,1971,1,"female",875,14,8,0,0,0,0,0,0
1459458,31,27,1982,2,"male",1354,0,0,0,0,0,0,0,0
1459482,68,12,1945,10,"male",570,121,97,0,9,0,6,0,3
1459489,22,25,1991,5,"male",121,268,243,108,40,108,32,0,8
1459496,32,22,1981,9,"male",1156,56,47,0,0,0,0,0,0
1459510,38,14,1975,5,"male",275,29,13,1,0,1,0,0,0
1459555,68,19,1945,3,"female",334,18,16,77,23,2,10,75,13
1459559,18,19,1995,10,"female",524,438,27,279,702,67,387,212,315
1459567,30,13,1983,1,"female",964,98,36,103,100,47,40,56,60
1459616,72,28,1941,10,"female",131,39,29,3,23,3,10,0,13
1459672,14,24,1999,4,"female",526,369,242,2,4,0,0,2,4
1459715,55,15,1958,6,"female",1560,58,46,34,38,25,21,9,17
1459719,43,7,1970,10,"female",609,55,28,10,10,10,8,0,2
1459728,48,11,1965,3,"male",776,85,39,0,0,0,0,0,0
1459761,25,11,1988,5,"male",196,543,320,10498,2910,7701,1601,2797,1309
1459764,94,9,1919,9,"male",234,461,303,317,456,16,178,301,278
1459772,50,8,1963,4,"female",1879,10,4,0,0,0,0,0,0
1459785,51,11,1962,5,"male",308,15,8,0,10,0,1,0,9
1459788,59,16,1954,2,"male",426,52,16,4,3,0,1,4,2
1459860,16,9,1997,10,"female",278,102,56,34,90,8,21,26,69
1459866,18,26,1995,7,"female",387,57,30,83,11,83,6,0,5
1459870,34,21,1979,6,"female",496,7,2,0,0,0,0,0,0
1459872,24,10,1989,12,"female",136,90,9,273,30,273,30,0,0
1459877,50,8,1963,10,"male",705,192,129,6,3,1,2,5,1
1459899,103,1,1910,1,"female",666,102,59,0,0,0,0,0,0
1459912,21,11,1992,4,"male",284,209,140,596,734,596,435,0,299
1459925,18,6,1995,6,"male",565,2917,2279,7,13,7,10,0,3
1459971,46,5,1967,2,"male",368,79,40,0,0,0,0,0,0
1460003,19,25,1994,12,"female",610,1933,982,683,1271,563,763,120,508
1460016,18,13,1995,11,"male",206,420,357,6,6,6,4,0,2
1460029,60,6,1953,7,"female",269,12,10,19,0,19,0,0,0
1460095,27,19,1986,2,"male",608,515,365,290,184,18,39,272,145
1460098,61,2,1952,10,"male",110,16,10,14,9,0,1,14,8
1460110,20,15,1993,8,"male",299,146,101,3,0,3,0,0,0
1460120,24,18,1989,4,"female",29,75,46,8,6,8,3,0,3
1460126,60,21,1953,4,"male",1185,182,34,2,3,2,1,0,2
1460139,38,20,1975,10,"male",39,1,1,8,0,8,0,0,0
1460171,24,6,1989,10,"female",587,88,54,357,472,92,241,265,231
1460178,56,10,1957,3,"male",142,28,18,6,30,0,15,6,15
1460197,41,19,1972,1,"male",1060,172,48,3,13,3,5,0,8
1460200,18,21,1995,1,"female",374,101,59,1208,310,824,203,384,107
1460201,37,16,1976,5,"female",304,2,0,0,0,0,0,0,0
1460203,49,16,1964,11,"female",800,25,18,4,1,4,0,0,1
1460211,14,18,1999,9,"male",210,121,60,0,2,0,1,0,1
1460213,26,16,1987,11,"male",1366,83,36,0,11,0,6,0,5
1460220,65,2,1948,1,"female",309,35,30,496,15,493,12,3,3
1460266,31,21,1982,6,"male",215,17,10,2,30,2,23,0,7
1460268,21,1,1992,1,"female",305,121,20,8,10,8,5,0,5
1460270,19,15,1994,2,"female",146,197,128,0,1,0,0,0,1
1460351,20,19,1993,11,"female",549,130,54,54,163,54,99,0,64
1460364,51,3,1962,7,"female",511,49,28,216,14,0,3,216,11
1460365,18,27,1995,10,"female",143,341,130,2272,3827,2272,3376,0,451
1460380,36,12,1977,6,"male",40,1,0,0,0,0,0,0,0
1460384,22,16,1991,9,"male",595,183,51,16,17,0,7,16,10
1460413,44,29,1969,5,"female",592,100,81,118,202,71,120,47,82
1460429,41,1,1972,1,"male",128,176,72,0,0,0,0,0,0
1460442,30,15,1983,12,"female",279,124,77,0,3,0,2,0,1
1460452,36,19,1977,3,"female",544,51,43,3502,178,2968,139,534,39
1460462,22,7,1991,9,"female",236,47,16,1444,1589,1081,746,363,843
1460505,37,8,1976,9,"male",1542,231,96,144,133,144,98,0,35
1460514,16,28,1997,7,"male",165,300,282,0,1,0,1,0,0
1460517,16,5,1997,10,"male",12,46,43,0,0,0,0,0,0
1460519,19,2,1994,12,"male",256,142,108,0,3,0,0,0,3
1460530,27,7,1986,8,"female",111,1,1,6,3,0,1,6,2
1460545,44,2,1969,9,"male",1604,130,108,3,2,3,2,0,0
1460577,51,25,1962,4,"male",420,14,9,1,0,0,0,1,0
1460598,26,2,1987,3,"male",480,14,8,0,0,0,0,0,0
1460600,37,10,1976,4,"female",237,851,488,337,921,53,321,284,600
1460620,32,2,1981,4,"male",1404,79,38,84,47,78,30,6,17
1460631,37,24,1976,11,"male",405,8,2,0,0,0,0,0,0
1460653,67,5,1946,11,"female",1864,104,68,1031,170,1021,91,10,79
1460658,45,12,1968,2,"female",236,135,93,80,128,79,61,1,67
1460687,98,16,1915,11,"male",1116,936,448,69,44,69,38,0,6
1460700,48,8,1965,6,"female",1193,391,311,750,819,750,359,0,460
1460737,30,24,1983,11,"female",4,16,12,1,7,1,3,0,4
1460778,35,28,1978,6,"female",137,16,16,88,77,88,50,0,27
1460779,28,28,1985,6,"female",421,980,411,3204,914,3204,645,0,269
1460780,24,13,1989,7,"male",511,326,277,651,225,651,204,0,21
1460800,25,13,1988,8,"male",751,191,149,2,0,2,0,0,0
1460846,16,2,1997,9,"male",736,486,279,1,5,1,3,0,2
1460847,22,21,1991,3,"male",898,258,123,38,46,38,43,0,3
1460853,20,8,1993,8,"male",420,231,180,0,2,0,1,0,1
1460854,30,22,1983,3,"male",536,318,220,13,24,13,20,0,4
1460885,51,16,1962,4,"female",2046,46,29,34,9,33,5,1,4
1460894,39,19,1974,1,"male",419,11,10,1,0,0,0,1,0
1460908,23,1,1990,1,"male",210,65,55,0,0,0,0,0,0
1460912,30,24,1983,11,"male",460,9,4,1,0,0,0,1,0
1460926,34,20,1979,1,"female",845,112,72,295,350,278,237,17,113
1460985,53,11,1960,8,"female",1174,57,47,45,42,45,24,0,18
1460993,71,10,1942,4,"female",1796,463,345,337,349,3,155,334,194
1460997,66,30,1947,9,"female",1481,64,22,6,34,3,26,3,8
1460998,16,26,1997,8,"female",331,122,40,17,1,0,1,17,0
1461049,18,12,1995,11,"male",94,21,19,0,0,0,0,0,0
1461051,52,2,1961,5,"female",429,5,3,0,0,0,0,0,0
1461096,36,7,1977,5,"male",401,255,151,113,317,110,229,3,88
1461104,20,28,1993,4,"female",436,69,37,16,0,16,0,0,0
1461131,19,20,1994,1,"female",426,91,54,6,16,6,16,0,0
1461133,24,13,1989,2,"male",232,0,0,0,0,0,0,0,0
1461217,26,1,1987,1,"male",364,7,7,0,0,0,0,0,0
1461244,63,27,1950,1,"male",1817,36,22,393,188,0,30,393,158
1461259,52,2,1961,5,"female",276,97,58,639,239,639,172,0,67
1461278,17,25,1996,11,"female",559,221,94,20,0,20,0,0,0
1461306,103,15,1910,6,"male",1510,465,202,34,24,30,15,4,9
1461341,25,1,1988,1,"male",212,8,5,0,2,0,1,0,1
1461357,64,12,1949,1,"female",2252,98,34,552,291,552,222,0,69
1461363,50,9,1963,6,"female",1564,295,149,391,278,391,188,0,90
1461367,55,18,1958,11,"female",588,35,25,1,0,0,0,1,0
1461377,32,3,1981,11,"female",211,70,55,5,4,5,4,0,0
1461400,45,17,1968,9,"female",104,38,25,15,0,15,0,0,0
1461422,28,14,1985,2,"female",70,106,57,178,319,178,276,0,43
1461435,26,4,1987,9,"female",350,6,5,0,0,0,0,0,0
1461441,43,1,1970,1,"male",159,12,12,11,4,11,4,0,0
1461505,45,9,1968,8,"female",654,51,19,18,46,17,10,1,36
1461514,33,20,1980,2,"female",374,125,82,469,96,449,73,20,23
1461520,23,10,1990,12,"female",357,54,43,0,0,0,0,0,0
1461526,25,20,1988,11,"male",377,78,59,0,19,0,11,0,8
1461533,18,10,1995,10,"male",310,802,361,746,2618,746,2241,0,377
1461543,16,14,1997,1,"male",580,169,88,54,21,12,4,42,17
1461565,16,1,1997,2,"female",592,4737,701,2,61,2,42,0,19
1461572,25,16,1988,1,"male",240,17,14,35,130,35,95,0,35
1461590,26,7,1987,12,"female",190,57,39,68,179,64,164,4,15
1461627,50,12,1963,10,"female",269,211,28,194,39,188,26,6,13
1461641,53,12,1960,2,"male",197,13,8,10,1,9,1,1,0
1461682,69,28,1944,9,"male",743,224,140,76,16,0,5,76,11
1461721,36,7,1977,7,"female",170,100,84,107,38,78,32,29,6
1461725,58,8,1955,8,"female",1555,260,146,105,238,104,147,1,91
1461749,20,7,1993,4,"male",511,280,37,236,378,236,321,0,57
1461756,70,18,1943,7,"female",1455,89,47,648,277,648,131,0,146
1461767,44,17,1969,3,"female",1688,96,53,284,217,205,151,79,66
1461768,14,10,1999,4,"male",337,978,263,3839,4583,420,1790,3419,2793
1461773,19,27,1994,9,"female",28,347,321,1211,816,667,404,544,412
1461806,23,14,1990,9,"male",350,225,83,0,5,0,3,0,2
1461843,19,20,1994,5,"female",440,265,174,600,572,303,431,297,141
1461858,33,27,1980,11,"female",135,253,125,8213,7213,8175,5643,38,1570
1461909,54,4,1959,12,"male",26,0,0,3,0,3,0,0,0
1461912,23,11,1990,9,"male",306,62,28,10,0,2,0,8,0
1461926,19,3,1994,7,"male",13,19,14,1,8,1,4,0,4
1461940,44,5,1969,7,"female",830,374,82,221,138,79,68,142,70
1461947,17,22,1996,12,"male",280,441,198,427,108,398,74,29,34
1461960,44,2,1969,1,"male",351,45,30,0,1,0,0,0,1
1461964,23,12,1990,3,"female",629,15,4,0,1,0,1,0,0
1461970,29,22,1984,6,"male",249,5,5,0,0,0,0,0,0
1461974,19,15,1994,2,"female",106,87,26,1101,714,1101,442,0,272
1461998,21,7,1992,6,"male",328,71,42,1,17,1,14,0,3
1462024,18,24,1995,5,"female",418,143,95,65,50,65,26,0,24
1462026,18,19,1995,7,"female",489,186,132,1,5,0,3,1,2
1462031,58,26,1955,11,"female",207,135,101,350,101,327,92,23,9
1462033,44,1,1969,10,"male",759,45,8,0,3,0,3,0,0
1462054,20,6,1993,10,"male",316,135,92,7,17,7,15,0,2
1462057,43,5,1970,6,"female",438,33,32,10,1,10,1,0,0
1462058,53,20,1960,3,"female",895,651,96,226,2391,225,1798,1,593
1462074,29,10,1984,10,"male",190,19,5,42,3,0,0,42,3
1462079,59,17,1954,8,"male",733,38,5,0,0,0,0,0,0
1462108,15,4,1998,12,"male",107,16,10,4,2,4,1,0,1
1462124,19,1,1994,7,"male",101,63,57,0,0,0,0,0,0
1462127,18,12,1995,1,"male",74,32,21,1,1,1,1,0,0
1462166,48,30,1965,5,"male",423,159,141,0,3,0,1,0,2
1462167,49,15,1964,12,"female",251,37,31,1,0,0,0,1,0
1462215,18,26,1995,5,"female",253,891,247,54,13,54,11,0,2
1462221,18,6,1995,10,"male",251,57,43,3,25,3,22,0,3
1462261,31,3,1982,4,"male",683,76,72,4,0,4,0,0,0
1462320,25,1,1988,1,"male",75,11,10,32,6,32,5,0,1
1462347,23,31,1990,7,"male",125,141,113,5,51,5,36,0,15
1462355,17,24,1996,12,"male",512,129,100,14,0,14,0,0,0
1462392,16,9,1997,8,"female",497,1087,850,872,564,372,343,500,221
1462413,27,20,1986,9,"female",245,97,37,0,0,0,0,0,0
1462416,53,28,1960,10,"female",1415,71,29,16,13,16,12,0,1
1462425,58,30,1955,6,"male",1087,30,19,2,0,0,0,2,0
1462426,23,2,1990,2,"male",120,63,41,16,2,16,2,0,0
1462427,17,28,1996,3,"male",728,425,235,7,5,0,3,7,2
1462438,75,24,1938,7,"male",1298,30,15,38,22,1,7,37,15
1462439,32,2,1981,3,"male",389,172,140,8,0,8,0,0,0
1462463,18,3,1995,6,"female",317,622,234,1182,1427,810,487,372,940
1462477,13,2,2000,3,"female",133,296,153,11,5,11,3,0,2
1462503,22,25,1991,9,"female",1371,335,175,232,758,83,284,149,474
1462533,34,25,1979,12,"female",1000,69,53,71,90,71,70,0,20
1462541,53,25,1960,10,"male",1533,383,343,240,143,240,136,0,7
1462546,39,16,1974,9,"male",1200,373,143,13,67,13,41,0,26
1462548,14,27,1999,7,"female",172,681,404,870,754,478,464,392,290
1462581,36,5,1977,11,"male",425,103,4,52,5,44,5,8,0
1462583,18,26,1995,10,"male",369,253,158,219,80,205,51,14,29
1462602,38,11,1975,11,"male",541,102,73,14,33,14,30,0,3
1462644,22,17,1991,10,"female",16,28,15,30,19,30,18,0,1
1462650,25,6,1988,5,"male",293,67,59,0,2,0,0,0,2
1462655,108,25,1905,2,"female",90,45,37,11,4,11,3,0,1
1462661,37,10,1976,3,"male",386,115,82,636,262,636,172,0,90
1462664,39,21,1974,7,"female",679,366,254,6,1,6,1,0,0
1462671,21,26,1992,6,"male",330,156,111,38,2,38,1,0,1
1462692,29,9,1984,6,"male",317,16,16,1,1,1,1,0,0
1462704,19,21,1994,8,"male",769,0,0,0,0,0,0,0,0
1462748,24,23,1989,12,"female",713,138,47,16,1,16,0,0,1
1462760,20,27,1993,8,"male",458,819,665,0,8,0,7,0,1
1462816,26,18,1987,11,"female",85,102,91,155,287,155,235,0,52
1462827,17,20,1996,8,"male",122,61,47,0,0,0,0,0,0
1462831,28,21,1985,2,"female",394,0,0,0,0,0,0,0,0
1462846,83,25,1930,9,"male",1158,1850,1018,4215,2690,1238,1317,2977,1373
1462877,58,21,1955,2,"male",725,597,342,34,6,34,4,0,2
1462879,45,18,1968,1,"female",1044,65,35,4,10,4,4,0,6
1462884,25,10,1988,4,"female",57,121,116,65,112,41,53,24,59
1462904,33,3,1980,8,"male",583,70,56,2,1,2,1,0,0
1462909,16,21,1997,5,"female",122,543,431,82,35,27,14,55,21
1462929,18,25,1995,12,"female",169,718,546,45,180,45,159,0,21
1462932,22,19,1991,8,"male",492,90,69,298,88,264,62,34,26
1462948,63,1,1950,1,"male",476,6,4,0,0,0,0,0,0
1462960,18,19,1995,2,"female",327,807,631,120,541,120,526,0,15
1462964,21,23,1992,12,"female",93,251,31,8,16,8,6,0,10
1462968,24,9,1989,3,"female",484,851,611,44,63,44,45,0,18
1462969,85,25,1928,8,"male",1750,288,94,609,99,593,62,16,37
1462976,23,13,1990,3,"male",650,202,114,1,70,0,14,1,56
1463029,51,15,1962,11,"female",321,73,57,24,0,0,0,24,0
1463036,47,6,1966,4,"female",451,30,16,34,113,10,54,24,59
1463038,31,1,1982,1,"male",324,71,22,27,2,0,0,27,2
1463044,52,12,1961,3,"male",62,88,86,209,144,152,82,57,62
1463057,17,28,1996,2,"female",415,329,141,0,43,0,19,0,24
1463060,31,5,1982,5,"male",15,6,5,20,5,20,5,0,0
1463079,27,25,1986,3,"male",396,37,10,140,2,140,1,0,1
1463083,61,22,1952,3,"female",1776,715,392,673,1056,626,686,47,370
1463090,36,19,1977,2,"female",557,267,118,730,316,730,208,0,108
1463102,35,18,1978,9,"male",1612,235,167,27,10,27,4,0,6
1463103,56,1,1957,1,"male",101,20,18,826,104,0,52,826,52
1463116,18,28,1995,2,"male",451,66,57,0,1,0,1,0,0
1463132,17,2,1996,4,"female",53,2312,1121,1005,497,207,301,798,196
1463136,56,29,1957,10,"male",1557,59,14,0,1,0,0,0,1
1463174,50,19,1963,2,"male",209,33,23,17,2,15,1,2,1
1463219,45,11,1968,12,"male",1187,85,36,3,0,3,0,0,0
1463229,43,20,1970,1,"female",573,15,11,13,9,1,1,12,8
1463231,15,26,1998,8,"male",273,64,28,1,0,1,0,0,0
1463232,17,28,1996,8,"male",125,200,195,120,10,120,10,0,0
1463233,28,12,1985,1,"male",532,4,2,1,0,1,0,0,0
1463237,18,16,1995,12,"female",26,84,14,0,8,0,8,0,0
1463253,65,8,1948,9,"male",385,55,36,10,11,0,4,10,7
1463299,108,23,1905,9,"male",905,561,175,23,14,23,14,0,0
1463313,62,10,1951,3,"male",1345,15,6,0,0,0,0,0,0
1463334,108,22,1905,8,"female",971,151,101,4,4,4,4,0,0
1463381,25,10,1988,3,"male",24,1,1,0,0,0,0,0,0
1463392,94,11,1919,1,"male",726,474,212,0,7,0,7,0,0
1463401,26,30,1987,3,"male",39,85,68,3,68,3,63,0,5
1463403,24,22,1989,1,"male",50,31,28,0,0,0,0,0,0
1463432,65,26,1948,10,"female",1836,52,15,1,3,1,3,0,0
1463433,59,3,1954,11,"female",1613,183,108,1081,233,1081,171,0,62
1463437,30,13,1983,9,"male",520,33,14,0,0,0,0,0,0
1463442,25,1,1988,1,"male",611,74,51,67,18,67,10,0,8
1463453,52,28,1961,6,"female",599,36,18,6,2,0,2,6,0
1463457,67,29,1946,8,"female",24,21,12,54,13,0,6,54,7
1463477,18,25,1995,11,"female",66,53,21,6,9,6,7,0,2
1463481,68,15,1945,3,"male",18,6,4,0,7,0,3,0,4
1463506,20,6,1993,3,"female",547,525,297,63,47,63,42,0,5
1463523,28,16,1985,5,"male",562,26,9,0,15,0,13,0,2
1463527,30,23,1983,9,"female",82,138,47,22,12,22,10,0,2
1463530,39,21,1974,7,"male",205,475,382,6,0,0,0,6,0
1463533,32,4,1981,7,"female",428,23,11,0,0,0,0,0,0
1463534,67,27,1946,11,"female",500,63,50,53,87,53,76,0,11
1463573,21,27,1992,8,"female",116,221,150,450,273,425,263,25,10
1463585,49,9,1964,2,"male",555,3,2,0,0,0,0,0,0
1463614,33,16,1980,12,"female",1225,230,88,28,33,28,29,0,4
1463637,57,17,1956,10,"male",854,278,246,132,13,132,7,0,6
1463663,59,27,1954,10,"female",199,21,19,253,48,253,1,0,47
1463665,29,8,1984,4,"male",436,8,8,59,0,59,0,0,0
1463689,21,13,1992,3,"male",645,115,76,95,69,94,38,1,31
1463719,32,25,1981,6,"male",299,60,44,3,18,3,15,0,3
1463757,31,10,1982,10,"female",2217,65,39,226,208,98,104,128,104
1463763,26,10,1987,10,"female",507,132,98,3,6,3,3,0,3
1463767,17,26,1996,8,"male",541,101,70,14,37,14,33,0,4
1463790,59,14,1954,3,"male",676,117,66,32,16,31,11,1,5
1463791,16,7,1997,3,"male",344,579,469,13,92,12,58,1,34
1463813,24,8,1989,3,"male",581,370,330,0,0,0,0,0,0
1463840,44,2,1969,2,"female",877,102,49,218,97,212,59,6,38
1463854,21,1,1992,1,"male",294,24,19,1,0,0,0,1,0
1463878,21,11,1992,3,"male",631,6,3,0,0,0,0,0,0
1463884,72,27,1941,5,"female",1731,145,66,185,440,185,237,0,203
1463907,55,1,1958,2,"male",746,6,2,3,6,0,1,3,5
1463915,33,29,1980,1,"male",627,249,174,1,13,1,12,0,1
1463916,18,9,1995,2,"male",244,254,201,8,35,8,33,0,2
1463917,23,26,1990,4,"female",97,9,8,0,0,0,0,0,0
1463918,23,27,1990,12,"male",713,1367,1210,10,257,10,207,0,50
1463923,108,1,1905,9,"male",399,62,20,0,9,0,7,0,2
1463951,15,27,1998,10,"female",1189,3438,2559,951,1543,398,626,553,917
1463957,31,25,1982,11,"male",513,41,12,0,14,0,11,0,3
1463958,24,16,1989,11,"male",268,118,92,100,0,93,0,7,0
1463961,21,17,1992,2,"male",123,2,1,0,0,0,0,0,0
1464062,18,1,1995,11,"male",596,185,120,21,11,21,2,0,9
1464123,31,3,1982,5,"female",620,64,22,68,15,68,12,0,3
1464161,30,20,1983,7,"male",947,194,108,3,1,3,1,0,0
1464168,22,27,1991,12,"male",1347,94,61,4,5,4,5,0,0
1464185,15,7,1998,7,"male",353,340,310,0,0,0,0,0,0
1464193,23,14,1990,10,"male",1120,143,80,0,0,0,0,0,0
1464212,14,10,1999,5,"male",142,123,109,3,3,2,2,1,1
1464256,16,22,1997,9,"male",802,412,318,381,335,6,148,375,187
1464271,22,7,1991,11,"female",884,91,49,29,22,1,4,28,18
1464281,26,1,1987,1,"male",348,49,45,4,28,4,16,0,12
1464293,26,15,1987,8,"female",730,557,435,174,220,174,120,0,100
1464300,18,20,1995,3,"female",417,476,359,237,266,237,242,0,24
1464330,21,19,1992,12,"female",917,80,61,0,0,0,0,0,0
1464332,103,15,1910,1,"male",1044,119,35,3,59,1,21,2,38
1464385,17,9,1996,12,"male",689,175,86,0,8,0,8,0,0
1464410,17,8,1996,4,"female",26,403,79,71,32,62,15,9,17
1464417,29,17,1984,3,"female",377,58,24,11,0,11,0,0,0
1464419,103,31,1910,8,"male",855,36,15,19,3,14,3,5,0
1464420,52,10,1961,11,"male",1074,146,65,84,334,74,111,10,223
1464456,14,27,1999,5,"male",121,46,33,0,2,0,2,0,0
1464474,25,28,1988,8,"female",419,41,20,0,3,0,0,0,3
1464482,57,14,1956,1,"female",535,66,29,80,28,1,7,79,21
1464485,33,14,1980,10,"male",1758,1054,703,381,231,381,160,0,71
1464504,27,1,1986,11,"male",113,90,67,7,319,7,145,0,174
1464516,17,19,1996,5,"male",248,10,2,0,0,0,0,0,0
1464526,58,5,1955,11,"male",12,16,10,1,0,1,0,0,0
1464555,13,4,2000,4,"male",22,3,0,44,19,44,17,0,2
1464566,40,4,1973,8,"male",297,17,10,43,6,43,5,0,1
1464595,20,10,1993,10,"male",686,133,124,27,5,27,5,0,0
1464599,65,2,1948,10,"female",1608,89,57,18,15,0,1,18,14
1464654,26,11,1987,3,"female",224,94,29,552,147,545,90,7,57
1464673,30,1,1983,9,"male",1007,7,6,272,53,270,48,2,5
1464679,19,13,1994,4,"female",288,352,175,1,7,1,4,0,3
1464691,16,9,1997,7,"male",73,81,79,1,0,1,0,0,0
1464725,17,1,1996,4,"female",317,399,248,80,122,79,76,1,46
1464733,33,30,1980,4,"female",571,35,26,68,8,68,8,0,0
1464735,20,7,1993,7,"female",425,464,403,998,293,988,266,10,27
1464742,46,5,1967,12,"male",290,28,24,11,20,9,18,2,2
1464749,22,5,1991,8,"female",637,47,37,0,0,0,0,0,0
1464751,39,7,1974,10,"female",1562,66,26,1,11,0,7,1,4
1464778,24,16,1989,4,"male",383,55,33,18,21,18,7,0,14
1464830,19,10,1994,1,"male",123,0,0,1,1,0,0,1,1
1464831,26,20,1987,5,"male",58,0,0,0,0,0,0,0,0
1464858,68,12,1945,9,"male",477,377,310,22,2,0,1,22,1
1464861,26,24,1987,6,"female",563,87,41,0,5,0,5,0,0
1464870,41,10,1972,5,"male",258,145,70,46,61,46,31,0,30
1464884,57,28,1956,3,"male",493,0,0,0,0,0,0,0,0
1464912,19,30,1994,6,"male",490,75,67,0,0,0,0,0,0
1464947,64,5,1949,10,"female",28,59,47,182,72,182,63,0,9
1464956,22,7,1991,10,"male",561,142,81,232,73,179,28,53,45
1464975,23,15,1990,4,"male",194,155,79,18,40,7,20,11,20
1464978,31,1,1982,3,"female",127,69,38,215,74,215,45,0,29
1465007,53,4,1960,4,"male",10,19,18,17,9,17,5,0,4
1465026,20,10,1993,10,"male",330,801,485,4270,2195,4249,1717,21,478
1465059,62,20,1951,3,"male",208,11,7,0,0,0,0,0,0
1465102,52,23,1961,4,"male",931,89,50,335,41,0,13,335,28
1465110,15,8,1998,2,"female",227,4,4,1,0,1,0,0,0
1465136,19,20,1994,3,"male",509,115,68,28,3,28,3,0,0
1465139,100,27,1913,6,"female",1763,299,172,411,66,402,46,9,20
1465140,85,23,1928,8,"male",183,137,112,9,16,9,15,0,1
1465182,19,2,1994,5,"male",150,175,146,76,35,76,34,0,1
1465198,23,1,1990,1,"male",89,0,0,0,0,0,0,0,0
1465199,32,13,1981,5,"male",420,2,2,1,0,1,0,0,0
1465224,21,8,1992,10,"female",150,650,492,67,111,67,87,0,24
1465250,24,13,1989,12,"female",75,23,17,8,3,8,2,0,1
1465260,33,18,1980,10,"male",851,223,108,4,80,4,77,0,3
1465267,75,13,1938,3,"female",1200,23,7,40,3,40,2,0,1
1465280,36,16,1977,3,"male",625,108,54,0,2,0,2,0,0
1465289,18,11,1995,9,"male",248,386,350,0,25,0,23,0,2
1465304,32,17,1981,12,"male",685,225,146,0,11,0,4,0,7
1465311,18,14,1995,7,"female",250,415,178,26,5,1,0,25,5
1465338,24,25,1989,11,"male",922,16,15,673,272,609,212,64,60
1465371,37,6,1976,2,"male",463,34,17,2,1,2,1,0,0
1465413,38,31,1975,3,"female",116,25,22,8,8,1,1,7,7
1465417,19,27,1994,1,"female",380,6,3,1318,33,1313,16,5,17
1465433,23,15,1990,4,"male",418,198,120,5,1,0,0,5,1
1465438,19,23,1994,11,"female",346,172,36,1,3,1,3,0,0
1465481,22,11,1991,11,"female",361,439,156,21,10,21,9,0,1
1465506,56,20,1957,8,"male",593,83,49,240,73,228,41,12,32
1465514,37,1,1976,4,"female",329,9,8,0,1,0,0,0,1
1465517,15,3,1998,1,"male",129,178,125,355,0,355,0,0,0
1465545,21,30,1992,7,"male",146,42,37,3,0,3,0,0,0
1465564,27,17,1986,5,"male",112,211,199,45,1,45,0,0,1
1465565,26,3,1987,1,"male",718,265,178,28,1,28,1,0,0
1465568,17,22,1996,10,"male",331,186,157,288,287,256,138,32,149
1465572,39,4,1974,11,"female",381,348,148,366,133,366,112,0,21
1465578,22,2,1991,7,"male",206,160,146,5,0,5,0,0,0
1465583,93,21,1920,9,"female",124,142,127,1,36,1,7,0,29
1465605,50,21,1963,7,"male",185,32,27,199,26,199,8,0,18
1465606,34,25,1979,1,"female",310,12,8,237,5,237,3,0,2
1465633,25,1,1988,1,"male",131,72,52,0,1,0,1,0,0
1465648,27,29,1986,8,"male",633,19,19,0,0,0,0,0,0
1465653,19,13,1994,10,"female",331,273,127,12,139,12,93,0,46
1465703,25,30,1988,6,"male",105,10,9,0,0,0,0,0,0
1465717,83,1,1930,1,"male",900,342,196,995,227,675,142,320,85
1465731,24,26,1989,5,"female",417,2,2,0,0,0,0,0,0
1465743,29,1,1984,1,"male",9,8,6,43,5,43,3,0,2
1465760,17,22,1996,4,"male",94,243,232,2,0,2,0,0,0
1465778,49,10,1964,4,"female",515,13,10,0,0,0,0,0,0
1465784,35,19,1978,9,"male",28,66,64,85,9,85,4,0,5
1465796,14,20,1999,10,"female",244,274,188,238,73,238,53,0,20
1465800,56,3,1957,3,"male",496,5,5,10,0,0,0,10,0
1465833,19,2,1994,5,"male",29,360,285,330,56,327,52,3,4
1465846,24,22,1989,1,"male",230,89,74,7,7,7,7,0,0
1465850,17,13,1996,10,"female",736,2415,1795,3,0,0,0,3,0
1465860,25,28,1988,1,"male",59,69,62,7,9,7,5,0,4
1465869,55,1,1958,1,"male",407,50,35,8,3,8,3,0,0
1465898,21,4,1992,4,"female",525,60,24,4,1,4,1,0,0
1465945,28,1,1985,3,"male",54,408,392,1,1,0,1,1,0
1465948,22,7,1991,4,"female",500,58,28,32,31,32,23,0,8
1465962,42,18,1971,12,"female",364,1,0,3,5,0,3,3,2
1465964,20,12,1993,9,"male",220,448,412,23,14,22,9,1,5
1465984,74,7,1939,5,"male",1074,102,60,2,44,0,4,2,40
1466024,50,4,1963,4,"male",141,121,68,384,138,0,38,384,100
1466050,62,1,1951,1,"male",178,8,7,0,0,0,0,0,0
1466055,18,9,1995,12,"female",298,59,35,5,8,2,8,3,0
1466067,44,17,1969,12,"male",485,34,25,3,1,0,0,3,1
1466070,17,26,1996,6,"female",577,4584,2196,108,682,1,390,107,292
1466073,19,19,1994,3,"female",411,2,2,2,3,2,3,0,0
1466105,35,6,1978,9,"female",216,79,51,2,0,2,0,0,0
1466109,33,4,1980,6,"female",51,201,57,41,30,41,29,0,1
1466130,29,29,1984,1,"male",276,53,39,3,0,3,0,0,0
1466143,69,29,1944,1,"female",1745,71,28,38,19,17,13,21,6
1466155,18,15,1995,7,"male",100,0,0,0,0,0,0,0,0
1466236,38,15,1975,2,"male",571,109,100,1,4,1,4,0,0
1466237,36,19,1977,2,"female",642,38,24,12,18,12,14,0,4
1466238,26,20,1987,1,"male",46,24,8,3,32,3,11,0,21
1466241,34,23,1979,9,"male",85,1,1,6,1,0,0,6,1
1466257,83,16,1930,4,"female",302,65,43,0,0,0,0,0,0
1466258,18,9,1995,7,"male",129,50,42,0,0,0,0,0,0
1466273,15,1,1998,1,"male",44,40,36,1,0,1,0,0,0
1466274,66,13,1947,1,"female",1755,237,116,718,53,604,22,114,31
1466280,54,20,1959,9,"female",799,51,40,277,34,277,14,0,20
1466285,63,17,1950,8,"female",490,122,102,20,82,0,21,20,61
1466312,16,24,1997,3,"male",458,112,51,109,64,109,37,0,27
1466316,27,2,1986,8,"female",1199,714,475,264,1009,264,903,0,106
1466335,32,15,1981,10,"male",764,213,98,12,15,12,14,0,1
1466349,49,6,1964,2,"female",546,19,16,7,0,1,0,6,0
1466385,52,24,1961,4,"female",649,35,23,1,0,1,0,0,0
1466421,56,25,1957,12,"male",13,2,2,0,0,0,0,0,0
1466469,16,24,1997,1,"male",346,282,118,556,264,556,192,0,72
1466482,49,8,1964,7,"female",1255,62,53,70,105,70,58,0,47
1466484,27,19,1986,3,"female",52,214,189,448,99,448,41,0,58
1466493,33,1,1980,3,"male",747,7,1,1,0,1,0,0,0
1466515,19,12,1994,6,"male",207,317,260,1,1,1,0,0,1
1466543,30,27,1983,7,"male",117,50,21,1,0,0,0,1,0
1466604,18,23,1995,5,"female",471,57,39,5,5,5,5,0,0
1466622,29,16,1984,11,"male",695,39,25,42,17,42,16,0,1
1466627,23,1,1990,1,"male",960,289,191,4,0,0,0,4,0
1466635,33,24,1980,5,"male",465,19,8,0,0,0,0,0,0
1466641,15,17,1998,5,"male",358,175,156,0,3,0,3,0,0
1466644,23,12,1990,11,"female",311,152,82,6,13,6,8,0,5
1466661,25,18,1988,8,"male",396,257,202,82,15,82,10,0,5
1466666,26,20,1987,6,"male",122,16,9,7,0,0,0,7,0
1466674,17,10,1996,3,"female",314,339,189,245,243,218,143,27,100
1466680,31,23,1982,1,"female",411,24,21,73,43,73,28,0,15
1466687,32,27,1981,11,"male",633,145,93,14,24,10,4,4,20
1466700,24,17,1989,11,"male",98,222,170,17,22,16,10,1,12
1466736,17,9,1996,5,"male",262,98,76,24,26,23,21,1,5
1466741,67,7,1946,5,"male",1269,26,13,0,6,0,6,0,0
1466751,22,28,1991,12,"male",319,574,417,0,3,0,0,0,3
1466776,18,10,1995,6,"male",223,24,19,84,12,84,6,0,6
1466777,27,24,1986,6,"female",393,165,133,25,36,25,28,0,8
1466850,48,17,1965,9,"male",456,61,50,0,0,0,0,0,0
1466878,51,23,1962,3,"female",508,94,51,8,5,0,0,8,5
1466883,38,25,1975,6,"male",783,27,21,672,517,43,39,629,478
1466887,21,24,1992,4,"male",248,606,326,2767,880,2767,675,0,205
1466897,40,10,1973,6,"female",247,45,25,3,0,1,0,2,0
1466902,21,29,1992,4,"female",63,90,53,1145,211,1145,139,0,72
1466911,20,14,1993,6,"male",256,52,22,0,1,0,1,0,0
1466914,21,4,1992,2,"female",14,95,37,181,36,181,28,0,8
1466937,46,22,1967,4,"male",1157,376,217,91,43,66,25,25,18
1466942,23,22,1990,10,"male",431,350,309,85,8,78,5,7,3
1466946,30,4,1983,6,"male",145,139,106,934,670,925,491,9,179
1466976,66,17,1947,3,"male",515,40,28,1,0,0,0,1,0
1466990,20,26,1993,3,"male",702,65,26,3,10,3,9,0,1
1467003,35,18,1978,1,"male",511,19,13,0,0,0,0,0,0
1467031,54,4,1959,8,"female",2123,334,187,414,190,102,87,312,103
1467071,30,18,1983,11,"male",382,216,119,36,47,36,44,0,3
1467083,23,22,1990,5,"female",11,11,7,0,0,0,0,0,0
1467128,13,21,2000,5,"female",1,0,0,6,2,6,2,0,0
1467139,26,18,1987,12,"female",95,26,21,1,6,1,5,0,1
1467164,66,15,1947,9,"female",139,23,15,1,7,1,3,0,4
1467166,39,11,1974,8,"male",43,0,0,0,0,0,0,0,0
1467199,42,1,1971,2,"male",39,61,44,35,78,33,37,2,41
1467200,39,31,1974,7,"male",621,46,29,20,18,19,14,1,4
1467249,25,30,1988,4,"male",785,278,164,29,2,29,2,0,0
1467258,94,3,1919,2,"male",750,1222,846,122,217,122,157,0,60
1467266,53,27,1960,6,"male",22,21,18,7,33,2,21,5,12
1467272,28,16,1985,5,"male",787,96,57,690,65,690,35,0,30
1467338,64,22,1949,7,"female",1611,10,7,0,0,0,0,0,0
1467360,24,7,1989,11,"female",246,98,70,78,34,78,34,0,0
1467363,19,12,1994,10,"female",548,595,290,153,126,119,83,34,43
1467370,19,1,1994,1,"male",348,400,357,165,105,0,45,165,60
1467385,27,19,1986,11,"male",473,60,41,124,18,117,12,7,6
1467396,32,25,1981,9,"male",166,1,0,0,0,0,0,0,0
1467431,17,20,1996,10,"male",74,37,22,5,2,5,2,0,0
1467443,18,20,1995,10,"male",134,386,149,434,592,98,249,336,343
1467456,33,1,1980,1,"male",358,102,97,3,4,3,4,0,0
1467466,24,8,1989,11,"female",155,26,19,2,0,2,0,0,0
1467472,20,15,1993,11,"male",899,227,49,47,7,1,3,46,4
1467511,18,4,1995,12,"male",110,145,33,2,7,2,6,0,1
1467548,28,5,1985,4,"female",284,57,33,506,129,506,126,0,3
1467565,62,17,1951,8,"male",87,16,16,0,0,0,0,0,0
1467574,25,3,1988,1,"male",599,110,79,0,0,0,0,0,0
1467575,32,17,1981,2,"female",496,75,39,65,49,37,23,28,26
1467578,67,20,1946,9,"male",1189,285,172,67,22,48,13,19,9
1467587,21,3,1992,5,"male",471,224,148,66,10,66,10,0,0
1467592,34,2,1979,10,"male",89,25,14,2,18,2,10,0,8
1467595,18,1,1995,1,"male",500,54,31,12,24,10,19,2,5
1467615,17,14,1996,9,"male",427,107,79,1,0,0,0,1,0
1467644,33,13,1980,6,"female",1512,329,169,841,661,456,278,385,383
1467703,43,25,1970,3,"female",1715,335,241,59,153,59,121,0,32
1467717,17,7,1996,2,"male",460,77,41,33,35,30,21,3,14
1467728,24,10,1989,2,"male",133,3,3,0,0,0,0,0,0
1467737,24,9,1989,6,"male",349,54,52,41,6,0,1,41,5
1467744,17,22,1996,9,"male",250,137,40,6,0,6,0,0,0
1467760,27,10,1986,12,"female",428,81,31,0,0,0,0,0,0
1467768,20,1,1993,1,"female",154,172,159,13,4,3,4,10,0
1467800,29,30,1984,3,"male",121,100,67,2,15,2,14,0,1
1467828,17,24,1996,10,"female",279,73,38,0,0,0,0,0,0
1467852,46,10,1967,6,"male",753,77,45,0,13,0,6,0,7
1467877,31,15,1982,5,"male",556,54,21,45,8,45,8,0,0
1467881,24,25,1989,5,"male",50,104,69,1,2,1,2,0,0
1467896,58,6,1955,9,"male",780,44,28,15,17,9,10,6,7
1467907,19,8,1994,10,"male",220,472,307,880,1136,510,792,370,344
1467935,28,1,1985,10,"female",1240,201,139,77,150,38,61,39,89
1467950,22,15,1991,5,"female",269,2,2,2,0,2,0,0,0
1467959,52,5,1961,9,"female",619,69,51,32,27,27,10,5,17
1467976,20,17,1993,8,"male",946,229,77,8,11,8,11,0,0
1467983,17,14,1996,11,"male",505,84,53,1,15,1,5,0,10
1467995,20,30,1993,4,"male",246,114,66,6,3,6,3,0,0
1467999,17,26,1996,5,"male",36,69,58,50,139,42,62,8,77
1468006,23,5,1990,5,"male",113,179,148,783,129,13,102,770,27
1468018,22,12,1991,9,"male",924,1617,1346,19,10,19,6,0,4
1468019,45,21,1968,9,"male",46,372,360,215,137,215,116,0,21
1468020,42,13,1971,6,"male",439,43,36,7,8,0,8,7,0
1468023,65,20,1948,5,"female",668,12,9,0,1,0,1,0,0
1468027,14,21,1999,6,"male",711,37,17,3,0,0,0,3,0
1468042,25,1,1988,2,"male",518,36,17,1,0,1,0,0,0
1468054,29,20,1984,10,"male",295,83,67,31,9,31,6,0,3
1468063,16,19,1997,4,"female",772,1015,462,36,46,13,16,23,30
1468065,75,18,1938,12,"female",202,32,22,56,36,56,26,0,10
1468072,42,15,1971,10,"male",217,28,19,10,6,10,5,0,1
1468079,51,2,1962,11,"female",328,17,10,0,1,0,1,0,0
1468082,36,19,1977,10,"male",621,241,152,0,5,0,4,0,1
1468087,18,24,1995,12,"male",180,237,147,8,5,2,5,6,0
1468088,28,7,1985,5,"female",592,149,122,66,73,65,55,1,18
1468097,38,1,1975,1,"male",242,47,38,33,6,33,6,0,0
1468144,19,21,1994,11,"male",658,232,142,1,2,1,1,0,1
1468154,17,20,1996,1,"female",402,776,127,901,441,901,376,0,65
1468158,39,19,1974,12,"male",772,112,111,56,3,51,0,5,3
1468163,26,25,1987,10,"male",1059,166,52,1,8,1,8,0,0
1468167,24,21,1989,6,"female",141,295,96,19,28,19,18,0,10
1468194,20,1,1993,2,"male",244,59,10,0,0,0,0,0,0
1468196,51,30,1962,12,"female",584,8,7,1,0,1,0,0,0
1468204,103,10,1910,8,"male",959,451,263,2,0,2,0,0,0
1468221,63,24,1950,8,"male",46,9,9,0,0,0,0,0,0
1468235,14,16,1999,3,"female",466,497,391,127,16,98,13,29,3
1468280,28,28,1985,11,"male",151,58,36,10,4,10,2,0,2
1468288,56,14,1957,6,"female",227,67,64,0,2,0,2,0,0
1468302,21,17,1992,7,"male",655,107,33,1,0,0,0,1,0
1468342,34,14,1979,10,"female",212,47,16,48,12,48,8,0,4
1468352,46,7,1967,11,"female",691,205,92,591,293,591,176,0,117
1468397,48,9,1965,2,"male",222,9,7,0,0,0,0,0,0
1468402,35,2,1978,1,"female",824,168,91,78,327,78,305,0,22
1468408,36,7,1977,7,"male",164,110,81,13,1,13,1,0,0
1468446,23,18,1990,5,"male",402,15,11,1,2,1,1,0,1
1468478,65,8,1948,9,"female",534,68,20,176,71,0,18,176,53
1468499,37,8,1976,3,"male",234,230,168,26,12,26,5,0,7
1468500,32,27,1981,7,"female",646,249,159,490,617,364,442,126,175
1468506,17,11,1996,11,"female",542,1257,870,1211,1355,1211,1207,0,148
1468521,18,16,1995,11,"female",32,211,139,534,749,101,263,433,486
1468550,28,27,1985,5,"male",203,394,332,1045,1051,224,453,821,598
1468592,16,25,1997,9,"female",354,271,233,262,214,262,152,0,62
1468606,98,18,1915,7,"female",993,279,130,15,9,15,7,0,2
1468611,97,10,1916,2,"male",759,66,40,30,1,0,0,30,1
1468616,68,17,1945,8,"female",157,258,95,0,3,0,3,0,0
1468617,25,3,1988,6,"male",217,92,71,44,40,30,23,14,17
1468655,55,24,1958,8,"male",2346,101,32,17,2,17,2,0,0
1468662,21,18,1992,11,"female",656,55,30,867,655,444,227,423,428
1468704,40,21,1973,8,"female",121,139,125,515,168,509,122,6,46
1468710,31,28,1982,12,"male",247,228,81,23,2,23,1,0,1
1468726,62,19,1951,8,"male",1045,1222,734,316,238,269,140,47,98
1468732,67,22,1946,12,"female",1565,270,130,209,169,58,57,151,112
1468833,23,20,1990,10,"male",838,18,16,0,0,0,0,0,0
1468840,66,25,1947,2,"female",604,53,32,17,5,16,2,1,3
1468885,48,12,1965,6,"male",1539,600,188,266,202,110,41,156,161
1468903,52,18,1961,6,"female",1259,14,7,10,25,0,7,10,18
1468906,51,27,1962,4,"male",792,28,14,4,2,0,0,4,2
1468909,28,6,1985,6,"female",50,426,17,0,3,0,2,0,1
1468921,21,29,1992,7,"female",539,423,239,48,67,46,47,2,20
1468928,15,12,1998,3,"female",476,678,425,385,344,49,109,336,235
1468938,21,29,1992,12,"male",1244,0,0,0,0,0,0,0,0
1468957,16,1,1997,6,"male",494,158,34,3,0,3,0,0,0
1468963,49,27,1964,4,"male",745,53,38,7,4,7,3,0,1
1469005,18,2,1995,5,"male",310,89,86,3,1,3,0,0,1
1469021,20,15,1993,7,"male",378,68,56,1,0,1,0,0,0
1469024,60,10,1953,2,"male",445,50,31,5,8,0,0,5,8
1469034,39,25,1974,7,"male",308,53,44,7,20,7,19,0,1
1469037,33,12,1980,4,"male",19,21,20,6,1,6,1,0,0
1469089,57,15,1956,3,"female",284,16,15,0,1,0,1,0,0
1469138,42,16,1971,4,"male",374,35,13,1,19,1,9,0,10
1469141,20,1,1993,1,"male",159,60,53,46,5,46,3,0,2
1469163,27,4,1986,2,"female",370,120,19,1,0,1,0,0,0
1469176,55,21,1958,4,"female",536,227,72,71,48,71,30,0,18
1469182,62,16,1951,6,"female",368,224,30,4671,4986,0,392,4671,4594
1469199,48,7,1965,8,"female",92,116,27,0,0,0,0,0,0
1469206,50,20,1963,7,"male",213,7,4,0,2,0,1,0,1
1469253,108,9,1905,9,"male",1567,275,139,24,15,16,13,8,2
1469257,34,14,1979,11,"male",678,138,81,2,0,0,0,2,0
1469267,23,20,1990,7,"male",557,230,101,32,67,32,60,0,7
1469276,31,5,1982,12,"male",378,141,126,26,0,26,0,0,0
1469279,67,7,1946,3,"male",410,0,0,0,0,0,0,0,0
1469329,59,10,1954,3,"male",643,64,45,16,25,15,23,1,2
1469336,23,1,1990,6,"male",239,437,384,9,45,9,26,0,19
1469344,43,28,1970,12,"male",267,111,99,13,3,13,3,0,0
1469352,27,6,1986,4,"male",30,15,10,43,3,42,3,1,0
1469357,21,18,1992,8,"male",604,916,423,130,24,130,23,0,1
1469365,43,12,1970,2,"male",544,71,34,0,0,0,0,0,0
1469368,15,15,1998,9,"male",69,34,34,0,0,0,0,0,0
1469381,16,30,1997,4,"male",344,224,187,3,7,1,3,2,4
1469382,22,2,1991,8,"male",59,28,18,3,2,3,2,0,0
1469399,17,9,1996,9,"female",248,6,3,5,2,1,0,4,2
1469411,27,1,1986,10,"female",72,280,251,95,77,95,72,0,5
1469437,72,3,1941,11,"male",831,102,75,0,2,0,2,0,0
1469472,27,28,1986,10,"female",701,17,13,127,39,107,19,20,20
1469492,19,22,1994,2,"female",456,423,140,914,218,914,169,0,49
1469494,27,20,1986,1,"male",411,76,55,0,0,0,0,0,0
1469496,49,17,1964,1,"male",827,82,66,3,1,3,1,0,0
1469541,69,8,1944,7,"male",469,13,10,0,0,0,0,0,0
1469574,15,6,1998,5,"male",783,399,284,5,0,0,0,5,0
1469582,35,26,1978,12,"female",276,89,16,2,18,0,7,2,11
1469597,94,26,1919,8,"male",434,1224,1069,339,153,339,127,0,26
1469638,58,9,1955,8,"male",107,6,6,11,0,11,0,0,0
1469648,21,30,1992,6,"male",791,52,31,11,24,11,24,0,0
1469654,25,18,1988,4,"female",356,264,199,22,4,22,3,0,1
1469660,16,23,1997,12,"female",160,371,220,1,54,1,46,0,8
1469665,36,12,1977,11,"male",276,1,0,0,0,0,0,0,0
1469675,18,19,1995,1,"female",288,1072,136,35,47,35,39,0,8
1469683,48,25,1965,10,"female",1872,113,64,113,158,16,117,97,41
1469691,31,2,1982,11,"male",565,109,38,1,4,1,1,0,3
1469702,25,2,1988,8,"male",570,1,1,0,0,0,0,0,0
1469704,57,20,1956,12,"female",716,217,88,510,167,273,29,237,138
1469705,23,1,1990,1,"male",163,80,78,0,1,0,1,0,0
1469712,35,18,1978,6,"male",573,28,11,14,7,12,6,2,1
1469721,74,26,1939,9,NA,1998,1609,348,313,834,179,696,134,138
1469767,13,3,2000,10,"female",165,7,4,16,24,9,12,7,12
1469784,41,26,1972,3,"female",553,97,55,31,56,28,25,3,31
1469796,102,21,1911,9,"male",12,130,129,8,4,0,0,8,4
1469797,57,6,1956,1,"male",1426,2064,882,22,146,4,86,18,60
1469807,18,25,1995,2,"male",206,429,274,35,42,34,34,1,8
1469815,74,23,1939,7,"female",224,44,37,6,6,6,6,0,0
1469860,113,12,1900,8,"female",1200,78,42,257,28,257,25,0,3
1469876,22,26,1991,3,"male",369,146,96,0,3,0,3,0,0
1469903,23,5,1990,7,"female",530,86,80,159,282,34,181,125,101
1469914,23,4,1990,9,"male",753,364,91,118,61,118,54,0,7
1469934,33,17,1980,11,"female",538,43,16,92,130,92,129,0,1
1469943,18,5,1995,12,"male",638,1308,1064,7,6,7,5,0,1
1469959,58,27,1955,4,"male",289,14,6,37,34,0,5,37,29
1469997,20,15,1993,7,"male",1464,122,78,8,120,7,28,1,92
1470008,42,26,1971,8,"male",420,215,105,1,0,1,0,0,0
1470044,25,27,1988,5,"female",360,127,50,387,49,234,31,153,18
1470089,61,16,1952,3,"male",511,11,8,0,11,0,6,0,5
1470098,30,28,1983,11,"female",98,27,2,54,0,30,0,24,0
1470104,61,17,1952,4,"male",464,42,30,3,1,3,1,0,0
1470126,21,30,1992,1,"female",746,560,463,313,122,311,98,2,24
1470142,33,20,1980,7,"male",430,1,1,4,1,4,1,0,0
1470153,30,2,1983,7,"male",458,47,20,0,9,0,5,0,4
1470156,23,11,1990,11,"male",38,6,3,0,0,0,0,0,0
1470169,48,28,1965,8,"female",1316,252,82,853,522,741,509,112,13
1470180,19,7,1994,9,"male",74,3,2,3,0,3,0,0,0
1470186,25,1,1988,5,"female",100,67,11,1,11,1,6,0,5
1470196,103,20,1910,1,"male",778,164,58,406,74,406,39,0,35
1470197,56,20,1957,1,"male",1130,1465,997,11,14,0,6,11,8
1470262,71,18,1942,9,"male",383,59,54,0,5,0,5,0,0
1470282,18,14,1995,4,"female",474,277,183,72,120,67,110,5,10
1470286,43,15,1970,11,"male",353,24,16,0,0,0,0,0,0
1470299,16,5,1997,9,"female",539,79,50,78,3,78,3,0,0
1470301,27,15,1986,7,"female",157,65,53,1,5,1,4,0,1
1470327,18,25,1995,10,"female",785,4210,156,0,39,0,32,0,7
1470340,57,27,1956,2,"male",760,55,51,0,0,0,0,0,0
1470357,32,20,1981,12,"female",326,105,19,0,0,0,0,0,0
1470364,36,15,1977,12,"female",15,42,41,18,4,16,4,2,0
1470373,108,2,1905,5,"female",1074,109,55,3,3,3,3,0,0
1470431,37,23,1976,3,"male",625,14,12,1,0,1,0,0,0
1470432,25,20,1988,2,"male",198,1,1,0,0,0,0,0,0
1470434,67,7,1946,1,"male",733,304,66,571,71,571,55,0,16
1470440,63,6,1950,8,"female",2339,95,34,84,79,84,63,0,16
1470452,17,19,1996,1,"female",710,284,63,6,0,6,0,0,0
1470459,78,17,1935,2,"female",153,14,8,1,4,1,4,0,0
1470477,21,4,1992,10,"male",1364,282,153,15,21,15,16,0,5
1470495,52,7,1961,2,"female",164,50,29,6,15,4,5,2,10
1470505,21,15,1992,5,"female",426,373,77,7,18,7,9,0,9
1470527,60,21,1953,5,"female",1730,164,99,180,137,58,38,122,99
1470539,18,18,1995,3,"female",639,408,247,88,12,49,10,39,2
1470555,52,24,1961,12,"female",770,293,241,84,70,14,34,70,36
1470577,18,1,1995,2,"female",81,7,7,0,0,0,0,0,0
1470589,24,15,1989,8,"male",28,128,120,739,966,616,762,123,204
1470600,48,25,1965,8,"female",1675,148,67,854,180,307,129,547,51
1470613,58,30,1955,3,"female",1449,80,31,77,12,40,12,37,0
1470620,34,29,1979,1,"male",469,123,111,10,0,10,0,0,0
1470629,27,6,1986,12,"male",317,35,30,0,0,0,0,0,0
1470630,62,18,1951,7,"female",1622,185,134,2408,249,2370,125,38,124
1470632,17,19,1996,5,"female",430,410,356,792,669,276,294,516,375
1470637,16,12,1997,4,"male",362,54,24,0,0,0,0,0,0
1470638,17,18,1996,5,"female",184,47,33,0,0,0,0,0,0
1470642,42,20,1971,2,"male",1545,929,225,485,768,389,675,96,93
1470668,17,4,1996,4,"male",301,1281,647,5831,3344,5831,2979,0,365
1470671,28,20,1985,2,"male",260,3,3,0,0,0,0,0,0
1470685,69,29,1944,6,"female",1035,105,69,2,14,0,2,2,12
1470696,28,5,1985,5,"male",63,12,8,1,3,1,0,0,3
1470707,54,28,1959,10,"female",613,19,15,87,26,67,20,20,6
1470738,15,6,1998,7,"male",185,147,89,159,162,159,125,0,37
1470756,34,3,1979,2,"female",235,83,48,80,78,80,45,0,33
1470776,108,8,1905,10,"male",1676,210,23,1,0,0,0,1,0
1470794,29,30,1984,9,"male",355,39,19,1,0,1,0,0,0
1470800,45,28,1968,5,"female",133,18,16,7,0,7,0,0,0
1470823,16,3,1997,9,"male",94,200,152,126,46,126,38,0,8
1470826,21,16,1992,10,"male",485,110,72,3,40,0,12,3,28
1470846,108,13,1905,5,"male",1931,428,221,367,465,216,334,151,131
1470850,63,19,1950,6,"male",311,194,156,6,12,0,0,6,12
1470859,19,15,1994,1,"male",644,85,58,0,2,0,2,0,0
1470880,32,8,1981,9,"male",164,6,6,1,4,0,3,1,1
1470896,53,17,1960,12,"female",766,128,69,965,222,0,98,965,124
1470899,43,11,1970,10,"male",512,25,4,15,16,15,15,0,1
1471029,93,24,1920,1,"female",1090,95,68,4,16,4,4,0,12
1471040,22,2,1991,2,"male",153,42,27,14,2,14,2,0,0
1471049,34,10,1979,1,"male",277,44,34,0,0,0,0,0,0
1471051,42,4,1971,1,"male",486,106,84,0,0,0,0,0,0
1471085,33,29,1980,4,"male",365,154,115,301,637,155,449,146,188
1471095,30,11,1983,8,"male",581,284,156,45,67,45,54,0,13
1471107,15,20,1998,9,"male",538,49,49,0,0,0,0,0,0
1471120,54,11,1959,9,"female",313,61,49,349,307,0,88,349,219
1471127,50,13,1963,12,"female",2218,403,245,1357,1823,1330,699,27,1124
1471142,18,10,1995,8,"female",391,388,286,1026,682,1026,473,0,209
1471163,62,5,1951,10,"female",150,114,69,299,102,1,27,298,75
1471168,23,21,1990,11,"male",321,112,80,19,15,19,12,0,3
1471177,17,5,1996,7,"male",420,317,150,105,142,105,129,0,13
1471197,20,8,1993,7,"female",627,542,154,183,285,183,274,0,11
1471226,29,22,1984,7,"female",100,197,144,560,856,187,326,373,530
1471238,64,18,1949,7,"female",984,31,8,17,0,0,0,17,0
1471240,57,15,1956,4,"female",530,152,16,103,10,103,7,0,3
1471256,19,1,1994,5,"male",729,582,130,248,240,247,172,1,68
1471265,49,6,1964,3,"male",1089,43,22,17,7,17,3,0,4
1471278,47,1,1966,1,"male",234,5,2,0,0,0,0,0,0
1471306,52,24,1961,4,"male",433,29,21,0,0,0,0,0,0
1471324,53,21,1960,12,"female",956,76,33,48,14,0,7,48,7
1471333,19,26,1994,12,"male",272,42,26,0,32,0,11,0,21
1471337,15,20,1998,5,"female",422,64,21,0,0,0,0,0,0
1471339,24,2,1989,7,"female",465,184,139,3,45,0,27,3,18
1471343,31,1,1982,1,"female",246,19,12,0,0,0,0,0,0
1471357,29,5,1984,3,"female",503,119,92,174,192,174,189,0,3
1471395,66,20,1947,8,"male",2431,31,13,20,38,15,20,5,18
1471407,105,14,1908,5,"male",1090,30,23,1,0,0,0,1,0
1471489,15,3,1998,10,"male",740,117,95,110,0,109,0,1,0
1471494,66,29,1947,5,"female",2122,62,8,25,13,6,13,19,0
1471498,62,12,1951,9,"female",446,239,187,58,56,0,27,58,29
1471529,19,15,1994,11,"female",39,0,0,0,0,0,0,0,0
1471542,23,17,1990,2,"male",38,2,2,27,0,27,0,0,0
1471543,20,13,1993,10,"female",373,25,13,122,13,122,12,0,1
1471558,42,22,1971,4,"female",624,112,83,96,54,0,15,96,39
1471586,25,18,1988,6,"female",22,19,19,1,1,1,1,0,0
1471606,44,14,1969,1,"male",896,65,24,40,6,40,3,0,3
1471611,46,27,1967,10,"female",653,49,15,164,165,149,28,15,137
1471629,24,16,1989,12,"female",507,343,172,1135,1112,660,281,475,831
1471660,108,1,1905,1,"female",1850,19,7,22,4,0,2,22,2
1471676,14,6,1999,12,"male",14,3,3,2,1,1,0,1,1
1471682,23,5,1990,11,"male",109,51,49,4,8,2,3,2,5
1471704,18,12,1995,7,"male",311,29,18,3,1,3,0,0,1
1471705,37,9,1976,7,"male",545,7,5,38,10,0,6,38,4
1471720,23,1,1990,12,"male",294,269,140,360,161,188,115,172,46
1471722,27,15,1986,7,"male",232,478,424,770,80,770,76,0,4
1471723,17,10,1996,2,"male",365,141,99,0,1,0,0,0,1
1471726,23,18,1990,9,"male",629,131,93,1,0,1,0,0,0
1471728,18,4,1995,5,"female",147,30,15,0,0,0,0,0,0
1471753,57,19,1956,2,"male",396,0,0,0,0,0,0,0,0
1471778,20,9,1993,1,"male",1047,78,41,0,0,0,0,0,0
1471784,16,22,1997,1,"female",593,172,130,0,1,0,1,0,0
1471786,37,15,1976,5,"female",623,298,184,1,15,1,10,0,5
1471810,14,11,1999,7,"female",15,36,6,759,102,759,74,0,28
1471812,21,15,1992,12,"male",203,133,120,12,2,1,2,11,0
1471821,44,22,1969,9,"female",1309,690,298,1793,1699,1793,1334,0,365
1471839,59,1,1954,2,"male",728,209,95,856,2712,375,1284,481,1428
1471849,49,17,1964,12,"female",693,3,1,1,0,0,0,1,0
1471853,42,19,1971,11,"female",461,129,78,38,82,38,63,0,19
1471858,44,27,1969,12,"female",272,349,87,182,14,182,13,0,1
1471859,20,7,1993,3,"female",298,175,31,46,29,12,16,34,13
1471882,18,14,1995,3,"male",411,95,58,0,3,0,2,0,1
1471888,22,17,1991,3,"male",576,190,164,375,511,66,150,309,361
1471898,32,22,1981,8,"male",422,1,1,0,0,0,0,0,0
1471939,100,29,1913,9,"female",760,332,110,136,174,17,77,119,97
1471989,60,17,1953,1,"male",732,95,86,1,1,0,0,1,1
1472001,15,30,1998,5,"female",448,195,64,59,54,59,47,0,7
1472046,58,2,1955,9,"female",1352,183,57,255,199,240,144,15,55
1472049,23,14,1990,8,"male",197,107,106,0,0,0,0,0,0
1472076,54,27,1959,6,"female",1818,57,27,33,107,32,94,1,13
1472080,31,16,1982,4,"female",469,178,140,29,80,15,68,14,12
1472093,78,3,1935,5,"male",1095,33,9,0,0,0,0,0,0
1472127,103,10,1910,9,"male",1407,716,169,34,153,34,117,0,36
1472151,19,11,1994,8,"male",808,467,363,0,1,0,0,0,1
1472157,18,5,1995,5,"male",124,19,8,0,0,0,0,0,0
1472167,22,22,1991,9,"male",274,174,150,2,1,2,1,0,0
1472185,49,2,1964,9,"female",1919,183,25,61,55,22,48,39,7
1472205,29,10,1984,12,"male",40,185,172,69,62,69,53,0,9
1472223,74,22,1939,1,"male",179,17,11,11,16,0,10,11,6
1472228,32,30,1981,9,"female",273,88,43,18,12,2,8,16,4
1472233,39,11,1974,8,"male",213,48,18,29,138,29,131,0,7
1472234,49,11,1964,6,"male",46,8,7,8,0,8,0,0,0
1472274,30,30,1983,4,"male",257,344,271,185,52,2,6,183,46
1472275,61,24,1952,11,"male",613,35,16,48,0,1,0,47,0
1472315,31,28,1982,9,"male",456,175,150,23,0,23,0,0,0
1472328,21,15,1992,5,"female",412,648,540,63,161,63,97,0,64
1472333,19,16,1994,11,"male",470,138,88,10,3,10,2,0,1
1472339,31,20,1982,3,"male",1316,362,267,45,66,45,20,0,46
1472360,19,10,1994,10,"female",610,333,181,0,9,0,8,0,1
1472373,34,18,1979,5,"female",117,212,59,85,81,85,70,0,11
1472379,18,5,1995,7,"female",96,71,1,48,504,47,346,1,158
1472392,49,23,1964,10,"male",313,18,14,0,0,0,0,0,0
1472417,58,3,1955,9,"female",1320,122,52,13,31,12,19,1,12
1472440,51,29,1962,8,"male",184,56,29,64,70,64,67,0,3
1472460,21,11,1992,2,"female",452,46,32,36,7,36,6,0,1
1472466,47,21,1966,12,"female",1113,55,43,37,66,0,12,37,54
1472476,16,15,1997,10,"male",421,202,48,589,47,589,41,0,6
1472517,22,26,1991,3,"male",369,67,54,11,6,11,6,0,0
1472560,59,20,1954,9,"male",447,64,39,0,0,0,0,0,0
1472564,21,13,1992,6,"male",596,103,63,5,32,5,13,0,19
1472588,42,1,1971,1,"male",1770,46,28,2,2,2,2,0,0
1472602,52,11,1961,2,"female",1164,72,38,61,8,61,6,0,2
1472616,25,7,1988,5,"female",177,11,11,1,0,1,0,0,0
1472621,101,9,1912,10,"male",1158,434,161,109,154,4,23,105,131
1472643,45,10,1968,9,"male",19,28,19,4,5,4,4,0,1
1472650,15,8,1998,2,"female",602,87,27,20,59,11,23,9,36
1472655,20,25,1993,2,"female",389,298,163,223,348,223,346,0,2
1472660,37,9,1976,2,"female",365,15,5,311,143,311,112,0,31
1472678,46,26,1967,3,"male",596,40,28,32,2,31,2,1,0
1472708,108,1,1905,1,"male",1048,248,58,151,19,148,12,3,7
1472719,23,1,1990,12,"male",135,3,1,0,0,0,0,0,0
1472741,25,14,1988,3,"female",68,3,3,0,0,0,0,0,0
1472752,25,7,1988,6,"female",407,28,21,84,14,84,12,0,2
1472756,24,9,1989,2,"male",47,12,4,50,20,0,6,50,14
1472788,26,20,1987,6,"female",328,131,80,175,125,175,113,0,12
1472792,14,23,1999,11,"male",86,104,59,0,0,0,0,0,0
1472812,103,23,1910,5,"male",1771,1049,504,111,84,14,24,97,60
1472815,33,4,1980,9,"male",674,16,4,2,1,2,1,0,0
1472860,75,20,1938,6,"male",1448,64,20,0,0,0,0,0,0
1472866,20,28,1993,12,"female",350,328,264,40,0,0,0,40,0
1472889,90,30,1923,1,"male",394,251,180,43,6,0,1,43,5
1472917,16,7,1997,3,"male",399,70,45,18,2,17,0,1,2
1472927,58,7,1955,7,"male",244,6,2,2,6,2,4,0,2
1472937,22,27,1991,4,"male",534,61,49,212,5,212,5,0,0
1472956,32,9,1981,3,"female",249,2,2,0,2,0,2,0,0
1472964,36,10,1977,10,"male",226,12,11,3,1,0,1,3,0
1472980,61,6,1952,8,"male",499,169,72,10,26,10,23,0,3
1472999,38,18,1975,4,"male",258,11,6,21,6,21,5,0,1
1473011,65,25,1948,4,"male",1416,166,98,6,3,6,3,0,0
1473026,68,28,1945,11,"male",457,56,12,14,4,11,0,3,4
1473039,24,22,1989,8,"female",411,133,90,41,80,41,77,0,3
1473050,31,2,1982,4,"male",221,178,81,0,7,0,3,0,4
1473064,53,1,1960,8,"male",801,507,306,16,16,16,14,0,2
1473119,66,11,1947,10,"male",1430,141,52,740,492,674,218,66,274
1473121,59,10,1954,4,"female",1534,569,334,223,149,68,68,155,81
1473125,20,13,1993,8,"female",350,394,246,214,271,214,227,0,44
1473133,60,30,1953,7,"male",1200,20,8,4,0,0,0,4,0
1473142,19,22,1994,12,"female",145,21,12,0,0,0,0,0,0
1473173,43,12,1970,10,"female",375,23,10,0,0,0,0,0,0
1473187,19,19,1994,4,"female",1,0,0,0,0,0,0,0,0
1473204,21,1,1992,6,"female",510,560,105,315,612,91,290,224,322
1473243,26,21,1987,8,"male",584,531,493,65,125,16,106,49,19
1473260,56,27,1957,11,"male",1378,33,18,1,0,1,0,0,0
1473265,23,5,1990,4,"male",378,239,191,3,6,0,3,3,3
1473268,18,17,1995,4,"male",26,148,133,121,64,26,46,95,18
1473331,64,21,1949,5,"female",63,30,29,165,95,0,13,165,82
1473334,32,13,1981,11,"male",778,167,119,59,50,6,20,53,30
1473343,18,8,1995,6,"female",239,23,15,4,9,0,0,4,9
1473344,14,2,1999,10,"male",246,88,68,3,99,2,63,1,36
1473350,48,25,1965,8,"male",274,12,1,0,1,0,0,0,1
1473374,108,3,1905,1,"male",114,22,21,0,0,0,0,0,0
1473385,25,22,1988,9,"male",182,144,122,19,2,19,2,0,0
1473407,44,17,1969,10,"male",1869,83,15,1,155,1,145,0,10
1473421,16,28,1997,2,"female",272,75,62,3,1,0,0,3,1
1473505,33,28,1980,1,"male",610,22,14,0,0,0,0,0,0
1473507,25,18,1988,10,"female",328,71,3,11,3,11,3,0,0
1473511,25,1,1988,1,"male",63,602,452,1299,1843,1242,1634,57,209
1473524,20,21,1993,3,"female",1242,580,38,0,7,0,7,0,0
1473570,25,29,1988,11,"female",569,85,64,137,188,107,101,30,87
1473670,23,3,1990,3,"male",376,72,63,2,23,2,18,0,5
1473720,16,14,1997,2,"male",786,505,50,30,249,20,160,10,89
1473759,23,1,1990,1,"male",521,155,131,0,0,0,0,0,0
1473778,66,9,1947,6,"female",1199,34,17,4,1,0,0,4,1
1473780,19,14,1994,8,"male",586,137,113,50,138,44,83,6,55
1473784,26,6,1987,4,"female",323,93,73,0,0,0,0,0,0
1473816,23,13,1990,10,"male",334,158,99,187,36,187,34,0,2
1473818,24,10,1989,2,"male",297,121,36,0,0,0,0,0,0
1473866,25,24,1988,8,"female",626,138,60,0,1,0,1,0,0
1473884,23,3,1990,3,"female",649,95,44,8,12,0,5,8,7
1473908,83,28,1930,10,"female",1499,167,95,564,388,548,329,16,59
1473918,43,18,1970,8,"female",39,67,39,51,470,51,441,0,29
1473923,63,5,1950,12,"female",1666,96,57,54,26,21,6,33,20
1473935,62,21,1951,10,"female",1696,97,33,225,114,93,68,132,46
1473977,23,14,1990,3,"male",426,161,139,0,4,0,4,0,0
1473982,32,18,1981,2,"male",229,0,0,0,0,0,0,0,0
1473986,73,1,1940,1,"male",519,44,38,0,0,0,0,0,0
1474024,18,21,1995,2,"male",343,63,58,14,24,14,23,0,1
1474025,40,15,1973,11,"female",431,184,121,683,367,41,114,642,253
1474031,48,13,1965,10,"male",130,14,14,2,0,0,0,2,0
1474053,51,6,1962,2,"female",588,20,14,11,9,0,9,11,0
1474103,103,15,1910,6,"female",771,266,141,9,168,9,129,0,39
1474107,27,22,1986,10,"male",1015,116,83,0,1,0,1,0,0
1474113,42,20,1971,2,"male",492,35,10,7,0,7,0,0,0
1474126,36,3,1977,7,"male",1229,15,5,0,0,0,0,0,0
1474146,62,6,1951,11,"female",1233,15,8,0,0,0,0,0,0
1474172,20,2,1993,10,"female",732,424,154,1559,908,804,593,755,315
1474177,113,12,1900,5,"male",1276,398,135,63,88,61,47,2,41
1474188,16,2,1997,5,"female",353,673,358,64,10,18,5,46,5
1474204,18,29,1995,3,"female",201,569,161,33,126,33,105,0,21
1474226,47,25,1966,1,"female",424,81,35,2,10,2,1,0,9
1474229,52,29,1961,1,"female",164,54,38,249,82,0,37,249,45
1474241,79,24,1934,11,"female",1100,41,16,138,27,0,9,138,18
1474256,23,16,1990,11,"female",172,83,3,1,2,1,2,0,0
1474298,108,15,1905,4,"male",1084,146,115,0,8,0,6,0,2
1474299,38,9,1975,10,"male",990,128,72,219,75,2,8,217,67
1474300,40,25,1973,10,"male",191,55,41,2,3,2,3,0,0
1474323,18,5,1995,1,"female",99,77,57,122,34,118,28,4,6
1474346,49,23,1964,9,"male",828,109,68,3,16,3,13,0,3
1474349,20,10,1993,12,"female",459,4710,894,879,4830,671,3180,208,1650
1474358,33,20,1980,11,"male",422,111,108,5,0,5,0,0,0
1474383,73,25,1940,5,"male",89,16,16,0,0,0,0,0,0
1474475,29,22,1984,7,"male",342,172,122,0,0,0,0,0,0
1474487,20,15,1993,9,"female",294,1,1,1,0,1,0,0,0
1474491,33,5,1980,1,"male",879,23,2,10,0,0,0,10,0
1474515,17,6,1996,9,"male",673,173,125,31,5,31,5,0,0
1474553,43,1,1970,1,"female",253,41,22,16,33,16,19,0,14
1474572,42,25,1971,9,"male",419,27,19,0,0,0,0,0,0
1474574,28,16,1985,4,"male",98,139,131,546,83,546,76,0,7
1474597,26,20,1987,10,"male",677,15,2,0,3,0,3,0,0
1474604,22,12,1991,4,"male",261,48,28,25,20,25,20,0,0
1474619,28,30,1985,1,"female",401,46,37,10,14,0,7,10,7
1474622,42,21,1971,9,"male",459,18,9,8,4,5,3,3,1
1474627,53,25,1960,9,"male",1533,265,131,0,0,0,0,0,0
1474688,19,14,1994,3,"male",528,461,347,63,58,63,45,0,13
1474713,14,20,1999,7,"male",367,269,112,42,90,42,45,0,45
1474746,22,19,1991,8,"male",654,38,26,44,32,44,25,0,7
1474769,96,7,1917,1,"female",2341,2236,739,288,353,190,207,98,146
1474808,58,10,1955,7,"male",1444,195,120,77,79,73,48,4,31
1474840,18,6,1995,1,"male",890,400,287,19,4,19,1,0,3
1474849,63,9,1950,12,"female",1742,177,105,9,18,3,16,6,2
1474868,15,6,1998,2,"male",309,439,299,51,25,0,7,51,18
1474870,59,5,1954,3,"male",196,0,0,0,0,0,0,0,0
1474910,17,17,1996,10,"female",56,22,9,8,2,8,2,0,0
1474947,21,30,1992,12,"female",441,183,53,553,165,499,156,54,9
1474963,22,15,1991,1,"male",317,326,281,27,12,16,10,11,2
1474992,18,7,1995,7,"female",422,2770,1441,462,1495,37,750,425,745
1475040,19,23,1994,6,"female",214,195,134,152,258,144,177,8,81
1475054,25,8,1988,10,"female",409,119,53,297,41,276,33,21,8
1475066,74,26,1939,10,"male",1281,164,76,3,1,3,1,0,0
1475107,47,27,1966,8,"male",753,183,112,0,0,0,0,0,0
1475153,59,23,1954,2,"female",524,211,141,11,70,11,43,0,27
1475161,24,14,1989,10,"male",350,163,51,0,1,0,0,0,1
1475205,21,27,1992,6,"male",472,86,42,54,26,54,16,0,10
1475209,19,6,1994,4,"male",284,70,45,0,0,0,0,0,0
1475227,22,2,1991,1,"male",468,1,1,9,1,0,0,9,1
1475234,20,16,1993,6,"male",562,200,6,0,17,0,7,0,10
1475295,26,5,1987,1,"male",245,88,75,0,1,0,1,0,0
1475318,32,8,1981,10,"male",562,413,204,8,34,5,20,3,14
1475321,22,8,1991,11,"male",412,76,59,17,5,1,1,16,4
1475325,49,11,1964,10,"male",527,72,58,43,29,0,7,43,22
1475360,18,10,1995,4,"male",94,90,77,2,4,0,1,2,3
1475369,41,26,1972,10,"male",490,10,4,14,56,14,33,0,23
1475381,20,13,1993,8,"male",612,176,131,1,212,0,66,1,146
1475410,29,18,1984,4,"female",214,46,32,49,12,49,10,0,2
1475425,65,23,1948,2,"female",947,90,25,784,491,784,323,0,168
1475433,19,24,1994,12,"female",232,297,153,47,152,32,134,15,18
1475462,108,12,1905,5,"male",996,26,8,6,1,3,1,3,0
1475507,16,27,1997,7,"male",471,472,378,954,948,372,244,582,704
1475512,24,6,1989,6,"female",759,660,188,0,1,0,0,0,1
1475538,15,20,1998,10,"male",365,25,21,1,0,0,0,1,0
1475550,17,4,1996,2,"female",551,92,57,8,2,1,1,7,1
1475564,26,19,1987,6,"female",293,145,104,1444,573,1213,448,231,125
1475566,47,7,1966,7,"male",1653,122,69,0,0,0,0,0,0
1475569,21,9,1992,10,"male",540,11,10,0,0,0,0,0,0
1475598,37,24,1976,2,"male",389,34,17,11,14,11,11,0,3
1475608,37,5,1976,12,"male",246,58,31,0,2,0,2,0,0
1475624,24,13,1989,11,"male",299,195,144,94,59,68,28,26,31
1475647,56,11,1957,9,"female",508,44,36,0,0,0,0,0,0
1475692,24,4,1989,1,"male",280,58,35,0,4,0,2,0,2
1475698,45,9,1968,7,"female",367,91,75,7,0,0,0,7,0
1475703,19,26,1994,1,"female",529,255,122,7,13,6,7,1,6
1475720,36,30,1977,5,"male",271,88,73,25,7,25,7,0,0
1475750,20,4,1993,12,"female",1334,4622,1819,4280,45633,472,30754,3808,14879
1475755,33,23,1980,5,"male",1473,1100,742,8749,8059,7086,4784,1663,3275
1475762,39,6,1974,1,"female",987,132,70,298,64,278,44,20,20
1475763,19,31,1994,1,"male",571,12,12,0,0,0,0,0,0
1475771,71,31,1942,10,"male",1358,354,119,81,98,81,57,0,41
1475777,20,19,1993,10,"male",868,1277,1140,0,5,0,0,0,5
1475779,64,13,1949,10,"male",351,24,16,19,5,0,5,19,0
1475809,59,17,1954,11,"female",449,23,20,11,23,11,12,0,11
1475866,21,20,1992,6,"male",371,4,4,1,1,0,0,1,1
1475912,25,12,1988,12,"female",117,266,157,4,47,4,32,0,15
1475922,100,14,1913,11,"male",1130,150,82,2,5,0,5,2,0
1475941,69,17,1944,2,"female",380,23,8,2,6,2,6,0,0
1475946,35,1,1978,7,"male",221,34,27,3,0,3,0,0,0
1475982,70,30,1943,8,"female",1208,47,29,27,4,14,1,13,3
1475989,43,1,1970,4,"male",214,46,22,10,16,10,10,0,6
1476013,20,25,1993,8,"male",107,115,53,453,67,350,33,103,34
1476047,49,14,1964,2,"female",923,2,1,4,0,4,0,0,0
1476069,97,17,1916,7,"male",1340,177,37,322,458,7,57,315,401
1476080,25,16,1988,10,"male",433,149,85,363,94,363,64,0,30
1476108,48,25,1965,12,"male",335,51,44,230,15,220,7,10,8
1476109,21,20,1992,9,"male",529,46,39,0,1,0,1,0,0
1476123,44,20,1969,4,"female",236,129,113,259,71,259,52,0,19
1476152,43,22,1970,7,"female",563,24,19,91,7,91,5,0,2
1476153,13,11,2000,1,"male",117,10,2,0,0,0,0,0,0
1476178,52,24,1961,11,"female",319,34,23,20,15,20,3,0,12
1476192,26,1,1987,1,"male",302,42,41,0,1,0,0,0,1
1476217,46,12,1967,9,"female",299,44,25,37,73,37,9,0,64
1476222,18,23,1995,10,"female",478,211,93,542,236,542,209,0,27
1476223,49,12,1964,2,"female",312,40,29,0,0,0,0,0,0
1476224,47,10,1966,11,"male",557,8,6,0,0,0,0,0,0
1476267,18,23,1995,5,"female",525,119,58,2773,889,538,335,2235,554
1476292,14,10,1999,7,"female",132,675,243,45,0,30,0,15,0
1476297,26,23,1987,7,"male",284,71,68,7,10,2,3,5,7
1476320,19,21,1994,5,"female",402,86,31,329,265,11,91,318,174
1476355,53,1,1960,1,"male",260,7,2,0,0,0,0,0,0
1476380,33,6,1980,7,"male",599,53,31,7,21,7,16,0,5
1476405,23,29,1990,1,"male",717,150,71,2,0,2,0,0,0
1476409,18,8,1995,2,"male",517,77,59,240,4,16,2,224,2
1476444,23,7,1990,5,"female",300,178,86,28,22,28,13,0,9
1476510,24,12,1989,8,"female",342,79,6,4,13,4,10,0,3
1476513,24,11,1989,12,"male",292,0,0,0,0,0,0,0,0
1476520,23,25,1990,4,"female",284,80,32,425,121,425,120,0,1
1476523,18,3,1995,1,"male",319,129,94,72,58,72,47,0,11
1476564,19,10,1994,11,"male",380,955,822,1329,1459,1329,1380,0,79
1476573,59,21,1954,6,"female",114,6,6,4,0,4,0,0,0
1476584,19,1,1994,1,"female",341,17,8,0,0,0,0,0,0
1476590,18,20,1995,12,"male",477,147,105,15,14,0,0,15,14
1476602,50,6,1963,12,"male",453,1,0,0,0,0,0,0,0
1476663,19,11,1994,8,"male",14,3,0,1,0,0,0,1,0
1476673,18,18,1995,11,"male",269,42,24,0,0,0,0,0,0
1476695,113,22,1900,6,"male",1711,610,92,155,156,155,103,0,53
1476723,61,8,1952,4,"female",1755,108,71,7,20,0,17,7,3
1476731,63,25,1950,3,"female",542,75,43,1436,303,1436,160,0,143
1476744,51,6,1962,6,"female",243,100,62,181,215,1,75,180,140
1476747,17,24,1996,12,"male",26,62,57,26,16,26,13,0,3
1476770,38,26,1975,3,"male",695,177,122,0,1,0,1,0,0
1476779,53,17,1960,7,"male",1617,55,17,7,0,0,0,7,0
1476798,18,7,1995,8,"male",246,386,247,2,0,2,0,0,0
1476800,25,14,1988,2,"male",632,94,37,0,1,0,0,0,1
1476860,24,21,1989,9,"female",704,363,206,5,21,5,7,0,14
1476864,38,24,1975,8,"female",641,286,142,2,8,2,8,0,0
1476880,26,15,1987,2,"female",607,47,44,264,468,179,175,85,293
1476952,69,21,1944,10,"male",339,19,2,0,0,0,0,0,0
1476953,70,1,1943,3,"female",1091,27,20,0,10,0,7,0,3
1476957,15,13,1998,8,"male",539,76,28,0,0,0,0,0,0
1476962,43,1,1970,3,"male",402,5,5,0,0,0,0,0,0
1476990,39,31,1974,8,"male",443,197,122,14,8,14,3,0,5
1477023,17,25,1996,1,"male",419,78,59,158,299,158,223,0,76
1477024,20,4,1993,5,"female",304,185,139,74,31,74,31,0,0
1477063,24,25,1989,4,"female",462,299,230,108,326,105,324,3,2
1477065,17,24,1996,11,"female",431,58,27,14,16,9,11,5,5
1477067,42,2,1971,2,"male",135,462,419,47,257,40,167,7,90
1477081,20,15,1993,7,"male",432,372,302,10,6,0,0,10,6
1477105,60,16,1953,11,"female",549,51,44,2,6,0,3,2,3
1477114,28,9,1985,6,"male",1043,46,20,0,1,0,1,0,0
1477118,18,8,1995,4,"female",151,68,36,5,17,5,15,0,2
1477125,17,31,1996,1,"male",75,95,82,17,24,17,24,0,0
1477138,25,30,1988,12,"female",670,25,21,0,0,0,0,0,0
1477162,33,1,1980,4,"female",50,4,2,32,23,32,10,0,13
1477172,26,10,1987,3,"male",499,277,229,48,8,1,6,47,2
1477173,23,5,1990,9,"male",540,1,0,0,0,0,0,0,0
1477183,24,24,1989,5,"male",358,63,39,1,9,1,6,0,3
1477186,21,23,1992,3,"male",328,453,328,1261,234,89,147,1172,87
1477208,67,20,1946,9,"female",1743,207,91,704,508,7,115,697,393
1477227,49,5,1964,12,"male",175,82,31,6,0,6,0,0,0
1477250,57,5,1956,12,"female",846,58,42,59,20,0,8,59,12
1477272,81,13,1932,7,"female",1509,37,18,21,3,2,1,19,2
1477295,20,17,1993,11,"male",66,43,36,3,0,3,0,0,0
1477297,19,20,1994,5,"male",341,53,45,55,0,16,0,39,0
1477299,50,26,1963,5,"male",436,2,2,0,0,0,0,0,0
1477321,93,20,1920,6,"male",809,232,60,2499,1803,2101,1256,398,547
1477355,40,27,1973,11,"male",478,115,85,78,145,78,135,0,10
1477397,32,2,1981,10,"male",174,90,75,0,1,0,0,0,1
1477421,23,9,1990,6,"male",687,230,144,4,4,4,3,0,1
1477468,14,14,1999,6,"male",496,1,0,64,1,62,0,2,1
1477469,66,30,1947,6,"female",1500,150,82,156,120,155,64,1,56
1477490,34,2,1979,1,"male",775,112,58,8,12,8,8,0,4
1477515,26,5,1987,2,"male",512,167,129,1,1,1,0,0,1
1477516,19,1,1994,1,"female",219,30,24,269,241,266,158,3,83
1477571,18,1,1995,1,"female",872,653,159,57,95,57,81,0,14
1477585,24,15,1989,11,"male",356,12,0,0,0,0,0,0,0
1477640,68,16,1945,1,"male",1448,884,613,1,27,1,13,0,14
1477669,65,20,1948,11,"female",1077,242,152,344,46,0,9,344,37
1477675,54,6,1959,8,"male",272,160,27,2,6,2,5,0,1
1477681,54,20,1959,4,"female",50,0,0,0,0,0,0,0,0
1477715,19,1,1994,4,"male",97,98,89,22,0,22,0,0,0
1477732,33,14,1980,6,"male",327,30,16,0,4,0,4,0,0
1477753,28,19,1985,7,"female",615,53,40,153,135,43,122,110,13
1477754,18,21,1995,9,"female",698,228,49,8,22,8,22,0,0
1477762,46,7,1967,12,"male",352,19,15,0,0,0,0,0,0
1477875,38,1,1975,1,"male",24,5,4,1,1,1,1,0,0
1477880,108,25,1905,11,"female",962,44,27,0,0,0,0,0,0
1477881,108,1,1905,1,"male",1723,1,1,40,2,5,2,35,0
1477925,23,8,1990,9,"male",293,5,5,0,1,0,0,0,1
1477927,22,26,1991,8,"male",265,140,94,15,0,15,0,0,0
1477937,59,8,1954,2,"female",249,39,22,1,3,0,1,1,2
1477940,49,1,1964,2,"male",589,28,15,35,1,35,0,0,1
1477945,25,8,1988,5,"female",1161,17,11,0,9,0,3,0,6
1477954,112,5,1901,5,"female",1685,259,75,192,185,107,123,85,62
1477965,51,12,1962,10,"female",479,57,35,22,19,22,14,0,5
1478060,38,14,1975,6,"female",395,152,67,9,3,7,2,2,1
1478071,59,26,1954,11,"female",853,36,29,7,1,6,1,1,0
1478074,107,28,1906,11,"male",1709,732,554,51,196,41,61,10,135
1478088,55,28,1958,11,"female",462,147,144,328,21,209,9,119,12
1478089,66,2,1947,5,"male",300,27,15,52,7,0,3,52,4
1478101,25,6,1988,12,"male",252,169,166,3,0,3,0,0,0
1478128,79,5,1934,8,"female",784,152,105,423,101,0,11,423,90
1478129,23,5,1990,8,"male",309,39,18,0,0,0,0,0,0
1478138,26,31,1987,5,"female",119,156,119,3922,4103,1732,2979,2190,1124
1478142,25,21,1988,2,"female",441,1002,830,379,241,376,214,3,27
1478147,18,5,1995,2,"female",77,84,36,123,43,123,33,0,10
1478171,64,24,1949,10,"female",359,110,63,0,1,0,0,0,1
1478172,44,18,1969,4,"male",71,26,23,67,57,67,51,0,6
1478190,15,5,1998,1,"male",286,52,35,0,1,0,1,0,0
1478191,20,20,1993,2,"female",306,729,370,109,849,109,705,0,144
1478212,21,2,1992,8,"male",410,150,94,76,221,9,159,67,62
1478246,78,27,1935,5,"female",817,43,19,3,8,0,2,3,6
1478275,36,19,1977,2,"male",636,14,10,0,0,0,0,0,0
1478279,23,1,1990,1,"male",33,39,35,6,4,6,3,0,1
1478280,29,6,1984,2,"male",227,148,31,5,16,5,15,0,1
1478288,18,8,1995,8,"male",532,75,32,1,0,1,0,0,0
1478299,18,25,1995,2,"female",162,56,30,3,4,3,4,0,0
1478304,20,9,1993,9,"female",298,16,14,0,6,0,3,0,3
1478314,15,3,1998,11,"male",77,278,247,270,266,90,145,180,121
1478317,17,16,1996,6,"female",133,233,86,21,45,21,41,0,4
1478355,113,29,1900,8,"female",1781,168,63,6,11,6,3,0,8
1478358,18,8,1995,8,"male",264,24,4,0,0,0,0,0,0
1478361,43,1,1970,7,"male",118,33,21,172,28,172,27,0,1
1478368,20,22,1993,8,"female",592,465,118,7,661,7,588,0,73
1478380,30,16,1983,10,"male",604,111,64,105,9,105,5,0,4
1478384,104,29,1909,4,"male",225,19,6,0,0,0,0,0,0
1478416,25,1,1988,1,"female",11,48,31,84,138,84,128,0,10
1478425,52,26,1961,1,"female",428,16,13,38,1,17,1,21,0
1478459,18,2,1995,3,"male",768,153,109,8,17,0,9,8,8
1478470,32,7,1981,3,"male",1588,147,66,227,369,201,259,26,110
1478489,22,15,1991,7,"male",217,39,16,1,26,1,12,0,14
1478514,15,1,1998,3,"male",378,169,106,33,35,22,27,11,8
1478516,18,10,1995,8,"female",475,1706,665,2642,6140,2473,3363,169,2777
1478525,36,14,1977,5,"female",195,119,91,383,433,383,265,0,168
1478527,29,7,1984,4,"male",183,10,9,22,1,22,1,0,0
1478532,24,29,1989,8,"male",154,17,15,42,28,42,20,0,8
1478554,30,7,1983,3,"male",279,105,75,622,902,135,251,487,651
1478571,24,3,1989,12,"male",508,51,34,17,7,17,5,0,2
1478603,44,14,1969,5,"female",605,74,61,13,17,9,9,4,8
1478605,21,13,1992,10,"male",480,0,0,0,0,0,0,0,0
1478606,50,10,1963,9,"male",375,37,25,1,0,1,0,0,0
1478655,25,4,1988,3,"female",631,324,228,993,628,29,251,964,377
1478670,20,3,1993,4,"male",361,95,33,34,73,12,69,22,4
1478682,48,16,1965,4,"male",366,37,27,2,13,0,5,2,8
1478719,52,15,1961,10,"female",90,20,16,193,42,193,23,0,19
1478723,23,26,1990,3,"female",236,120,94,474,11,399,10,75,1
1478731,21,1,1992,1,"male",297,29,27,63,10,63,8,0,2
1478744,14,10,1999,6,"female",118,1036,483,392,1166,376,939,16,227
1478801,28,13,1985,9,"female",1222,233,127,219,365,179,144,40,221
1478834,20,17,1993,12,"female",526,220,86,28,18,0,10,28,8
1478847,36,26,1977,1,"male",142,376,332,14,7,14,5,0,2
1478856,29,14,1984,6,"male",1109,123,82,4,143,4,136,0,7
1478888,108,1,1905,1,"female",1109,456,113,28,52,0,14,28,38
1478889,16,14,1997,11,"male",632,1536,1004,304,877,262,793,42,84
1478893,103,27,1910,9,"female",972,436,236,85,58,85,43,0,15
1478905,45,30,1968,7,"female",422,11,3,31,10,20,3,11,7
1478913,33,1,1980,1,"male",456,18,3,0,0,0,0,0,0
1478920,55,18,1958,6,"male",664,75,40,0,1,0,1,0,0
1478921,39,28,1974,4,"male",533,24,10,4,0,4,0,0,0
1478924,25,1,1988,1,"male",489,365,307,2,12,2,4,0,8
1478942,50,16,1963,10,"male",1696,94,65,31,8,0,2,31,6
1478962,19,24,1994,8,"female",813,713,350,152,95,102,55,50,40
1478965,110,10,1903,7,"male",2015,160,66,83,104,81,66,2,38
1479020,103,5,1910,5,"male",567,231,175,1,0,1,0,0,0
1479036,21,26,1992,3,"female",843,25,5,0,0,0,0,0,0
1479040,22,1,1991,2,"female",154,46,19,22,20,11,9,11,11
1479047,19,14,1994,3,"male",793,140,104,0,10,0,1,0,9
1479048,29,28,1984,8,"male",274,76,39,36,95,36,56,0,39
1479058,47,14,1966,12,"female",988,56,30,4,7,4,7,0,0
1479067,32,9,1981,6,"male",571,680,408,108,208,96,102,12,106
1479075,22,9,1991,2,"female",174,132,61,85,95,85,78,0,17
1479100,18,20,1995,8,"male",705,392,174,56,134,53,102,3,32
1479122,30,29,1983,9,"male",214,49,32,22,20,1,5,21,15
1479198,14,2,1999,5,"female",111,29,25,0,0,0,0,0,0
1479295,13,27,2000,3,"female",70,472,278,1822,797,1101,248,721,549
1479308,52,4,1961,9,"male",316,95,92,188,94,188,82,0,12
1479326,60,11,1953,5,"male",1255,71,25,29,114,28,78,1,36
1479371,35,29,1978,1,"female",408,79,28,107,31,65,18,42,13
1479383,67,15,1946,7,"male",1590,126,79,2,18,0,2,2,16
1479399,16,18,1997,7,"female",426,411,226,1047,211,1047,185,0,26
1479425,32,19,1981,2,"male",295,88,49,49,3,49,3,0,0
1479458,33,27,1980,7,"female",187,60,27,116,38,31,8,85,30
1479477,19,7,1994,1,"male",524,201,128,5,0,5,0,0,0
1479484,44,23,1969,7,"male",58,58,53,1,32,1,25,0,7
1479519,25,8,1988,12,"male",590,46,11,3,0,0,0,3,0
1479576,108,7,1905,8,"female",227,8,3,0,0,0,0,0,0
1479588,31,1,1982,7,"male",822,148,74,0,8,0,7,0,1
1479615,19,1,1994,4,"male",445,104,67,7,2,7,2,0,0
1479661,27,20,1986,6,"male",460,30,20,0,0,0,0,0,0
1479662,32,23,1981,12,"female",406,188,41,469,474,469,306,0,168
1479676,17,13,1996,9,"male",48,11,6,5,8,5,1,0,7
1479678,68,2,1945,5,"male",996,49,27,195,5,106,4,89,1
1479685,19,15,1994,3,"male",264,509,196,32,15,11,15,21,0
1479692,45,8,1968,5,"male",1817,15,3,3,0,3,0,0,0
1479725,25,26,1988,7,"male",51,0,0,0,0,0,0,0,0
1479743,68,21,1945,9,"male",999,2447,432,260,414,260,387,0,27
1479758,14,25,1999,6,"male",391,124,73,1,0,1,0,0,0
1479777,15,15,1998,1,"female",882,3407,627,364,1213,285,686,79,527
1479782,85,29,1928,7,"male",1537,30,2,48,5,0,3,48,2
1479804,64,10,1949,6,"male",1942,267,171,94,97,93,61,1,36
1479810,31,12,1982,12,"male",228,22,10,3,0,3,0,0,0
1479812,70,10,1943,3,"male",1460,43,18,0,1,0,1,0,0
1479829,36,27,1977,11,"male",60,9,6,0,0,0,0,0,0
1479857,19,20,1994,4,"male",466,94,86,0,1,0,1,0,0
1479860,36,4,1977,7,"male",559,33,12,0,1,0,0,0,1
1479865,23,8,1990,7,"male",739,283,171,239,284,239,215,0,69
1479893,20,30,1993,7,"female",111,540,499,59,136,16,28,43,108
1479895,38,15,1975,6,"male",607,53,17,2,0,2,0,0,0
1479901,21,1,1992,1,"female",83,48,43,2,2,2,2,0,0
1479908,19,22,1994,6,"male",1342,1451,1160,22,79,6,22,16,57
1479941,39,21,1974,12,"male",52,5,3,38,7,38,7,0,0
1479971,14,14,1999,9,"male",348,172,107,28,1,0,0,28,1
1479984,57,30,1956,8,"male",1111,55,34,11,0,11,0,0,0
1479994,17,27,1996,10,"female",251,42,13,6,14,6,3,0,11
1479996,23,14,1990,5,"female",83,3423,168,77,5120,77,4049,0,1071
1480021,29,16,1984,6,"male",631,721,684,90,16,0,14,90,2
1480082,64,25,1949,1,"male",1296,204,143,63,69,51,26,12,43
1480096,23,25,1990,12,"male",111,46,37,1,0,1,0,0,0
1480124,56,10,1957,11,"female",715,111,67,99,16,0,3,99,13
1480128,25,1,1988,1,"male",446,17,14,0,0,0,0,0,0
1480129,20,29,1993,6,"female",855,1080,716,567,636,186,307,381,329
1480149,18,12,1995,10,"female",36,63,29,60,37,60,23,0,14
1480164,22,1,1991,1,"male",1025,257,116,0,3,0,3,0,0
1480176,51,4,1962,12,"female",55,12,10,15,0,0,0,15,0
1480187,18,17,1995,9,"male",314,85,21,1,10,1,7,0,3
1480190,26,1,1987,1,"female",336,1,1,1,0,0,0,1,0
1480217,24,8,1989,1,"male",684,244,87,3,31,3,24,0,7
1480243,19,9,1994,6,"male",526,94,75,7,13,3,4,4,9
1480308,19,5,1994,7,"female",130,96,26,0,0,0,0,0,0
1480318,45,31,1968,8,"male",99,40,5,27,46,27,45,0,1
1480327,14,21,1999,8,"female",296,403,310,619,266,94,56,525,210
1480335,25,17,1988,7,"male",669,68,44,1,0,1,0,0,0
1480336,45,14,1968,2,"female",1303,132,94,174,38,3,14,171,24
1480350,15,22,1998,3,"female",610,188,117,146,94,143,79,3,15
1480359,25,7,1988,9,"male",125,18,18,0,0,0,0,0,0
1480374,57,12,1956,2,"male",1742,122,72,25,15,1,10,24,5
1480383,25,28,1988,6,"male",294,719,597,3,62,3,57,0,5
1480389,59,31,1954,12,"female",74,29,26,114,2,88,2,26,0
1480394,32,12,1981,3,"female",452,452,201,346,894,346,585,0,309
1480395,62,18,1951,9,"female",26,16,11,3,10,3,8,0,2
1480430,20,3,1993,3,"male",526,224,214,11,5,11,5,0,0
1480450,25,18,1988,8,"female",548,0,0,0,0,0,0,0,0
1480592,41,28,1972,7,"female",864,104,30,55,76,54,63,1,13
1480607,44,23,1969,5,"female",276,48,34,73,10,70,4,3,6
1480617,59,17,1954,4,"male",1090,14,8,4,0,0,0,4,0
1480618,18,4,1995,5,"female",234,100,68,2,1,2,1,0,0
1480633,77,25,1936,9,"female",860,60,40,100,12,0,1,100,11
1480634,31,16,1982,11,"male",339,98,87,150,30,150,7,0,23
1480635,28,22,1985,12,"male",546,16,13,0,0,0,0,0,0
1480672,32,15,1981,3,"male",181,53,38,0,0,0,0,0,0
1480673,69,30,1944,7,"female",1691,111,33,5,3,0,0,5,3
1480674,14,9,1999,10,"male",213,53,41,0,0,0,0,0,0
1480686,17,2,1996,3,"male",243,65,44,10,2,10,2,0,0
1480687,22,14,1991,2,"female",319,18,12,0,0,0,0,0,0
1480695,52,26,1961,8,"female",638,5,1,0,0,0,0,0,0
1480700,25,12,1988,1,"male",387,65,54,16,6,16,3,0,3
1480724,23,3,1990,12,"male",237,39,26,0,2,0,0,0,2
1480731,49,23,1964,6,"male",422,115,82,352,71,0,26,352,45
1480748,21,25,1992,5,"female",598,316,145,285,299,258,206,27,93
1480759,103,5,1910,3,"male",296,18,10,5,0,0,0,5,0
1480774,15,1,1998,1,"male",128,105,88,0,9,0,3,0,6
1480782,25,23,1988,9,"male",360,66,48,1,0,0,0,1,0
1480819,20,15,1993,10,"male",382,0,0,0,0,0,0,0,0
1480833,19,17,1994,8,"female",286,55,23,3,4,3,4,0,0
1480838,20,23,1993,4,"female",63,13,5,98,2,98,0,0,2
1480844,21,10,1992,9,"male",382,212,149,2,0,2,0,0,0
1480861,24,10,1989,7,"male",1411,1632,1012,65,131,65,99,0,32
1480874,31,3,1982,1,"male",474,278,8,0,0,0,0,0,0
1480908,16,17,1997,12,"male",746,152,90,13,0,13,0,0,0
1480909,62,15,1951,3,"female",672,78,41,0,0,0,0,0,0
1480953,14,11,1999,11,"male",20,36,16,1,4,1,4,0,0
1480959,50,24,1963,9,"male",190,31,23,18,32,18,18,0,14
1480972,18,11,1995,1,"male",75,527,62,4,20,4,7,0,13
1480979,20,13,1993,11,"female",1128,136,98,0,6,0,6,0,0
1480993,43,27,1970,2,"male",221,21,6,10,3,0,1,10,2
1480994,19,1,1994,3,"male",23,0,0,0,0,0,0,0,0
1481005,100,13,1913,11,"male",2039,374,280,25,29,23,24,2,5
1481008,15,19,1998,9,"male",1,29,14,1,0,1,0,0,0
1481073,108,13,1905,9,"female",1865,139,95,251,184,214,112,37,72
1481100,18,11,1995,1,"female",666,1070,261,27,29,27,27,0,2
1481104,30,15,1983,9,"female",892,232,137,88,84,26,56,62,28
1481108,29,8,1984,3,"male",307,93,46,252,156,228,27,24,129
1481112,17,31,1996,5,"male",194,1526,964,626,1229,6,984,620,245
1481139,28,28,1985,8,"male",324,31,11,0,1,0,1,0,0
1481149,38,28,1975,11,"female",428,53,19,41,6,10,2,31,4
1481167,15,18,1998,4,"male",184,182,165,2,8,2,3,0,5
1481190,103,28,1910,11,"male",1101,129,110,0,17,0,15,0,2
1481208,56,25,1957,5,"male",738,5,0,0,0,0,0,0,0
1481233,52,11,1961,8,"male",175,13,11,2,0,2,0,0,0
1481242,108,29,1905,5,"female",1041,135,44,1,0,0,0,1,0
1481303,47,15,1966,3,"female",953,10,6,2,1,0,0,2,1
1481317,20,21,1993,8,"male",645,1519,1129,46,69,46,54,0,15
1481334,19,23,1994,4,"female",342,316,219,1378,810,1193,601,185,209
1481336,21,3,1992,2,"female",439,46,19,378,145,378,83,0,62
1481379,21,24,1992,4,"male",619,131,86,199,203,87,52,112,151
1481411,24,31,1989,12,"female",411,7,4,0,0,0,0,0,0
1481422,62,24,1951,11,"male",2291,80,48,44,40,31,20,13,20
1481459,19,11,1994,2,"male",239,17,4,0,1,0,1,0,0
1481471,62,2,1951,3,"male",424,37,20,38,2,15,0,23,2
1481481,87,6,1926,9,"male",1793,479,249,82,57,82,44,0,13
1481482,57,27,1956,9,"male",1009,71,47,19,2,19,2,0,0
1481501,19,13,1994,1,"female",481,16,6,1,0,0,0,1,0
1481505,24,1,1989,7,"male",336,237,184,1,0,1,0,0,0
1481513,23,27,1990,8,"female",710,312,224,86,581,86,517,0,64
1481520,32,26,1981,6,"male",553,55,16,26,58,14,21,12,37
1481535,38,5,1975,7,"female",169,6,2,2,0,2,0,0,0
1481553,108,10,1905,6,"female",1035,48,26,9,15,0,5,9,10
1481640,36,11,1977,7,"male",136,44,28,173,100,58,82,115,18
1481658,42,15,1971,7,"female",381,13,12,54,1,54,0,0,1
1481663,58,6,1955,2,"male",15,18,13,9,18,9,16,0,2
1481688,98,8,1915,4,"female",1648,102,68,20,15,0,4,20,11
1481703,21,6,1992,8,"female",1659,643,384,2870,2408,2220,2031,650,377
1481729,25,15,1988,6,"male",341,208,116,46,15,19,3,27,12
1481769,44,25,1969,12,"female",511,236,140,389,286,389,205,0,81
1481790,23,12,1990,12,"male",358,56,47,98,7,60,1,38,6
1481798,23,24,1990,6,"male",140,24,11,27,35,25,30,2,5
1481834,63,21,1950,4,"female",419,22,17,437,240,0,128,437,112
1481863,25,2,1988,6,"male",506,315,249,283,172,53,127,230,45
1481876,39,12,1974,11,"male",394,15,13,20,14,20,6,0,8
1481877,17,15,1996,10,"male",388,29,17,0,0,0,0,0,0
1481885,108,30,1905,1,"male",1342,236,153,4,3,0,0,4,3
1481921,20,24,1993,8,"female",434,0,0,0,0,0,0,0,0
1481923,26,17,1987,10,"male",193,101,84,31,11,31,10,0,1
1481940,19,4,1994,3,"male",358,271,209,62,41,58,38,4,3
1481947,19,20,1994,6,"male",125,285,231,14,2,14,1,0,1
1481962,32,14,1981,10,"male",123,117,68,70,35,70,29,0,6
1481975,28,20,1985,4,"male",421,33,20,1,1,1,0,0,1
1481987,37,15,1976,12,"male",412,131,102,275,14,275,11,0,3
1481995,26,1,1987,1,"female",391,349,133,0,0,0,0,0,0
1482009,28,23,1985,11,"female",87,28,21,0,0,0,0,0,0
1482037,60,17,1953,2,"female",1593,130,73,68,133,10,26,58,107
1482041,21,24,1992,11,"male",887,469,265,5,38,5,24,0,14
1482048,25,24,1988,10,"male",495,1,1,0,1,0,0,0,1
1482064,21,8,1992,12,"male",1657,224,120,25,25,4,8,21,17
1482065,43,17,1970,7,"male",325,1,0,50,2,0,0,50,2
1482109,53,21,1960,9,"female",810,80,47,782,17,426,4,356,13
1482111,45,29,1968,10,"female",260,139,105,210,217,210,118,0,99
1482113,20,1,1993,8,"male",529,500,284,10,125,0,40,10,85
1482135,19,5,1994,11,"male",263,31,11,4,1,4,1,0,0
1482156,52,25,1961,9,"female",1419,40,30,248,142,248,74,0,68
1482167,25,31,1988,12,"male",150,52,42,114,142,114,122,0,20
1482200,22,5,1991,5,"male",503,164,77,11,0,11,0,0,0
1482202,26,6,1987,12,"male",645,61,34,2,0,2,0,0,0
1482211,15,18,1998,11,"female",237,914,510,1438,2274,891,1445,547,829
1482251,75,24,1938,7,"female",494,30,11,1,0,1,0,0,0
1482299,16,11,1997,1,"male",536,50,28,0,0,0,0,0,0
1482302,23,3,1990,3,"male",451,88,75,1,0,1,0,0,0
1482304,20,2,1993,4,"female",724,471,257,21,62,8,23,13,39
1482319,44,1,1969,6,"male",450,232,88,31,291,9,179,22,112
1482331,30,18,1983,9,"male",153,48,39,3,0,3,0,0,0
1482349,33,1,1980,11,"male",208,45,39,11,0,11,0,0,0
1482353,57,6,1956,8,"female",1041,71,45,2,2,0,0,2,2
1482359,19,13,1994,5,"female",342,831,356,5,0,5,0,0,0
1482388,18,1,1995,7,"male",448,515,450,0,0,0,0,0,0
1482396,25,22,1988,7,"female",81,332,145,2202,1102,2039,676,163,426
1482418,25,15,1988,4,"male",31,16,12,16,6,16,6,0,0
1482419,17,8,1996,10,"male",743,378,134,10,5,10,3,0,2
1482424,18,9,1995,6,"female",337,349,296,45,19,15,12,30,7
1482477,17,22,1996,8,"female",1408,586,347,288,282,205,166,83,116
1482503,20,19,1993,12,"female",557,65,48,0,0,0,0,0,0
1482509,33,20,1980,1,"female",552,46,27,138,122,137,76,1,46
1482511,19,26,1994,7,"male",432,8,4,1,0,0,0,1,0
1482523,26,1,1987,1,"female",358,105,61,15,2,15,1,0,1
1482542,22,19,1991,11,"male",286,156,126,3,25,3,9,0,16
1482562,14,17,1999,2,"male",620,140,56,7,6,0,3,7,3
1482572,31,29,1982,12,"male",295,1,1,0,0,0,0,0,0
1482584,68,18,1945,3,"female",72,112,68,458,240,458,222,0,18
1482640,17,14,1996,4,"male",409,210,62,19,46,0,14,19,32
1482665,42,20,1971,6,"male",226,24,18,1,1,1,1,0,0
1482666,70,10,1943,1,"male",140,45,22,1,1,1,1,0,0
1482706,59,6,1954,6,"male",685,111,88,41,11,41,10,0,1
1482709,19,13,1994,3,"male",495,12,11,0,0,0,0,0,0
1482747,48,1,1965,1,"male",816,43,10,3,0,3,0,0,0
1482756,22,20,1991,12,"male",148,100,83,0,9,0,7,0,2
1482783,61,13,1952,10,"female",2329,843,213,949,640,943,425,6,215
1482795,23,24,1990,11,"male",379,360,316,5,0,0,0,5,0
1482801,100,3,1913,9,"female",390,173,123,366,333,358,235,8,98
1482812,21,1,1992,10,"female",506,580,83,6,12,6,5,0,7
1482850,51,23,1962,5,"female",183,21,8,0,5,0,1,0,4
1482859,23,8,1990,6,"male",611,444,323,97,48,97,33,0,15
1482872,35,23,1978,5,"female",464,89,54,171,9,130,3,41,6
1482876,32,6,1981,6,"female",365,66,54,0,23,0,4,0,19
1482883,20,11,1993,7,"male",92,48,28,13,0,13,0,0,0
1482897,78,8,1935,2,"male",346,25,19,20,2,0,1,20,1
1482907,70,8,1943,4,"female",1440,100,27,6,0,6,0,0,0
1482941,53,23,1960,4,"male",1300,78,37,17,30,17,19,0,11
1482949,29,9,1984,9,"male",39,123,114,9,49,0,36,9,13
1482954,15,8,1998,8,"male",330,143,113,48,0,48,0,0,0
1482956,25,10,1988,5,"female",810,376,202,164,196,110,140,54,56
1482965,68,17,1945,8,"male",111,21,14,0,0,0,0,0,0
1482984,22,24,1991,12,"female",455,356,238,139,73,0,26,139,47
1482987,15,6,1998,8,"male",72,24,18,0,4,0,1,0,3
1482989,54,25,1959,2,"male",687,28,24,105,4,0,3,105,1
1483000,15,1,1998,2,"male",499,46,32,16,4,0,2,16,2
1483003,36,9,1977,8,"female",1532,249,150,445,190,443,122,2,68
1483005,18,24,1995,1,"male",260,99,75,30,0,30,0,0,0
1483006,108,30,1905,12,"male",1124,1199,806,144,214,49,71,95,143
1483024,59,8,1954,4,"female",177,9,7,2,3,2,3,0,0
1483026,19,24,1994,1,"female",447,360,142,221,197,144,166,77,31
1483033,29,13,1984,12,"male",582,173,161,22,2,22,0,0,2
1483036,22,20,1991,9,"male",771,1,1,0,0,0,0,0,0
1483051,23,11,1990,10,"male",330,21,10,2,0,0,0,2,0
1483059,29,26,1984,6,"male",450,51,46,5,66,5,50,0,16
1483084,59,13,1954,12,"male",1088,26,6,16,55,0,45,16,10
1483085,16,5,1997,7,"male",329,231,179,1,0,0,0,1,0
1483121,63,8,1950,3,"male",65,5,3,0,0,0,0,0,0
1483131,16,31,1997,7,"female",272,413,84,27,144,27,126,0,18
1483139,22,6,1991,6,"male",1737,236,166,51,65,51,55,0,10
1483152,24,14,1989,3,"male",381,51,44,0,0,0,0,0,0
1483162,27,5,1986,11,"female",302,120,93,187,43,116,33,71,10
1483192,19,19,1994,2,"female",633,136,89,42,0,42,0,0,0
1483210,32,10,1981,12,"male",153,1,1,0,0,0,0,0,0
1483221,33,15,1980,7,"male",154,16,9,0,0,0,0,0,0
1483227,23,8,1990,10,"male",175,226,162,119,14,47,5,72,9
1483267,24,20,1989,2,"male",154,36,28,33,32,33,18,0,14
1483272,46,21,1967,6,"female",349,91,52,0,0,0,0,0,0
1483278,47,9,1966,2,"male",483,95,31,753,183,211,144,542,39
1483304,20,13,1993,10,"male",409,29,24,0,0,0,0,0,0
1483320,18,8,1995,11,"female",78,264,126,328,668,287,260,41,408
1483367,35,7,1978,3,"female",62,19,18,45,35,11,6,34,29
1483391,22,4,1991,2,"male",533,552,182,180,198,171,79,9,119
1483435,39,22,1974,3,"male",288,7,6,0,0,0,0,0,0
1483465,20,7,1993,7,"male",578,161,129,2,96,0,66,2,30
1483494,108,17,1905,10,"male",1766,620,171,23,42,10,22,13,20
1483509,21,14,1992,7,"female",317,24,17,191,26,0,3,191,23
1483542,20,9,1993,1,"male",1047,140,96,26,52,22,21,4,31
1483545,35,26,1978,5,"male",135,6,6,0,0,0,0,0,0
1483559,73,1,1940,1,"male",1848,94,25,38,24,0,6,38,18
1483566,52,4,1961,3,"male",81,19,13,0,2,0,2,0,0
1483573,20,22,1993,1,"male",81,49,42,168,55,168,41,0,14
1483600,49,31,1964,10,"female",197,398,291,366,190,16,63,350,127
1483603,14,14,1999,8,"female",375,196,134,54,54,54,54,0,0
1483626,24,15,1989,3,"male",15,13,13,0,0,0,0,0,0
1483630,16,7,1997,9,"female",326,114,67,960,912,288,152,672,760
1483646,21,25,1992,9,"male",598,57,9,1,1,0,1,1,0
1483680,23,14,1990,2,"male",26,89,64,2434,415,2434,243,0,172
1483702,61,15,1952,9,"male",71,6,4,0,0,0,0,0,0
1483712,16,29,1997,1,"male",118,18,16,2,6,0,1,2,5
1483715,32,21,1981,8,"male",1150,18,6,2,0,2,0,0,0
1483749,21,5,1992,11,"male",382,309,263,6,5,6,3,0,2
1483761,33,20,1980,1,"male",668,15,10,0,0,0,0,0,0
1483777,25,18,1988,6,"female",453,31,26,10,1,7,1,3,0
1483856,88,11,1925,11,"female",1005,100,58,0,0,0,0,0,0
1483870,19,26,1994,6,"male",641,664,350,247,443,82,135,165,308
1483878,31,9,1982,7,"male",1157,30,16,1,0,0,0,1,0
1483880,17,26,1996,8,"male",444,161,134,51,97,12,8,39,89
1483886,16,30,1997,4,"male",430,202,80,173,89,173,79,0,10
1483891,34,7,1979,9,"male",2165,421,66,44,29,44,24,0,5
1483907,20,1,1993,1,"male",244,491,468,0,0,0,0,0,0
1483926,71,30,1942,4,"male",303,51,42,4,1,0,0,4,1
1483940,32,23,1981,5,"male",360,40,15,6,13,6,10,0,3
1483961,26,30,1987,7,"male",830,24,19,108,48,103,43,5,5
1483983,22,1,1991,8,"male",203,37,24,28,2,28,1,0,1
1483984,42,18,1971,5,"male",564,7,6,1,0,1,0,0,0
1483991,19,6,1994,8,"male",432,4,0,0,0,0,0,0,0
1483996,74,16,1939,1,"female",2011,32,20,0,0,0,0,0,0
1484024,13,24,2000,5,"male",439,342,228,1,1,0,1,1,0
1484045,65,14,1948,10,"female",1188,167,125,16,28,0,9,16,19
1484062,23,2,1990,5,"female",404,195,125,97,53,46,27,51,26
1484072,108,1,1905,1,"male",1373,25,11,9,2,3,0,6,2
1484099,27,19,1986,6,"female",202,0,0,0,0,0,0,0,0
1484103,52,1,1961,12,"male",293,18,8,3,0,3,0,0,0
1484123,18,22,1995,4,"female",336,254,224,93,113,46,87,47,26
1484126,70,20,1943,4,"male",578,9,9,2972,98,0,25,2972,73
1484129,39,30,1974,1,"female",143,17,14,9,5,0,1,9,4
1484170,22,25,1991,10,"female",963,264,87,38,54,38,49,0,5
1484176,23,1,1990,1,"male",1417,272,106,28,18,28,14,0,4
1484193,27,22,1986,5,"female",1470,36,22,0,1,0,0,0,1
1484262,45,3,1968,12,"male",2056,167,120,3,5,3,3,0,2
1484293,30,1,1983,5,"male",587,177,115,1,0,1,0,0,0
1484333,39,18,1974,10,"female",287,8,7,8,6,8,5,0,1
1484336,86,25,1927,8,"male",1354,243,109,116,18,61,6,55,12
1484337,23,2,1990,2,"male",62,53,41,498,99,498,90,0,9
1484348,22,24,1991,7,"female",140,29,20,14,20,14,10,0,10
1484351,16,24,1997,11,"male",427,415,323,21,48,21,41,0,7
1484388,33,29,1980,9,"female",237,35,27,0,1,0,1,0,0
1484402,23,23,1990,11,"female",536,42,17,0,0,0,0,0,0
1484419,32,1,1981,7,"male",665,45,14,4,16,4,16,0,0
1484436,47,16,1966,2,"male",314,13,13,0,3,0,2,0,1
1484439,23,20,1990,4,"male",1097,191,137,146,33,133,30,13,3
1484487,67,15,1946,7,"female",312,32,23,23,4,23,2,0,2
1484488,24,16,1989,5,"male",870,183,145,0,2,0,2,0,0
1484497,35,30,1978,10,"female",389,380,256,959,990,414,358,545,632
1484498,18,8,1995,3,"female",390,270,25,14,14,10,10,4,4
1484505,16,3,1997,10,"male",849,37,22,0,0,0,0,0,0
1484519,22,15,1991,1,"male",1093,34,25,0,1,0,1,0,0
1484538,22,18,1991,8,"female",415,149,126,1,8,1,4,0,4
1484544,47,8,1966,9,"male",217,13,11,1,6,1,3,0,3
1484547,21,5,1992,5,"male",280,263,108,29,0,1,0,28,0
1484548,54,2,1959,5,"female",1405,291,99,44,331,44,216,0,115
1484575,29,15,1984,12,"male",351,73,49,19,0,0,0,19,0
1484577,46,24,1967,4,"female",217,53,45,291,167,5,73,286,94
1484585,20,13,1993,12,"male",688,1617,1509,1,8,1,5,0,3
1484599,19,9,1994,5,"male",138,115,94,13,30,13,26,0,4
1484635,40,22,1973,7,"female",1652,421,270,289,247,272,167,17,80
1484636,34,8,1979,2,"male",390,9,9,0,0,0,0,0,0
1484659,53,30,1960,3,"male",1285,486,347,357,262,357,204,0,58
1484667,16,27,1997,2,"male",614,51,33,0,1,0,0,0,1
1484668,22,27,1991,9,"female",271,398,287,181,596,85,224,96,372
1484669,13,15,2000,1,"male",580,229,84,49,2,0,0,49,2
1484681,103,28,1910,3,"female",1257,507,140,40,5,7,3,33,2
1484684,23,14,1990,5,"male",351,177,142,252,61,252,61,0,0
1484708,20,10,1993,12,"female",395,206,110,6,13,2,6,4,7
1484711,19,15,1994,7,"male",417,253,145,62,70,46,32,16,38
1484720,32,28,1981,11,"female",1093,84,21,1,10,1,4,0,6
1484740,54,11,1959,4,"female",207,13,4,4,1,0,0,4,1
1484741,20,23,1993,11,"male",244,344,283,665,281,644,101,21,180
1484764,27,19,1986,2,"male",1082,134,72,0,0,0,0,0,0
1484766,18,12,1995,4,"male",10,34,26,20,35,20,35,0,0
1484800,24,12,1989,3,"female",281,1062,277,108,120,108,113,0,7
1484807,46,28,1967,2,"male",619,34,26,52,66,0,5,52,61
1484810,33,20,1980,1,"male",809,2,2,2,1,2,1,0,0
1484831,68,15,1945,4,"female",5,0,0,0,0,0,0,0,0
1484837,50,12,1963,3,"female",373,32,28,2,1,2,0,0,1
1484839,15,21,1998,2,"male",557,640,387,304,34,3,5,301,29
1484841,68,30,1945,4,"male",1235,51,36,67,95,38,50,29,45
1484853,32,29,1981,9,"male",397,81,41,9,0,4,0,5,0
1484864,17,31,1996,8,"male",1090,275,73,30,26,13,15,17,11
1484868,18,12,1995,10,"male",198,87,68,2,2,2,2,0,0
1484870,34,8,1979,7,"male",100,40,29,1,4,1,0,0,4
1484897,66,3,1947,8,"male",1743,34,26,1,0,1,0,0,0
1484933,55,6,1958,9,"female",696,61,27,701,134,0,103,701,31
1484952,22,25,1991,2,"male",643,221,167,20,8,20,6,0,2
1484956,29,31,1984,12,"male",752,115,76,13,1,13,1,0,0
1484966,24,12,1989,10,"female",571,288,151,460,373,432,223,28,150
1484972,50,25,1963,3,"male",301,3,3,0,0,0,0,0,0
1484979,16,26,1997,2,"male",626,3,2,1,0,1,0,0,0
1485046,48,21,1965,11,"female",1284,32,19,8,12,8,10,0,2
1485075,16,12,1997,9,"male",10,207,173,51,58,51,47,0,11
1485093,21,25,1992,6,"male",833,41,19,5,1,0,0,5,1
1485096,34,3,1979,8,"female",66,15,13,13,8,13,6,0,2
1485131,65,23,1948,9,"female",1628,24,10,26,12,26,9,0,3
1485152,50,24,1963,12,"male",783,498,202,401,257,401,147,0,110
1485160,15,10,1998,5,"male",392,1299,1123,0,18,0,8,0,10
1485181,25,26,1988,6,"female",646,58,39,2,0,2,0,0,0
1485182,46,11,1967,8,"female",701,405,260,232,212,218,173,14,39
1485188,57,17,1956,3,"female",246,269,100,287,84,87,31,200,53
1485191,21,25,1992,5,"male",449,182,143,14,4,14,4,0,0
1485199,23,18,1990,8,"male",345,55,39,254,4,185,0,69,4
1485205,32,27,1981,3,"male",604,493,292,57,45,57,40,0,5
1485231,23,14,1990,11,"male",464,172,133,136,195,125,171,11,24
1485246,39,21,1974,10,"female",112,46,36,77,47,3,26,74,21
1485273,48,20,1965,2,"male",193,68,39,77,45,77,30,0,15
1485284,18,16,1995,11,"male",131,270,240,13,59,13,39,0,20
1485285,19,2,1994,11,"female",432,621,492,0,10,0,10,0,0
1485287,28,9,1985,4,"male",1418,1437,1055,69,112,4,33,65,79
1485290,54,12,1959,12,"female",726,114,70,71,55,0,4,71,51
1485305,60,14,1953,5,"male",1001,50,27,33,81,27,58,6,23
1485311,95,10,1918,4,"male",489,19,17,0,0,0,0,0,0
1485338,103,12,1910,2,"female",315,37,10,0,0,0,0,0,0
1485369,58,20,1955,5,"female",223,172,134,70,161,3,107,67,54
1485394,91,17,1922,8,"female",1911,32,4,0,1,0,0,0,1
1485435,16,13,1997,7,"female",145,130,79,81,109,19,31,62,78
1485507,25,5,1988,4,"male",60,9,8,15,0,15,0,0,0
1485538,103,15,1910,5,"female",1617,628,307,57,144,57,106,0,38
1485559,14,27,1999,9,"female",102,94,83,44,22,8,16,36,6
1485572,62,5,1951,6,"female",1372,24,11,0,1,0,0,0,1
1485581,20,10,1993,5,"female",218,204,117,55,95,55,51,0,44
1485589,53,25,1960,11,"male",496,16,12,2,2,0,0,2,2
1485630,20,5,1993,3,"male",223,108,59,149,26,143,25,6,1
1485647,21,13,1992,2,"female",952,567,321,48,107,6,91,42,16
1485672,20,7,1993,10,"male",317,255,58,0,14,0,9,0,5
1485687,52,5,1961,9,"female",741,32,14,241,26,0,11,241,15
1485688,60,1,1953,11,"female",1082,16,6,3,0,0,0,3,0
1485691,22,1,1991,6,"male",214,4,3,0,0,0,0,0,0
1485711,48,30,1965,1,"female",451,239,78,3,6,0,2,3,4
1485713,16,3,1997,9,"female",443,1225,778,1804,2083,33,528,1771,1555
1485725,16,1,1997,6,"female",445,219,153,1,0,1,0,0,0
1485727,25,25,1988,1,"female",52,19,12,12,1,12,1,0,0
1485760,38,27,1975,6,"male",507,25,23,455,44,355,13,100,31
1485762,16,25,1997,7,"male",365,50,26,0,0,0,0,0,0
1485841,21,23,1992,4,"female",297,119,44,25,6,25,5,0,1
1485847,34,11,1979,4,"female",557,73,42,390,219,390,167,0,52
1485855,34,16,1979,11,"male",511,75,22,0,54,0,6,0,48
1485859,108,18,1905,9,"male",1541,193,81,35,1,35,0,0,1
1485868,65,31,1948,3,"female",493,39,25,0,0,0,0,0,0
1485883,49,6,1964,2,"male",548,176,122,3231,1165,3205,675,26,490
1485892,98,19,1915,2,"male",773,154,114,11,0,0,0,11,0
1485915,46,20,1967,1,"female",309,7,5,7,1,7,1,0,0
1485925,30,3,1983,1,"male",536,1,1,0,0,0,0,0,0
1485936,47,24,1966,6,"female",304,480,394,52,497,52,360,0,137
1485947,33,7,1980,3,"male",192,125,109,656,90,656,45,0,45
1485962,56,9,1957,12,"male",794,5,3,13,28,0,20,13,8
1485970,19,1,1994,5,"female",821,289,113,204,291,74,137,130,154
1485986,21,5,1992,12,"male",554,94,64,0,3,0,3,0,0
1485994,57,1,1956,10,"male",1600,182,58,255,173,250,127,5,46
1486021,32,20,1981,7,"female",279,62,30,19,76,19,42,0,34
1486025,62,14,1951,4,"male",813,18,10,4,15,1,10,3,5
1486027,19,8,1994,5,"female",490,1124,851,53,36,5,26,48,10
1486050,108,1,1905,1,"male",1733,23,12,19,44,0,13,19,31
1486053,45,28,1968,3,"female",343,219,43,2,4,0,3,2,1
1486056,21,17,1992,7,"male",42,6,6,1,0,1,0,0,0
1486068,18,28,1995,6,"male",60,73,38,2,0,2,0,0,0
1486074,17,5,1996,11,"female",103,24,2,112,67,112,27,0,40
1486084,23,1,1990,1,"female",190,45,38,4,4,4,4,0,0
1486087,23,16,1990,8,"male",463,92,62,8,3,7,2,1,1
1486095,22,17,1991,6,"male",493,377,313,609,30,263,18,346,12
1486134,21,9,1992,3,"male",179,64,41,2,2,2,2,0,0
1486150,42,18,1971,10,"male",492,426,210,2611,583,2611,256,0,327
1486156,16,12,1997,1,"female",140,213,113,309,108,309,104,0,4
1486190,19,24,1994,7,"female",539,300,129,4,1,4,1,0,0
1486222,22,27,1991,7,"male",131,37,27,0,3,0,3,0,0
1486233,78,9,1935,6,"male",1146,14,11,15,0,0,0,15,0
1486240,60,16,1953,7,"male",68,80,70,7,0,0,0,7,0
1486248,21,24,1992,4,"female",1081,329,99,8,8,8,4,0,4
1486255,28,22,1985,11,"male",183,31,23,0,0,0,0,0,0
1486256,44,7,1969,5,"male",144,14,11,0,0,0,0,0,0
1486294,28,16,1985,5,"female",531,106,66,460,445,412,306,48,139
1486308,24,12,1989,5,"male",860,150,85,68,43,24,20,44,23
1486313,46,4,1967,10,"male",311,17,13,0,11,0,9,0,2
1486325,48,15,1965,9,"female",330,101,63,3,0,3,0,0,0
1486340,59,1,1954,5,"male",383,199,171,576,117,576,24,0,93
1486363,25,5,1988,7,"male",464,204,65,9,13,0,3,9,10
1486403,84,15,1929,12,"male",867,20,17,2,0,0,0,2,0
1486424,16,23,1997,8,"male",620,352,192,5,74,5,65,0,9
1486457,55,7,1958,2,"male",127,6,5,11,9,7,4,4,5
1486466,64,30,1949,3,"male",613,28,17,1,0,0,0,1,0
1486472,42,15,1971,8,"male",280,130,108,1,0,0,0,1,0
1486476,71,22,1942,8,"male",1725,97,46,40,50,23,9,17,41
1486486,23,29,1990,10,"female",1438,458,196,229,187,63,76,166,111
1486488,19,12,1994,8,"male",330,205,61,26,1,26,1,0,0
1486493,26,1,1987,1,"female",210,47,28,7,15,7,12,0,3
1486507,49,10,1964,6,"female",672,204,128,438,405,438,278,0,127
1486561,17,10,1996,5,"male",289,195,150,2,1,2,0,0,1
1486593,16,22,1997,4,"male",433,692,289,378,145,302,73,76,72
1486606,23,1,1990,1,"male",3,10,10,1,1,1,0,0,1
1486630,24,28,1989,2,"male",595,72,50,19,2,19,0,0,2
1486641,16,28,1997,2,"female",911,29,25,15,1,15,0,0,1
1486675,39,29,1974,5,"male",234,66,52,1,0,1,0,0,0
1486709,19,13,1994,4,"male",100,20,16,3,1,3,0,0,1
1486716,22,17,1991,10,"male",583,289,243,10,57,5,46,5,11
1486726,24,15,1989,6,"male",311,60,60,0,19,0,4,0,15
1486799,41,17,1972,7,"male",364,188,135,52,41,52,31,0,10
1486815,18,26,1995,8,"male",365,57,50,2,24,2,15,0,9
1486818,27,28,1986,12,"male",1726,308,134,38,32,38,25,0,7
1486846,66,22,1947,5,"male",1748,62,21,63,6,6,0,57,6
1486853,21,30,1992,1,"female",470,225,117,24,20,24,17,0,3
1486878,21,16,1992,2,"female",439,360,250,467,656,467,568,0,88
1486889,32,3,1981,11,"female",1401,446,159,186,190,100,118,86,72
1486967,18,14,1995,11,"female",550,237,190,749,208,283,67,466,141
1487000,17,1,1996,3,"male",28,13,13,1,0,1,0,0,0
1487017,67,15,1946,3,"female",789,5,4,0,0,0,0,0,0
1487048,25,1,1988,3,"male",538,2,0,0,0,0,0,0,0
1487078,20,22,1993,2,"male",100,4,1,0,0,0,0,0,0
1487156,81,14,1932,7,"female",140,10,4,1,9,1,6,0,3
1487202,26,26,1987,10,"male",373,89,72,0,2,0,0,0,2
1487219,34,16,1979,5,"male",180,10,10,0,0,0,0,0,0
1487228,15,27,1998,7,"male",375,119,58,9,1,0,0,9,1
1487229,17,16,1996,7,"female",251,259,77,0,0,0,0,0,0
1487267,40,5,1973,3,"male",125,35,35,0,0,0,0,0,0
1487295,48,22,1965,11,"male",159,12,8,20,15,20,11,0,4
1487308,64,7,1949,1,"female",549,40,17,10,18,1,2,9,16
1487309,19,1,1994,10,"female",666,1430,859,220,146,192,123,28,23
1487331,56,14,1957,8,"female",205,94,69,261,58,1,13,260,45
1487335,58,6,1955,8,"female",1034,154,123,470,89,164,24,306,65
1487337,18,10,1995,1,"male",13,0,0,0,0,0,0,0,0
1487345,36,20,1977,8,"male",258,16,11,12,0,0,0,12,0
1487353,15,10,1998,11,"female",319,585,73,24,34,24,18,0,16
1487360,22,9,1991,7,"male",600,229,152,4,0,4,0,0,0
1487364,19,11,1994,5,"male",989,1647,1315,71,66,71,54,0,12
1487389,21,2,1992,1,"male",154,120,79,28,17,26,10,2,7
1487390,25,1,1988,1,"male",91,4,4,1,0,1,0,0,0
1487424,30,3,1983,7,"male",437,136,91,56,54,56,32,0,22
1487435,36,18,1977,4,"female",269,32,19,13,20,9,12,4,8
1487511,70,5,1943,6,"male",855,94,52,0,1,0,1,0,0
1487521,18,6,1995,10,"male",445,0,0,0,0,0,0,0,0
1487522,17,4,1996,10,"female",974,1824,203,360,570,52,183,308,387
1487525,23,22,1990,10,"male",9,0,0,0,0,0,0,0,0
1487529,25,8,1988,8,"male",1205,445,251,0,0,0,0,0,0
1487554,44,10,1969,3,"female",70,23,16,19,2,19,0,0,2
1487570,27,1,1986,1,"male",570,1,0,0,0,0,0,0,0
1487587,31,4,1982,12,"male",195,6,5,0,0,0,0,0,0
1487600,35,5,1978,10,"male",139,122,106,71,92,71,57,0,35
1487608,43,8,1970,1,"male",162,41,23,27,8,1,2,26,6
1487686,18,15,1995,7,"male",169,18,13,0,0,0,0,0,0
1487690,29,17,1984,7,"male",409,119,67,0,0,0,0,0,0
1487711,53,18,1960,3,"male",699,157,60,17,20,17,14,0,6
1487732,16,21,1997,11,"male",396,294,173,871,26,871,24,0,2
1487746,23,21,1990,10,"female",304,193,134,502,344,502,257,0,87
1487758,63,5,1950,12,"female",360,367,316,515,516,11,160,504,356
1487763,45,18,1968,3,"female",796,115,76,36,33,33,25,3,8
1487769,68,19,1945,10,"male",680,56,44,0,0,0,0,0,0
1487785,27,1,1986,1,"male",721,229,91,116,50,116,47,0,3
1487825,14,16,1999,1,"female",358,144,107,36,0,23,0,13,0
1487837,69,23,1944,12,"female",1714,117,41,623,257,598,153,25,104
1487838,28,15,1985,8,"male",19,11,7,25,12,25,10,0,2
1487844,20,15,1993,6,"female",397,27,1,16,0,16,0,0,0
1487861,63,9,1950,12,"male",842,74,33,0,0,0,0,0,0
1487884,25,1,1988,1,"male",255,33,30,0,0,0,0,0,0
1487888,93,31,1920,1,"female",911,388,228,43,74,38,56,5,18
1487910,24,24,1989,6,"female",661,202,78,1,6,1,5,0,1
1487919,16,1,1997,7,"female",99,35,31,0,0,0,0,0,0
1487923,24,10,1989,8,"female",1120,851,460,908,1059,887,483,21,576
1487925,27,8,1986,11,"male",245,107,68,3,1,3,1,0,0
1487927,45,27,1968,2,"male",186,0,0,12,2,12,1,0,1
1487929,24,15,1989,10,"female",826,368,314,268,1337,90,837,178,500
1487932,22,2,1991,3,"male",241,172,146,558,40,558,40,0,0
1487934,108,14,1905,2,"male",582,296,99,4,12,4,7,0,5
1488011,28,9,1985,6,"male",573,0,0,0,0,0,0,0,0
1488012,15,5,1998,3,"male",159,87,42,46,30,46,18,0,12
1488019,104,30,1909,4,"female",2017,575,106,20,11,7,6,13,5
1488023,105,21,1908,8,"female",1072,140,96,36,18,35,18,1,0
1488062,23,13,1990,7,"male",104,1,0,2,1,0,0,2,1
1488063,14,20,1999,4,"female",290,338,178,27,5,25,4,2,1
1488118,19,2,1994,10,"male",299,447,378,22,1,22,1,0,0
1488130,23,7,1990,7,"male",457,103,82,5,6,0,2,5,4
1488167,20,24,1993,8,"female",661,37,35,0,0,0,0,0,0
1488177,26,29,1987,7,"male",321,327,207,640,143,640,106,0,37
1488190,21,25,1992,3,"male",578,363,301,12,19,5,16,7,3
1488203,20,27,1993,5,"male",261,246,206,2,1,2,0,0,1
1488212,42,17,1971,7,"female",1897,395,146,2959,4182,1427,2951,1532,1231
1488236,35,18,1978,11,"male",626,2,1,0,0,0,0,0,0
1488237,27,22,1986,5,"female",366,7,4,3,1,0,0,3,1
1488254,63,31,1950,12,"female",325,70,28,1,10,0,5,1,5
1488259,61,2,1952,1,"female",1171,298,14,6,4,6,4,0,0
1488266,16,19,1997,2,"male",382,192,145,23,3,17,0,6,3
1488271,44,13,1969,9,"female",379,26,2,0,0,0,0,0,0
1488281,23,1,1990,1,"male",794,363,273,0,13,0,8,0,5
1488285,24,25,1989,10,"male",199,125,77,12,9,12,9,0,0
1488287,14,26,1999,10,"male",174,220,171,1601,244,1564,211,37,33
1488294,32,25,1981,5,"male",93,2,1,0,0,0,0,0,0
1488318,50,7,1963,10,"male",1147,183,99,258,186,62,87,196,99
1488345,96,27,1917,8,"male",1060,471,313,1242,1340,1242,977,0,363
1488353,69,11,1944,12,"male",1184,100,34,15,9,0,0,15,9
1488392,17,26,1996,10,"female",628,1724,370,21,229,13,172,8,57
1488419,31,19,1982,11,"male",351,293,256,63,81,63,63,0,18
1488445,16,29,1997,5,"female",721,322,255,27,26,13,11,14,15
1488520,54,20,1959,9,"male",428,12,4,75,4,0,0,75,4
1488548,24,1,1989,4,"female",160,74,33,5,19,3,12,2,7
1488553,28,6,1985,3,"male",440,18,3,1,1,1,0,0,1
1488570,101,18,1912,1,"male",1353,880,522,825,187,578,128,247,59
1488592,49,12,1964,10,"female",1368,79,43,413,373,170,269,243,104
1488596,60,11,1953,10,"female",95,1,1,2,12,2,7,0,5
1488626,21,3,1992,1,"male",138,22,6,11,4,1,1,10,3
1488661,25,1,1988,1,"male",134,56,7,81,83,81,70,0,13
1488670,103,15,1910,3,"male",930,130,84,38,22,38,18,0,4
1488677,15,8,1998,5,"male",263,840,690,1972,320,1972,145,0,175
1488699,17,20,1996,8,"female",664,1025,494,161,1046,132,467,29,579
1488704,27,1,1986,10,"male",261,294,214,157,144,157,71,0,73
1488718,18,16,1995,2,"male",409,17,13,84,20,84,17,0,3
1488770,17,25,1996,12,"male",327,83,75,3,0,3,0,0,0
1488772,73,17,1940,12,"female",1645,46,19,2,0,2,0,0,0
1488783,68,10,1945,8,"male",848,112,86,2,0,2,0,0,0
1488812,61,24,1952,1,"male",610,65,32,29,21,1,9,28,12
1488849,22,7,1991,10,"male",40,149,125,4,27,4,15,0,12
1488853,24,21,1989,9,"female",261,233,201,245,234,221,180,24,54
1488861,17,1,1996,1,"male",340,307,184,0,2,0,2,0,0
1488863,33,27,1980,5,"female",195,200,77,1,2,1,2,0,0
1488888,20,10,1993,6,"male",323,4,3,1,1,1,1,0,0
1488901,25,22,1988,7,"male",976,190,143,0,4,0,1,0,3
1488914,21,8,1992,8,"male",557,64,58,4,0,4,0,0,0
1488951,18,1,1995,1,"male",295,257,247,19,0,19,0,0,0
1488993,24,12,1989,3,"male",22,19,18,16,0,16,0,0,0
1489019,18,2,1995,8,"female",246,224,163,256,209,226,114,30,95
1489024,41,4,1972,4,"male",1184,53,11,33,19,33,11,0,8
1489033,23,19,1990,4,"female",845,2674,494,59,196,59,150,0,46
1489040,19,1,1994,1,"female",232,10,6,0,0,0,0,0,0
1489044,58,16,1955,9,"female",132,53,43,144,45,28,23,116,22
1489049,66,12,1947,7,"female",446,30,20,5,1,5,0,0,1
1489065,69,25,1944,9,"female",1345,171,12,7,210,5,145,2,65
1489066,24,5,1989,1,"male",478,86,65,2,0,0,0,2,0
1489082,29,15,1984,1,"male",398,61,33,1,0,1,0,0,0
1489121,33,28,1980,4,"male",566,48,42,0,2,0,1,0,1
1489151,31,23,1982,5,"male",70,21,14,0,1,0,1,0,0
1489164,20,18,1993,7,"male",120,13,9,3,1,3,1,0,0
1489166,21,5,1992,3,"female",72,64,57,3,5,0,1,3,4
1489177,25,17,1988,3,"female",105,57,27,2,0,2,0,0,0
1489178,19,31,1994,7,"female",469,163,65,1,2,1,0,0,2
1489215,26,2,1987,10,"male",265,13,13,1,2,0,1,1,1
1489229,72,15,1941,11,"female",504,365,296,265,7,141,4,124,3
1489258,33,10,1980,12,"female",370,90,69,20,124,0,41,20,83
1489272,27,14,1986,8,"female",435,7,6,1,2,1,1,0,1
1489306,54,16,1959,1,"male",801,390,38,82,140,81,69,1,71
1489312,52,24,1961,1,"male",713,9,3,9,1,9,0,0,1
1489317,27,6,1986,6,"male",425,62,30,1,0,1,0,0,0
1489329,89,31,1924,10,"female",657,22,14,2,1,0,0,2,1
1489351,61,30,1952,3,"male",1210,4844,561,7,247,5,96,2,151
1489366,17,16,1996,3,"female",316,30,20,0,2,0,2,0,0
1489367,19,4,1994,9,"female",463,139,46,70,72,70,70,0,2
1489379,33,1,1980,1,"male",155,216,128,5127,214,5127,206,0,8
1489390,16,7,1997,9,"female",147,237,112,7,27,0,16,7,11
1489458,68,9,1945,4,"female",1199,134,111,763,382,32,178,731,204
1489463,61,28,1952,9,"male",34,51,45,86,5,86,3,0,2
1489492,82,4,1931,12,"male",1020,78,17,17,1,0,1,17,0
1489495,42,4,1971,7,"male",334,166,85,146,146,146,78,0,68
1489500,25,10,1988,5,"female",287,30,0,0,0,0,0,0,0
1489504,29,5,1984,1,"male",549,75,22,4,0,1,0,3,0
1489526,15,2,1998,6,"female",339,373,245,117,199,3,114,114,85
1489527,31,9,1982,2,"female",585,213,162,46,30,28,24,18,6
1489540,20,1,1993,8,"female",150,955,130,1979,3498,1874,1913,105,1585
1489580,16,12,1997,9,"female",302,311,99,4,5,0,1,4,4
1489611,40,25,1973,6,"male",416,48,19,0,0,0,0,0,0
1489619,44,13,1969,2,"male",41,28,17,75,25,10,13,65,12
1489634,55,12,1958,8,"female",1602,268,58,334,451,334,322,0,129
1489641,26,13,1987,3,"male",646,73,44,4,18,4,18,0,0
1489647,24,1,1989,1,"male",1159,195,102,1,32,1,31,0,1
1489649,15,8,1998,1,"female",554,309,227,38,0,3,0,35,0
1489655,36,9,1977,12,"female",366,25,22,1,0,0,0,1,0
1489689,16,11,1997,10,"male",597,596,478,23,28,23,21,0,7
1489711,21,17,1992,10,"male",649,25,21,0,3,0,2,0,1
1489721,19,27,1994,10,"female",146,285,181,3,9,3,9,0,0
1489746,25,22,1988,12,"male",349,45,33,6,5,6,5,0,0
1489750,75,18,1938,12,"male",1432,19,10,11,0,11,0,0,0
1489756,32,29,1981,5,"male",159,0,0,0,0,0,0,0,0
1489778,55,4,1958,3,"male",544,90,35,390,40,390,23,0,17
1489786,21,2,1992,1,"male",320,47,41,77,0,77,0,0,0
1489809,24,28,1989,5,"female",1329,4390,1214,526,978,62,519,464,459
1489894,55,21,1958,11,"female",425,89,66,60,102,22,21,38,81
1489914,34,7,1979,11,"male",640,4,4,0,0,0,0,0,0
1489954,25,27,1988,12,"male",376,221,144,1044,576,363,146,681,430
1489955,28,7,1985,10,"male",520,24,7,18,14,9,12,9,2
1489988,83,20,1930,6,"male",702,119,41,3,9,3,2,0,7
1489991,33,31,1980,7,"female",212,53,44,203,391,42,148,161,243
1490001,23,2,1990,1,"female",45,23,18,5,1,5,1,0,0
1490002,25,16,1988,2,"female",800,179,56,34,32,34,25,0,7
1490009,35,9,1978,1,"female",608,59,32,13,5,0,5,13,0
1490015,17,1,1996,6,"male",321,480,307,382,231,382,196,0,35
1490070,19,5,1994,8,"male",556,748,560,190,37,186,24,4,13
1490107,26,13,1987,12,"female",929,490,275,225,305,192,94,33,211
1490159,14,6,1999,3,"female",263,86,75,7,0,0,0,7,0
1490171,62,31,1951,8,"male",261,35,12,0,0,0,0,0,0
1490208,26,11,1987,5,"male",693,214,195,0,0,0,0,0,0
1490224,101,11,1912,9,"male",2190,2547,1652,425,1729,157,1398,268,331
1490231,47,7,1966,3,"male",2078,4,1,3,14,1,1,2,13
1490262,18,23,1995,11,"male",539,1200,854,49,60,25,43,24,17
1490273,20,15,1993,11,"female",1537,1722,1017,4501,6016,2464,1999,2037,4017
1490305,29,1,1984,1,"male",110,19,16,62,23,61,11,1,12
1490313,29,29,1984,12,"female",360,31,19,334,214,12,26,322,188
1490340,21,20,1992,4,"male",287,249,158,42,51,7,50,35,1
1490362,36,4,1977,9,"male",599,137,92,0,0,0,0,0,0
1490383,18,23,1995,1,"male",521,386,266,42,62,31,47,11,15
1490384,43,3,1970,7,"male",27,0,0,0,0,0,0,0,0
1490401,103,28,1910,3,"male",1295,753,573,0,1,0,0,0,1
1490420,34,13,1979,1,"male",645,59,16,1,2,1,2,0,0
1490424,16,25,1997,8,"female",389,759,411,32,80,32,15,0,65
1490428,18,3,1995,3,"male",22,83,83,2,2,2,2,0,0
1490436,32,16,1981,5,"male",385,144,72,13,36,0,13,13,23
1490451,23,22,1990,2,"male",686,129,54,12,0,12,0,0,0
1490455,28,28,1985,12,"female",356,45,24,115,85,9,15,106,70
1490461,61,3,1952,1,"female",164,7,2,0,0,0,0,0,0
1490493,45,15,1968,12,"male",662,154,17,23,183,23,139,0,44
1490503,64,22,1949,11,"male",467,45,37,12,5,9,5,3,0
1490519,62,4,1951,7,"female",776,32,16,1,0,0,0,1,0
1490525,73,18,1940,1,"male",795,28,3,24,5,0,4,24,1
1490530,25,21,1988,11,"male",1213,756,575,1,0,1,0,0,0
1490537,21,16,1992,7,"male",21,10,10,10,5,10,4,0,1
1490558,18,25,1995,6,"male",267,63,31,0,0,0,0,0,0
1490564,18,5,1995,6,"female",1224,303,102,832,1022,599,500,233,522
1490590,45,26,1968,8,"male",435,214,164,253,420,253,334,0,86
1490593,55,2,1958,5,"female",461,24,10,145,28,115,18,30,10
1490604,25,4,1988,11,"female",1018,425,267,221,436,153,220,68,216
1490605,48,30,1965,11,"male",284,166,39,24,1,24,1,0,0
1490623,16,14,1997,11,"female",246,515,284,52,176,52,168,0,8
1490628,61,27,1952,10,"male",1581,63,7,0,4,0,2,0,2
1490632,113,1,1900,1,"male",1467,213,101,10,11,10,11,0,0
1490642,20,4,1993,1,"female",386,1,1,0,0,0,0,0,0
1490652,23,25,1990,8,"male",585,88,63,0,2,0,2,0,0
1490654,14,24,1999,8,"female",246,2424,1728,128,159,128,153,0,6
1490682,19,9,1994,10,"male",534,219,72,12,29,12,4,0,25
1490717,18,14,1995,12,"female",858,278,91,1717,3785,1502,2218,215,1567
1490719,33,7,1980,12,"male",34,16,12,30,24,30,19,0,5
1490733,17,28,1996,11,"male",382,2,2,0,0,0,0,0,0
1490738,63,1,1950,1,"male",829,77,49,0,0,0,0,0,0
1490758,68,25,1945,9,"female",1379,52,28,45,15,45,14,0,1
1490768,15,22,1998,6,"female",783,3,1,0,0,0,0,0,0
1490806,37,12,1976,10,"female",194,20,19,3,4,3,2,0,2
1490817,48,25,1965,5,"female",599,45,30,3,1,3,0,0,1
1490869,106,5,1907,3,"female",32,65,59,24,21,24,15,0,6
1490882,21,16,1992,11,"female",61,354,45,5,14,5,5,0,9
1490896,23,23,1990,4,"female",241,134,111,2,0,2,0,0,0
1490906,61,18,1952,1,"female",174,29,21,0,0,0,0,0,0
1490913,43,5,1970,2,"male",673,25,11,17,14,3,8,14,6
1490914,17,27,1996,12,"male",303,42,37,11,4,0,1,11,3
1490943,16,26,1997,11,"male",347,137,108,0,0,0,0,0,0
1490962,23,3,1990,3,"male",563,341,180,9,2,9,2,0,0
1490968,101,20,1912,2,"male",1505,1310,545,11696,17434,9915,16855,1781,579
1490970,42,15,1971,3,"male",416,93,47,693,87,630,32,63,55
1490997,25,16,1988,8,"male",98,84,64,1,0,1,0,0,0
1491017,108,26,1905,3,"male",249,135,64,224,78,158,27,66,51
1491024,18,9,1995,10,"male",349,44,28,5,0,5,0,0,0
1491055,18,13,1995,8,"male",422,142,63,11,2,11,2,0,0
1491057,69,29,1944,8,"female",768,22,18,0,3,0,2,0,1
1491096,68,31,1945,5,"female",1213,35,15,9,4,0,4,9,0
1491104,66,24,1947,2,"female",1670,1129,784,638,1385,75,526,563,859
1491106,45,27,1968,1,"female",455,189,141,201,82,46,55,155,27
1491160,29,15,1984,7,"male",196,164,148,0,0,0,0,0,0
1491197,19,5,1994,10,"female",540,26,19,62,15,41,10,21,5
1491207,43,21,1970,5,"female",294,53,35,6,22,5,11,1,11
1491249,17,18,1996,8,"male",516,422,334,0,0,0,0,0,0
1491257,25,1,1988,1,"male",43,76,59,7,0,0,0,7,0
1491272,36,8,1977,12,"male",163,54,42,81,7,79,4,2,3
1491274,108,6,1905,6,NA,1517,5,2,6,15,0,4,6,11
1491285,19,18,1994,10,"female",713,114,80,29,26,29,25,0,1
1491292,23,24,1990,1,"male",378,462,374,23,43,23,7,0,36
1491298,25,16,1988,9,"male",228,133,26,48,0,3,0,45,0
1491304,18,2,1995,4,"female",618,881,577,314,777,65,202,249,575
1491361,25,21,1988,2,"male",1127,837,462,26,29,26,26,0,3
1491387,23,15,1990,6,"female",714,46,21,0,0,0,0,0,0
1491388,28,12,1985,9,"female",74,0,0,4,3,4,3,0,0
1491405,35,2,1978,2,"male",5,0,0,0,0,0,0,0,0
1491469,33,14,1980,2,"male",503,18,11,0,0,0,0,0,0
1491473,27,4,1986,1,"male",858,174,75,4,2,0,2,4,0
1491524,53,23,1960,5,"female",170,2,1,0,10,0,8,0,2
1491553,39,24,1974,7,"female",494,73,36,0,1,0,1,0,0
1491593,29,8,1984,4,"male",167,259,233,23,28,23,25,0,3
1491656,19,6,1994,11,"female",550,420,249,129,351,100,295,29,56
1491680,23,3,1990,6,"male",1992,699,379,236,392,171,262,65,130
1491700,48,5,1965,5,"female",79,17,16,43,3,36,2,7,1
1491703,24,15,1989,12,"male",549,364,144,107,39,107,34,0,5
1491758,22,11,1991,1,"male",260,3,2,0,0,0,0,0,0
1491761,96,17,1917,9,"female",1489,145,53,121,103,121,86,0,17
1491771,20,13,1993,6,"male",208,106,56,3831,869,2947,425,884,444
1491829,18,1,1995,1,"male",365,233,87,43,85,43,47,0,38
1491830,17,28,1996,4,"female",564,265,141,2,10,2,7,0,3
1491835,29,25,1984,6,"female",320,31,19,6,1,6,1,0,0
1491869,26,8,1987,7,"female",820,1038,579,97,128,97,95,0,33
1491871,30,8,1983,2,"female",645,118,64,401,214,296,155,105,59
1491886,37,6,1976,4,"male",468,9,9,0,0,0,0,0,0
1491906,100,1,1913,11,"male",1113,118,83,152,116,152,114,0,2
1491915,78,29,1935,4,"female",188,29,14,148,3,148,2,0,1
1491954,14,8,1999,7,"male",306,174,102,15,9,14,4,1,5
1491960,20,4,1993,2,"male",692,323,194,341,314,278,206,63,108
1491964,36,31,1977,10,"male",473,67,39,9,17,0,9,9,8
1491970,25,25,1988,8,"male",267,209,72,2,0,2,0,0,0
1491986,27,18,1986,4,"male",558,319,294,3,5,3,0,0,5
1491987,25,18,1988,12,"male",360,0,0,0,0,0,0,0,0
1491992,51,28,1962,5,"male",614,38,8,0,2,0,2,0,0
1491998,38,15,1975,11,"male",481,359,220,516,560,516,471,0,89
1492050,17,19,1996,12,"male",329,104,48,281,0,19,0,262,0
1492088,16,12,1997,1,"male",51,67,66,2,0,2,0,0,0
1492112,29,10,1984,7,"male",300,351,243,90,305,35,99,55,206
1492113,18,17,1995,12,"male",287,451,415,2,6,2,5,0,1
1492130,28,29,1985,10,"male",338,179,153,19,14,19,13,0,1
1492132,27,1,1986,2,"male",311,46,38,0,1,0,1,0,0
1492137,25,1,1988,1,"male",164,113,103,32,9,19,9,13,0
1492169,18,4,1995,11,"male",450,73,54,156,1,156,1,0,0
1492172,20,22,1993,4,"male",552,396,308,111,92,61,24,50,68
1492196,108,30,1905,10,"female",1746,369,102,56,24,56,21,0,3
1492263,108,23,1905,3,"male",1683,227,133,24,10,0,8,24,2
1492273,13,9,2000,6,"male",143,10,10,10,0,10,0,0,0
1492288,18,26,1995,3,"female",592,2426,585,8667,9534,7539,6731,1128,2803
1492289,72,6,1941,10,"male",1883,439,250,19,10,2,9,17,1
1492308,25,20,1988,9,"female",172,280,97,700,368,700,194,0,174
1492318,64,26,1949,1,"male",71,18,12,2,7,2,3,0,4
1492323,27,3,1986,5,"male",247,32,19,1,8,1,4,0,4
1492341,42,20,1971,5,"male",397,7,6,0,4,0,4,0,0
1492343,28,22,1985,12,"male",529,46,34,0,0,0,0,0,0
1492357,26,13,1987,3,"male",423,65,45,62,63,53,37,9,26
1492384,83,22,1930,10,"male",71,71,46,53,24,53,15,0,9
1492400,22,1,1991,1,"female",395,681,523,1816,835,1214,497,602,338
1492405,22,24,1991,1,"female",413,456,202,35,62,35,57,0,5
1492489,113,12,1900,6,"male",1700,167,121,10,3,10,3,0,0
1492529,18,15,1995,9,"male",300,155,150,4,3,4,3,0,0
1492562,47,12,1966,3,"male",164,216,149,2,22,0,6,2,16
1492569,31,21,1982,1,"male",519,287,213,816,300,772,277,44,23
1492575,29,6,1984,6,"male",155,4,1,0,0,0,0,0,0
1492576,23,20,1990,7,"female",683,445,300,0,10,0,9,0,1
1492600,15,18,1998,11,"female",31,395,61,53,1428,53,1104,0,324
1492618,49,12,1964,10,"female",637,38,11,21,38,21,24,0,14
1492637,20,27,1993,6,"male",639,76,63,1,0,0,0,1,0
1492641,35,20,1978,3,"male",632,13,9,0,1,0,1,0,0
1492691,18,18,1995,12,"male",85,48,36,0,0,0,0,0,0
1492695,38,1,1975,3,"female",265,67,55,1,2,0,2,1,0
1492710,47,26,1966,6,"female",1293,969,691,316,129,5,36,311,93
1492748,17,11,1996,5,"female",182,1,1,0,0,0,0,0,0
1492763,18,20,1995,12,"male",515,434,312,3,0,3,0,0,0
1492794,40,9,1973,10,"male",103,120,97,0,0,0,0,0,0
1492804,19,22,1994,5,"male",216,46,40,31,5,31,3,0,2
1492805,54,22,1959,6,"male",128,65,65,26,3,0,0,26,3
1492814,31,14,1982,11,"male",293,76,41,183,26,183,18,0,8
1492819,27,4,1986,2,"male",386,72,71,0,0,0,0,0,0
1492822,34,13,1979,5,"male",1052,271,94,0,0,0,0,0,0
1492835,21,2,1992,2,"female",390,726,380,5326,900,5326,747,0,153
1492849,64,6,1949,3,"male",1381,61,33,0,0,0,0,0,0
1492853,59,27,1954,5,"female",1296,259,183,1185,1581,842,1130,343,451
1492871,18,10,1995,7,"female",302,192,93,20,31,20,31,0,0
1492910,18,13,1995,4,"female",462,193,62,12,4,12,1,0,3
1492927,28,22,1985,11,"female",560,320,174,101,99,29,46,72,53
1492933,57,12,1956,11,"male",1031,58,26,74,13,9,9,65,4
1492954,108,25,1905,1,"male",1885,607,188,158,128,148,77,10,51
1492962,18,15,1995,6,"male",46,24,23,1,0,1,0,0,0
1492964,61,11,1952,5,"female",740,32,17,180,1,180,1,0,0
1492967,22,2,1991,6,"female",595,150,69,1,1,1,1,0,0
1492988,100,5,1913,12,"male",732,22,15,0,2,0,2,0,0
1492993,15,3,1998,4,"female",179,4,3,0,0,0,0,0,0
1493005,71,9,1942,7,"female",245,58,46,11,2,0,0,11,2
1493033,26,12,1987,11,"female",31,1,1,0,0,0,0,0,0
1493077,22,15,1991,6,"female",396,212,61,11,35,11,16,0,19
1493098,108,15,1905,9,"female",1031,583,291,120,123,0,53,120,70
1493106,23,19,1990,9,"male",220,8,6,0,0,0,0,0,0
1493111,33,11,1980,12,"female",553,314,97,342,301,260,197,82,104
1493152,47,26,1966,2,"female",774,281,94,530,239,521,106,9,133
1493198,48,21,1965,10,"male",1336,56,40,0,0,0,0,0,0
1493207,18,27,1995,11,"male",575,182,100,5,8,0,6,5,2
1493218,14,19,1999,7,"male",134,136,88,43,13,43,13,0,0
1493228,50,5,1963,9,"female",98,13,8,14,25,14,24,0,1
1493255,24,28,1989,11,"male",3,21,17,18,3,18,2,0,1
1493289,17,14,1996,6,"female",55,26,20,121,152,119,140,2,12
1493339,52,4,1961,10,"female",82,66,49,27,101,8,14,19,87
1493358,57,23,1956,8,"female",466,163,38,232,439,230,300,2,139
1493375,19,25,1994,5,"female",179,49,25,3,1,3,1,0,0
1493381,21,11,1992,9,"male",615,319,139,10,0,4,0,6,0
1493384,25,7,1988,1,"female",480,43,27,8,0,8,0,0,0
1493413,18,18,1995,6,"male",365,807,613,271,138,271,72,0,66
1493418,14,22,1999,8,"male",3,17,15,5,1,5,1,0,0
1493426,20,28,1993,8,"male",1129,1176,176,14,8,14,4,0,4
1493432,60,11,1953,3,"female",350,100,82,335,73,0,22,335,51
1493454,56,4,1957,2,"male",702,39,10,0,0,0,0,0,0
1493455,23,23,1990,10,"female",225,221,21,18,29,18,20,0,9
1493467,68,20,1945,11,"female",647,1955,368,793,426,2,237,791,189
1493471,23,14,1990,12,"male",503,1261,885,29,265,29,231,0,34
1493490,39,28,1974,6,"female",208,17,12,0,0,0,0,0,0
1493501,53,30,1960,4,"female",2220,1990,623,1700,6043,1262,2919,438,3124
1493550,54,28,1959,12,"female",983,110,50,118,80,118,51,0,29
1493551,17,14,1996,11,"male",349,257,114,28,3,0,2,28,1
1493568,71,11,1942,6,"male",1500,71,22,44,118,0,16,44,102
1493570,50,22,1963,4,"female",168,29,27,29,2,18,1,11,1
1493577,79,2,1934,6,"female",1457,61,23,4,3,4,2,0,1
1493608,19,24,1994,4,"male",1296,3639,1616,514,962,20,228,494,734
1493669,53,25,1960,9,"female",1491,230,75,981,838,88,364,893,474
1493724,25,13,1988,2,"male",1660,71,31,65,215,11,85,54,130
1493745,53,28,1960,10,"female",1030,53,27,3,2,3,1,0,1
1493754,33,11,1980,4,"male",195,49,46,30,238,30,225,0,13
1493767,33,5,1980,7,"female",378,20,8,0,0,0,0,0,0
1493778,17,27,1996,5,"male",92,371,330,4073,1027,4073,597,0,430
1493839,28,2,1985,1,"female",175,192,11,111,500,81,97,30,403
1493893,45,10,1968,4,"female",584,250,155,25,265,12,119,13,146
1493900,27,1,1986,6,"male",160,4,3,1,1,1,1,0,0
1493902,14,21,1999,6,"male",62,61,48,0,0,0,0,0,0
1493939,21,18,1992,4,"female",350,85,28,36,12,25,2,11,10
1493940,30,2,1983,9,"male",339,177,89,437,95,437,58,0,37
1493964,26,1,1987,1,"male",507,88,49,0,0,0,0,0,0
1494015,21,5,1992,2,"male",144,64,51,0,13,0,7,0,6
1494016,22,5,1991,9,"male",970,561,134,198,219,0,69,198,150
1494021,17,5,1996,6,"male",335,193,179,0,0,0,0,0,0
1494045,68,27,1945,9,"male",1043,225,156,1,0,1,0,0,0
1494057,99,4,1914,12,"male",1047,171,85,24,4,24,4,0,0
1494068,18,21,1995,4,"male",243,81,64,0,0,0,0,0,0
1494071,17,4,1996,4,"male",187,49,41,6,12,4,3,2,9
1494106,19,3,1994,7,"male",559,179,65,73,4,73,0,0,4
1494160,68,18,1945,3,"female",203,35,22,1,0,0,0,1,0
1494188,40,14,1973,9,"male",233,106,66,139,29,121,16,18,13
1494190,25,30,1988,8,"male",547,94,72,4,9,4,1,0,8
1494230,20,17,1993,11,"male",197,18,16,0,0,0,0,0,0
1494238,15,29,1998,9,"male",30,91,53,0,8,0,8,0,0
1494276,30,9,1983,4,"female",613,59,38,0,1,0,1,0,0
1494304,25,10,1988,4,"female",326,156,54,3,4,3,4,0,0
1494340,20,13,1993,9,"female",69,46,22,12,2,12,2,0,0
1494342,46,25,1967,7,"female",120,62,60,7,26,7,22,0,4
1494360,54,19,1959,3,"male",2076,24,10,0,0,0,0,0,0
1494368,25,8,1988,2,"male",825,8,7,0,0,0,0,0,0
1494379,20,1,1993,7,"male",893,748,471,1069,1454,2,655,1067,799
1494402,21,13,1992,1,"male",726,3,2,0,0,0,0,0,0
1494413,23,4,1990,2,"male",721,198,126,189,77,189,61,0,16
1494427,16,19,1997,7,"male",267,43,25,16,0,16,0,0,0
1494446,41,25,1972,1,"female",377,2,2,0,0,0,0,0,0
1494452,99,25,1914,7,"male",1246,349,195,58,47,12,36,46,11
1494457,18,29,1995,5,"female",720,40,40,18,7,6,2,12,5
1494500,27,1,1986,12,"male",8,5,4,9,12,9,12,0,0
1494504,56,29,1957,6,"female",274,38,25,341,50,333,25,8,25
1494507,17,2,1996,12,"male",381,135,26,19,41,19,30,0,11
1494582,14,1,1999,2,"male",111,0,0,0,1,0,0,0,1
1494622,20,20,1993,4,"female",156,263,235,135,77,27,11,108,66
1494628,50,12,1963,3,"female",768,34,12,31,26,31,16,0,10
1494661,15,21,1998,12,"male",130,18,8,0,1,0,0,0,1
1494682,21,25,1992,3,"male",124,101,2,0,3,0,1,0,2
1494710,17,3,1996,3,"male",628,20,3,0,0,0,0,0,0
1494748,71,29,1942,11,"male",988,45,15,253,40,0,23,253,17
1494749,22,25,1991,12,"male",491,87,46,0,0,0,0,0,0
1494753,16,4,1997,3,"male",363,0,0,0,0,0,0,0,0
1494771,28,25,1985,9,"female",489,54,47,29,31,22,14,7,17
1494779,49,26,1964,1,"female",445,77,44,1,1,1,0,0,1
1494780,15,19,1998,1,"male",14,5,5,3,1,3,1,0,0
1494793,23,1,1990,1,"male",61,44,34,0,0,0,0,0,0
1494794,44,31,1969,3,"female",405,3,3,0,0,0,0,0,0
1494822,16,3,1997,10,"male",626,297,180,112,0,90,0,22,0
1494853,52,25,1961,4,"male",89,26,18,0,0,0,0,0,0
1494896,63,30,1950,11,"female",2035,60,32,25,37,8,17,17,20
1494918,70,4,1943,6,"male",947,150,67,1,10,0,9,1,1
1494926,14,30,1999,12,"female",130,131,71,1239,102,1198,34,41,68
1494929,23,25,1990,11,"male",827,69,19,72,25,18,4,54,21
1494935,23,12,1990,12,"female",2071,463,197,410,368,236,121,174,247
1494937,34,14,1979,11,"female",475,210,115,215,139,214,115,1,24
1494996,16,2,1997,1,"female",358,605,379,107,439,21,227,86,212
1495017,65,30,1948,1,"male",143,7,3,0,1,0,1,0,0
1495025,22,31,1991,5,"female",301,398,359,179,188,138,15,41,173
1495045,62,13,1951,12,"female",1178,34,13,8,0,0,0,8,0
1495057,41,1,1972,5,"female",544,53,39,28,40,28,37,0,3
1495071,60,24,1953,11,"female",1837,159,94,384,174,384,146,0,28
1495086,18,3,1995,5,"female",365,614,487,0,2,0,0,0,2
1495124,69,9,1944,10,"female",1849,27,5,0,0,0,0,0,0
1495190,40,2,1973,7,"male",332,95,37,0,1,0,1,0,0
1495233,48,19,1965,1,"male",327,182,148,93,13,4,0,89,13
1495235,42,20,1971,3,"male",454,179,65,145,362,145,311,0,51
1495236,57,23,1956,9,"male",992,17,12,3,2,3,1,0,1
1495245,64,24,1949,3,"female",417,19,4,1,3,0,0,1,3
1495258,52,27,1961,10,"female",1704,129,42,13,43,13,26,0,17
1495268,72,1,1941,12,"male",1923,180,66,1,4,1,4,0,0
1495271,20,28,1993,4,"male",555,190,80,8,3,8,3,0,0
1495307,41,31,1972,3,"male",519,94,61,26,11,26,5,0,6
1495319,16,4,1997,5,"female",604,2883,325,126,86,100,51,26,35
1495322,19,5,1994,7,"male",495,49,49,88,42,87,32,1,10
1495342,108,5,1905,5,"male",380,172,82,114,56,114,40,0,16
1495378,17,27,1996,7,"female",477,286,117,381,416,381,217,0,199
1495411,49,1,1964,5,"male",180,62,20,18,12,18,12,0,0
1495473,25,1,1988,1,"male",272,294,244,6,4,6,1,0,3
1495476,53,26,1960,8,"female",1003,82,43,35,38,35,38,0,0
1495489,20,3,1993,3,"male",182,126,100,29,1,1,0,28,1
1495495,43,7,1970,4,"female",171,8,7,50,2,50,2,0,0
1495497,30,28,1983,7,"male",469,153,112,0,0,0,0,0,0
1495537,67,26,1946,10,"female",530,49,34,10,10,0,1,10,9
1495538,58,3,1955,4,"male",1707,17,8,7,0,7,0,0,0
1495547,64,6,1949,6,"male",1440,37,8,3,5,0,1,3,4
1495559,47,25,1966,8,"male",2321,72,37,41,4,39,4,2,0
1495560,64,10,1949,6,"female",2147,32,15,0,0,0,0,0,0
1495578,58,1,1955,2,"male",1647,32,19,0,1,0,0,0,1
1495590,46,7,1967,2,"female",412,17,11,141,70,0,14,141,56
1495646,17,10,1996,7,"male",301,3,3,0,0,0,0,0,0
1495658,35,9,1978,4,"female",21,0,0,3,3,0,0,3,3
1495697,25,25,1988,8,"male",838,63,31,4,2,3,2,1,0
1495713,57,23,1956,10,"male",439,68,10,5,30,0,7,5,23
1495722,29,15,1984,10,"male",229,26,21,14,18,0,1,14,17
1495726,31,1,1982,6,"male",57,19,17,13,1,13,0,0,1
1495727,59,4,1954,4,"male",57,2,1,0,0,0,0,0,0
1495731,46,25,1967,6,"male",1814,203,69,3222,970,1407,589,1815,381
1495732,27,28,1986,7,"female",1860,703,473,642,771,250,414,392,357
1495748,24,11,1989,1,"male",237,59,49,13,24,13,20,0,4
1495749,35,18,1978,10,"male",799,57,48,24,31,24,29,0,2
1495772,19,10,1994,4,"male",474,205,175,0,0,0,0,0,0
1495774,24,18,1989,2,"male",594,1,0,0,0,0,0,0,0
1495780,27,27,1986,7,"male",202,30,26,7,6,7,6,0,0
1495785,69,3,1944,8,"male",1686,119,28,344,99,55,48,289,51
1495806,46,7,1967,11,"female",556,28,12,0,0,0,0,0,0
1495812,31,14,1982,5,"female",20,16,9,3,5,3,3,0,2
1495832,30,24,1983,3,"female",388,150,83,2164,590,2081,501,83,89
1495854,113,7,1900,6,"male",1473,947,442,571,478,561,368,10,110
1495862,30,21,1983,9,"male",211,198,174,36,84,36,52,0,32
1495882,20,7,1993,9,"female",922,564,242,733,401,261,184,472,217
1495888,32,20,1981,7,"female",354,49,36,0,4,0,3,0,1
1495930,21,19,1992,11,"female",574,42,24,0,0,0,0,0,0
1496002,103,2,1910,5,"female",1266,986,499,1532,1157,1532,908,0,249
1496024,41,23,1972,6,"male",225,147,69,43,25,43,21,0,4
1496039,60,3,1953,6,"female",698,80,57,331,180,331,122,0,58
1496069,50,23,1963,4,"male",1372,14,4,0,0,0,0,0,0
1496072,20,28,1993,1,"male",763,239,164,12,0,0,0,12,0
1496086,23,11,1990,9,"female",1037,79,49,0,0,0,0,0,0
1496105,20,10,1993,3,"male",528,139,108,2,18,0,11,2,7
1496143,54,13,1959,5,"female",2245,134,78,61,33,61,7,0,26
1496159,44,18,1969,9,"female",270,71,53,890,903,810,612,80,291
1496164,20,19,1993,10,"female",244,686,202,171,848,155,589,16,259
1496190,25,6,1988,11,"female",920,198,60,512,364,211,124,301,240
1496196,25,11,1988,11,"male",257,38,16,2,0,2,0,0,0
1496201,29,4,1984,4,"male",764,172,102,10,1,10,1,0,0
1496224,15,24,1998,12,"male",86,56,32,33,20,2,13,31,7
1496254,18,3,1995,5,"female",207,224,164,186,48,186,43,0,5
1496281,23,29,1990,7,"female",500,208,131,3,27,3,3,0,24
1496299,23,1,1990,6,"female",174,8,6,3,5,3,4,0,1
1496300,21,8,1992,7,"male",366,36,13,68,74,18,45,50,29
1496301,57,11,1956,6,"male",602,23,9,0,2,0,2,0,0
1496319,38,11,1975,12,"male",150,9,2,0,0,0,0,0,0
1496322,18,31,1995,8,"male",301,73,42,1,0,1,0,0,0
1496327,19,10,1994,11,"female",447,11,4,0,6,0,6,0,0
1496343,17,20,1996,4,"female",127,516,459,1008,527,971,229,37,298
1496366,54,22,1959,1,"female",363,94,90,350,280,0,31,350,249
1496407,19,21,1994,3,"female",550,933,576,13,34,2,4,11,30
1496419,17,27,1996,11,"male",422,1372,1052,0,1,0,0,0,1
1496425,27,27,1986,2,"male",530,124,59,0,0,0,0,0,0
1496479,69,13,1944,6,"female",487,41,26,46,7,46,2,0,5
1496484,48,10,1965,7,"female",1373,502,354,118,64,105,17,13,47
1496533,52,15,1961,10,"male",752,147,36,132,74,38,43,94,31
1496537,23,14,1990,11,"female",587,96,41,24,10,24,3,0,7
1496555,64,28,1949,9,"male",695,63,18,1,2,1,2,0,0
1496565,28,15,1985,7,"male",165,267,138,26,8,26,5,0,3
1496592,27,7,1986,5,"male",893,164,73,1,0,0,0,1,0
1496601,26,1,1987,1,"male",262,306,295,244,99,210,87,34,12
1496625,20,16,1993,12,"male",658,145,117,0,0,0,0,0,0
1496632,23,6,1990,4,"male",976,20,13,0,0,0,0,0,0
1496647,21,18,1992,9,"male",717,315,237,13,7,6,5,7,2
1496678,29,28,1984,4,"female",1070,124,50,130,112,54,32,76,80
1496681,30,19,1983,2,"male",396,113,86,85,221,85,151,0,70
1496687,18,4,1995,6,"female",330,217,140,57,167,32,105,25,62
1496705,24,2,1989,12,"male",674,64,43,0,0,0,0,0,0
1496723,21,21,1992,9,"male",402,68,24,1,2,1,2,0,0
1496780,43,11,1970,11,"male",142,46,24,0,0,0,0,0,0
1496825,18,16,1995,3,"male",674,9,5,6,0,6,0,0,0
1496832,53,23,1960,11,"male",93,0,0,1,1,0,1,1,0
1496841,18,15,1995,8,"male",961,159,61,0,0,0,0,0,0
1496845,50,20,1963,6,"female",868,61,21,174,94,93,49,81,45
1496848,45,11,1968,4,"male",301,15,15,22,8,22,3,0,5
1496886,36,9,1977,7,"male",230,436,353,402,283,399,227,3,56
1496887,76,5,1937,11,"female",1382,83,20,206,34,0,15,206,19
1496889,33,3,1980,2,"male",441,10,10,0,0,0,0,0,0
1496897,25,2,1988,7,"female",573,191,82,302,182,302,127,0,55
1496919,41,24,1972,6,"female",240,80,57,14,0,14,0,0,0
1496933,25,15,1988,1,"male",57,36,22,1,0,1,0,0,0
1496934,45,25,1968,12,"female",388,78,70,45,1,45,0,0,1
1496995,43,16,1970,12,"male",280,8,7,2,3,0,3,2,0
1497037,23,24,1990,8,"male",973,258,190,13,1,13,1,0,0
1497050,17,28,1996,4,"female",208,71,54,109,91,0,31,109,60
1497078,68,20,1945,7,"female",1584,228,124,9,0,0,0,9,0
1497097,107,20,1906,8,"male",392,139,119,281,199,281,148,0,51
1497105,50,20,1963,5,"female",2395,294,160,966,618,684,383,282,235
1497118,51,28,1962,5,"female",148,5,3,0,0,0,0,0,0
1497128,68,20,1945,11,"male",1960,20,11,0,0,0,0,0,0
1497169,29,20,1984,12,"male",472,17,3,0,0,0,0,0,0
1497178,14,14,1999,5,"female",11,0,0,0,0,0,0,0,0
1497251,36,1,1977,1,"male",363,16,12,0,0,0,0,0,0
1497275,18,30,1995,10,"female",228,1135,497,1074,480,668,293,406,187
1497281,19,28,1994,6,"female",581,3118,1782,724,3589,484,2126,240,1463
1497292,40,1,1973,5,"male",1136,23,12,38,45,28,26,10,19
1497362,31,21,1982,3,"male",14,4,3,6,0,2,0,4,0
1497376,30,2,1983,10,"male",179,35,27,1,1,1,0,0,1
1497395,103,4,1910,5,"male",469,220,150,5,7,5,7,0,0
1497426,21,1,1992,6,"male",247,18,15,0,0,0,0,0,0
1497434,19,27,1994,3,"male",459,317,165,0,3,0,3,0,0
1497458,70,26,1943,4,"female",1704,54,22,2580,777,2580,299,0,478
1497473,27,17,1986,8,"male",450,202,63,6,69,3,36,3,33
1497481,57,28,1956,12,"male",146,38,27,0,2,0,2,0,0
1497491,28,17,1985,11,"male",587,815,725,19,35,19,31,0,4
1497511,22,25,1991,10,"male",492,587,515,184,105,52,65,132,40
1497543,17,28,1996,6,"male",17,2,2,0,0,0,0,0,0
1497565,15,26,1998,7,"female",386,50,41,45,13,45,10,0,3
1497580,46,22,1967,4,"male",53,5,5,0,0,0,0,0,0
1497592,57,22,1956,6,"female",384,38,17,2,8,2,8,0,0
1497599,66,20,1947,10,"female",879,0,0,0,0,0,0,0,0
1497628,25,1,1988,1,"male",102,1,0,0,0,0,0,0,0
1497689,24,18,1989,12,"male",222,1,1,1,0,0,0,1,0
1497735,13,2,2000,3,"female",1399,362,163,235,195,235,160,0,35
1497754,18,10,1995,8,"male",56,87,78,2,135,0,101,2,34
1497801,17,17,1996,12,"female",634,980,757,412,240,299,107,113,133
1497882,18,1,1995,4,"female",458,237,177,19,30,19,16,0,14
1497889,61,21,1952,1,"female",1721,49,29,31,60,17,44,14,16
1497891,49,28,1964,1,"male",122,319,226,671,598,186,153,485,445
1497894,25,10,1988,1,"male",419,170,47,0,0,0,0,0,0
1497897,61,29,1952,9,"female",1466,32,20,3,3,3,3,0,0
1497914,41,27,1972,7,"male",415,23,17,0,0,0,0,0,0
1497938,62,8,1951,10,"female",367,54,30,1,2,0,0,1,2
1497953,25,1,1988,1,"male",23,2,2,0,1,0,1,0,0
1497960,56,9,1957,3,"male",137,32,25,1,1,0,0,1,1
1497991,51,1,1962,4,"female",416,27,9,1,1,1,1,0,0
1498023,21,15,1992,5,"male",285,12,11,2,0,2,0,0,0
1498068,41,18,1972,12,"female",52,10,5,2,0,2,0,0,0
1498081,23,30,1990,8,"female",382,78,40,113,32,113,14,0,18
1498092,29,26,1984,3,"male",393,1,1,0,0,0,0,0,0
1498112,30,14,1983,2,"male",798,22,13,0,1,0,1,0,0
1498120,55,23,1958,12,"female",1021,167,118,88,53,88,40,0,13
1498127,17,24,1996,9,"female",19,499,483,1004,926,753,535,251,391
1498129,51,5,1962,12,"female",334,64,34,102,51,0,25,102,26
1498144,20,29,1993,10,"female",385,196,33,0,0,0,0,0,0
1498181,21,11,1992,2,"male",497,13,3,0,0,0,0,0,0
1498217,15,24,1998,6,"male",175,24,1,0,1,0,1,0,0
1498227,24,12,1989,8,"male",234,142,94,7,25,4,18,3,7
1498273,20,21,1993,4,"female",476,256,161,40,4,0,4,40,0
1498279,52,24,1961,12,"male",146,76,49,250,269,0,180,250,89
1498295,49,13,1964,4,"male",479,11,1,0,0,0,0,0,0
1498345,75,19,1938,9,"male",882,58,32,1,25,0,13,1,12
1498375,63,19,1950,5,"female",717,50,41,13,2,2,2,11,0
1498379,23,31,1990,12,"male",581,159,138,0,2,0,2,0,0
1498411,14,8,1999,6,"female",233,250,152,1288,762,406,230,882,532
1498413,24,27,1989,4,"female",322,65,16,974,64,974,51,0,13
1498439,43,27,1970,11,"male",41,53,48,30,37,30,21,0,16
1498441,36,2,1977,12,"male",471,120,82,2,1,2,1,0,0
1498454,26,6,1987,7,"male",409,302,126,68,71,68,71,0,0
1498537,43,12,1970,4,"female",1988,241,114,479,1031,479,837,0,194
1498577,17,11,1996,4,"female",411,991,396,444,717,444,460,0,257
1498609,16,10,1997,8,"female",350,42,23,1,0,1,0,0,0
1498623,39,15,1974,6,"male",39,101,92,0,2,0,0,0,2
1498657,43,17,1970,4,"male",518,11,7,0,1,0,1,0,0
1498670,67,2,1946,6,"male",1293,45,22,0,1,0,1,0,0
1498723,53,8,1960,2,"female",2025,229,107,1355,653,171,191,1184,462
1498752,68,17,1945,10,"female",1544,122,78,143,73,75,30,68,43
1498763,43,28,1970,8,"male",215,88,55,5,3,0,0,5,3
1498767,20,24,1993,8,"female",665,441,271,282,135,255,57,27,78
1498781,20,8,1993,12,"female",214,187,79,1,3,1,2,0,1
1498782,30,12,1983,3,"male",479,118,111,0,1,0,1,0,0
1498783,30,12,1983,2,"male",499,17,7,0,0,0,0,0,0
1498798,19,20,1994,1,"male",643,59,41,0,0,0,0,0,0
1498831,20,16,1993,1,"male",563,62,46,96,23,96,19,0,4
1498841,62,1,1951,4,"female",1324,64,21,20,12,20,8,0,4
1498859,17,31,1996,7,"male",675,1225,862,2589,1339,2589,1281,0,58
1498921,108,18,1905,6,"male",348,174,99,159,108,159,66,0,42
1498960,35,31,1978,7,"male",682,10,1,6,4,6,2,0,2
1498975,26,10,1987,9,"female",356,1,0,0,0,0,0,0,0
1498980,19,29,1994,12,"female",73,387,31,2,15,2,10,0,5
1499012,27,25,1986,7,"male",1582,204,89,3,1,3,1,0,0
1499015,25,3,1988,2,"male",257,93,72,0,3,0,3,0,0
1499034,60,31,1953,1,"female",594,37,3,0,0,0,0,0,0
1499044,26,18,1987,1,"male",223,56,49,288,11,288,9,0,2
1499052,23,19,1990,7,"female",1535,465,239,644,663,594,479,50,184
1499123,40,5,1973,5,"female",560,94,8,5,4,4,2,1,2
1499128,17,27,1996,10,"male",910,33,13,33,3,33,1,0,2
1499154,62,27,1951,2,"male",570,148,38,0,0,0,0,0,0
1499159,23,1,1990,7,"female",631,59,41,0,0,0,0,0,0
1499178,35,19,1978,5,"male",249,8,7,1,1,0,1,1,0
1499234,26,28,1987,7,"female",390,137,73,94,78,94,56,0,22
1499279,29,18,1984,10,"male",393,32,10,1,7,1,2,0,5
1499284,24,1,1989,6,"female",655,321,287,2,0,2,0,0,0
1499286,24,28,1989,6,"male",642,30,23,0,0,0,0,0,0
1499296,17,4,1996,8,"male",437,264,9,76,21,76,19,0,2
1499307,30,12,1983,3,"male",527,182,118,0,0,0,0,0,0
1499314,21,8,1992,6,"male",388,89,65,43,14,2,11,41,3
1499343,59,19,1954,12,"female",1458,178,109,521,48,0,35,521,13
1499388,100,3,1913,6,"male",271,690,597,366,414,62,183,304,231
1499412,46,16,1967,8,"female",352,48,26,77,132,77,42,0,90
1499422,21,21,1992,6,"female",535,217,154,0,1,0,1,0,0
1499428,15,21,1998,2,"female",554,1455,880,759,281,76,103,683,178
1499430,22,22,1991,12,"male",187,14,13,0,3,0,2,0,1
1499466,17,1,1996,10,"female",315,2014,388,46,1000,8,647,38,353
1499471,63,3,1950,9,"female",383,137,123,1,1,1,1,0,0
1499476,26,15,1987,9,"male",719,13,11,2,0,2,0,0,0
1499478,33,30,1980,4,"male",137,62,45,23,36,15,16,8,20
1499505,63,20,1950,2,"male",90,14,2,0,0,0,0,0,0
1499506,57,5,1956,6,"male",1388,549,56,17,37,17,12,0,25
1499550,26,14,1987,2,"male",455,97,44,254,92,0,35,254,57
1499554,34,6,1979,4,"male",710,102,74,99,99,75,56,24,43
1499569,38,8,1975,9,"male",270,109,77,507,111,507,91,0,20
1499582,21,8,1992,8,"male",314,2,2,0,0,0,0,0,0
1499610,22,31,1991,7,"male",443,149,130,70,0,70,0,0,0
1499670,22,21,1991,7,"male",254,707,545,157,345,100,264,57,81
1499680,57,7,1956,3,"male",484,71,62,45,38,0,5,45,33
1499699,24,1,1989,1,"female",244,207,44,1,0,1,0,0,0
1499721,105,23,1908,1,"female",1939,175,32,93,4,0,2,93,2
1499772,31,11,1982,12,"male",579,135,97,0,0,0,0,0,0
1499792,108,29,1905,5,"male",645,207,131,34,13,0,2,34,11
1499811,18,27,1995,3,"male",252,384,343,44,0,44,0,0,0
1499828,23,24,1990,10,"male",228,237,183,417,640,417,557,0,83
1499843,24,17,1989,7,"male",1360,956,711,127,29,127,25,0,4
1499898,17,10,1996,4,"male",520,598,483,190,70,151,42,39,28
1499904,91,23,1922,4,"female",437,19,10,4,8,4,3,0,5
1499921,16,3,1997,6,"male",386,31,23,0,0,0,0,0,0
1499950,17,26,1996,12,"male",767,623,443,0,7,0,7,0,0
1499956,31,5,1982,4,"female",93,29,21,7,13,1,11,6,2
1499965,30,24,1983,12,"male",381,408,322,2355,519,2355,469,0,50
1499972,56,5,1957,9,"female",1538,72,36,13,40,1,12,12,28
1499975,40,22,1973,9,"male",398,245,184,1,5,1,4,0,1
1499979,68,15,1945,3,"male",283,1827,1133,143,774,3,411,140,363
1499994,63,20,1950,12,"female",1349,79,40,139,84,109,43,30,41
1499996,47,2,1966,1,"male",1196,39,13,0,14,0,5,0,9
1500004,23,27,1990,5,"male",24,10,8,12,8,12,8,0,0
1500019,26,22,1987,8,"male",241,109,95,1,0,0,0,1,0
1500026,16,19,1997,1,"female",697,1676,374,69,129,69,115,0,14
1500030,23,27,1990,1,"male",220,65,45,21,4,21,4,0,0
1500044,19,9,1994,3,"female",428,214,160,8,29,8,10,0,19
1500068,18,13,1995,1,"female",264,301,151,36,18,17,10,19,8
1500081,58,6,1955,5,"male",1108,47,13,3,2,1,0,2,2
1500088,51,23,1962,1,"female",1713,405,217,49,45,42,37,7,8
1500108,16,22,1997,1,"male",439,431,265,21,57,2,10,19,47
1500122,83,22,1930,8,"female",1097,25,16,79,1,79,1,0,0
1500158,21,9,1992,9,"male",799,97,56,368,419,212,343,156,76
1500165,32,7,1981,4,"male",365,19,16,0,1,0,1,0,0
1500166,25,16,1988,1,"male",296,69,45,0,0,0,0,0,0
1500168,65,2,1948,3,"female",1030,30,17,0,0,0,0,0,0
1500182,31,30,1982,9,"female",946,133,66,0,12,0,0,0,12
1500248,54,4,1959,6,"female",501,83,73,2663,127,2662,83,1,44
1500278,16,16,1997,6,"male",239,47,43,22,2,22,0,0,2
1500285,103,23,1910,9,"male",944,363,319,40,167,40,113,0,54
1500300,14,20,1999,9,"female",453,297,158,517,213,33,91,484,122
1500301,20,15,1993,5,"male",155,52,42,0,13,0,8,0,5
1500308,60,11,1953,12,"male",390,103,49,26,14,26,14,0,0
1500321,82,14,1931,3,"female",1512,55,8,5,1,0,1,5,0
1500324,23,6,1990,11,"male",525,130,88,1,0,1,0,0,0
1500339,103,21,1910,5,"male",697,890,591,7,19,7,19,0,0
1500358,34,24,1979,9,"male",10,4,3,0,0,0,0,0,0
1500368,107,6,1906,8,"male",69,11,5,0,2,0,1,0,1
1500396,27,29,1986,12,"male",298,191,143,25,4,25,4,0,0
1500397,26,11,1987,4,"female",318,68,54,2,3,2,3,0,0
1500424,45,6,1968,3,"female",1316,525,344,1023,768,608,221,415,547
1500429,22,1,1991,1,"male",233,75,67,19,9,19,5,0,4
1500432,16,7,1997,1,"male",509,1465,1093,215,841,158,355,57,486
1500476,19,1,1994,1,"male",313,162,90,0,77,0,51,0,26
1500480,103,22,1910,5,"male",840,98,73,42,52,42,29,0,23
1500493,108,27,1905,9,"male",1028,329,202,1,3,1,3,0,0
1500517,42,4,1971,3,"male",1949,348,119,0,82,0,36,0,46
1500521,102,1,1911,1,"male",796,22,15,12,1,7,1,5,0
1500522,77,9,1936,4,"female",13,0,0,3,3,0,0,3,3
1500550,28,16,1985,4,"female",441,119,82,36,27,8,14,28,13
1500552,18,2,1995,11,"male",375,333,191,23,74,23,56,0,18
1500556,26,1,1987,1,"male",557,156,102,1,0,1,0,0,0
1500576,20,17,1993,6,"female",467,14,10,0,0,0,0,0,0
1500585,100,14,1913,4,"female",973,37,21,6,1,6,1,0,0
1500599,108,5,1905,7,"male",243,51,47,0,0,0,0,0,0
1500608,59,1,1954,7,"female",310,24,17,5,3,1,3,4,0
1500611,27,3,1986,5,"female",14,63,36,4,8,4,8,0,0
1500612,55,6,1958,3,"female",1403,36,28,197,24,197,11,0,13
1500645,18,1,1995,1,"female",495,3740,1922,1696,2470,1690,1781,6,689
1500650,36,7,1977,10,"male",1523,80,43,0,1,0,1,0,0
1500651,28,21,1985,7,"male",291,79,22,14,8,0,3,14,5
1500653,55,17,1958,9,"female",976,422,181,68,303,2,165,66,138
1500696,30,8,1983,1,"female",425,206,126,130,360,124,202,6,158
1500720,16,5,1997,6,"male",221,96,86,12,0,0,0,12,0
1500726,23,17,1990,9,"male",488,152,123,0,0,0,0,0,0
1500747,19,13,1994,7,"male",456,1128,911,16,12,16,12,0,0
1500748,19,24,1994,4,"male",311,115,92,87,1,87,0,0,1
1500762,108,5,1905,1,"female",1034,176,100,37,1,36,1,1,0
1500767,15,20,1998,11,"female",465,152,96,0,2,0,2,0,0
1500797,19,27,1994,5,"female",558,441,157,14,10,0,0,14,10
1500830,66,27,1947,1,"female",1598,36,19,65,72,15,15,50,57
1500838,31,18,1982,1,"female",670,29,21,17,4,16,2,1,2
1500856,34,29,1979,12,"male",136,165,150,35,27,25,15,10,12
1500861,21,6,1992,2,"male",495,194,138,104,69,102,59,2,10
1500886,63,12,1950,10,"male",536,77,27,8,66,8,43,0,23
1500902,31,30,1982,3,"male",31,63,20,18,35,17,29,1,6
1500913,22,4,1991,2,"male",134,10,9,0,0,0,0,0,0
1500914,43,1,1970,1,"male",478,24,22,0,3,0,0,0,3
1500939,22,14,1991,8,"female",238,35,7,69,41,69,35,0,6
1500952,75,1,1938,6,"male",319,12,8,0,7,0,0,0,7
1500957,14,26,1999,1,"male",219,89,80,54,1,1,1,53,0
1500981,46,3,1967,5,"female",157,189,74,87,70,87,30,0,40
1501002,64,22,1949,3,"male",2243,68,56,6,13,4,9,2,4
1501030,24,17,1989,9,"male",285,77,57,106,23,106,22,0,1
1501046,19,8,1994,6,"female",250,13,2,125,78,39,55,86,23
1501047,33,5,1980,8,"male",169,73,69,0,2,0,2,0,0
1501067,16,27,1997,8,"female",411,214,175,340,123,160,62,180,61
1501073,16,5,1997,8,"female",525,91,64,2,2,0,2,2,0
1501091,20,10,1993,5,"male",211,91,71,33,20,33,17,0,3
1501096,17,9,1996,1,"male",531,169,107,74,21,74,15,0,6
1501118,102,15,1911,10,"male",1799,24,19,3,0,0,0,3,0
1501131,48,10,1965,8,"male",227,29,23,12,10,12,2,0,8
1501152,24,28,1989,8,"female",454,12,5,1,1,1,1,0,0
1501162,36,7,1977,9,"female",161,144,88,55,18,41,3,14,15
1501164,56,6,1957,2,"male",802,1445,1010,0,0,0,0,0,0
1501175,18,14,1995,3,"female",354,434,100,1,5,0,5,1,0
1501176,19,28,1994,3,"male",387,652,557,14,0,1,0,13,0
1501193,60,17,1953,6,"female",1562,4794,3538,586,1318,560,960,26,358
1501203,23,30,1990,11,"female",302,206,129,1195,632,754,251,441,381
1501206,24,27,1989,9,"male",350,79,36,0,2,0,2,0,0
1501260,20,10,1993,8,"female",586,39,13,0,4,0,0,0,4
1501272,55,22,1958,2,"male",170,0,0,0,0,0,0,0,0
1501288,19,23,1994,4,"male",293,85,79,35,0,35,0,0,0
1501304,29,18,1984,6,"female",322,72,41,80,99,18,17,62,82
1501308,68,17,1945,8,"female",36,282,123,35,45,10,33,25,12
1501312,34,25,1979,1,"male",350,18,17,0,0,0,0,0,0
1501356,32,14,1981,1,"female",352,268,137,99,223,63,73,36,150
1501428,36,25,1977,5,"female",482,61,45,362,273,362,263,0,10
1501429,15,7,1998,8,"male",534,110,50,310,66,310,66,0,0
1501445,37,19,1976,7,"female",151,53,34,265,234,259,109,6,125
1501464,24,22,1989,12,"female",16,19,18,37,35,37,28,0,7
1501513,23,25,1990,7,"female",958,203,70,2,2,2,2,0,0
1501528,103,12,1910,12,"male",1111,860,631,7,28,7,15,0,13
1501561,18,6,1995,8,"male",1054,1024,455,2,12,2,11,0,1
1501573,17,25,1996,7,"female",368,970,552,397,587,292,137,105,450
1501576,59,28,1954,4,"female",306,8,4,152,38,0,0,152,38
1501583,29,20,1984,2,"male",128,25,24,34,30,34,24,0,6
1501616,18,17,1995,6,"male",237,179,47,415,130,0,57,415,73
1501654,18,4,1995,3,"male",657,893,727,1,1,1,0,0,1
1501689,23,1,1990,1,"male",133,11,1,8,0,8,0,0,0
1501697,27,7,1986,4,"male",759,148,50,9,2,9,2,0,0
1501702,31,27,1982,12,"male",214,88,78,5,1,5,1,0,0
1501726,24,9,1989,8,"male",155,106,57,27,7,27,3,0,4
1501755,34,27,1979,8,"female",286,18,14,152,36,86,1,66,35
1501769,57,10,1956,3,"female",743,102,46,761,193,0,59,761,134
1501774,31,24,1982,10,"male",302,72,55,56,18,56,14,0,4
1501786,26,16,1987,3,"female",102,148,41,10,19,10,18,0,1
1501829,15,26,1998,12,"female",156,31,26,1,0,1,0,0,0
1501856,19,15,1994,2,"male",151,52,30,5,4,0,0,5,4
1501871,33,6,1980,6,"male",109,2,2,1,0,1,0,0,0
1501899,44,13,1969,5,"female",230,163,94,225,49,225,18,0,31
1501918,99,16,1914,3,"male",855,216,111,44,10,44,10,0,0
1501934,43,1,1970,4,"male",348,203,103,7,12,7,11,0,1
1501937,58,25,1955,5,"male",266,25,19,0,0,0,0,0,0
1501940,23,5,1990,8,"male",216,41,34,9,4,9,4,0,0
1501976,28,5,1985,1,"female",731,195,102,79,121,79,47,0,74
1501999,63,20,1950,12,"female",816,104,87,4,54,0,42,4,12
1502001,40,11,1973,7,"female",350,13,6,1,0,1,0,0,0
1502067,23,10,1990,5,"male",297,113,43,5,2,5,1,0,1
1502068,28,8,1985,1,"female",542,131,95,44,10,8,2,36,8
1502080,52,2,1961,9,"male",299,11,11,0,0,0,0,0,0
1502083,19,8,1994,8,"male",267,156,92,381,270,47,73,334,197
1502096,32,8,1981,9,"male",1321,111,55,1,44,0,8,1,36
1502144,22,22,1991,10,"male",137,53,37,20,13,20,5,0,8
1502155,36,23,1977,12,"male",36,9,8,0,0,0,0,0,0
1502159,108,22,1905,6,"female",2192,302,124,163,323,124,268,39,55
1502168,90,8,1923,12,"male",2198,134,96,45,9,45,9,0,0
1502173,25,1,1988,1,"male",36,18,17,147,24,147,16,0,8
1502185,18,8,1995,10,"female",88,40,27,0,0,0,0,0,0
1502188,101,7,1912,7,"male",349,31,29,6,3,0,1,6,2
1502195,30,16,1983,5,"female",622,105,51,0,0,0,0,0,0
1502197,19,1,1994,1,"male",150,115,74,44,31,44,30,0,1
1502213,17,1,1996,2,"male",222,297,224,5,31,5,23,0,8
1502223,28,29,1985,12,"male",262,125,99,0,2,0,0,0,2
1502229,20,6,1993,4,"female",286,131,78,6,19,6,16,0,3
1502240,19,9,1994,8,"male",859,18,4,0,0,0,0,0,0
1502253,35,8,1978,1,"male",710,27,20,0,2,0,1,0,1
1502271,59,6,1954,9,"male",399,13,8,16,16,16,16,0,0
1502298,36,13,1977,5,"male",303,171,115,85,49,85,36,0,13
1502300,37,11,1976,9,"female",429,179,151,252,199,208,135,44,64
1502329,64,30,1949,12,"female",132,33,26,5,0,5,0,0,0
1502339,29,2,1984,8,"female",308,47,23,21,19,21,18,0,1
1502346,18,30,1995,7,"male",414,263,175,15,79,15,46,0,33
1502361,23,20,1990,10,"male",268,0,0,0,0,0,0,0,0
1502377,15,2,1998,8,"female",295,337,129,49,88,24,23,25,65
1502388,90,7,1923,2,"male",984,609,274,515,592,175,306,340,286
1502390,30,22,1983,8,"male",303,154,89,33,9,31,6,2,3
1502399,17,28,1996,10,"female",416,1,1,1,0,0,0,1,0
1502422,98,13,1915,3,"female",222,262,201,9,22,9,21,0,1
1502425,21,27,1992,10,"male",340,143,89,0,0,0,0,0,0
1502478,19,28,1994,12,"female",559,273,108,0,0,0,0,0,0
1502519,18,4,1995,6,"male",391,137,86,42,10,33,4,9,6
1502525,60,6,1953,9,"male",1405,176,125,69,18,44,10,25,8
1502528,25,10,1988,6,"female",658,286,177,9,35,1,18,8,17
1502532,19,21,1994,5,"female",423,311,162,121,117,121,59,0,58
1502535,59,27,1954,2,"male",753,74,45,0,1,0,1,0,0
1502563,23,25,1990,4,"male",400,217,192,817,86,817,81,0,5
1502575,108,21,1905,3,"male",1747,417,285,286,379,126,111,160,268
1502595,53,28,1960,2,"male",1163,73,33,13,21,10,15,3,6
1502596,26,5,1987,6,"male",76,0,0,1,1,1,1,0,0
1502603,19,19,1994,4,"male",709,972,795,213,166,213,145,0,21
1502608,72,30,1941,10,"male",1582,58,46,1,37,0,11,1,26
1502609,16,15,1997,2,"male",247,77,60,0,1,0,1,0,0
1502612,29,5,1984,3,"female",709,87,6,0,0,0,0,0,0
1502613,50,28,1963,11,"female",297,55,40,276,57,231,20,45,37
1502628,30,20,1983,10,"male",45,1,1,0,0,0,0,0,0
1502639,15,23,1998,4,"male",526,18,13,0,0,0,0,0,0
1502657,63,1,1950,4,"female",1557,35,5,3,3,0,1,3,2
1502669,17,7,1996,3,"male",120,16,9,8,25,5,24,3,1
1502681,18,7,1995,3,"female",277,1886,700,346,861,344,695,2,166
1502682,25,12,1988,1,"male",427,1135,1072,101,224,101,170,0,54
1502713,28,1,1985,7,"male",321,0,0,0,0,0,0,0,0
1502715,53,31,1960,1,"male",30,13,9,9,13,9,4,0,9
1502749,21,13,1992,6,"female",846,883,297,835,1563,248,639,587,924
1502759,22,5,1991,12,"female",169,652,267,21,17,21,17,0,0
1502762,14,16,1999,4,"male",415,439,399,195,5,69,3,126,2
1502770,63,7,1950,11,"male",1554,639,487,20,32,20,15,0,17
1502787,19,24,1994,8,"male",327,49,38,108,2,108,2,0,0
1502797,24,6,1989,12,"male",524,147,69,2,2,2,2,0,0
1502809,17,14,1996,4,"male",336,269,168,424,376,402,243,22,133
1502810,98,11,1915,10,"female",335,134,95,3,46,3,37,0,9
1502820,25,8,1988,10,"male",393,176,91,128,82,128,54,0,28
1502847,39,9,1974,6,"female",751,287,227,433,156,167,42,266,114
1502857,35,9,1978,5,"female",373,249,120,10,177,7,149,3,28
1502861,41,1,1972,1,"male",330,18,14,0,6,0,4,0,2
1502863,100,1,1913,3,"male",2072,620,335,279,534,151,186,128,348
1502867,18,18,1995,7,"female",243,454,195,177,464,177,385,0,79
1502872,49,25,1964,6,"female",1686,173,68,92,18,91,16,1,2
1502891,49,11,1964,3,"female",1572,4,3,7,1,7,1,0,0
1502893,24,23,1989,3,"female",157,40,5,4,6,4,5,0,1
1502898,24,27,1989,3,"male",359,587,402,972,396,799,233,173,163
1502906,63,31,1950,12,"male",967,17,10,0,0,0,0,0,0
1502907,27,10,1986,8,"male",465,253,244,24,9,24,9,0,0
1502978,65,21,1948,5,"male",572,275,158,36,292,33,81,3,211
1502990,50,31,1963,3,"female",736,264,55,72,10,66,8,6,2
1502996,25,1,1988,1,"female",132,0,0,0,0,0,0,0,0
1503022,35,12,1978,1,"female",509,178,162,148,22,147,15,1,7
1503037,18,13,1995,3,"male",529,106,94,0,0,0,0,0,0
1503086,51,13,1962,1,"female",1501,1,1,31,10,31,9,0,1
1503092,25,15,1988,2,"male",432,24,18,3,0,3,0,0,0
1503096,25,9,1988,5,"female",258,68,22,189,25,189,7,0,18
1503097,18,1,1995,5,"female",446,175,69,59,13,8,0,51,13
1503105,25,3,1988,6,"male",174,77,34,1,0,1,0,0,0
1503145,61,23,1952,11,"female",424,75,63,1,8,0,3,1,5
1503199,24,22,1989,6,"male",187,42,21,35,39,28,34,7,5
1503202,17,25,1996,8,"male",443,159,113,347,6,266,3,81,3
1503233,25,7,1988,5,"male",470,200,146,7,3,0,2,7,1
1503238,14,16,1999,11,"male",13,0,0,0,0,0,0,0,0
1503272,58,28,1955,6,"female",210,94,56,2,5,0,2,2,3
1503275,15,14,1998,4,"female",85,71,45,0,0,0,0,0,0
1503290,23,11,1990,6,"male",303,16,9,0,0,0,0,0,0
1503314,21,8,1992,10,"male",328,128,98,57,26,57,22,0,4
1503320,19,19,1994,1,"female",504,78,56,40,46,40,43,0,3
1503345,18,16,1995,2,"male",421,109,32,0,0,0,0,0,0
1503379,19,27,1994,3,"male",233,221,168,0,0,0,0,0,0
1503418,54,9,1959,11,"male",1335,16,11,0,0,0,0,0,0
1503423,20,23,1993,5,"male",783,57,49,11,0,0,0,11,0
1503425,25,31,1988,7,"male",413,60,47,101,20,0,11,101,9
1503436,41,15,1972,4,"female",1572,167,61,259,290,227,103,32,187
1503439,22,8,1991,8,"male",19,0,0,4,0,0,0,4,0
1503472,66,18,1947,5,"male",827,49,39,51,47,51,44,0,3
1503482,84,23,1929,6,"female",1698,2650,408,4,23,4,20,0,3
1503484,44,5,1969,5,"male",401,51,8,1,3,1,2,0,1
1503486,22,29,1991,7,"female",314,27,11,412,35,412,35,0,0
1503509,32,15,1981,8,"female",249,102,82,177,80,177,42,0,38
1503510,103,23,1910,12,"male",1023,425,252,326,41,279,30,47,11
1503512,69,25,1944,8,"female",1368,27,11,5,2,5,0,0,2
1503524,33,1,1980,2,"male",115,2,1,2,20,2,2,0,18
1503530,14,21,1999,6,"male",181,550,457,1237,317,0,58,1237,259
1503531,68,18,1945,9,"male",1015,18,12,0,0,0,0,0,0
1503544,19,10,1994,7,"male",590,278,228,18,3,18,3,0,0
1503557,15,14,1998,6,"female",253,105,52,5,0,5,0,0,0
1503576,46,20,1967,10,"male",172,100,58,38,24,38,22,0,2
1503586,43,31,1970,12,"female",634,55,36,2,1,0,0,2,1
1503604,64,19,1949,4,"male",970,12,9,3,4,0,2,3,2
1503631,47,3,1966,3,"male",1091,144,73,1,14,0,7,1,7
1503661,53,24,1960,3,"male",54,37,27,6,27,6,6,0,21
1503665,19,22,1994,9,"female",437,294,201,234,153,199,118,35,35
1503689,23,20,1990,5,"male",631,28,26,34,18,34,14,0,4
1503771,54,1,1959,4,"male",45,8,8,12,16,12,5,0,11
1503823,59,21,1954,11,"female",510,65,33,0,4,0,2,0,2
1503847,99,24,1914,8,"male",2162,25,9,7,0,0,0,7,0
1503865,17,19,1996,6,"male",35,126,114,6,3,6,3,0,0
1503869,37,3,1976,11,"male",619,207,78,462,124,462,74,0,50
1503892,27,5,1986,3,"male",127,120,85,721,410,721,222,0,188
1503899,102,9,1911,1,"female",413,86,24,441,397,56,154,385,243
1503911,19,31,1994,12,"male",375,167,93,1,0,0,0,1,0
1503924,13,12,2000,6,"female",15,44,25,7,10,7,5,0,5
1503939,64,18,1949,12,"female",646,23,21,5,0,5,0,0,0
1503960,39,23,1974,6,"female",810,10,8,0,0,0,0,0,0
1503965,24,18,1989,1,"male",1230,341,125,9,15,5,6,4,9
1503975,49,27,1964,6,"female",94,88,54,212,90,4,36,208,54
1503992,41,22,1972,1,"female",607,17,7,0,0,0,0,0,0
1504003,20,25,1993,6,"male",396,127,87,67,14,0,2,67,12
1504013,47,7,1966,3,"male",586,426,211,436,316,386,138,50,178
1504023,14,20,1999,1,"male",388,515,380,17,8,1,0,16,8
1504030,31,18,1982,4,"male",583,46,25,2,0,2,0,0,0
1504032,20,20,1993,7,"female",338,67,52,0,0,0,0,0,0
1504055,68,18,1945,2,"female",269,37,31,129,74,0,37,129,37
1504079,38,13,1975,9,"female",427,25,9,20,4,20,1,0,3
1504084,46,28,1967,10,"male",748,29,11,1,3,1,2,0,1
1504095,34,15,1979,6,"female",660,134,22,0,7,0,2,0,5
1504128,30,27,1983,9,"male",26,143,128,14,85,7,61,7,24
1504177,65,17,1948,7,"female",987,59,22,33,125,0,82,33,43
1504192,20,27,1993,5,"male",525,41,20,0,5,0,4,0,1
1504193,81,26,1932,11,"female",482,54,44,149,17,149,10,0,7
1504224,25,1,1988,1,"male",26,53,33,31,35,29,17,2,18
1504284,15,19,1998,10,"male",14,6,4,2,0,2,0,0,0
1504295,25,16,1988,6,"male",744,541,407,43,34,42,17,1,17
1504297,22,14,1991,8,"male",930,455,202,0,0,0,0,0,0
1504318,32,23,1981,2,"male",574,39,15,33,9,33,4,0,5
1504334,103,22,1910,12,"male",1457,199,78,2,2,2,2,0,0
1504342,62,18,1951,11,"male",831,9,3,0,0,0,0,0,0
1504363,24,29,1989,9,"male",583,272,161,2,5,2,3,0,2
1504376,20,11,1993,11,"male",147,7,1,0,0,0,0,0,0
1504388,54,4,1959,8,"female",681,68,45,94,34,94,23,0,11
1504405,19,16,1994,2,"female",313,524,449,806,797,806,570,0,227
1504420,19,14,1994,2,"male",920,1316,1004,13,19,13,17,0,2
1504429,42,25,1971,8,"male",268,20,14,0,0,0,0,0,0
1504454,21,5,1992,2,"male",74,23,22,18,1,18,0,0,1
1504465,19,23,1994,10,"male",324,77,31,3,9,3,6,0,3
1504478,21,21,1992,6,"female",286,74,23,12,4,12,4,0,0
1504484,23,21,1990,5,"female",354,171,80,26,1,0,1,26,0
1504492,58,23,1955,7,"male",286,57,24,24,1,24,1,0,0
1504508,46,14,1967,3,"male",223,250,158,350,79,350,78,0,1
1504510,51,4,1962,10,"female",1580,236,118,185,152,183,100,2,52
1504536,63,15,1950,10,"female",2064,198,112,1467,1199,1465,735,2,464
1504544,34,27,1979,9,"female",462,26,20,1,1,1,1,0,0
1504555,29,14,1984,4,"male",288,64,50,6,0,6,0,0,0
1504559,81,30,1932,7,"male",1063,464,197,408,567,388,246,20,321
1504563,28,20,1985,1,"female",1437,603,361,0,0,0,0,0,0
1504570,37,1,1976,2,"female",865,184,138,0,0,0,0,0,0
1504579,18,17,1995,10,"female",679,138,72,25,1,23,1,2,0
1504585,71,5,1942,11,"female",725,29,20,197,64,0,7,197,57
1504596,14,20,1999,3,"male",403,255,125,269,199,269,149,0,50
1504601,50,15,1963,7,"male",43,245,239,504,5,504,2,0,3
1504638,60,6,1953,1,"female",1009,123,65,108,114,108,73,0,41
1504663,19,1,1994,1,"female",119,7,0,0,0,0,0,0,0
1504678,19,14,1994,8,"male",412,13,11,0,0,0,0,0,0
1504689,28,21,1985,11,"female",148,48,34,0,6,0,3,0,3
1504695,17,13,1996,1,"male",374,254,100,3,0,3,0,0,0
1504701,20,4,1993,4,"male",428,193,97,6,9,0,0,6,9
1504755,34,19,1979,8,"female",667,63,46,0,2,0,0,0,2
1504756,21,31,1992,12,"male",422,159,59,35,54,35,44,0,10
1504780,108,1,1905,1,"male",286,444,371,16,29,0,13,16,16
1504811,39,30,1974,6,"male",420,59,28,2,8,0,1,2,7
1504823,47,10,1966,7,"female",737,81,57,1105,399,1101,334,4,65
1504873,23,8,1990,12,"female",612,126,49,0,1,0,0,0,1
1504895,18,7,1995,7,"male",1073,905,813,5,16,5,12,0,4
1504926,64,21,1949,11,"male",1867,23,5,9,1,0,0,9,1
1504932,20,11,1993,9,"female",269,197,166,45,135,20,52,25,83
1504934,20,16,1993,7,"male",479,280,155,149,88,88,44,61,44
1504947,19,11,1994,9,"male",671,1770,1443,272,680,134,478,138,202
1504952,59,10,1954,4,"male",251,135,83,25,39,0,13,25,26
1504976,33,1,1980,1,"female",204,9,6,0,0,0,0,0,0
1504980,26,12,1987,5,"male",201,317,158,6,62,6,50,0,12
1505025,108,20,1905,5,"male",110,105,92,89,1,89,1,0,0
1505029,84,7,1929,2,"female",1616,54,10,15,22,2,9,13,13
1505040,27,22,1986,5,"male",48,32,6,4,0,4,0,0,0
1505056,15,13,1998,10,"female",634,2990,901,430,3339,178,2067,252,1272
1505077,30,28,1983,11,"female",255,12,5,245,42,16,9,229,33
1505084,27,26,1986,6,"female",112,20,12,0,0,0,0,0,0
1505085,23,11,1990,5,"female",157,32,20,95,31,95,26,0,5
1505093,20,29,1993,12,"male",594,92,20,6,2,6,0,0,2
1505096,27,1,1986,4,"male",1321,76,28,0,19,0,7,0,12
1505112,27,12,1986,3,"male",502,51,49,145,24,145,20,0,4
1505130,19,1,1994,1,"male",249,213,120,17,10,0,5,17,5
1505133,25,1,1988,1,"female",50,39,37,0,1,0,1,0,0
1505140,61,30,1952,9,"male",1751,69,21,36,14,0,0,36,14
1505149,17,2,1996,2,"male",443,43,32,1,1,0,0,1,1
1505156,29,11,1984,8,"female",578,8,1,0,0,0,0,0,0
1505178,27,11,1986,2,"female",197,219,211,0,0,0,0,0,0
1505193,25,18,1988,12,"male",611,27,20,6,0,6,0,0,0
1505263,33,4,1980,2,"male",489,146,127,0,1,0,1,0,0
1505307,55,31,1958,12,"male",688,67,31,19,22,19,4,0,18
1505317,54,3,1959,8,"female",1177,35,14,1,1,0,1,1,0
1505342,56,22,1957,1,"female",943,81,31,254,175,38,55,216,120
1505398,22,9,1991,12,"female",780,164,113,1607,1210,69,106,1538,1104
1505430,29,11,1984,2,"male",197,74,67,10,3,10,0,0,3
1505448,75,9,1938,10,"male",1170,14,5,0,1,0,1,0,0
1505450,20,10,1993,1,"male",139,166,129,3,4,3,4,0,0
1505486,66,3,1947,11,"male",419,10,7,0,0,0,0,0,0
1505534,32,21,1981,10,"male",479,104,82,1,1,0,1,1,0
1505542,108,12,1905,5,"male",235,138,126,20,25,20,6,0,19
1505555,33,2,1980,5,"female",467,57,49,67,9,67,5,0,4
1505557,19,29,1994,9,"female",461,585,300,105,138,105,75,0,63
1505559,58,12,1955,7,"female",560,99,82,0,8,0,4,0,4
1505592,25,5,1988,1,"female",145,260,163,28,130,14,85,14,45
1505594,18,23,1995,9,"female",359,590,202,1018,450,596,307,422,143
1505603,57,15,1956,6,"female",34,21,15,62,12,62,6,0,6
1505621,24,4,1989,6,"female",192,32,29,69,3,61,2,8,1
1505626,28,8,1985,5,"male",651,519,413,26,156,26,155,0,1
1505637,15,16,1998,4,"female",371,1229,1048,57,1386,57,1073,0,313
1505660,31,10,1982,7,"male",130,49,41,8,68,3,32,5,36
1505668,17,12,1996,5,"female",137,625,543,18,62,17,31,1,31
1505672,16,15,1997,12,"female",108,611,461,90,48,89,36,1,12
1505690,30,9,1983,6,"male",1030,1,1,0,0,0,0,0,0
1505703,18,1,1995,6,"male",410,186,122,23,3,23,3,0,0
1505720,49,12,1964,5,"male",237,1,1,0,0,0,0,0,0
1505736,15,9,1998,9,"female",3,4,4,2,0,2,0,0,0
1505747,67,7,1946,7,"female",740,114,62,0,0,0,0,0,0
1505754,18,1,1995,11,"male",344,48,24,46,2,46,2,0,0
1505774,17,8,1996,7,"female",9,98,80,518,78,502,65,16,13
1505810,28,10,1985,12,"female",213,606,186,957,867,17,148,940,719
1505904,102,19,1911,4,"female",905,331,269,0,4,0,4,0,0
1505933,27,10,1986,6,"female",187,81,66,73,49,73,28,0,21
1505956,73,18,1940,11,"female",644,122,55,376,432,376,267,0,165
1505959,40,14,1973,12,"male",428,37,35,0,3,0,3,0,0
1505969,103,25,1910,12,"male",726,35,29,0,1,0,1,0,0
1505971,32,25,1981,12,"male",228,0,0,0,0,0,0,0,0
1505979,18,16,1995,7,"male",416,426,246,254,164,251,98,3,66
1505983,45,28,1968,9,"female",1684,317,233,289,125,288,38,1,87
1506027,16,1,1997,5,"male",19,29,25,4,1,4,0,0,1
1506038,101,12,1912,12,"female",33,22,18,15,9,15,9,0,0
1506049,61,20,1952,9,"male",285,5,2,3,0,0,0,3,0
1506059,22,23,1991,8,"female",645,68,37,99,95,99,56,0,39
1506076,66,19,1947,7,"female",971,138,110,686,230,0,29,686,201
1506100,18,10,1995,2,"female",457,275,110,856,179,114,74,742,105
1506104,62,1,1951,9,"female",1545,21,10,2,2,2,0,0,2
1506171,26,1,1987,1,"female",315,45,37,2,0,2,0,0,0
1506185,74,10,1939,8,"female",784,43,25,15,7,0,5,15,2
1506196,35,8,1978,12,"female",466,87,46,0,0,0,0,0,0
1506199,14,5,1999,7,"female",266,79,35,2452,4251,1589,326,863,3925
1506220,21,22,1992,9,"male",382,27,14,2,2,0,2,2,0
1506229,49,5,1964,5,"male",365,15,13,0,1,0,1,0,0
1506230,39,31,1974,8,"male",443,276,237,5,0,5,0,0,0
1506243,52,14,1961,12,"male",462,521,323,20,2,20,2,0,0
1506246,23,30,1990,4,"male",352,44,33,10,0,10,0,0,0
1506255,14,26,1999,11,"male",382,221,189,4,0,0,0,4,0
1506288,35,24,1978,6,"male",733,13,5,4,14,0,4,4,10
1506290,19,15,1994,5,"female",506,245,148,224,315,224,311,0,4
1506299,27,9,1986,4,"female",456,154,118,20,26,20,24,0,2
1506319,29,31,1984,10,"male",526,198,119,1,0,0,0,1,0
1506337,20,23,1993,10,"female",93,298,191,557,149,557,130,0,19
1506348,17,9,1996,12,"male",486,31,12,4,2,0,0,4,2
1506351,23,22,1990,11,"male",439,48,27,0,2,0,1,0,1
1506367,55,13,1958,8,"male",882,315,133,36,93,11,27,25,66
1506389,39,31,1974,1,"male",807,51,40,7,1,7,1,0,0
1506418,28,29,1985,12,"male",317,34,33,0,0,0,0,0,0
1506450,55,22,1958,2,"male",27,9,6,6,0,6,0,0,0
1506456,17,27,1996,3,"male",849,1139,636,401,381,266,280,135,101
1506470,17,29,1996,6,"male",183,43,39,1,1,1,1,0,0
1506476,28,2,1985,7,"male",73,26,21,11,6,4,4,7,2
1506486,19,27,1994,3,"male",422,268,101,73,14,12,6,61,8
1506487,18,10,1995,6,"male",292,187,147,0,9,0,7,0,2
1506495,14,7,1999,11,"female",357,317,109,137,16,126,8,11,8
1506505,108,26,1905,1,"female",1133,457,217,22,18,22,18,0,0
1506510,21,19,1992,8,"male",424,122,85,5,0,3,0,2,0
1506524,25,1,1988,1,"male",14,7,7,2,0,2,0,0,0
1506529,53,11,1960,9,"female",1024,187,127,52,293,15,78,37,215
1506541,55,4,1958,12,"female",533,133,58,500,165,34,100,466,65
1506546,18,14,1995,12,"male",176,15,15,0,0,0,0,0,0
1506555,35,27,1978,2,"female",430,2,2,0,0,0,0,0,0
1506581,36,23,1977,2,"female",637,217,68,57,274,57,75,0,199
1506588,69,10,1944,5,"female",1131,354,141,43,28,43,8,0,20
1506614,27,12,1986,5,"male",378,158,130,4,14,4,14,0,0
1506616,38,2,1975,5,"female",150,22,20,10,9,10,5,0,4
1506618,14,11,1999,7,"female",94,239,118,301,222,235,148,66,74
1506620,23,1,1990,1,"male",394,256,147,0,0,0,0,0,0
1506670,28,13,1985,5,"male",296,96,52,1,8,0,5,1,3
1506673,59,21,1954,1,"female",332,60,10,263,128,0,9,263,119
1506678,60,26,1953,4,"female",986,18,13,121,19,121,15,0,4
1506683,55,8,1958,4,"female",15,36,28,315,47,305,22,10,25
1506686,17,1,1996,1,"male",688,1404,1093,87,7,87,4,0,3
1506690,46,6,1967,11,"female",94,24,6,10,0,10,0,0,0
1506729,28,4,1985,4,"male",426,14,9,0,0,0,0,0,0
1506751,18,13,1995,1,"male",177,303,140,0,9,0,8,0,1
1506759,16,27,1997,5,"female",378,447,292,16,104,15,56,1,48
1506778,26,1,1987,12,"male",183,23,18,0,0,0,0,0,0
1506794,18,13,1995,10,"female",389,67,22,3,11,3,11,0,0
1506811,73,8,1940,2,"female",1021,158,110,5,9,0,6,5,3
1506841,19,11,1994,11,"female",464,841,545,415,861,378,652,37,209
1506870,43,16,1970,10,"female",430,30,11,40,3,40,3,0,0
1506874,25,1,1988,1,"male",241,6,4,2,0,2,0,0,0
1506877,30,14,1983,2,"male",540,227,174,100,27,99,24,1,3
1506879,53,29,1960,3,"female",660,59,23,82,134,4,22,78,112
1506884,31,18,1982,9,"female",471,171,18,0,0,0,0,0,0
1506905,34,2,1979,10,"male",109,95,45,0,0,0,0,0,0
1506908,24,28,1989,4,"female",1077,152,75,9,2,4,2,5,0
1506916,21,3,1992,1,"male",18,14,13,2,1,2,1,0,0
1506956,40,4,1973,9,"male",382,32,23,0,0,0,0,0,0
1506963,30,3,1983,10,"male",513,324,233,87,46,62,21,25,25
1506965,66,28,1947,7,"male",141,7,3,15,1,0,0,15,1
1506999,19,28,1994,5,"male",263,0,0,0,1,0,1,0,0
1507004,20,30,1993,5,"male",362,275,145,3,16,0,8,3,8
1507007,27,28,1986,2,"male",757,86,46,0,0,0,0,0,0
1507017,48,1,1965,5,"male",468,114,89,21,29,21,8,0,21
1507033,50,1,1963,1,"female",237,12,10,0,0,0,0,0,0
1507036,29,19,1984,12,"female",100,303,201,11,34,11,30,0,4
1507050,19,5,1994,4,"male",2,0,0,0,0,0,0,0,0
1507052,43,1,1970,11,"male",730,127,81,73,28,62,19,11,9
1507065,23,19,1990,11,"male",587,247,178,8,4,8,4,0,0
1507101,53,13,1960,9,"male",325,48,27,184,121,0,10,184,111
1507108,39,15,1974,8,"female",185,94,78,647,369,556,300,91,69
1507131,33,6,1980,11,"male",216,56,37,2,12,2,1,0,11
1507136,27,24,1986,4,"male",696,36,28,0,0,0,0,0,0
1507138,19,28,1994,5,"male",604,73,19,1,2,1,1,0,1
1507161,49,3,1964,9,"female",1723,164,83,452,594,452,352,0,242
1507196,19,19,1994,1,"female",17,37,5,0,4,0,0,0,4
1507212,33,2,1980,11,"male",228,96,85,29,7,5,6,24,1
1507218,21,1,1992,1,"male",156,105,51,7,9,1,5,6,4
1507246,15,16,1998,12,"male",112,27,22,0,0,0,0,0,0
1507251,74,6,1939,3,"female",1614,22,5,1,3,0,0,1,3
1507255,22,29,1991,4,"female",649,371,202,26,13,26,1,0,12
1507261,33,6,1980,12,"female",340,158,132,512,235,512,232,0,3
1507270,30,7,1983,7,"female",387,1464,468,372,604,17,105,355,499
1507290,15,26,1998,8,"male",201,206,103,46,60,46,47,0,13
1507306,18,21,1995,4,"female",378,125,35,0,13,0,7,0,6
1507310,36,14,1977,3,"female",259,9,3,16,1,16,1,0,0
1507330,53,20,1960,8,"male",920,1000,519,0,0,0,0,0,0
1507372,16,23,1997,8,"male",243,39,39,0,0,0,0,0,0
1507382,29,16,1984,10,"female",98,128,81,114,88,114,70,0,18
1507393,16,8,1997,10,"male",121,239,225,77,6,77,5,0,1
1507404,38,22,1975,12,"male",843,247,122,12,78,12,46,0,32
1507418,103,3,1910,7,"male",1231,53,36,19,17,0,3,19,14
1507422,30,15,1983,11,"male",351,9,7,0,0,0,0,0,0
1507515,19,7,1994,4,"male",384,452,390,11,13,0,10,11,3
1507521,33,19,1980,9,"female",281,56,38,308,134,180,115,128,19
1507547,27,2,1986,2,"female",215,16,10,0,0,0,0,0,0
1507551,17,25,1996,4,"male",373,276,181,545,46,104,25,441,21
1507565,64,20,1949,3,"female",1159,164,42,451,324,0,113,451,211
1507570,19,4,1994,12,"female",381,989,388,19,97,19,60,0,37
1507573,21,10,1992,12,"male",132,56,51,20,2,20,2,0,0
1507577,48,1,1965,1,"female",708,121,48,8,3,7,2,1,1
1507580,45,20,1968,9,"female",144,15,12,3,1,0,1,3,0
1507586,22,17,1991,2,"male",50,13,9,1,4,1,4,0,0
1507587,18,23,1995,12,"male",350,245,144,99,82,99,77,0,5
1507599,59,18,1954,7,"female",701,201,106,3,29,3,18,0,11
1507635,17,21,1996,10,"male",468,327,186,37,26,20,3,17,23
1507668,100,1,1913,1,"male",694,45,28,5,1,5,1,0,0
1507674,29,15,1984,5,"female",366,366,304,453,403,453,122,0,281
1507678,16,6,1997,8,"female",682,3358,2239,2665,5721,2664,4735,1,986
1507702,29,14,1984,12,"female",442,154,130,144,86,144,85,0,1
1507719,39,16,1974,8,"female",285,399,326,857,252,857,188,0,64
1507731,108,1,1905,7,"male",1140,349,225,264,11,0,1,264,10
1507810,52,28,1961,1,"male",293,248,188,8,192,8,186,0,6
1507812,22,24,1991,12,"female",268,33,31,14,42,14,14,0,28
1507844,25,23,1988,10,"male",997,75,43,2,4,2,3,0,1
1507848,41,5,1972,3,"male",432,80,57,3,20,3,20,0,0
1507887,47,17,1966,3,"female",497,27,13,0,0,0,0,0,0
1507897,23,3,1990,7,"female",322,671,349,37,134,35,75,2,59
1507952,45,2,1968,3,"male",53,36,24,7,33,0,1,7,32
1507970,59,28,1954,4,"female",310,152,111,61,134,61,40,0,94
1507975,29,9,1984,10,"male",43,143,77,146,52,29,14,117,38
1507978,22,22,1991,4,"male",430,114,34,1,3,1,2,0,1
1507988,20,1,1993,3,"male",109,62,31,110,109,110,99,0,10
1507998,44,25,1969,6,"male",435,2,2,0,0,0,0,0,0
1507999,28,8,1985,1,"male",405,332,242,314,235,296,101,18,134
1508001,20,20,1993,6,"female",255,396,296,174,293,143,122,31,171
1508014,45,27,1968,1,"female",1419,1230,491,11615,11929,11615,10758,0,1171
1508021,55,3,1958,2,"male",810,149,23,360,343,329,248,31,95
1508027,27,17,1986,11,"male",281,2,2,2,2,0,2,2,0
1508035,108,31,1905,7,"male",960,319,182,30,7,30,6,0,1
1508041,50,27,1963,7,"male",284,30,21,153,17,0,13,153,4
1508058,108,17,1905,10,"female",1609,55,32,21,18,0,2,21,16
1508062,67,9,1946,5,"male",403,38,18,0,0,0,0,0,0
1508063,99,29,1914,4,"male",849,69,37,9,0,9,0,0,0
1508074,39,14,1974,5,"male",214,42,25,15,44,11,28,4,16
1508117,26,28,1987,11,"female",204,139,51,419,183,369,110,50,73
1508142,20,6,1993,3,"male",176,79,61,0,1,0,1,0,0
1508157,27,19,1986,1,"male",222,7,4,0,1,0,1,0,0
1508218,15,31,1998,5,"female",334,8,7,0,0,0,0,0,0
1508263,23,3,1990,12,"male",990,5,1,9,0,3,0,6,0
1508274,35,9,1978,12,"male",697,1,1,9,1,7,1,2,0
1508286,27,13,1986,3,"male",74,42,25,120,37,120,24,0,13
1508303,44,6,1969,3,"male",4,1,0,1,3,0,0,1,3
1508314,35,15,1978,12,"male",274,29,10,5,22,5,15,0,7
1508326,20,7,1993,10,"male",165,93,68,3,1,3,0,0,1
1508340,16,25,1997,11,"male",78,4,3,0,0,0,0,0,0
1508346,63,26,1950,5,"female",1135,676,474,94,45,83,29,11,16
1508348,15,14,1998,6,"male",800,92,50,1,1,1,0,0,1
1508352,94,5,1919,12,"male",262,69,51,33,15,33,6,0,9
1508362,15,16,1998,9,"female",367,380,181,7,17,3,11,4,6
1508420,17,5,1996,10,"male",54,283,269,83,31,83,30,0,1
1508426,26,4,1987,11,"male",111,16,10,9,10,8,3,1,7
1508430,18,25,1995,10,"female",85,1023,272,295,127,293,55,2,72
1508438,48,3,1965,9,"female",370,336,289,891,49,891,48,0,1
1508454,18,27,1995,4,"male",477,606,473,20,2,16,0,4,2
1508469,28,20,1985,6,"male",197,45,29,0,0,0,0,0,0
1508491,17,1,1996,2,"male",489,270,217,29,13,20,8,9,5
1508494,68,16,1945,12,"male",972,98,90,367,69,367,61,0,8
1508536,66,13,1947,7,"male",301,0,0,0,0,0,0,0,0
1508538,24,14,1989,6,"male",777,272,137,0,0,0,0,0,0
1508549,18,5,1995,3,"male",437,145,121,83,4,6,4,77,0
1508572,21,30,1992,6,"female",804,311,242,27,17,27,13,0,4
1508591,54,7,1959,3,"female",1755,605,345,164,3,164,3,0,0
1508601,64,6,1949,5,"female",462,48,36,8,2,8,0,0,2
1508606,17,13,1996,8,"male",313,432,259,89,107,69,96,20,11
1508647,19,28,1994,1,"male",566,183,52,0,0,0,0,0,0
1508664,59,12,1954,5,"female",1272,50,14,107,31,98,25,9,6
1508681,16,8,1997,10,"male",226,287,194,158,75,157,62,1,13
1508687,108,26,1905,8,"female",1748,321,177,93,117,82,50,11,67
1508700,23,13,1990,6,"male",627,9,6,0,0,0,0,0,0
1508703,31,18,1982,10,"male",475,59,53,0,0,0,0,0,0
1508720,19,1,1994,1,"female",171,57,42,3,9,0,3,3,6
1508723,15,17,1998,1,"male",291,100,76,44,7,44,5,0,2
1508730,57,6,1956,12,"female",133,40,36,14,13,1,5,13,8
1508742,43,1,1970,12,"female",308,103,52,2,13,2,12,0,1
1508767,22,17,1991,11,"male",350,57,14,0,1,0,1,0,0
1508797,18,20,1995,1,"male",4,4,3,0,0,0,0,0,0
1508801,17,26,1996,10,"female",636,169,91,3,4,1,0,2,4
1508807,101,13,1912,6,NA,2337,327,257,678,341,576,84,102,257
1508816,16,23,1997,4,"female",226,91,65,1,121,1,87,0,34
1508818,47,28,1966,1,"male",1831,1012,635,1064,1483,735,459,329,1024
1508821,29,29,1984,3,"female",752,5,3,0,0,0,0,0,0
1508867,20,13,1993,6,"female",255,811,318,88,163,1,115,87,48
1508869,33,15,1980,7,"female",1832,620,133,2656,2816,545,1224,2111,1592
1508883,14,26,1999,9,"male",363,117,82,2,4,2,2,0,2
1508898,30,1,1983,6,"female",615,322,197,0,1,0,0,0,1
1508905,17,5,1996,12,"female",12,5,1,0,0,0,0,0,0
1508917,28,2,1985,10,"female",495,42,4,2329,1436,1640,691,689,745
1508930,53,7,1960,7,"female",565,136,63,82,23,60,5,22,18
1508936,14,18,1999,9,"male",308,193,129,0,0,0,0,0,0
1508952,48,29,1965,5,"female",1073,45,24,127,21,127,16,0,5
1508982,29,18,1984,3,"male",162,137,112,84,192,84,98,0,94
1508988,39,5,1974,7,"female",79,58,44,69,14,3,13,66,1
1508990,21,26,1992,4,"female",158,230,42,2582,1085,2582,779,0,306
1508996,37,18,1976,11,"male",418,6,5,1,0,1,0,0,0
1509011,46,30,1967,4,"female",355,11,8,9,0,9,0,0,0
1509029,18,15,1995,5,"male",385,374,205,9,2,9,0,0,2
1509032,15,29,1998,3,"female",437,3820,1834,0,778,0,123,0,655
1509039,22,21,1991,8,"male",188,94,54,33,35,2,9,31,26
1509086,16,21,1997,11,"male",14,10,8,0,1,0,0,0,1
1509088,108,2,1905,1,"male",1562,116,82,0,3,0,3,0,0
1509089,42,24,1971,11,"male",746,88,49,150,148,150,113,0,35
1509096,108,28,1905,1,"male",1023,123,72,3,104,2,80,1,24
1509101,57,24,1956,10,"female",922,52,22,302,80,302,56,0,24
1509116,18,22,1995,9,"female",477,452,322,145,392,130,317,15,75
1509127,23,2,1990,7,"female",442,80,48,4,3,4,3,0,0
1509145,23,3,1990,1,"male",421,37,20,7,27,0,3,7,24
1509170,16,26,1997,10,"female",592,320,104,0,10,0,8,0,2
1509174,22,21,1991,10,"male",1209,834,588,1,3,0,0,1,3
1509184,23,1,1990,1,"male",287,30,0,0,2,0,0,0,2
1509203,29,24,1984,3,"female",380,66,53,12,14,12,9,0,5
1509222,54,2,1959,9,"female",358,128,102,84,294,69,246,15,48
1509280,16,14,1997,6,"male",723,172,123,10,7,8,5,2,2
1509290,28,17,1985,5,"female",549,178,104,1013,350,473,209,540,141
1509291,17,5,1996,12,"male",287,24,17,1,1,1,1,0,0
1509295,58,30,1955,8,"female",799,140,87,182,69,169,38,13,31
1509330,17,13,1996,12,"male",459,353,202,225,78,206,52,19,26
1509343,39,25,1974,2,"female",358,2,1,0,0,0,0,0,0
1509358,29,15,1984,5,"male",287,68,28,2,6,2,6,0,0
1509361,16,4,1997,6,"female",692,885,607,457,731,247,515,210,216
1509363,21,2,1992,11,"female",272,45,26,0,0,0,0,0,0
1509374,95,15,1918,10,"female",131,3,0,27,3,27,3,0,0
1509388,18,4,1995,4,"male",395,70,55,0,0,0,0,0,0
1509396,17,24,1996,10,"male",219,472,337,259,527,259,417,0,110
1509398,26,15,1987,2,"female",926,2,1,24,11,24,11,0,0
1509402,28,15,1985,7,"male",424,19,4,3,11,3,9,0,2
1509405,17,8,1996,6,"female",281,1224,183,1279,2432,1035,926,244,1506
1509407,15,6,1998,3,"male",769,978,623,15,0,0,0,15,0
1509410,32,10,1981,10,"male",141,21,8,0,4,0,2,0,2
1509465,59,8,1954,5,"female",1574,74,11,81,7,81,5,0,2
1509491,57,5,1956,2,"male",82,68,52,3,6,0,0,3,6
1509538,52,1,1961,3,"female",191,59,49,302,158,302,138,0,20
1509554,102,31,1911,1,"male",1662,237,87,105,159,6,64,99,95
1509563,19,22,1994,12,"male",325,24,16,3,0,0,0,3,0
1509593,21,19,1992,7,"male",482,46,40,4,0,4,0,0,0
1509604,19,5,1994,9,"male",165,194,160,0,0,0,0,0,0
1509642,26,9,1987,6,"male",388,256,208,18,18,4,12,14,6
1509678,35,17,1978,1,"male",327,38,20,1,4,1,4,0,0
1509691,22,11,1991,10,"male",88,143,126,8,79,8,58,0,21
1509731,34,10,1979,12,"male",500,20,7,11,8,11,2,0,6
1509751,23,17,1990,11,"female",184,72,61,0,14,0,2,0,12
1509757,26,1,1987,1,"male",384,22,22,0,0,0,0,0,0
1509811,36,31,1977,3,"female",441,29,17,113,125,113,111,0,14
1509812,28,19,1985,4,"male",1207,380,129,98,24,83,20,15,4
1509823,26,25,1987,1,"male",244,92,66,0,22,0,18,0,4
1509858,23,21,1990,3,"female",173,90,38,0,25,0,0,0,25
1509889,22,8,1991,3,"male",283,97,47,1,2,1,2,0,0
1509916,23,4,1990,5,"male",405,38,29,5,0,5,0,0,0
1509970,27,9,1986,8,"male",441,11,7,3,0,3,0,0,0
1510012,42,12,1971,11,"male",598,55,37,10,1,10,1,0,0
1510036,25,24,1988,7,"male",711,129,40,12,69,4,17,8,52
1510039,29,28,1984,7,"male",507,0,0,0,0,0,0,0,0
1510054,27,22,1986,3,"male",328,68,55,3,0,3,0,0,0
1510076,37,25,1976,9,"male",409,59,3,0,2,0,2,0,0
1510116,30,29,1983,9,"male",338,57,35,8,1,0,0,8,1
1510117,73,3,1940,3,"male",462,20,15,6,9,0,0,6,9
1510133,25,28,1988,10,"male",509,93,46,0,0,0,0,0,0
1510135,18,5,1995,11,"female",264,5,5,31,0,31,0,0,0
1510144,31,6,1982,6,"female",82,99,77,10,43,10,29,0,14
1510160,20,4,1993,1,"female",553,285,180,0,1,0,1,0,0
1510185,26,24,1987,6,"female",331,4,0,0,0,0,0,0,0
1510198,23,8,1990,1,"male",466,94,62,0,1,0,0,0,1
1510232,15,22,1998,10,"female",348,189,122,361,150,361,127,0,23
1510251,17,10,1996,12,"male",47,33,19,1,0,1,0,0,0
1510290,30,29,1983,7,"female",169,27,20,0,1,0,0,0,1
1510299,22,12,1991,1,"male",268,1,1,0,0,0,0,0,0
1510303,23,23,1990,7,"male",287,137,89,146,9,146,7,0,2
1510320,53,6,1960,11,"male",102,22,17,0,0,0,0,0,0
1510330,27,12,1986,12,"male",37,80,76,14,13,14,11,0,2
1510339,15,12,1998,1,"male",102,25,20,109,9,109,8,0,1
1510343,108,11,1905,4,"female",1756,804,451,25,71,12,27,13,44
1510357,20,15,1993,11,"female",15,119,117,246,42,246,35,0,7
1510361,17,14,1996,10,"male",7,0,0,0,0,0,0,0,0
1510373,19,7,1994,5,"female",584,319,205,258,359,258,270,0,89
1510375,72,16,1941,4,"female",1422,90,32,97,71,88,48,9,23
1510398,18,1,1995,1,"female",16,11,5,15,19,15,7,0,12
1510426,106,9,1907,7,"male",1132,234,160,31,12,0,5,31,7
1510435,50,15,1963,3,"male",265,0,0,0,0,0,0,0,0
1510443,39,23,1974,7,"male",997,73,38,15,17,15,14,0,3
1510444,19,18,1994,7,"male",366,120,52,0,10,0,9,0,1
1510463,44,17,1969,12,"male",945,10,6,0,0,0,0,0,0
1510465,73,17,1940,12,"male",314,43,30,0,5,0,1,0,4
1510467,26,12,1987,9,"male",434,255,221,42,40,42,29,0,11
1510484,33,1,1980,5,"female",527,18,14,0,0,0,0,0,0
1510508,73,19,1940,10,"female",157,50,25,0,0,0,0,0,0
1510551,23,11,1990,8,"male",470,62,57,0,0,0,0,0,0
1510566,30,2,1983,10,"male",225,221,139,301,272,100,208,201,64
1510596,19,27,1994,2,"male",162,34,28,19,5,16,5,3,0
1510608,21,22,1992,10,"male",388,132,94,0,0,0,0,0,0
1510632,21,12,1992,11,"female",232,42,29,63,2,62,2,1,0
1510685,23,25,1990,1,"female",597,25,16,0,0,0,0,0,0
1510700,18,4,1995,7,"male",140,88,77,173,43,163,28,10,15
1510728,41,1,1972,3,"female",155,34,15,0,0,0,0,0,0
1510729,62,10,1951,7,"female",159,91,28,111,56,111,23,0,33
1510731,16,14,1997,3,"male",460,105,64,1,26,1,23,0,3
1510737,39,6,1974,11,"female",162,20,12,37,11,37,11,0,0
1510752,28,21,1985,9,"female",5,255,158,78,170,70,138,8,32
1510760,32,30,1981,4,"female",535,283,161,432,119,428,44,4,75
1510785,23,10,1990,4,"female",470,608,456,26,7,26,4,0,3
1510827,26,24,1987,4,"male",265,26,19,0,0,0,0,0,0
1510853,37,9,1976,11,"male",718,10,1,0,0,0,0,0,0
1510867,57,8,1956,9,"male",474,208,159,132,5,124,4,8,1
1510936,101,27,1912,11,"female",1947,782,120,8,17,8,15,0,2
1510941,40,18,1973,4,"female",205,65,31,16,16,15,9,1,7
1510959,35,9,1978,6,"male",536,127,59,0,0,0,0,0,0
1510975,13,25,2000,1,"male",591,132,94,8,1,0,0,8,1
1510992,44,11,1969,7,"female",431,21,13,62,13,2,4,60,9
1511009,18,14,1995,3,"male",246,34,25,1,0,0,0,1,0
1511021,100,14,1913,8,"female",2228,247,80,99,110,89,83,10,27
1511031,20,28,1993,8,"male",137,22,21,0,2,0,0,0,2
1511033,41,8,1972,10,"female",302,8,6,0,2,0,0,0,2
1511051,19,25,1994,9,"male",1,2,2,28,0,0,0,28,0
1511067,30,19,1983,3,"male",467,91,49,1,2,1,2,0,0
1511094,18,3,1995,7,"female",59,499,97,246,587,160,239,86,348
1511097,59,17,1954,3,"male",333,194,106,17,8,0,0,17,8
1511107,18,28,1995,9,"female",667,1228,970,3370,2807,2038,2033,1332,774
1511137,36,14,1977,12,"female",529,191,89,27,73,27,33,0,40
1511149,31,14,1982,5,"male",261,263,86,120,13,116,7,4,6
1511171,18,24,1995,3,"female",380,16,11,0,0,0,0,0,0
1511174,14,26,1999,11,"male",224,74,35,0,1,0,1,0,0
1511187,35,26,1978,5,"female",586,416,355,52,68,0,29,52,39
1511216,39,17,1974,7,"male",289,73,36,1,1,1,1,0,0
1511267,15,21,1998,2,"female",197,239,171,32,69,32,67,0,2
1511279,26,9,1987,8,"male",303,4,4,0,0,0,0,0,0
1511280,15,28,1998,1,"male",261,60,33,10,0,10,0,0,0
1511321,103,19,1910,11,"female",1744,336,118,108,172,23,109,85,63
1511325,48,14,1965,12,"male",417,24,17,10,5,0,3,10,2
1511333,33,19,1980,6,"male",270,66,40,102,8,102,5,0,3
1511339,63,22,1950,10,"male",489,62,37,0,0,0,0,0,0
1511361,108,12,1905,3,"male",1486,675,305,4,1,2,1,2,0
1511397,103,11,1910,8,"male",796,463,287,49,66,0,17,49,49
1511411,21,19,1992,5,"male",332,170,142,308,343,308,230,0,113
1511438,90,1,1923,1,"male",2,33,32,0,0,0,0,0,0
1511449,20,30,1993,12,"female",350,427,165,209,126,100,87,109,39
1511452,29,23,1984,6,"male",186,324,198,960,1392,858,1176,102,216
1511466,25,1,1988,1,"male",31,20,18,309,7,309,7,0,0
1511514,51,20,1962,7,"female",68,44,43,44,4,44,4,0,0
1511516,57,5,1956,7,"male",1434,113,46,141,60,140,38,1,22
1511520,18,30,1995,3,"female",242,65,35,60,30,60,17,0,13
1511524,38,26,1975,8,"female",33,14,12,51,17,48,16,3,1
1511525,67,2,1946,3,"female",171,232,201,121,122,121,96,0,26
1511534,81,28,1932,2,"female",1049,5,0,3,1,0,0,3,1
1511535,20,8,1993,7,"male",141,582,492,213,390,175,296,38,94
1511537,15,1,1998,7,"female",269,65,45,0,3,0,0,0,3
1511569,33,1,1980,1,"male",327,4,4,0,0,0,0,0,0
1511615,17,15,1996,6,"male",432,352,173,173,237,173,231,0,6
1511621,108,22,1905,9,"male",1068,46,24,5,5,5,5,0,0
1511627,68,13,1945,10,"male",1373,10,1,79,12,0,7,79,5
1511641,57,12,1956,4,"female",1701,540,434,57,320,57,221,0,99
1511654,79,13,1934,6,"female",1053,188,91,25,32,0,15,25,17
1511674,71,30,1942,1,"male",229,0,0,18,14,0,9,18,5
1511678,23,24,1990,12,"male",727,213,143,307,150,307,94,0,56
1511714,24,25,1989,4,"female",398,9,6,0,2,0,0,0,2
1511728,98,15,1915,12,"female",57,222,206,945,810,166,166,779,644
1511733,60,10,1953,9,"male",313,67,33,185,506,185,306,0,200
1511744,33,21,1980,4,"female",130,93,87,2,11,2,5,0,6
1511747,22,2,1991,4,"male",383,139,119,0,0,0,0,0,0
1511748,103,3,1910,3,"female",771,520,282,145,185,145,113,0,72
1511755,14,24,1999,8,"male",368,215,131,2,0,2,0,0,0
1511779,29,12,1984,3,"male",123,29,16,0,6,0,1,0,5
1511782,54,20,1959,12,"female",646,1,1,1,0,0,0,1,0
1511784,16,13,1997,7,"male",247,1565,955,1744,1664,1743,1278,1,386
1511794,16,25,1997,7,"male",479,465,424,2,1,2,0,0,1
1511813,23,14,1990,1,"male",271,92,83,87,38,33,13,54,25
1511818,108,9,1905,5,"male",1521,610,491,4,8,4,7,0,1
1511829,35,11,1978,10,"female",761,74,42,629,109,629,76,0,33
1511867,31,27,1982,2,"male",363,152,120,400,144,400,77,0,67
1511871,24,16,1989,8,"male",364,76,30,3,18,3,5,0,13
1511885,17,19,1996,2,"male",174,111,100,0,1,0,0,0,1
1511892,18,11,1995,11,"male",874,408,229,45,22,13,9,32,13
1511906,55,28,1958,4,"male",550,1,1,123,135,0,2,123,133
1511907,72,23,1941,7,"female",1701,11,11,11,0,0,0,11,0
1511931,108,24,1905,10,"female",1264,343,252,363,90,0,22,363,68
1511933,24,26,1989,12,"male",372,181,95,3,32,3,28,0,4
1511947,20,22,1993,12,"female",837,3079,280,768,2140,638,1413,130,727
1511975,43,29,1970,11,"male",695,154,121,13,1,4,1,9,0
1511993,32,3,1981,2,"male",750,147,94,0,50,0,42,0,8
1512002,58,24,1955,2,"male",653,314,228,690,162,0,62,690,100
1512007,56,6,1957,5,"female",970,107,75,1238,102,1238,69,0,33
1512048,45,10,1968,8,"female",830,40,21,1,2,0,1,1,1
1512057,22,1,1991,1,"male",265,40,40,0,0,0,0,0,0
1512058,25,8,1988,8,"female",573,98,66,31,22,24,12,7,10
1512088,33,20,1980,11,"female",945,268,197,1446,735,1446,562,0,173
1512118,20,6,1993,6,"male",451,858,799,7,2,5,1,2,1
1512134,22,24,1991,6,"female",428,15,10,0,0,0,0,0,0
1512144,18,25,1995,12,"male",216,13,12,1,0,1,0,0,0
1512147,20,23,1993,2,"male",84,18,16,88,32,13,10,75,22
1512162,65,10,1948,3,"male",983,96,49,8,83,0,16,8,67
1512165,24,13,1989,7,"female",361,309,245,16,4,14,4,2,0
1512186,54,19,1959,2,"female",308,61,52,37,1,37,1,0,0
1512203,22,15,1991,5,"male",347,88,83,2,1,0,0,2,1
1512224,14,2,1999,1,"male",412,379,280,3,5,1,1,2,4
1512234,23,10,1990,9,"male",465,111,69,8,49,0,15,8,34
1512274,33,15,1980,5,"male",521,64,54,0,0,0,0,0,0
1512283,63,27,1950,3,"male",1311,638,485,445,134,286,100,159,34
1512286,20,31,1993,3,"female",788,193,69,6160,4814,4371,3118,1789,1696
1512305,18,24,1995,10,"male",368,126,65,123,156,20,76,103,80
1512314,66,10,1947,4,"male",1343,31,18,14,32,0,15,14,17
1512323,67,10,1946,9,"female",1101,349,200,0,0,0,0,0,0
1512324,15,14,1998,1,"female",592,285,130,370,142,132,107,238,35
1512331,16,2,1997,12,"female",510,315,218,3,5,3,3,0,2
1512334,69,23,1944,6,"female",746,19,9,15,1,0,0,15,1
1512344,21,9,1992,10,"male",726,738,672,4,1,4,1,0,0
1512355,37,17,1976,2,"female",143,154,134,26,33,26,31,0,2
1512360,15,1,1998,5,"male",377,313,241,17,2,17,2,0,0
1512362,66,11,1947,1,"female",1492,76,42,1142,121,78,25,1064,96
1512397,19,9,1994,12,"male",105,589,401,733,1433,733,1312,0,121
1512403,65,10,1948,6,"female",845,66,36,289,89,225,41,64,48
1512409,33,5,1980,5,"female",466,16,11,131,417,0,79,131,338
1512413,26,1,1987,12,"male",312,149,105,78,82,78,55,0,27
1512468,47,3,1966,3,"male",988,11,8,1,3,1,0,0,3
1512479,32,3,1981,1,"male",475,4,4,0,0,0,0,0,0
1512508,46,10,1967,3,"female",509,90,9,55,28,2,12,53,16
1512527,19,1,1994,5,"female",314,185,145,64,7,64,7,0,0
1512533,17,17,1996,12,"female",341,2554,1346,92,2102,92,1661,0,441
1512546,20,5,1993,1,"female",438,154,63,10,32,9,12,1,20
1512553,37,16,1976,4,"male",440,18,8,46,21,46,20,0,1
1512575,22,28,1991,10,"female",208,48,21,0,0,0,0,0,0
1512615,17,7,1996,5,"female",528,432,190,108,35,26,24,82,11
1512651,67,1,1946,1,"male",651,40,13,121,85,121,72,0,13
1512655,62,22,1951,7,"male",43,11,10,53,12,53,2,0,10
1512667,39,8,1974,1,"female",465,28,7,80,135,3,121,77,14
1512704,33,30,1980,10,"male",226,8,3,3,1,1,0,2,1
1512718,108,2,1905,4,"male",1583,361,199,1,22,0,3,1,19
1512724,73,9,1940,10,"female",1409,47,25,3,1,3,0,0,1
1512725,19,1,1994,1,"male",219,4,3,10,0,0,0,10,0
1512760,25,2,1988,5,"male",251,104,92,1,1,1,1,0,0
1512798,15,18,1998,5,"female",286,213,90,237,54,237,48,0,6
1512805,15,14,1998,6,"male",183,263,234,117,112,29,19,88,93
1512822,47,18,1966,5,"female",289,80,28,236,223,0,70,236,153
1512865,46,20,1967,4,"male",622,29,20,28,0,28,0,0,0
1512902,15,29,1998,8,"male",171,57,39,4,5,4,5,0,0
1512905,15,25,1998,3,"female",854,267,36,157,194,139,134,18,60
1512908,19,5,1994,10,"female",41,27,24,1,5,1,4,0,1
1512919,22,24,1991,8,"male",647,138,85,0,0,0,0,0,0
1512934,27,12,1986,12,"male",383,70,63,16,4,0,1,16,3
1512953,16,18,1997,2,"female",287,975,467,286,460,278,291,8,169
1512957,67,11,1946,10,"female",490,25,18,75,31,74,13,1,18
1512986,23,13,1990,6,"male",173,204,112,8,0,0,0,8,0
1512991,15,20,1998,7,"female",251,249,168,257,156,257,115,0,41
1513016,19,7,1994,1,"male",484,355,287,21,62,19,15,2,47
1513038,61,22,1952,1,"male",22,143,89,90,177,90,145,0,32
1513041,24,5,1989,6,"male",545,77,38,49,17,49,16,0,1
1513043,22,20,1991,2,"male",324,140,91,1,8,0,5,1,3
1513083,56,23,1957,8,"female",1177,39,20,11,29,11,12,0,17
1513092,18,7,1995,9,"male",973,227,122,32,36,11,12,21,24
1513120,25,21,1988,2,"female",328,97,82,207,220,199,169,8,51
1513127,29,17,1984,7,"male",536,177,147,0,0,0,0,0,0
1513148,18,5,1995,5,"male",1010,2958,2195,806,764,75,458,731,306
1513222,68,13,1945,5,"male",1232,102,33,0,5,0,5,0,0
1513252,30,7,1983,11,"male",1048,226,153,4,13,4,6,0,7
1513260,52,26,1961,1,"female",608,29,24,18,12,18,7,0,5
1513274,16,17,1997,6,"male",521,312,80,111,185,85,146,26,39
1513283,26,19,1987,5,"male",264,71,51,0,11,0,7,0,4
1513298,28,1,1985,12,"female",1262,24,17,2,1,2,1,0,0
1513322,26,31,1987,5,"male",521,185,154,582,231,582,121,0,110
1513331,30,24,1983,4,"female",991,312,95,13,25,13,7,0,18
1513351,19,26,1994,7,"female",1056,851,724,61,231,61,207,0,24
1513380,108,28,1905,7,"female",98,27,24,5,5,5,2,0,3
1513386,20,19,1993,12,"male",911,50,42,0,0,0,0,0,0
1513395,19,2,1994,3,"female",598,4557,1355,618,4986,617,3835,1,1151
1513396,55,1,1958,7,"male",21,19,13,111,22,50,12,61,10
1513402,16,21,1997,2,"male",492,328,204,597,449,374,248,223,201
1513414,71,4,1942,2,"male",1514,107,46,74,5,73,3,1,2
1513416,24,14,1989,4,"male",312,205,92,94,33,94,30,0,3
1513417,64,13,1949,11,"female",1327,231,44,573,19,441,4,132,15
1513446,82,14,1931,3,"female",145,27,26,0,0,0,0,0,0
1513450,54,3,1959,6,"male",1655,890,651,454,547,454,239,0,308
1513455,36,6,1977,12,"male",612,54,26,23,39,23,25,0,14
1513487,20,20,1993,5,"male",204,185,123,56,140,54,127,2,13
1513520,94,19,1919,1,"female",1147,138,64,14,32,14,20,0,12
1513526,28,23,1985,4,"male",377,136,121,2,3,2,0,0,3
1513531,45,11,1968,12,"male",482,15,12,79,67,3,26,76,41
1513532,113,17,1900,1,"male",1295,274,70,110,71,33,36,77,35
1513554,22,10,1991,7,"female",402,34,16,0,0,0,0,0,0
1513572,31,9,1982,12,"female",447,90,62,66,68,48,37,18,31
1513577,25,18,1988,9,"male",596,37,17,10,3,9,2,1,1
1513580,103,1,1910,1,"male",280,70,42,0,0,0,0,0,0
1513598,28,11,1985,2,"male",1387,17,1,0,0,0,0,0,0
1513610,16,26,1997,3,"female",734,412,131,15,13,15,5,0,8
1513611,19,19,1994,6,"female",484,3463,1024,875,2000,373,674,502,1326
1513625,17,12,1996,12,"male",696,711,548,0,0,0,0,0,0
1513654,28,21,1985,3,"male",1439,13,10,3,0,0,0,3,0
1513659,17,26,1996,11,"male",446,17,4,0,6,0,0,0,6
1513708,30,30,1983,5,"female",131,96,63,160,264,160,178,0,86
1513710,23,14,1990,8,"male",490,31,8,1,2,1,2,0,0
1513722,15,12,1998,8,"male",16,11,11,0,0,0,0,0,0
1513728,20,19,1993,9,"female",1723,755,344,426,477,393,302,33,175
1513750,24,14,1989,12,"male",308,32,17,0,2,0,2,0,0
1513754,24,29,1989,8,"female",144,37,15,25,170,25,40,0,130
1513767,52,3,1961,11,"female",464,114,56,108,53,53,38,55,15
1513803,54,17,1959,8,"male",206,55,23,54,49,0,31,54,18
1513805,16,23,1997,7,"female",262,626,467,130,84,130,63,0,21
1513875,22,4,1991,10,"female",420,91,46,2,3,2,3,0,0
1513889,16,1,1997,1,"female",210,113,18,1,23,1,14,0,9
1513900,18,14,1995,3,"female",385,30,25,1,1,1,1,0,0
1513902,20,26,1993,4,"female",229,217,128,2,17,2,5,0,12
1513924,15,3,1998,11,"male",71,68,64,0,2,0,2,0,0
1513978,47,13,1966,8,"female",1438,94,55,22,16,22,14,0,2
1513996,67,18,1946,2,"female",1692,57,23,4,3,4,2,0,1
1514033,36,10,1977,1,"male",770,16,9,1,1,1,0,0,1
1514055,34,1,1979,7,"male",305,83,82,2,1,2,0,0,1
1514061,52,24,1961,4,"male",365,20,17,6,2,6,1,0,1
1514069,32,21,1981,2,"male",320,192,122,5,12,5,5,0,7
1514081,23,15,1990,10,"male",21,14,13,0,1,0,1,0,0
1514088,39,12,1974,2,"female",591,108,98,396,112,396,45,0,67
1514099,21,1,1992,1,"male",281,37,36,0,0,0,0,0,0
1514102,23,15,1990,4,"male",697,60,38,4,2,4,2,0,0
1514166,19,6,1994,6,"female",364,172,107,148,227,114,135,34,92
1514188,19,14,1994,10,"female",50,5,1,12,4,10,0,2,4
1514199,24,30,1989,10,"female",22,34,15,13,22,13,13,0,9
1514251,25,11,1988,8,"female",324,187,113,249,377,241,265,8,112
1514284,58,4,1955,4,"female",238,31,21,67,18,67,18,0,0
1514306,23,15,1990,11,"male",32,12,11,1,1,1,1,0,0
1514310,19,5,1994,11,"male",136,31,23,42,9,42,5,0,4
1514337,18,15,1995,3,"female",529,514,264,361,299,11,54,350,245
1514345,68,12,1945,8,"female",2324,145,43,130,39,92,25,38,14
1514346,18,10,1995,5,"male",40,43,19,2,0,2,0,0,0
1514374,63,22,1950,12,"male",124,4,2,18,0,0,0,18,0
1514409,18,19,1995,10,"male",337,2,2,0,0,0,0,0,0
1514450,21,11,1992,1,"male",591,366,257,316,83,51,37,265,46
1514453,66,4,1947,7,"female",1834,94,39,112,74,0,60,112,14
1514470,24,25,1989,8,"male",319,54,38,0,0,0,0,0,0
1514498,14,31,1999,1,"male",102,18,6,1,1,1,1,0,0
1514500,27,7,1986,5,"male",307,34,29,0,0,0,0,0,0
1514526,14,16,1999,6,"female",198,648,50,27,36,1,25,26,11
1514551,103,5,1910,12,"male",1436,414,388,0,0,0,0,0,0
1514559,41,13,1972,3,"female",1544,11,7,0,7,0,6,0,1
1514568,22,10,1991,4,"female",266,98,83,0,12,0,5,0,7
1514581,46,28,1967,5,"male",627,64,21,36,15,36,13,0,2
1514597,40,23,1973,3,"male",61,1,0,3,0,0,0,3,0
1514598,49,21,1964,11,"female",816,82,13,11,4,11,4,0,0
1514609,21,5,1992,5,"female",106,74,9,1,3,1,3,0,0
1514626,39,21,1974,5,"male",642,3,1,0,0,0,0,0,0
1514629,39,1,1974,9,"male",404,124,73,5,0,5,0,0,0
1514675,15,21,1998,2,"female",433,370,183,361,170,279,161,82,9
1514684,24,18,1989,4,"male",556,85,62,24,17,24,17,0,0
1514702,30,8,1983,6,"male",114,3,3,0,2,0,2,0,0
1514706,47,9,1966,9,"female",2084,665,485,4520,5218,2787,2191,1733,3027
1514713,103,11,1910,7,"male",570,246,144,2,21,2,18,0,3
1514754,39,31,1974,12,"male",338,2,0,0,0,0,0,0,0
1514759,46,30,1967,5,"male",622,9,3,0,0,0,0,0,0
1514773,53,28,1960,10,"male",997,16,5,2,0,2,0,0,0
1514783,25,24,1988,1,"male",202,65,32,199,122,171,39,28,83
1514788,55,21,1958,10,"female",576,4,2,1,0,0,0,1,0
1514827,34,2,1979,2,"male",254,100,36,22,4,17,1,5,3
1514850,50,6,1963,3,"female",284,526,402,579,262,409,94,170,168
1514855,20,10,1993,5,"male",221,96,40,24,13,15,3,9,10
1514870,57,26,1956,6,"male",860,58,19,0,25,0,16,0,9
1514876,71,16,1942,12,"female",944,28,16,23,75,0,2,23,73
1514877,22,9,1991,10,"female",276,104,24,1,5,0,1,1,4
1514912,97,22,1916,12,"female",1684,882,365,55,17,41,13,14,4
1514922,20,10,1993,9,"male",30,11,11,0,0,0,0,0,0
1514953,25,1,1988,1,"female",61,0,0,0,0,0,0,0,0
1514968,18,31,1995,8,"male",559,190,159,6,5,6,3,0,2
1514975,28,25,1985,12,"female",1,0,0,0,0,0,0,0,0
1514978,71,6,1942,1,"female",378,27,8,11,2,0,2,11,0
1515016,103,16,1910,11,"female",1180,263,62,21,18,21,12,0,6
1515022,66,13,1947,5,"female",253,102,59,342,577,0,301,342,276
1515031,20,16,1993,8,"male",210,1,1,0,0,0,0,0,0
1515050,70,7,1943,7,"female",1148,48,22,20,6,0,3,20,3
1515104,19,3,1994,1,"female",467,5,3,0,0,0,0,0,0
1515124,59,22,1954,6,"male",152,1,0,8,2,0,1,8,1
1515138,64,4,1949,7,"female",1397,31,12,6834,25,0,4,6834,21
1515173,22,11,1991,6,"male",296,126,104,0,2,0,2,0,0
1515178,17,15,1996,3,"male",1177,251,167,53,13,18,1,35,12
1515188,106,18,1907,11,"male",147,109,97,50,0,5,0,45,0
1515191,31,21,1982,8,"female",742,30,14,87,35,25,14,62,21
1515200,18,8,1995,12,"female",188,75,35,9,37,7,26,2,11
1515201,21,1,1992,1,"male",281,127,115,7,2,7,2,0,0
1515220,52,16,1961,2,"female",263,58,39,276,53,0,12,276,41
1515238,20,25,1993,5,"male",508,696,569,9,14,9,11,0,3
1515303,18,17,1995,8,"male",117,60,58,41,11,41,9,0,2
1515309,52,23,1961,5,"female",174,100,66,926,276,926,85,0,191
1515346,13,13,2000,2,"female",845,582,369,2178,990,2145,796,33,194
1515363,39,16,1974,2,"male",838,127,17,3,2,0,1,3,1
1515395,20,20,1993,8,"female",477,380,284,26,105,26,87,0,18
1515398,50,11,1963,1,"male",826,59,23,93,20,73,11,20,9
1515401,14,25,1999,12,"female",316,173,118,305,360,12,21,293,339
1515402,34,22,1979,3,"male",276,3,1,10,2,0,0,10,2
1515457,40,15,1973,12,"female",301,64,43,115,284,115,185,0,99
1515459,54,18,1959,1,"male",596,2,0,0,0,0,0,0,0
1515467,70,13,1943,11,"female",365,23,12,9,6,9,3,0,3
1515470,37,12,1976,6,"female",314,2,0,0,0,0,0,0,0
1515500,18,7,1995,7,"female",299,22,8,15,5,6,0,9,5
1515508,52,3,1961,3,"male",686,6,3,1,2,1,0,0,2
1515518,37,22,1976,10,"male",128,107,91,10,38,2,25,8,13
1515524,19,24,1994,11,"male",216,28,8,132,73,132,37,0,36
1515530,19,20,1994,3,"male",481,265,240,49,4,49,0,0,4
1515540,30,26,1983,11,"female",581,17,8,40,118,40,85,0,33
1515577,20,13,1993,1,"female",515,563,243,848,2798,848,2156,0,642
1515621,56,26,1957,8,"male",1377,73,39,2,0,1,0,1,0
1515643,15,10,1998,1,"male",450,347,252,1,1,1,1,0,0
1515647,34,29,1979,12,"male",570,67,42,6,6,3,4,3,2
1515688,23,9,1990,10,"male",331,20,19,0,0,0,0,0,0
1515690,53,21,1960,1,"female",615,154,95,731,671,0,118,731,553
1515693,58,8,1955,8,"male",1398,122,68,28,2,0,1,28,1
1515707,21,26,1992,3,"male",462,771,429,383,747,192,553,191,194
1515732,28,13,1985,2,"male",570,187,136,0,0,0,0,0,0
1515743,23,2,1990,3,"male",507,68,43,0,0,0,0,0,0
1515748,21,12,1992,5,"female",10,17,2,61,642,55,440,6,202
1515755,17,11,1996,7,"female",613,244,169,155,259,0,61,155,198
1515775,23,4,1990,10,"male",448,217,105,634,332,113,159,521,173
1515790,29,1,1984,5,"female",137,1,1,1,1,1,0,0,1
1515812,32,9,1981,1,"male",512,21,15,1,2,1,1,0,1
1515903,18,7,1995,12,"female",25,211,68,123,132,90,61,33,71
1515905,18,8,1995,5,"female",159,378,336,166,27,166,23,0,4
1515922,33,20,1980,3,"male",174,13,5,0,0,0,0,0,0
1515943,38,10,1975,8,"male",221,34,25,6,0,6,0,0,0
1515966,108,1,1905,5,"male",180,26,11,1,1,0,1,1,0
1515987,73,1,1940,1,"male",416,3,0,1,0,1,0,0,0
1516001,57,6,1956,7,"male",306,137,64,240,50,0,6,240,44
1516002,23,25,1990,8,"male",880,828,689,59,130,39,108,20,22
1516015,21,9,1992,9,"male",514,32,26,0,0,0,0,0,0
1516061,18,4,1995,7,"male",582,1,1,2,1,2,1,0,0
1516068,42,1,1971,1,"male",15,5,5,0,0,0,0,0,0
1516074,108,19,1905,6,"male",94,48,14,1,8,0,4,1,4
1516082,23,17,1990,7,"female",650,450,276,520,446,493,231,27,215
1516107,24,23,1989,8,"female",674,91,48,100,0,100,0,0,0
1516119,65,22,1948,12,"female",501,46,15,87,20,61,15,26,5
1516132,69,5,1944,10,"female",393,26,17,147,67,147,57,0,10
1516145,23,7,1990,11,"female",393,146,121,4,0,4,0,0,0
1516147,27,10,1986,4,"male",225,146,77,18,4,0,0,18,4
1516152,52,12,1961,6,"male",389,19,3,6,2,0,0,6,2
1516171,27,1,1986,1,"male",88,20,19,50,5,50,5,0,0
1516181,19,8,1994,9,"male",643,53,28,249,82,0,38,249,44
1516185,19,5,1994,3,"female",18,90,85,14,34,14,8,0,26
1516186,40,8,1973,3,"male",102,1,1,36,21,0,0,36,21
1516196,38,28,1975,7,"female",399,85,18,127,14,1,10,126,4
1516200,66,15,1947,8,"male",769,40,11,4,10,0,7,4,3
1516222,21,16,1992,9,"male",273,40,33,243,5,243,5,0,0
1516234,38,8,1975,9,"male",686,163,94,10,2,1,1,9,1
1516244,23,18,1990,7,"male",85,7,4,10,7,10,3,0,4
1516259,19,1,1994,8,"male",95,12,7,3,0,3,0,0,0
1516279,41,23,1972,9,"female",195,224,170,2400,1057,1254,519,1146,538
1516305,13,18,2000,7,"male",78,69,58,4,2,4,2,0,0
1516320,26,1,1987,1,"female",516,0,0,0,0,0,0,0,0
1516436,20,6,1993,12,"male",583,129,82,107,71,62,25,45,46
1516471,65,18,1948,10,"male",1679,28,15,1,7,1,5,0,2
1516475,45,1,1968,10,"male",227,138,122,32,3,32,1,0,2
1516479,22,16,1991,3,"male",31,26,25,0,3,0,2,0,1
1516513,36,17,1977,11,"male",617,48,21,0,0,0,0,0,0
1516540,113,27,1900,5,"female",1432,74,31,339,157,11,66,328,91
1516597,28,18,1985,9,"male",389,15,6,29,43,27,23,2,20
1516602,100,8,1913,1,"male",961,170,50,21,285,4,93,17,192
1516623,35,13,1978,5,"female",195,70,51,64,39,37,2,27,37
1516647,22,1,1991,7,"male",343,82,48,4,1,2,1,2,0
1516672,21,12,1992,3,"male",376,150,70,45,78,28,35,17,43
1516679,28,16,1985,2,"female",894,9,6,36,7,32,3,4,4
1516697,22,12,1991,11,"female",277,3,3,2,0,0,0,2,0
1516706,58,8,1955,9,"male",830,68,23,11,8,0,1,11,7
1516715,53,6,1960,9,"male",262,13,7,55,8,0,4,55,4
1516746,18,28,1995,11,"male",686,268,156,1,0,1,0,0,0
1516751,65,17,1948,4,"male",1454,68,23,4,12,0,5,4,7
1516764,55,25,1958,4,"male",304,201,64,110,6,0,0,110,6
1516816,28,4,1985,1,"male",298,3,3,0,0,0,0,0,0
1516821,76,18,1937,2,"male",292,94,27,13,0,0,0,13,0
1516830,18,29,1995,10,"male",29,24,20,6,17,2,15,4,2
1516839,68,11,1945,8,"male",1135,379,271,20,3,1,2,19,1
1516850,57,4,1956,4,"male",93,33,22,0,1,0,1,0,0
1516875,18,19,1995,4,"male",681,475,296,127,88,127,73,0,15
1516876,28,8,1985,2,"female",401,37,24,2,1,2,1,0,0
1516901,36,20,1977,12,"male",392,39,29,2,0,0,0,2,0
1516908,28,27,1985,12,"female",155,18,16,49,56,49,46,0,10
1516918,33,22,1980,10,"female",373,7,4,6,0,0,0,6,0
1516929,32,4,1981,1,"male",407,87,76,0,0,0,0,0,0
1516931,23,19,1990,12,"male",172,9,1,0,0,0,0,0,0
1516937,100,1,1913,12,"female",171,0,0,0,0,0,0,0,0
1516969,26,17,1987,1,"male",420,41,33,0,1,0,0,0,1
1516998,41,3,1972,8,"male",165,72,61,41,84,16,19,25,65
1517004,46,26,1967,4,"male",297,28,7,7,8,7,7,0,1
1517016,22,23,1991,4,"female",527,107,19,2,15,2,14,0,1
1517039,57,10,1956,12,"male",215,241,193,245,362,245,307,0,55
1517048,64,6,1949,3,"male",852,172,102,3,7,0,0,3,7
1517065,103,13,1910,8,"male",1040,88,55,4,1,4,1,0,0
1517129,14,10,1999,12,"female",2,1,1,0,0,0,0,0,0
1517140,27,3,1986,12,"male",462,90,39,48,48,48,45,0,3
1517160,24,22,1989,11,"female",436,2,2,0,1,0,1,0,0
1517175,22,5,1991,7,"female",441,47,30,0,0,0,0,0,0
1517178,97,6,1916,6,"male",1213,819,527,1206,696,1206,647,0,49
1517181,55,19,1958,4,"female",300,48,29,338,38,338,27,0,11
1517184,28,22,1985,9,"female",551,84,49,4,25,4,15,0,10
1517196,25,2,1988,10,"female",272,48,29,13,31,0,26,13,5
1517242,31,8,1982,5,"male",291,484,393,637,72,637,69,0,3
1517275,25,1,1988,1,"male",251,78,65,0,4,0,3,0,1
1517306,18,2,1995,6,"female",674,126,66,26,56,19,44,7,12
1517343,29,13,1984,6,"female",362,69,50,9,13,9,8,0,5
1517345,55,27,1958,6,"female",1331,58,22,53,79,15,13,38,66
1517359,14,2,1999,5,"male",368,88,57,0,1,0,0,0,1
1517383,21,24,1992,9,"male",424,32,0,0,4,0,0,0,4
1517385,58,16,1955,6,"male",134,25,11,13,37,8,26,5,11
1517406,20,2,1993,1,"male",524,350,266,12,17,12,7,0,10
1517434,47,1,1966,12,"female",1842,9,4,16,4,16,2,0,2
1517465,64,30,1949,9,"female",1007,139,105,4,5,4,2,0,3
1517485,71,7,1942,6,"female",1299,193,95,1049,312,0,157,1049,155
1517497,21,18,1992,11,"male",53,94,84,385,98,385,71,0,27
1517526,14,19,1999,5,"male",167,23,17,1,2,1,1,0,1
1517538,14,16,1999,3,"female",21,0,0,0,0,0,0,0,0
1517544,41,18,1972,8,"female",983,716,349,2089,2700,982,1491,1107,1209
1517557,25,16,1988,6,"male",543,38,34,15,17,15,6,0,11
1517567,15,3,1998,4,"male",8,58,45,7,6,7,1,0,5
1517585,23,10,1990,10,"male",336,165,125,2,2,2,2,0,0
1517604,42,12,1971,1,"male",1158,18,5,0,0,0,0,0,0
1517605,75,7,1938,5,"female",166,86,81,438,12,0,6,438,6
1517626,52,13,1961,5,"female",1384,47,16,9,1,0,1,9,0
1517631,49,15,1964,4,"female",1193,145,90,146,54,146,53,0,1
1517637,23,9,1990,1,"female",360,299,274,1,0,0,0,1,0
1517646,16,7,1997,2,"female",213,243,125,12,0,12,0,0,0
1517672,45,25,1968,9,"male",586,153,70,95,116,95,67,0,49
1517681,18,6,1995,1,"female",328,156,73,12,11,12,11,0,0
1517685,24,7,1989,6,"male",279,163,131,10,3,10,0,0,3
1517720,54,25,1959,2,"female",873,82,33,226,29,0,4,226,25
1517723,18,16,1995,6,"female",297,1421,837,775,1518,775,1185,0,333
1517739,57,1,1956,7,"male",573,23,11,1,0,1,0,0,0
1517761,19,16,1994,1,"male",467,185,133,3,0,0,0,3,0
1517799,28,27,1985,8,"male",163,146,97,6,25,0,2,6,23
1517839,19,10,1994,6,"female",419,193,113,258,174,55,40,203,134
1517866,21,16,1992,9,"male",85,84,76,1,0,0,0,1,0
1517869,25,6,1988,6,"male",261,694,543,2,3,2,1,0,2
1517870,46,12,1967,1,"male",385,1,0,0,0,0,0,0,0
1517871,17,30,1996,4,"female",245,109,35,18,24,18,18,0,6
1517883,38,23,1975,6,"male",513,66,49,98,31,98,17,0,14
1517903,45,11,1968,1,"female",1644,836,615,386,682,238,295,148,387
1517914,20,1,1993,1,"female",675,119,69,246,172,122,92,124,80
1517941,59,1,1954,1,"male",298,19,2,3,6,1,5,2,1
1517951,22,20,1991,5,"male",497,51,33,0,0,0,0,0,0
1517962,56,11,1957,7,"male",622,18,12,0,13,0,8,0,5
1517967,70,8,1943,12,"female",1310,158,71,93,78,0,16,93,62
1517984,14,27,1999,2,"female",516,3966,2308,86,721,23,454,63,267
1517995,22,25,1991,11,"female",471,267,179,1,0,1,0,0,0
1517999,16,29,1997,9,"male",667,74,52,4,0,4,0,0,0
1518009,33,24,1980,4,"male",511,141,90,6,27,4,13,2,14
1518017,51,28,1962,3,"female",419,64,33,67,1,67,1,0,0
1518061,44,28,1969,7,"male",513,269,164,2091,568,109,354,1982,214
1518072,34,14,1979,4,"male",357,193,181,1366,442,1366,427,0,15
1518116,50,22,1963,5,"male",49,5,1,3,2,0,2,3,0
1518157,28,7,1985,9,"male",809,373,306,34,4,34,3,0,1
1518182,23,23,1990,10,"male",202,54,30,19,77,19,13,0,64
1518200,33,25,1980,6,"female",405,11,9,2,16,2,5,0,11
1518215,16,20,1997,3,"male",0,30,27,0,0,0,0,0,0
1518216,28,20,1985,6,"male",636,120,98,3,227,3,216,0,11
1518226,36,29,1977,8,"male",252,465,162,22,11,22,9,0,2
1518231,24,2,1989,6,"male",53,37,33,2,13,1,9,1,4
1518245,20,3,1993,8,"female",147,191,46,125,117,125,74,0,43
1518291,66,20,1947,8,"female",609,38,25,3,1,3,1,0,0
1518308,47,4,1966,2,"male",194,27,15,34,74,0,1,34,73
1518314,19,7,1994,1,"male",406,144,116,0,0,0,0,0,0
1518344,18,15,1995,5,"male",506,1003,655,134,195,134,131,0,64
1518352,26,6,1987,5,"male",312,34,5,0,11,0,4,0,7
1518354,53,20,1960,6,"male",407,244,125,4,7,4,6,0,1
1518370,30,9,1983,3,"male",382,136,124,1,4,1,3,0,1
1518416,31,2,1982,5,"male",82,7,5,2,1,0,0,2,1
1518426,85,23,1928,5,"male",1295,1505,812,138,220,118,90,20,130
1518445,74,30,1939,10,"female",1338,34,24,5,14,0,8,5,6
1518457,20,4,1993,6,"female",115,118,92,56,241,22,94,34,147
1518522,21,25,1992,8,"male",667,236,168,16,7,4,5,12,2
1518534,69,18,1944,4,"female",275,32,22,9,5,0,4,9,1
1518588,61,5,1952,5,"male",88,1,0,0,0,0,0,0,0
1518590,26,11,1987,7,"male",427,165,112,1,4,0,0,1,4
1518599,23,1,1990,1,"male",219,34,32,10,0,10,0,0,0
1518604,28,26,1985,6,"male",854,19,18,1,0,0,0,1,0
1518614,67,18,1946,12,"female",300,9,7,10,0,0,0,10,0
1518619,16,23,1997,1,"male",6,4,4,0,0,0,0,0,0
1518630,18,9,1995,9,"male",451,60,10,0,7,0,6,0,1
1518644,52,27,1961,9,"male",591,27,26,0,0,0,0,0,0
1518656,53,30,1960,9,"female",455,65,30,497,111,0,34,497,77
1518700,31,29,1982,11,"male",331,74,30,52,18,5,10,47,8
1518726,103,5,1910,6,"male",666,63,21,531,99,531,86,0,13
1518729,34,2,1979,8,"female",119,128,65,204,212,60,63,144,149
1518762,21,7,1992,1,"male",6,7,6,2,1,2,1,0,0
1518772,17,24,1996,11,"female",239,472,337,589,248,589,223,0,25
1518785,66,2,1947,8,"male",896,692,514,402,976,355,883,47,93
1518791,81,24,1932,10,"female",974,278,65,2,8,1,6,1,2
1518861,93,8,1920,7,"female",1365,232,81,501,334,100,203,401,131
1518887,42,19,1971,4,"female",356,2,2,0,0,0,0,0,0
1518891,15,13,1998,3,"male",677,218,110,8,9,3,1,5,8
1518918,18,19,1995,12,"female",282,23,14,27,12,26,4,1,8
1518919,18,4,1995,5,"female",321,581,478,0,0,0,0,0,0
1518921,25,12,1988,12,"female",237,18,8,0,0,0,0,0,0
1518937,53,15,1960,7,"male",375,8,8,0,0,0,0,0,0
1518939,15,10,1998,2,"female",124,133,63,41,9,41,3,0,6
1519009,22,26,1991,3,"male",349,74,68,2,0,2,0,0,0
1519030,17,26,1996,2,"male",414,64,47,0,0,0,0,0,0
1519058,31,11,1982,4,"male",525,17,7,0,0,0,0,0,0
1519061,23,1,1990,6,"male",398,214,159,2,9,2,1,0,8
1519104,28,19,1985,1,"female",16,25,12,0,0,0,0,0,0
1519108,69,17,1944,9,"female",93,21,14,3,3,3,2,0,1
1519123,40,6,1973,5,"male",1111,49,24,2,1,0,1,2,0
1519134,42,2,1971,10,"male",287,18,5,149,85,148,83,1,2
1519139,99,22,1914,8,"male",1235,90,24,1,2,1,2,0,0
1519180,53,30,1960,10,"female",1538,67,11,32,57,32,44,0,13
1519183,26,1,1987,1,"female",12,15,13,3,0,3,0,0,0
1519207,31,15,1982,7,"male",571,127,39,32,38,32,37,0,1
1519219,19,1,1994,8,"male",275,108,99,3,0,3,0,0,0
1519242,40,14,1973,7,"female",279,34,22,1,2,0,2,1,0
1519260,37,9,1976,8,"male",337,25,21,1,0,0,0,1,0
1519264,48,12,1965,1,"male",79,0,0,0,0,0,0,0,0
1519294,27,12,1986,7,"male",424,42,30,2,0,2,0,0,0
1519325,31,27,1982,2,"male",1338,123,116,0,0,0,0,0,0
1519333,51,28,1962,8,"male",240,70,51,35,43,35,31,0,12
1519410,75,12,1938,9,"male",1814,565,310,24,26,19,15,5,11
1519425,36,9,1977,9,"male",445,27,13,10,0,10,0,0,0
1519427,43,17,1970,6,"male",241,218,182,2,0,2,0,0,0
1519428,72,2,1941,12,"male",1387,378,239,119,212,0,73,119,139
1519431,20,22,1993,8,"female",945,1513,665,1064,1912,1053,1760,11,152
1519432,31,10,1982,8,"male",668,125,71,4,0,4,0,0,0
1519441,14,31,1999,10,"female",293,860,698,30,52,29,17,1,35
1519442,57,24,1956,5,"male",1047,161,116,154,81,0,13,154,68
1519451,44,25,1969,6,"male",402,154,113,16,8,13,6,3,2
1519463,63,4,1950,1,"female",150,29,26,1,46,1,35,0,11
1519470,17,29,1996,12,"female",178,93,86,20,4,20,0,0,4
1519476,26,6,1987,6,"female",518,381,154,9,26,9,11,0,15
1519478,89,31,1924,1,"male",1353,732,285,390,730,390,233,0,497
1519518,53,1,1960,1,"female",373,14,11,0,0,0,0,0,0
1519524,61,13,1952,3,"female",1599,92,22,0,26,0,17,0,9
1519531,28,15,1985,10,"female",935,265,94,293,349,289,175,4,174
1519552,14,2,1999,4,"female",273,833,425,2613,2112,2321,1543,292,569
1519579,23,23,1990,6,"male",354,62,60,0,1,0,0,0,1
1519603,22,1,1991,4,"female",496,51,41,162,159,93,84,69,75
1519625,15,8,1998,10,"female",89,996,385,181,984,93,425,88,559
1519626,67,31,1946,7,"male",1445,39,35,2,11,0,0,2,11
1519661,42,6,1971,9,"male",481,117,81,2,1,2,1,0,0
1519663,99,21,1914,1,"male",455,738,535,0,1,0,1,0,0
1519673,53,16,1960,4,"female",63,21,19,9,3,6,1,3,2
1519736,16,23,1997,7,"female",71,123,64,0,0,0,0,0,0
1519813,23,7,1990,2,"male",78,18,16,15,12,15,7,0,5
1519818,35,4,1978,11,"female",498,95,60,490,92,167,57,323,35
1519849,37,8,1976,10,"female",437,29,19,44,0,44,0,0,0
1519856,50,9,1963,8,"female",626,319,269,182,31,182,16,0,15
1519862,51,25,1962,10,"male",260,1,0,0,0,0,0,0,0
1519868,18,31,1995,1,"female",48,46,26,33,72,9,33,24,39
1519878,63,24,1950,12,"female",646,22,16,28,13,2,8,26,5
1519897,43,31,1970,7,"male",327,44,16,186,212,186,191,0,21
1519910,48,15,1965,12,"male",1088,56,26,60,2,23,1,37,1
1519911,50,19,1963,2,"female",63,58,47,629,424,0,39,629,385
1519931,17,26,1996,8,"female",404,138,115,0,1,0,1,0,0
1519958,44,10,1969,4,"female",922,176,158,1124,172,1106,155,18,17
1519968,13,27,2000,4,"male",183,219,200,3,27,1,6,2,21
1519969,14,26,1999,5,"male",385,23,19,0,5,0,4,0,1
1519983,18,27,1995,7,"female",213,319,59,2,2,2,2,0,0
1519987,19,18,1994,6,"male",105,17,17,13,4,0,1,13,3
1519995,67,9,1946,6,"female",1355,49,26,96,32,96,25,0,7
1519998,52,18,1961,10,"male",63,34,31,2,3,2,2,0,1
1520019,28,2,1985,10,"female",2592,387,285,428,237,428,211,0,26
1520038,15,29,1998,11,"male",503,191,161,0,5,0,1,0,4
1520048,18,19,1995,10,"female",392,116,80,14,35,14,23,0,12
1520068,80,1,1933,5,"female",1049,41,19,0,0,0,0,0,0
1520075,34,18,1979,2,"male",342,88,75,4,8,4,3,0,5
1520081,45,2,1968,7,"male",2329,68,23,9,1,9,0,0,1
1520141,60,1,1953,1,"male",192,24,13,6,14,0,7,6,7
1520157,19,23,1994,11,"female",619,779,518,76,460,14,325,62,135
1520216,25,10,1988,6,"female",263,36,26,37,3,0,0,37,3
1520225,46,10,1967,8,"female",202,0,0,0,0,0,0,0,0
1520242,28,21,1985,9,"male",1279,192,134,0,0,0,0,0,0
1520248,22,13,1991,5,"female",10,1,0,0,0,0,0,0,0
1520307,18,6,1995,2,"female",398,584,319,476,1106,390,369,86,737
1520331,65,12,1948,6,"female",1105,40,24,27,15,0,9,27,6
1520341,52,25,1961,8,"male",347,45,32,3,17,3,15,0,2
1520359,23,24,1990,7,"male",432,190,72,11,19,11,12,0,7
1520366,18,12,1995,1,"male",343,45,28,5,0,0,0,5,0
1520387,27,9,1986,12,"male",151,17,3,2,10,2,10,0,0
1520397,16,19,1997,9,"female",103,46,33,81,101,78,81,3,20
1520414,28,12,1985,12,"female",573,8,5,779,26,779,17,0,9
1520417,37,27,1976,12,"male",212,158,102,27,2,0,0,27,2
1520432,23,2,1990,10,"male",271,228,180,2,6,0,0,2,6
1520435,21,30,1992,6,"male",829,63,14,1,11,1,11,0,0
1520448,26,3,1987,6,"male",20,14,7,0,0,0,0,0,0
1520500,28,19,1985,10,"male",420,303,170,2,3,2,2,0,1
1520534,33,1,1980,1,"male",288,17,8,0,0,0,0,0,0
1520543,16,30,1997,6,"male",92,304,236,191,140,191,114,0,26
1520563,30,1,1983,4,"male",231,102,90,0,1,0,1,0,0
1520568,17,10,1996,1,"male",153,291,238,2,7,0,2,2,5
1520609,52,28,1961,8,"male",242,55,38,23,10,5,0,18,10
1520623,35,12,1978,7,"female",410,85,42,1109,183,749,124,360,59
1520625,51,8,1962,1,"male",135,7,5,7,3,7,3,0,0
1520635,30,20,1983,9,"female",541,34,24,0,0,0,0,0,0
1520637,35,1,1978,2,"male",999,39,37,9,3,9,3,0,0
1520639,19,21,1994,7,"male",667,83,77,3,0,3,0,0,0
1520651,50,3,1963,10,"female",411,28,7,27,1,0,0,27,1
1520666,51,3,1962,7,"male",43,25,21,2,2,2,2,0,0
1520670,17,18,1996,2,"male",259,605,493,262,489,143,299,119,190
1520671,26,5,1987,1,"female",617,80,33,224,25,224,18,0,7
1520770,63,31,1950,8,"male",144,14,11,56,4,0,4,56,0
1520806,17,17,1996,7,"male",313,814,661,30,1,30,1,0,0
1520847,48,6,1965,2,"female",656,22,13,72,24,72,13,0,11
1520856,43,10,1970,2,"male",355,88,43,8,27,8,20,0,7
1520888,36,14,1977,1,"male",316,20,15,0,1,0,1,0,0
1520933,17,27,1996,8,"male",235,238,141,38,0,0,0,38,0
1521027,60,12,1953,4,"male",1402,345,48,17,5,17,4,0,1
1521063,19,28,1994,10,"female",547,295,71,17,26,17,23,0,3
1521064,61,19,1952,9,"female",256,39,26,1,0,0,0,1,0
1521112,51,17,1962,12,"female",1446,343,252,1525,737,0,330,1525,407
1521115,34,3,1979,11,"male",352,359,282,5,18,5,16,0,2
1521145,108,12,1905,6,"male",1572,224,88,29,23,24,12,5,11
1521146,30,5,1983,6,"male",736,98,84,267,565,211,202,56,363
1521161,35,23,1978,5,"male",116,68,63,0,0,0,0,0,0
1521165,16,27,1997,6,"female",313,214,64,299,45,299,42,0,3
1521177,21,17,1992,12,"female",468,383,242,379,189,379,184,0,5
1521188,23,24,1990,8,"male",1869,581,253,139,239,136,183,3,56
1521224,37,16,1976,1,"male",617,69,60,2,0,2,0,0,0
1521228,75,18,1938,11,"male",632,48,36,1,11,0,7,1,4
1521230,18,22,1995,5,"male",1470,302,142,16,2,1,1,15,1
1521245,57,22,1956,4,"female",1126,122,53,179,472,40,248,139,224
1521275,50,23,1963,9,"female",304,37,25,26,16,0,8,26,8
1521304,18,1,1995,1,"male",210,1,1,0,0,0,0,0,0
1521305,26,19,1987,7,"male",257,23,11,9,0,0,0,9,0
1521324,25,12,1988,12,"male",331,358,276,15,69,12,36,3,33
1521325,44,5,1969,8,"male",581,20,10,6,4,6,4,0,0
1521338,103,23,1910,9,"female",21,28,26,2,32,2,21,0,11
1521385,24,30,1989,3,"male",111,28,24,0,0,0,0,0,0
1521404,14,24,1999,10,"male",364,70,63,5,0,4,0,1,0
1521416,108,1,1905,1,"male",857,34,15,0,0,0,0,0,0
1521422,29,15,1984,12,"male",256,90,58,4,25,4,20,0,5
1521423,63,16,1950,9,"male",1382,129,37,201,430,0,125,201,305
1521425,16,1,1997,8,"male",164,94,72,0,0,0,0,0,0
1521447,67,7,1946,9,"male",906,12,9,0,0,0,0,0,0
1521451,21,17,1992,3,"male",277,36,23,4,13,4,12,0,1
1521456,57,19,1956,12,"female",1626,113,64,1,6,0,6,1,0
1521459,29,7,1984,7,"male",950,118,56,7,1,6,0,1,1
1521464,47,5,1966,6,"female",933,36,18,96,37,95,14,1,23
1521472,28,19,1985,7,"female",202,71,42,13,7,13,5,0,2
1521497,23,15,1990,4,"male",305,33,29,7,5,7,5,0,0
1521499,21,17,1992,3,"male",563,260,202,0,2,0,0,0,2
1521507,17,15,1996,5,"male",349,58,48,51,18,23,2,28,16
1521539,23,12,1990,12,"female",515,56,13,60,0,60,0,0,0
1521576,15,8,1998,5,"male",476,1232,735,436,1815,178,1064,258,751
1521598,103,26,1910,6,"female",2006,97,54,45,15,44,12,1,3
1521600,103,13,1910,10,"male",754,400,242,131,47,58,21,73,26
1521608,33,2,1980,2,"male",397,182,172,36,9,36,9,0,0
1521609,20,28,1993,3,"male",152,0,0,2,0,0,0,2,0
1521610,21,10,1992,6,"male",54,39,35,188,26,188,20,0,6
1521624,23,4,1990,6,"male",100,31,28,0,5,0,3,0,2
1521636,33,2,1980,1,"male",608,7,4,3,1,3,1,0,0
1521643,16,18,1997,3,"female",300,150,95,82,30,82,17,0,13
1521698,19,16,1994,8,"male",501,152,97,103,61,99,52,4,9
1521730,53,8,1960,1,"male",1355,92,44,15,20,0,2,15,18
1521743,47,7,1966,11,"male",108,0,0,0,0,0,0,0,0
1521744,16,5,1997,8,"female",921,242,156,2,47,1,28,1,19
1521745,56,1,1957,5,"male",135,95,85,110,27,0,1,110,26
1521754,33,8,1980,7,"female",171,209,43,844,442,844,351,0,91
1521762,52,15,1961,8,"female",858,130,82,6,15,6,6,0,9
1521778,27,11,1986,11,"male",137,14,8,0,0,0,0,0,0
1521795,35,11,1978,5,"male",404,15,14,2,0,2,0,0,0
1521824,19,4,1994,5,"male",967,94,61,8,18,8,17,0,1
1521828,21,2,1992,9,"male",525,191,142,41,59,12,14,29,45
1521832,23,10,1990,10,"male",135,35,24,25,17,25,16,0,1
1521848,25,27,1988,7,"male",614,208,189,456,287,452,243,4,44
1521859,21,15,1992,1,"female",487,319,45,6,6,6,6,0,0
1521868,29,11,1984,7,"female",270,199,27,6,27,0,12,6,15
1521890,55,19,1958,6,"female",853,214,125,106,4,100,2,6,2
1521904,58,18,1955,8,"male",192,1,0,600,0,600,0,0,0
1521921,27,19,1986,3,"male",325,25,24,0,1,0,1,0,0
1521924,23,7,1990,2,"male",357,55,38,77,22,77,19,0,3
1521972,15,2,1998,5,"male",339,59,54,0,0,0,0,0,0
1521973,52,18,1961,2,"female",1127,108,58,146,243,146,172,0,71
1521976,29,31,1984,1,"male",118,37,22,32,22,9,16,23,6
1521991,26,2,1987,2,"male",182,239,145,1814,3863,17,1835,1797,2028
1522003,18,24,1995,8,"male",151,106,84,42,7,42,5,0,2
1522030,32,18,1981,3,"male",532,17,17,4,0,0,0,4,0
1522032,65,25,1948,8,"male",1541,2860,1503,2046,1702,1832,1081,214,621
1522044,19,11,1994,11,"male",151,57,47,0,9,0,8,0,1
1522045,48,28,1965,10,"male",151,1,1,9,0,7,0,2,0
1522064,24,19,1989,5,"male",409,45,17,4,8,4,7,0,1
1522104,25,16,1988,10,"male",409,501,312,90,73,90,65,0,8
1522110,37,19,1976,8,"male",131,20,20,0,1,0,1,0,0
1522121,23,29,1990,3,"male",409,457,425,0,5,0,5,0,0
1522135,74,7,1939,3,"female",147,45,33,16,0,16,0,0,0
1522182,16,29,1997,5,"male",247,154,101,14,3,13,1,1,2
1522217,26,4,1987,6,"male",259,60,51,1,0,1,0,0,0
1522224,28,28,1985,10,"male",313,150,75,32,25,21,18,11,7
1522251,29,7,1984,1,"male",165,19,18,112,16,110,16,2,0
1522263,24,22,1989,9,"male",441,39,25,12,12,12,6,0,6
1522273,23,10,1990,9,"male",197,254,205,41,22,41,14,0,8
1522284,22,17,1991,3,"female",154,156,13,127,36,127,34,0,2
1522292,15,11,1998,4,"male",543,203,106,19,38,14,7,5,31
1522303,38,2,1975,2,"male",449,4,1,6,0,6,0,0,0
1522323,45,7,1968,12,"male",470,189,75,74,0,74,0,0,0
1522326,27,24,1986,5,"male",415,100,76,2,2,2,1,0,1
1522334,37,30,1976,6,"male",398,7,6,0,0,0,0,0,0
1522339,20,1,1993,11,"female",468,319,244,863,287,174,118,689,169
1522344,51,20,1962,5,"female",79,225,215,50,107,47,100,3,7
1522347,19,2,1994,3,"male",877,89,31,47,0,47,0,0,0
1522354,68,27,1945,1,"male",387,92,64,10,6,0,0,10,6
1522367,50,13,1963,12,"female",674,132,78,77,13,0,2,77,11
1522393,23,14,1990,6,"male",585,278,178,13,4,12,3,1,1
1522394,19,1,1994,10,"male",142,266,216,332,57,330,47,2,10
1522432,18,16,1995,3,"male",452,691,569,11,30,11,25,0,5
1522451,48,22,1965,12,"male",250,71,65,407,299,114,134,293,165
1522472,19,19,1994,7,"female",135,220,180,645,303,645,254,0,49
1522485,27,23,1986,10,"male",399,380,330,15,17,15,17,0,0
1522490,33,4,1980,8,"male",347,28,26,3,0,1,0,2,0
1522510,28,4,1985,4,"male",265,1,1,0,0,0,0,0,0
1522515,21,1,1992,11,"male",438,31,5,0,3,0,3,0,0
1522534,34,2,1979,12,"female",390,2,2,0,0,0,0,0,0
1522538,23,18,1990,9,"male",733,64,37,3,1,3,1,0,0
1522574,25,14,1988,1,"male",595,13,11,1,1,1,1,0,0
1522636,24,29,1989,6,"male",857,258,206,1,0,1,0,0,0
1522643,18,6,1995,3,"female",266,544,171,42,648,42,544,0,104
1522690,34,10,1979,2,"male",687,74,15,2,0,2,0,0,0
1522697,70,11,1943,8,"male",989,26,15,1,1,0,0,1,1
1522706,15,20,1998,5,"male",421,74,10,1,0,1,0,0,0
1522711,31,26,1982,8,"male",485,37,33,2,6,2,3,0,3
1522719,22,25,1991,4,"male",509,343,285,2,24,2,7,0,17
1522722,59,17,1954,8,"male",625,17,8,7,0,7,0,0,0
1522750,19,27,1994,11,"male",66,49,32,142,152,142,152,0,0
1522753,63,30,1950,6,"female",1789,79,51,20,21,20,12,0,9
1522760,20,12,1993,11,"male",343,159,99,9,4,3,3,6,1
1522787,108,31,1905,12,"male",1401,39,26,16,19,16,16,0,3
1522812,20,17,1993,12,"male",310,100,50,14,2,10,2,4,0
1522844,20,5,1993,8,"male",152,221,208,342,145,30,80,312,65
1522848,20,19,1993,1,"male",50,44,44,0,0,0,0,0,0
1522849,32,1,1981,1,"male",15,7,4,0,0,0,0,0,0
1522853,32,17,1981,9,"male",459,209,113,129,6,129,5,0,1
1522870,43,1,1970,1,"male",159,31,31,5,0,5,0,0,0
1522886,50,2,1963,10,"male",1380,93,47,9,4,9,4,0,0
1522898,29,7,1984,3,"male",227,27,11,37,2,37,1,0,1
1522904,20,23,1993,4,"male",1594,505,127,11,26,10,14,1,12
1522943,72,23,1941,2,"female",1281,47,26,18,10,18,9,0,1
1522956,23,16,1990,4,"male",508,71,47,0,0,0,0,0,0
1522969,22,5,1991,6,"female",83,164,52,64,9,64,9,0,0
1522979,25,19,1988,6,"female",249,367,282,1467,1536,1466,1267,1,269
1522989,21,7,1992,8,"male",677,462,422,77,23,77,19,0,4
1522993,16,6,1997,4,"male",262,179,88,86,0,86,0,0,0
1523041,18,5,1995,12,"male",405,102,79,0,0,0,0,0,0
1523093,23,31,1990,7,"male",177,172,127,13,8,13,5,0,3
1523098,16,19,1997,8,"male",665,61,31,0,6,0,5,0,1
1523100,25,29,1988,12,"female",411,85,57,12,13,12,10,0,3
1523107,68,28,1945,4,"female",1061,55,31,73,4,0,1,73,3
1523121,24,13,1989,11,"male",374,43,35,1,1,0,0,1,1
1523166,18,8,1995,1,"male",216,113,98,2,0,2,0,0,0
1523193,20,5,1993,1,"female",195,103,80,3,80,1,66,2,14
1523205,22,27,1991,6,"female",468,382,93,0,1,0,1,0,0
1523224,23,15,1990,5,"male",374,412,337,28,127,28,112,0,15
1523226,13,24,2000,4,"female",134,169,66,27,28,4,4,23,24
1523237,43,4,1970,3,"male",74,2,1,0,0,0,0,0,0
1523239,18,19,1995,11,"male",672,264,103,0,2,0,2,0,0
1523257,43,24,1970,12,"male",300,64,51,0,0,0,0,0,0
1523285,39,4,1974,7,"male",47,55,52,9,0,7,0,2,0
1523305,47,30,1966,9,"male",247,130,99,3,4,3,4,0,0
1523339,52,27,1961,11,"male",301,1,1,0,0,0,0,0,0
1523376,45,18,1968,2,"female",853,52,20,0,1,0,0,0,1
1523406,16,30,1997,1,"male",230,134,87,111,51,66,24,45,27
1523444,38,29,1975,10,"female",29,0,0,0,0,0,0,0,0
1523451,21,17,1992,6,"male",318,259,69,2004,1296,1656,702,348,594
1523467,27,27,1986,4,"male",524,103,50,27,23,27,17,0,6
1523474,54,9,1959,11,"female",75,37,28,118,29,118,19,0,10
1523478,26,1,1987,1,"male",314,1,1,0,0,0,0,0,0
1523487,59,14,1954,10,"female",549,69,24,46,33,0,5,46,28
1523506,29,7,1984,6,"male",489,42,31,3,3,3,3,0,0
1523528,23,20,1990,7,"male",691,329,188,40,1,40,1,0,0
1523552,20,17,1993,4,"female",574,631,369,300,321,300,186,0,135
1523565,14,3,1999,4,"female",498,188,150,19,6,19,5,0,1
1523587,17,11,1996,2,"female",701,507,174,204,58,20,38,184,20
1523612,24,1,1989,1,"female",125,15,6,7,0,3,0,4,0
1523623,29,1,1984,1,"male",46,10,6,4,2,4,1,0,1
1523634,21,21,1992,6,"male",329,107,93,175,126,175,75,0,51
1523657,23,10,1990,9,"female",209,10,6,18,0,18,0,0,0
1523675,19,28,1994,12,"female",455,31,29,98,80,1,33,97,47
1523682,33,29,1980,6,"female",215,40,4,1707,199,1707,93,0,106
1523708,39,21,1974,4,"male",256,63,55,8,11,8,10,0,1
1523726,31,4,1982,4,"male",426,59,44,94,19,87,10,7,9
1523737,19,1,1994,10,"male",309,136,102,55,79,54,60,1,19
1523741,21,28,1992,10,"male",25,12,12,0,0,0,0,0,0
1523781,17,10,1996,7,"female",365,152,81,36,54,36,32,0,22
1523782,108,6,1905,1,"male",1340,385,271,471,270,0,165,471,105
1523812,34,13,1979,4,"male",35,0,0,35,0,35,0,0,0
1523906,28,26,1985,5,"male",23,21,21,5,1,5,0,0,1
1523913,93,9,1920,12,"male",1134,804,735,0,5,0,5,0,0
1523914,68,20,1945,10,"male",1998,250,108,113,68,88,48,25,20
1523980,32,13,1981,1,"male",636,567,443,46,7,46,6,0,1
1523992,43,6,1970,10,"female",1626,72,50,574,483,570,168,4,315
1523997,15,5,1998,3,"male",24,76,63,13,54,13,16,0,38
1524061,71,24,1942,4,"female",1564,85,50,47,46,27,27,20,19
1524075,16,24,1997,5,"male",328,194,113,13,18,13,18,0,0
1524106,26,18,1987,9,"male",1026,385,226,1,6,1,5,0,1
1524108,21,2,1992,6,"male",535,201,128,22,9,22,5,0,4
1524112,20,15,1993,8,"female",196,36,14,40,23,40,0,0,23
1524120,45,10,1968,10,"male",180,24,13,0,0,0,0,0,0
1524141,20,2,1993,6,"male",233,68,26,42,34,0,29,42,5
1524150,33,31,1980,1,"male",182,24,24,4,1,4,1,0,0
1524162,27,28,1986,1,"female",136,105,69,2,1,2,1,0,0
1524166,15,13,1998,5,"male",346,132,95,12,1,11,1,1,0
1524221,16,4,1997,8,"female",85,2,0,0,0,0,0,0,0
1524258,27,18,1986,11,"male",387,154,47,74,55,23,41,51,14
1524284,24,7,1989,6,"male",460,41,27,102,40,102,31,0,9
1524291,42,7,1971,9,"female",627,330,146,137,254,137,238,0,16
1524296,43,12,1970,9,"female",603,9,6,35,31,35,26,0,5
1524301,28,27,1985,8,"male",255,132,97,10,52,9,15,1,37
1524326,44,14,1969,6,"female",376,31,24,73,46,73,24,0,22
1524340,50,10,1963,6,"female",231,63,29,203,114,203,101,0,13
1524346,17,30,1996,11,"male",364,161,107,2,0,2,0,0,0
1524399,38,12,1975,6,"male",58,40,32,7,1,6,1,1,0
1524414,41,3,1972,6,"male",745,36,14,1,1,1,1,0,0
1524419,44,8,1969,11,"male",131,38,9,7,26,5,6,2,20
1524489,24,9,1989,1,"male",821,6,3,9,0,0,0,9,0
1524496,19,22,1994,3,"male",78,63,52,5,26,5,15,0,11
1524510,18,2,1995,2,"male",383,8,7,0,0,0,0,0,0
1524521,38,30,1975,7,"male",228,13,9,0,0,0,0,0,0
1524538,22,4,1991,4,"female",302,124,72,62,61,43,26,19,35
1524619,108,5,1905,7,"male",473,164,6,0,29,0,12,0,17
1524704,36,5,1977,5,"female",429,55,23,0,1,0,1,0,0
1524730,108,28,1905,3,"female",1311,137,87,27,13,27,10,0,3
1524764,59,28,1954,4,"female",1939,40,15,14,8,3,5,11,3
1524765,23,25,1990,1,"female",208,8,7,0,0,0,0,0,0
1524799,17,2,1996,7,"male",471,34,19,0,0,0,0,0,0
1524800,30,26,1983,6,"male",666,6,1,0,0,0,0,0,0
1524828,36,20,1977,6,"female",556,192,110,364,179,359,19,5,160
1524833,30,27,1983,8,"male",659,113,72,12,8,12,7,0,1
1524841,19,4,1994,9,"male",182,0,0,0,0,0,0,0,0
1524871,45,26,1968,2,"male",1958,43,30,11,29,11,27,0,2
1524882,89,10,1924,4,"male",2076,344,219,34,40,7,19,27,21
1524918,53,24,1960,5,"female",785,77,23,220,128,209,105,11,23
1524944,103,29,1910,3,"female",1686,379,199,92,76,80,38,12,38
1524979,15,5,1998,10,"male",44,184,170,81,51,81,51,0,0
1524985,37,14,1976,3,"male",502,27,22,6,1,6,1,0,0
1524999,20,17,1993,3,"female",596,4585,1744,1350,1963,1307,1431,43,532
1525008,16,12,1997,12,"female",172,368,122,88,54,28,16,60,38
1525022,32,1,1981,1,"male",229,43,35,10,61,10,43,0,18
1525056,25,18,1988,9,"male",364,132,75,115,15,86,6,29,9
1525060,25,18,1988,6,"male",651,74,52,8,25,8,18,0,7
1525092,61,23,1952,6,"male",614,67,48,23,3,23,3,0,0
1525104,15,20,1998,2,"male",411,273,236,0,3,0,0,0,3
1525115,56,24,1957,7,"male",1926,17,4,2,3,0,0,2,3
1525159,70,1,1943,7,"male",438,6,2,0,0,0,0,0,0
1525165,47,26,1966,4,"female",444,33,11,48,3,48,1,0,2
1525191,19,13,1994,1,"female",102,22,11,0,5,0,2,0,3
1525210,31,14,1982,5,"female",261,39,29,79,101,0,30,79,71
1525215,25,2,1988,7,"male",453,153,143,10,3,10,3,0,0
1525243,39,7,1974,4,"male",327,154,103,62,47,62,41,0,6
1525256,48,23,1965,12,"male",62,35,23,5,1,4,1,1,0
1525267,15,15,1998,4,"male",122,61,42,2,2,1,2,1,0
1525275,16,24,1997,5,"male",621,125,24,336,0,336,0,0,0
1525283,33,11,1980,12,"male",367,386,370,300,239,300,219,0,20
1525301,63,6,1950,1,"female",1131,17,5,5,13,0,5,5,8
1525316,45,26,1968,3,"female",595,87,45,691,113,691,106,0,7
1525363,19,26,1994,11,"female",109,5,4,40,26,40,21,0,5
1525387,26,18,1987,5,"female",493,103,58,981,30,226,21,755,9
1525398,22,4,1991,10,"female",268,47,26,0,0,0,0,0,0
1525399,20,13,1993,12,"male",99,213,98,213,269,52,57,161,212
1525426,33,12,1980,12,"male",720,36,14,0,3,0,3,0,0
1525460,15,31,1998,10,"male",159,27,24,0,1,0,0,0,1
1525461,19,13,1994,5,"male",318,333,290,8,4,5,4,3,0
1525474,23,6,1990,5,"female",111,47,34,7,72,7,60,0,12
1525483,18,12,1995,4,"male",303,374,252,19,1,19,1,0,0
1525497,68,17,1945,8,"male",504,898,807,15,1,15,0,0,1
1525516,16,21,1997,5,"female",526,204,111,100,1,99,1,1,0
1525528,18,12,1995,2,"male",682,516,344,163,150,163,125,0,25
1525546,57,30,1956,3,"male",1317,89,39,1,3,1,2,0,1
1525555,52,13,1961,3,"female",739,40,28,87,31,23,16,64,15
1525571,50,9,1963,4,"male",278,360,80,9,67,1,35,8,32
1525628,27,12,1986,3,"male",667,181,32,0,4,0,4,0,0
1525630,33,16,1980,4,"male",676,414,350,2,1,0,0,2,1
1525638,16,17,1997,3,"female",795,622,122,317,562,296,310,21,252
1525644,19,16,1994,8,"male",426,39,28,0,0,0,0,0,0
1525649,21,13,1992,3,"female",377,123,62,189,47,18,26,171,21
1525685,63,21,1950,4,"male",1627,145,77,5,36,0,14,5,22
1525688,25,16,1988,11,"male",691,35,0,0,0,0,0,0,0
1525699,20,13,1993,4,"male",189,21,21,1,1,1,0,0,1
1525705,25,17,1988,2,"male",172,165,121,12,56,12,42,0,14
1525763,14,30,1999,4,"female",250,0,0,0,0,0,0,0,0
1525793,35,24,1978,7,"female",320,38,23,30,73,23,26,7,47
1525813,89,29,1924,2,"female",818,32,15,4,27,0,16,4,11
1525821,28,1,1985,5,"female",333,200,174,651,326,622,180,29,146
1525844,19,1,1994,10,"male",225,209,124,2,3,2,3,0,0
1525937,45,1,1968,5,"male",648,1,1,24,5,22,1,2,4
1525942,65,28,1948,12,"male",703,12,3,0,4,0,4,0,0
1525968,19,29,1994,7,"male",357,46,27,0,0,0,0,0,0
1525977,25,17,1988,10,"female",218,329,278,26,60,26,59,0,1
1526013,58,20,1955,8,"female",684,58,28,54,6,53,2,1,4
1526047,26,21,1987,6,"female",751,333,306,176,262,176,200,0,62
1526050,37,21,1976,9,"female",346,60,18,0,2,0,2,0,0
1526057,24,11,1989,12,"male",273,154,73,88,192,88,116,0,76
1526069,74,23,1939,9,"female",342,1526,1051,472,2262,472,1167,0,1095
1526099,100,2,1913,2,"male",1237,707,278,37,27,32,7,5,20
1526115,43,1,1970,1,"male",364,11,10,5,4,5,4,0,0
1526119,33,29,1980,8,"female",406,145,87,26,7,23,3,3,4
1526130,14,15,1999,9,"male",47,5,1,0,0,0,0,0,0
1526131,58,11,1955,4,"male",735,119,52,5,10,5,6,0,4
1526146,48,2,1965,12,"male",989,33,18,1,0,1,0,0,0
1526149,43,10,1970,8,"male",154,11,9,5,0,0,0,5,0
1526155,28,5,1985,5,"male",279,151,119,5,2,5,1,0,1
1526159,52,24,1961,4,"male",429,51,26,2,2,0,0,2,2
1526179,67,13,1946,2,"female",781,28,10,46,4,25,0,21,4
1526187,25,10,1988,7,"male",115,17,17,0,0,0,0,0,0
1526192,21,23,1992,11,"male",318,31,19,0,0,0,0,0,0
1526222,52,1,1961,8,"female",246,49,42,2,4,2,4,0,0
1526239,23,23,1990,3,"male",391,2,2,0,0,0,0,0,0
1526241,29,15,1984,6,"male",117,36,35,58,8,0,7,58,1
1526257,32,10,1981,7,"female",195,50,40,79,30,79,27,0,3
1526312,28,3,1985,3,"male",480,12,12,0,19,0,3,0,16
1526317,21,1,1992,6,"male",367,270,99,40,10,30,4,10,6
1526329,26,17,1987,11,"male",137,111,100,0,0,0,0,0,0
1526353,22,21,1991,7,"male",573,21,11,1,0,1,0,0,0
1526367,47,29,1966,12,"female",110,33,30,41,18,41,15,0,3
1526390,29,24,1984,8,"female",328,107,77,1178,527,935,171,243,356
1526412,18,22,1995,12,"male",210,68,63,170,96,170,69,0,27
1526425,32,18,1981,8,"male",717,132,72,14,0,14,0,0,0
1526427,15,7,1998,8,"male",237,214,106,0,0,0,0,0,0
1526443,92,4,1921,1,NA,2303,73,28,339,350,266,240,73,110
1526474,24,3,1989,7,"male",365,917,851,422,224,422,213,0,11
1526475,17,28,1996,5,"male",196,204,188,12,8,12,3,0,5
1526477,71,11,1942,7,"female",1586,30,19,31,8,31,2,0,6
1526507,57,3,1956,10,"male",1180,65,14,2,2,2,1,0,1
1526508,29,1,1984,1,"male",9,6,6,31,53,31,51,0,2
1526514,25,1,1988,1,"male",133,6,3,0,0,0,0,0,0
1526533,19,3,1994,3,"male",460,233,23,27,41,20,20,7,21
1526556,19,20,1994,1,"male",188,94,44,11,35,11,17,0,18
1526593,25,18,1988,9,"male",510,63,59,4,6,1,4,3,2
1526617,36,31,1977,10,"male",636,339,308,29,13,27,5,2,8
1526631,15,5,1998,10,"female",603,59,35,67,39,66,35,1,4
1526656,26,11,1987,1,"male",414,97,95,1,0,0,0,1,0
1526660,18,25,1995,1,"female",137,39,36,212,14,205,4,7,10
1526661,16,29,1997,12,"male",625,437,216,49,21,49,11,0,10
1526726,32,9,1981,6,"male",97,48,41,13,3,0,0,13,3
1526732,27,22,1986,5,"female",701,229,127,21,11,18,7,3,4
1526734,24,26,1989,9,"male",358,27,21,44,0,0,0,44,0
1526779,15,7,1998,11,"female",248,546,384,53,44,51,23,2,21
1526780,18,30,1995,5,"female",159,90,51,13,50,7,18,6,32
1526818,108,29,1905,3,"male",162,88,79,10,8,10,7,0,1
1526838,47,18,1966,9,"male",176,13,10,63,16,63,12,0,4
1526865,91,21,1922,11,"male",878,43,15,0,0,0,0,0,0
1526876,26,24,1987,9,"female",314,126,82,32,70,32,53,0,17
1526898,24,25,1989,11,"female",198,116,45,116,86,61,60,55,26
1526930,23,24,1990,11,"female",522,142,88,30,81,20,32,10,49
1526932,54,1,1959,10,"male",157,32,21,8,0,0,0,8,0
1526937,27,1,1986,1,"male",556,78,55,39,5,0,0,39,5
1526949,18,8,1995,6,"male",531,59,29,0,0,0,0,0,0
1526953,25,8,1988,8,"male",53,43,29,3,2,3,2,0,0
1526965,33,1,1980,6,"male",29,1,0,0,0,0,0,0,0
1526980,57,12,1956,4,"male",1972,10,3,2,0,2,0,0,0
1527013,27,26,1986,6,"male",820,34,13,101,22,101,20,0,2
1527018,25,21,1988,5,"male",261,26,9,507,14,507,12,0,2
1527025,13,23,2000,4,"male",307,146,99,23,17,4,8,19,9
1527043,16,1,1997,2,"male",174,22,16,0,0,0,0,0,0
1527051,53,11,1960,5,"male",240,16,5,26,16,0,6,26,10
1527055,19,12,1994,10,"male",455,222,189,0,0,0,0,0,0
1527060,32,18,1981,4,"female",386,191,113,520,6,520,5,0,1
1527088,39,23,1974,1,"male",377,84,51,1,1,0,0,1,1
1527099,37,4,1976,3,"male",729,149,60,0,3,0,2,0,1
1527103,34,9,1979,1,"male",872,294,117,6,4,0,4,6,0
1527137,73,15,1940,5,"male",163,17,4,87,12,0,2,87,10
1527188,18,13,1995,12,"male",287,7,6,0,0,0,0,0,0
1527195,18,1,1995,10,"male",181,109,100,3,6,3,5,0,1
1527212,33,4,1980,4,"male",292,3,3,0,0,0,0,0,0
1527251,19,7,1994,11,"male",88,262,243,4,18,4,12,0,6
1527256,28,23,1985,8,"female",685,42,18,336,212,334,121,2,91
1527265,108,18,1905,4,"male",1617,277,161,2,41,0,17,2,24
1527267,40,11,1973,7,"male",417,12,12,0,0,0,0,0,0
1527276,71,25,1942,11,"male",1299,61,20,0,0,0,0,0,0
1527300,32,6,1981,5,"female",380,96,45,51,12,0,4,51,8
1527302,15,24,1998,11,"female",126,52,12,7,2,2,0,5,2
1527359,35,18,1978,8,"female",1524,262,94,4,6,4,5,0,1
1527414,25,10,1988,10,"male",594,366,187,3,26,3,17,0,9
1527421,23,25,1990,3,"male",139,82,72,95,14,95,14,0,0
1527462,48,20,1965,10,"female",274,31,19,80,9,80,7,0,2
1527476,33,13,1980,1,"female",1109,233,101,1654,1628,1646,495,8,1133
1527486,20,11,1993,5,"male",517,2983,2772,253,1763,245,1544,8,219
1527515,64,23,1949,9,"male",1334,242,83,241,547,3,264,238,283
1527521,50,6,1963,11,"female",675,185,118,2554,466,1931,233,623,233
1527532,54,16,1959,6,"female",615,88,45,33,0,33,0,0,0
1527544,25,13,1988,8,"male",499,487,392,1443,664,1203,360,240,304
1527546,16,25,1997,3,"male",477,233,151,6,1,6,1,0,0
1527565,20,4,1993,5,"female",269,43,25,0,0,0,0,0,0
1527612,26,11,1987,3,"female",317,0,0,0,0,0,0,0,0
1527637,36,7,1977,7,"male",554,743,654,1,0,1,0,0,0
1527640,51,21,1962,2,"female",638,104,72,219,205,202,97,17,108
1527676,19,22,1994,2,"male",516,888,633,1281,343,1281,281,0,62
1527708,24,14,1989,10,"male",256,100,88,27,11,18,4,9,7
1527750,62,24,1951,9,"female",1731,61,51,87,63,81,52,6,11
1527765,36,29,1977,6,"female",428,28,19,27,18,27,12,0,6
1527788,18,14,1995,1,"male",150,532,463,185,86,185,82,0,4
1527796,20,15,1993,9,"male",912,87,47,0,0,0,0,0,0
1527852,49,9,1964,11,"female",1204,117,60,541,424,541,313,0,111
1527866,17,13,1996,2,"male",727,207,143,0,0,0,0,0,0
1527878,31,24,1982,9,"male",478,73,34,153,10,153,10,0,0
1527879,14,7,1999,1,"male",224,37,29,0,13,0,5,0,8
1527899,71,30,1942,8,"female",667,658,433,12,86,12,74,0,12
1527901,45,31,1968,8,"female",159,43,24,158,53,158,49,0,4
1527911,62,14,1951,6,"male",1186,58,26,267,33,0,9,267,24
1527920,40,11,1973,7,"female",340,45,21,203,4,17,3,186,1
1527922,21,6,1992,7,"male",431,62,53,0,0,0,0,0,0
1527930,52,4,1961,3,"female",427,138,70,474,101,0,6,474,95
1527976,35,11,1978,3,"male",732,4,0,0,1,0,0,0,1
1527979,18,1,1995,1,"female",79,3,3,0,0,0,0,0,0
1527993,108,1,1905,1,"male",1080,32,25,1,1,1,0,0,1
1527994,48,20,1965,11,"male",299,220,154,743,418,743,281,0,137
1528006,18,12,1995,2,"male",285,45,45,0,0,0,0,0,0
1528025,18,4,1995,5,"male",261,73,43,0,2,0,0,0,2
1528038,75,9,1938,10,"female",808,106,76,25,7,25,5,0,2
1528047,24,18,1989,9,"male",34,4,4,0,0,0,0,0,0
1528050,14,7,1999,4,"female",551,250,124,284,403,258,334,26,69
1528053,18,28,1995,2,"male",134,161,118,1,0,1,0,0,0
1528059,97,16,1916,1,"male",1553,89,62,7,4,0,2,7,2
1528060,37,5,1976,9,"female",1316,32,14,35,79,35,28,0,51
1528066,25,1,1988,1,"male",18,6,5,0,0,0,0,0,0
1528083,19,3,1994,12,"female",404,269,193,0,4,0,1,0,3
1528099,47,13,1966,8,"male",583,4,1,1,0,1,0,0,0
1528102,64,9,1949,5,"female",1533,94,48,92,527,21,332,71,195
1528124,46,25,1967,8,"female",141,150,54,54,291,23,103,31,188
1528130,19,29,1994,9,"male",180,1,0,13,0,0,0,13,0
1528138,62,4,1951,5,"male",1341,122,69,22,45,22,40,0,5
1528140,60,8,1953,3,"female",283,20,17,66,17,66,8,0,9
1528169,25,9,1988,6,"male",473,215,175,193,123,193,59,0,64
1528186,108,3,1905,12,"male",1900,345,118,160,37,116,28,44,9
1528237,33,15,1980,1,"female",271,72,34,7,4,4,1,3,3
1528241,63,13,1950,6,"female",451,129,64,0,0,0,0,0,0
1528247,15,31,1998,10,"female",123,94,29,0,0,0,0,0,0
1528251,103,12,1910,11,"male",1590,256,118,370,43,280,24,90,19
1528277,107,3,1906,8,"female",2459,583,279,98,112,67,88,31,24
1528286,27,5,1986,4,"male",564,13,12,0,0,0,0,0,0
1528294,43,21,1970,6,"female",210,68,47,11,0,11,0,0,0
1528313,17,27,1996,2,"female",447,2083,311,599,1372,598,1048,1,324
1528335,35,1,1978,6,"female",507,98,22,2,2,2,2,0,0
1528338,20,31,1993,10,"male",507,6,5,0,0,0,0,0,0
1528351,32,15,1981,5,"female",311,120,104,328,167,328,33,0,134
1528367,25,19,1988,1,"female",1008,126,55,4,8,4,8,0,0
1528386,21,5,1992,11,"female",11,99,96,7,16,7,13,0,3
1528390,18,9,1995,2,"female",1023,59,29,26,14,26,13,0,1
1528400,45,28,1968,10,"male",349,9,7,0,0,0,0,0,0
1528417,28,6,1985,4,"male",410,22,2,2,0,2,0,0,0
1528438,43,29,1970,6,"male",924,36,20,0,0,0,0,0,0
1528453,24,22,1989,5,"female",693,99,42,17,34,17,34,0,0
1528480,20,17,1993,7,"female",97,485,36,46,158,46,124,0,34
1528529,55,26,1958,6,"female",714,153,87,0,0,0,0,0,0
1528540,18,29,1995,11,"female",502,188,106,28,1,23,0,5,1
1528570,40,2,1973,4,"female",302,45,40,39,18,0,16,39,2
1528590,20,3,1993,3,"female",319,868,619,2961,598,2129,333,832,265
1528596,21,17,1992,8,"male",405,14,11,320,51,296,32,24,19
1528603,59,24,1954,9,"female",457,247,207,468,589,468,297,0,292
1528635,22,12,1991,5,"male",630,836,655,2,83,2,53,0,30
1528672,23,16,1990,4,"male",384,38,14,1,3,1,2,0,1
1528681,20,1,1993,9,"male",454,39,20,0,0,0,0,0,0
1528701,58,15,1955,8,"female",308,29,21,6,6,4,2,2,4
1528709,31,11,1982,12,"male",253,145,129,10,5,10,3,0,2
1528710,47,5,1966,4,"male",631,0,0,1,1,0,1,1,0
1528713,57,9,1956,3,"female",290,25,13,460,55,460,7,0,48
1528782,43,12,1970,6,"female",412,134,94,29,55,3,31,26,24
1528795,18,28,1995,2,"female",145,15,13,2,9,0,6,2,3
1528839,49,9,1964,12,"female",738,94,75,6,2,6,1,0,1
1528849,37,25,1976,9,"male",466,11,7,43,0,43,0,0,0
1528893,23,11,1990,9,"male",1067,56,19,3,1,3,1,0,0
1528936,108,1,1905,1,"female",2297,96,46,225,67,213,40,12,27
1528944,33,15,1980,8,"male",523,48,28,0,0,0,0,0,0
1528952,51,21,1962,2,"male",481,67,32,45,50,43,39,2,11
1528963,60,15,1953,11,"female",753,13,7,128,8,0,6,128,2
1528979,34,8,1979,3,"male",308,77,51,13,33,13,29,0,4
1529021,14,26,1999,9,"male",184,11,11,0,3,0,2,0,1
1529026,23,6,1990,6,"female",747,591,382,0,0,0,0,0,0
1529068,22,11,1991,9,"male",112,370,347,2,4,2,4,0,0
1529073,19,6,1994,11,"male",643,317,120,5,19,5,18,0,1
1529077,14,6,1999,8,"female",88,266,37,24,112,24,97,0,15
1529082,15,1,1998,3,"female",614,1309,316,29,114,9,54,20,60
1529084,57,22,1956,6,"female",1515,61,33,93,14,2,5,91,9
1529105,19,27,1994,12,"male",74,228,202,2,7,2,6,0,1
1529142,48,25,1965,6,"male",1777,51,19,889,381,683,301,206,80
1529175,33,3,1980,2,"male",434,120,25,1,0,1,0,0,0
1529203,26,4,1987,12,"male",553,136,120,0,1,0,1,0,0
1529206,30,2,1983,12,"male",265,79,52,0,9,0,3,0,6
1529208,48,14,1965,10,"female",1446,274,182,70,15,0,1,70,14
1529259,103,10,1910,10,"male",987,134,103,93,69,0,23,93,46
1529270,28,6,1985,6,"female",296,98,94,86,53,86,32,0,21
1529352,15,10,1998,8,"female",211,91,33,29,0,29,0,0,0
1529366,14,15,1999,8,"male",309,37,28,4,6,4,4,0,2
1529379,22,18,1991,6,"male",227,230,156,334,226,264,141,70,85
1529390,68,19,1945,7,"male",352,134,91,22,12,22,12,0,0
1529418,34,2,1979,1,"male",314,10,8,0,0,0,0,0,0
1529477,108,21,1905,6,"male",1290,240,45,520,410,0,131,520,279
1529498,53,5,1960,1,"male",661,13,9,0,5,0,5,0,0
1529514,20,26,1993,12,"male",409,48,28,64,24,34,8,30,16
1529515,60,27,1953,6,"female",288,9,7,0,0,0,0,0,0
1529529,78,17,1935,2,"female",1613,25,13,4,0,0,0,4,0
1529534,19,11,1994,8,"female",33,125,18,12,20,12,11,0,9
1529565,42,3,1971,12,"female",458,36,23,51,27,0,15,51,12
1529599,38,18,1975,1,"male",234,2,1,13,2,0,0,13,2
1529610,108,16,1905,3,"male",1597,94,33,3,0,3,0,0,0
1529623,42,4,1971,4,"female",1805,186,124,39,95,39,82,0,13
1529624,18,26,1995,4,"male",1020,173,35,191,15,191,14,0,1
1529628,108,28,1905,8,"male",185,598,444,1189,2629,70,1680,1119,949
1529639,75,10,1938,6,"female",1308,64,41,34,13,0,9,34,4
1529645,51,15,1962,9,"female",180,39,32,36,54,36,27,0,27
1529677,18,29,1995,10,"female",284,626,21,30,67,30,64,0,3
1529680,66,12,1947,7,"male",827,67,38,279,198,0,60,279,138
1529699,33,7,1980,1,"male",415,14,9,2,15,2,3,0,12
1529700,28,11,1985,9,"female",162,87,52,145,101,145,56,0,45
1529705,56,5,1957,4,"female",813,29,25,1,15,0,2,1,13
1529707,22,16,1991,10,"male",572,542,441,103,45,103,43,0,2
1529731,25,28,1988,8,"male",317,93,69,0,2,0,0,0,2
1529732,45,11,1968,4,"male",248,31,11,355,243,310,233,45,10
1529759,65,1,1948,3,"male",1668,118,69,1310,320,5,249,1305,71
1529766,23,10,1990,10,"female",1690,2177,353,927,1483,572,230,355,1253
1529770,21,23,1992,3,"male",427,52,50,5,0,0,0,5,0
1529833,25,6,1988,3,"female",339,82,29,7,23,5,17,2,6
1529853,20,18,1993,2,"male",256,180,125,40,3,0,0,40,3
1529861,16,2,1997,1,"female",585,150,104,95,31,70,16,25,15
1529872,19,3,1994,8,"male",707,53,10,11,19,11,14,0,5
1529875,17,11,1996,8,"female",83,7,6,5,0,0,0,5,0
1529876,25,15,1988,5,"female",315,127,61,129,50,129,35,0,15
1529880,70,17,1943,7,"female",134,6,3,15,10,0,1,15,9
1529894,22,3,1991,9,"female",818,358,206,15,12,15,12,0,0
1529908,83,18,1930,9,"female",309,13,9,18,0,0,0,18,0
1529912,16,24,1997,1,"male",48,364,309,1181,855,315,145,866,710
1529914,14,16,1999,7,"female",122,5,4,36,4,36,3,0,1
1529971,16,5,1997,1,"female",490,300,188,19,58,19,52,0,6
1529977,44,28,1969,9,"male",267,6,5,787,85,0,20,787,65
1529985,28,22,1985,2,"male",175,187,165,1,0,1,0,0,0
1529989,21,4,1992,3,"male",501,1192,601,974,1869,114,932,860,937
1530007,29,7,1984,8,"male",415,68,49,0,13,0,6,0,7
1530028,34,17,1979,3,"female",40,28,20,32,9,32,4,0,5
1530041,63,27,1950,7,"male",1742,24,16,0,1,0,1,0,0
1530105,47,11,1966,4,"female",306,276,195,981,623,827,346,154,277
1530113,45,29,1968,2,"male",1183,1,1,2,0,2,0,0,0
1530116,19,26,1994,7,"female",363,877,444,3198,1962,1927,918,1271,1044
1530129,26,30,1987,10,"male",502,4,4,0,0,0,0,0,0
1530139,18,17,1995,1,"female",220,26,18,74,22,74,17,0,5
1530142,47,15,1966,12,"male",237,43,9,35,56,35,51,0,5
1530143,48,18,1965,3,"female",337,4,3,0,0,0,0,0,0
1530144,106,15,1907,11,"male",1031,1,1,1244,47,1237,31,7,16
1530175,57,13,1956,11,"female",669,5,5,0,8,0,4,0,4
1530180,19,27,1994,2,"male",1065,955,734,3,7,3,6,0,1
1530192,31,26,1982,8,"male",389,475,433,937,449,787,261,150,188
1530204,99,31,1914,3,"female",1275,140,64,1,6,1,6,0,0
1530224,45,3,1968,6,"female",462,131,99,330,107,161,45,169,62
1530239,20,23,1993,1,"male",506,338,303,23,10,1,7,22,3
1530287,25,10,1988,11,"male",504,14,1,0,0,0,0,0,0
1530289,46,22,1967,10,"female",335,14,7,9,8,9,5,0,3
1530293,48,14,1965,4,"female",206,85,47,3,49,0,21,3,28
1530310,68,10,1945,5,"female",719,55,22,0,0,0,0,0,0
1530317,32,23,1981,1,"male",299,81,40,124,87,118,72,6,15
1530324,43,23,1970,2,"male",454,14,8,17,0,17,0,0,0
1530331,108,26,1905,3,"female",1041,568,145,34,63,34,63,0,0
1530346,33,29,1980,10,"male",333,17,10,6,26,6,12,0,14
1530347,66,15,1947,7,"female",851,152,100,339,24,339,8,0,16
1530355,30,19,1983,6,"male",664,77,40,78,2,78,2,0,0
1530365,36,16,1977,9,"male",1824,193,99,11,6,11,4,0,2
1530366,23,22,1990,1,"male",18,6,3,0,0,0,0,0,0
1530385,69,20,1944,7,"male",1797,152,17,177,103,135,43,42,60
1530389,46,31,1967,8,"female",2342,224,86,178,210,34,155,144,55
1530401,19,16,1994,3,"male",853,13,11,1,0,1,0,0,0
1530405,20,10,1993,5,"male",293,20,12,150,6,150,4,0,2
1530427,22,20,1991,3,"female",744,1411,795,647,910,574,491,73,419
1530437,15,7,1998,9,"male",222,482,264,0,21,0,14,0,7
1530442,20,22,1993,12,"female",1118,144,107,0,0,0,0,0,0
1530494,18,19,1995,12,"male",359,848,752,349,205,349,181,0,24
1530507,19,8,1994,7,"male",572,203,65,13,4,0,0,13,4
1530528,14,4,1999,5,"female",271,45,31,33,17,0,12,33,5
1530537,52,6,1961,8,"male",584,88,66,4,0,4,0,0,0
1530557,17,22,1996,5,"female",385,441,154,47,368,0,213,47,155
1530572,18,2,1995,3,"male",163,45,30,0,3,0,2,0,1
1530580,63,27,1950,3,"female",1690,273,122,224,256,2,191,222,65
1530617,24,2,1989,4,"male",284,2,2,0,0,0,0,0,0
1530673,17,18,1996,9,"male",133,35,32,1,0,0,0,1,0
1530695,32,9,1981,7,"male",597,47,17,1,0,1,0,0,0
1530700,59,26,1954,4,"male",184,20,18,0,0,0,0,0,0
1530728,66,30,1947,4,"male",707,56,31,14,19,1,8,13,11
1530743,15,12,1998,3,"female",1673,1871,835,1029,2375,491,1927,538,448
1530744,18,6,1995,1,"male",157,131,126,2,0,0,0,2,0
1530796,46,1,1967,6,"male",639,47,8,91,42,91,31,0,11
1530818,20,20,1993,10,"female",296,93,69,5,9,5,8,0,1
1530832,17,30,1996,7,"female",519,41,15,1,0,1,0,0,0
1530847,18,22,1995,6,"male",188,90,44,0,0,0,0,0,0
1530852,20,8,1993,8,"female",22,2,2,1,1,1,1,0,0
1530866,43,20,1970,8,"male",97,28,15,1,0,1,0,0,0
1530905,36,20,1977,3,"male",168,161,122,2,19,0,5,2,14
1530921,17,20,1996,12,"female",438,928,810,27,265,27,166,0,99
1530936,108,22,1905,2,"male",1729,136,91,44,16,44,6,0,10
1530938,25,4,1988,7,"male",1337,1122,620,112,309,112,276,0,33
1530973,25,31,1988,12,"male",706,892,819,23,0,4,0,19,0
1530987,50,30,1963,9,"male",678,133,58,191,20,164,10,27,10
1530988,20,13,1993,7,"female",692,371,105,6,50,3,17,3,33
1530992,26,10,1987,4,"male",340,15,8,0,0,0,0,0,0
1531024,70,28,1943,5,"female",1124,58,22,150,6,106,4,44,2
1531035,38,11,1975,6,"male",420,35,30,5,26,2,3,3,23
1531038,62,7,1951,7,"female",681,164,113,198,51,198,41,0,10
1531040,29,8,1984,7,"female",187,9,5,18,7,18,6,0,1
1531044,62,3,1951,10,"female",91,229,195,388,410,388,299,0,111
1531054,22,14,1991,7,"female",189,24,20,91,22,38,12,53,10
1531056,22,24,1991,11,"female",1601,1126,331,143,281,117,126,26,155
1531071,29,5,1984,6,"male",162,34,29,1,1,1,0,0,1
1531093,80,5,1933,7,"female",1674,220,61,25,10,0,5,25,5
1531094,54,3,1959,1,"male",16,42,16,2,8,0,0,2,8
1531117,37,20,1976,5,"female",491,146,17,267,520,267,418,0,102
1531149,47,16,1966,12,"female",191,37,17,194,22,0,3,194,19
1531164,53,26,1960,2,"male",988,10,3,0,4,0,4,0,0
1531184,66,10,1947,11,"female",1759,71,34,17,31,14,12,3,19
1531202,60,14,1953,2,"male",106,48,14,6,13,6,12,0,1
1531212,21,1,1992,1,"male",570,86,69,3,1,0,1,3,0
1531280,65,22,1948,11,"male",1069,38,20,0,0,0,0,0,0
1531316,29,16,1984,4,"male",1603,32,13,0,4,0,4,0,0
1531343,28,17,1985,7,"female",456,176,58,150,100,150,86,0,14
1531376,51,22,1962,10,"male",591,24,14,4,1,0,0,4,1
1531381,56,5,1957,4,"male",1142,130,80,33,12,33,1,0,11
1531383,32,27,1981,6,"female",954,352,245,493,183,50,55,443,128
1531403,17,13,1996,3,"male",235,36,26,0,0,0,0,0,0
1531419,14,21,1999,2,"female",237,410,289,360,450,360,338,0,112
1531452,14,16,1999,7,"male",318,950,783,104,202,83,160,21,42
1531459,17,22,1996,1,"female",423,174,98,35,127,29,32,6,95
1531474,25,16,1988,11,"male",842,675,492,314,249,153,112,161,137
1531493,46,25,1967,8,"male",92,0,0,0,0,0,0,0,0
1531505,30,19,1983,9,"male",332,156,102,5234,3941,5220,2458,14,1483
1531563,20,22,1993,9,"female",460,36,18,314,169,314,114,0,55
1531565,15,8,1998,10,"female",478,475,302,100,404,99,184,1,220
1531569,29,10,1984,6,"male",471,281,195,58,39,58,28,0,11
1531578,99,27,1914,2,"male",1000,318,248,0,1,0,1,0,0
1531579,16,22,1997,9,"male",298,101,68,135,83,94,38,41,45
1531605,19,1,1994,1,"male",53,5,4,4,1,4,1,0,0
1531608,33,12,1980,5,"male",608,590,380,452,363,452,307,0,56
1531609,20,10,1993,3,"male",96,33,11,0,0,0,0,0,0
1531641,15,6,1998,7,"male",177,662,395,1814,390,1660,183,154,207
1531642,26,11,1987,5,"male",1005,364,245,0,2,0,2,0,0
1531648,44,1,1969,1,"male",314,11,4,0,2,0,2,0,0
1531667,19,30,1994,5,"female",900,1404,690,39,72,12,31,27,41
1531680,18,12,1995,4,"male",223,458,297,29,0,29,0,0,0
1531741,69,19,1944,10,"male",1813,253,151,177,266,39,125,138,141
1531762,32,9,1981,3,"male",543,192,132,5,2,5,2,0,0
1531763,25,1,1988,1,"female",283,4,4,0,0,0,0,0,0
1531773,28,1,1985,4,"female",764,13,12,1,1,1,0,0,1
1531800,26,16,1987,3,"male",423,215,145,21,56,21,55,0,1
1531802,56,26,1957,7,"female",814,78,43,67,182,31,155,36,27
1531822,15,22,1998,1,"female",602,116,68,40,26,24,13,16,13
1531827,58,5,1955,9,"male",734,11,5,0,5,0,5,0,0
1531838,27,27,1986,11,"male",716,359,140,71,109,71,47,0,62
1531908,19,13,1994,5,"male",88,184,164,132,298,132,42,0,256
1531918,63,13,1950,9,"female",1117,23,6,3,15,2,6,1,9
1531922,15,2,1998,11,"female",309,64,39,12,3,12,3,0,0
1531994,56,8,1957,11,"male",144,192,179,25,38,25,16,0,22
1532012,19,15,1994,8,"male",394,4538,4144,4501,15088,4435,5961,66,9127
1532018,33,27,1980,4,"male",548,96,88,35,14,35,10,0,4
1532031,23,26,1990,7,"male",418,46,40,0,0,0,0,0,0
1532038,53,15,1960,10,"female",91,60,36,17,3,17,3,0,0
1532045,33,19,1980,5,"female",128,13,9,33,2,0,1,33,1
1532054,60,16,1953,9,"female",1693,39,20,196,5,196,4,0,1
1532055,48,27,1965,1,"female",1227,96,59,32,111,26,81,6,30
1532057,25,16,1988,5,"male",443,348,250,539,216,539,176,0,40
1532079,25,22,1988,4,"male",298,80,67,0,0,0,0,0,0
1532080,66,21,1947,1,"female",1014,47,23,2345,50,2344,30,1,20
1532086,14,31,1999,1,"male",418,147,110,19,0,19,0,0,0
1532152,39,22,1974,1,"female",398,57,35,1,0,1,0,0,0
1532182,54,17,1959,11,"female",400,20,13,5,20,5,17,0,3
1532190,14,8,1999,2,"female",146,31,19,176,67,176,49,0,18
1532194,13,9,2000,6,"female",548,148,81,187,185,187,101,0,84
1532202,14,23,1999,8,"female",107,23,9,0,7,0,3,0,4
1532204,49,21,1964,5,"female",430,92,33,0,0,0,0,0,0
1532231,36,1,1977,11,"female",574,85,44,0,0,0,0,0,0
1532243,24,1,1989,7,"male",1175,179,119,19,1,19,1,0,0
1532248,17,26,1996,10,"male",304,75,63,2,0,2,0,0,0
1532250,22,24,1991,11,"female",602,260,134,808,1026,0,235,808,791
1532261,28,11,1985,5,"male",335,62,32,0,1,0,0,0,1
1532286,18,17,1995,8,"male",27,246,185,125,315,122,207,3,108
1532299,21,18,1992,1,"male",67,116,108,1,3,1,2,0,1
1532322,82,1,1931,5,"male",1352,691,295,112,596,112,488,0,108
1532324,24,6,1989,10,"female",1331,240,92,0,3,0,1,0,2
1532329,21,22,1992,3,"female",113,123,97,80,85,67,58,13,27
1532340,14,10,1999,7,"male",95,154,128,300,326,300,182,0,144
1532366,47,7,1966,1,"male",362,78,42,137,37,0,12,137,25
1532379,103,30,1910,12,"male",772,1337,706,41,129,40,129,1,0
1532389,30,5,1983,9,"female",307,197,160,97,0,0,0,97,0
1532408,21,19,1992,10,"female",365,142,38,104,153,85,145,19,8
1532444,68,15,1945,5,"male",1134,286,265,65,11,65,8,0,3
1532451,19,28,1994,9,"female",1303,341,143,1187,1372,311,734,876,638
1532490,40,26,1973,2,"male",100,2,2,0,0,0,0,0,0
1532516,44,23,1969,11,"female",627,175,109,204,72,0,15,204,57
1532525,30,25,1983,9,"female",175,197,127,471,379,371,141,100,238
1532534,73,9,1940,10,"female",344,15,15,14,9,0,4,14,5
1532545,58,25,1955,11,"male",311,247,225,172,78,172,66,0,12
1532575,40,22,1973,1,"male",557,92,34,15,5,15,5,0,0
1532609,35,8,1978,7,"female",486,35,9,41,19,1,7,40,12
1532628,33,3,1980,4,"male",1215,96,19,8,1,2,1,6,0
1532636,50,2,1963,12,"female",399,36,25,61,5,61,2,0,3
1532672,99,14,1914,2,"male",217,45,35,15,1,15,1,0,0
1532696,45,4,1968,8,"male",1061,21,12,64,15,46,8,18,7
1532731,41,1,1972,2,"female",1515,174,80,576,618,226,416,350,202
1532733,108,5,1905,11,"male",1261,105,36,26,10,25,10,1,0
1532781,27,14,1986,1,"male",645,68,38,1,0,1,0,0,0
1532782,18,6,1995,10,"male",543,304,206,19,1,19,1,0,0
1532786,53,24,1960,4,"female",529,36,16,52,68,52,53,0,15
1532814,58,5,1955,7,"female",589,62,37,166,24,166,21,0,3
1532834,15,8,1998,7,"female",155,309,136,834,603,602,242,232,361
1532896,29,1,1984,9,"male",464,57,49,10,4,7,0,3,4
1532898,18,12,1995,12,"male",149,26,19,3,0,3,0,0,0
1532900,21,1,1992,7,"female",596,60,16,0,2,0,2,0,0
1532932,44,5,1969,4,"female",670,90,59,948,132,948,95,0,37
1532945,29,6,1984,6,"male",719,274,86,0,1,0,1,0,0
1532956,52,23,1961,12,"female",360,203,122,1028,263,293,159,735,104
1532990,63,22,1950,4,"male",2282,322,27,6,1,6,0,0,1
1533008,17,19,1996,9,"female",45,102,90,7,53,7,42,0,11
1533019,38,19,1975,12,"male",341,33,26,0,0,0,0,0,0
1533052,42,3,1971,11,"female",390,5,1,0,0,0,0,0,0
1533075,19,22,1994,2,"female",168,340,131,1169,1204,906,825,263,379
1533119,19,1,1994,8,"female",915,972,224,493,394,287,117,206,277
1533132,53,4,1960,5,"female",464,2,1,134,5,0,1,134,4
1533157,23,20,1990,3,"male",450,8,6,15,9,15,9,0,0
1533160,29,2,1984,3,"male",44,37,22,1,4,0,2,1,2
1533161,104,10,1909,7,"female",1667,672,207,503,408,78,128,425,280
1533201,22,2,1991,8,"female",1074,900,479,111,182,67,72,44,110
1533320,16,5,1997,9,"female",392,717,55,4,46,4,43,0,3
1533348,15,13,1998,6,"male",167,43,19,0,1,0,1,0,0
1533371,21,22,1992,7,"female",280,5,5,16,13,0,0,16,13
1533383,16,26,1997,9,"male",535,910,312,290,623,25,171,265,452
1533394,18,10,1995,9,"female",119,238,49,573,249,573,145,0,104
1533406,25,16,1988,5,"female",995,362,217,108,324,108,242,0,82
1533445,50,14,1963,10,"male",25,24,4,4,4,4,3,0,1
1533448,41,4,1972,4,"female",517,100,59,0,3,0,1,0,2
1533452,16,6,1997,8,"female",119,261,7,329,10,329,8,0,2
1533462,21,27,1992,8,"male",968,206,135,1,56,1,20,0,36
1533489,68,1,1945,1,"male",583,141,87,5,16,5,16,0,0
1533498,19,6,1994,9,"male",226,0,0,0,0,0,0,0,0
1533520,31,2,1982,1,"male",282,33,22,2,0,1,0,1,0
1533551,28,14,1985,2,"male",34,1,1,0,0,0,0,0,0
1533553,58,20,1955,3,"male",486,265,248,167,132,0,20,167,112
1533593,29,23,1984,12,"male",1522,69,44,6,11,6,3,0,8
1533601,16,9,1997,12,"female",637,46,18,42,3,42,3,0,0
1533604,35,20,1978,5,"male",435,6,3,31,8,17,5,14,3
1533632,23,30,1990,11,"female",203,78,62,0,0,0,0,0,0
1533668,64,4,1949,9,"male",892,101,35,47,41,22,27,25,14
1533680,32,23,1981,5,"male",1526,94,46,2,3,2,3,0,0
1533681,24,25,1989,6,"male",85,19,15,3,1,3,0,0,1
1533682,59,25,1954,1,"male",998,92,55,1,21,0,11,1,10
1533729,21,23,1992,9,"male",49,286,271,168,114,118,51,50,63
1533732,42,7,1971,7,"female",411,75,45,27,22,27,20,0,2
1533740,108,8,1905,11,"female",465,141,76,3,4,0,3,3,1
1533751,60,1,1953,6,"female",459,435,218,1059,1244,853,942,206,302
1533752,108,12,1905,9,"female",1000,130,34,2,0,2,0,0,0
1533753,53,17,1960,9,"male",666,48,29,3,16,3,12,0,4
1533805,18,14,1995,8,"male",631,289,159,17,2,17,1,0,1
1533817,54,3,1959,9,"male",391,5,3,2,6,0,6,2,0
1533827,26,7,1987,10,"female",1213,1012,674,698,586,201,163,497,423
1533828,35,14,1978,12,"female",53,45,26,16,9,16,9,0,0
1533840,23,1,1990,1,"male",464,1,1,1,0,0,0,1,0
1533847,18,18,1995,3,"male",233,31,21,1,0,1,0,0,0
1533866,23,31,1990,10,"female",345,87,56,1,4,1,4,0,0
1533870,17,6,1996,11,"female",721,1136,430,135,110,45,49,90,61
1533909,22,28,1991,7,"male",628,19,10,1,0,0,0,1,0
1533921,108,31,1905,10,"male",1292,566,451,0,0,0,0,0,0
1533935,59,31,1954,1,"female",977,24,19,3,1,0,0,3,1
1533955,52,20,1961,5,"male",329,142,77,14,3,0,0,14,3
1533984,26,20,1987,7,"female",66,6,3,15,16,15,7,0,9
1533986,18,9,1995,12,"female",391,190,63,30,24,0,8,30,16
1534011,35,12,1978,9,"male",356,37,22,3,0,3,0,0,0
1534039,18,30,1995,3,"male",313,171,137,0,0,0,0,0,0
1534045,66,29,1947,8,"male",1400,35,11,18,22,18,20,0,2
1534077,16,18,1997,12,"female",173,163,65,19,37,19,14,0,23
1534079,78,5,1935,7,"female",874,133,111,1529,1064,144,227,1385,837
1534087,19,10,1994,1,"female",90,124,50,0,0,0,0,0,0
1534110,80,18,1933,7,"male",769,173,143,0,0,0,0,0,0
1534120,28,9,1985,12,"male",1332,82,76,0,0,0,0,0,0
1534121,44,20,1969,8,"male",156,15,14,2,0,0,0,2,0
1534182,15,27,1998,12,"male",355,50,30,27,13,0,1,27,12
1534208,15,16,1998,9,"female",801,1232,658,1010,2331,52,1233,958,1098
1534218,16,25,1997,8,"male",741,235,93,3,30,3,4,0,26
1534250,23,26,1990,9,"female",402,198,125,112,244,112,66,0,178
1534257,63,11,1950,7,"male",1022,50,36,26,4,26,4,0,0
1534267,57,20,1956,11,"male",485,123,79,229,23,4,6,225,17
1534274,22,6,1991,2,"male",539,521,443,0,0,0,0,0,0
1534296,33,23,1980,12,"male",99,22,11,40,1,40,0,0,1
1534311,15,12,1998,12,"female",320,172,97,1,7,1,0,0,7
1534312,26,26,1987,4,"male",102,54,23,876,754,876,435,0,319
1534331,53,4,1960,4,"male",376,184,99,602,264,474,122,128,142
1534334,54,29,1959,6,"male",1057,31,13,85,143,59,73,26,70
1534346,23,7,1990,6,"male",880,1214,749,7,21,5,10,2,11
1534361,14,22,1999,2,"female",762,93,51,49,43,7,22,42,21
1534393,30,22,1983,10,"male",541,169,58,16,91,16,77,0,14
1534412,26,28,1987,10,"male",568,202,124,15,9,15,2,0,7
1534419,48,21,1965,5,"female",427,14,9,21,25,21,24,0,1
1534425,54,30,1959,5,"female",854,191,54,159,369,159,190,0,179
1534457,18,21,1995,1,"male",210,344,319,0,3,0,2,0,1
1534547,18,10,1995,1,"male",212,161,72,18,9,18,4,0,5
1534551,41,5,1972,2,"male",110,36,33,0,0,0,0,0,0
1534561,34,21,1979,4,"female",527,61,40,26,8,0,0,26,8
1534575,17,20,1996,6,"female",750,269,135,19,0,11,0,8,0
1534600,26,14,1987,3,"male",1032,330,199,2,6,0,2,2,4
1534609,16,13,1997,2,"female",330,128,80,1,8,1,5,0,3
1534643,32,7,1981,4,"female",818,356,267,354,82,199,55,155,27
1534651,22,13,1991,5,"male",395,31,26,0,0,0,0,0,0
1534657,24,2,1989,6,"male",332,0,0,0,0,0,0,0,0
1534708,20,24,1993,8,"female",545,90,60,0,1,0,0,0,1
1534738,71,4,1942,12,"female",698,39,23,112,2,0,2,112,0
1534771,49,28,1964,11,"male",156,2,0,0,0,0,0,0,0
1534773,17,23,1996,11,"male",495,106,75,0,0,0,0,0,0
1534793,103,3,1910,10,"male",1012,391,146,2,2,2,1,0,1
1534796,14,24,1999,6,"female",414,774,397,1952,1076,1541,444,411,632
1534803,26,1,1987,5,"female",352,73,21,544,876,544,424,0,452
1534811,23,5,1990,5,"male",309,69,61,0,0,0,0,0,0
1534829,75,14,1938,3,"male",1040,44,25,3,2,1,1,2,1
1534831,13,3,2000,3,"female",491,268,152,48,32,1,1,47,31
1534838,57,2,1956,10,"female",1816,279,50,88,240,87,160,1,80
1534878,62,27,1951,7,"female",481,106,65,845,548,0,91,845,457
1534882,33,1,1980,1,"male",529,81,36,3,1,3,1,0,0
1534883,55,17,1958,10,"male",311,27,13,111,22,0,3,111,19
1534886,22,9,1991,10,"female",280,28,15,25,55,0,17,25,38
1534906,69,23,1944,7,"male",893,2125,470,3395,2486,952,1261,2443,1225
1534925,29,9,1984,1,"male",713,104,62,8,7,2,4,6,3
1534976,49,25,1964,2,"male",36,250,90,657,83,657,69,0,14
1534981,25,2,1988,5,"male",58,34,16,1,5,1,5,0,0
1535010,29,15,1984,11,"male",108,25,11,100,79,100,29,0,50
1535023,30,3,1983,12,"male",242,102,45,71,4,71,3,0,1
1535029,19,9,1994,9,"female",616,85,58,37,197,37,135,0,62
1535031,32,20,1981,1,"male",389,31,14,0,0,0,0,0,0
1535041,64,10,1949,5,"male",1654,497,223,10,132,3,11,7,121
1535051,35,7,1978,8,"male",549,9,4,2,0,2,0,0,0
1535056,18,28,1995,9,"female",126,604,572,18,59,18,55,0,4
1535077,18,18,1995,6,"female",315,132,61,6,36,6,20,0,16
1535096,17,22,1996,4,"male",617,502,322,133,260,56,135,77,125
1535098,17,1,1996,11,"female",17,38,29,2,5,2,2,0,3
1535130,25,4,1988,10,"male",99,182,152,0,0,0,0,0,0
1535133,19,24,1994,8,"male",487,64,30,0,0,0,0,0,0
1535172,25,12,1988,1,"male",32,3,3,9,0,9,0,0,0
1535188,21,9,1992,9,"female",1500,98,28,61,193,61,180,0,13
1535193,38,28,1975,2,"female",721,36,11,30,51,24,2,6,49
1535225,102,24,1911,10,"male",1499,202,67,279,104,54,32,225,72
1535233,61,2,1952,7,"female",1176,150,129,57,13,6,3,51,10
1535287,18,14,1995,5,"male",241,297,281,2,2,2,1,0,1
1535299,17,12,1996,8,"male",582,374,174,14,41,13,11,1,30
1535306,22,29,1991,11,"male",217,66,33,0,1,0,1,0,0
1535330,63,15,1950,2,"female",963,27,12,39,6,39,4,0,2
1535391,18,13,1995,7,"male",428,98,74,46,0,0,0,46,0
1535399,27,27,1986,3,"male",89,17,14,0,0,0,0,0,0
1535404,44,27,1969,8,"female",454,826,434,1511,2634,134,122,1377,2512
1535443,17,28,1996,7,"male",471,169,56,0,0,0,0,0,0
1535446,31,9,1982,5,"male",240,34,19,1,0,1,0,0,0
1535466,17,29,1996,10,"female",523,205,84,237,93,237,39,0,54
1535481,53,8,1960,4,"male",248,12,9,66,0,66,0,0,0
1535501,19,7,1994,7,"male",331,188,144,33,5,7,2,26,3
1535505,39,1,1974,5,"female",361,13,12,0,1,0,1,0,0
1535515,44,1,1969,3,"male",1758,480,243,150,186,137,128,13,58
1535528,50,7,1963,12,"female",578,78,21,0,0,0,0,0,0
1535529,21,7,1992,9,"female",165,69,44,13,8,13,7,0,1
1535531,59,2,1954,9,"female",771,24,13,4,5,2,3,2,2
1535544,32,1,1981,7,"male",278,52,46,4,1,4,1,0,0
1535551,52,20,1961,2,"female",26,9,7,38,7,38,7,0,0
1535553,55,25,1958,8,"female",765,99,71,209,64,0,42,209,22
1535558,29,17,1984,8,"male",238,213,171,31,10,31,4,0,6
1535609,21,16,1992,4,"female",429,127,4,23,54,23,39,0,15
1535616,47,24,1966,10,"female",422,77,54,7,7,0,0,7,7
1535619,26,22,1987,5,"male",953,1449,689,1732,1887,662,1061,1070,826
1535625,30,28,1983,11,"female",312,81,43,107,62,107,40,0,22
1535636,18,4,1995,5,"female",549,35,32,0,0,0,0,0,0
1535640,25,23,1988,9,"male",139,113,68,256,111,256,89,0,22
1535642,25,6,1988,1,"female",40,0,0,0,0,0,0,0,0
1535672,21,27,1992,5,"male",176,285,256,2,62,2,46,0,16
1535730,20,27,1993,8,"male",110,146,108,3,44,3,37,0,7
1535737,32,16,1981,10,"male",464,40,30,8,14,8,1,0,13
1535763,30,20,1983,4,"female",362,108,46,1106,339,1106,329,0,10
1535767,17,10,1996,10,"female",426,91,53,195,121,21,35,174,86
1535776,49,10,1964,11,"female",392,45,43,40,35,35,29,5,6
1535786,45,9,1968,7,"female",140,45,32,9,4,9,4,0,0
1535797,19,7,1994,6,"female",467,295,172,77,16,77,15,0,1
1535846,68,4,1945,3,"male",1737,39,10,81,9,0,3,81,6
1535850,65,1,1948,2,"male",1352,7,1,1,20,0,11,1,9
1535876,21,22,1992,4,"female",231,1253,835,4110,4714,4110,4258,0,456
1535894,16,26,1997,10,"female",272,37,28,53,51,24,16,29,35
1535922,35,4,1978,9,"male",492,68,38,0,12,0,0,0,12
1535936,18,9,1995,9,"female",103,149,126,0,0,0,0,0,0
1535942,30,9,1983,5,"female",337,134,96,706,306,706,204,0,102
1535943,37,30,1976,10,"male",502,63,52,14,21,14,21,0,0
1535958,39,8,1974,4,"female",373,5,2,0,0,0,0,0,0
1535975,28,28,1985,2,"male",316,118,89,11,0,11,0,0,0
1535995,21,10,1992,11,"male",420,92,55,1648,622,1511,382,137,240
1535996,45,27,1968,9,"male",257,9,6,0,0,0,0,0,0
1536006,19,30,1994,4,"male",125,73,66,52,2,37,0,15,2
1536025,20,2,1993,10,"male",182,0,0,0,0,0,0,0,0
1536035,52,22,1961,12,"female",233,113,65,16,5,7,2,9,3
1536070,39,2,1974,5,"male",45,12,12,1,0,1,0,0,0
1536088,17,6,1996,11,"female",128,695,395,1723,2062,1638,1869,85,193
1536090,67,7,1946,10,"male",2224,194,115,34,28,2,13,32,15
1536112,21,4,1992,4,"male",573,88,71,1,11,1,11,0,0
1536117,66,18,1947,6,"male",940,53,29,20,102,10,51,10,51
1536123,23,1,1990,10,"male",253,830,404,5,39,0,14,5,25
1536129,63,14,1950,11,"female",647,15,7,0,0,0,0,0,0
1536174,37,5,1976,10,"male",37,0,0,0,0,0,0,0,0
1536176,25,8,1988,6,"female",505,35,22,70,69,70,51,0,18
1536205,40,6,1973,6,"female",187,97,53,0,565,0,378,0,187
1536213,69,26,1944,7,"female",1696,232,107,176,139,161,104,15,35
1536216,33,21,1980,9,"male",476,74,70,0,12,0,4,0,8
1536228,105,8,1908,10,"male",1670,74,23,83,10,83,2,0,8
1536250,25,7,1988,4,"male",449,85,36,4,1,4,1,0,0
1536253,53,14,1960,11,"female",704,26,6,0,5,0,2,0,3
1536255,44,1,1969,1,"male",8,1,0,10,14,7,7,3,7
1536265,49,1,1964,12,"male",294,17,6,0,0,0,0,0,0
1536273,29,29,1984,5,"female",606,379,342,102,30,102,25,0,5
1536282,50,8,1963,2,"male",320,25,24,1,0,1,0,0,0
1536283,29,14,1984,7,"male",164,86,60,62,68,62,31,0,37
1536284,37,7,1976,4,"male",506,118,45,98,39,98,38,0,1
1536318,60,20,1953,6,"female",151,21,18,3,4,3,2,0,2
1536324,20,2,1993,2,"female",365,347,131,87,400,87,284,0,116
1536327,24,18,1989,6,"female",64,381,355,3131,1184,2872,591,259,593
1536345,64,24,1949,11,"female",1517,63,23,87,9,87,5,0,4
1536368,25,22,1988,2,"male",381,26,16,0,0,0,0,0,0
1536380,32,30,1981,7,"male",1775,223,75,8,9,8,8,0,1
1536381,14,4,1999,5,"female",13,262,126,539,238,16,128,523,110
1536384,16,23,1997,4,"female",295,157,89,58,85,58,68,0,17
1536389,49,24,1964,1,"female",343,271,80,179,65,0,13,179,52
1536392,33,10,1980,10,"male",34,138,133,4,11,4,11,0,0
1536410,55,31,1958,10,"female",2112,470,346,479,185,165,130,314,55
1536411,30,2,1983,10,"male",398,22,16,0,0,0,0,0,0
1536447,20,14,1993,9,"male",133,19,18,39,57,11,42,28,15
1536453,20,20,1993,6,"female",371,33,31,21,16,21,10,0,6
1536457,19,15,1994,4,"male",362,229,104,2,14,2,12,0,2
1536464,24,5,1989,10,"male",276,139,113,1,10,1,10,0,0
1536467,23,10,1990,7,"male",435,298,233,39,12,39,5,0,7
1536511,26,26,1987,11,"male",285,75,37,2,5,2,4,0,1
1536517,43,22,1970,12,"female",425,43,28,0,33,0,25,0,8
1536530,19,24,1994,10,"female",168,63,22,79,35,79,25,0,10
1536537,55,10,1958,8,"male",746,441,311,2,5,2,4,0,1
1536544,55,8,1958,7,"female",639,25,12,20,3,1,0,19,3
1536547,50,27,1963,4,"male",546,122,48,112,124,87,57,25,67
1536578,42,2,1971,7,"male",306,6,4,1,1,1,0,0,1
1536587,77,7,1936,12,"female",1397,176,124,87,37,87,30,0,7
1536606,18,2,1995,2,"male",256,123,99,0,0,0,0,0,0
1536643,16,16,1997,11,"male",47,17,16,97,21,97,13,0,8
1536672,23,9,1990,9,"female",1393,386,107,27,51,7,25,20,26
1536719,21,15,1992,10,"male",334,45,23,25,8,0,3,25,5
1536746,59,25,1954,12,"female",12,26,13,41,33,0,22,41,11
1536766,30,5,1983,6,"female",862,59,31,11,2,11,2,0,0
1536780,49,22,1964,5,"female",641,66,47,1,10,1,5,0,5
1536792,50,26,1963,12,"male",628,1,1,0,0,0,0,0,0
1536812,20,24,1993,5,"male",339,191,176,2,4,0,3,2,1
1536832,103,6,1910,11,"female",975,213,73,6,1,6,0,0,1
1536835,36,21,1977,3,"male",136,52,30,58,31,0,2,58,29
1536840,18,16,1995,3,"male",217,59,39,429,523,45,181,384,342
1536848,54,27,1959,2,"female",1937,67,40,136,73,136,51,0,22
1536884,20,2,1993,1,"male",213,43,15,7,7,7,2,0,5
1536888,40,26,1973,1,"female",686,20,15,1,4,0,2,1,2
1536948,52,15,1961,6,"male",760,127,62,22,56,21,35,1,21
1536955,70,10,1943,7,"male",221,505,318,50,31,43,23,7,8
1536960,46,12,1967,5,"female",792,65,39,611,852,611,802,0,50
1536969,26,1,1987,3,"male",517,371,151,108,254,108,228,0,26
1536971,35,19,1978,5,"male",155,41,22,85,37,85,31,0,6
1536972,16,12,1997,1,"male",580,269,158,18,2,18,1,0,1
1537032,39,30,1974,8,"male",503,91,43,1,62,1,20,0,42
1537058,64,10,1949,1,"male",904,48,29,443,46,443,37,0,9
1537060,21,2,1992,4,"male",187,51,14,114,57,113,42,1,15
1537068,20,3,1993,12,"male",376,27,10,6,1,4,0,2,1
1537093,40,10,1973,11,"female",233,55,47,0,2,0,0,0,2
1537101,28,12,1985,1,"male",286,4,1,0,0,0,0,0,0
1537121,23,22,1990,2,"male",318,9,7,0,1,0,0,0,1
1537122,27,1,1986,10,"male",157,25,8,15,19,15,18,0,1
1537164,31,22,1982,12,"male",638,162,150,0,0,0,0,0,0
1537173,103,25,1910,12,"female",1824,144,106,17,25,0,2,17,23
1537174,59,12,1954,4,"female",33,1,1,1,1,1,1,0,0
1537178,24,26,1989,7,"male",157,104,71,18,3,18,3,0,0
1537187,26,5,1987,4,"male",29,0,0,0,0,0,0,0,0
1537196,74,19,1939,11,"female",364,35,25,8,24,0,12,8,12
1537225,20,26,1993,8,"male",307,21,13,0,0,0,0,0,0
1537228,26,15,1987,12,"female",188,76,67,15,7,15,4,0,3
1537246,34,21,1979,2,"male",482,12,4,0,2,0,1,0,1
1537253,94,12,1919,8,"female",1500,46,13,0,0,0,0,0,0
1537282,18,9,1995,2,"female",55,151,129,29,53,29,45,0,8
1537297,16,24,1997,12,"female",73,3,2,0,0,0,0,0,0
1537327,24,7,1989,11,"male",79,58,42,2,0,0,0,2,0
1537335,23,11,1990,1,"male",831,689,473,8,32,8,23,0,9
1537351,38,5,1975,5,"male",446,4413,315,1962,650,1962,571,0,79
1537368,26,27,1987,12,"male",538,123,102,13,2,11,1,2,1
1537375,33,17,1980,4,"male",475,34,19,0,0,0,0,0,0
1537389,28,29,1985,9,"female",248,84,63,46,42,46,20,0,22
1537403,56,27,1957,3,"female",151,35,23,5,10,0,2,5,8
1537431,37,9,1976,10,"female",401,351,269,1514,659,1514,547,0,112
1537439,14,16,1999,1,"male",78,28,12,0,0,0,0,0,0
1537441,29,27,1984,1,"male",580,268,203,330,89,330,51,0,38
1537442,19,10,1994,1,"male",452,57,33,0,40,0,40,0,0
1537453,26,20,1987,4,"female",1152,370,297,65,28,15,15,50,13
1537475,24,18,1989,7,"male",457,4,3,0,1,0,0,0,1
1537486,14,17,1999,2,"male",72,33,28,2,0,2,0,0,0
1537491,30,30,1983,6,"female",380,457,263,423,533,423,502,0,31
1537507,37,4,1976,1,"male",453,17,9,0,0,0,0,0,0
1537508,30,2,1983,2,"male",1265,37,13,26,15,22,6,4,9
1537554,21,1,1992,1,"male",33,52,43,0,0,0,0,0,0
1537560,43,19,1970,3,"male",140,6,4,3,7,0,0,3,7
1537568,14,28,1999,10,"female",306,384,117,9,69,8,29,1,40
1537580,56,6,1957,5,"male",1043,11,8,1,0,0,0,1,0
1537588,23,1,1990,1,"female",80,18,16,1,0,1,0,0,0
1537602,33,22,1980,7,"male",613,236,126,90,37,3,1,87,36
1537628,26,13,1987,10,"female",106,155,128,208,71,29,5,179,66
1537636,20,17,1993,8,"male",78,17,11,1,4,1,2,0,2
1537648,51,11,1962,12,"male",1589,29,3,10,2,10,1,0,1
1537654,76,26,1937,11,"male",1943,55,24,0,7,0,5,0,2
1537659,18,10,1995,8,"female",309,671,263,114,476,114,448,0,28
1537661,61,5,1952,10,"female",1224,61,32,11,53,2,25,9,28
1537668,40,1,1973,1,"male",66,1,1,0,0,0,0,0,0
1537686,25,29,1988,11,"male",85,24,21,0,0,0,0,0,0
1537692,56,25,1957,12,"female",554,43,34,212,46,0,3,212,43
1537697,52,20,1961,8,"male",432,31,4,2,0,0,0,2,0
1537713,15,2,1998,2,"female",238,6,4,0,0,0,0,0,0
1537757,24,21,1989,5,"female",207,32,7,0,0,0,0,0,0
1537792,23,2,1990,12,"male",244,106,77,64,21,64,20,0,1
1537816,29,17,1984,1,"female",509,80,22,219,57,219,55,0,2
1537824,46,25,1967,4,"male",295,147,101,19,9,19,7,0,2
1537832,45,13,1968,4,"female",1825,162,75,152,385,152,319,0,66
1537834,15,20,1998,7,"male",189,74,56,3,4,3,3,0,1
1537835,38,6,1975,9,"female",183,82,50,87,78,1,29,86,49
1537851,43,5,1970,7,"male",232,209,18,106,71,106,38,0,33
1537884,16,3,1997,9,"female",554,1614,972,877,468,759,293,118,175
1537899,30,11,1983,11,"male",704,26,22,5,0,0,0,5,0
1537928,26,25,1987,12,"male",615,105,103,0,0,0,0,0,0
1537937,52,20,1961,7,"male",392,47,31,0,0,0,0,0,0
1537938,23,8,1990,7,"male",558,29,16,0,0,0,0,0,0
1537955,49,5,1964,5,"female",106,66,53,17,79,12,39,5,40
1537966,23,2,1990,2,"male",11,3,0,0,0,0,0,0,0
1537979,15,23,1998,2,"female",329,57,29,4,12,4,12,0,0
1537980,32,26,1981,12,"male",292,609,525,86,5,3,0,83,5
1537986,23,10,1990,7,"female",263,56,23,0,0,0,0,0,0
1537991,22,28,1991,5,"male",409,193,86,4,2,4,2,0,0
1537998,43,10,1970,6,"female",1603,16,6,2,14,2,8,0,6
1538027,26,14,1987,4,"male",364,97,62,14,1,0,0,14,1
1538032,43,27,1970,3,"male",459,17,14,416,44,416,30,0,14
1538061,50,8,1963,4,"female",137,65,33,78,88,78,28,0,60
1538094,17,22,1996,9,"male",523,86,29,59,31,41,11,18,20
1538104,42,10,1971,1,"male",371,77,35,747,356,747,252,0,104
1538123,27,27,1986,1,"male",156,34,10,8,21,8,21,0,0
1538159,39,20,1974,6,"male",451,5,4,1,1,1,1,0,0
1538179,30,3,1983,7,"male",76,28,21,7,12,7,7,0,5
1538205,28,9,1985,9,"male",246,0,0,67,55,0,7,67,48
1538209,67,9,1946,9,"female",1522,194,112,19,26,19,15,0,11
1538210,38,30,1975,11,"female",574,5,0,0,0,0,0,0,0
1538268,28,17,1985,11,"female",774,24,9,0,0,0,0,0,0
1538279,25,22,1988,1,"male",653,122,83,473,212,473,184,0,28
1538303,31,17,1982,2,"male",160,23,15,0,0,0,0,0,0
1538320,18,16,1995,1,"male",176,217,159,15,8,13,5,2,3
1538324,29,10,1984,4,"female",566,249,188,92,129,48,22,44,107
1538333,58,7,1955,12,"female",658,41,28,0,0,0,0,0,0
1538352,18,31,1995,12,"male",206,11,1,133,0,93,0,40,0
1538368,30,8,1983,5,"male",437,21,14,0,0,0,0,0,0
1538390,23,18,1990,5,"male",58,1,1,0,0,0,0,0,0
1538396,46,21,1967,6,"male",151,1,1,0,0,0,0,0,0
1538406,20,29,1993,9,"male",843,666,501,44,27,6,13,38,14
1538408,58,9,1955,3,"male",691,107,56,20,0,0,0,20,0
1538418,25,13,1988,8,"female",143,216,162,38,2,38,1,0,1
1538450,108,24,1905,12,"female",1281,26,11,0,0,0,0,0,0
1538456,30,21,1983,9,"female",905,40,24,1,6,1,4,0,2
1538469,23,23,1990,7,"male",372,102,81,64,25,64,12,0,13
1538492,36,11,1977,4,"male",472,256,186,0,18,0,16,0,2
1538515,31,16,1982,6,"female",160,22,6,2,0,2,0,0,0
1538521,108,4,1905,1,"female",1008,582,245,639,778,22,423,617,355
1538530,33,1,1980,4,"female",416,5,2,0,0,0,0,0,0
1538536,15,28,1998,9,"male",135,36,35,5,2,5,0,0,2
1538539,64,11,1949,8,"female",1105,17,7,1,1,0,0,1,1
1538547,108,13,1905,11,"female",839,114,53,2000,454,371,280,1629,174
1538557,17,11,1996,6,"male",257,194,172,6,5,6,2,0,3
1538565,24,3,1989,6,"male",209,166,157,0,0,0,0,0,0
1538566,26,1,1987,7,"female",400,35,14,0,0,0,0,0,0
1538576,26,13,1987,12,"male",420,96,73,59,45,0,8,59,37
1538577,31,28,1982,3,"female",205,79,56,20,7,20,3,0,4
1538585,75,20,1938,6,"male",1691,25,15,37,4,0,0,37,4
1538623,29,12,1984,9,"male",34,63,59,2,16,2,10,0,6
1538665,53,4,1960,11,"male",24,1,1,2,2,2,2,0,0
1538669,22,13,1991,6,"male",437,451,249,38,27,38,16,0,11
1538679,60,17,1953,3,"male",532,27,5,16,39,0,7,16,32
1538692,31,1,1982,6,"male",483,3,3,0,0,0,0,0,0
1538713,26,1,1987,1,"male",67,83,66,1,4,1,1,0,3
1538727,32,30,1981,5,"male",694,67,13,0,0,0,0,0,0
1538769,53,22,1960,12,"male",368,183,137,1,4,1,4,0,0
1538839,20,21,1993,5,"female",1272,423,209,18,98,8,51,10,47
1538850,84,13,1929,10,"male",447,0,0,0,0,0,0,0,0
1538862,19,15,1994,8,"male",543,36,21,9,0,9,0,0,0
1538883,19,13,1994,5,"male",327,57,17,2,1,2,1,0,0
1538899,19,31,1994,12,"female",247,2653,702,10386,5354,4451,2140,5935,3214
1538903,18,3,1995,5,"male",498,202,127,139,9,139,9,0,0
1538911,28,1,1985,6,"male",606,6,3,0,1,0,1,0,0
1538914,28,9,1985,2,"male",247,81,46,1,10,1,10,0,0
1538915,52,28,1961,7,"female",556,114,86,17,3,17,3,0,0
1538920,22,20,1991,4,"male",386,190,108,2,2,2,2,0,0
1538963,48,8,1965,3,"male",289,48,36,6,49,6,31,0,18
1538989,16,18,1997,12,"female",40,273,169,27,86,23,34,4,52
1538996,60,2,1953,4,"female",381,40,29,1,1,0,1,1,0
1539001,54,5,1959,8,"male",1491,219,101,64,21,64,9,0,12
1539007,51,23,1962,12,"female",223,94,79,10,31,10,27,0,4
1539043,18,25,1995,2,"male",2,640,299,5640,2542,4251,1587,1389,955
1539046,15,27,1998,3,"female",23,66,56,717,259,76,166,641,93
1539051,53,19,1960,12,"female",765,46,30,80,63,65,33,15,30
1539060,35,24,1978,7,"female",850,11,6,73,53,73,53,0,0
1539090,19,30,1994,5,"male",471,239,131,89,19,89,16,0,3
1539104,56,13,1957,10,"male",359,255,54,7,104,7,59,0,45
1539105,28,16,1985,10,"male",464,2,1,83,0,0,0,83,0
1539147,34,22,1979,7,"male",752,118,109,0,16,0,16,0,0
1539162,26,28,1987,8,"male",515,207,116,11,82,11,62,0,20
1539166,24,12,1989,1,"male",471,479,296,228,148,81,33,147,115
1539175,18,1,1995,1,"male",254,121,40,0,4,0,1,0,3
1539184,18,25,1995,5,"male",215,445,410,59,22,32,18,27,4
1539193,43,18,1970,6,"male",144,39,14,39,4,39,1,0,3
1539243,17,8,1996,2,"female",265,750,193,20,167,20,32,0,135
1539280,49,20,1964,3,"female",538,94,71,51,4,51,2,0,2
1539325,93,8,1920,12,"male",1707,56,30,92,34,0,13,92,21
1539331,31,7,1982,10,"male",385,28,22,0,0,0,0,0,0
1539349,21,14,1992,4,"male",594,224,169,57,11,57,9,0,2
1539359,18,7,1995,2,"female",525,206,129,56,37,55,20,1,17
1539411,94,5,1919,6,"male",107,15,11,1,1,1,1,0,0
1539424,18,12,1995,12,"male",284,2,2,10,1,10,1,0,0
1539444,27,28,1986,10,"male",517,257,166,23,0,23,0,0,0
1539447,62,14,1951,7,"female",1130,335,214,94,163,42,57,52,106
1539450,22,12,1991,12,"male",138,20,16,0,0,0,0,0,0
1539460,20,1,1993,1,"male",180,73,63,0,1,0,0,0,1
1539469,22,29,1991,1,"female",1547,892,191,15,218,15,115,0,103
1539480,36,12,1977,4,"male",461,106,61,0,0,0,0,0,0
1539501,49,13,1964,11,"female",1813,207,163,37,65,37,37,0,28
1539506,61,17,1952,3,"female",1742,29,25,37,11,3,2,34,9
1539546,18,25,1995,7,"female",257,53,21,0,1,0,1,0,0
1539550,16,18,1997,11,"male",318,78,56,0,0,0,0,0,0
1539575,32,20,1981,9,"male",213,88,53,12,7,5,2,7,5
1539603,19,17,1994,8,"male",215,30,21,15,23,5,4,10,19
1539605,26,14,1987,8,"male",297,179,146,4,12,3,8,1,4
1539609,48,30,1965,12,"female",462,65,44,43,60,0,23,43,37
1539619,27,13,1986,12,"male",219,51,32,67,90,58,71,9,19
1539623,28,20,1985,12,"female",719,153,74,10,37,9,19,1,18
1539630,41,22,1972,9,"male",269,138,98,8,11,1,5,7,6
1539657,25,1,1988,1,"female",157,33,24,30,0,30,0,0,0
1539697,48,10,1965,6,"female",1009,244,123,514,416,381,181,133,235
1539700,20,26,1993,8,"male",267,204,173,112,1,0,1,112,0
1539727,16,9,1997,12,"male",307,107,48,0,0,0,0,0,0
1539734,20,8,1993,9,"female",111,137,127,5,47,5,24,0,23
1539741,24,11,1989,1,"male",581,82,57,1,6,1,4,0,2
1539744,58,4,1955,7,"female",421,42,26,5,1,0,0,5,1
1539752,18,15,1995,5,"male",133,2,1,63,3,6,0,57,3
1539760,28,13,1985,6,"female",403,121,63,0,0,0,0,0,0
1539762,38,11,1975,11,"female",371,78,64,200,98,200,82,0,16
1539811,55,3,1958,10,"male",399,15,11,7,0,5,0,2,0
1539819,25,21,1988,6,"male",569,93,61,0,0,0,0,0,0
1539829,103,28,1910,4,"female",744,197,103,41,17,41,17,0,0
1539844,56,21,1957,7,"female",587,129,35,229,15,179,8,50,7
1539847,74,26,1939,4,"male",78,71,71,115,62,1,17,114,45
1539900,26,23,1987,6,"male",143,10,9,2,0,2,0,0,0
1539905,61,9,1952,9,"male",155,33,7,53,9,0,5,53,4
1539915,103,14,1910,3,"female",654,473,185,59,36,59,22,0,14
1539916,111,1,1902,1,"female",2142,37,19,30,1,30,1,0,0
1539930,25,1,1988,1,"male",168,103,77,24,7,24,7,0,0
1539946,22,31,1991,10,"male",248,52,29,14,3,14,3,0,0
1539948,100,23,1913,8,"male",1733,207,137,383,268,0,74,383,194
1539952,36,25,1977,7,"male",167,17,12,0,3,0,1,0,2
1539959,18,25,1995,12,"female",108,19,8,2,0,2,0,0,0
1539962,20,12,1993,6,"female",546,345,145,1,5,1,3,0,2
1539978,30,18,1983,1,"female",282,47,18,0,1,0,1,0,0
1539980,57,27,1956,3,"female",1473,219,20,7,14,5,4,2,10
1539986,103,18,1910,3,"male",1666,74,40,376,95,63,21,313,74
1540009,103,16,1910,10,"male",1801,508,292,116,98,116,82,0,16
1540016,22,22,1991,5,"male",89,118,104,164,221,164,202,0,19
1540018,38,13,1975,5,"female",460,43,21,77,42,77,36,0,6
1540042,30,16,1983,12,"female",487,38,21,0,3,0,1,0,2
1540073,19,10,1994,10,"male",542,141,28,25,32,25,23,0,9
1540080,14,8,1999,5,"female",390,160,77,294,148,160,15,134,133
1540083,29,1,1984,5,"male",644,198,123,7,139,4,66,3,73
1540085,18,8,1995,4,"female",276,61,38,0,0,0,0,0,0
1540138,57,29,1956,2,"female",754,205,84,130,295,3,65,127,230
1540189,21,10,1992,10,"male",427,100,71,7,0,2,0,5,0
1540256,32,1,1981,1,"male",56,12,11,1,0,1,0,0,0
1540299,44,26,1969,3,"male",566,34,16,10,2,0,0,10,2
1540316,71,23,1942,7,"female",653,320,246,889,18,0,10,889,8
1540321,34,10,1979,1,"male",290,129,119,57,136,37,49,20,87
1540329,46,8,1967,1,"female",432,30,15,9,22,1,7,8,15
1540330,34,4,1979,9,"male",511,0,0,0,0,0,0,0,0
1540382,62,18,1951,7,"male",263,15,11,23,1,23,0,0,1
1540390,26,1,1987,1,"male",312,64,49,0,0,0,0,0,0
1540394,50,16,1963,6,"male",121,90,82,508,3,508,2,0,1
1540404,25,15,1988,6,"female",627,3,2,1,6,0,4,1,2
1540405,19,22,1994,11,"male",974,4,1,2,0,2,0,0,0
1540410,47,24,1966,3,"female",63,15,9,14,21,14,15,0,6
1540427,108,28,1905,4,"male",832,160,140,126,67,126,53,0,14
1540429,64,8,1949,6,"female",2361,429,278,442,225,326,80,116,145
1540438,45,8,1968,8,"female",1520,75,41,28,8,28,1,0,7
1540483,27,8,1986,11,"female",258,214,149,3,29,0,14,3,15
1540502,16,1,1997,1,"male",12,23,18,0,0,0,0,0,0
1540524,18,1,1995,1,"male",351,45,34,1,0,1,0,0,0
1540531,26,1,1987,11,"female",374,145,62,0,3,0,3,0,0
1540563,25,11,1988,12,"male",219,53,28,0,0,0,0,0,0
1540567,66,20,1947,2,"male",1770,53,18,0,1,0,0,0,1
1540572,33,11,1980,11,"female",31,0,0,1,0,0,0,1,0
1540590,18,25,1995,9,"male",398,1,1,0,0,0,0,0,0
1540592,17,7,1996,5,"male",428,1,0,0,0,0,0,0,0
1540630,18,14,1995,10,"female",92,231,70,31,65,31,58,0,7
1540654,33,17,1980,6,"female",794,11,8,139,130,139,41,0,89
1540664,37,15,1976,3,"male",857,24,1,1,1,1,1,0,0
1540689,29,29,1984,12,"male",538,82,57,21,0,0,0,21,0
1540690,30,6,1983,11,"male",458,44,14,277,360,58,129,219,231
1540695,25,14,1988,9,"female",638,263,172,624,2396,589,2324,35,72
1540698,16,11,1997,10,"female",124,40,30,51,15,44,7,7,8
1540711,31,23,1982,11,"male",640,192,134,973,460,973,346,0,114
1540724,25,16,1988,4,"female",470,325,282,62,4,13,1,49,3
1540739,25,1,1988,1,"male",20,1,1,0,0,0,0,0,0
1540743,18,8,1995,11,"male",980,203,92,0,0,0,0,0,0
1540755,24,27,1989,8,"male",647,7,3,21,14,21,6,0,8
1540770,57,19,1956,2,"male",1940,346,177,323,234,286,105,37,129
1540775,105,16,1908,11,"male",894,516,461,1,1,1,1,0,0
1540776,32,1,1981,1,"male",161,114,75,6,22,6,4,0,18
1540813,20,18,1993,10,"female",781,141,78,0,0,0,0,0,0
1540861,108,7,1905,10,"male",852,315,119,6,12,6,9,0,3
1540867,30,18,1983,12,"female",764,319,100,353,193,353,100,0,93
1540869,98,28,1915,9,"female",670,122,49,5,2,5,1,0,1
1540877,18,23,1995,8,"female",109,426,184,4708,3125,3328,1846,1380,1279
1540913,26,17,1987,4,"male",403,89,71,0,2,0,1,0,1
1540939,56,27,1957,12,"female",261,39,19,76,13,0,2,76,11
1540981,22,3,1991,7,"female",789,20,16,156,6,107,6,49,0
1540997,15,25,1998,10,"female",383,1025,429,1153,1780,128,803,1025,977
1541003,65,13,1948,4,"male",1116,229,122,474,94,474,70,0,24
1541009,18,11,1995,4,"male",412,379,321,59,10,59,3,0,7
1541020,31,4,1982,5,"male",655,183,145,4,0,4,0,0,0
1541035,41,2,1972,4,"female",319,134,105,612,22,612,20,0,2
1541075,20,16,1993,11,"male",392,244,200,0,0,0,0,0,0
1541111,43,23,1970,4,"male",548,131,115,52,58,50,22,2,36
1541144,49,30,1964,3,"male",1591,42,27,524,281,504,110,20,171
1541155,54,10,1959,2,"female",1531,157,90,368,150,368,109,0,41
1541160,20,24,1993,9,"female",53,220,203,26,6,26,6,0,0
1541179,16,27,1997,3,"female",131,456,144,60,9,0,2,60,7
1541206,24,30,1989,5,"female",269,96,80,7,19,7,11,0,8
1541240,21,22,1992,11,"female",946,59,41,0,1,0,1,0,0
1541248,26,3,1987,3,"male",1137,164,92,4,0,4,0,0,0
1541254,18,26,1995,4,"male",567,236,123,41,93,31,66,10,27
1541255,14,4,1999,12,"female",230,104,92,10,26,2,14,8,12
1541270,53,6,1960,12,"male",280,76,38,99,196,96,110,3,86
1541276,16,21,1997,6,"male",146,145,134,0,0,0,0,0,0
1541294,25,1,1988,1,"male",14,0,0,0,0,0,0,0,0
1541316,27,1,1986,1,"female",671,31,21,7,0,7,0,0,0
1541324,47,23,1966,7,"male",418,14,4,4,1,4,1,0,0
1541328,19,17,1994,5,"male",892,447,371,0,0,0,0,0,0
1541336,14,17,1999,8,"male",173,41,32,2,0,1,0,1,0
1541340,43,22,1970,5,"male",880,32,16,5,1,0,0,5,1
1541364,16,17,1997,5,"male",703,162,102,1,10,1,9,0,1
1541370,70,5,1943,2,"female",914,55,47,4,10,1,0,3,10
1541374,28,23,1985,5,"male",446,88,73,200,232,181,154,19,78
1541396,58,12,1955,4,"male",142,11,9,0,3,0,3,0,0
1541397,23,17,1990,5,"female",248,271,66,1178,328,1178,236,0,92
1541402,20,27,1993,11,"female",80,133,43,285,386,278,266,7,120
1541453,21,8,1992,5,"female",817,2218,492,669,1286,246,711,423,575
1541478,31,14,1982,6,"male",56,2,1,9,0,9,0,0,0
1541507,17,10,1996,10,"male",79,327,220,313,503,119,231,194,272
1541514,15,15,1998,2,"male",1,0,0,73,28,1,7,72,21
1541519,27,25,1986,9,"female",299,161,130,24,24,24,6,0,18
1541522,36,1,1977,1,"male",23,6,2,6,11,6,10,0,1
1541529,15,19,1998,4,"female",458,518,380,1372,731,726,381,646,350
1541561,18,15,1995,1,"female",401,2281,1790,7176,3256,6993,2397,183,859
1541562,25,10,1988,8,"female",280,113,17,30,31,30,15,0,16
1541577,22,22,1991,4,"female",286,143,122,3,3,3,3,0,0
1541592,15,20,1998,2,"female",208,604,516,47,52,47,47,0,5
1541595,23,10,1990,4,"male",199,205,70,2,10,2,8,0,2
1541611,20,1,1993,9,"female",165,655,521,1133,3018,1133,2787,0,231
1541623,19,2,1994,5,"female",885,692,238,719,115,507,58,212,57
1541636,72,14,1941,6,"male",682,60,44,15,2,0,0,15,2
1541645,45,20,1968,3,"male",397,96,69,252,15,19,2,233,13
1541673,24,7,1989,12,"male",186,55,34,11,16,11,15,0,1
1541677,46,4,1967,8,"male",1923,78,43,3,1,3,0,0,1
1541681,86,9,1927,12,"female",113,22,21,46,7,0,7,46,0
1541689,51,10,1962,8,"female",1239,202,109,160,148,14,38,146,110
1541690,36,7,1977,11,"male",195,30,14,108,38,108,33,0,5
1541695,68,4,1945,2,"female",226,12,10,10,3,0,0,10,3
1541722,19,21,1994,10,"female",82,56,49,128,85,72,53,56,32
1541729,44,24,1969,10,"female",449,57,31,0,0,0,0,0,0
1541752,18,11,1995,8,"female",537,264,137,47,55,45,52,2,3
1541759,25,16,1988,3,"male",117,80,71,14,2,14,2,0,0
1541773,16,6,1997,9,"female",1267,935,550,620,1153,207,592,413,561
1541805,59,17,1954,12,"female",1607,82,16,4,7,0,3,4,4
1541816,17,6,1996,1,"male",150,295,256,15,23,15,23,0,0
1541871,48,22,1965,3,"female",94,20,8,21,35,0,19,21,16
1541888,17,14,1996,8,"male",173,11,11,4,1,0,1,4,0
1541980,45,3,1968,1,"male",815,180,107,51,19,0,1,51,18
1541991,46,28,1967,9,"male",861,79,51,9,3,9,1,0,2
1541995,35,21,1978,4,"male",87,31,23,0,0,0,0,0,0
1542005,75,4,1938,10,"female",96,14,8,1,1,0,1,1,0
1542026,57,11,1956,10,"female",67,67,63,0,1,0,1,0,0
1542079,13,23,2000,1,"female",135,127,89,3872,358,3603,193,269,165
1542083,52,29,1961,6,"male",335,3,3,0,0,0,0,0,0
1542091,25,17,1988,7,"female",329,727,154,0,0,0,0,0,0
1542095,25,9,1988,10,"female",354,70,23,3,29,3,20,0,9
1542097,22,10,1991,7,"male",851,1030,813,46,40,46,39,0,1
1542113,65,2,1948,1,"female",100,0,0,0,0,0,0,0,0
1542187,16,15,1997,8,"female",473,288,184,279,327,225,100,54,227
1542192,19,17,1994,2,"male",460,29,23,2,0,0,0,2,0
1542247,39,4,1974,11,"male",1101,1,1,0,0,0,0,0,0
1542300,63,1,1950,1,"male",1875,235,94,103,169,2,113,101,56
1542329,50,8,1963,8,"male",160,18,11,0,6,0,2,0,4
1542356,64,12,1949,10,"female",24,30,25,240,14,0,2,240,12
1542362,17,6,1996,5,"female",181,54,30,3,0,0,0,3,0
1542388,20,20,1993,7,"female",125,65,49,120,177,83,39,37,138
1542403,20,19,1993,12,"male",680,169,49,3,0,3,0,0,0
1542419,19,13,1994,10,"female",153,28,11,41,6,35,5,6,1
1542425,62,15,1951,10,"male",981,461,305,1939,1092,99,406,1840,686
1542434,19,23,1994,1,"female",644,70,41,221,150,40,16,181,134
1542442,19,16,1994,11,"male",501,37,12,1,0,0,0,1,0
1542444,34,10,1979,12,"female",231,20,12,6,7,6,5,0,2
1542451,31,7,1982,3,"female",202,154,70,0,0,0,0,0,0
1542476,22,27,1991,8,"female",397,14,7,61,96,26,60,35,36
1542485,18,2,1995,11,"male",436,162,111,0,6,0,4,0,2
1542486,108,1,1905,1,"female",2084,227,68,4,20,3,4,1,16
1542493,15,20,1998,8,"male",620,328,234,33,0,17,0,16,0
1542503,18,28,1995,6,"female",1249,2843,828,1679,5765,1359,4106,320,1659
1542511,25,28,1988,1,"female",1077,99,31,0,3,0,3,0,0
1542518,16,16,1997,6,"female",410,403,200,18,13,18,2,0,11
1542562,17,4,1996,11,"male",100,192,168,205,128,205,115,0,13
1542565,36,17,1977,9,"male",112,65,45,1,3,0,0,1,3
1542581,32,4,1981,4,"male",800,138,66,70,224,70,220,0,4
1542583,33,6,1980,11,"female",1254,53,26,9884,6793,2892,3329,6992,3464
1542592,103,15,1910,6,"female",1885,101,18,1,0,0,0,1,0
1542594,24,14,1989,10,"male",558,17,15,0,0,0,0,0,0
1542602,18,1,1995,3,"female",455,164,111,30,16,30,8,0,8
1542609,26,11,1987,3,"female",343,187,55,267,190,267,183,0,7
1542624,28,5,1985,4,"female",1156,103,44,35,61,34,35,1,26
1542626,49,31,1964,10,"male",1220,289,128,4,5,3,4,1,1
1542627,22,15,1991,5,"male",283,61,45,2,2,2,2,0,0
1542633,38,12,1975,12,"male",417,122,113,0,1,0,1,0,0
1542644,24,27,1989,3,"female",77,22,17,3,21,3,12,0,9
1542651,28,27,1985,9,"male",153,1,1,0,0,0,0,0,0
1542692,25,1,1988,9,"male",73,17,16,7,1,7,1,0,0
1542727,25,4,1988,10,"female",660,1,1,0,0,0,0,0,0
1542750,19,23,1994,8,"female",657,198,63,0,0,0,0,0,0
1542760,40,14,1973,7,"male",605,52,34,0,0,0,0,0,0
1542785,23,22,1990,5,"male",196,113,99,0,0,0,0,0,0
1542791,64,31,1949,12,"male",283,33,32,2,3,0,3,2,0
1542815,34,2,1979,9,"male",537,21,13,5,0,5,0,0,0
1542852,19,14,1994,1,"male",101,73,59,0,1,0,1,0,0
1542858,35,14,1978,1,"female",542,244,126,343,110,154,34,189,76
1542869,21,1,1992,1,"female",699,94,50,71,40,49,16,22,24
1542884,43,28,1970,12,"female",371,20,8,34,13,34,13,0,0
1542909,18,1,1995,7,"female",677,57,44,5,26,5,9,0,17
1542927,18,14,1995,2,"female",373,106,73,77,69,77,43,0,26
1542974,25,10,1988,2,"female",377,538,185,816,1268,816,1198,0,70
1542991,25,17,1988,10,"female",340,1281,1204,154,429,153,296,1,133
1542993,13,9,2000,5,"female",111,117,35,5,12,1,5,4,7
1543031,54,3,1959,2,"female",1859,199,128,141,73,69,60,72,13
1543034,63,11,1950,12,"male",1892,56,32,0,2,0,1,0,1
1543041,15,1,1998,1,"male",54,12,8,0,0,0,0,0,0
1543046,13,26,2000,7,"male",33,85,76,1,0,1,0,0,0
1543061,16,19,1997,9,"female",590,180,64,30,9,2,5,28,4
1543081,23,25,1990,1,"male",668,25,6,0,3,0,3,0,0
1543124,64,17,1949,5,"female",1517,14,5,0,0,0,0,0,0
1543150,18,22,1995,11,"female",118,125,91,78,56,78,50,0,6
1543167,69,12,1944,10,"female",885,29,19,12,7,12,2,0,5
1543170,21,11,1992,11,"female",442,286,22,2,35,2,35,0,0
1543191,23,12,1990,4,"male",352,45,23,0,0,0,0,0,0
1543212,15,19,1998,8,"male",312,1117,841,1039,439,117,168,922,271
1543215,63,8,1950,8,"female",2012,517,385,682,265,596,117,86,148
1543234,72,29,1941,11,"female",1909,73,19,1101,245,0,97,1101,148
1543245,26,1,1987,10,"male",245,190,134,1,56,1,54,0,2
1543250,19,16,1994,8,"male",623,213,150,0,0,0,0,0,0
1543255,25,1,1988,1,"male",28,61,58,122,13,122,8,0,5
1543258,25,23,1988,3,"male",523,72,56,1947,908,1947,853,0,55
1543272,55,20,1958,10,"male",40,1,1,0,0,0,0,0,0
1543283,35,12,1978,1,"male",468,79,47,6,29,6,25,0,4
1543304,36,18,1977,3,"male",451,3,1,0,2,0,2,0,0
1543317,35,14,1978,8,"female",355,10,6,0,0,0,0,0,0
1543342,37,18,1976,10,"male",397,30,16,0,0,0,0,0,0
1543364,22,23,1991,5,"male",362,66,37,0,0,0,0,0,0
1543393,27,10,1986,2,"female",267,23,18,1,2,1,2,0,0
1543394,45,25,1968,10,"male",16,5,5,12,0,12,0,0,0
1543448,57,10,1956,5,"female",258,37,31,20,5,20,4,0,1
1543460,59,30,1954,3,"male",208,57,55,623,162,623,150,0,12
1543461,63,12,1950,12,"female",407,127,102,70,28,65,9,5,19
1543475,41,5,1972,11,"male",70,32,28,10,9,10,6,0,3
1543495,16,31,1997,12,"male",860,319,209,395,3,395,2,0,1
1543501,20,25,1993,6,"male",22,40,24,71,1,71,1,0,0
1543530,25,1,1988,1,"male",220,24,24,0,0,0,0,0,0
1543541,44,25,1969,7,"male",339,45,34,8,1,0,0,8,1
1543560,39,23,1974,7,"female",641,85,56,117,144,117,43,0,101
1543568,65,14,1948,5,"female",1006,28,13,11,0,9,0,2,0
1543589,26,8,1987,3,"female",354,219,131,100,16,100,12,0,4
1543595,23,1,1990,1,"male",471,6,5,1,4,0,0,1,4
1543600,18,9,1995,12,"male",566,126,76,60,2,60,2,0,0
1543656,40,30,1973,1,"female",110,8,4,8,9,8,3,0,6
1543714,31,23,1982,9,"female",1187,236,166,12,7,5,3,7,4
1543719,21,8,1992,3,"male",13,9,5,0,0,0,0,0,0
1543739,30,6,1983,12,"male",637,396,335,48,56,48,40,0,16
1543742,76,21,1937,10,"male",992,119,88,66,6,0,4,66,2
1543789,25,17,1988,7,"male",213,76,72,0,3,0,2,0,1
1543814,31,25,1982,6,"female",1155,307,130,744,766,637,345,107,421
1543816,18,3,1995,8,"female",732,161,93,1,5,0,1,1,4
1543827,24,22,1989,5,"male",488,1368,1232,462,2511,462,2189,0,322
1543838,22,25,1991,7,"male",629,344,248,0,1,0,1,0,0
1543860,14,31,1999,12,"male",143,475,275,34,44,17,10,17,34
1543877,75,5,1938,10,"female",1284,43,17,0,2,0,2,0,0
1543891,16,18,1997,8,"male",200,64,49,5,13,0,0,5,13
1543900,29,28,1984,5,"male",339,186,76,0,0,0,0,0,0
1543924,66,27,1947,12,"female",1868,17,9,14,2,0,0,14,2
1543929,39,4,1974,5,"male",515,178,95,32,6,18,4,14,2
1543951,61,20,1952,3,"female",2271,65,33,20,38,18,21,2,17
1543961,48,12,1965,3,"male",747,11,10,29,20,29,16,0,4
1543967,18,16,1995,6,"male",167,230,214,0,0,0,0,0,0
1543997,23,2,1990,3,"male",101,15,14,9,2,9,2,0,0
1544011,65,26,1948,5,"female",1534,142,52,445,329,0,26,445,303
1544026,17,6,1996,6,"female",236,2719,115,52,269,52,187,0,82
1544031,29,20,1984,1,"female",752,17,15,161,5,161,2,0,3
1544035,16,7,1997,12,"female",335,498,380,20,0,14,0,6,0
1544043,18,14,1995,1,"female",300,73,54,0,0,0,0,0,0
1544046,16,10,1997,2,"female",144,102,91,1,1,1,0,0,1
1544071,25,11,1988,6,"female",1296,111,68,2,10,1,4,1,6
1544072,29,13,1984,9,"female",353,595,369,916,793,907,660,9,133
1544093,94,14,1919,10,"female",583,276,226,5,14,5,14,0,0
1544108,15,11,1998,7,"male",462,199,174,5,0,0,0,5,0
1544153,60,5,1953,1,"male",612,50,35,376,24,376,11,0,13
1544178,13,1,2000,1,"female",390,1067,171,359,211,278,148,81,63
1544192,19,1,1994,6,"male",270,405,290,1,2,1,1,0,1
1544194,75,1,1938,9,"male",277,8,8,0,0,0,0,0,0
1544223,23,21,1990,10,"female",397,176,142,134,21,134,10,0,11
1544232,17,19,1996,5,"male",445,79,52,10,1,2,0,8,1
1544237,16,18,1997,5,"male",183,83,57,13,0,13,0,0,0
1544250,20,25,1993,12,"male",290,112,50,6,4,0,0,6,4
1544261,49,21,1964,7,"male",279,42,41,0,2,0,2,0,0
1544308,17,22,1996,2,"male",315,261,215,1,0,1,0,0,0
1544316,21,5,1992,5,"male",129,86,68,20,8,20,8,0,0
1544359,17,15,1996,1,"female",368,134,55,34,20,32,14,2,6
1544360,28,23,1985,6,"male",768,212,143,0,0,0,0,0,0
1544367,52,25,1961,7,"male",222,36,22,9,25,9,21,0,4
1544372,64,7,1949,7,"male",424,11,8,2,4,2,4,0,0
1544397,19,12,1994,8,"female",467,2640,792,302,245,9,142,293,103
1544406,21,15,1992,6,"male",363,78,67,1,1,1,0,0,1
1544409,23,1,1990,10,"male",413,302,196,4,1,1,0,3,1
1544471,42,17,1971,7,"male",554,287,136,121,251,6,68,115,183
1544496,28,15,1985,5,"male",289,13,11,0,0,0,0,0,0
1544498,71,31,1942,12,"female",1543,109,56,84,42,64,10,20,32
1544502,21,5,1992,5,"female",1327,512,281,466,204,455,99,11,105
1544536,59,6,1954,7,"male",152,25,22,4,7,2,3,2,4
1544540,108,10,1905,10,"female",140,122,58,95,137,80,85,15,52
1544588,46,19,1967,12,"male",388,112,77,57,96,24,70,33,26
1544617,73,15,1940,1,"male",1086,114,53,6,0,4,0,2,0
1544637,18,10,1995,2,"female",491,4695,1388,28,151,28,121,0,30
1544647,56,11,1957,8,"male",470,2,0,0,0,0,0,0,0
1544652,53,15,1960,2,"male",102,41,13,26,27,7,22,19,5
1544765,63,7,1950,3,"female",984,71,46,189,81,0,18,189,63
1544767,55,22,1958,11,"male",865,39,17,11,2,0,2,11,0
1544769,69,29,1944,2,"male",789,180,77,1,2,0,0,1,2
1544794,18,17,1995,7,"male",43,73,48,13,23,13,19,0,4
1544879,54,18,1959,4,"male",208,33,18,177,53,0,27,177,26
1544895,19,1,1994,10,"female",426,74,35,587,759,0,69,587,690
1544896,36,1,1977,10,"male",1326,313,98,3,4,3,3,0,1
1544926,19,30,1994,6,"male",467,118,105,1,6,1,5,0,1
1544930,56,22,1957,6,"female",581,94,66,0,0,0,0,0,0
1544932,18,6,1995,1,"male",236,303,263,3,6,0,3,3,3
1544944,50,25,1963,12,"male",321,65,53,14,4,4,3,10,1
1544950,25,5,1988,6,"male",39,15,11,5,8,5,7,0,1
1544957,42,14,1971,5,"male",398,7,7,26,6,0,1,26,5
1544961,21,8,1992,5,"male",646,257,82,150,11,143,9,7,2
1544982,29,6,1984,3,"male",205,39,18,2,14,2,3,0,11
1545030,37,15,1976,4,"male",551,159,121,17,31,17,17,0,14
1545056,24,28,1989,1,"male",119,147,135,3,14,2,7,1,7
1545074,19,27,1994,7,"male",82,10,10,0,0,0,0,0,0
1545076,39,25,1974,1,"male",541,103,24,160,75,160,62,0,13
1545149,19,9,1994,9,"male",856,38,24,0,1,0,0,0,1
1545166,24,26,1989,1,"male",252,15,10,23,24,13,4,10,20
1545203,17,10,1996,11,"male",205,22,17,0,1,0,1,0,0
1545210,51,11,1962,8,"female",827,59,29,1332,715,1332,613,0,102
1545277,18,6,1995,12,"male",147,105,46,2,1,0,0,2,1
1545336,21,9,1992,6,"female",559,1100,588,182,314,182,251,0,63
1545344,100,21,1913,10,"male",1211,218,113,21,19,21,13,0,6
1545355,21,19,1992,2,"male",241,104,59,23,44,22,18,1,26
1545373,52,24,1961,7,"male",831,277,187,56,78,0,61,56,17
1545382,25,7,1988,6,"female",246,174,135,556,870,556,601,0,269
1545386,27,4,1986,11,"male",643,166,89,0,9,0,6,0,3
1545387,25,1,1988,1,"male",33,0,0,0,0,0,0,0,0
1545397,46,18,1967,8,"female",369,29,15,12,0,12,0,0,0
1545445,19,5,1994,2,"female",610,807,510,60,318,41,223,19,95
1545457,27,3,1986,2,"male",220,34,30,1,1,1,1,0,0
1545458,46,7,1967,8,"male",226,108,105,46,6,46,6,0,0
1545470,46,9,1967,9,"male",185,95,60,87,30,87,18,0,12
1545480,21,27,1992,9,"male",190,27,25,7,2,7,1,0,1
1545481,19,24,1994,12,"male",294,269,62,315,45,24,40,291,5
1545496,20,11,1993,11,"female",222,29,5,0,0,0,0,0,0
1545509,20,7,1993,1,"male",792,201,121,105,148,71,31,34,117
1545536,58,30,1955,7,"male",918,31,3,9,1,0,1,9,0
1545563,22,24,1991,9,"female",348,57,34,17,2,16,2,1,0
1545565,18,24,1995,11,"female",723,526,367,808,790,352,264,456,526
1545567,25,1,1988,1,"male",264,15,11,5,5,5,5,0,0
1545568,18,25,1995,12,"male",630,434,363,75,13,63,12,12,1
1545616,36,6,1977,10,"male",132,23,14,1,3,1,3,0,0
1545632,55,28,1958,11,"female",2390,159,60,343,247,209,158,134,89
1545648,23,3,1990,3,"male",209,177,159,3,0,3,0,0,0
1545665,21,18,1992,7,"female",203,1060,118,95,197,95,147,0,50
1545701,19,2,1994,1,"male",576,1,1,0,0,0,0,0,0
1545713,53,29,1960,10,"male",1429,695,319,5,3,3,2,2,1
1545722,21,15,1992,4,"female",1046,313,236,0,0,0,0,0,0
1545729,35,24,1978,7,"male",781,24,8,11,17,11,10,0,7
1545759,31,4,1982,4,"male",756,8,6,31,1,23,0,8,1
1545763,51,15,1962,7,"male",469,64,38,41,39,26,32,15,7
1545787,34,5,1979,4,"female",137,251,186,12,29,12,20,0,9
1545791,28,2,1985,6,"female",103,49,40,0,0,0,0,0,0
1545816,14,8,1999,6,"female",290,391,85,617,144,422,82,195,62
1545839,33,12,1980,12,"male",422,282,221,35,16,19,9,16,7
1545865,20,2,1993,11,"male",816,84,29,30,2,0,0,30,2
1545875,55,19,1958,3,"female",751,14,8,2,0,0,0,2,0
1545903,15,14,1998,2,"female",380,217,170,88,115,88,58,0,57
1545961,17,5,1996,11,"male",196,104,86,4,0,4,0,0,0
1545965,54,20,1959,7,"female",149,51,28,121,78,121,60,0,18
1545973,78,24,1935,9,"female",2231,29,14,2,37,0,22,2,15
1545978,30,13,1983,12,"female",412,178,93,25,71,12,38,13,33
1545997,17,5,1996,8,"female",408,809,609,459,635,337,320,122,315
1546046,26,1,1987,1,"male",547,157,107,0,0,0,0,0,0
1546079,46,16,1967,9,"female",141,45,26,253,90,253,59,0,31
1546088,30,19,1983,5,"male",491,2,0,2,1,2,0,0,1
1546098,28,17,1985,7,"female",471,30,24,0,0,0,0,0,0
1546111,17,1,1996,11,"female",68,145,138,84,50,36,17,48,33
1546133,29,13,1984,8,"male",191,0,0,0,0,0,0,0,0
1546163,32,19,1981,12,"male",109,27,26,0,0,0,0,0,0
1546189,17,8,1996,11,"female",258,103,80,2,0,1,0,1,0
1546196,23,29,1990,10,"male",717,46,25,0,6,0,6,0,0
1546204,103,26,1910,4,"male",514,218,148,22,15,22,15,0,0
1546208,24,10,1989,5,"male",153,2,2,1,0,0,0,1,0
1546214,14,24,1999,6,"male",112,42,23,2,16,0,10,2,6
1546220,36,31,1977,7,"male",443,54,33,3,1,3,1,0,0
1546240,57,4,1956,3,"female",2418,84,26,39,42,30,12,9,30
1546245,23,31,1990,12,"female",304,90,51,226,264,132,119,94,145
1546269,26,15,1987,4,"male",284,3,2,6,0,0,0,6,0
1546280,23,6,1990,9,"male",864,588,423,2,2,2,2,0,0
1546299,36,18,1977,8,"female",15,106,40,4,7,4,7,0,0
1546331,17,21,1996,11,"male",19,244,195,427,451,195,158,232,293
1546361,19,26,1994,3,"male",243,1,1,0,0,0,0,0,0
1546372,58,16,1955,12,"male",139,12,11,0,0,0,0,0,0
1546401,14,22,1999,11,"female",50,10,7,8,1,8,1,0,0
1546409,21,13,1992,8,"male",374,408,349,8,32,8,31,0,1
1546410,22,26,1991,8,"male",1032,339,271,50,18,50,17,0,1
1546436,108,23,1905,6,"male",1085,2060,1365,55,35,55,31,0,4
1546441,26,8,1987,8,"male",853,64,52,3,0,3,0,0,0
1546480,14,25,1999,12,"male",76,50,34,2,1,2,1,0,0
1546539,61,2,1952,10,"male",771,4,3,0,0,0,0,0,0
1546541,71,1,1942,1,"female",1176,26,20,4,5,3,2,1,3
1546544,28,1,1985,1,"male",249,0,0,0,0,0,0,0,0
1546579,17,11,1996,9,"male",133,2,2,0,0,0,0,0,0
1546591,37,3,1976,9,"female",392,26,15,13,5,13,1,0,4
1546631,14,21,1999,1,"male",350,505,399,415,92,415,47,0,45
1546642,103,20,1910,1,"male",381,40,21,1,0,1,0,0,0
1546671,18,20,1995,3,"male",153,5,3,892,2,892,0,0,2
1546676,22,1,1991,4,"male",96,74,56,5,8,5,8,0,0
1546680,30,29,1983,7,"male",652,36,7,15,16,15,15,0,1
1546712,36,30,1977,11,"male",873,144,129,138,9,138,9,0,0
1546720,18,17,1995,8,"male",359,5,4,1,2,0,1,1,1
1546721,18,10,1995,11,"female",398,4147,926,457,2180,440,1074,17,1106
1546725,43,9,1970,1,"male",195,161,129,15,1,15,0,0,1
1546745,14,10,1999,3,"female",32,217,130,854,349,458,107,396,242
1546747,19,23,1994,4,"male",520,0,0,0,0,0,0,0,0
1546749,35,17,1978,11,"female",150,55,32,7,0,5,0,2,0
1546755,41,25,1972,1,"female",1007,43,4,27,0,27,0,0,0
1546768,50,11,1963,4,"male",316,41,29,104,2,104,2,0,0
1546773,34,15,1979,1,"female",544,39,2,4,25,3,23,1,2
1546819,25,20,1988,2,"male",1365,212,102,0,0,0,0,0,0
1546823,51,26,1962,1,"female",492,65,35,36,11,36,6,0,5
1546828,24,3,1989,5,"female",621,247,211,80,67,80,58,0,9
1546841,58,1,1955,2,"male",107,22,11,128,67,128,45,0,22
1546870,22,7,1991,7,"female",684,67,45,601,24,601,24,0,0
1546906,32,25,1981,3,"female",187,7,7,345,84,345,70,0,14
1546929,74,3,1939,5,"male",54,0,0,0,0,0,0,0,0
1546937,70,12,1943,10,"female",1682,30,7,1,4,0,3,1,1
1546968,67,20,1946,9,"female",91,31,29,5,7,0,0,5,7
1546974,39,23,1974,7,"male",909,261,162,67,47,0,14,67,33
1546991,19,20,1994,9,"male",421,843,763,262,864,262,709,0,155
1546999,50,27,1963,9,"male",812,10,9,0,5,0,3,0,2
1547063,18,16,1995,8,"male",836,196,97,0,15,0,11,0,4
1547064,25,29,1988,6,"female",505,329,149,236,105,227,34,9,71
1547099,20,20,1993,8,"female",37,5,4,50,25,50,10,0,15
1547109,57,6,1956,1,"male",214,13,8,0,0,0,0,0,0
1547113,28,12,1985,8,"female",629,251,140,121,217,87,108,34,109
1547115,20,21,1993,7,"female",85,543,461,703,1824,703,1463,0,361
1547135,21,28,1992,10,"female",124,1,1,0,0,0,0,0,0
1547140,107,6,1906,5,"female",1020,58,35,109,22,64,3,45,19
1547150,23,1,1990,1,"male",300,28,22,196,23,0,18,196,5
1547152,19,11,1994,11,"male",750,101,39,5,0,0,0,5,0
1547160,30,24,1983,12,"male",183,90,49,429,57,416,23,13,34
1547162,24,26,1989,1,"female",855,298,116,240,282,59,41,181,241
1547178,49,26,1964,1,"female",394,132,53,45,25,0,2,45,23
1547190,27,15,1986,8,"male",112,96,76,72,254,70,146,2,108
1547195,44,24,1969,3,"male",500,43,30,215,115,215,41,0,74
1547202,25,15,1988,6,"male",253,117,109,36,20,36,11,0,9
1547210,26,30,1987,11,"male",72,13,6,41,18,1,14,40,4
1547232,61,9,1952,7,"female",1542,54,20,7,2,7,1,0,1
1547261,17,8,1996,8,"male",475,394,303,10,3,0,2,10,1
1547291,20,25,1993,3,"male",219,39,20,0,0,0,0,0,0
1547299,18,22,1995,8,"female",91,14,12,187,110,178,43,9,67
1547348,18,31,1995,8,"male",15,30,23,0,1,0,1,0,0
1547362,46,11,1967,2,"female",144,130,86,33,114,18,21,15,93
1547405,33,14,1980,11,"female",38,60,55,2,9,2,8,0,1
1547419,42,2,1971,6,"male",731,106,69,113,129,110,105,3,24
1547448,24,15,1989,10,"male",437,38,36,0,0,0,0,0,0
1547451,50,3,1963,8,"male",305,36,18,125,61,0,8,125,53
1547457,17,18,1996,11,"male",526,152,108,1,10,0,2,1,8
1547464,22,1,1991,1,"male",453,0,0,0,0,0,0,0,0
1547488,28,23,1985,2,"male",85,58,30,3,0,3,0,0,0
1547492,20,4,1993,11,"male",1147,486,190,1402,1516,1284,1420,118,96
1547503,32,7,1981,10,"male",858,0,0,0,0,0,0,0,0
1547506,22,22,1991,4,"male",159,72,61,36,0,1,0,35,0
1547564,18,14,1995,10,"female",701,568,399,2471,1891,2471,794,0,1097
1547577,40,2,1973,2,"female",1732,220,81,845,466,718,244,127,222
1547588,22,9,1991,1,"male",268,199,65,103,23,103,22,0,1
1547590,18,16,1995,5,"male",187,0,0,0,0,0,0,0,0
1547596,16,9,1997,7,"male",386,254,156,25,75,25,25,0,50
1547623,54,7,1959,8,"male",1529,224,112,45,74,45,51,0,23
1547644,23,7,1990,8,"female",338,79,41,218,134,218,73,0,61
1547651,47,1,1966,5,"male",22,0,0,0,0,0,0,0,0
1547652,23,28,1990,6,"male",1282,395,83,0,0,0,0,0,0
1547661,23,15,1990,3,"male",249,344,47,61,140,31,72,30,68
1547681,17,13,1996,11,"female",169,116,99,118,19,118,18,0,1
1547725,49,26,1964,10,"female",37,45,34,3,17,0,3,3,14
1547726,23,15,1990,8,"male",288,2,2,0,0,0,0,0,0
1547731,22,1,1991,2,"male",472,142,66,232,68,174,57,58,11
1547742,31,27,1982,8,"female",116,28,24,113,61,113,60,0,1
1547749,65,25,1948,7,"female",1843,82,21,47,24,47,13,0,11
1547753,19,22,1994,7,"male",889,291,223,5,20,5,15,0,5
1547772,74,29,1939,11,"female",1593,13,4,4,2,0,0,4,2
1547791,44,23,1969,1,"male",496,32,31,3,0,0,0,3,0
1547811,19,1,1994,1,"female",426,165,138,38,13,14,0,24,13
1547819,46,27,1967,2,"male",398,66,53,7,3,3,3,4,0
1547830,27,22,1986,6,"male",674,161,71,6,14,0,2,6,12
1547835,55,5,1958,5,"female",1568,38,22,77,74,77,49,0,25
1547843,20,13,1993,3,"male",473,0,0,0,0,0,0,0,0
1547879,47,29,1966,10,"male",347,49,28,26,62,26,34,0,28
1547911,15,1,1998,2,"female",44,8,8,0,0,0,0,0,0
1547940,19,25,1994,6,"female",686,1938,1357,435,424,432,273,3,151
1547944,18,21,1995,3,"male",426,140,55,1950,1014,7,128,1943,886
1547952,22,24,1991,11,"male",401,171,92,6,16,6,10,0,6
1547986,26,12,1987,6,"male",315,66,61,0,0,0,0,0,0
1548014,34,13,1979,3,"male",941,162,100,6,132,6,102,0,30
1548043,67,27,1946,7,"male",296,46,35,6,5,6,5,0,0
1548069,19,1,1994,9,"male",263,0,0,0,0,0,0,0,0
1548084,40,22,1973,10,"female",482,50,19,35,45,35,34,0,11
1548090,42,15,1971,12,"male",119,41,21,3,3,3,3,0,0
1548097,102,1,1911,9,"male",1978,841,442,113,116,0,17,113,99
1548130,23,3,1990,7,"male",459,441,253,532,169,530,87,2,82
1548131,22,25,1991,6,"male",417,1,1,5,1,0,0,5,1
1548135,30,3,1983,1,"female",397,243,170,709,1566,575,1188,134,378
1548169,52,6,1961,3,"female",1090,205,138,39,0,0,0,39,0
1548178,33,11,1980,11,"female",294,82,76,86,38,86,35,0,3
1548187,45,28,1968,2,"male",1045,13,11,0,0,0,0,0,0
1548193,56,26,1957,1,"male",589,76,31,0,0,0,0,0,0
1548221,61,22,1952,11,"female",1541,61,42,17,15,0,3,17,12
1548223,39,2,1974,3,"female",288,3,3,0,0,0,0,0,0
1548354,19,28,1994,10,"male",573,580,469,7,0,6,0,1,0
1548364,34,1,1979,3,"male",219,24,19,5,0,5,0,0,0
1548375,31,25,1982,10,"male",769,94,63,7,3,7,0,0,3
1548397,19,26,1994,5,"female",384,365,141,681,604,394,135,287,469
1548414,21,24,1992,1,"male",146,56,43,77,20,77,17,0,3
1548417,13,22,2000,4,"male",141,64,35,26,21,26,18,0,3
1548432,16,8,1997,10,"male",577,75,46,1,9,1,6,0,3
1548460,25,12,1988,1,"male",200,108,98,2,4,2,3,0,1
1548501,28,2,1985,6,"female",55,38,24,6,0,6,0,0,0
1548505,49,9,1964,9,"male",222,78,63,24,1,0,1,24,0
1548506,23,7,1990,4,"male",434,42,28,0,1,0,0,0,1
1548529,25,28,1988,6,"female",244,13,10,0,0,0,0,0,0
1548553,22,19,1991,11,"female",107,26,17,34,42,13,26,21,16
1548557,34,24,1979,8,"male",704,68,48,4,1,4,1,0,0
1548570,44,23,1969,6,"female",1430,288,119,1193,465,944,193,249,272
1548623,74,14,1939,8,"female",905,31,22,1,27,1,13,0,14
1548625,24,17,1989,12,"male",161,46,35,7,1,7,1,0,0
1548635,55,6,1958,2,"female",1544,39,10,101,5,15,5,86,0
1548650,14,26,1999,4,"female",403,236,169,336,394,318,194,18,200
1548665,19,15,1994,8,"female",322,212,151,383,583,15,148,368,435
1548721,29,9,1984,10,"male",393,74,67,0,0,0,0,0,0
1548733,19,20,1994,9,"male",571,216,105,15,5,15,4,0,1
1548739,21,26,1992,1,"female",331,103,36,36,31,36,25,0,6
1548747,21,28,1992,7,"male",688,299,222,22,13,15,9,7,4
1548816,30,3,1983,1,"female",703,113,58,49,59,45,37,4,22
1548831,26,27,1987,1,"female",258,7,3,0,0,0,0,0,0
1548857,24,1,1989,1,"male",469,4,3,0,0,0,0,0,0
1548901,26,14,1987,2,"male",97,129,103,60,76,60,62,0,14
1548908,23,27,1990,11,"male",25,46,41,0,10,0,5,0,5
1548947,16,6,1997,5,"female",370,989,234,1037,1993,1024,1241,13,752
1548960,39,10,1974,6,"female",1425,519,246,648,1048,211,443,437,605
1548968,80,21,1933,7,"male",1281,61,47,4,5,2,1,2,4
1548970,73,2,1940,3,"male",262,6,2,4,3,3,3,1,0
1548971,22,23,1991,11,"female",3,1,1,1,0,1,0,0,0
1548995,15,5,1998,5,"male",170,223,199,375,113,375,86,0,27
1549007,23,20,1990,12,"male",391,1005,792,780,331,660,250,120,81
1549081,56,7,1957,4,"male",452,35,32,7,3,2,2,5,1
1549109,44,29,1969,5,"male",1560,397,137,2,0,1,0,1,0
1549126,16,24,1997,10,"male",165,107,17,0,0,0,0,0,0
1549135,66,30,1947,1,"female",548,54,27,68,37,68,20,0,17
1549136,23,7,1990,9,"male",349,77,59,1,0,1,0,0,0
1549159,19,24,1994,6,"male",27,118,104,15,14,15,7,0,7
1549177,16,9,1997,4,"male",452,490,372,10,6,9,4,1,2
1549185,20,14,1993,1,"female",292,494,352,15,49,15,17,0,32
1549190,35,11,1978,10,"female",601,321,82,1283,770,1283,542,0,228
1549203,59,2,1954,10,"female",1189,441,183,185,17,0,1,185,16
1549213,20,9,1993,2,"male",575,185,131,15,13,9,12,6,1
1549221,18,2,1995,2,"male",7,6,6,29,0,29,0,0,0
1549296,17,8,1996,8,"male",294,42,38,0,6,0,4,0,2
1549297,61,27,1952,10,"male",595,41,29,5,7,0,6,5,1
1549344,76,17,1937,7,"male",736,121,103,0,3,0,1,0,2
1549360,14,1,1999,8,"female",213,256,182,50,43,50,37,0,6
1549369,23,14,1990,7,"male",340,474,397,0,0,0,0,0,0
1549387,26,1,1987,1,"male",406,2,1,0,0,0,0,0,0
1549393,21,15,1992,7,"female",273,24,15,38,36,38,28,0,8
1549396,25,16,1988,1,"male",208,637,33,4,26,4,24,0,2
1549421,65,19,1948,10,"male",1733,38,12,19,9,0,8,19,1
1549435,21,28,1992,2,"female",305,2,1,8,0,8,0,0,0
1549449,18,1,1995,1,"female",13,0,0,0,0,0,0,0,0
1549456,31,10,1982,6,"male",169,16,10,1,3,0,1,1,2
1549459,50,26,1963,2,"male",171,42,23,56,83,56,50,0,33
1549460,14,13,1999,3,"male",445,152,130,38,22,33,12,5,10
1549482,29,1,1984,1,"male",403,15,8,44,21,0,8,44,13
1549498,54,1,1959,1,"male",239,28,15,22,29,0,1,22,28
1549504,53,13,1960,1,"male",598,94,65,9,8,9,0,0,8
1549530,31,1,1982,10,"male",103,10,8,3,1,3,1,0,0
1549537,64,7,1949,6,"female",739,105,73,0,0,0,0,0,0
1549560,59,5,1954,7,"female",492,365,321,693,552,42,185,651,367
1549565,32,11,1981,5,"male",867,107,41,4,2,4,2,0,0
1549585,68,10,1945,10,"male",489,59,12,0,1,0,1,0,0
1549596,16,23,1997,5,"female",15,170,126,4,13,4,2,0,11
1549597,24,2,1989,8,"male",73,78,70,282,115,282,73,0,42
1549614,19,4,1994,1,"female",841,1250,418,249,3866,186,2970,63,896
1549616,16,25,1997,5,"male",205,76,44,1,11,1,11,0,0
1549626,91,22,1922,2,"male",2205,932,319,16,44,12,35,4,9
1549627,58,29,1955,1,"male",1712,846,344,384,813,334,492,50,321
1549653,31,17,1982,3,"male",32,9,8,0,0,0,0,0,0
1549692,38,14,1975,7,"female",361,200,168,82,37,24,29,58,8
1549695,59,21,1954,11,"female",306,24,17,5,0,3,0,2,0
1549712,47,8,1966,12,"female",1686,218,154,189,108,179,60,10,48
1549733,31,11,1982,5,"male",217,33,28,0,1,0,1,0,0
1549741,37,13,1976,12,"female",1798,154,100,1359,1273,533,447,826,826
1549747,19,4,1994,9,"female",580,306,79,1088,1115,638,406,450,709
1549755,18,4,1995,7,"female",245,587,159,4,157,4,121,0,36
1549764,108,27,1905,2,"male",623,50,35,0,0,0,0,0,0
1549778,50,22,1963,6,"female",194,138,67,34,6,0,2,34,4
1549793,15,21,1998,12,"male",26,6,6,4,1,4,1,0,0
1549819,23,15,1990,4,"male",468,49,3,1,1,1,1,0,0
1549882,17,20,1996,4,"male",531,611,403,1178,1947,143,653,1035,1294
1549890,24,6,1989,6,"female",478,163,91,395,90,300,53,95,37
1549911,49,1,1964,1,"male",431,59,31,22,14,2,2,20,12
1549920,50,1,1963,4,"male",797,16,7,32,0,32,0,0,0
1549940,21,25,1992,5,"male",294,92,58,2,6,2,5,0,1
1549952,25,19,1988,2,"male",182,103,72,42,8,31,4,11,4
1549974,16,12,1997,7,"female",551,133,114,3065,1397,2579,1126,486,271
1550003,14,7,1999,1,"male",152,155,108,1,1,0,0,1,1
1550025,25,30,1988,5,"female",643,87,56,6,1,0,1,6,0
1550035,40,15,1973,1,"male",539,17,12,13,36,11,36,2,0
1550046,20,5,1993,3,"male",314,19,15,9,10,0,1,9,9
1550097,20,29,1993,1,"female",263,66,53,50,75,41,28,9,47
1550103,53,10,1960,7,"male",395,233,203,9,2,0,0,9,2
1550112,33,8,1980,1,"female",212,60,26,0,0,0,0,0,0
1550125,43,20,1970,4,"female",111,22,20,17,14,17,11,0,3
1550132,18,15,1995,11,"male",335,238,61,102,114,102,82,0,32
1550153,24,22,1989,6,"male",427,5,3,8,3,8,3,0,0
1550170,23,8,1990,8,"male",334,569,30,80,27,63,19,17,8
1550172,38,20,1975,3,"male",384,18,6,7,1,7,1,0,0
1550187,47,28,1966,9,"male",390,259,54,134,70,132,46,2,24
1550220,15,31,1998,3,"male",240,95,28,328,10,311,8,17,2
1550228,21,12,1992,5,"male",150,28,20,1,0,1,0,0,0
1550259,44,26,1969,9,"male",928,83,33,14,0,14,0,0,0
1550283,21,5,1992,9,"female",20,6,5,0,0,0,0,0,0
1550293,33,13,1980,2,"male",209,59,37,10,3,10,2,0,1
1550297,23,10,1990,3,"male",118,69,43,509,70,498,63,11,7
1550300,69,4,1944,3,"female",444,65,40,3,5,0,2,3,3
1550310,47,14,1966,6,"female",612,178,109,16,6,13,4,3,2
1550332,21,30,1992,7,"male",121,138,124,26,0,26,0,0,0
1550343,19,8,1994,7,"male",863,374,146,17,22,17,18,0,4
1550344,16,1,1997,8,"male",802,6,5,0,0,0,0,0,0
1550367,103,8,1910,9,"female",1645,254,149,516,287,215,129,301,158
1550405,30,10,1983,5,"male",301,5,4,0,0,0,0,0,0
1550410,43,28,1970,9,"male",943,116,57,97,93,97,72,0,21
1550418,43,13,1970,3,"female",643,199,92,29,50,12,38,17,12
1550433,21,13,1992,2,"male",210,147,34,1,0,1,0,0,0
1550472,20,17,1993,10,"female",255,1187,785,816,974,97,488,719,486
1550488,22,23,1991,1,"female",425,184,46,1,6,1,1,0,5
1550491,23,17,1990,12,"female",587,220,128,2,3,2,3,0,0
1550538,39,9,1974,8,"female",448,153,100,536,64,395,26,141,38
1550540,23,5,1990,3,"male",505,60,54,0,0,0,0,0,0
1550571,38,20,1975,2,"male",1930,4845,942,1768,4886,1208,1619,560,3267
1550598,54,30,1959,3,"male",501,26,14,0,0,0,0,0,0
1550603,22,5,1991,6,"male",613,382,206,1,14,1,10,0,4
1550610,18,14,1995,9,"female",423,334,264,140,26,115,7,25,19
1550616,14,21,1999,4,"male",224,275,205,5,3,5,0,0,3
1550631,56,7,1957,8,"female",65,9,3,1,1,0,0,1,1
1550724,26,5,1987,1,"male",190,65,46,2,5,2,2,0,3
1550730,18,22,1995,7,"female",25,7,6,10,0,10,0,0,0
1550755,16,19,1997,3,"male",422,367,238,44,46,10,22,34,24
1550767,58,3,1955,4,"male",1185,240,111,753,475,407,147,346,328
1550780,25,1,1988,1,"male",133,16,10,0,0,0,0,0,0
1550805,20,9,1993,5,"male",49,27,22,0,8,0,2,0,6
1550843,32,28,1981,8,"male",259,144,111,54,290,54,210,0,80
1550878,22,4,1991,2,"female",273,156,99,10,26,10,22,0,4
1550888,16,26,1997,3,"female",412,181,96,1,0,1,0,0,0
1550910,30,10,1983,9,"female",718,710,260,1084,324,0,150,1084,174
1550916,27,28,1986,2,"male",361,1,1,0,0,0,0,0,0
1550922,19,13,1994,12,"female",344,124,58,202,0,202,0,0,0
1550931,50,5,1963,5,"male",750,65,46,5,78,5,58,0,20
1550937,22,4,1991,7,"male",508,67,35,1,0,1,0,0,0
1550943,18,17,1995,5,"male",930,219,167,27,59,27,49,0,10
1550951,28,12,1985,12,"male",194,22,18,34,33,34,29,0,4
1550968,26,1,1987,1,"male",425,177,158,103,0,103,0,0,0
1550980,32,1,1981,1,"male",302,122,109,113,18,113,8,0,10
1550992,42,6,1971,5,"male",266,86,59,13,24,13,12,0,12
1550998,69,19,1944,8,"female",749,92,66,5,6,5,6,0,0
1551001,16,20,1997,9,"male",179,20,13,6,19,6,18,0,1
1551004,20,5,1993,5,"male",70,56,48,6,0,6,0,0,0
1551005,30,14,1983,7,"male",1124,75,38,7,18,7,7,0,11
1551013,18,4,1995,2,"male",63,21,19,0,0,0,0,0,0
1551023,18,29,1995,10,"female",0,0,0,246,100,0,9,246,91
1551024,26,18,1987,9,"male",399,38,32,41,61,33,22,8,39
1551042,17,1,1996,1,"female",8,13,11,12,6,10,5,2,1
1551063,28,8,1985,6,"male",275,35,29,0,0,0,0,0,0
1551085,32,11,1981,7,"male",20,5,5,0,0,0,0,0,0
1551096,20,24,1993,1,"female",611,184,135,1,0,0,0,1,0
1551104,61,21,1952,7,"female",2368,112,95,30,39,10,35,20,4
1551112,58,29,1955,6,"female",886,33,23,8,2,8,2,0,0
1551138,23,16,1990,9,"female",551,194,66,153,93,12,65,141,28
1551140,26,29,1987,7,"male",610,3,1,0,0,0,0,0,0
1551169,24,23,1989,5,"male",540,527,419,1,0,1,0,0,0
1551195,21,2,1992,5,"male",666,132,39,0,3,0,3,0,0
1551231,19,7,1994,10,"female",402,870,731,67,113,50,84,17,29
1551234,22,5,1991,5,"male",48,36,25,1,4,1,2,0,2
1551268,30,18,1983,6,"male",585,41,25,28,8,7,7,21,1
1551294,58,10,1955,8,"male",242,277,12,57,231,57,192,0,39
1551329,22,2,1991,1,"female",171,51,12,47,78,47,47,0,31
1551346,29,31,1984,7,"male",84,58,24,0,3,0,2,0,1
1551348,71,22,1942,9,"female",20,38,21,10,20,0,6,10,14
1551352,29,8,1984,3,"male",448,51,31,0,2,0,2,0,0
1551359,21,16,1992,8,"male",231,640,532,642,614,607,385,35,229
1551361,63,2,1950,2,"female",309,30,13,0,3,0,1,0,2
1551379,31,5,1982,8,"male",73,18,12,32,26,29,16,3,10
1551380,41,30,1972,12,"male",352,75,53,0,3,0,2,0,1
1551471,42,8,1971,6,"male",413,90,81,41,14,41,13,0,1
1551501,43,28,1970,4,"female",783,67,45,0,5,0,1,0,4
1551505,20,14,1993,4,"female",562,140,103,506,734,128,450,378,284
1551508,23,29,1990,6,"male",66,256,231,78,2,71,1,7,1
1551542,26,11,1987,7,"male",535,185,168,18,16,18,12,0,4
1551549,24,19,1989,11,"female",545,248,139,302,415,302,104,0,311
1551575,42,19,1971,9,"male",433,98,43,174,54,174,42,0,12
1551581,27,20,1986,8,"female",426,99,78,18,8,18,7,0,1
1551591,17,10,1996,10,"female",459,241,57,5,13,5,7,0,6
1551596,25,7,1988,11,"male",9,0,0,0,0,0,0,0,0
1551630,61,28,1952,7,"female",102,33,7,1,0,0,0,1,0
1551643,19,15,1994,6,"male",49,37,31,6,4,6,3,0,1
1551660,57,27,1956,7,"female",1488,97,68,46,110,46,86,0,24
1551688,46,1,1967,11,"female",538,60,33,48,29,33,22,15,7
1551713,28,12,1985,10,"female",317,137,62,535,430,415,237,120,193
1551716,44,20,1969,4,"female",1276,72,38,22,21,3,8,19,13
1551723,52,15,1961,2,"female",438,35,13,505,27,505,20,0,7
1551758,54,21,1959,8,"female",1418,63,38,39,17,36,13,3,4
1551763,62,25,1951,6,"female",1418,379,278,3248,1879,0,366,3248,1513
1551772,103,18,1910,6,"male",1297,639,32,379,961,0,313,379,648
1551773,17,18,1996,3,"female",825,1484,694,172,303,106,256,66,47
1551812,18,2,1995,9,"male",246,188,110,15,19,15,15,0,4
1551844,25,13,1988,12,"male",151,175,111,13,36,13,26,0,10
1551851,37,20,1976,10,"female",2391,181,158,185,119,185,90,0,29
1551897,18,22,1995,5,"female",477,1076,612,5,72,5,51,0,21
1551936,57,26,1956,8,"female",1251,28,16,107,20,43,9,64,11
1551950,22,24,1991,11,"female",1688,686,200,0,3,0,0,0,3
1551961,17,12,1996,12,"male",161,332,306,173,112,173,104,0,8
1552004,35,12,1978,9,"male",348,252,218,101,87,55,52,46,35
1552013,68,11,1945,1,"female",1463,74,16,50,5,0,4,50,1
1552043,23,10,1990,7,"male",273,0,0,0,0,0,0,0,0
1552051,73,3,1940,8,"female",2173,27,8,11,3,0,0,11,3
1552111,29,15,1984,7,"male",253,38,27,0,0,0,0,0,0
1552141,64,25,1949,2,"male",733,147,27,11,13,0,10,11,3
1552177,56,29,1957,12,"male",1734,2,0,4,0,0,0,4,0
1552207,41,24,1972,6,"female",275,16,13,0,0,0,0,0,0
1552237,30,12,1983,4,"female",453,57,25,40,198,40,183,0,15
1552306,17,12,1996,7,"male",40,24,22,6,3,6,2,0,1
1552318,35,6,1978,9,"female",0,0,0,1,0,1,0,0,0
1552323,23,12,1990,10,"male",409,373,326,80,176,80,165,0,11
1552337,19,22,1994,12,"female",445,388,275,138,54,111,17,27,37
1552379,62,30,1951,6,"male",173,15,2,5,1,5,1,0,0
1552444,19,3,1994,1,"male",244,378,320,136,44,136,32,0,12
1552446,47,6,1966,4,"female",390,82,41,717,558,0,95,717,463
1552449,34,8,1979,11,"female",1485,148,57,60,70,59,33,1,37
1552507,24,24,1989,10,"male",744,236,208,2,2,0,1,2,1
1552686,31,16,1982,1,"male",414,69,44,112,0,112,0,0,0
1552721,32,9,1981,7,"male",246,19,15,1,11,1,6,0,5
1552727,46,16,1967,5,"male",869,67,66,187,14,172,4,15,10
1552773,33,20,1980,11,"female",348,290,107,0,10,0,10,0,0
1552785,73,15,1940,1,"female",1148,84,36,129,75,129,59,0,16
1552789,22,4,1991,1,"male",502,174,133,19,17,19,11,0,6
1552810,17,4,1996,4,"female",651,809,615,582,263,481,224,101,39
1552828,56,23,1957,11,"male",578,45,27,0,0,0,0,0,0
1552862,31,28,1982,8,"female",46,22,18,100,57,70,22,30,35
1552866,29,29,1984,4,"female",300,46,19,67,7,67,7,0,0
1552885,30,13,1983,4,"male",351,93,49,7,15,3,8,4,7
1552896,45,26,1968,12,"male",77,0,0,0,0,0,0,0,0
1552914,29,20,1984,3,"male",173,66,50,0,0,0,0,0,0
1552926,69,2,1944,10,"female",1906,630,232,1132,1096,362,257,770,839
1552982,30,14,1983,7,"male",34,2,2,0,0,0,0,0,0
1552991,47,23,1966,11,"male",326,205,126,13,31,6,5,7,26
1552996,17,4,1996,1,"male",161,133,114,0,0,0,0,0,0
1553003,102,29,1911,9,"male",1476,1687,570,255,421,253,301,2,120
1553036,62,8,1951,5,"male",1640,9,4,2,1,2,1,0,0
1553063,18,8,1995,11,"male",169,27,26,0,1,0,1,0,0
1553099,25,11,1988,2,"male",53,22,12,29,15,20,12,9,3
1553191,43,27,1970,11,"female",370,0,0,0,0,0,0,0,0
1553223,16,16,1997,4,"female",331,14,3,16,0,16,0,0,0
1553245,33,1,1980,2,"female",322,0,0,0,0,0,0,0,0
1553258,51,26,1962,7,"female",468,137,111,585,65,0,11,585,54
1553279,30,7,1983,12,"male",420,17,10,48,12,48,7,0,5
1553281,35,2,1978,9,"female",452,203,165,183,140,176,66,7,74
1553321,25,1,1988,1,"male",33,35,22,0,0,0,0,0,0
1553327,113,8,1900,12,"female",1611,107,58,2,0,2,0,0,0
1553349,64,6,1949,5,"female",1561,111,48,28,58,1,30,27,28
1553393,54,7,1959,3,"female",225,63,43,2,17,0,10,2,7
1553406,49,10,1964,5,"female",393,84,36,67,6,33,3,34,3
1553410,46,10,1967,10,"male",1042,13,6,5,0,4,0,1,0
1553412,27,3,1986,10,"male",333,78,60,5,23,2,12,3,11
1553418,42,11,1971,10,"female",52,217,142,45,52,45,45,0,7
1553429,65,23,1948,2,"male",816,5,1,0,0,0,0,0,0
1553439,25,3,1988,9,"male",159,15,15,7,1,7,1,0,0
1553494,17,19,1996,7,"male",274,1037,898,112,200,112,120,0,80
1553507,27,21,1986,3,"male",5,0,0,0,0,0,0,0,0
1553522,44,6,1969,9,"male",130,39,25,13,23,12,19,1,4
1553527,38,13,1975,8,"male",374,58,24,1,5,1,5,0,0
1553596,64,16,1949,5,"female",1223,84,61,1,0,0,0,1,0
1553599,27,21,1986,8,"male",124,77,75,0,1,0,0,0,1
1553608,103,9,1910,6,"male",638,155,63,1,3,1,3,0,0
1553633,19,5,1994,5,"female",1119,269,93,38,52,38,51,0,1
1553655,24,12,1989,11,"female",214,1812,508,176,302,176,260,0,42
1553664,27,17,1986,4,"male",411,23,22,0,0,0,0,0,0
1553667,20,15,1993,9,"female",440,1132,853,1319,1794,955,1062,364,732
1553681,23,16,1990,5,"male",293,376,350,6,9,0,7,6,2
1553707,25,1,1988,1,"male",49,33,33,1,1,1,0,0,1
1553708,41,15,1972,7,"male",666,48,18,0,5,0,1,0,4
1553729,62,22,1951,9,"female",1686,78,17,294,220,4,155,290,65
1553748,24,19,1989,9,"male",332,84,61,0,0,0,0,0,0
1553771,36,3,1977,12,"female",1349,480,273,3920,1012,3163,802,757,210
1553809,27,26,1986,8,"male",209,28,22,0,0,0,0,0,0
1553858,20,19,1993,12,"male",272,91,65,0,1,0,1,0,0
1553871,20,2,1993,7,"male",436,387,274,34,236,34,183,0,53
1553872,33,15,1980,5,"male",251,114,67,527,1542,512,1117,15,425
1553883,19,15,1994,6,"female",209,215,152,80,160,80,60,0,100
1553887,41,27,1972,11,"male",279,59,20,2,12,0,10,2,2
1553906,32,23,1981,8,"female",224,219,138,25,20,0,4,25,16
1553925,18,30,1995,8,"male",280,1,1,3,0,3,0,0,0
1553931,72,12,1941,8,"female",116,16,12,11,54,0,1,11,53
1553932,21,15,1992,12,"male",212,3,2,17,22,6,6,11,16
1553943,66,8,1947,8,"male",284,2,2,40,1,40,1,0,0
1553963,27,6,1986,6,"female",151,80,50,23,22,23,20,0,2
1553965,23,11,1990,9,"male",162,34,22,0,0,0,0,0,0
1553979,19,19,1994,5,"male",59,21,16,0,2,0,0,0,2
1553996,108,14,1905,11,"male",1988,504,359,2,24,1,10,1,14
1553997,31,6,1982,7,"male",533,124,110,7,21,7,18,0,3
1554064,36,5,1977,4,"male",451,43,6,0,0,0,0,0,0
1554072,28,12,1985,4,"female",1728,243,131,41,109,39,58,2,51
1554073,22,14,1991,5,"male",5,8,8,9,4,9,4,0,0
1554076,20,15,1993,11,"male",810,1,0,4,3,4,3,0,0
1554082,52,6,1961,3,"female",1201,26,3,9,1,9,0,0,1
1554102,43,20,1970,12,"male",732,4,3,0,0,0,0,0,0
1554130,33,12,1980,6,"male",224,13,7,0,0,0,0,0,0
1554152,20,24,1993,12,"female",127,1,1,0,0,0,0,0,0
1554160,47,18,1966,3,"male",843,67,20,33,54,33,41,0,13
1554213,53,15,1960,11,"female",159,24,16,31,12,31,2,0,10
1554216,19,1,1994,11,"male",303,734,509,124,192,65,151,59,41
1554235,41,16,1972,5,"male",303,24,22,32,13,32,12,0,1
1554238,20,12,1993,11,"female",651,252,187,84,51,82,40,2,11
1554260,33,1,1980,1,"male",347,9,5,0,0,0,0,0,0
1554270,23,8,1990,1,"male",286,64,11,4,1,3,1,1,0
1554280,27,9,1986,10,"male",1192,106,34,3,7,0,4,3,3
1554326,33,29,1980,6,"female",259,75,15,0,1,0,1,0,0
1554351,62,11,1951,5,"female",1399,519,233,640,372,30,132,610,240
1554413,18,26,1995,8,"male",451,303,232,0,48,0,24,0,24
1554426,18,29,1995,9,"female",846,96,84,0,0,0,0,0,0
1554469,64,2,1949,5,"male",1752,78,54,0,5,0,0,0,5
1554470,22,26,1991,8,"female",435,531,159,662,498,662,433,0,65
1554482,51,21,1962,7,"male",442,109,68,0,1,0,1,0,0
1554490,19,1,1994,1,"male",40,30,27,1,1,1,0,0,1
1554551,70,10,1943,6,"male",286,0,0,0,0,0,0,0,0
1554558,22,5,1991,11,"male",143,1,1,166,41,166,21,0,20
1554569,64,4,1949,9,"female",131,25,15,1,5,0,4,1,1
1554576,105,19,1908,8,"female",1072,950,294,6,17,0,10,6,7
1554601,27,15,1986,6,"female",413,1,1,0,0,0,0,0,0
1554602,27,18,1986,12,"male",655,411,116,0,0,0,0,0,0
1554610,23,23,1990,3,"male",142,199,147,21,121,20,48,1,73
1554648,25,1,1988,1,"male",48,13,11,3,3,3,1,0,2
1554685,27,31,1986,10,"male",382,8,5,0,0,0,0,0,0
1554688,93,1,1920,1,"female",498,114,80,19,18,19,13,0,5
1554695,24,6,1989,9,"male",298,125,86,9,6,9,6,0,0
1554713,17,6,1996,6,"male",193,361,184,187,91,187,71,0,20
1554736,64,5,1949,8,"female",430,26,19,119,31,119,31,0,0
1554746,33,26,1980,8,"female",167,39,27,126,211,126,210,0,1
1554794,71,25,1942,5,"female",280,0,0,1,5,0,3,1,2
1554827,28,4,1985,3,"female",393,207,112,9,167,5,109,4,58
1554851,25,1,1988,1,"male",85,1,1,40,22,40,22,0,0
1554856,63,6,1950,10,"male",132,377,320,100,44,80,42,20,2
1554861,103,26,1910,6,"male",656,332,283,1,1,1,1,0,0
1554863,25,23,1988,2,"male",425,132,125,6,0,6,0,0,0
1554888,34,31,1979,8,"male",161,70,57,2,1,2,1,0,0
1554905,21,27,1992,2,"female",658,375,57,311,1323,310,1052,1,271
1554918,18,10,1995,10,"male",310,238,215,141,20,141,19,0,1
1554965,64,21,1949,8,"female",92,34,32,4,8,4,4,0,4
1554967,18,10,1995,2,"female",277,575,469,88,61,72,24,16,37
1554988,86,28,1927,8,"male",333,165,93,1,0,0,0,1,0
1555002,18,21,1995,3,"male",463,142,92,0,0,0,0,0,0
1555008,73,13,1940,6,"female",596,48,29,0,0,0,0,0,0
1555014,15,9,1998,12,"female",350,103,68,13,0,11,0,2,0
1555028,16,15,1997,3,"male",217,14,1,0,0,0,0,0,0
1555059,57,24,1956,6,"female",440,80,54,38,37,0,16,38,21
1555076,24,11,1989,10,"male",643,60,26,1,7,1,1,0,6
1555085,24,1,1989,7,"female",341,6,5,17,4,17,4,0,0
1555086,56,15,1957,2,"male",165,31,26,76,0,76,0,0,0
1555101,33,3,1980,5,"male",649,42,26,0,6,0,0,0,6
1555116,29,15,1984,11,"female",163,30,19,1,32,0,14,1,18
1555123,23,3,1990,4,"female",635,0,0,0,0,0,0,0,0
1555144,17,11,1996,10,"male",242,262,203,18,2,18,2,0,0
1555169,40,13,1973,8,"male",1457,41,16,6,3,5,2,1,1
1555171,24,1,1989,1,"male",271,169,96,9,37,9,26,0,11
1555177,23,5,1990,6,"male",702,151,118,0,0,0,0,0,0
1555214,14,8,1999,2,"female",447,308,197,94,38,94,34,0,4
1555238,18,22,1995,2,"male",321,14,8,148,28,1,8,147,20
1555270,59,19,1954,11,"male",86,34,17,0,3,0,2,0,1
1555271,59,3,1954,12,"female",1394,178,78,58,377,24,303,34,74
1555281,19,13,1994,11,"male",563,70,68,2,0,2,0,0,0
1555285,21,3,1992,8,"male",200,1,0,0,0,0,0,0,0
1555288,17,22,1996,8,"male",230,112,102,28,1,3,1,25,0
1555294,19,29,1994,1,"male",474,80,58,2,1,2,1,0,0
1555314,25,26,1988,7,"male",951,9,6,0,0,0,0,0,0
1555325,24,12,1989,12,"female",411,38,6,0,0,0,0,0,0
1555343,49,12,1964,12,"male",203,1,0,0,0,0,0,0,0
1555367,13,14,2000,7,"female",629,92,53,173,248,87,112,86,136
1555368,29,9,1984,9,"male",463,3,1,2,0,2,0,0,0
1555372,31,29,1982,6,"female",216,53,53,154,15,154,14,0,1
1555391,28,1,1985,8,"male",119,112,94,25,10,24,6,1,4
1555395,18,1,1995,1,"male",37,63,51,24,29,24,7,0,22
1555415,25,12,1988,4,"male",737,24,3,2,1,2,1,0,0
1555435,50,29,1963,8,"male",1681,183,123,379,339,117,179,262,160
1555461,31,2,1982,3,"male",136,32,31,8,0,0,0,8,0
1555495,23,24,1990,9,"male",270,61,51,16,3,16,2,0,1
1555503,47,29,1966,11,"male",361,17,10,18,0,18,0,0,0
1555510,18,1,1995,11,"male",344,1342,602,1060,3328,465,1953,595,1375
1555519,22,13,1991,3,"male",23,0,0,4,4,4,2,0,2
1555539,21,15,1992,5,"male",602,204,117,3,3,3,1,0,2
1555553,102,12,1911,8,"male",775,583,438,945,683,945,584,0,99
1555559,35,12,1978,11,"female",230,173,140,0,0,0,0,0,0
1555582,33,15,1980,11,"female",962,52,22,271,131,229,97,42,34
1555596,31,7,1982,5,"male",319,34,24,0,16,0,9,0,7
1555627,68,28,1945,1,"male",480,2,1,0,0,0,0,0,0
1555637,58,19,1955,3,"male",32,0,0,0,0,0,0,0,0
1555638,53,19,1960,3,"male",1831,79,31,1,1,0,1,1,0
1555648,33,16,1980,7,"female",41,38,21,301,133,297,80,4,53
1555655,14,8,1999,8,"female",123,63,34,27,7,27,2,0,5
1555673,62,31,1951,1,"female",119,50,25,1,0,1,0,0,0
1555684,17,24,1996,2,"male",312,2354,1582,679,1805,257,1391,422,414
1555736,30,11,1983,5,"female",33,8,8,4,1,4,1,0,0
1555793,19,20,1994,12,"female",144,198,103,2012,1904,685,812,1327,1092
1555794,33,19,1980,2,"female",369,3,2,0,5,0,5,0,0
1555797,30,1,1983,1,"male",198,57,38,2,0,2,0,0,0
1555819,103,10,1910,1,"male",1039,21,12,10,8,10,3,0,5
1555844,20,25,1993,12,"female",58,195,104,144,178,144,161,0,17
1555868,22,11,1991,9,"female",691,67,55,0,0,0,0,0,0
1555889,18,28,1995,5,"female",727,1132,310,668,1380,433,352,235,1028
1555930,65,15,1948,3,"male",216,65,46,57,5,57,4,0,1
1555996,66,5,1947,4,"male",701,256,120,261,49,261,41,0,8
1556065,79,6,1934,3,"male",826,23,15,15,9,0,7,15,2
1556078,30,10,1983,1,"male",297,23,18,81,1,81,1,0,0
1556100,73,12,1940,2,"male",1898,321,58,2,9,1,3,1,6
1556123,73,6,1940,8,"female",62,66,48,302,128,0,9,302,119
1556124,30,27,1983,7,"male",64,23,20,15,7,15,7,0,0
1556143,18,19,1995,11,"female",397,92,55,2,0,2,0,0,0
1556147,31,16,1982,2,"male",947,142,81,9,1,9,1,0,0
1556154,32,26,1981,1,"male",261,6,5,3,5,0,3,3,2
1556175,108,14,1905,10,"female",1619,202,158,995,35,7,17,988,18
1556202,27,16,1986,5,"female",334,1,1,0,0,0,0,0,0
1556211,33,17,1980,5,"female",319,63,15,20,115,20,78,0,37
1556230,26,23,1987,4,"female",443,74,27,16,27,16,24,0,3
1556267,22,23,1991,3,"female",84,4508,195,905,4844,538,1001,367,3843
1556274,51,9,1962,2,"female",298,523,360,13,91,0,34,13,57
1556282,21,22,1992,10,"female",69,488,404,3740,5000,2699,3764,1041,1236
1556286,94,1,1919,1,"male",2192,61,29,5,18,0,2,5,16
1556296,21,25,1992,1,"male",377,82,45,5,5,5,5,0,0
1556304,56,27,1957,4,"male",681,64,40,0,0,0,0,0,0
1556305,22,1,1991,1,"male",679,103,62,0,0,0,0,0,0
1556308,55,6,1958,10,"male",619,421,342,3,8,0,0,3,8
1556310,15,20,1998,4,"female",673,482,192,32,106,20,57,12,49
1556319,47,8,1966,3,"male",365,49,21,60,2,60,1,0,1
1556326,23,2,1990,3,"female",165,132,118,58,46,58,16,0,30
1556368,53,8,1960,4,"male",463,7,4,1,0,0,0,1,0
1556379,21,17,1992,12,"female",804,97,91,0,0,0,0,0,0
1556416,19,11,1994,8,"male",506,71,30,0,0,0,0,0,0
1556424,28,25,1985,8,"male",1441,3,3,0,0,0,0,0,0
1556430,25,18,1988,8,"male",194,45,43,117,16,112,8,5,8
1556451,48,18,1965,2,"male",543,32,23,0,0,0,0,0,0
1556454,19,21,1994,1,"female",398,934,460,1023,1240,806,655,217,585
1556485,40,21,1973,1,"female",153,55,32,449,125,449,96,0,29
1556487,57,14,1956,7,"male",56,62,55,10,9,0,8,10,1
1556505,19,12,1994,7,"male",21,45,39,3,3,3,3,0,0
1556535,57,4,1956,8,"female",1817,397,200,1719,1524,617,931,1102,593
1556538,16,5,1997,7,"male",292,389,276,20,13,9,13,11,0
1556561,20,20,1993,12,"male",388,200,86,2,29,2,8,0,21
1556562,70,14,1943,1,"female",1705,287,191,179,61,179,46,0,15
1556581,42,13,1971,3,"male",2184,94,63,68,53,68,41,0,12
1556601,25,1,1988,1,"female",265,7,6,46,42,44,36,2,6
1556610,30,14,1983,5,"female",242,271,131,83,98,83,95,0,3
1556635,51,1,1962,11,"male",445,21,15,110,59,17,36,93,23
1556707,107,24,1906,10,"female",1577,644,131,65,186,8,94,57,92
1556732,23,21,1990,5,"male",760,45,28,1,0,1,0,0,0
1556757,36,9,1977,2,"female",402,81,42,196,186,1,123,195,63
1556769,23,1,1990,7,"male",26,40,30,0,4,0,2,0,2
1556788,14,4,1999,1,"female",266,139,63,5,4,0,1,5,3
1556794,22,15,1991,3,"male",155,222,203,1,6,1,6,0,0
1556820,20,3,1993,9,"female",396,84,20,0,4,0,4,0,0
1556882,46,19,1967,1,"male",1411,138,54,54,170,27,37,27,133
1556914,20,14,1993,6,"male",278,297,258,164,58,70,20,94,38
1556922,66,6,1947,5,"male",46,33,17,11,0,11,0,0,0
1556926,63,14,1950,7,"female",29,14,11,24,73,24,56,0,17
1556932,108,18,1905,12,NA,1860,265,119,58,14,0,3,58,11
1556967,22,28,1991,3,"male",553,65,49,1,2,1,2,0,0
1556991,52,11,1961,2,"female",239,21,15,19,23,4,5,15,18
1557009,29,26,1984,10,"male",678,150,45,311,328,266,118,45,210
1557020,36,9,1977,11,"male",643,11,1,2,0,2,0,0,0
1557045,46,20,1967,11,"male",233,81,71,0,1,0,0,0,1
1557048,42,13,1971,2,"male",174,53,36,6,7,0,5,6,2
1557061,27,11,1986,6,"female",564,34,28,122,112,105,48,17,64
1557125,70,22,1943,7,"female",1717,53,21,90,12,90,10,0,2
1557139,17,13,1996,5,"male",191,188,22,17,24,0,6,17,18
1557168,66,9,1947,3,"female",601,95,46,100,25,0,18,100,7
1557201,25,16,1988,11,"female",247,207,60,5,21,5,17,0,4
1557207,97,1,1916,5,"female",293,68,40,672,60,0,9,672,51
1557219,48,6,1965,5,"male",200,39,30,13,16,1,3,12,13
1557241,20,18,1993,4,"male",154,30,23,32,23,22,11,10,12
1557290,18,28,1995,2,"male",577,216,110,1,5,1,3,0,2
1557300,18,12,1995,3,"male",491,269,142,324,33,2,23,322,10
1557327,23,10,1990,10,"female",239,69,38,71,6,71,6,0,0
1557328,83,28,1930,3,"female",1691,247,166,89,18,89,14,0,4
1557329,26,9,1987,7,"female",411,55,34,96,54,96,33,0,21
1557351,38,1,1975,4,"female",514,111,66,39,150,32,100,7,50
1557359,18,1,1995,9,"female",445,391,107,1416,738,1084,354,332,384
1557364,34,19,1979,2,"male",668,211,144,156,686,155,235,1,451
1557399,50,6,1963,12,"female",462,37,33,7,16,5,7,2,9
1557401,26,10,1987,7,"male",610,40,19,0,0,0,0,0,0
1557445,28,14,1985,2,"female",3,0,0,0,0,0,0,0,0
1557449,24,30,1989,3,"male",153,140,104,17,36,17,25,0,11
1557491,17,6,1996,10,"male",456,479,413,11,3,0,3,11,0
1557493,26,1,1987,1,"female",385,7,3,0,0,0,0,0,0
1557529,23,26,1990,6,"female",509,190,68,11,20,9,10,2,10
1557534,20,28,1993,11,"male",108,7,5,7,3,7,2,0,1
1557543,47,30,1966,8,"male",499,66,36,0,1,0,0,0,1
1557548,25,24,1988,9,"male",303,405,269,3138,1962,3138,1650,0,312
1557555,40,21,1973,9,"male",306,20,14,5,5,5,3,0,2
1557601,18,20,1995,12,"female",304,515,475,283,128,283,125,0,3
1557610,26,2,1987,2,"male",307,26,24,1,1,1,1,0,0
1557612,16,27,1997,1,"female",420,54,31,5,0,5,0,0,0
1557617,108,1,1905,1,"female",513,86,54,81,162,0,110,81,52
1557619,56,28,1957,3,"male",994,37,18,5,15,5,6,0,9
1557627,54,15,1959,10,"male",277,74,24,274,254,274,126,0,128
1557645,14,18,1999,5,"female",815,958,327,3168,4146,2024,3678,1144,468
1557669,66,9,1947,7,"male",998,15,4,2,3,0,3,2,0
1557711,39,25,1974,12,"female",644,377,177,626,951,626,394,0,557
1557736,15,22,1998,4,"female",289,138,105,0,3,0,3,0,0
1557753,23,2,1990,2,"female",58,45,38,28,6,28,0,0,6
1557763,43,18,1970,12,"male",103,63,46,1,0,1,0,0,0
1557799,108,13,1905,1,"female",2149,217,113,21,18,0,5,21,13
1557805,108,31,1905,12,"female",233,80,69,0,0,0,0,0,0
1557820,15,2,1998,6,"male",251,85,46,0,0,0,0,0,0
1557825,32,24,1981,4,"female",233,47,24,624,426,624,273,0,153
1557836,43,14,1970,1,"female",244,171,144,81,99,64,84,17,15
1557840,39,11,1974,12,"female",347,27,15,5,6,1,0,4,6
1557871,17,20,1996,11,"female",506,589,195,88,245,7,187,81,58
1557873,19,1,1994,1,"female",599,490,304,338,306,331,112,7,194
1557891,62,17,1951,12,"male",164,27,24,1,0,1,0,0,0
1557893,43,21,1970,10,"male",1230,67,30,10,21,8,15,2,6
1557915,17,20,1996,12,"male",899,117,55,2,31,2,27,0,4
1557937,14,13,1999,4,"female",110,231,107,97,68,96,37,1,31
1557941,69,24,1944,10,"male",1039,30,18,15,2,15,2,0,0
1557953,57,30,1956,5,"male",1280,70,45,150,131,150,51,0,80
1557972,15,4,1998,12,"female",66,331,107,67,283,67,263,0,20
1557975,22,7,1991,7,"male",324,482,378,0,0,0,0,0,0
1557985,18,21,1995,6,"male",127,138,116,73,50,73,13,0,37
1557986,47,28,1966,2,"female",292,36,26,10,34,10,33,0,1
1557988,14,26,1999,1,"male",228,137,29,3,0,3,0,0,0
1558007,25,29,1988,3,"male",583,0,0,0,0,0,0,0,0
1558016,20,22,1993,2,"male",424,97,52,19,10,16,7,3,3
1558036,40,30,1973,9,"male",142,0,0,0,0,0,0,0,0
1558044,61,11,1952,10,"male",428,93,53,2,3,0,1,2,2
1558072,17,11,1996,12,"female",189,31,7,0,9,0,1,0,8
1558098,23,26,1990,10,"male",908,1844,929,165,305,164,262,1,43
1558105,26,1,1987,1,"male",408,89,30,0,0,0,0,0,0
1558128,24,5,1989,3,"male",160,107,69,0,1,0,1,0,0
1558130,48,26,1965,7,"female",834,154,57,98,53,98,43,0,10
1558158,21,15,1992,4,"female",353,612,254,31,35,31,31,0,4
1558173,26,1,1987,1,"male",593,109,106,122,3,122,3,0,0
1558181,25,23,1988,7,"male",716,154,95,6,4,0,2,6,2
1558209,72,29,1941,3,"male",1162,113,79,429,428,426,417,3,11
1558223,25,13,1988,7,"male",70,53,47,34,1,34,1,0,0
1558272,30,21,1983,7,"female",744,163,76,0,2,0,1,0,1
1558273,24,17,1989,5,"male",414,243,59,9,1,0,1,9,0
1558287,22,11,1991,3,"male",99,327,234,1306,444,1306,368,0,76
1558297,63,28,1950,9,"male",109,12,9,0,0,0,0,0,0
1558344,68,26,1945,2,"male",258,20,18,13,15,0,10,13,5
1558364,20,11,1993,4,"male",15,0,0,0,0,0,0,0,0
1558370,71,27,1942,7,"female",1879,114,39,15,13,15,12,0,1
1558376,103,30,1910,7,"female",1153,230,92,1151,713,130,166,1021,547
1558387,78,2,1935,9,"female",1679,101,42,1,1,0,0,1,1
1558392,63,1,1950,9,"male",583,2,1,0,0,0,0,0,0
1558394,43,1,1970,9,"female",1197,892,614,1138,1650,11,813,1127,837
1558397,108,12,1905,5,"female",650,320,90,6,12,6,7,0,5
1558433,18,11,1995,9,"male",356,138,106,12,0,11,0,1,0
1558440,17,7,1996,2,"female",170,484,411,104,97,50,72,54,25
1558442,20,2,1993,8,"female",566,275,84,4,0,4,0,0,0
1558443,17,28,1996,1,"male",339,178,101,798,180,645,103,153,77
1558475,30,12,1983,12,"male",744,7,5,0,0,0,0,0,0
1558480,17,6,1996,6,"male",240,38,23,0,2,0,1,0,1
1558483,47,6,1966,7,"female",494,57,10,12,14,12,10,0,4
1558499,24,9,1989,4,"male",38,16,13,1,1,1,1,0,0
1558509,34,21,1979,8,"female",50,104,100,35,45,31,12,4,33
1558515,25,3,1988,1,"male",207,19,16,0,2,0,2,0,0
1558532,45,1,1968,2,"male",373,55,20,23,142,23,134,0,8
1558548,32,8,1981,11,"female",629,199,74,169,48,102,14,67,34
1558560,30,16,1983,5,"male",125,108,89,350,28,350,25,0,3
1558568,15,21,1998,11,"female",743,133,22,31,85,0,1,31,84
1558592,15,11,1998,3,"male",64,12,10,0,0,0,0,0,0
1558605,77,11,1936,2,"female",691,47,22,166,98,0,3,166,95
1558616,28,16,1985,1,"male",86,0,0,0,0,0,0,0,0
1558626,18,3,1995,11,"male",498,653,514,10,41,10,40,0,1
1558689,64,2,1949,6,"male",486,10,6,0,0,0,0,0,0
1558695,93,18,1920,4,"male",414,9,8,0,0,0,0,0,0
1558697,70,12,1943,7,"female",272,7,5,16,11,0,5,16,6
1558716,26,1,1987,1,"male",199,11,7,0,1,0,0,0,1
1558723,22,6,1991,9,"male",187,66,48,0,0,0,0,0,0
1558725,66,7,1947,11,"female",1915,74,20,29,97,29,83,0,14
1558781,29,11,1984,9,"female",287,46,41,6,0,6,0,0,0
1558782,23,2,1990,10,"male",829,137,66,72,96,0,2,72,94
1558786,43,27,1970,3,"female",402,222,73,355,220,355,174,0,46
1558802,19,31,1994,3,"male",592,267,157,139,72,139,68,0,4
1558819,17,15,1996,2,"male",872,69,35,0,0,0,0,0,0
1558823,32,7,1981,8,"male",636,592,381,89,198,83,135,6,63
1558835,20,18,1993,8,"male",513,1,1,0,0,0,0,0,0
1558846,34,3,1979,8,"female",337,87,57,2,1,2,0,0,1
1558847,108,5,1905,9,"female",376,90,68,4,6,4,4,0,2
1558849,45,15,1968,12,"male",845,49,36,1,0,0,0,1,0
1558852,22,8,1991,12,"male",175,35,25,0,0,0,0,0,0
1558900,25,24,1988,7,"female",464,109,77,49,52,3,11,46,41
1558914,14,31,1999,7,"male",147,52,31,4,0,0,0,4,0
1558926,19,26,1994,9,"female",420,115,38,4,6,4,6,0,0
1558934,26,8,1987,1,"male",272,24,9,8,1,8,1,0,0
1558941,59,19,1954,3,"female",1540,257,112,2329,2378,1586,1432,743,946
1558942,22,4,1991,7,"female",341,17,10,101,69,90,18,11,51
1558984,20,16,1993,2,"male",1090,61,51,11,0,2,0,9,0
1558993,14,1,1999,1,"female",1281,987,604,606,419,141,143,465,276
1559040,14,27,1999,4,"female",334,2091,474,899,2297,287,1919,612,378
1559050,88,17,1925,10,"male",1330,140,89,18,6,0,3,18,3
1559075,36,20,1977,10,"female",271,13,9,2,2,0,2,2,0
1559095,30,12,1983,10,"male",1416,5,4,0,0,0,0,0,0
1559120,49,20,1964,8,"male",555,25,19,0,0,0,0,0,0
1559162,21,11,1992,2,"female",378,534,300,36,88,36,60,0,28
1559170,28,15,1985,10,"male",281,213,161,15,131,15,45,0,86
1559176,54,16,1959,4,"female",419,19,13,5,3,1,0,4,3
1559177,46,6,1967,8,"female",712,1,1,1,1,1,1,0,0
1559204,33,10,1980,6,"male",1088,201,45,48,68,46,27,2,41
1559207,24,22,1989,11,"male",695,503,207,250,360,212,201,38,159
1559219,60,8,1953,2,"female",672,9,7,0,1,0,1,0,0
1559228,14,21,1999,2,"male",296,16,9,0,0,0,0,0,0
1559229,21,26,1992,5,"male",324,282,256,0,0,0,0,0,0
1559240,19,19,1994,10,"male",595,294,181,3,20,3,13,0,7
1559253,21,25,1992,12,"female",422,581,104,125,113,125,99,0,14
1559260,25,17,1988,5,"male",10,42,37,25,0,25,0,0,0
1559277,52,29,1961,8,"male",281,88,59,7,9,0,0,7,9
1559313,25,28,1988,7,"male",536,29,2,4,0,4,0,0,0
1559316,71,18,1942,8,"female",242,7,4,3,5,3,4,0,1
1559363,57,28,1956,5,"female",465,38,18,28,5,28,3,0,2
1559415,24,8,1989,2,"female",138,315,269,1340,473,1340,399,0,74
1559442,18,12,1995,3,"male",661,71,24,2,11,2,6,0,5
1559451,19,17,1994,11,"male",323,288,225,291,45,291,40,0,5
1559455,53,8,1960,10,"male",1980,30,15,0,0,0,0,0,0
1559457,20,2,1993,11,"male",525,274,249,20,3,20,3,0,0
1559499,28,23,1985,10,"male",413,77,53,2,2,2,2,0,0
1559510,79,23,1934,8,"female",1260,22,13,23,1,0,0,23,1
1559565,21,25,1992,2,"male",834,173,93,0,0,0,0,0,0
1559579,45,17,1968,10,"male",96,8,5,1,1,1,0,0,1
1559586,39,10,1974,7,"female",255,35,11,1,3,0,0,1,3
1559650,17,26,1996,8,"male",549,197,133,134,231,17,141,117,90
1559659,70,4,1943,11,"male",1625,84,24,20,17,20,16,0,1
1559661,41,4,1972,2,"male",684,1,1,0,0,0,0,0,0
1559663,56,5,1957,9,"male",117,15,8,1,0,1,0,0,0
1559683,22,16,1991,6,"male",895,54,2,0,7,0,7,0,0
1559685,23,14,1990,8,"male",127,105,102,5,2,5,2,0,0
1559713,45,27,1968,11,"male",1506,127,59,0,0,0,0,0,0
1559738,14,28,1999,8,"female",255,436,106,27,12,27,6,0,6
1559755,61,28,1952,4,"female",1804,209,169,511,174,360,123,151,51
1559768,18,23,1995,2,"male",566,121,88,0,0,0,0,0,0
1559778,31,30,1982,9,"female",268,46,32,42,41,23,27,19,14
1559810,76,10,1937,11,"female",569,59,34,488,77,488,72,0,5
1559815,27,14,1986,2,"male",299,465,406,139,163,139,145,0,18
1559819,56,17,1957,1,"male",688,3,3,0,0,0,0,0,0
1559822,61,23,1952,1,"male",1250,449,385,1,1,1,0,0,1
1559868,20,24,1993,12,"female",262,1716,179,0,4,0,2,0,2
1559877,33,7,1980,7,"male",315,18,11,1,3,0,0,1,3
1559891,16,16,1997,4,"female",503,3630,161,46,380,46,340,0,40
1559892,22,1,1991,1,"male",476,13,6,0,0,0,0,0,0
1559903,16,14,1997,7,"female",238,331,99,58,135,58,87,0,48
1559908,26,5,1987,9,"male",575,93,50,4,16,0,9,4,7
1559947,20,21,1993,3,"male",417,27,22,1,0,1,0,0,0
1559967,23,21,1990,1,"male",507,96,78,1,0,1,0,0,0
1559995,14,24,1999,10,"male",249,708,283,40,81,0,64,40,17
1559996,64,22,1949,9,"male",111,42,37,3,77,3,49,0,28
1559998,28,15,1985,5,"male",607,68,33,4,13,4,12,0,1
1560012,24,20,1989,11,"female",326,22,18,1,0,1,0,0,0
1560045,33,16,1980,4,"female",561,5,4,0,0,0,0,0,0
1560060,43,20,1970,8,"male",300,66,36,93,89,93,64,0,25
1560066,15,24,1998,1,"female",12,15,14,5,23,5,23,0,0
1560091,103,9,1910,3,"female",506,315,72,11,128,6,109,5,19
1560111,15,29,1998,5,"female",190,161,60,0,0,0,0,0,0
1560121,18,27,1995,1,"female",249,165,92,11,36,11,36,0,0
1560123,15,22,1998,5,"male",446,481,447,626,159,267,116,359,43
1560153,21,20,1992,4,"male",8,27,19,0,0,0,0,0,0
1560170,42,1,1971,12,"female",273,37,23,17,9,17,2,0,7
1560178,21,2,1992,11,"female",492,190,97,95,43,59,9,36,34
1560218,46,26,1967,12,"female",312,165,122,125,52,8,8,117,44
1560248,20,22,1993,11,"female",138,292,257,18,2,18,0,0,2
1560274,63,2,1950,10,"female",841,25,12,16,5,0,2,16,3
1560296,56,14,1957,11,"female",1021,63,26,225,40,0,11,225,29
1560318,17,29,1996,11,"male",200,54,26,11,7,11,4,0,3
1560335,21,12,1992,10,"female",655,283,164,64,134,64,114,0,20
1560350,19,6,1994,6,"male",331,360,238,27,89,2,68,25,21
1560355,46,3,1967,9,"female",354,17,16,4,11,0,2,4,9
1560358,23,13,1990,1,"male",494,149,100,22,9,22,4,0,5
1560362,23,23,1990,7,"female",285,55,46,750,693,0,60,750,633
1560380,21,10,1992,1,"male",138,63,42,18,6,18,4,0,2
1560415,58,29,1955,6,"female",24,16,10,9,20,0,18,9,2
1560418,40,12,1973,2,"male",282,9,8,0,0,0,0,0,0
1560499,80,26,1933,5,"female",1942,114,17,22,11,22,8,0,3
1560528,18,15,1995,8,"male",139,58,46,1,0,1,0,0,0
1560561,31,5,1982,6,"female",1191,70,63,1072,1203,1063,932,9,271
1560578,64,16,1949,7,"male",934,70,51,296,51,49,32,247,19
1560582,25,10,1988,9,"male",554,101,81,12,4,12,3,0,1
1560592,31,11,1982,3,"female",279,30,18,26,5,25,1,1,4
1560600,20,6,1993,4,"male",557,93,52,3,75,3,24,0,51
1560601,23,28,1990,9,"male",547,428,234,260,307,260,173,0,134
1560621,25,30,1988,7,"female",550,306,190,238,194,94,22,144,172
1560637,19,9,1994,6,"male",424,173,122,2,1,0,0,2,1
1560659,59,13,1954,9,"male",1115,18,11,0,0,0,0,0,0
1560681,29,9,1984,10,"female",263,2,1,0,0,0,0,0,0
1560683,63,21,1950,7,"female",1795,324,145,615,691,582,510,33,181
1560687,59,25,1954,1,"female",1061,76,47,114,107,111,57,3,50
1560719,19,8,1994,8,"male",202,14,12,3,6,3,1,0,5
1560726,58,4,1955,10,"female",723,17,12,50,11,50,6,0,5
1560765,19,24,1994,6,"female",506,2749,437,106,554,94,415,12,139
1560798,29,8,1984,3,"male",685,162,134,1,0,1,0,0,0
1560799,52,24,1961,7,"female",103,18,16,19,8,0,2,19,6
1560805,20,12,1993,7,"male",68,44,26,0,0,0,0,0,0
1560807,22,1,1991,3,"male",177,18,10,0,0,0,0,0,0
1560837,16,1,1997,11,"female",155,17,9,0,0,0,0,0,0
1560868,35,16,1978,2,"female",213,39,6,0,6,0,4,0,2
1560877,29,4,1984,1,"male",215,66,57,25,14,25,5,0,9
1560906,21,4,1992,2,"male",650,429,290,0,1,0,1,0,0
1560909,28,15,1985,3,"male",801,66,32,0,0,0,0,0,0
1560929,16,27,1997,3,"female",156,54,33,135,32,132,16,3,16
1560938,33,2,1980,1,"male",511,73,61,17,7,5,5,12,2
1560947,16,27,1997,4,"female",899,158,53,76,48,63,16,13,32
1560995,61,26,1952,5,"female",309,62,20,0,0,0,0,0,0
1561004,14,28,1999,11,"female",322,824,531,57,345,56,223,1,122
1561024,65,24,1948,5,"male",418,40,15,0,1,0,1,0,0
1561058,19,17,1994,1,"male",327,66,56,19,8,19,7,0,1
1561090,27,19,1986,9,"male",615,329,185,38,35,29,15,9,20
1561136,36,7,1977,7,"female",365,152,71,1,13,1,10,0,3
1561141,23,4,1990,3,"male",209,78,51,0,0,0,0,0,0
1561166,16,14,1997,12,"female",1336,984,392,239,364,173,294,66,70
1561167,34,12,1979,5,"male",95,34,24,55,26,55,21,0,5
1561230,14,1,1999,1,"female",236,1,0,1,0,1,0,0,0
1561246,30,23,1983,1,"male",203,26,23,36,5,35,3,1,2
1561247,21,22,1992,6,"female",756,238,118,5,1,0,1,5,0
1561258,22,1,1991,12,"male",393,145,106,41,20,41,18,0,2
1561259,55,25,1958,5,"female",458,42,27,1,4,0,0,1,4
1561261,20,8,1993,7,"male",246,85,71,0,0,0,0,0,0
1561263,103,14,1910,11,"female",1693,125,30,4,8,0,0,4,8
1561281,18,8,1995,1,"male",509,4,1,0,0,0,0,0,0
1561283,33,17,1980,3,"male",230,68,54,2,2,0,1,2,1
1561294,93,19,1920,5,"male",1275,152,73,4,1,4,0,0,1
1561297,39,27,1974,12,"female",232,112,59,31,26,31,7,0,19
1561318,58,13,1955,11,"female",5,10,10,0,1,0,1,0,0
1561322,24,22,1989,2,"female",625,122,53,2,8,0,1,2,7
1561327,21,29,1992,2,"female",231,102,65,1,0,1,0,0,0
1561335,16,8,1997,3,"male",301,82,45,175,29,175,15,0,14
1561354,17,27,1996,8,"female",623,760,402,535,491,159,328,376,163
1561374,52,16,1961,9,"female",1386,94,48,250,227,243,171,7,56
1561378,26,15,1987,11,"male",365,17,11,0,14,0,3,0,11
1561404,18,27,1995,4,"female",358,1,1,0,0,0,0,0,0
1561449,35,5,1978,7,"male",615,54,40,0,0,0,0,0,0
1561452,62,17,1951,9,"female",256,185,84,119,15,0,9,119,6
1561465,49,14,1964,11,"male",522,52,44,131,47,0,4,131,43
1561478,68,31,1945,8,"male",1693,92,25,3,0,0,0,3,0
1561485,53,24,1960,4,"male",408,18,12,14,8,9,0,5,8
1561507,38,13,1975,6,"female",501,137,121,2,3,2,3,0,0
1561514,18,29,1995,8,"female",233,145,70,2,0,2,0,0,0
1561540,15,17,1998,3,"female",486,1584,1093,6,3,6,3,0,0
1561544,58,31,1955,1,"female",416,35,31,0,0,0,0,0,0
1561560,50,9,1963,9,"male",768,42,21,6,5,6,4,0,1
1561579,35,3,1978,4,"male",375,34,31,1,14,1,12,0,2
1561584,18,1,1995,10,"male",661,202,112,912,301,912,238,0,63
1561611,19,25,1994,7,"male",409,2053,314,891,2745,514,2296,377,449
1561615,18,22,1995,12,"female",54,1127,122,151,405,62,193,89,212
1561633,46,23,1967,3,"female",402,36,33,12,1,12,1,0,0
1561638,20,10,1993,6,"male",171,218,71,254,882,254,529,0,353
1561644,62,8,1951,6,"female",310,29,14,152,75,0,30,152,45
1561664,22,15,1991,1,"male",443,1142,1056,278,64,278,63,0,1
1561665,50,12,1963,2,"male",1353,190,83,61,20,57,15,4,5
1561685,77,4,1936,10,"male",127,7,5,1,0,1,0,0,0
1561755,83,18,1930,7,"female",834,16,3,12,5,0,1,12,4
1561767,37,11,1976,7,"female",481,1,1,0,0,0,0,0,0
1561770,33,23,1980,7,"male",175,23,23,2,0,2,0,0,0
1561776,17,22,1996,10,"male",206,75,32,53,17,35,8,18,9
1561777,108,27,1905,9,"female",1885,255,121,84,18,20,7,64,11
1561795,22,2,1991,12,"male",192,127,92,12,15,12,6,0,9
1561819,67,23,1946,10,"male",1551,69,47,1,1,0,1,1,0
1561824,25,3,1988,12,"male",67,21,3,1,5,1,1,0,4
1561861,59,30,1954,9,"female",502,27,15,111,55,111,34,0,21
1561880,20,23,1993,10,"male",740,60,42,0,0,0,0,0,0
1561904,19,15,1994,6,"male",619,1049,919,3,25,3,21,0,4
1561922,18,5,1995,7,"male",102,48,29,1,0,1,0,0,0
1561954,18,17,1995,4,"female",510,73,54,253,58,242,33,11,25
1561957,38,17,1975,5,"female",479,23,9,1,4,1,3,0,1
1561959,21,4,1992,3,"female",494,514,202,367,290,349,206,18,84
1561977,102,5,1911,7,"male",1739,198,100,165,54,1,20,164,34
1561980,24,7,1989,11,"male",427,244,223,0,1,0,1,0,0
1561986,64,9,1949,4,"male",615,75,44,74,6,0,2,74,4
1561987,31,5,1982,5,"male",159,27,26,2,8,2,2,0,6
1561989,15,20,1998,11,"female",297,189,110,596,305,596,275,0,30
1562005,27,20,1986,10,"male",54,12,11,34,7,34,3,0,4
1562024,47,12,1966,7,"female",616,27,20,1,0,0,0,1,0
1562026,55,11,1958,10,"female",387,108,96,250,128,7,53,243,75
1562046,50,18,1963,6,"male",671,6,3,4,0,2,0,2,0
1562055,55,23,1958,4,"female",216,53,19,11,107,0,39,11,68
1562056,20,14,1993,2,"male",414,60,54,0,1,0,1,0,0
1562069,36,1,1977,3,"male",296,59,32,244,192,243,152,1,40
1562077,24,27,1989,2,"male",299,68,45,15,3,15,3,0,0
1562083,33,29,1980,11,"female",208,25,5,89,43,89,21,0,22
1562100,15,3,1998,5,"male",1042,1266,905,5022,6168,3053,3000,1969,3168
1562126,26,15,1987,10,"female",1003,307,159,82,76,82,48,0,28
1562131,31,20,1982,4,"female",599,30,12,12,25,0,3,12,22
1562132,18,19,1995,4,"male",798,2156,392,64,132,64,99,0,33
1562152,41,16,1972,2,"male",528,160,101,53,14,0,6,53,8
1562188,56,18,1957,4,"male",180,68,55,14,9,14,7,0,2
1562190,17,1,1996,10,"female",579,94,51,18,15,10,7,8,8
1562244,26,30,1987,8,"male",228,1,1,10,2,3,0,7,2
1562267,30,10,1983,8,"male",350,302,249,98,37,31,25,67,12
1562275,25,1,1988,1,"male",22,0,0,0,0,0,0,0,0
1562312,29,21,1984,12,"male",18,55,53,10,14,10,10,0,4
1562318,26,7,1987,3,"male",263,40,40,31,12,31,8,0,4
1562335,38,2,1975,8,"female",274,6,3,0,0,0,0,0,0
1562347,58,6,1955,9,"female",2306,98,56,80,65,26,44,54,21
1562348,103,18,1910,7,"female",1273,187,112,24,125,24,113,0,12
1562358,34,28,1979,8,"male",358,119,92,1,2,1,2,0,0
1562402,23,1,1990,8,"male",245,232,114,7,5,7,3,0,2
1562419,46,29,1967,6,"female",155,108,45,45,40,41,17,4,23
1562425,17,5,1996,12,"male",1170,112,45,16,4,1,1,15,3
1562451,23,11,1990,8,"female",86,39,33,0,0,0,0,0,0
1562454,24,25,1989,3,"male",340,7,3,25,2,25,2,0,0
1562473,25,21,1988,4,"male",421,40,25,0,0,0,0,0,0
1562474,20,30,1993,11,"male",445,237,149,0,0,0,0,0,0
1562476,19,12,1994,11,"male",17,1,1,0,0,0,0,0,0
1562478,35,16,1978,9,"male",156,7,5,0,0,0,0,0,0
1562554,69,26,1944,4,"female",1543,119,69,190,103,40,25,150,78
1562559,30,17,1983,1,"female",678,89,78,6,5,4,1,2,4
1562567,103,17,1910,4,"female",532,126,94,23,16,23,15,0,1
1562580,18,30,1995,3,"female",888,287,173,456,124,456,73,0,51
1562588,20,21,1993,1,"male",243,211,177,0,0,0,0,0,0
1562606,17,7,1996,7,"male",156,61,36,7,17,7,11,0,6
1562624,53,17,1960,12,"male",582,2,2,8,6,6,4,2,2
1562677,47,5,1966,6,"male",581,173,63,14,8,14,3,0,5
1562679,25,1,1988,1,"male",351,135,50,54,65,54,63,0,2
1562695,18,16,1995,6,"male",708,304,196,79,48,79,38,0,10
1562712,51,19,1962,5,"male",2043,108,31,31,12,31,12,0,0
1562758,18,16,1995,1,"male",182,250,169,25,37,1,25,24,12
1562768,15,11,1998,1,"male",25,0,0,0,0,0,0,0,0
1562828,18,13,1995,6,"female",1103,4021,1325,2067,1028,883,540,1184,488
1562830,27,26,1986,8,"male",821,0,0,3,0,0,0,3,0
1562842,23,5,1990,6,"male",410,140,118,28,4,28,4,0,0
1562849,101,10,1912,10,"female",716,119,42,135,115,135,103,0,12
1562871,15,30,1998,9,"female",43,4,3,1,1,1,0,0,1
1562890,24,19,1989,6,"male",73,1,1,0,0,0,0,0,0
1562934,27,10,1986,12,"male",355,1,1,5,1,2,1,3,0
1562945,80,18,1933,2,"female",809,3,3,5,0,0,0,5,0
1562979,25,28,1988,5,"male",450,506,421,52,62,52,39,0,23
1562980,53,20,1960,5,"female",768,84,53,23,11,11,1,12,10
1563011,55,17,1958,4,"female",760,85,30,0,0,0,0,0,0
1563021,29,10,1984,7,"male",628,272,213,2,1,0,0,2,1
1563033,18,2,1995,3,"female",375,1124,336,1898,426,1089,307,809,119
1563036,20,23,1993,10,"female",175,1,1,6,15,6,15,0,0
1563059,44,8,1969,11,"male",13,266,82,1188,1342,376,901,812,441
1563086,16,2,1997,10,"female",621,482,94,59,118,59,111,0,7
1563106,47,12,1966,5,"female",125,53,43,56,8,56,5,0,3
1563123,38,6,1975,12,"female",483,60,15,1003,1509,16,161,987,1348
1563134,23,27,1990,5,"male",157,81,71,0,0,0,0,0,0
1563150,108,8,1905,11,"male",1587,278,179,185,245,185,217,0,28
1563198,24,23,1989,5,"male",527,23,17,0,2,0,1,0,1
1563219,15,16,1998,4,"female",349,294,148,18,14,18,12,0,2
1563289,23,24,1990,9,"female",481,77,51,0,0,0,0,0,0
1563313,22,12,1991,9,"male",1163,279,103,0,0,0,0,0,0
1563320,17,20,1996,9,"male",1151,487,410,3,48,0,20,3,28
1563335,55,19,1958,10,"female",289,1,0,1,0,1,0,0,0
1563361,19,29,1994,4,"female",155,115,94,295,154,281,118,14,36
1563370,108,17,1905,3,"female",1043,94,28,7,19,0,13,7,6
1563397,19,18,1994,8,"male",273,54,26,64,66,41,42,23,24
1563418,108,31,1905,12,"male",9,435,423,321,114,3,79,318,35
1563441,36,30,1977,11,"male",620,16,11,0,3,0,3,0,0
1563449,15,7,1998,9,"female",190,351,158,105,147,46,40,59,107
1563456,18,24,1995,2,"female",276,85,41,202,169,135,92,67,77
1563475,108,30,1905,1,"male",1771,759,131,105,191,92,147,13,44
1563477,23,29,1990,7,"male",257,183,139,0,0,0,0,0,0
1563512,26,1,1987,1,"male",385,97,66,0,0,0,0,0,0
1563518,53,7,1960,4,"female",174,5,4,25,122,24,117,1,5
1563598,45,22,1968,5,"male",324,37,34,139,65,0,47,139,18
1563599,111,2,1902,6,"female",1576,109,56,244,459,5,297,239,162
1563609,48,4,1965,10,"male",197,5,5,12,41,0,3,12,38
1563615,93,23,1920,7,"male",945,411,273,66,82,66,75,0,7
1563677,47,25,1966,12,"male",377,42,23,516,96,516,79,0,17
1563687,65,10,1948,12,"female",988,55,38,17,5,17,5,0,0
1563701,55,28,1958,10,"female",1395,375,240,765,440,465,182,300,258
1563707,61,3,1952,12,"female",1557,63,38,9,2,9,2,0,0
1563714,32,15,1981,12,"male",612,31,18,0,0,0,0,0,0
1563743,23,6,1990,3,"male",12,44,39,107,25,107,17,0,8
1563762,15,1,1998,1,"female",348,56,2,58,0,21,0,37,0
1563815,14,29,1999,12,"female",14,1,0,2,0,2,0,0,0
1563853,17,1,1996,2,"male",49,22,11,70,39,70,32,0,7
1563920,18,1,1995,12,"female",351,294,107,883,2326,241,565,642,1761
1563945,18,8,1995,5,"male",357,76,57,4,6,4,6,0,0
1563972,20,22,1993,6,"male",355,15,6,0,3,0,3,0,0
1563975,56,25,1957,8,"female",274,83,50,25,348,25,107,0,241
1563984,16,13,1997,2,"male",322,6,4,0,9,0,9,0,0
1564008,28,21,1985,5,"male",772,41,21,185,71,185,66,0,5
1564041,62,19,1951,10,"male",23,11,5,2,7,0,0,2,7
1564047,19,20,1994,1,"female",776,371,158,542,404,341,178,201,226
1564056,39,1,1974,1,"male",592,1,0,0,0,0,0,0,0
1564065,24,20,1989,2,"female",188,48,28,1,8,1,7,0,1
1564068,33,11,1980,4,"male",835,12,12,18,0,0,0,18,0
1564113,44,14,1969,8,"female",500,74,50,100,71,100,30,0,41
1564144,29,2,1984,8,"female",583,43,25,0,0,0,0,0,0
1564158,28,31,1985,3,"female",97,71,70,82,106,38,52,44,54
1564166,25,21,1988,8,"male",199,177,143,2,14,2,13,0,1
1564172,23,18,1990,9,"male",341,37,18,0,0,0,0,0,0
1564184,70,23,1943,11,"male",1206,27,4,3,6,2,2,1,4
1564187,59,10,1954,10,"female",845,23,8,10,43,0,19,10,24
1564189,18,9,1995,2,"female",538,571,269,242,184,242,117,0,67
1564231,20,15,1993,9,"female",631,354,198,12,6,12,5,0,1
1564243,22,4,1991,4,"male",564,25,4,0,0,0,0,0,0
1564249,16,7,1997,5,"male",917,160,126,998,422,440,266,558,156
1564266,45,1,1968,7,"male",494,11,11,0,1,0,0,0,1
1564292,66,13,1947,2,"male",419,33,17,3,7,0,0,3,7
1564294,43,15,1970,1,"male",175,18,17,0,2,0,0,0,2
1564331,20,23,1993,8,"female",269,48,33,883,453,75,169,808,284
1564344,27,15,1986,5,"female",410,191,144,15,99,13,38,2,61
1564365,46,27,1967,1,"female",458,248,115,445,562,137,246,308,316
1564390,49,11,1964,1,"female",1911,106,38,131,220,118,171,13,49
1564398,18,29,1995,5,"male",662,120,87,23,59,23,21,0,38
1564438,17,4,1996,3,"male",393,638,537,2,0,2,0,0,0
1564467,16,9,1997,8,"male",256,24,18,70,25,32,7,38,18
1564471,41,1,1972,11,"female",631,16,12,94,7,94,7,0,0
1564490,105,23,1908,8,"female",2237,685,388,162,21,0,12,162,9
1564531,31,10,1982,6,"male",478,16,11,0,0,0,0,0,0
1564549,23,2,1990,2,"male",500,10,7,0,0,0,0,0,0
1564551,29,17,1984,8,"male",637,312,242,0,1,0,1,0,0
1564558,113,20,1900,6,"male",1522,450,287,55,2,0,0,55,2
1564560,16,21,1997,6,"female",426,3282,426,1872,5435,353,2595,1519,2840
1564570,18,23,1995,6,"female",412,612,360,418,1008,239,452,179,556
1564597,108,13,1905,9,"male",590,141,21,88,34,88,27,0,7
1564602,103,14,1910,10,"male",831,414,84,27,31,27,31,0,0
1564612,43,21,1970,1,"female",498,19,7,0,1,0,0,0,1
1564615,45,20,1968,9,"female",1494,29,4,3,28,0,20,3,8
1564630,56,12,1957,10,"male",962,7,5,0,0,0,0,0,0
1564674,50,31,1963,1,"male",442,72,15,136,80,0,27,136,53
1564678,24,8,1989,5,"male",166,54,23,1,7,0,0,1,7
1564685,20,7,1993,7,"male",310,69,42,13,1,13,0,0,1
1564703,20,20,1993,8,"female",679,1780,806,395,1268,373,610,22,658
1564743,32,1,1981,11,"male",805,26,25,0,0,0,0,0,0
1564749,63,7,1950,7,"female",82,130,74,99,48,0,7,99,41
1564784,73,27,1940,4,"female",715,52,30,33,14,33,3,0,11
1564793,34,22,1979,2,"male",572,26,16,1,0,1,0,0,0
1564808,54,4,1959,9,"male",658,13,6,1,3,0,0,1,3
1564821,18,20,1995,2,"male",46,27,26,9,3,9,2,0,1
1564838,27,13,1986,3,"female",228,19,13,11,10,11,10,0,0
1564840,26,10,1987,9,"male",153,56,26,3,0,3,0,0,0
1564841,20,29,1993,10,"female",177,69,30,19,16,19,10,0,6
1564844,23,18,1990,9,"female",170,39,23,39,50,39,15,0,35
1564855,19,22,1994,1,"male",398,6,5,94,2,0,0,94,2
1564859,19,14,1994,11,"male",31,55,51,93,3,93,3,0,0
1564860,26,24,1987,3,"female",1408,343,182,443,253,443,167,0,86
1564897,24,1,1989,11,"male",503,29,12,2,0,2,0,0,0
1564918,19,19,1994,5,"male",379,99,56,42,16,42,16,0,0
1564919,18,26,1995,2,"male",114,238,197,14,11,14,7,0,4
1564938,28,19,1985,4,"male",405,68,46,0,8,0,4,0,4
1564971,95,29,1918,12,NA,2228,830,383,413,506,0,243,413,263
1564980,59,15,1954,6,"female",101,53,45,38,2,0,1,38,1
1564988,58,5,1955,9,"female",553,67,55,33,6,20,5,13,1
1564990,42,20,1971,10,"male",240,3,1,1,0,1,0,0,0
1564997,26,1,1987,1,"male",332,104,91,23,18,17,14,6,4
1565046,31,8,1982,1,"female",481,204,95,38,27,0,7,38,20
1565062,17,14,1996,11,"male",351,110,7,0,0,0,0,0,0
1565067,18,6,1995,3,"female",448,364,178,2164,324,533,199,1631,125
1565094,113,20,1900,6,"male",1895,2417,1397,360,140,114,98,246,42
1565123,17,12,1996,11,"male",101,54,46,3,3,0,3,3,0
1565140,39,7,1974,3,"male",1546,48,13,28,10,24,10,4,0
1565173,26,7,1987,12,"male",342,149,100,2,17,0,2,2,15
1565175,48,27,1965,4,"male",655,109,27,3,15,3,6,0,9
1565182,50,6,1963,12,"female",441,336,275,368,23,368,12,0,11
1565199,22,14,1991,9,"male",698,335,282,222,277,222,257,0,20
1565210,26,17,1987,2,"male",72,35,34,11,0,11,0,0,0
1565216,45,14,1968,5,"female",219,42,30,23,12,23,3,0,9
1565251,62,30,1951,1,"female",119,86,74,1,3,0,1,1,2
1565261,22,26,1991,10,"female",644,95,38,0,0,0,0,0,0
1565262,34,21,1979,4,"male",798,173,123,6,16,6,14,0,2
1565284,26,11,1987,4,"male",395,133,113,0,0,0,0,0,0
1565321,71,31,1942,10,"female",41,43,16,53,14,0,8,53,6
1565343,33,10,1980,9,"male",189,13,4,0,0,0,0,0,0
1565419,15,18,1998,6,"male",327,151,147,6,2,0,0,6,2
1565435,103,24,1910,11,"male",1487,893,487,164,218,48,91,116,127
1565439,39,17,1974,10,"female",355,32,16,0,0,0,0,0,0
1565454,19,24,1994,5,"male",46,15,9,26,11,26,11,0,0
1565507,103,10,1910,11,"male",142,6,3,0,0,0,0,0,0
1565508,19,24,1994,6,"male",251,184,140,8,15,8,15,0,0
1565515,15,26,1998,6,"female",236,119,81,27,9,27,9,0,0
1565520,18,5,1995,11,"female",93,157,68,52,5,12,1,40,4
1565523,18,1,1995,1,"male",279,255,167,27,285,13,102,14,183
1565534,27,10,1986,3,"male",484,123,78,14,18,14,5,0,13
1565544,68,13,1945,8,"male",821,288,197,925,392,922,293,3,99
1565549,26,9,1987,3,"male",184,138,123,14,3,14,3,0,0
1565593,18,4,1995,2,"female",431,16,9,107,45,1,3,106,42
1565655,16,20,1997,10,"male",566,942,324,370,221,370,152,0,69
1565659,31,29,1982,9,"male",380,27,14,27,133,27,53,0,80
1565666,15,15,1998,1,"female",743,687,518,222,61,221,50,1,11
1565674,29,10,1984,9,"female",212,37,33,0,0,0,0,0,0
1565677,34,25,1979,1,"male",427,109,30,9,31,9,20,0,11
1565690,18,28,1995,12,"male",62,33,30,9,0,0,0,9,0
1565729,103,5,1910,5,"male",1498,4717,1219,6,249,6,181,0,68
1565736,42,5,1971,1,"female",269,2,0,0,0,0,0,0,0
1565741,59,12,1954,8,"female",1589,170,99,177,95,177,74,0,21
1565753,47,28,1966,4,"male",2166,22,13,57,86,57,80,0,6
1565765,60,11,1953,6,"female",646,12,10,0,0,0,0,0,0
1565808,33,22,1980,7,"male",17,9,7,0,0,0,0,0,0
1565824,15,2,1998,8,"female",503,1110,658,123,563,123,428,0,135
1565856,40,26,1973,10,"male",137,108,94,95,0,95,0,0,0
1565885,17,16,1996,5,"male",449,496,426,112,13,112,13,0,0
1565886,16,19,1997,11,"male",191,211,18,0,2,0,2,0,0
1565892,42,17,1971,6,"male",274,38,22,3,0,3,0,0,0
1565904,77,25,1936,8,"female",515,28,7,31,27,0,6,31,21
1565907,27,26,1986,9,"male",742,187,87,120,74,113,31,7,43
1565912,17,5,1996,5,"female",17,35,32,2,10,2,6,0,4
1565919,18,27,1995,11,"male",479,345,244,112,41,104,36,8,5
1565930,108,21,1905,4,"male",1030,384,168,9,45,6,34,3,11
1565968,25,18,1988,9,"female",426,5,3,1,0,0,0,1,0
1565977,35,10,1978,11,"male",198,3,1,0,1,0,1,0,0
1565995,28,11,1985,7,"male",502,423,367,5,2,5,2,0,0
1565999,31,20,1982,2,"male",140,25,22,2,26,1,19,1,7
1566048,17,4,1996,2,"male",335,28,25,0,0,0,0,0,0
1566086,46,26,1967,3,"male",211,32,21,49,29,20,17,29,12
1566127,25,14,1988,12,"male",7,132,129,4,0,4,0,0,0
1566131,22,26,1991,9,"male",394,75,40,625,160,299,103,326,57
1566150,38,6,1975,5,"male",659,71,24,4,6,4,3,0,3
1566185,17,10,1996,7,"female",94,506,355,78,273,78,201,0,72
1566196,35,16,1978,6,"female",541,41,24,0,1,0,1,0,0
1566197,33,8,1980,2,"female",590,73,52,0,0,0,0,0,0
1566206,35,29,1978,4,"male",51,16,15,0,0,0,0,0,0
1566222,32,1,1981,12,"male",192,3,3,0,0,0,0,0,0
1566225,19,9,1994,1,"male",545,24,18,390,72,383,42,7,30
1566249,39,7,1974,12,"female",457,50,39,18,1,18,1,0,0
1566273,21,2,1992,4,"male",196,774,546,610,550,595,343,15,207
1566284,86,6,1927,3,"female",1804,142,90,22,60,0,42,22,18
1566300,14,17,1999,10,"male",84,0,0,0,0,0,0,0,0
1566310,16,3,1997,5,"male",400,439,313,1,9,1,8,0,1
1566316,23,23,1990,12,"male",379,68,40,89,21,89,13,0,8
1566335,17,14,1996,2,"male",70,78,69,0,0,0,0,0,0
1566361,15,30,1998,8,"male",177,691,51,9804,3763,9321,1758,483,2005
1566368,47,16,1966,11,"male",948,4,4,10,3,0,0,10,3
1566380,18,2,1995,6,"male",925,366,170,37,102,18,64,19,38
1566410,73,5,1940,10,"female",761,15,11,0,0,0,0,0,0
1566439,28,1,1985,6,"male",262,122,52,16,5,0,0,16,5
1566441,24,25,1989,6,"male",688,282,213,11,7,11,3,0,4
1566460,102,1,1911,1,"male",1820,1,0,0,0,0,0,0,0
1566478,36,17,1977,10,"male",52,15,13,55,28,39,26,16,2
1566484,19,18,1994,3,"female",37,214,47,49,121,49,108,0,13
1566502,59,1,1954,11,"male",573,230,167,117,6,0,2,117,4
1566522,30,27,1983,9,"male",2214,200,123,169,255,132,183,37,72
1566528,17,19,1996,4,"female",148,549,480,126,17,117,10,9,7
1566531,39,19,1974,3,"male",608,10,4,0,0,0,0,0,0
1566547,32,1,1981,1,"male",163,172,159,1,40,1,30,0,10
1566554,26,10,1987,7,"female",680,261,103,0,0,0,0,0,0
1566569,44,8,1969,2,"female",710,104,77,252,216,185,72,67,144
1566606,52,30,1961,10,"male",643,0,0,0,0,0,0,0,0
1566614,25,14,1988,11,"male",329,242,201,335,58,335,35,0,23
1566623,103,20,1910,10,"male",597,246,135,18,2,3,1,15,1
1566654,15,31,1998,8,"female",503,591,331,343,408,333,127,10,281
1566708,59,14,1954,3,"female",1428,110,86,1066,274,0,97,1066,177
1566719,21,16,1992,6,"female",14,85,73,513,182,0,86,513,96
1566726,74,29,1939,9,"female",317,58,32,577,154,577,128,0,26
1566734,74,22,1939,1,"female",1625,43,25,29,2,29,1,0,1
1566739,71,10,1942,4,"female",551,14,7,0,0,0,0,0,0
1566764,32,19,1981,6,"male",1359,16,6,2,0,2,0,0,0
1566811,27,19,1986,3,"male",1267,291,214,14,11,0,4,14,7
1566814,46,1,1967,1,"female",297,64,46,269,306,269,186,0,120
1566819,23,2,1990,7,"male",457,512,422,0,7,0,1,0,6
1566823,56,14,1957,9,"male",900,112,63,9,0,9,0,0,0
1566866,76,3,1937,9,"female",708,45,17,34,1,0,1,34,0
1566882,41,1,1972,6,"male",2,1,1,64,0,54,0,10,0
1566885,58,28,1955,8,"female",1689,819,565,1669,228,1011,125,658,103
1566900,25,4,1988,10,"female",191,52,20,139,13,33,4,106,9
1566926,23,11,1990,3,"male",138,42,38,37,9,4,8,33,1
1566931,28,26,1985,2,"female",497,52,28,79,10,63,4,16,6
1566949,28,28,1985,7,"male",690,207,161,1,9,1,8,0,1
1566967,33,2,1980,2,"male",73,98,58,196,95,196,80,0,15
1566982,23,13,1990,2,"male",197,150,140,0,0,0,0,0,0
1566988,31,10,1982,8,"female",369,221,124,90,35,90,28,0,7
1567006,38,20,1975,1,"female",607,1028,308,30,98,30,31,0,67
1567015,58,13,1955,4,"female",411,36,22,337,75,337,20,0,55
1567061,53,10,1960,9,"male",206,18,5,0,2,0,1,0,1
1567071,21,31,1992,10,"male",311,210,71,31,22,27,19,4,3
1567139,18,27,1995,8,"male",11,30,28,90,2,51,1,39,1
1567161,33,18,1980,3,"male",37,26,13,1,0,1,0,0,0
1567165,65,7,1948,8,"male",1577,37,8,10,18,2,4,8,14
1567176,64,4,1949,2,"female",117,27,16,4,7,0,7,4,0
1567223,23,14,1990,11,"female",121,44,34,32,30,21,7,11,23
1567225,28,10,1985,10,"female",1041,235,94,278,55,278,24,0,31
1567230,21,2,1992,3,"male",411,182,159,0,0,0,0,0,0
1567231,21,25,1992,5,"male",543,1017,791,19,76,19,58,0,18
1567233,24,9,1989,12,"male",523,1,0,0,0,0,0,0,0
1567248,48,16,1965,9,"female",734,296,105,79,285,79,252,0,33
1567249,13,21,2000,2,"female",120,238,58,20,77,20,44,0,33
1567251,37,14,1976,8,"male",360,281,115,6,8,0,0,6,8
1567256,26,29,1987,11,"female",205,41,17,2,3,2,3,0,0
1567259,22,1,1991,4,"male",430,1267,1149,13,28,13,25,0,3
1567261,108,14,1905,9,"male",1524,112,90,3,1,0,0,3,1
1567262,23,10,1990,11,"male",70,19,17,1,0,0,0,1,0
1567273,67,2,1946,10,"male",1479,259,143,9,217,8,41,1,176
1567292,28,1,1985,6,"male",314,36,35,9,0,9,0,0,0
1567294,25,15,1988,5,"male",541,72,30,1,0,1,0,0,0
1567298,21,7,1992,6,"male",409,354,258,11,20,4,7,7,13
1567325,24,28,1989,11,"female",191,132,115,74,19,72,10,2,9
1567375,30,9,1983,5,"male",1706,43,16,55,479,48,304,7,175
1567376,16,1,1997,1,"male",215,532,473,31,56,25,29,6,27
1567420,23,11,1990,4,"female",447,106,72,14,1,8,0,6,1
1567455,67,13,1946,8,"female",115,27,16,0,0,0,0,0,0
1567534,24,10,1989,7,"female",312,35,16,0,3,0,3,0,0
1567558,32,31,1981,12,"male",366,74,30,40,2,40,2,0,0
1567562,17,9,1996,8,"male",395,162,96,435,12,435,11,0,1
1567570,16,17,1997,2,"male",345,31,28,0,0,0,0,0,0
1567582,23,6,1990,12,"male",649,2,2,1,0,1,0,0,0
1567598,23,16,1990,2,"female",338,1289,897,4005,983,3946,698,59,285
1567628,30,16,1983,10,"male",422,106,58,1,1,0,0,1,1
1567648,58,15,1955,7,"female",159,185,88,595,286,595,115,0,171
1567686,20,5,1993,3,"female",373,214,181,119,57,119,10,0,47
1567754,37,28,1976,12,"male",1433,40,5,103,143,42,97,61,46
1567756,20,11,1993,2,"male",468,45,22,0,2,0,1,0,1
1567786,30,26,1983,9,"male",427,448,208,297,126,291,86,6,40
1567791,38,5,1975,6,"male",974,96,52,27,34,7,18,20,16
1567792,66,21,1947,10,"male",313,589,187,678,850,1,240,677,610
1567857,108,1,1905,1,"male",1098,65,38,22,13,0,5,22,8
1567899,23,6,1990,6,"female",650,374,197,114,265,114,245,0,20
1567907,30,27,1983,7,"male",747,36,34,146,15,146,14,0,1
1567917,83,18,1930,5,"female",2279,381,210,71,18,71,12,0,6
1567920,49,15,1964,7,"male",479,50,31,3,0,2,0,1,0
1567934,56,1,1957,1,"male",128,26,26,0,0,0,0,0,0
1567935,21,28,1992,7,"male",436,104,61,4,1,4,0,0,1
1567955,68,16,1945,9,"female",1761,186,40,17,527,0,269,17,258
1568004,65,13,1948,2,"male",900,34,18,11,12,11,6,0,6
1568015,29,6,1984,11,"male",288,82,51,3,11,3,11,0,0
1568016,54,31,1959,8,"male",662,29,24,8,22,8,10,0,12
1568024,15,16,1998,3,"female",398,103,62,3,0,0,0,3,0
1568056,22,8,1991,11,"female",702,277,106,815,1042,631,388,184,654
1568059,29,12,1984,9,"male",557,464,396,167,143,144,133,23,10
1568080,58,30,1955,6,"male",1441,141,95,90,64,90,56,0,8
1568167,17,25,1996,10,"male",42,56,43,144,21,144,19,0,2
1568181,62,5,1951,9,"female",502,122,57,47,109,47,66,0,43
1568207,16,25,1997,10,"female",115,226,101,78,67,78,51,0,16
1568211,23,28,1990,12,"male",259,73,39,174,19,174,15,0,4
1568218,27,12,1986,8,"male",494,243,200,19,5,19,4,0,1
1568229,63,7,1950,8,"male",944,3,1,0,0,0,0,0,0
1568235,47,10,1966,10,"female",380,33,12,2,0,0,0,2,0
1568238,53,21,1960,2,"male",438,35,5,2,39,1,32,1,7
1568250,36,15,1977,1,"female",388,8,7,0,0,0,0,0,0
1568282,22,18,1991,9,"female",169,258,188,482,423,482,366,0,57
1568300,101,7,1912,6,"female",512,13,9,4,23,0,9,4,14
1568305,30,20,1983,4,"male",642,13,4,7,1,7,0,0,1
1568313,39,27,1974,7,"male",664,65,41,1,0,1,0,0,0
1568321,19,21,1994,3,"male",1689,683,230,2,0,2,0,0,0
1568326,103,31,1910,3,"female",1536,496,365,8,2,0,1,8,1
1568332,23,27,1990,2,"female",938,182,77,31,5,22,3,9,2
1568400,108,1,1905,11,"female",182,27,22,3,15,3,4,0,11
1568404,17,19,1996,9,"female",507,82,22,26,3,10,1,16,2
1568412,16,25,1997,12,"female",131,173,107,23,92,2,20,21,72
1568477,52,14,1961,9,"female",149,62,25,14,44,0,2,14,42
1568493,25,27,1988,11,"male",607,55,49,1,0,1,0,0,0
1568501,79,1,1934,8,"male",1835,42,12,0,0,0,0,0,0
1568538,20,25,1993,10,"male",247,86,49,54,42,42,37,12,5
1568561,17,11,1996,7,"female",131,5,3,1,1,0,0,1,1
1568576,36,15,1977,10,"female",267,18,10,3,3,3,1,0,2
1568632,15,26,1998,5,"male",86,123,90,46,22,46,14,0,8
1568633,38,13,1975,4,"female",426,16,7,0,1,0,0,0,1
1568646,53,3,1960,4,"male",415,53,42,8,2,0,0,8,2
1568651,20,26,1993,3,"female",417,39,24,4117,169,10,42,4107,127
1568680,108,14,1905,6,"male",972,66,31,3,52,0,26,3,26
1568681,43,27,1970,4,"female",248,187,97,29,370,29,300,0,70
1568707,37,4,1976,5,"female",257,56,27,256,41,256,19,0,22
1568790,61,23,1952,11,"male",996,279,214,0,0,0,0,0,0
1568823,25,24,1988,10,"male",93,39,38,1,0,1,0,0,0
1568839,31,20,1982,5,"male",112,38,34,0,0,0,0,0,0
1568843,29,1,1984,1,"male",153,37,33,0,0,0,0,0,0
1568871,108,1,1905,12,"male",396,334,271,369,64,369,63,0,1
1568897,51,24,1962,6,"male",501,120,62,102,20,78,4,24,16
1568914,19,27,1994,3,"male",327,260,205,9,19,9,16,0,3
1568915,23,1,1990,1,"male",394,553,453,1421,281,24,210,1397,71
1568926,18,13,1995,5,"male",215,84,36,0,0,0,0,0,0
1568954,23,17,1990,8,"female",453,18,11,50,1,49,0,1,1
1568956,14,21,1999,6,"female",202,81,32,560,427,560,294,0,133
1568960,16,15,1997,4,"female",669,4337,1422,22,179,22,93,0,86
1568986,108,18,1905,12,"male",491,379,286,25,31,25,29,0,2
1569003,24,25,1989,11,"male",379,245,174,0,2,0,2,0,0
1569006,13,19,2000,7,"male",1,6,1,12,29,0,0,12,29
1569007,26,1,1987,6,"male",258,31,24,0,0,0,0,0,0
1569010,30,9,1983,8,"male",93,71,60,14,0,14,0,0,0
1569052,33,22,1980,10,"male",408,97,76,0,0,0,0,0,0
1569054,27,26,1986,1,"male",434,41,24,2,8,2,8,0,0
1569059,71,22,1942,12,"female",453,40,30,17,15,0,6,17,9
1569081,19,15,1994,11,"male",345,69,40,13,0,0,0,13,0
1569093,106,21,1907,9,"male",1721,922,522,174,124,140,109,34,15
1569110,36,1,1977,1,"male",167,47,43,0,0,0,0,0,0
1569114,39,3,1974,11,"male",193,14,8,1,0,0,0,1,0
1569116,21,31,1992,12,"male",458,15,10,0,0,0,0,0,0
1569126,31,2,1982,2,"male",32,0,0,0,0,0,0,0,0
1569151,44,21,1969,12,"male",811,23,7,6,10,6,2,0,8
1569155,23,12,1990,5,"female",395,163,58,532,257,456,177,76,80
1569176,40,6,1973,9,"male",339,7,3,0,1,0,1,0,0
1569187,18,9,1995,2,"female",332,416,115,87,357,87,196,0,161
1569188,57,16,1956,4,"female",1032,414,292,361,109,7,30,354,79
1569228,20,8,1993,1,"male",59,21,19,36,21,36,9,0,12
1569321,57,21,1956,10,"female",162,77,66,86,114,0,12,86,102
1569326,15,17,1998,5,"female",296,756,353,1944,702,1424,377,520,325
1569359,33,4,1980,4,"male",62,137,68,52,119,33,112,19,7
1569396,48,14,1965,5,"female",1551,53,27,657,150,590,84,67,66
1569419,104,19,1909,2,"female",241,138,78,255,403,255,293,0,110
1569420,25,18,1988,8,"male",176,160,155,1,0,1,0,0,0
1569423,28,12,1985,1,"male",366,18,16,227,2,172,2,55,0
1569438,26,30,1987,7,"male",270,147,93,332,655,332,554,0,101
1569441,17,5,1996,7,"male",111,20,2,5,15,5,5,0,10
1569446,30,13,1983,6,"female",453,212,53,41,226,24,148,17,78
1569447,29,8,1984,6,"male",528,423,280,5,30,5,22,0,8
1569448,33,7,1980,11,"male",1063,94,40,4,2,0,0,4,2
1569459,64,14,1949,9,"female",503,57,24,39,54,39,44,0,10
1569468,33,29,1980,3,"female",490,38,9,49,1,49,1,0,0
1569498,23,25,1990,11,"female",31,65,51,256,339,177,66,79,273
1569542,18,15,1995,5,"male",140,122,28,38,57,35,50,3,7
1569552,26,1,1987,5,"male",654,39,29,0,0,0,0,0,0
1569592,58,7,1955,7,"male",107,28,16,0,0,0,0,0,0
1569604,82,30,1931,7,"female",836,63,16,12,27,10,22,2,5
1569606,39,24,1974,9,"male",503,18,10,1,0,1,0,0,0
1569610,31,18,1982,9,"female",695,48,41,467,61,459,50,8,11
1569630,66,25,1947,2,"female",509,36,28,2,3,0,1,2,2
1569648,24,1,1989,1,"male",420,103,80,219,142,219,139,0,3
1569650,17,16,1996,10,"female",213,302,38,38,66,38,9,0,57
1569655,19,20,1994,9,"male",732,76,45,7,1,6,1,1,0
1569669,27,11,1986,6,"male",216,85,76,2,8,2,6,0,2
1569679,45,6,1968,8,"male",378,130,103,76,73,76,48,0,25
1569683,24,13,1989,12,"female",36,135,134,0,0,0,0,0,0
1569738,29,15,1984,6,"male",404,82,36,0,19,0,13,0,6
1569782,23,1,1990,1,"male",180,32,9,0,0,0,0,0,0
1569787,23,1,1990,5,"male",413,0,0,0,0,0,0,0,0
1569796,17,2,1996,8,"female",309,98,39,11,9,11,9,0,0
1569797,17,9,1996,11,"male",245,114,92,0,0,0,0,0,0
1569802,15,12,1998,9,"female",1349,1556,624,2055,5115,321,3222,1734,1893
1569809,19,1,1994,7,"male",323,13,9,0,0,0,0,0,0
1569814,27,20,1986,9,"male",131,25,22,23,20,23,18,0,2
1569818,42,14,1971,5,"female",116,40,27,69,89,14,21,55,68
1569828,19,26,1994,8,"male",832,375,263,49,11,47,6,2,5
1569843,20,18,1993,3,"male",205,292,197,487,55,6,26,481,29
1569844,47,29,1966,5,"male",705,8,4,0,0,0,0,0,0
1569845,48,12,1965,7,"male",994,14,9,0,0,0,0,0,0
1569850,48,22,1965,9,"male",1316,436,197,18,106,14,49,4,57
1569867,34,18,1979,5,"male",554,71,52,0,0,0,0,0,0
1569880,32,3,1981,10,"female",247,264,191,9,47,8,25,1,22
1569887,23,10,1990,3,"male",560,71,53,54,11,54,11,0,0
1569907,23,10,1990,2,"male",352,5,2,30,9,29,5,1,4
1569917,48,4,1965,12,"female",355,29,20,4,0,4,0,0,0
1569957,68,28,1945,3,"male",732,873,289,278,470,2,194,276,276
1569976,27,10,1986,2,"male",172,14,8,1,6,1,6,0,0
1569986,52,24,1961,11,"male",1012,30,3,2,16,2,12,0,4
1570031,14,8,1999,2,"male",287,426,376,0,0,0,0,0,0
1570062,15,10,1998,8,"male",182,210,162,1,27,1,9,0,18
1570081,57,10,1956,12,"female",254,77,43,441,285,6,150,435,135
1570095,47,16,1966,4,"male",837,91,21,28,25,28,24,0,1
1570096,35,12,1978,10,"female",561,139,106,80,19,80,12,0,7
1570113,23,11,1990,12,"male",430,3,2,0,0,0,0,0,0
1570114,41,6,1972,5,"male",534,2,2,4,4,4,3,0,1
1570143,41,5,1972,2,"male",231,7,7,0,6,0,5,0,1
1570196,17,22,1996,10,"male",151,113,105,5,3,5,1,0,2
1570210,52,1,1961,8,"female",634,4,2,2,0,0,0,2,0
1570242,103,30,1910,3,"female",1378,204,75,15,52,0,10,15,42
1570245,52,13,1961,3,"female",571,50,5,113,23,0,4,113,19
1570246,17,1,1996,10,"male",10,8,8,2,0,2,0,0,0
1570250,108,1,1905,1,"male",24,113,77,3,25,0,11,3,14
1570251,45,23,1968,9,"female",66,56,37,208,87,208,54,0,33
1570280,14,28,1999,1,"male",335,12,2,27,1,27,1,0,0
1570289,18,14,1995,6,"male",104,6,5,2,2,2,1,0,1
1570333,28,31,1985,12,"male",653,36,21,0,1,0,1,0,0
1570360,27,16,1986,4,"female",403,57,27,31,6,21,2,10,4
1570374,30,11,1983,7,"female",377,235,129,84,99,67,24,17,75
1570402,17,1,1996,1,"male",186,106,87,0,1,0,0,0,1
1570414,68,15,1945,3,"female",1190,268,52,0,2,0,2,0,0
1570415,20,15,1993,9,"male",194,196,112,26,0,15,0,11,0
1570478,53,10,1960,6,"female",1484,176,95,226,224,226,105,0,119
1570479,73,17,1940,9,"female",301,94,50,9,7,0,1,9,6
1570497,54,1,1959,1,"female",431,191,100,1,2,0,0,1,2
1570512,43,16,1970,9,"female",47,4,4,43,0,43,0,0,0
1570539,53,28,1960,2,"male",418,6,1,0,0,0,0,0,0
1570555,58,8,1955,1,"male",429,53,28,0,3,0,0,0,3
1570556,51,21,1962,12,"male",631,219,182,1,12,1,6,0,6
1570585,19,9,1994,12,"female",53,261,28,3,123,3,27,0,96
1570603,45,22,1968,10,"female",756,276,237,2852,424,2831,338,21,86
1570630,18,8,1995,7,"male",337,7,5,7,10,7,9,0,1
1570632,62,12,1951,9,"female",270,81,69,6,4,0,0,6,4
1570671,17,1,1996,10,"male",544,230,168,13,7,1,0,12,7
1570677,53,27,1960,5,"female",955,92,30,10,38,0,8,10,30
1570689,40,30,1973,1,"female",290,13,8,8,10,8,10,0,0
1570692,16,17,1997,10,"female",254,1,1,0,0,0,0,0,0
1570704,20,10,1993,3,"female",33,169,67,25,21,25,14,0,7
1570705,18,19,1995,10,"male",136,45,36,5,32,5,13,0,19
1570711,26,10,1987,11,"male",1455,93,45,1,0,0,0,1,0
1570712,26,28,1987,3,"male",299,1113,375,1197,2024,635,1023,562,1001
1570727,52,5,1961,10,"male",302,13,11,2,4,0,2,2,2
1570758,33,1,1980,12,"female",556,208,73,338,127,330,82,8,45
1570765,18,17,1995,2,"female",380,90,68,5,3,5,2,0,1
1570825,19,12,1994,8,"male",353,95,88,10,6,10,3,0,3
1570843,20,16,1993,8,"female",459,328,169,64,146,63,74,1,72
1570847,31,8,1982,9,"female",280,108,64,2,6,2,4,0,2
1570850,16,31,1997,7,"male",120,5,4,1,1,0,1,1,0
1570860,108,21,1905,3,"male",121,22,21,154,45,139,10,15,35
1570865,14,24,1999,12,"female",155,58,48,10,0,10,0,0,0
1570882,51,19,1962,6,"female",1573,58,27,176,96,176,91,0,5
1570913,38,10,1975,8,"female",603,72,40,0,2,0,2,0,0
1570918,15,23,1998,9,"female",372,347,229,107,660,104,412,3,248
1570922,106,21,1907,1,"female",1481,148,78,3,17,0,5,3,12
1570946,31,27,1982,10,"male",74,24,13,48,114,40,34,8,80
1570957,103,1,1910,1,"male",307,127,96,45,59,45,37,0,22
1570970,15,13,1998,8,"male",137,195,167,171,1,171,0,0,1
1570987,21,8,1992,7,"female",340,154,97,89,123,84,91,5,32
1570989,18,3,1995,11,"male",693,62,37,40,10,6,2,34,8
1570999,31,14,1982,12,"female",540,52,25,0,0,0,0,0,0
1571011,17,2,1996,7,"male",413,374,258,33,88,33,50,0,38
1571038,62,30,1951,1,"female",169,1,0,2,0,2,0,0,0
1571050,29,4,1984,12,"male",267,46,16,0,0,0,0,0,0
1571054,51,12,1962,7,"female",200,10,10,3,0,3,0,0,0
1571070,28,9,1985,3,"female",1170,312,158,67,70,67,45,0,25
1571079,15,8,1998,11,"female",310,201,92,87,148,87,7,0,141
1571083,35,1,1978,6,"male",923,113,58,1,1,1,1,0,0
1571106,54,20,1959,7,"female",128,36,34,40,27,40,22,0,5
1571167,95,11,1918,11,"male",1335,791,344,20,61,3,29,17,32
1571168,56,28,1957,4,"female",143,49,37,300,20,0,2,300,18
1571169,37,13,1976,8,"male",194,7,5,7,6,7,4,0,2
1571179,43,25,1970,4,"male",68,7,4,0,0,0,0,0,0
1571191,52,5,1961,7,"male",1549,107,28,44,21,44,18,0,3
1571196,23,29,1990,7,"female",130,47,32,0,0,0,0,0,0
1571269,18,19,1995,5,"male",113,411,388,95,69,0,28,95,41
1571295,32,4,1981,11,"female",251,20,13,1,1,0,1,1,0
1571328,20,7,1993,11,"female",252,82,57,42,0,42,0,0,0
1571338,59,22,1954,3,"female",1451,37,24,130,94,59,76,71,18
1571341,41,10,1972,6,"female",275,222,128,63,102,63,78,0,24
1571348,27,4,1986,12,"male",69,15,10,53,16,2,0,51,16
1571368,71,14,1942,10,"female",583,144,113,1,10,1,5,0,5
1571404,24,26,1989,3,"male",138,1,1,3,0,0,0,3,0
1571410,27,5,1986,2,"male",250,78,69,4,0,4,0,0,0
1571411,35,13,1978,9,"female",18,113,37,22,12,22,10,0,2
1571447,21,1,1992,1,"male",532,59,23,0,0,0,0,0,0
1571455,19,14,1994,1,"male",426,61,24,0,1,0,0,0,1
1571469,25,25,1988,10,"male",925,116,42,1,13,1,11,0,2
1571472,18,23,1995,8,"male",153,61,39,17,5,17,5,0,0
1571474,26,18,1987,4,"female",69,58,48,12,15,12,13,0,2
1571481,54,10,1959,1,"female",313,33,30,0,3,0,3,0,0
1571493,27,4,1986,11,"male",65,1,0,1,0,1,0,0,0
1571508,14,21,1999,4,"male",450,258,151,7,2,6,2,1,0
1571510,57,6,1956,11,"female",212,52,25,68,36,28,21,40,15
1571551,16,28,1997,10,"female",276,4,2,93,40,92,7,1,33
1571578,52,10,1961,11,"female",566,74,34,1204,432,1075,161,129,271
1571595,50,23,1963,1,"female",824,121,97,664,121,329,57,335,64
1571667,15,20,1998,6,"female",590,580,287,26,94,24,56,2,38
1571680,47,16,1966,11,"male",224,17,12,0,0,0,0,0,0
1571697,23,1,1990,1,"female",811,11,4,1,0,1,0,0,0
1571715,51,30,1962,6,"male",492,40,15,128,4,0,0,128,4
1571716,21,4,1992,5,"female",582,251,176,147,62,49,51,98,11
1571727,107,25,1906,10,"female",1166,1128,781,494,860,494,835,0,25
1571765,35,23,1978,9,"female",486,22,8,0,0,0,0,0,0
1571805,31,24,1982,7,"female",386,0,0,0,0,0,0,0,0
1571806,25,30,1988,10,"female",34,31,25,26,38,26,37,0,1
1571845,33,2,1980,2,"male",563,222,143,220,218,220,176,0,42
1571849,108,23,1905,4,"female",367,19,11,28,8,28,8,0,0
1571857,25,30,1988,12,"male",741,216,197,0,3,0,0,0,3
1571859,16,12,1997,10,"female",158,27,26,5,0,0,0,5,0
1571864,46,13,1967,5,"male",304,50,18,0,5,0,0,0,5
1571868,28,1,1985,10,"male",878,57,42,2,0,2,0,0,0
1571870,21,30,1992,1,"female",171,12,3,0,0,0,0,0,0
1571908,33,14,1980,1,"female",658,104,67,26,16,1,10,25,6
1571916,37,5,1976,7,"male",273,58,51,9,2,0,1,9,1
1571930,16,10,1997,11,"male",82,48,47,3,1,3,1,0,0
1571939,25,7,1988,7,"female",160,51,35,39,79,39,19,0,60
1571941,21,19,1992,1,"female",590,168,35,3,0,3,0,0,0
1571954,23,12,1990,9,"male",32,37,31,0,0,0,0,0,0
1571963,33,16,1980,5,"female",205,112,7,3,0,3,0,0,0
1571968,57,21,1956,1,"female",5,18,16,50,40,33,19,17,21
1571973,16,26,1997,6,"male",267,367,182,5,88,5,65,0,23
1571975,35,1,1978,9,"female",176,149,134,106,87,106,61,0,26
1571979,28,10,1985,4,"female",142,1,0,0,0,0,0,0,0
1571984,23,13,1990,12,"female",242,481,387,97,59,23,35,74,24
1571997,24,1,1989,1,"male",69,65,44,0,0,0,0,0,0
1572010,44,23,1969,5,"female",599,135,110,7,25,7,24,0,1
1572022,34,30,1979,12,"female",381,47,32,1,0,1,0,0,0
1572024,26,23,1987,3,"male",462,119,80,1,0,0,0,1,0
1572026,45,10,1968,5,"male",1184,199,76,110,109,106,101,4,8
1572090,17,24,1996,4,"male",150,8,8,0,0,0,0,0,0
1572091,38,14,1975,11,"male",303,1,1,0,0,0,0,0,0
1572092,22,7,1991,9,"female",507,165,98,4,4,4,3,0,1
1572105,61,26,1952,7,"male",652,45,35,1,62,0,47,1,15
1572113,23,6,1990,6,"male",661,210,182,0,1,0,1,0,0
1572136,21,8,1992,3,"male",449,194,45,13,0,12,0,1,0
1572140,16,17,1997,11,"male",419,217,170,35,1,0,0,35,1
1572162,18,28,1995,5,"female",512,18,5,0,0,0,0,0,0
1572175,19,8,1994,6,"male",359,116,82,323,99,323,94,0,5
1572181,14,13,1999,6,"male",155,51,47,0,14,0,2,0,12
1572198,18,6,1995,8,"male",465,1310,1028,450,140,268,114,182,26
1572278,23,5,1990,10,"male",94,12,11,2,0,2,0,0,0
1572283,59,12,1954,5,"female",328,60,41,230,73,230,22,0,51
1572302,29,9,1984,2,"female",284,0,0,0,6,0,1,0,5
1572326,33,22,1980,3,"male",78,2,1,5,0,0,0,5,0
1572336,72,9,1941,11,"female",286,155,71,28,29,1,11,27,18
1572339,68,16,1945,12,"male",498,332,223,20,13,20,11,0,2
1572388,24,11,1989,10,"male",260,47,34,2,6,2,6,0,0
1572410,14,15,1999,8,"male",328,64,48,5,0,0,0,5,0
1572411,38,13,1975,6,"male",209,57,37,51,18,20,10,31,8
1572419,18,4,1995,3,"female",1538,872,408,395,738,117,271,278,467
1572459,54,19,1959,12,"female",180,22,22,2,0,2,0,0,0
1572462,23,23,1990,11,"female",395,355,151,0,0,0,0,0,0
1572471,32,15,1981,7,"male",95,42,37,0,6,0,1,0,5
1572480,56,18,1957,3,"male",499,27,2,8,17,2,4,6,13
1572523,83,29,1930,6,"male",1194,32,4,0,8,0,2,0,6
1572524,54,27,1959,5,"female",397,0,0,0,0,0,0,0,0
1572540,54,12,1959,8,"female",127,32,23,106,19,106,16,0,3
1572547,29,25,1984,8,"male",59,14,13,0,4,0,4,0,0
1572578,27,21,1986,6,"male",390,10,4,10,0,10,0,0,0
1572603,19,17,1994,12,"male",41,49,49,0,0,0,0,0,0
1572621,25,1,1988,1,"male",141,36,35,3,0,3,0,0,0
1572639,24,8,1989,7,"male",174,57,49,18,39,18,39,0,0
1572642,52,11,1961,12,"female",1560,144,65,1,5,0,0,1,5
1572744,24,7,1989,4,"female",626,771,456,332,1082,327,714,5,368
1572768,56,28,1957,10,"male",141,4,2,0,0,0,0,0,0
1572784,103,30,1910,9,"female",1628,87,58,78,24,78,22,0,2
1572813,67,6,1946,10,"male",409,62,45,4,1,4,1,0,0
1572840,55,22,1958,5,"female",1769,51,11,200,81,200,59,0,22
1572844,21,7,1992,12,"female",985,9,6,0,0,0,0,0,0
1572847,74,31,1939,12,"female",1864,336,254,506,262,506,251,0,11
1572851,33,5,1980,8,"male",175,12,9,0,7,0,4,0,3
1572852,23,25,1990,11,"female",27,7,4,73,19,73,8,0,11
1572853,15,12,1998,1,"male",468,15,14,0,3,0,3,0,0
1572864,45,9,1968,10,"female",2029,15,13,4,3,2,1,2,2
1572874,23,30,1990,4,"male",454,443,412,85,63,85,48,0,15
1572875,20,23,1993,5,"female",380,136,91,36,18,36,18,0,0
1572887,24,5,1989,4,"female",471,110,56,384,709,384,671,0,38
1572908,33,1,1980,1,"male",707,499,398,0,0,0,0,0,0
1572933,32,14,1981,6,"male",490,40,27,5,3,5,3,0,0
1572958,53,26,1960,6,"female",200,98,61,505,74,505,28,0,46
1572966,15,7,1998,12,"male",420,70,59,0,0,0,0,0,0
1573018,37,27,1976,4,"female",133,30,28,56,65,32,27,24,38
1573059,48,26,1965,2,"female",623,39,27,27,3,27,2,0,1
1573074,68,31,1945,10,"female",1599,48,27,1168,32,387,18,781,14
1573094,17,16,1996,8,"female",317,89,37,180,7,180,6,0,1
1573115,19,29,1994,9,"male",291,135,61,1,2,1,1,0,1
1573151,24,26,1989,7,"male",211,25,9,0,0,0,0,0,0
1573175,18,24,1995,1,"female",469,407,37,788,203,774,156,14,47
1573208,44,28,1969,5,"male",103,5,4,0,0,0,0,0,0
1573220,68,6,1945,9,"male",1124,1382,1155,117,326,117,258,0,68
1573266,29,28,1984,11,"female",518,23,16,2,1,2,0,0,1
1573277,21,28,1992,2,"male",110,130,116,0,0,0,0,0,0
1573286,28,10,1985,7,"male",596,7,1,0,2,0,2,0,0
1573315,68,21,1945,8,"male",1420,1702,266,451,182,56,133,395,49
1573333,15,22,1998,8,"female",242,0,0,0,0,0,0,0,0
1573347,15,5,1998,3,"female",655,24,11,153,8,16,6,137,2
1573361,59,25,1954,8,"male",156,57,46,1,2,0,0,1,2
1573395,30,23,1983,4,"male",673,133,43,11,13,0,7,11,6
1573405,41,21,1972,7,"female",271,5,4,0,0,0,0,0,0
1573413,22,25,1991,1,"female",253,225,166,3731,1842,3435,1652,296,190
1573447,17,14,1996,11,"male",130,44,40,0,0,0,0,0,0
1573452,24,9,1989,9,"male",867,109,85,2,7,2,4,0,3
1573489,67,5,1946,6,"female",1152,62,21,81,15,81,10,0,5
1573494,74,31,1939,8,"female",50,18,12,4,14,3,12,1,2
1573515,29,21,1984,8,"male",1575,46,29,8,25,8,19,0,6
1573518,47,25,1966,10,"female",488,95,55,1225,169,17,109,1208,60
1573522,103,6,1910,12,"female",522,347,85,0,5,0,4,0,1
1573547,33,10,1980,7,"male",320,0,0,0,0,0,0,0,0
1573561,40,28,1973,4,"male",487,44,40,1,0,1,0,0,0
1573589,19,29,1994,4,"male",162,74,64,35,72,35,63,0,9
1573593,17,28,1996,2,"female",937,1691,477,111,447,72,379,39,68
1573602,14,15,1999,2,"male",80,23,18,45,47,0,6,45,41
1573613,32,26,1981,7,"male",673,65,57,3,0,0,0,3,0
1573614,59,16,1954,3,"male",765,634,207,9,4,0,0,9,4
1573616,51,27,1962,11,"male",307,29,22,0,0,0,0,0,0
1573626,21,11,1992,10,"male",699,182,43,5,10,5,10,0,0
1573635,20,16,1993,9,"male",627,98,50,208,84,48,25,160,59
1573645,15,3,1998,4,"male",623,66,22,1,0,1,0,0,0
1573656,33,1,1980,1,"male",1003,2,1,0,0,0,0,0,0
1573673,21,11,1992,10,"male",418,240,156,367,158,367,132,0,26
1573677,35,1,1978,5,"female",604,32,13,46,9,39,8,7,1
1573713,27,24,1986,10,"female",341,2,1,0,0,0,0,0,0
1573720,20,27,1993,4,"female",181,65,2,0,0,0,0,0,0
1573741,17,16,1996,8,"male",205,628,581,2472,192,2366,133,106,59
1573776,76,3,1937,6,"female",643,23,18,0,0,0,0,0,0
1573778,65,31,1948,12,"female",998,105,51,269,768,269,572,0,196
1573806,16,17,1997,8,"female",589,17,12,6,0,0,0,6,0
1573815,25,18,1988,9,"male",506,101,55,1,8,0,7,1,1
1573819,51,2,1962,5,"female",188,26,10,0,0,0,0,0,0
1573825,19,4,1994,2,"female",297,322,62,68,204,1,77,67,127
1573900,67,17,1946,8,"male",1517,79,45,4,0,0,0,4,0
1573916,43,26,1970,6,"female",444,24,22,43,18,34,12,9,6
1573930,54,19,1959,11,"male",52,5,4,22,3,22,3,0,0
1573943,50,18,1963,5,"female",190,88,66,8,9,0,6,8,3
1573961,61,20,1952,5,"female",712,35,29,62,55,2,28,60,27
1573969,14,9,1999,1,"female",323,48,29,0,0,0,0,0,0
1574002,18,26,1995,6,"female",538,516,306,223,103,203,31,20,72
1574029,24,1,1989,10,"male",323,21,2,0,0,0,0,0,0
1574037,18,27,1995,8,"female",538,363,198,464,268,446,56,18,212
1574043,29,5,1984,5,"male",603,39,21,0,0,0,0,0,0
1574051,58,2,1955,2,"female",1692,126,34,4,20,4,6,0,14
1574059,21,28,1992,6,"female",658,838,344,105,75,40,47,65,28
1574074,34,26,1979,3,"female",363,183,130,322,261,322,177,0,84
1574086,38,26,1975,7,"female",186,84,28,5,9,5,9,0,0
1574089,29,13,1984,11,"female",152,20,17,7,4,7,4,0,0
1574101,26,17,1987,3,"male",695,453,356,1,10,1,9,0,1
1574102,25,2,1988,12,"female",265,448,247,60,909,60,747,0,162
1574114,56,8,1957,6,"female",137,56,28,125,46,0,21,125,25
1574121,20,11,1993,11,"female",269,26,19,0,0,0,0,0,0
1574139,66,14,1947,1,"female",596,66,51,259,116,259,100,0,16
1574153,35,20,1978,8,"male",810,84,11,22,18,22,6,0,12
1574185,23,27,1990,3,"female",209,244,190,9,15,9,10,0,5
1574190,17,2,1996,2,"female",414,133,92,80,57,58,28,22,29
1574223,22,31,1991,12,"female",394,21,15,19,174,19,99,0,75
1574241,39,6,1974,11,"female",157,14,9,6,0,0,0,6,0
1574244,65,21,1948,5,"female",434,93,56,253,8,0,0,253,8
1574246,55,26,1958,7,"male",1261,52,25,0,1,0,1,0,0
1574324,24,27,1989,3,"male",148,4,4,0,0,0,0,0,0
1574331,17,14,1996,6,"female",557,641,446,8,27,8,15,0,12
1574334,15,24,1998,3,"male",435,676,403,1291,265,1291,225,0,40
1574344,67,17,1946,3,"male",85,112,96,1129,241,0,7,1129,234
1574363,65,21,1948,10,"male",1302,104,34,36,10,36,10,0,0
1574398,32,7,1981,5,"male",627,3,1,0,0,0,0,0,0
1574421,19,22,1994,2,"female",200,126,83,120,154,59,57,61,97
1574486,21,6,1992,10,"female",233,10,8,56,35,1,6,55,29
1574498,26,4,1987,10,"female",547,46,16,94,51,86,18,8,33
1574525,29,10,1984,6,"male",1063,7,3,0,4,0,1,0,3
1574544,16,16,1997,4,"male",525,565,414,4,3,0,0,4,3
1574547,23,16,1990,6,"male",107,1,1,0,0,0,0,0,0
1574550,19,1,1994,9,"male",122,938,167,143,1196,123,457,20,739
1574572,26,3,1987,4,"male",217,21,15,12,0,12,0,0,0
1574575,34,23,1979,6,"male",1202,201,47,22,14,22,11,0,3
1574581,23,17,1990,4,"female",771,195,38,1,7,1,6,0,1
1574585,20,31,1993,12,"male",251,479,301,125,49,125,43,0,6
1574593,29,21,1984,9,"female",437,78,45,0,0,0,0,0,0
1574605,16,9,1997,10,"male",354,21,13,0,0,0,0,0,0
1574616,19,22,1994,2,"male",451,504,426,5,6,1,0,4,6
1574641,61,22,1952,10,"female",1394,100,41,117,96,69,68,48,28
1574683,48,29,1965,7,"male",35,1,0,0,0,0,0,0,0
1574723,42,7,1971,2,"male",15,16,3,0,0,0,0,0,0
1574793,51,24,1962,2,"male",507,92,71,38,31,27,10,11,21
1574800,103,30,1910,6,NA,2127,357,101,137,243,10,89,127,154
1574803,27,4,1986,12,"male",546,18,18,35,17,33,10,2,7
1574806,22,9,1991,3,"male",195,68,40,0,0,0,0,0,0
1574823,36,1,1977,4,"male",538,9,7,0,0,0,0,0,0
1574838,28,3,1985,9,"female",212,199,166,360,149,58,47,302,102
1574859,57,5,1956,5,"male",111,9,7,0,2,0,1,0,1
1574894,20,13,1993,1,"female",155,4,4,64,29,60,15,4,14
1574899,28,29,1985,9,"female",405,109,71,3,95,3,43,0,52
1574902,19,30,1994,5,"male",201,109,82,2,0,2,0,0,0
1574923,28,12,1985,5,"male",525,4,1,0,0,0,0,0,0
1574942,51,29,1962,11,"male",420,35,6,136,48,136,45,0,3
1574951,74,10,1939,10,"male",414,99,41,3,16,0,4,3,12
1574987,45,30,1968,8,"male",150,16,11,2,0,2,0,0,0
1575007,53,16,1960,6,"female",344,149,117,11,28,11,18,0,10
1575008,74,18,1939,7,"male",462,152,115,798,139,798,103,0,36
1575017,69,16,1944,6,"female",1129,68,46,121,141,121,86,0,55
1575027,24,1,1989,6,"male",718,234,118,3,1,0,0,3,1
1575043,30,10,1983,4,"female",297,73,23,6,0,6,0,0,0
1575070,75,19,1938,4,"female",542,23,3,12,0,12,0,0,0
1575085,25,29,1988,8,"female",530,459,250,245,3833,245,2769,0,1064
1575094,29,10,1984,10,"male",168,52,26,19,0,19,0,0,0
1575114,28,26,1985,7,"female",216,135,22,5,36,5,13,0,23
1575148,30,25,1983,12,"male",498,227,117,9,44,9,32,0,12
1575157,57,19,1956,10,"male",648,116,94,31,24,31,20,0,4
1575168,31,5,1982,10,"female",233,64,27,1,10,1,5,0,5
1575192,46,8,1967,3,"male",360,19,13,12,0,12,0,0,0
1575196,31,1,1982,2,"male",549,0,0,0,0,0,0,0,0
1575204,59,13,1954,10,"female",537,12,6,4,28,2,25,2,3
1575208,18,5,1995,10,"female",215,78,19,0,0,0,0,0,0
1575213,33,7,1980,2,"male",325,45,38,147,6,147,4,0,2
1575219,100,13,1913,10,"male",831,126,71,334,171,276,103,58,68
1575234,26,7,1987,4,"male",174,30,21,2,7,2,5,0,2
1575250,43,17,1970,7,"male",443,141,119,17,32,17,27,0,5
1575264,45,10,1968,11,"female",146,58,17,12,54,10,24,2,30
1575266,18,6,1995,9,"female",492,41,32,73,114,65,67,8,47
1575276,47,10,1966,12,"male",1349,145,70,13,19,13,16,0,3
1575280,45,29,1968,11,"male",446,45,38,83,46,80,18,3,28
1575301,18,1,1995,1,"female",39,246,109,15,11,15,9,0,2
1575308,75,29,1938,10,"female",2303,302,39,9,9,2,8,7,1
1575318,16,15,1997,8,"male",953,191,78,127,71,114,55,13,16
1575335,66,2,1947,5,"female",424,105,39,2,4,0,2,2,2
1575339,49,26,1964,7,"female",516,40,27,1548,0,1548,0,0,0
1575351,30,4,1983,11,"female",354,215,146,607,281,155,123,452,158
1575352,15,8,1998,1,"male",132,60,32,132,63,132,39,0,24
1575361,16,1,1997,1,"male",541,371,241,0,0,0,0,0,0
1575391,28,19,1985,1,"male",650,43,28,231,48,231,23,0,25
1575400,26,6,1987,10,"male",671,335,85,72,56,58,39,14,17
1575401,28,24,1985,1,"male",241,4,3,0,0,0,0,0,0
1575411,27,21,1986,12,"female",486,8,5,1,1,0,0,1,1
1575418,20,27,1993,5,"female",224,302,123,27,24,24,10,3,14
1575470,15,20,1998,9,"male",224,35,20,31,25,20,20,11,5
1575474,44,10,1969,7,"female",272,203,129,1034,424,228,158,806,266
1575536,52,1,1961,1,"male",438,1058,517,96,161,76,111,20,50
1575539,59,13,1954,8,"male",393,3,2,0,0,0,0,0,0
1575545,57,30,1956,3,"female",659,12,9,0,0,0,0,0,0
1575554,22,8,1991,5,"female",1334,154,70,285,142,269,97,16,45
1575605,18,7,1995,6,"male",537,121,50,15,10,15,9,0,1
1575608,20,1,1993,5,"male",143,73,25,25,8,25,3,0,5
1575631,20,30,1993,12,"female",342,99,45,547,176,529,98,18,78
1575656,48,20,1965,10,"female",310,496,215,659,1083,16,533,643,550
1575659,68,20,1945,6,"female",1007,29,21,33,6,0,6,33,0
1575677,17,22,1996,2,"female",394,2,1,0,0,0,0,0,0
1575689,31,21,1982,8,"male",1122,92,32,0,0,0,0,0,0
1575715,78,22,1935,2,"female",360,2,1,0,0,0,0,0,0
1575732,16,2,1997,3,"female",427,682,210,238,561,65,245,173,316
1575752,36,11,1977,9,"female",561,26,22,0,0,0,0,0,0
1575767,18,23,1995,3,"male",408,44,23,19,2,19,2,0,0
1575787,14,6,1999,3,"female",456,196,125,409,26,409,11,0,15
1575815,16,30,1997,4,"female",404,681,383,439,1471,308,943,131,528
1575824,65,10,1948,8,"female",80,23,13,0,0,0,0,0,0
1575829,25,7,1988,7,"male",303,168,135,46,35,36,18,10,17
1575892,40,13,1973,7,"male",383,34,27,0,0,0,0,0,0
1575898,61,16,1952,6,"female",419,14,11,0,0,0,0,0,0
1575906,44,23,1969,3,"female",215,160,78,86,111,24,72,62,39
1575919,19,6,1994,11,"male",391,16,11,0,0,0,0,0,0
1575927,36,12,1977,8,"male",14,1,0,9,5,9,5,0,0
1575950,21,21,1992,1,"male",695,362,222,92,15,91,15,1,0
1576005,40,13,1973,8,"male",494,3,2,1,0,1,0,0,0
1576037,20,11,1993,3,"male",92,402,400,18,19,18,19,0,0
1576039,67,14,1946,5,"female",108,34,28,7,27,7,26,0,1
1576047,33,3,1980,6,"female",313,78,57,0,0,0,0,0,0
1576068,28,22,1985,2,"male",1286,0,0,0,0,0,0,0,0
1576131,14,27,1999,6,"male",145,190,100,288,154,288,142,0,12
1576147,36,10,1977,1,"male",1267,128,62,14,2,3,2,11,0
1576176,23,26,1990,7,"male",797,13,4,0,0,0,0,0,0
1576192,35,18,1978,5,"male",169,32,26,5,8,5,6,0,2
1576193,15,12,1998,8,"female",370,110,53,36,6,9,0,27,6
1576199,42,19,1971,5,"female",453,125,71,48,17,46,6,2,11
1576211,25,14,1988,7,"male",564,117,39,12,8,12,4,0,4
1576214,67,26,1946,7,"male",1380,114,28,5,0,5,0,0,0
1576312,27,17,1986,6,"female",539,228,201,8,26,7,12,1,14
1576329,16,3,1997,7,"male",392,414,344,3,5,3,2,0,3
1576348,21,27,1992,4,"female",404,5,3,26,8,12,5,14,3
1576355,60,16,1953,12,"female",1762,406,244,191,193,99,101,92,92
1576379,27,26,1986,6,"male",558,104,25,4,0,0,0,4,0
1576382,52,17,1961,12,"male",368,13,9,21,0,21,0,0,0
1576388,18,12,1995,6,"male",172,44,41,1,1,1,1,0,0
1576420,14,8,1999,7,"male",139,43,41,7,1,7,1,0,0
1576434,18,14,1995,11,"male",355,29,9,0,0,0,0,0,0
1576464,27,19,1986,12,"male",305,66,56,38,0,33,0,5,0
1576471,20,28,1993,7,"male",530,335,218,21,1,0,0,21,1
1576478,14,8,1999,1,"male",298,27,25,0,2,0,1,0,1
1576508,17,9,1996,4,"female",339,151,66,0,2,0,0,0,2
1576542,17,10,1996,5,"male",272,62,37,0,0,0,0,0,0
1576563,27,24,1986,6,"male",449,101,20,3,7,0,3,3,4
1576570,30,9,1983,1,"male",269,63,26,3,15,3,13,0,2
1576579,33,22,1980,11,"female",781,377,93,1,32,1,6,0,26
1576584,48,20,1965,4,"female",284,156,105,360,107,360,97,0,10
1576617,14,30,1999,8,"male",364,136,94,134,5,134,4,0,1
1576636,16,13,1997,4,"male",137,65,52,0,0,0,0,0,0
1576643,34,1,1979,3,"male",255,53,26,66,139,66,35,0,104
1576678,64,3,1949,9,"female",155,33,17,31,1,3,0,28,1
1576685,17,7,1996,11,"female",274,284,110,2,19,0,7,2,12
1576689,41,6,1972,1,"male",282,8,6,226,156,226,154,0,2
1576705,23,2,1990,2,"male",42,62,35,1,11,1,11,0,0
1576731,43,25,1970,3,"male",205,1,1,0,0,0,0,0,0
1576733,46,15,1967,3,"female",552,111,88,76,27,0,4,76,23
1576736,38,14,1975,5,"male",23,6,6,0,1,0,1,0,0
1576741,21,19,1992,11,"male",548,215,120,0,0,0,0,0,0
1576766,58,1,1955,1,"male",1096,127,74,6,23,0,5,6,18
1576797,73,10,1940,9,"male",473,24,18,6,28,0,19,6,9
1576798,55,6,1958,11,"male",506,58,52,523,83,0,38,523,45
1576815,21,4,1992,12,"male",848,187,68,103,15,103,12,0,3
1576816,26,8,1987,10,"female",947,1296,191,105,35,28,9,77,26
1576827,29,14,1984,10,"male",279,26,16,529,101,529,77,0,24
1576836,77,21,1936,12,"male",1401,161,80,83,67,83,44,0,23
1576841,17,10,1996,4,"female",328,174,138,20,8,20,7,0,1
1576850,46,17,1967,2,"female",566,88,12,185,150,110,92,75,58
1576873,18,25,1995,9,"female",571,213,135,25,31,9,21,16,10
1576875,57,14,1956,10,"female",969,5,2,0,0,0,0,0,0
1576897,18,25,1995,1,"male",218,122,87,9,6,9,2,0,4
1576903,22,31,1991,8,"male",447,152,59,1,0,1,0,0,0
1576925,22,26,1991,7,"female",1517,459,243,394,491,194,359,200,132
1576943,35,1,1978,6,"male",647,8,6,78,1,0,1,78,0
1576953,41,3,1972,5,"male",61,191,170,167,99,167,51,0,48
1576979,37,22,1976,4,"female",163,1586,1227,64,2376,54,2070,10,306
1577006,41,19,1972,1,"female",223,53,41,1,2,1,1,0,1
1577013,18,24,1995,8,"male",143,162,148,377,163,239,84,138,79
1577017,20,5,1993,8,"female",385,137,99,380,243,0,56,380,187
1577053,31,1,1982,12,"male",130,1,1,5,0,5,0,0,0
1577083,103,29,1910,3,"male",356,73,56,55,67,38,54,17,13
1577119,55,27,1958,6,"male",1768,30,11,31,7,29,6,2,1
1577130,25,14,1988,2,"female",341,74,53,115,225,115,187,0,38
1577154,28,28,1985,10,"male",639,1,0,6,0,6,0,0,0
1577201,33,6,1980,10,"male",615,29,20,7,2,7,2,0,0
1577208,23,26,1990,5,"male",273,49,29,0,0,0,0,0,0
1577210,53,8,1960,6,"male",191,87,32,3,3,0,3,3,0
1577216,23,1,1990,1,"male",294,37,31,0,18,0,6,0,12
1577247,51,2,1962,5,"male",183,48,29,0,0,0,0,0,0
1577248,36,29,1977,12,"male",553,64,29,0,0,0,0,0,0
1577256,60,11,1953,1,"female",677,74,48,52,33,0,24,52,9
1577258,19,12,1994,5,"male",597,25,14,1,1,1,1,0,0
1577272,32,24,1981,4,"female",433,18,11,20,10,20,10,0,0
1577289,71,22,1942,9,"female",1580,42,17,10,7,9,3,1,4
1577302,68,12,1945,11,"male",1498,612,533,28,71,6,36,22,35
1577322,21,8,1992,6,"male",502,41,20,4,22,4,21,0,1
1577324,35,4,1978,10,"male",332,2,2,1,0,0,0,1,0
1577356,63,25,1950,11,"male",393,63,36,0,0,0,0,0,0
1577363,36,26,1977,1,"male",299,28,16,2,4,2,3,0,1
1577391,22,11,1991,4,"male",1428,1613,791,0,0,0,0,0,0
1577397,25,7,1988,3,"male",537,232,125,12,4,4,0,8,4
1577408,30,2,1983,1,"male",379,143,97,10,117,10,78,0,39
1577417,93,1,1920,12,"female",579,77,59,1109,513,1109,319,0,194
1577434,26,1,1987,1,"male",274,93,50,221,12,221,10,0,2
1577507,32,1,1981,12,"male",390,36,27,138,21,138,18,0,3
1577522,34,10,1979,10,"male",194,1,1,0,0,0,0,0,0
1577554,31,23,1982,6,"male",310,43,30,0,0,0,0,0,0
1577568,21,1,1992,1,"male",29,9,9,2,1,2,1,0,0
1577569,57,16,1956,8,"female",210,20,14,0,0,0,0,0,0
1577593,42,22,1971,1,"male",280,39,9,0,0,0,0,0,0
1577595,28,10,1985,6,"male",702,449,395,135,24,134,17,1,7
1577620,79,7,1934,1,"female",2063,56,45,41,23,0,15,41,8
1577624,21,3,1992,12,"female",118,227,172,22,9,14,6,8,3
1577646,31,6,1982,1,"male",181,51,13,0,2,0,2,0,0
1577672,23,6,1990,10,"female",532,165,108,366,543,264,242,102,301
1577685,15,8,1998,11,"female",359,290,136,46,44,46,29,0,15
1577694,19,14,1994,1,"male",596,799,469,84,95,63,23,21,72
1577696,56,24,1957,10,"female",258,4,4,3,2,0,0,3,2
1577708,44,17,1969,7,"female",345,90,46,1479,633,937,249,542,384
1577760,49,3,1964,12,"female",29,0,0,10,17,10,4,0,13
1577771,32,7,1981,3,"male",181,13,6,1,1,1,1,0,0
1577830,21,7,1992,10,"male",1374,765,501,9,64,9,62,0,2
1577831,18,10,1995,4,"female",233,1579,324,137,1468,137,1070,0,398
1577864,53,1,1960,3,"male",301,48,30,164,85,121,57,43,28
1577879,27,7,1986,9,"female",210,351,246,12,20,12,13,0,7
1577888,21,3,1992,6,"male",369,31,18,0,2,0,1,0,1
1577898,16,14,1997,7,"male",235,293,178,40,27,1,16,39,11
1577900,23,18,1990,10,"male",2,2,2,0,0,0,0,0,0
1577931,27,14,1986,6,"female",613,425,189,224,625,1,168,223,457
1577953,43,1,1970,11,"female",1147,29,12,2,1,2,0,0,1
1577968,65,4,1948,5,"female",391,12,7,826,90,0,9,826,81
1578017,24,6,1989,6,"male",367,11,1,0,0,0,0,0,0
1578034,28,9,1985,3,"male",183,87,85,2,1,2,1,0,0
1578044,22,10,1991,7,"female",254,125,69,25,23,25,22,0,1
1578063,22,30,1991,12,"male",566,290,252,3,2,3,1,0,1
1578079,60,22,1953,9,"male",1235,106,49,27,16,24,11,3,5
1578099,27,6,1986,6,"male",589,18,18,0,1,0,1,0,0
1578118,40,16,1973,9,"male",666,56,35,2,0,2,0,0,0
1578122,27,30,1986,7,"male",321,54,49,5,0,5,0,0,0
1578165,20,10,1993,12,"female",587,68,36,122,49,0,35,122,14
1578170,48,16,1965,5,"male",1455,34,16,1,4,1,3,0,1
1578190,25,7,1988,1,"male",105,243,200,1,0,1,0,0,0
1578198,17,13,1996,10,"male",321,51,16,0,0,0,0,0,0
1578215,49,9,1964,11,"female",1488,109,80,15,63,8,31,7,32
1578226,18,21,1995,8,"male",102,95,57,69,116,69,11,0,105
1578230,17,1,1996,1,"male",957,175,123,0,1,0,1,0,0
1578235,56,12,1957,2,"male",1498,44,30,18,2,12,2,6,0
1578262,15,8,1998,6,"male",491,247,205,8,0,0,0,8,0
1578268,28,21,1985,6,"male",772,18,14,0,12,0,7,0,5
1578318,22,5,1991,5,"male",451,38,29,1,1,0,0,1,1
1578336,54,8,1959,11,"female",373,113,104,209,102,209,73,0,29
1578359,20,8,1993,1,"female",453,372,222,62,827,62,655,0,172
1578369,18,21,1995,5,"male",175,84,71,4,0,4,0,0,0
1578374,27,3,1986,3,"male",458,114,61,20,54,20,41,0,13
1578381,61,15,1952,12,"female",706,22,17,9,1,9,1,0,0
1578402,31,5,1982,1,"female",423,53,32,0,0,0,0,0,0
1578405,29,18,1984,12,"male",397,0,0,0,0,0,0,0,0
1578409,103,18,1910,4,"male",1116,1261,924,1233,573,1233,444,0,129
1578417,38,7,1975,8,"male",316,86,77,13,20,13,11,0,9
1578422,23,20,1990,10,"female",26,6,4,27,2,27,1,0,1
1578428,20,13,1993,10,"female",612,256,155,76,61,76,57,0,4
1578449,49,2,1964,7,"female",303,13,10,8,8,4,6,4,2
1578468,37,19,1976,8,"female",407,167,130,22,53,22,38,0,15
1578473,68,18,1945,8,"female",1525,45,33,59,91,7,30,52,61
1578482,14,14,1999,1,"male",524,184,159,0,20,0,13,0,7
1578513,61,10,1952,2,"male",174,7,7,0,0,0,0,0,0
1578541,26,14,1987,12,"male",1701,728,227,0,1,0,0,0,1
1578563,31,14,1982,11,"male",128,0,0,0,0,0,0,0,0
1578578,26,6,1987,5,"female",464,4,1,0,0,0,0,0,0
1578579,15,27,1998,1,"male",730,684,544,187,214,78,126,109,88
1578581,106,6,1907,5,"male",1422,190,110,63,56,14,24,49,32
1578594,15,3,1998,2,"male",133,20,16,24,0,15,0,9,0
1578595,19,4,1994,12,"female",543,134,79,8,0,8,0,0,0
1578601,22,12,1991,8,"male",19,0,0,0,0,0,0,0,0
1578620,69,25,1944,11,"male",810,2,1,52,6,52,6,0,0
1578634,33,16,1980,5,"male",396,170,106,43,25,0,10,43,15
1578638,31,15,1982,1,"male",447,82,50,4,15,4,14,0,1
1578651,52,27,1961,4,"female",669,91,43,50,17,36,10,14,7
1578674,43,8,1970,4,"male",113,28,24,70,1,70,0,0,1
1578691,26,30,1987,1,"male",342,73,49,20,8,8,5,12,3
1578730,30,26,1983,3,"female",192,128,65,149,32,53,22,96,10
1578733,34,1,1979,1,"male",52,1,1,0,0,0,0,0,0
1578737,42,8,1971,7,"female",805,77,30,38,10,38,7,0,3
1578751,51,21,1962,11,"male",1637,109,66,134,0,134,0,0,0
1578805,24,6,1989,11,"male",85,70,52,29,16,29,11,0,5
1578812,53,31,1960,8,"female",488,41,20,0,0,0,0,0,0
1578825,31,12,1982,3,"male",9,7,5,0,3,0,2,0,1
1578838,36,17,1977,8,"female",801,60,39,20,48,0,10,20,38
1578888,34,21,1979,2,"male",41,1,1,8,32,8,18,0,14
1578916,37,23,1976,11,"male",39,1,1,1,2,1,2,0,0
1578921,28,12,1985,10,"female",492,295,222,617,586,594,353,23,233
1578934,38,9,1975,6,"male",197,74,57,7,0,7,0,0,0
1578941,58,27,1955,10,"female",607,50,29,363,154,276,71,87,83
1578959,76,23,1937,6,"male",1488,22,16,0,0,0,0,0,0
1578979,39,1,1974,10,"male",338,34,15,0,4,0,1,0,3
1578989,62,2,1951,7,"male",997,30,17,0,0,0,0,0,0
1578994,103,16,1910,9,"male",647,1131,612,159,163,159,109,0,54
1579024,30,30,1983,5,"male",312,48,18,34,50,34,23,0,27
1579046,25,8,1988,5,"male",21,4,2,5,5,5,5,0,0
1579058,62,1,1951,1,"male",1265,29,19,30,9,18,3,12,6
1579093,23,15,1990,6,"male",524,319,239,3,5,3,5,0,0
1579119,43,14,1970,10,"male",46,3,3,4,0,0,0,4,0
1579122,18,22,1995,8,"female",284,629,432,155,142,104,105,51,37
1579131,18,10,1995,1,"male",315,170,139,61,32,45,26,16,6
1579148,28,1,1985,1,"male",24,0,0,0,0,0,0,0,0
1579155,39,28,1974,1,"female",355,32,28,4,16,4,16,0,0
1579173,21,3,1992,11,"male",255,106,28,12,1,0,0,12,1
1579188,18,10,1995,2,"male",269,74,57,0,8,0,2,0,6
1579191,18,27,1995,1,"male",208,71,27,10,46,9,24,1,22
1579204,26,20,1987,5,"male",143,23,18,11,1,11,1,0,0
1579219,58,26,1955,11,"female",1830,282,185,557,698,422,113,135,585
1579262,30,5,1983,8,"male",214,0,0,0,0,0,0,0,0
1579285,19,8,1994,10,"female",244,140,92,353,233,353,175,0,58
1579293,39,17,1974,4,"male",288,155,114,33,168,33,62,0,106
1579327,20,6,1993,1,"male",435,67,8,132,124,125,107,7,17
1579332,60,28,1953,10,"female",414,88,53,88,15,0,2,88,13
1579341,46,15,1967,2,"male",1312,1,0,0,0,0,0,0,0
1579356,14,17,1999,6,"male",673,35,16,8,10,8,4,0,6
1579361,35,17,1978,10,"male",300,5,4,0,0,0,0,0,0
1579370,21,10,1992,8,"male",39,55,34,44,0,44,0,0,0
1579375,17,5,1996,11,"female",170,152,105,330,51,286,14,44,37
1579389,22,9,1991,7,"female",599,6,5,10,0,0,0,10,0
1579439,108,8,1905,8,"male",862,204,136,3,23,3,22,0,1
1579464,24,13,1989,12,"female",417,149,121,36,5,0,2,36,3
1579485,34,5,1979,8,"male",213,4,4,0,0,0,0,0,0
1579499,25,31,1988,10,"female",630,113,28,0,0,0,0,0,0
1579502,20,12,1993,8,"male",17,14,14,6,0,4,0,2,0
1579506,35,17,1978,8,"female",706,70,31,2,6,2,5,0,1
1579510,22,26,1991,3,"male",536,89,51,2,7,2,7,0,0
1579520,20,27,1993,5,"female",698,540,260,28,26,28,16,0,10
1579531,23,29,1990,4,"male",550,260,178,132,95,132,86,0,9
1579544,19,3,1994,3,"male",420,290,222,54,7,54,1,0,6
1579567,38,12,1975,11,"male",661,34,15,12,1,0,1,12,0
1579572,18,8,1995,8,"male",624,61,44,43,21,15,21,28,0
1579589,62,1,1951,1,"female",183,28,22,165,62,165,51,0,11
1579602,44,3,1969,10,"male",98,45,37,48,10,0,3,48,7
1579605,16,1,1997,4,"male",520,631,235,19,2,19,0,0,2
1579606,37,27,1976,2,"female",306,62,53,530,9,530,4,0,5
1579614,62,2,1951,9,"male",1321,87,46,1,18,1,18,0,0
1579624,61,12,1952,9,"female",795,208,132,16,20,0,10,16,10
1579637,19,18,1994,7,"male",494,221,196,0,0,0,0,0,0
1579654,15,2,1998,10,"female",730,256,200,345,40,189,34,156,6
1579661,18,25,1995,9,"female",174,1051,629,1108,699,1108,620,0,79
1579668,25,10,1988,1,"female",171,555,61,3876,1769,3876,1428,0,341
1579695,27,1,1986,1,"male",298,6,6,0,0,0,0,0,0
1579731,45,29,1968,3,"female",912,69,23,24,100,24,56,0,44
1579747,25,4,1988,10,"female",525,49,30,690,40,690,19,0,21
1579770,32,9,1981,1,"male",728,192,147,15,1,4,0,11,1
1579785,32,17,1981,9,"female",296,126,76,3,14,3,13,0,1
1579797,68,12,1945,7,"male",1721,60,25,7,39,7,34,0,5
1579806,55,11,1958,10,"male",245,33,27,0,2,0,2,0,0
1579819,68,9,1945,9,"female",25,127,100,163,101,102,76,61,25
1579843,18,11,1995,6,"female",763,488,323,439,235,349,169,90,66
1579877,103,1,1910,1,"male",229,715,649,27,83,5,25,22,58
1579879,16,26,1997,1,"female",406,238,210,18,40,0,2,18,38
1579893,63,17,1950,4,"female",500,19,10,0,2,0,2,0,0
1579899,26,1,1987,9,"male",453,63,42,0,2,0,0,0,2
1579956,18,8,1995,3,"female",266,318,46,68,72,67,28,1,44
1579972,17,13,1996,8,"male",426,323,222,25,25,10,19,15,6
1579990,36,1,1977,1,"male",153,22,22,0,0,0,0,0,0
1580003,43,6,1970,3,"female",634,22,3,0,0,0,0,0,0
1580007,71,2,1942,2,"female",659,314,156,74,44,0,9,74,35
1580018,29,17,1984,6,"male",152,4,4,13,0,13,0,0,0
1580051,67,4,1946,1,"female",1344,75,13,0,0,0,0,0,0
1580055,18,6,1995,8,"female",267,48,7,3,0,3,0,0,0
1580064,45,1,1968,1,"female",89,1,1,1,1,1,0,0,1
1580081,25,10,1988,8,"male",482,98,33,22,0,22,0,0,0
1580082,33,12,1980,4,"female",394,1,1,0,0,0,0,0,0
1580098,64,23,1949,9,"male",341,9,8,358,61,0,19,358,42
1580113,23,10,1990,10,"male",293,177,127,0,0,0,0,0,0
1580120,52,20,1961,10,"male",231,29,12,3,0,3,0,0,0
1580131,17,18,1996,4,"male",25,62,61,19,5,19,5,0,0
1580136,27,17,1986,3,"male",498,156,94,14,33,14,32,0,1
1580199,27,20,1986,10,"male",259,159,77,93,92,93,59,0,33
1580213,34,23,1979,11,"female",1014,55,29,40,30,37,16,3,14
1580220,26,22,1987,7,"female",415,45,8,0,1,0,1,0,0
1580238,19,21,1994,8,"male",536,144,52,9,5,9,4,0,1
1580265,50,13,1963,9,"male",673,263,241,13,6,0,0,13,6
1580270,18,12,1995,12,"male",254,174,96,0,1,0,0,0,1
1580281,26,1,1987,1,"male",377,1,1,0,0,0,0,0,0
1580283,44,3,1969,8,"female",353,18,13,247,85,219,58,28,27
1580287,38,26,1975,3,"female",713,38,19,1,6,1,5,0,1
1580293,33,14,1980,1,"female",101,10,6,102,179,52,96,50,83
1580311,32,18,1981,4,"female",409,60,39,50,204,50,75,0,129
1580333,32,16,1981,12,"male",598,43,39,14,0,14,0,0,0
1580339,19,31,1994,12,"female",426,464,230,77,68,77,35,0,33
1580342,42,7,1971,1,"male",493,1,1,0,0,0,0,0,0
1580364,21,25,1992,5,"female",289,961,657,2898,1136,2898,1056,0,80
1580373,19,13,1994,11,"male",115,178,155,243,35,240,32,3,3
1580388,32,4,1981,5,"female",272,185,98,123,246,111,111,12,135
1580395,103,24,1910,4,"male",193,142,113,1,1,1,1,0,0
1580415,14,27,1999,8,"male",20,10,10,0,0,0,0,0,0
1580441,17,13,1996,5,"male",404,419,358,19,17,0,2,19,15
1580444,34,7,1979,8,"male",489,27,26,0,0,0,0,0,0
1580467,25,1,1988,1,"female",27,2,0,0,0,0,0,0,0
1580482,14,15,1999,12,"male",48,40,35,1,1,1,1,0,0
1580494,18,24,1995,12,"female",306,1453,227,48,197,48,149,0,48
1580508,103,10,1910,2,"female",1981,2505,1125,818,857,818,775,0,82
1580526,25,29,1988,3,"female",69,2,2,11,1,11,1,0,0
1580536,40,2,1973,6,"female",422,100,74,1,15,0,7,1,8
1580551,56,7,1957,3,"female",1344,118,85,278,85,47,19,231,66
1580557,25,11,1988,6,"male",565,406,327,0,145,0,102,0,43
1580574,30,23,1983,10,"male",84,4,4,2,0,2,0,0,0
1580582,15,6,1998,11,"female",134,337,39,6,26,6,26,0,0
1580594,21,4,1992,2,"male",570,253,118,5,13,2,6,3,7
1580600,44,18,1969,10,"male",1942,32,9,0,0,0,0,0,0
1580617,67,10,1946,1,"female",221,50,40,200,25,0,10,200,15
1580623,25,1,1988,1,"male",115,93,68,11,0,7,0,4,0
1580630,69,22,1944,10,"female",1680,29,10,40,15,0,2,40,13
1580643,35,14,1978,2,"male",468,6,5,9,3,9,3,0,0
1580663,15,30,1998,5,"female",154,95,79,48,50,46,43,2,7
1580687,22,26,1991,6,"female",57,62,61,111,27,111,14,0,13
1580701,32,12,1981,3,"male",303,157,93,8,36,8,25,0,11
1580710,19,24,1994,12,"male",162,277,249,820,350,736,250,84,100
1580750,26,9,1987,9,"female",742,73,34,0,0,0,0,0,0
1580751,18,18,1995,8,"male",144,9,8,0,0,0,0,0,0
1580754,24,2,1989,11,"female",362,73,54,0,0,0,0,0,0
1580755,47,18,1966,12,"male",822,20,11,4,3,4,1,0,2
1580788,39,12,1974,12,"male",10,7,3,7,0,7,0,0,0
1580790,34,3,1979,5,"male",285,338,160,44,18,44,14,0,4
1580810,63,16,1950,9,"male",492,288,155,8,16,8,5,0,11
1580818,101,12,1912,12,"male",236,107,97,5,5,5,5,0,0
1580828,57,16,1956,10,"female",83,21,16,137,16,137,7,0,9
1580851,80,12,1933,11,"male",1310,118,97,74,7,74,4,0,3
1580874,31,6,1982,10,"male",598,49,43,51,76,51,73,0,3
1580876,50,16,1963,4,"male",218,35,22,6,3,6,2,0,1
1580936,50,1,1963,8,"male",551,8,4,3,0,1,0,2,0
1580939,16,11,1997,4,"female",271,77,70,273,160,54,57,219,103
1580950,19,22,1994,4,"male",277,148,46,44,21,44,18,0,3
1580957,18,10,1995,5,"female",851,112,55,108,31,108,13,0,18
1580962,37,7,1976,11,"male",110,124,99,25,4,25,1,0,3
1580963,29,22,1984,6,"male",257,44,19,19,12,19,8,0,4
1580972,18,17,1995,3,"male",310,46,35,3,0,0,0,3,0
1580990,25,1,1988,7,"male",147,23,14,0,0,0,0,0,0
1581030,103,6,1910,7,"female",449,181,98,4,2,4,2,0,0
1581035,18,7,1995,12,"female",504,352,183,24,84,24,60,0,24
1581043,19,19,1994,3,"female",674,543,449,34,14,34,7,0,7
1581047,22,17,1991,1,"female",219,1030,840,617,1136,1,232,616,904
1581076,34,6,1979,12,"female",538,314,192,33,59,14,38,19,21
1581125,25,6,1988,2,"male",492,287,234,0,56,0,50,0,6
1581144,26,1,1987,1,"male",346,52,34,0,0,0,0,0,0
1581188,14,8,1999,1,"female",352,1269,671,7,17,7,15,0,2
1581189,54,15,1959,1,"female",169,37,22,31,33,31,22,0,11
1581202,22,25,1991,9,"male",244,472,18,0,2,0,2,0,0
1581209,15,17,1998,1,"male",545,952,902,305,140,285,109,20,31
1581217,22,1,1991,3,"female",201,108,61,15,36,0,20,15,16
1581226,50,29,1963,11,"male",1063,19,3,0,0,0,0,0,0
1581227,23,17,1990,1,"female",691,232,50,458,590,458,555,0,35
1581231,41,1,1972,1,"male",251,34,8,0,2,0,1,0,1
1581233,103,29,1910,5,"male",1316,889,438,138,226,138,183,0,43
1581248,54,6,1959,5,"female",302,22,19,0,0,0,0,0,0
1581253,25,15,1988,5,"male",241,287,265,88,84,88,75,0,9
1581275,60,14,1953,5,"female",1696,225,119,42,763,11,512,31,251
1581295,31,10,1982,10,"male",295,53,39,37,8,37,5,0,3
1581307,71,10,1942,10,"male",277,5,5,0,0,0,0,0,0
1581363,36,2,1977,6,"female",623,104,40,35,27,35,21,0,6
1581383,20,28,1993,2,"female",261,593,193,9,106,9,95,0,11
1581401,19,16,1994,9,"female",456,118,73,9,6,5,4,4,2
1581428,42,18,1971,3,"male",178,121,104,97,33,89,25,8,8
1581429,18,10,1995,10,"female",916,1029,153,84,617,84,411,0,206
1581435,18,28,1995,1,"male",412,20,16,3,0,3,0,0,0
1581443,58,19,1955,11,"male",222,19,9,0,0,0,0,0,0
1581510,36,19,1977,11,"male",1417,171,89,18,25,17,8,1,17
1581543,19,12,1994,11,"female",249,311,143,964,1260,954,994,10,266
1581583,16,13,1997,6,"male",494,194,93,0,0,0,0,0,0
1581597,29,29,1984,10,"male",236,65,24,1,1,1,1,0,0
1581604,68,25,1945,6,"female",1005,1830,912,55,991,55,394,0,597
1581648,53,12,1960,7,"male",279,75,63,77,218,0,43,77,175
1581655,19,27,1994,7,"male",462,61,17,0,0,0,0,0,0
1581671,37,5,1976,5,"female",351,12,6,1,146,0,58,1,88
1581681,106,11,1907,10,"female",301,56,41,16,49,16,20,0,29
1581695,27,24,1986,4,"male",96,52,24,2,1,2,1,0,0
1581700,17,26,1996,9,"male",229,25,22,0,0,0,0,0,0
1581814,70,9,1943,7,"female",1196,70,37,0,17,0,5,0,12
1581818,56,7,1957,1,"female",139,60,42,1116,26,1116,20,0,6
1581835,29,5,1984,8,"male",422,71,61,0,0,0,0,0,0
1581849,14,5,1999,11,"female",90,9,6,7,0,7,0,0,0
1581873,30,13,1983,2,"male",95,0,0,0,0,0,0,0,0
1581876,21,21,1992,1,"male",302,5,5,0,0,0,0,0,0
1581919,23,14,1990,9,"male",283,170,136,72,15,72,6,0,9
1581927,63,25,1950,5,"female",695,61,31,21,60,0,7,21,53
1581942,97,30,1916,9,"male",1028,725,290,257,279,257,175,0,104
1581976,52,19,1961,12,"female",271,11,10,16,0,6,0,10,0
1582000,103,5,1910,5,"female",527,86,64,2,2,2,2,0,0
1582003,46,22,1967,5,"male",433,19,13,2,26,0,21,2,5
1582053,41,30,1972,7,"male",237,38,13,0,0,0,0,0,0
1582057,21,23,1992,5,"male",3,3,3,3,7,3,3,0,4
1582078,36,27,1977,12,"female",342,45,44,3,0,3,0,0,0
1582118,17,27,1996,12,"male",334,209,155,151,3,37,2,114,1
1582146,33,21,1980,8,"male",457,43,30,0,0,0,0,0,0
1582182,53,12,1960,5,"female",394,24,12,145,38,101,19,44,19
1582217,26,15,1987,4,"male",293,65,55,1,0,1,0,0,0
1582246,25,2,1988,3,"male",459,321,211,1435,828,1435,740,0,88
1582249,56,16,1957,2,"female",42,84,72,27,58,27,55,0,3
1582261,25,3,1988,12,"male",744,76,49,0,0,0,0,0,0
1582275,24,30,1989,5,"male",842,181,165,0,1,0,0,0,1
1582284,46,27,1967,7,"female",371,51,24,33,16,33,12,0,4
1582293,35,1,1978,1,"male",196,66,48,0,0,0,0,0,0
1582307,23,31,1990,12,"female",328,309,147,399,462,333,337,66,125
1582314,25,7,1988,6,"male",36,52,51,0,0,0,0,0,0
1582320,55,2,1958,3,"female",702,112,89,157,34,157,24,0,10
1582329,13,5,2000,3,"female",35,66,52,3,2,3,1,0,1
1582349,62,18,1951,10,"female",153,72,61,42,276,27,140,15,136
1582363,50,26,1963,1,"male",1326,683,497,475,331,15,177,460,154
1582368,48,25,1965,6,"female",253,57,28,162,23,162,14,0,9
1582384,18,7,1995,7,"female",347,6,4,1,0,1,0,0,0
1582386,66,19,1947,8,"female",312,28,21,22,0,22,0,0,0
1582443,26,23,1987,8,"female",641,224,76,0,0,0,0,0,0
1582452,25,1,1988,1,"male",24,7,6,3,2,3,2,0,0
1582456,38,12,1975,5,"female",133,215,185,117,41,117,41,0,0
1582465,28,28,1985,9,"female",263,134,46,0,5,0,5,0,0
1582479,34,21,1979,5,"female",375,160,96,678,343,368,143,310,200
1582511,47,16,1966,6,"male",147,21,3,87,38,65,29,22,9
1582515,33,1,1980,11,"male",533,504,346,66,48,40,30,26,18
1582517,25,20,1988,1,"male",393,55,24,47,3,47,3,0,0
1582543,16,22,1997,8,"female",109,375,291,2,63,1,36,1,27
1582557,21,28,1992,7,"male",468,170,150,5,25,5,12,0,13
1582558,15,21,1998,10,"male",377,57,44,0,1,0,1,0,0
1582570,16,12,1997,12,"male",238,40,33,1,21,1,17,0,4
1582646,82,15,1931,7,"female",1140,27,12,5,0,0,0,5,0
1582651,15,30,1998,10,"female",652,469,278,3841,1088,3469,709,372,379
1582691,25,27,1988,7,"female",332,140,52,852,967,852,914,0,53
1582701,108,28,1905,2,"male",1520,231,89,26,72,19,48,7,24
1582727,43,21,1970,7,"female",519,165,132,135,23,0,3,135,20
1582752,18,6,1995,4,"male",373,62,42,0,0,0,0,0,0
1582759,15,19,1998,5,"female",469,886,125,537,1020,537,591,0,429
1582766,20,18,1993,3,"female",379,5,2,0,0,0,0,0,0
1582779,23,1,1990,1,"female",814,2,0,54,0,53,0,1,0
1582789,18,31,1995,7,"female",104,5,4,6,3,6,3,0,0
1582816,25,1,1988,7,"male",121,134,62,15,0,15,0,0,0
1582824,108,18,1905,2,"male",318,588,451,314,155,30,132,284,23
1582836,24,12,1989,11,"female",292,94,50,214,593,178,312,36,281
1582840,15,22,1998,8,"male",234,182,128,19,9,0,6,19,3
1582859,39,1,1974,5,"female",949,375,221,452,463,452,443,0,20
1582863,23,13,1990,3,"male",257,31,29,1,0,1,0,0,0
1582869,23,25,1990,2,"male",639,133,78,3,47,3,42,0,5
1582881,66,23,1947,6,"male",1377,17,7,7,10,0,4,7,6
1582888,25,30,1988,1,"female",248,18,4,5,7,5,6,0,1
1582938,34,9,1979,8,"male",663,85,55,5,28,5,15,0,13
1582939,69,14,1944,4,"female",482,153,81,847,41,833,27,14,14
1582963,18,14,1995,8,"female",176,459,114,34,136,34,98,0,38
1582964,24,26,1989,2,"female",419,536,205,1671,1108,1671,936,0,172
1582967,33,10,1980,10,"male",44,14,11,0,0,0,0,0,0
1582973,33,11,1980,11,"male",38,37,37,1,2,1,2,0,0
1582979,16,3,1997,6,"male",27,24,20,86,3,86,3,0,0
1583006,20,15,1993,1,"male",201,140,123,10,4,1,1,9,3
1583008,26,1,1987,1,"male",473,16,14,0,0,0,0,0,0
1583032,61,9,1952,1,"female",611,21,13,14,20,14,2,0,18
1583035,63,26,1950,11,"female",238,18,14,9,2,0,0,9,2
1583049,40,20,1973,4,"female",175,201,102,20,15,20,10,0,5
1583073,57,22,1956,3,"female",964,82,36,42,38,28,36,14,2
1583076,83,29,1930,10,NA,2235,21,8,35,12,34,8,1,4
1583103,19,14,1994,8,"male",830,192,179,0,26,0,19,0,7
1583108,35,30,1978,9,"male",126,1,0,1,0,1,0,0,0
1583123,17,15,1996,6,"male",722,682,394,474,149,456,98,18,51
1583149,58,22,1955,8,"female",1123,33,9,17,7,6,6,11,1
1583188,15,24,1998,5,"female",198,1361,1252,51,33,51,20,0,13
1583189,13,23,2000,1,"male",252,421,231,58,127,48,68,10,59
1583197,36,16,1977,4,"male",72,2,2,2,0,2,0,0,0
1583199,38,30,1975,5,"male",160,173,164,10,30,10,21,0,9
1583210,103,3,1910,11,"male",751,194,136,49,25,49,25,0,0
1583257,27,5,1986,6,"male",368,68,59,0,3,0,3,0,0
1583270,16,2,1997,2,"male",162,33,27,29,24,29,11,0,13
1583281,18,2,1995,11,"female",523,603,408,330,765,315,643,15,122
1583300,34,22,1979,1,"female",509,1,0,8,4,8,4,0,0
1583345,19,2,1994,7,"male",237,231,189,8,5,8,4,0,1
1583347,27,3,1986,4,"female",123,40,35,3379,2468,3379,364,0,2104
1583348,24,4,1989,2,"male",387,129,58,200,97,0,7,200,90
1583353,43,18,1970,2,"male",1397,50,13,0,0,0,0,0,0
1583366,33,9,1980,7,"female",425,1,1,0,0,0,0,0,0
1583382,42,10,1971,9,"male",641,50,17,61,55,61,35,0,20
1583405,17,5,1996,10,"male",502,218,101,2,4,2,4,0,0
1583419,41,27,1972,9,"female",303,40,29,260,327,252,168,8,159
1583421,17,8,1996,11,"male",485,1343,1130,2239,805,2239,515,0,290
1583429,64,29,1949,10,"female",413,7,7,4,0,4,0,0,0
1583435,29,20,1984,9,"female",6,0,0,0,0,0,0,0,0
1583476,62,28,1951,10,"male",1618,91,35,0,4,0,0,0,4
1583480,24,11,1989,1,"female",216,0,0,0,0,0,0,0,0
1583481,16,16,1997,3,"male",181,18,17,0,0,0,0,0,0
1583496,26,24,1987,12,"male",65,10,9,0,0,0,0,0,0
1583508,16,28,1997,10,"male",548,327,203,4,1,0,1,4,0
1583527,29,25,1984,2,"male",105,33,27,6,45,6,34,0,11
1583548,43,19,1970,6,"male",532,365,133,23,31,4,29,19,2
1583563,23,7,1990,5,"male",1406,455,310,2,6,2,5,0,1
1583567,78,20,1935,3,"male",2221,31,17,5,1,2,0,3,1
1583618,19,2,1994,2,"male",403,34,23,0,7,0,7,0,0
1583621,49,24,1964,1,"male",543,228,145,66,22,7,10,59,12
1583627,41,27,1972,9,"female",464,89,47,0,0,0,0,0,0
1583638,20,16,1993,3,"male",362,350,209,91,46,60,29,31,17
1583642,73,24,1940,5,"female",1079,224,150,2390,30,1,3,2389,27
1583662,62,26,1951,7,"male",1049,219,201,48,9,48,7,0,2
1583672,51,10,1962,7,"male",992,139,79,73,136,57,71,16,65
1583680,23,3,1990,9,"male",399,190,115,9,33,9,29,0,4
1583695,47,18,1966,5,"female",390,82,72,188,117,188,87,0,30
1583710,47,31,1966,5,"male",1375,122,61,6,2,0,1,6,1
1583717,45,25,1968,4,"male",302,8,4,18,29,2,8,16,21
1583739,16,31,1997,12,"female",359,281,177,0,0,0,0,0,0
1583763,28,14,1985,8,"female",525,95,64,89,164,89,125,0,39
1583782,59,3,1954,11,"male",971,15,9,0,1,0,0,0,1
1583806,18,19,1995,12,"female",945,175,101,85,107,67,69,18,38
1583807,20,22,1993,10,"female",157,1,0,0,0,0,0,0,0
1583822,32,14,1981,9,"female",438,78,64,99,80,99,76,0,4
1583851,32,1,1981,1,"male",1042,30,25,0,5,0,3,0,2
1583884,14,12,1999,12,"female",97,267,96,0,0,0,0,0,0
1583920,39,31,1974,8,"male",371,80,57,0,0,0,0,0,0
1583941,34,20,1979,12,"male",211,97,68,19,84,19,62,0,22
1583947,24,9,1989,4,"male",348,50,35,0,26,0,22,0,4
1583962,24,6,1989,1,"female",43,31,5,68,27,68,27,0,0
1583968,25,4,1988,4,"male",574,90,35,52,14,52,10,0,4
1583990,21,4,1992,5,"female",633,32,11,11,3,11,2,0,1
1584009,20,24,1993,3,"male",309,7,0,0,0,0,0,0,0
1584041,19,11,1994,10,"female",620,433,305,2,5,2,5,0,0
1584062,18,14,1995,7,"male",761,101,33,2,2,0,0,2,2
1584066,100,15,1913,5,"male",1100,620,226,51,21,37,12,14,9
1584095,40,28,1973,4,"male",160,1,0,0,0,0,0,0,0
1584118,46,15,1967,2,"female",445,79,42,122,166,122,63,0,103
1584148,14,31,1999,1,"female",331,277,200,334,107,45,74,289,33
1584158,50,4,1963,3,"female",68,10,9,4,3,4,3,0,0
1584184,14,26,1999,9,"female",334,200,158,282,21,282,19,0,2
1584204,23,18,1990,6,"female",1394,370,204,142,100,134,44,8,56
1584208,19,19,1994,7,"female",562,2473,557,82,223,82,210,0,13
1584246,23,25,1990,3,"female",583,205,85,17,1,17,1,0,0
1584274,32,8,1981,12,"male",6,9,5,0,0,0,0,0,0
1584279,66,15,1947,12,"female",635,1,0,0,0,0,0,0,0
1584297,28,20,1985,12,"male",1544,4,4,0,0,0,0,0,0
1584299,29,23,1984,11,"male",259,56,48,13,0,13,0,0,0
1584301,28,10,1985,6,"female",653,47,34,1,0,1,0,0,0
1584310,54,14,1959,2,"female",493,263,185,636,90,636,38,0,52
1584312,55,22,1958,6,"male",1061,149,61,0,3,0,0,0,3
1584317,54,23,1959,6,"female",168,53,27,45,110,45,82,0,28
1584322,37,8,1976,5,"male",302,0,0,0,0,0,0,0,0
1584330,19,26,1994,4,"male",960,1482,1375,116,152,24,120,92,32
1584356,15,12,1998,7,"female",364,407,312,65,3,65,3,0,0
1584370,27,19,1986,11,"female",165,17,1,2,1,2,1,0,0
1584378,26,13,1987,10,"male",474,23,20,18,0,0,0,18,0
1584397,13,9,2000,2,"female",15,869,569,825,3228,119,1638,706,1590
1584398,23,30,1990,3,"male",644,60,19,2,0,0,0,2,0
1584403,44,31,1969,3,"female",435,64,56,2,7,2,7,0,0
1584409,55,3,1958,1,"female",1347,369,115,2701,1488,2701,1290,0,198
1584411,33,14,1980,10,"male",341,250,157,321,186,321,135,0,51
1584414,84,5,1929,9,"male",1460,768,319,6,14,2,8,4,6
1584421,21,14,1992,5,"male",400,58,53,1,0,1,0,0,0
1584436,15,21,1998,4,"male",477,17,14,0,2,0,1,0,1
1584442,71,14,1942,7,"male",157,13,4,5,2,5,0,0,2
1584444,21,6,1992,8,"male",160,54,29,155,116,0,45,155,71
1584468,36,5,1977,6,"female",152,23,12,1,2,1,2,0,0
1584472,59,10,1954,10,"male",225,37,32,0,0,0,0,0,0
1584484,33,1,1980,1,"male",33,0,0,0,0,0,0,0,0
1584493,26,8,1987,5,"female",532,6,5,2,0,0,0,2,0
1584501,103,26,1910,9,"male",1309,493,259,26,0,26,0,0,0
1584517,36,16,1977,4,"female",1459,76,32,40,18,40,12,0,6
1584528,18,9,1995,1,"male",404,11,10,0,0,0,0,0,0
1584532,27,25,1986,8,"male",755,43,21,7,16,7,11,0,5
1584536,28,29,1985,10,"male",287,33,14,94,36,94,33,0,3
1584538,17,29,1996,8,"male",1088,4524,2610,505,1111,168,383,337,728
1584541,31,8,1982,4,"male",111,17,9,2,6,2,3,0,3
1584577,71,7,1942,5,"male",258,2,2,0,2,0,0,0,2
1584587,37,10,1976,11,"female",367,251,107,1068,926,823,665,245,261
1584595,16,1,1997,4,"male",736,355,175,55,33,47,31,8,2
1584607,59,28,1954,9,"female",857,74,39,14,11,0,3,14,8
1584608,51,18,1962,3,"male",1744,40,26,916,563,901,461,15,102
1584614,23,3,1990,7,"male",420,31,24,6,0,6,0,0,0
1584637,15,1,1998,10,"male",27,0,0,0,0,0,0,0,0
1584682,25,31,1988,12,"male",252,205,195,27,5,14,1,13,4
1584697,91,23,1922,3,"male",422,332,177,429,282,0,232,429,50
1584698,52,11,1961,2,"female",583,142,84,17,6,17,4,0,2
1584784,60,1,1953,3,"male",1341,416,351,25,14,25,13,0,1
1584797,24,6,1989,10,"female",762,121,73,130,79,130,74,0,5
1584810,69,8,1944,8,"male",986,57,33,36,6,0,5,36,1
1584823,25,25,1988,7,"female",536,83,55,0,51,0,12,0,39
1584838,23,13,1990,6,"male",145,19,13,6,3,6,2,0,1
1584862,61,22,1952,4,"male",397,28,7,11,10,11,5,0,5
1584870,20,21,1993,3,"male",135,48,46,0,0,0,0,0,0
1584882,52,27,1961,12,"male",138,23,16,919,380,0,326,919,54
1584883,55,12,1958,5,"female",789,27,15,9,3,0,1,9,2
1584885,18,11,1995,2,"male",242,41,41,0,0,0,0,0,0
1584887,68,11,1945,5,"male",1276,69,10,83,20,0,8,83,12
1584899,67,14,1946,12,"male",152,4,4,0,0,0,0,0,0
1584900,19,18,1994,12,"male",603,233,154,50,9,26,7,24,2
1584920,29,17,1984,1,"male",512,569,412,919,859,911,641,8,218
1584922,38,3,1975,11,"male",45,17,16,3,1,3,1,0,0
1584996,25,1,1988,1,"male",130,290,153,70,52,70,43,0,9
1585007,48,9,1965,3,"female",919,171,115,360,728,209,206,151,522
1585068,61,26,1952,11,"male",1618,59,23,49,5,49,4,0,1
1585096,42,10,1971,4,"male",588,23,8,12,3,0,1,12,2
1585109,42,29,1971,6,"male",1371,288,148,12,14,12,12,0,2
1585114,63,27,1950,9,"female",385,91,46,17,4,17,2,0,2
1585138,14,11,1999,3,"female",505,697,208,445,777,82,554,363,223
1585141,22,20,1991,9,"male",381,67,30,11,1,0,1,11,0
1585195,62,16,1951,4,"female",914,13,6,96,39,0,26,96,13
1585210,85,13,1928,11,"male",1709,170,97,355,273,355,219,0,54
1585222,58,9,1955,3,"male",640,23,14,0,0,0,0,0,0
1585228,18,4,1995,4,"female",761,733,310,136,45,136,37,0,8
1585231,23,2,1990,6,"female",139,14,11,2,1,2,1,0,0
1585249,30,28,1983,11,"female",587,149,41,0,0,0,0,0,0
1585283,25,12,1988,11,"male",228,11,11,0,0,0,0,0,0
1585306,19,12,1994,9,"male",320,206,162,1193,35,1182,10,11,25
1585336,21,1,1992,12,"male",392,227,162,10,29,0,10,10,19
1585347,38,26,1975,12,"male",666,55,43,19,38,19,32,0,6
1585357,17,9,1996,9,"female",407,251,140,164,396,158,182,6,214
1585368,35,29,1978,10,"female",310,131,72,49,36,0,11,49,25
1585386,30,12,1983,11,"male",43,49,48,312,15,312,14,0,1
1585395,26,10,1987,7,"male",83,41,36,0,0,0,0,0,0
1585401,19,19,1994,6,"male",211,230,116,153,46,153,44,0,2
1585438,71,12,1942,6,"male",619,44,19,134,64,0,13,134,51
1585489,21,19,1992,11,"male",654,449,316,57,61,57,27,0,34
1585506,64,2,1949,7,"female",512,8,6,52,5,0,0,52,5
1585524,31,9,1982,8,"male",160,37,24,1,8,1,4,0,4
1585532,26,28,1987,1,"male",456,177,112,4,14,4,11,0,3
1585544,106,21,1907,2,"male",1676,1139,688,106,76,99,60,7,16
1585571,19,24,1994,6,"female",709,274,79,2,69,2,61,0,8
1585592,22,19,1991,3,"male",517,958,919,0,50,0,29,0,21
1585602,25,15,1988,7,"female",248,21,18,309,55,285,47,24,8
1585608,20,15,1993,7,"male",145,436,376,71,107,20,40,51,67
1585614,41,22,1972,8,"female",442,17,16,1,1,1,1,0,0
1585620,46,4,1967,6,"female",165,830,503,12,46,12,34,0,12
1585635,43,20,1970,9,"female",261,23,22,188,102,39,60,149,42
1585654,65,16,1948,6,"male",1240,15,4,0,0,0,0,0,0
1585675,23,21,1990,5,"male",109,98,91,0,0,0,0,0,0
1585676,48,25,1965,7,"male",378,30,24,25,11,0,0,25,11
1585717,27,24,1986,11,"male",67,3,2,5,6,5,5,0,1
1585740,80,12,1933,5,"male",1853,457,203,32,14,0,5,32,9
1585746,43,1,1970,11,"male",665,599,372,31,395,9,100,22,295
1585761,25,8,1988,2,"female",250,63,50,534,314,531,125,3,189
1585767,59,4,1954,3,"female",230,25,23,1,1,1,1,0,0
1585777,17,23,1996,4,"female",664,2517,508,1542,3212,1302,544,240,2668
1585789,17,7,1996,1,"female",291,247,144,29,87,20,45,9,42
1585793,31,11,1982,2,"female",166,89,71,480,147,480,141,0,6
1585875,17,13,1996,11,"male",333,86,41,0,0,0,0,0,0
1585881,23,23,1990,2,"female",230,24,12,1,6,1,4,0,2
1585884,14,14,1999,9,"male",240,132,98,4,0,0,0,4,0
1585904,68,25,1945,6,"female",275,7,4,85,33,0,19,85,14
1585941,23,1,1990,8,"male",375,64,48,47,4,47,4,0,0
1585963,57,3,1956,11,"female",1767,250,144,1844,619,1731,398,113,221
1586000,113,3,1900,8,"female",1533,250,102,41,11,0,7,41,4
1586020,28,9,1985,1,"male",829,215,107,6,7,6,5,0,2
1586029,24,18,1989,11,"male",402,196,139,50,57,50,47,0,10
1586037,55,3,1958,3,"female",1116,121,70,422,616,422,430,0,186
1586049,24,20,1989,10,"female",228,263,42,1,3,1,3,0,0
1586058,13,8,2000,5,"male",69,43,38,1,0,1,0,0,0
1586091,61,13,1952,6,"male",1718,91,18,0,0,0,0,0,0
1586129,31,16,1982,10,"male",689,535,407,47,70,47,64,0,6
1586132,16,9,1997,3,"male",88,20,16,11,2,11,2,0,0
1586142,15,28,1998,8,"male",70,39,26,280,48,280,47,0,1
1586157,23,1,1990,2,"male",545,421,367,0,63,0,27,0,36
1586191,39,20,1974,2,"male",404,223,136,424,443,424,340,0,103
1586204,69,3,1944,12,"female",260,62,15,136,158,136,136,0,22
1586212,51,22,1962,10,"female",285,32,20,30,42,4,12,26,30
1586227,26,4,1987,4,"male",314,99,63,58,24,58,21,0,3
1586238,18,14,1995,4,"male",329,23,20,14,1,14,1,0,0
1586294,51,24,1962,6,"female",120,28,18,159,54,59,34,100,20
1586298,23,12,1990,7,"male",254,43,30,0,0,0,0,0,0
1586331,28,3,1985,2,"male",559,112,53,3,1,3,1,0,0
1586350,20,13,1993,10,"male",826,1119,825,128,237,127,155,1,82
1586351,21,25,1992,7,"female",624,4,0,1,1,0,0,1,1
1586355,34,4,1979,12,"male",219,140,137,1,0,0,0,1,0
1586387,37,11,1976,3,"male",2122,127,56,16,11,15,8,1,3
1586404,26,1,1987,1,"male",159,83,76,0,0,0,0,0,0
1586420,103,3,1910,9,"female",1672,582,355,1091,444,663,204,428,240
1586431,61,16,1952,5,"male",1766,216,68,10,13,0,9,10,4
1586465,57,19,1956,3,"male",1062,44,18,1014,19,1014,13,0,6
1586478,69,21,1944,9,"male",1767,183,71,41,5,40,2,1,3
1586502,29,17,1984,6,"male",20,2,0,0,0,0,0,0,0
1586503,92,1,1921,11,"male",461,226,74,142,41,84,24,58,17
1586529,26,1,1987,1,"male",324,51,1,0,4,0,3,0,1
1586534,52,27,1961,11,"male",1110,40,23,7,0,7,0,0,0
1586544,16,7,1997,1,"female",408,58,32,10,0,10,0,0,0
1586552,24,11,1989,6,"male",418,141,96,1,0,0,0,1,0
1586579,41,10,1972,2,"male",162,22,13,9,4,0,0,9,4
1586581,20,16,1993,4,"male",563,297,187,17,23,12,17,5,6
1586599,28,1,1985,3,"female",168,47,42,751,467,0,19,751,448
1586611,15,16,1998,11,"male",583,70,21,0,13,0,4,0,9
1586615,38,4,1975,7,"male",419,139,134,1,0,1,0,0,0
1586623,24,9,1989,2,"male",454,47,2,2,0,2,0,0,0
1586633,21,8,1992,4,"male",207,241,182,250,191,157,104,93,87
1586651,24,12,1989,1,"female",19,11,10,4,5,4,5,0,0
1586664,21,4,1992,3,"male",756,1,0,0,0,0,0,0,0
1586714,41,19,1972,11,"male",472,122,94,13,2,13,2,0,0
1586726,47,27,1966,8,"female",1370,263,162,266,251,264,211,2,40
1586730,15,20,1998,6,"male",399,113,30,2,5,2,4,0,1
1586776,108,1,1905,1,"male",608,166,82,26,51,26,47,0,4
1586782,19,1,1994,11,"male",48,12,9,7,11,0,0,7,11
1586791,23,17,1990,2,"male",528,94,26,43,1,0,0,43,1
1586816,20,4,1993,4,"male",737,132,70,0,4,0,3,0,1
1586845,108,5,1905,6,"male",378,649,579,87,34,44,25,43,9
1586861,60,18,1953,4,"female",679,11,2,2,2,2,1,0,1
1586887,58,8,1955,5,"male",466,29,18,0,0,0,0,0,0
1586899,51,20,1962,2,"female",1831,316,106,358,213,153,101,205,112
1586910,74,3,1939,10,"male",1624,13,3,0,4,0,3,0,1
1586911,19,1,1994,1,"male",31,15,7,42,18,42,12,0,6
1586925,103,10,1910,10,"female",734,180,72,71,51,71,49,0,2
1586932,15,30,1998,1,"male",530,211,91,0,0,0,0,0,0
1586940,59,28,1954,11,"female",945,92,32,32,11,0,2,32,9
1586945,26,18,1987,11,"male",498,1,1,11,1,0,0,11,1
1586964,25,29,1988,9,"male",752,60,21,1,0,1,0,0,0
1586979,23,9,1990,3,"male",239,212,183,11,47,11,30,0,17
1586990,20,2,1993,3,"male",220,175,97,20,5,14,5,6,0
1587019,23,12,1990,7,"male",115,13,13,1,1,0,0,1,1
1587080,108,8,1905,4,"female",363,86,24,0,1,0,1,0,0
1587108,26,20,1987,5,"female",407,29,9,1,10,1,10,0,0
1587113,22,16,1991,7,"male",1095,309,165,34,4,28,2,6,2
1587124,18,21,1995,12,"male",231,201,141,21,5,8,4,13,1
1587163,38,4,1975,5,"male",1123,141,62,0,0,0,0,0,0
1587171,76,17,1937,6,"female",270,99,76,125,24,125,15,0,9
1587180,44,19,1969,3,"male",161,28,20,342,75,342,33,0,42
1587202,61,2,1952,2,"female",900,42,11,8,10,8,8,0,2
1587240,15,14,1998,3,"female",104,229,188,7,0,7,0,0,0
1587259,78,9,1935,5,"male",469,0,0,0,0,0,0,0,0
1587270,36,23,1977,1,"male",1476,14,10,126,23,122,3,4,20
1587294,19,17,1994,1,"female",358,259,144,1104,395,834,279,270,116
1587320,14,7,1999,3,"female",84,69,47,21,28,21,23,0,5
1587356,65,22,1948,2,"female",287,37,32,0,0,0,0,0,0
1587366,19,17,1994,1,"male",129,66,59,0,0,0,0,0,0
1587392,20,5,1993,4,"male",568,111,58,2,2,2,1,0,1
1587400,33,4,1980,9,"female",575,546,446,356,269,265,188,91,81
1587425,19,1,1994,1,"female",391,30,17,3,0,0,0,3,0
1587463,18,5,1995,2,"male",80,113,68,141,44,141,35,0,9
1587479,23,7,1990,7,"male",239,16,6,0,0,0,0,0,0
1587481,18,19,1995,8,"male",130,49,38,26,18,26,18,0,0
1587485,14,28,1999,11,"male",267,50,28,38,1,0,0,38,1
1587493,24,21,1989,12,"female",41,20,10,1,10,1,10,0,0
1587507,33,28,1980,7,"female",658,162,29,509,549,278,390,231,159
1587547,18,18,1995,10,"female",69,68,46,122,173,80,143,42,30
1587550,28,15,1985,8,"male",574,281,231,128,22,128,22,0,0
1587564,24,10,1989,7,"male",718,78,39,5,53,0,3,5,50
1587583,100,6,1913,11,"female",1591,164,92,41,99,40,57,1,42
1587594,46,27,1967,1,"female",371,145,94,481,199,481,154,0,45
1587600,27,1,1986,1,"male",712,145,109,51,21,51,21,0,0
1587603,16,9,1997,4,"male",427,634,483,629,475,244,190,385,285
1587643,36,13,1977,5,"female",258,13,11,2,0,0,0,2,0
1587659,21,14,1992,7,"male",598,29,14,1,0,0,0,1,0
1587661,18,17,1995,5,"male",130,325,300,1,0,1,0,0,0
1587675,65,25,1948,4,"male",279,5,4,1,0,0,0,1,0
1587692,100,25,1913,11,"female",1108,229,77,5,10,5,8,0,2
1587714,108,1,1905,1,"male",2392,207,107,85,15,0,11,85,4
1587755,14,27,1999,1,"female",39,209,151,763,1324,224,843,539,481
1587765,52,18,1961,12,"male",233,78,58,46,28,46,4,0,24
1587794,26,1,1987,2,"male",587,94,76,13,0,13,0,0,0
1587822,18,29,1995,12,"female",9,25,12,4,1,0,1,4,0
1587839,35,1,1978,1,"male",123,78,59,76,23,76,22,0,1
1587864,35,19,1978,10,"female",744,16,13,18,24,18,15,0,9
1587869,26,28,1987,4,"female",382,30,9,0,0,0,0,0,0
1587889,16,14,1997,2,"male",276,1107,364,30,62,30,35,0,27
1587914,20,4,1993,4,"female",535,11,5,0,0,0,0,0,0
1587929,33,29,1980,1,"male",139,50,36,2,17,2,8,0,9
1587930,34,2,1979,1,"male",766,71,47,4,0,4,0,0,0
1587949,59,21,1954,3,"male",1246,272,120,21,449,14,79,7,370
1587951,32,28,1981,1,"male",254,52,38,2,3,2,1,0,2
1588004,15,13,1998,4,"male",328,784,322,40,59,40,49,0,10
1588025,103,1,1910,1,"male",1559,267,127,44,69,43,57,1,12
1588033,21,14,1992,9,"male",425,134,70,26,5,26,2,0,3
1588092,26,1,1987,1,"male",207,43,22,476,45,476,35,0,10
1588096,23,28,1990,12,"female",444,294,196,1,0,1,0,0,0
1588130,20,13,1993,3,"male",180,143,123,3,19,3,13,0,6
1588159,23,13,1990,1,"female",280,228,171,4,32,1,12,3,20
1588187,46,6,1967,7,"female",412,112,78,69,109,69,94,0,15
1588240,53,4,1960,4,"male",894,452,239,1,1,1,1,0,0
1588263,19,27,1994,5,"female",192,90,57,212,103,169,36,43,67
1588265,42,19,1971,3,"female",1145,207,129,200,290,176,223,24,67
1588297,18,27,1995,7,"male",243,11,9,1,0,1,0,0,0
1588314,26,27,1987,12,"male",386,32,31,1,0,1,0,0,0
1588328,18,25,1995,9,"male",542,134,119,27,3,27,2,0,1
1588355,40,19,1973,10,"female",473,35,15,20,0,20,0,0,0
1588374,23,1,1990,5,"male",63,3,2,0,0,0,0,0,0
1588393,20,10,1993,8,"female",406,399,106,338,171,338,125,0,46
1588404,34,13,1979,2,"male",313,236,175,9,2,9,2,0,0
1588406,28,30,1985,10,"female",606,34,5,0,0,0,0,0,0
1588409,52,25,1961,4,"male",1481,92,13,1,2,1,0,0,2
1588425,59,18,1954,10,"male",1003,63,34,95,6,16,0,79,6
1588457,22,1,1991,4,"female",404,211,25,79,143,79,22,0,121
1588459,23,18,1990,1,"male",246,160,93,47,10,47,8,0,2
1588493,22,4,1991,4,"male",480,1097,109,20,35,0,6,20,29
1588526,32,16,1981,4,"male",641,180,153,91,9,46,6,45,3
1588536,47,21,1966,6,"female",460,9,6,1,1,0,1,1,0
1588550,44,21,1969,10,"male",93,82,72,42,117,21,82,21,35
1588567,30,12,1983,8,"male",233,32,15,2,1,2,0,0,1
1588586,16,28,1997,1,"female",236,243,1,0,0,0,0,0,0
1588587,21,17,1992,3,"male",51,53,22,3,2,3,2,0,0
1588594,28,12,1985,1,"male",292,9,5,17,12,17,7,0,5
1588613,14,11,1999,7,"male",295,57,41,10,32,10,15,0,17
1588653,74,10,1939,7,"female",582,29,20,5,1,5,1,0,0
1588662,26,20,1987,12,"female",625,53,30,8,0,8,0,0,0
1588673,17,26,1996,3,"male",615,1201,939,982,664,885,377,97,287
1588674,83,29,1930,9,"male",1399,1130,460,4,0,0,0,4,0
1588731,18,29,1995,6,"male",236,456,63,12,35,10,20,2,15
1588737,14,21,1999,1,"male",536,171,118,46,5,46,3,0,2
1588744,103,5,1910,5,"female",1691,2067,475,122,327,122,276,0,51
1588750,50,16,1963,4,"female",649,272,190,2,3,0,1,2,2
1588775,21,10,1992,10,"male",62,178,166,1,2,1,1,0,1
1588809,16,10,1997,2,"female",206,71,20,15,8,15,8,0,0
1588813,23,28,1990,9,"male",949,530,362,1,28,1,24,0,4
1588814,49,15,1964,7,"male",383,66,60,1,2,1,2,0,0
1588831,17,28,1996,11,"female",373,120,66,0,0,0,0,0,0
1588841,44,10,1969,11,"female",393,6,1,0,0,0,0,0,0
1588846,57,16,1956,9,"female",1476,102,65,996,471,11,260,985,211
1588856,24,7,1989,10,"male",951,293,175,3,3,3,2,0,1
1588944,23,15,1990,12,"female",9,10,10,0,0,0,0,0,0
1588952,21,26,1992,9,"female",70,9,4,5,1,5,1,0,0
1588965,15,9,1998,11,"male",361,467,387,4,36,4,34,0,2
1588980,66,13,1947,9,"female",1267,44,23,182,20,182,15,0,5
1588987,93,17,1920,6,"female",1683,114,72,34,28,0,14,34,14
1589010,19,13,1994,11,"male",271,393,255,151,158,151,78,0,80
1589051,18,17,1995,4,"female",239,390,161,421,392,409,342,12,50
1589062,18,3,1995,1,"male",296,430,89,0,10,0,8,0,2
1589076,38,12,1975,11,"male",501,1,1,0,0,0,0,0,0
1589087,60,1,1953,12,"male",326,36,28,1,1,1,1,0,0
1589099,21,6,1992,2,"male",360,242,229,81,1,81,1,0,0
1589128,54,30,1959,5,"female",588,202,141,0,0,0,0,0,0
1589151,18,11,1995,7,"female",529,375,162,1750,545,1750,277,0,268
1589155,103,19,1910,5,"male",478,158,107,2,2,2,2,0,0
1589167,24,31,1989,10,"female",63,27,7,11,8,11,7,0,1
1589247,32,20,1981,8,"female",852,398,229,139,96,93,45,46,51
1589262,19,27,1994,1,"male",234,408,234,52,77,51,72,1,5
1589311,113,25,1900,10,"male",1586,75,37,212,28,107,9,105,19
1589335,40,8,1973,8,"male",738,118,101,0,1,0,0,0,1
1589352,51,13,1962,5,"male",1253,35,16,2,1,0,1,2,0
1589366,33,16,1980,3,"female",389,62,49,30,5,30,1,0,4
1589370,21,11,1992,2,"male",158,23,13,2,0,2,0,0,0
1589384,16,27,1997,11,"female",343,439,289,84,89,83,49,1,40
1589394,40,19,1973,10,"female",442,3,2,0,0,0,0,0,0
1589409,16,27,1997,7,"male",114,10,9,0,0,0,0,0,0
1589417,26,18,1987,10,"female",428,49,31,285,117,250,82,35,35
1589457,29,16,1984,8,"male",7,1,1,9,10,0,0,9,10
1589461,24,5,1989,6,"male",100,24,20,0,33,0,9,0,24
1589467,48,14,1965,9,"female",660,33,3,8,2,8,1,0,1
1589468,35,16,1978,4,"male",2,12,11,2,2,0,1,2,1
1589493,21,1,1992,12,"male",558,326,160,46,277,46,130,0,147
1589495,39,29,1974,3,"female",431,7,3,0,0,0,0,0,0
1589507,51,12,1962,3,"female",517,47,30,500,348,414,239,86,109
1589512,108,9,1905,3,"male",1328,148,18,12,23,3,15,9,8
1589526,25,13,1988,12,"male",803,141,76,31,49,8,9,23,40
1589528,30,12,1983,9,"male",341,155,146,1,0,1,0,0,0
1589556,60,3,1953,10,"male",826,73,41,254,11,254,10,0,1
1589571,101,1,1912,1,"male",977,35,25,1,12,1,6,0,6
1589572,33,2,1980,4,"male",633,25,13,2,0,0,0,2,0
1589576,21,4,1992,12,"female",100,21,17,4028,4589,3779,1652,249,2937
1589623,31,1,1982,1,"male",78,76,50,233,123,233,107,0,16
1589626,58,6,1955,12,"female",659,126,68,113,141,8,43,105,98
1589649,26,10,1987,12,"male",97,90,87,14,2,14,1,0,1
1589650,23,8,1990,12,"male",999,31,18,0,0,0,0,0,0
1589658,16,1,1997,8,"female",206,408,218,1737,1480,1724,845,13,635
1589659,108,25,1905,3,"female",44,125,116,246,150,91,71,155,79
1589663,23,12,1990,4,"female",624,700,332,1480,2149,890,612,590,1537
1589681,21,19,1992,12,"male",71,2,2,3,7,3,7,0,0
1589690,26,10,1987,11,"male",481,54,36,37,4,37,2,0,2
1589696,35,14,1978,9,"male",743,83,31,163,153,163,123,0,30
1589726,68,19,1945,5,"male",445,4,4,0,0,0,0,0,0
1589729,27,28,1986,11,"female",470,25,21,0,0,0,0,0,0
1589730,26,19,1987,7,"female",367,24,14,0,0,0,0,0,0
1589742,103,18,1910,1,"male",311,331,280,5,1,5,1,0,0
1589759,49,24,1964,1,"male",484,83,15,0,0,0,0,0,0
1589774,60,20,1953,8,"female",1803,21,12,126,2,126,2,0,0
1589792,18,20,1995,1,"female",352,493,194,99,142,0,63,99,79
1589801,108,1,1905,1,"male",1131,12,7,6,4,0,2,6,2
1589819,30,14,1983,2,"male",303,10,9,0,0,0,0,0,0
1589822,23,1,1990,1,"male",885,32,16,0,0,0,0,0,0
1589830,20,2,1993,11,"female",384,730,550,520,50,470,38,50,12
1589839,31,4,1982,5,"male",484,138,114,3,1,3,1,0,0
1589851,108,18,1905,2,"male",1539,4632,931,1,428,1,325,0,103
1589869,31,12,1982,11,"female",232,256,199,38,69,38,43,0,26
1589877,27,2,1986,6,"female",12,76,71,0,0,0,0,0,0
1589898,102,21,1911,6,"female",155,341,276,599,157,599,132,0,25
1589929,19,25,1994,12,"female",424,1,1,0,0,0,0,0,0
1589983,32,10,1981,2,"male",1670,276,79,11,19,5,4,6,15
1589996,16,25,1997,1,"male",411,490,437,134,80,85,34,49,46
1590028,100,1,1913,1,"female",38,13,12,13,5,13,1,0,4
1590032,68,25,1945,12,"female",1449,142,112,1,8,1,8,0,0
1590067,67,18,1946,9,"male",294,77,51,2,14,2,8,0,6
1590086,66,1,1947,10,"female",728,83,20,9,3,1,2,8,1
1590103,20,27,1993,12,"female",1356,4767,2061,791,6077,746,3769,45,2308
1590121,16,19,1997,11,"female",233,1324,726,938,2010,147,748,791,1262
1590129,17,4,1996,12,"female",158,256,195,11,12,11,12,0,0
1590203,21,7,1992,4,"female",419,245,150,218,301,218,232,0,69
1590209,18,23,1995,6,"male",413,361,325,124,8,55,2,69,6
1590229,27,20,1986,8,"male",78,33,27,31,3,31,1,0,2
1590233,36,4,1977,5,"male",1349,65,27,2,1,1,1,1,0
1590238,18,25,1995,5,"male",107,55,53,0,1,0,1,0,0
1590247,38,29,1975,8,"male",316,53,32,0,22,0,0,0,22
1590290,22,1,1991,1,"female",213,474,231,555,425,516,303,39,122
1590306,44,16,1969,4,"female",160,1,1,4,1,4,1,0,0
1590340,42,6,1971,9,"male",58,29,28,77,33,77,20,0,13
1590349,78,4,1935,6,"female",58,230,65,699,141,699,61,0,80
1590361,24,24,1989,11,"male",1087,358,196,33,49,33,44,0,5
1590366,67,4,1946,2,"male",2030,20,10,9,1,9,1,0,0
1590412,15,18,1998,12,"male",338,9,6,0,0,0,0,0,0
1590442,21,2,1992,9,"male",94,58,32,12,19,12,19,0,0
1590471,28,15,1985,3,"male",514,0,0,0,0,0,0,0,0
1590496,25,3,1988,3,"male",447,51,2,0,0,0,0,0,0
1590499,38,7,1975,7,"female",282,22,19,19,7,18,4,1,3
1590517,13,21,2000,6,"female",21,50,41,14,4,14,3,0,1
1590569,64,16,1949,4,"female",1208,40,23,12,5,12,3,0,2
1590590,17,4,1996,2,"male",167,431,342,2318,796,2318,553,0,243
1590601,29,6,1984,5,"male",529,138,77,22,19,0,2,22,17
1590627,42,20,1971,11,"female",641,967,383,2644,928,1076,337,1568,591
1590649,49,2,1964,3,"female",1565,78,36,311,439,179,258,132,181
1590659,16,7,1997,10,"male",432,363,127,242,185,231,119,11,66
1590670,61,27,1952,1,"female",369,15,10,100,25,100,22,0,3
1590707,53,14,1960,3,"male",598,249,217,289,123,0,37,289,86
1590723,16,9,1997,3,"female",461,121,49,72,2,71,2,1,0
1590733,44,2,1969,4,"male",298,196,131,18,49,15,31,3,18
1590738,27,9,1986,7,"male",776,17,12,0,1,0,0,0,1
1590761,20,4,1993,9,"female",613,542,301,74,304,74,194,0,110
1590765,20,31,1993,8,"female",427,576,69,339,647,339,595,0,52
1590768,15,2,1998,4,"male",348,562,38,11,39,11,24,0,15
1590779,59,27,1954,5,"male",1619,28,11,7,2,6,2,1,0
1590837,34,4,1979,1,"male",473,20,9,2,1,0,0,2,1
1590850,64,19,1949,1,"male",104,19,16,141,25,141,22,0,3
1590860,38,27,1975,12,"male",210,54,42,0,0,0,0,0,0
1590870,46,21,1967,6,"female",441,188,138,28,28,28,10,0,18
1590939,68,17,1945,12,"female",1480,320,170,7,13,7,12,0,1
1590943,21,26,1992,5,"male",120,108,91,3,3,3,3,0,0
1590957,36,25,1977,7,"female",439,46,28,268,112,268,104,0,8
1590984,15,20,1998,4,"male",188,60,40,2,0,0,0,2,0
1591009,51,13,1962,10,"female",425,185,126,0,4,0,3,0,1
1591019,28,22,1985,3,"male",389,0,0,0,0,0,0,0,0
1591031,18,15,1995,6,"male",711,599,466,18,0,16,0,2,0
1591063,16,1,1997,12,"female",249,261,160,15,7,0,7,15,0
1591074,18,7,1995,7,"male",737,317,261,33,14,33,8,0,6
1591083,23,30,1990,11,"female",905,86,72,1,0,1,0,0,0
1591101,15,8,1998,3,"male",342,36,22,22,0,22,0,0,0
1591132,51,12,1962,3,"female",776,100,73,0,5,0,1,0,4
1591170,17,28,1996,6,"male",176,206,147,0,4,0,3,0,1
1591195,15,21,1998,10,"male",388,191,55,10,87,10,41,0,46
1591220,28,16,1985,2,"male",296,58,41,40,39,7,11,33,28
1591246,42,5,1971,12,"male",143,290,252,43,17,43,16,0,1
1591260,29,4,1984,5,"male",670,128,44,5,190,5,154,0,36
1591266,30,16,1983,3,"male",48,43,42,1,0,1,0,0,0
1591277,43,19,1970,4,"female",270,55,14,38,28,38,19,0,9
1591315,17,3,1996,11,"male",239,116,74,63,37,63,10,0,27
1591321,17,1,1996,6,"female",377,224,95,1082,370,1000,162,82,208
1591323,26,8,1987,2,"male",492,97,54,13,11,3,5,10,6
1591344,25,9,1988,10,"male",75,56,33,0,0,0,0,0,0
1591356,24,8,1989,9,"male",572,405,310,28,6,28,6,0,0
1591357,57,31,1956,12,"female",926,65,26,19,13,3,5,16,8
1591381,81,27,1932,10,"female",1289,1786,1128,1938,680,1938,638,0,42
1591414,49,8,1964,7,"female",1192,42,14,9,10,2,9,7,1
1591455,42,13,1971,3,"male",209,146,91,0,5,0,1,0,4
1591508,47,3,1966,9,"male",420,9,8,2,0,2,0,0,0
1591510,38,18,1975,11,"male",174,19,17,0,0,0,0,0,0
1591516,17,19,1996,5,"male",779,292,186,280,427,57,302,223,125
1591518,100,1,1913,1,"male",2257,802,325,217,434,163,269,54,165
1591520,15,9,1998,3,"male",775,328,154,75,28,26,3,49,25
1591529,19,11,1994,2,"male",435,12,2,1,0,0,0,1,0
1591554,67,2,1946,3,"female",1561,123,57,37,39,37,22,0,17
1591602,39,23,1974,1,"male",86,5,1,0,0,0,0,0,0
1591618,20,7,1993,6,"male",798,296,200,439,32,439,24,0,8
1591621,30,26,1983,1,"female",792,23,7,5,0,5,0,0,0
1591623,23,15,1990,9,"male",882,192,53,3,4,0,1,3,3
1591624,18,8,1995,10,"male",506,1,1,58,4,0,1,58,3
1591653,19,15,1994,11,"male",288,21,10,2,1,1,0,1,1
1591658,24,1,1989,2,"male",165,31,23,0,0,0,0,0,0
1591707,47,22,1966,6,"female",211,1171,324,160,312,159,151,1,161
1591719,48,24,1965,1,"female",549,143,113,331,226,0,48,331,178
1591769,24,27,1989,6,"male",88,8,6,0,3,0,3,0,0
1591792,45,28,1968,1,"male",336,46,33,9,10,0,5,9,5
1591797,36,16,1977,8,"female",1701,625,327,716,288,715,205,1,83
1591809,42,20,1971,3,"male",430,163,116,0,0,0,0,0,0
1591836,62,10,1951,8,"female",1215,38,2,10,30,0,6,10,24
1591840,21,18,1992,9,"female",53,27,6,13,3,13,3,0,0
1591850,18,1,1995,3,"female",480,210,104,21,24,4,21,17,3
1591857,19,22,1994,9,"female",553,3014,584,1949,6011,1949,1897,0,4114
1591858,20,1,1993,1,"male",81,34,16,1,2,1,1,0,1
1591863,55,3,1958,10,"female",156,176,140,160,60,160,41,0,19
1591868,25,28,1988,9,"male",265,54,42,15,1,0,0,15,1
1591889,14,16,1999,9,"male",35,253,203,83,49,66,41,17,8
1591909,14,31,1999,5,"female",433,253,148,547,41,547,21,0,20
1591988,19,17,1994,4,"female",73,241,206,2359,1318,517,390,1842,928
1591998,18,15,1995,9,"male",151,123,111,9,0,0,0,9,0
1591999,64,17,1949,2,"male",1676,374,149,73,235,0,73,73,162
1592062,34,22,1979,5,"female",455,161,114,2,39,0,10,2,29
1592064,35,10,1978,12,"male",21,25,15,1,4,1,4,0,0
1592118,18,8,1995,5,"male",243,291,223,166,155,166,141,0,14
1592144,23,3,1990,5,"female",744,398,213,44,128,44,83,0,45
1592162,17,30,1996,11,"female",218,292,80,14,17,14,15,0,2
1592167,62,4,1951,5,"male",1499,244,166,373,320,348,86,25,234
1592178,16,30,1997,1,"male",800,1367,1045,292,2898,243,2228,49,670
1592180,16,14,1997,5,"male",742,2264,1669,663,1362,78,717,585,645
1592192,14,27,1999,6,"female",279,82,63,0,0,0,0,0,0
1592198,21,24,1992,6,"female",567,466,363,210,135,209,122,1,13
1592207,58,5,1955,2,"female",232,70,42,72,24,72,19,0,5
1592208,43,28,1970,11,"male",798,196,92,40,99,40,55,0,44
1592212,65,16,1948,10,"female",590,29,10,272,3,272,1,0,2
1592246,15,17,1998,8,"female",53,447,52,17,151,17,115,0,36
1592248,25,4,1988,4,"female",162,99,93,3,15,3,12,0,3
1592269,58,31,1955,7,"male",1312,31,15,3,33,1,0,2,33
1592279,47,31,1966,5,"female",452,63,35,3,10,0,5,3,5
1592333,16,11,1997,11,"male",195,38,12,0,14,0,14,0,0
1592352,15,17,1998,10,"male",248,98,74,4,2,4,2,0,0
1592354,23,7,1990,9,"female",254,111,68,73,41,73,23,0,18
1592366,17,26,1996,1,"male",530,791,568,926,203,926,194,0,9
1592382,35,7,1978,12,"male",645,59,16,21,4,21,4,0,0
1592420,13,22,2000,9,"female",203,260,65,1129,2155,60,450,1069,1705
1592490,19,4,1994,9,"male",569,100,68,17,0,8,0,9,0
1592498,15,28,1998,5,"male",471,218,67,63,36,63,22,0,14
1592499,15,17,1998,5,"female",243,154,95,50,0,4,0,46,0
1592500,22,25,1991,8,"female",337,36,24,1,2,1,2,0,0
1592541,65,10,1948,8,"male",546,57,44,7,5,0,3,7,2
1592556,22,28,1991,12,"male",391,13,12,0,0,0,0,0,0
1592579,21,8,1992,3,"female",360,126,29,4,6,4,5,0,1
1592582,54,5,1959,5,"female",1599,52,28,1477,858,28,234,1449,624
1592585,29,8,1984,11,"female",263,184,128,178,158,111,68,67,90
1592604,53,9,1960,5,"male",896,103,43,0,7,0,7,0,0
1592617,17,27,1996,3,"male",119,396,197,22,112,18,41,4,71
1592631,19,8,1994,12,"female",280,241,99,2,16,2,16,0,0
1592653,37,2,1976,10,"female",503,104,46,113,37,113,27,0,10
1592654,33,19,1980,4,"female",593,343,206,0,0,0,0,0,0
1592672,17,11,1996,6,"male",140,41,41,4,12,4,10,0,2
1592690,13,15,2000,1,"male",199,1,1,0,0,0,0,0,0
1592698,17,8,1996,3,"female",353,254,48,212,58,212,42,0,16
1592700,16,14,1997,6,"male",793,139,44,0,9,0,4,0,5
1592706,28,24,1985,1,"male",377,99,68,1,7,1,7,0,0
1592780,19,27,1994,11,"male",431,123,85,52,4,36,0,16,4
1592808,22,18,1991,12,"female",546,69,35,2,11,0,7,2,4
1592819,19,14,1994,4,"male",307,194,126,6,3,2,2,4,1
1592834,29,25,1984,12,"male",547,51,43,19,0,19,0,0,0
1592865,39,6,1974,9,"female",450,71,33,564,246,564,156,0,90
1592881,103,1,1910,2,"male",585,465,271,374,241,374,147,0,94
1592885,39,8,1974,8,"male",464,150,44,107,64,107,59,0,5
1592908,26,14,1987,2,"male",109,14,14,0,0,0,0,0,0
1592972,23,17,1990,4,"male",213,118,84,2,7,0,1,2,6
1592975,32,12,1981,5,"male",901,488,377,1,0,1,0,0,0
1592998,84,2,1929,9,"female",70,138,102,1558,1324,1558,909,0,415
1593010,18,9,1995,9,"female",234,463,200,341,376,149,278,192,98
1593022,23,26,1990,5,"male",249,107,80,3,12,3,6,0,6
1593052,26,1,1987,10,"male",15,1,1,2,0,0,0,2,0
1593073,63,29,1950,10,"female",206,51,23,1172,351,0,96,1172,255
1593118,18,20,1995,7,"female",609,701,509,492,534,438,288,54,246
1593135,25,1,1988,1,"male",260,103,64,40,127,40,30,0,97
1593178,33,11,1980,1,"male",618,2,2,0,2,0,0,0,2
1593201,19,5,1994,6,"male",324,189,97,21,55,21,54,0,1
1593209,32,30,1981,7,"male",416,30,14,2,20,2,18,0,2
1593210,14,30,1999,6,"male",168,55,47,1,0,0,0,1,0
1593214,40,1,1973,2,"male",302,68,47,114,41,114,17,0,24
1593234,45,12,1968,4,"female",650,28,10,703,125,8,19,695,106
1593238,18,30,1995,8,"female",221,250,162,351,281,309,137,42,144
1593248,108,27,1905,9,"female",848,174,70,58,4,0,4,58,0
1593253,18,16,1995,1,"male",101,50,44,1,0,1,0,0,0
1593263,27,17,1986,8,"male",899,1,1,1,1,0,0,1,1
1593285,68,21,1945,1,"female",861,21,8,16,0,16,0,0,0
1593292,26,20,1987,7,"male",116,58,47,175,269,175,253,0,16
1593301,29,25,1984,10,"female",550,28,14,0,0,0,0,0,0
1593308,20,12,1993,1,"male",465,256,151,13,53,9,50,4,3
1593309,18,7,1995,1,"female",208,766,340,1057,1925,459,580,598,1345
1593311,73,22,1940,5,"male",1602,31,8,0,0,0,0,0,0
1593328,38,15,1975,7,"male",326,54,42,0,9,0,0,0,9
1593354,30,25,1983,1,"female",169,69,21,266,19,266,14,0,5
1593359,47,27,1966,7,"male",151,0,0,0,0,0,0,0,0
1593372,67,11,1946,4,"female",114,24,20,0,0,0,0,0,0
1593386,28,8,1985,10,"male",431,1,1,0,0,0,0,0,0
1593450,51,17,1962,3,"male",243,45,36,21,8,21,5,0,3
1593452,60,1,1953,10,"female",384,17,9,137,55,0,30,137,25
1593455,43,7,1970,4,"male",598,36,16,0,1,0,0,0,1
1593499,46,2,1967,1,"male",635,26,16,1,0,0,0,1,0
1593502,44,8,1969,5,"male",165,101,60,16,5,0,1,16,4
1593539,74,22,1939,4,"female",190,45,37,1,1,0,1,1,0
1593573,31,30,1982,5,"male",484,237,176,44,3,44,3,0,0
1593622,38,17,1975,6,"male",303,0,0,0,0,0,0,0,0
1593635,38,21,1975,4,"female",591,150,95,1439,533,1439,452,0,81
1593660,43,2,1970,1,"male",23,6,4,5,6,5,6,0,0
1593682,18,25,1995,11,"male",40,61,54,138,101,138,66,0,35
1593714,48,19,1965,7,"male",1482,1003,737,421,2629,256,1423,165,1206
1593718,23,20,1990,1,"male",267,251,202,920,478,221,129,699,349
1593794,20,17,1993,8,"female",188,251,186,631,654,151,152,480,502
1593815,19,25,1994,1,"female",639,241,120,10,19,10,3,0,16
1593824,50,4,1963,7,"male",639,55,12,0,0,0,0,0,0
1593833,23,15,1990,4,"male",310,40,30,4,3,4,1,0,2
1593836,17,19,1996,10,"female",224,427,210,27,34,15,18,12,16
1593837,21,2,1992,8,"male",402,105,29,456,96,439,71,17,25
1593843,48,10,1965,7,"male",101,8,5,40,12,40,10,0,2
1593936,18,11,1995,2,"male",307,13,12,4,0,4,0,0,0
1593956,19,14,1994,2,"female",101,151,48,7,0,7,0,0,0
1593957,21,4,1992,4,"male",529,1135,837,375,362,375,251,0,111
1593971,26,14,1987,4,"male",179,12,10,1,0,1,0,0,0
1593990,41,10,1972,9,"male",286,42,33,0,0,0,0,0,0
1594000,94,11,1919,9,"male",2033,801,167,1,0,1,0,0,0
1594007,46,8,1967,3,"male",88,66,62,20,1,20,1,0,0
1594020,24,27,1989,11,"male",304,706,622,36,557,31,381,5,176
1594025,16,30,1997,12,"female",588,242,132,235,125,227,66,8,59
1594029,81,25,1932,12,"male",1518,10,6,1,0,0,0,1,0
1594049,38,1,1975,6,"male",418,43,42,3,1,3,0,0,1
1594055,29,26,1984,10,"male",50,140,129,2,2,2,2,0,0
1594058,83,23,1930,2,"female",1169,86,58,61,9,61,4,0,5
1594064,28,6,1985,3,"male",729,6,3,13,19,13,9,0,10
1594086,73,3,1940,4,"male",1734,44,18,21,7,0,4,21,3
1594107,52,3,1961,6,"female",1092,46,29,655,97,651,36,4,61
1594125,35,1,1978,2,"male",181,124,70,0,0,0,0,0,0
1594163,26,24,1987,9,"male",168,48,19,0,0,0,0,0,0
1594192,58,31,1955,3,"male",645,3,2,0,0,0,0,0,0
1594213,39,26,1974,9,"male",340,37,31,0,0,0,0,0,0
1594229,22,25,1991,11,"female",208,18,7,6,4,6,3,0,1
1594266,38,29,1975,12,"male",239,16,11,19,29,19,26,0,3
1594271,19,1,1994,1,"male",552,327,256,2,2,2,2,0,0
1594292,33,2,1980,9,"female",144,148,96,30,8,30,1,0,7
1594300,38,9,1975,9,"male",130,29,25,2,1,2,0,0,1
1594321,20,20,1993,10,"male",518,129,42,2,0,2,0,0,0
1594323,52,11,1961,10,"female",234,56,26,4,4,4,1,0,3
1594332,35,7,1978,3,"male",475,34,20,11,0,11,0,0,0
1594335,33,1,1980,12,"male",621,133,59,8,69,2,25,6,44
1594358,26,1,1987,1,"male",499,21,21,0,0,0,0,0,0
1594414,55,27,1958,2,"male",957,20,9,3,2,0,0,3,2
1594432,30,6,1983,10,"male",44,6,4,8,7,8,3,0,4
1594489,27,11,1986,9,"female",399,21,13,10,8,10,4,0,4
1594490,95,22,1918,8,"male",1737,436,242,3258,1088,128,506,3130,582
1594516,25,18,1988,4,"male",21,0,0,0,0,0,0,0,0
1594517,107,22,1906,5,"male",242,0,0,0,0,0,0,0,0
1594531,52,11,1961,3,"female",665,416,161,233,495,233,230,0,265
1594534,61,20,1952,9,"male",1323,219,128,17,122,17,88,0,34
1594543,100,12,1913,10,"male",1811,16,8,2,1,0,1,2,0
1594628,38,6,1975,6,"male",38,57,46,1,0,1,0,0,0
1594645,22,12,1991,7,"female",255,102,51,89,54,88,29,1,25
1594649,14,24,1999,7,"male",71,26,15,7,6,5,6,2,0
1594673,56,12,1957,10,"female",82,62,57,8,10,8,8,0,2
1594680,56,22,1957,10,"male",639,12,6,4,6,0,4,4,2
1594704,23,10,1990,7,"female",387,353,147,77,61,19,33,58,28
1594715,100,21,1913,8,"male",390,495,385,187,261,187,206,0,55
1594727,83,6,1930,6,"male",2028,49,25,5,1,0,0,5,1
1594737,47,3,1966,11,"male",554,49,38,3,41,0,16,3,25
1594750,68,4,1945,2,"male",887,154,75,122,7,0,2,122,5
1594758,52,26,1961,4,"female",63,63,46,131,112,115,41,16,71
1594776,63,28,1950,4,"female",1297,87,41,574,214,146,75,428,139
1594793,19,22,1994,9,"female",673,229,129,44,42,44,29,0,13
1594794,19,4,1994,12,"male",343,59,39,10,5,10,5,0,0
1594796,14,19,1999,11,"female",68,91,71,1,2,0,2,1,0
1594802,75,9,1938,11,"male",375,23,3,0,15,0,1,0,14
1594817,62,24,1951,10,"male",206,10,7,4,7,0,1,4,6
1594818,17,17,1996,4,"female",399,611,485,75,87,12,42,63,45
1594857,36,15,1977,1,"female",136,117,89,1622,366,1586,49,36,317
1594876,32,26,1981,8,"female",369,42,26,293,117,293,104,0,13
1594878,21,28,1992,1,"female",291,54,49,266,155,266,153,0,2
1594903,14,3,1999,10,"male",301,449,400,0,1,0,0,0,1
1594934,50,29,1963,12,"male",849,121,101,1,1,0,0,1,1
1594948,78,25,1935,5,"female",912,6,4,0,0,0,0,0,0
1594960,31,5,1982,10,"male",1488,316,140,36,39,36,33,0,6
1594992,69,13,1944,7,"female",745,152,112,1226,508,0,57,1226,451
1594999,39,13,1974,9,"male",690,30,18,14,36,14,26,0,10
1595020,103,25,1910,8,"male",723,241,207,0,0,0,0,0,0
1595032,63,21,1950,6,"male",179,23,13,1,1,0,1,1,0
1595082,29,8,1984,12,"male",268,62,61,0,0,0,0,0,0
1595093,51,22,1962,10,"male",1073,94,30,235,105,235,56,0,49
1595096,22,27,1991,9,"male",715,194,151,159,4,159,4,0,0
1595110,25,15,1988,5,"male",5,29,27,3,7,3,3,0,4
1595152,65,12,1948,1,"female",1253,34,29,158,64,0,6,158,58
1595165,20,17,1993,7,"male",526,348,194,3,9,3,7,0,2
1595175,18,3,1995,8,"male",467,215,195,8,49,6,45,2,4
1595209,28,19,1985,12,"female",339,34,29,45,9,1,0,44,9
1595236,17,2,1996,2,"male",514,331,184,86,35,70,31,16,4
1595249,19,25,1994,12,"male",660,411,139,3,0,0,0,3,0
1595269,62,26,1951,5,"female",247,43,10,82,12,0,1,82,11
1595314,23,8,1990,10,"male",436,323,240,2,3,1,2,1,1
1595315,38,7,1975,8,"male",355,199,104,8,8,4,4,4,4
1595352,17,11,1996,3,"male",1027,294,84,0,150,0,74,0,76
1595359,18,30,1995,6,"male",32,30,24,15,24,14,7,1,17
1595371,24,15,1989,5,"male",545,142,41,5,1,1,0,4,1
1595385,38,25,1975,3,"male",595,24,20,105,152,105,152,0,0
1595416,33,16,1980,7,"male",298,1,1,0,0,0,0,0,0
1595456,33,31,1980,12,"male",138,2,2,0,2,0,2,0,0
1595471,21,4,1992,3,"male",226,32,27,0,0,0,0,0,0
1595473,21,20,1992,12,"male",308,105,99,3,0,0,0,3,0
1595486,13,19,2000,3,"male",144,40,32,15,4,15,3,0,1
1595488,25,27,1988,9,"male",21,1,1,8,10,8,10,0,0
1595489,16,3,1997,7,"male",593,12,9,0,0,0,0,0,0
1595520,31,13,1982,2,"male",584,171,135,4,18,4,11,0,7
1595530,18,20,1995,8,"male",203,583,419,134,130,130,123,4,7
1595532,51,30,1962,5,"female",130,27,25,107,14,33,5,74,9
1595560,108,20,1905,8,"female",992,318,81,76,73,0,30,76,43
1595571,18,27,1995,11,"male",810,265,210,34,2,34,1,0,1
1595572,63,31,1950,3,"female",778,138,113,9,2,0,1,9,1
1595578,17,7,1996,1,"female",107,462,113,169,279,159,225,10,54
1595596,85,16,1928,1,"male",1742,26,11,1,0,1,0,0,0
1595620,68,20,1945,6,"male",675,1128,949,16,46,16,43,0,3
1595633,22,10,1991,6,"male",755,13,9,2,8,2,4,0,4
1595679,49,20,1964,3,"male",1443,579,265,673,1465,558,1111,115,354
1595686,36,5,1977,4,"female",532,60,31,235,160,212,12,23,148
1595697,22,12,1991,1,"female",346,134,95,16,11,16,10,0,1
1595703,17,17,1996,2,"male",386,154,108,50,7,0,3,50,4
1595713,20,31,1993,12,"male",868,10,9,0,4,0,2,0,2
1595718,20,3,1993,3,"female",544,1233,246,445,601,352,303,93,298
1595740,18,5,1995,2,"female",357,186,165,137,154,12,48,125,106
1595764,13,13,2000,3,"male",4,1,0,0,0,0,0,0,0
1595772,33,15,1980,1,"female",481,163,134,0,2,0,0,0,2
1595783,21,18,1992,7,"male",454,441,191,229,180,228,98,1,82
1595791,33,4,1980,11,"female",251,74,21,25,24,23,13,2,11
1595807,17,17,1996,9,"male",328,300,207,215,62,51,11,164,51
1595812,51,28,1962,5,"male",739,135,24,14,10,5,6,9,4
1595820,49,30,1964,9,"female",505,81,34,0,0,0,0,0,0
1595853,41,3,1972,5,"male",242,41,14,37,16,37,13,0,3
1595880,47,30,1966,10,"male",30,5,1,1,1,0,1,1,0
1595904,29,28,1984,5,"male",437,32,25,15,11,15,9,0,2
1595913,22,2,1991,12,"male",311,358,283,67,82,10,64,57,18
1595955,30,15,1983,11,"male",260,55,26,0,6,0,6,0,0
1596004,43,23,1970,4,"female",264,121,60,0,0,0,0,0,0
1596064,39,16,1974,4,"female",268,50,24,47,69,47,13,0,56
1596065,35,13,1978,8,"male",765,30,24,0,10,0,3,0,7
1596090,45,7,1968,7,"male",308,25,20,1,2,1,2,0,0
1596094,44,24,1969,9,"male",328,1,1,0,0,0,0,0,0
1596123,34,18,1979,11,"male",453,115,103,103,11,103,11,0,0
1596132,36,27,1977,1,"male",738,160,102,63,114,63,44,0,70
1596148,18,1,1995,8,"female",295,130,43,1,0,1,0,0,0
1596161,21,25,1992,4,"male",765,360,291,85,4,1,3,84,1
1596169,28,27,1985,7,"male",391,546,492,9,118,9,84,0,34
1596205,64,15,1949,2,"female",1605,62,16,3,51,2,32,1,19
1596221,102,2,1911,4,"female",1689,245,106,130,91,8,42,122,49
1596232,56,25,1957,5,"female",889,29,17,52,11,9,4,43,7
1596240,43,12,1970,4,"male",336,96,64,0,0,0,0,0,0
1596245,94,18,1919,9,"male",246,191,114,30,2,4,2,26,0
1596319,103,16,1910,4,"female",1234,471,176,27,27,15,15,12,12
1596326,22,11,1991,8,"male",143,10,6,0,2,0,1,0,1
1596334,72,7,1941,6,"female",71,62,49,100,16,100,9,0,7
1596341,20,11,1993,3,"male",44,31,18,0,0,0,0,0,0
1596368,23,25,1990,11,"male",417,100,75,6,7,6,6,0,1
1596407,14,29,1999,12,"female",271,21,8,1,1,0,0,1,1
1596412,42,11,1971,10,"male",310,71,37,26,39,17,5,9,34
1596416,108,29,1905,3,"male",1539,1095,768,279,93,42,37,237,56
1596443,20,15,1993,11,"male",172,178,120,3,2,3,1,0,1
1596476,23,21,1990,2,"male",644,31,5,0,1,0,0,0,1
1596481,40,24,1973,11,"male",304,128,37,78,39,0,13,78,26
1596484,101,11,1912,6,"male",548,205,89,133,94,133,57,0,37
1596512,24,21,1989,2,"female",602,231,189,943,728,262,301,681,427
1596515,21,1,1992,1,"male",867,71,33,4,0,4,0,0,0
1596521,17,7,1996,10,"male",15,2,2,1,1,1,1,0,0
1596539,49,31,1964,10,"male",309,76,51,2,1,0,0,2,1
1596568,19,28,1994,2,"female",26,46,18,10,6,10,5,0,1
1596604,29,1,1984,2,"male",352,372,274,323,67,323,66,0,1
1596619,16,25,1997,3,"female",287,230,82,57,66,57,61,0,5
1596624,25,31,1988,5,"male",329,8,8,0,7,0,0,0,7
1596627,71,7,1942,7,"male",617,17,8,12,0,0,0,12,0
1596637,20,2,1993,7,"male",625,350,139,39,39,37,8,2,31
1596641,75,15,1938,2,"female",1813,60,22,19,87,7,14,12,73
1596642,23,17,1990,2,"female",125,1,0,63,4,0,0,63,4
1596645,17,5,1996,10,"female",233,38,31,0,3,0,2,0,1
1596656,48,2,1965,1,"male",317,69,19,47,129,0,24,47,105
1596673,19,31,1994,7,"female",505,109,28,27,62,27,55,0,7
1596686,15,19,1998,12,"male",36,62,58,2,8,2,7,0,1
1596689,92,28,1921,10,"male",1274,139,75,192,248,38,152,154,96
1596698,18,9,1995,8,"female",263,671,168,325,602,270,301,55,301
1596728,17,20,1996,11,"male",470,553,346,287,218,287,184,0,34
1596757,19,15,1994,6,"female",568,1923,302,297,1775,173,1210,124,565
1596797,27,19,1986,12,"female",609,34,21,0,0,0,0,0,0
1596803,21,11,1992,5,"male",487,97,76,1,0,1,0,0,0
1596824,66,28,1947,11,"male",973,121,71,114,137,0,65,114,72
1596836,16,22,1997,6,"male",588,71,47,33,8,25,7,8,1
1596855,22,30,1991,4,"male",567,39,36,0,0,0,0,0,0
1596867,52,4,1961,2,"female",532,8,5,0,0,0,0,0,0
1596930,18,25,1995,5,"male",715,209,163,20,0,20,0,0,0
1596931,40,6,1973,1,"male",1002,34,23,8,4,0,4,8,0
1596959,55,1,1958,9,"female",1290,106,65,1734,594,99,196,1635,398
1596970,22,4,1991,5,"female",273,279,110,1092,742,1092,594,0,148
1596973,43,9,1970,5,"female",488,122,77,1132,172,1130,109,2,63
1596982,22,4,1991,4,"male",641,27,16,0,0,0,0,0,0
1596990,25,11,1988,5,"female",576,56,17,8,18,8,12,0,6
1596996,63,29,1950,4,"male",851,81,24,371,259,21,124,350,135
1597005,35,29,1978,1,"female",300,144,89,48,21,48,15,0,6
1597007,22,21,1991,2,"male",531,542,424,19,5,1,1,18,4
1597029,28,17,1985,4,"female",307,18,16,28,11,3,1,25,10
1597094,13,12,2000,5,"male",271,198,108,95,7,19,5,76,2
1597109,18,23,1995,8,"male",89,73,60,1,0,1,0,0,0
1597110,30,26,1983,6,"female",460,75,41,11,0,11,0,0,0
1597112,46,4,1967,3,"male",1009,72,36,3,3,3,0,0,3
1597113,108,10,1905,7,"male",248,62,54,3,2,3,2,0,0
1597116,56,23,1957,2,"female",460,195,149,322,88,3,30,319,58
1597127,32,17,1981,11,"male",352,10,9,29,8,29,8,0,0
1597156,14,18,1999,12,"male",318,391,274,218,156,209,31,9,125
1597178,71,31,1942,8,"female",1458,4,2,16,1,0,1,16,0
1597192,50,21,1963,7,"male",1057,35,10,29,55,29,41,0,14
1597202,52,4,1961,11,"male",305,63,44,0,5,0,5,0,0
1597241,56,28,1957,11,"male",878,58,34,0,0,0,0,0,0
1597259,28,26,1985,12,"male",463,301,255,112,189,112,186,0,3
1597262,21,15,1992,1,"male",111,30,16,0,0,0,0,0,0
1597267,28,4,1985,10,"female",548,154,109,486,184,485,124,1,60
1597309,17,8,1996,10,"male",153,861,716,204,1058,204,984,0,74
1597321,36,11,1977,8,"male",332,52,35,431,74,431,73,0,1
1597323,15,9,1998,4,"male",274,985,801,1823,640,1823,623,0,17
1597365,108,2,1905,12,"male",26,63,40,66,26,66,25,0,1
1597390,18,1,1995,1,"male",33,226,136,28,27,28,20,0,7
1597422,68,29,1945,10,"male",1688,136,48,211,234,203,130,8,104
1597432,25,9,1988,5,"male",234,149,133,1,12,0,8,1,4
1597459,39,23,1974,2,"female",158,19,18,26,4,26,4,0,0
1597477,28,30,1985,8,"male",618,270,159,0,0,0,0,0,0
1597480,51,29,1962,3,"female",351,15,4,2,0,0,0,2,0
1597511,51,7,1962,5,"female",750,33,5,516,1283,65,945,451,338
1597531,22,6,1991,10,"female",480,143,52,46,22,43,15,3,7
1597542,45,2,1968,7,"male",1757,113,29,0,0,0,0,0,0
1597590,52,27,1961,8,"female",443,109,83,2,1,2,0,0,1
1597605,23,3,1990,6,"female",258,11,7,0,0,0,0,0,0
1597611,23,20,1990,5,"male",424,329,230,9,7,9,6,0,1
1597613,36,19,1977,11,"male",1746,1759,1005,569,1045,536,816,33,229
1597636,22,2,1991,5,"female",156,64,21,0,0,0,0,0,0
1597662,19,2,1994,11,"male",146,202,177,28,0,28,0,0,0
1597668,47,1,1966,4,"male",1655,114,58,1,4,1,4,0,0
1597674,28,6,1985,1,"male",345,77,31,0,12,0,8,0,4
1597681,52,11,1961,9,"male",1934,76,22,84,126,0,98,84,28
1597700,68,24,1945,2,"female",268,42,32,3,0,3,0,0,0
1597722,25,23,1988,6,"male",599,17,15,0,0,0,0,0,0
1597730,56,31,1957,12,"female",1286,243,143,100,184,97,128,3,56
1597742,16,11,1997,8,"male",264,873,496,404,90,315,73,89,17
1597785,25,9,1988,2,"female",782,88,75,3,14,3,8,0,6
1597810,40,21,1973,7,"male",303,25,16,0,1,0,0,0,1
1597830,37,4,1976,5,"female",1038,102,48,634,183,634,148,0,35
1597839,54,4,1959,1,"female",38,33,22,6,8,0,5,6,3
1597854,50,12,1963,10,"male",462,190,114,9,2,0,1,9,1
1597856,20,8,1993,8,"male",609,306,276,4,0,4,0,0,0
1597872,52,28,1961,10,"male",377,42,33,1,0,0,0,1,0
1597879,51,27,1962,8,"female",1778,92,52,7,24,7,11,0,13
1597888,39,11,1974,7,"female",562,64,33,3,40,3,15,0,25
1597901,18,10,1995,6,"male",381,299,204,296,271,296,186,0,85
1597918,25,3,1988,1,"male",163,45,40,0,2,0,1,0,1
1597919,19,27,1994,4,"female",1008,116,55,878,853,518,331,360,522
1597941,29,11,1984,2,"male",350,61,49,0,1,0,1,0,0
1597953,28,9,1985,10,"female",427,224,158,787,636,782,567,5,69
1597975,61,15,1952,9,"male",1311,74,60,95,47,74,22,21,25
1597996,108,4,1905,6,"female",562,290,152,44,66,44,60,0,6
1598006,15,14,1998,12,"female",372,522,360,647,481,60,147,587,334
1598018,38,27,1975,10,"male",171,14,10,4,6,4,6,0,0
1598063,33,16,1980,8,"male",608,94,36,4,0,4,0,0,0
1598069,32,9,1981,1,"male",839,12,5,0,0,0,0,0,0
1598095,28,1,1985,1,"male",775,96,23,21,2,14,0,7,2
1598103,55,13,1958,7,"male",871,326,273,872,212,872,166,0,46
1598106,15,8,1998,5,"male",247,160,146,107,26,30,11,77,15
1598116,59,9,1954,5,"female",124,4,3,1,0,0,0,1,0
1598121,22,7,1991,4,"female",794,98,63,230,86,230,77,0,9
1598132,56,20,1957,7,"female",389,20,15,0,1,0,0,0,1
1598167,27,6,1986,6,"male",413,73,54,10,10,10,10,0,0
1598201,72,12,1941,6,"female",376,21,18,0,0,0,0,0,0
1598215,20,1,1993,1,"female",1741,197,145,181,131,111,102,70,29
1598236,56,20,1957,4,"female",694,60,34,44,63,44,49,0,14
1598252,102,1,1911,1,"male",790,9,5,3,7,3,0,0,7
1598259,108,13,1905,11,"male",1080,158,132,0,0,0,0,0,0
1598263,32,22,1981,7,"male",179,51,40,1,0,1,0,0,0
1598264,18,11,1995,12,"male",296,53,14,9,0,9,0,0,0
1598272,25,15,1988,7,"male",190,441,417,123,53,123,41,0,12
1598273,38,25,1975,9,"female",160,181,103,7,192,7,156,0,36
1598286,24,17,1989,2,"female",471,152,143,2,3,2,2,0,1
1598293,14,8,1999,5,"female",125,126,101,425,33,133,8,292,25
1598298,20,13,1993,3,"female",253,88,48,0,40,0,33,0,7
1598304,52,27,1961,2,"female",45,21,18,247,60,0,20,247,40
1598339,35,21,1978,8,"male",284,21,19,2,0,2,0,0,0
1598363,26,20,1987,8,"female",163,22,16,26,26,0,1,26,25
1598382,25,6,1988,11,"female",98,77,70,9,39,9,19,0,20
1598424,36,1,1977,1,"male",833,0,0,0,0,0,0,0,0
1598445,22,8,1991,9,"female",593,129,106,346,233,346,225,0,8
1598497,25,1,1988,1,"male",202,81,58,2,0,2,0,0,0
1598503,63,15,1950,2,"male",680,21,10,0,0,0,0,0,0
1598552,98,27,1915,10,"male",374,151,135,0,0,0,0,0,0
1598556,27,16,1986,7,"male",218,110,79,4,2,4,2,0,0
1598575,95,9,1918,9,"female",412,51,9,0,0,0,0,0,0
1598582,40,6,1973,5,"male",299,75,52,0,1,0,0,0,1
1598588,34,10,1979,11,"male",718,408,344,4,36,4,32,0,4
1598623,23,30,1990,9,"male",440,143,65,134,266,94,144,40,122
1598635,17,30,1996,8,"male",778,1081,827,1350,1956,291,1326,1059,630
1598677,108,31,1905,3,"female",2266,205,127,258,137,244,75,14,62
1598685,19,4,1994,9,"male",40,115,48,61,66,53,48,8,18
1598689,46,1,1967,1,"male",70,8,8,7,0,0,0,7,0
1598693,29,12,1984,11,"male",1396,232,71,11,18,11,15,0,3
1598718,16,16,1997,2,"male",245,165,82,0,0,0,0,0,0
1598727,107,3,1906,11,"female",1823,139,35,85,114,50,19,35,95
1598774,25,3,1988,8,"female",205,12,3,0,0,0,0,0,0
1598805,16,30,1997,1,"male",1104,680,182,22,65,0,16,22,49
1598835,48,14,1965,4,"female",360,35,8,1,1,0,0,1,1
1598837,42,4,1971,12,"male",703,166,110,0,0,0,0,0,0
1598878,18,24,1995,1,"female",313,1823,819,81,386,79,215,2,171
1598879,56,25,1957,5,"male",327,42,12,83,54,74,36,9,18
1598900,27,30,1986,9,"female",549,46,27,50,124,50,30,0,94
1598945,21,26,1992,6,"female",336,147,138,3,6,3,4,0,2
1598972,30,20,1983,6,"male",349,1,0,0,0,0,0,0,0
1599008,24,6,1989,12,"male",501,234,132,23,57,22,17,1,40
1599016,25,1,1988,1,"male",26,6,6,0,0,0,0,0,0
1599037,46,8,1967,9,"male",1129,131,65,53,48,50,32,3,16
1599042,32,31,1981,7,"female",389,264,223,254,117,254,90,0,27
1599063,58,25,1955,3,"male",575,24,17,5,2,0,1,5,1
1599065,21,25,1992,6,"female",195,29,14,17,6,17,2,0,4
1599073,21,13,1992,9,"male",1280,173,37,2,1,0,0,2,1
1599104,28,30,1985,11,"male",329,129,74,47,14,47,13,0,1
1599124,19,1,1994,10,"male",539,114,53,107,29,90,14,17,15
1599135,34,1,1979,1,"male",352,53,43,36,6,0,2,36,4
1599153,41,10,1972,1,"female",2352,238,145,631,472,501,334,130,138
1599179,48,1,1965,7,"male",728,167,96,80,14,80,11,0,3
1599180,25,19,1988,8,"male",314,165,125,11,8,11,7,0,1
1599193,46,1,1967,6,"female",126,109,94,304,85,0,35,304,50
1599207,40,14,1973,6,"male",709,187,59,3,27,0,12,3,15
1599238,61,3,1952,5,"male",441,62,47,0,0,0,0,0,0
1599295,21,15,1992,8,"male",301,208,178,91,55,91,52,0,3
1599297,18,1,1995,1,"male",401,119,64,6,1,6,1,0,0
1599306,23,26,1990,5,"male",467,7,4,8,6,8,5,0,1
1599309,19,27,1994,12,"female",243,81,42,504,309,504,246,0,63
1599362,31,14,1982,10,"male",281,23,11,338,281,338,257,0,24
1599369,25,5,1988,6,"male",402,171,153,0,0,0,0,0,0
1599381,43,4,1970,6,"male",282,27,8,55,1,20,1,35,0
1599417,36,5,1977,11,"female",250,32,21,17,5,14,1,3,4
1599438,23,7,1990,10,"female",656,1264,560,41,443,19,280,22,163
1599445,56,9,1957,5,"female",1698,861,556,263,810,259,483,4,327
1599454,33,2,1980,2,"male",453,2,2,1,0,1,0,0,0
1599476,17,3,1996,6,"male",1397,1386,847,380,168,379,114,1,54
1599485,103,25,1910,12,"male",586,709,544,206,43,0,33,206,10
1599491,14,29,1999,1,"male",378,113,92,1,2,1,0,0,2
1599508,30,25,1983,4,"female",697,221,109,77,132,68,55,9,77
1599515,27,25,1986,1,"male",830,24,19,0,2,0,1,0,1
1599525,51,12,1962,6,"female",739,280,176,1173,190,1173,139,0,51
1599526,29,22,1984,2,"male",337,38,23,58,63,7,34,51,29
1599527,25,6,1988,2,"male",426,86,42,2,5,2,3,0,2
1599540,93,1,1920,1,"female",162,45,39,1,15,0,1,1,14
1599553,28,20,1985,4,"female",87,144,133,3,23,3,15,0,8
1599554,26,22,1987,5,"female",575,2,0,68,2,68,2,0,0
1599558,19,13,1994,10,"female",171,356,158,5485,5060,1250,977,4235,4083
1599576,71,3,1942,5,"female",1470,15,9,21,3,0,2,21,1
1599587,17,24,1996,4,"male",1476,276,120,1,0,1,0,0,0
1599603,36,18,1977,9,"female",657,49,25,0,1,0,1,0,0
1599638,33,23,1980,11,"female",237,78,52,0,0,0,0,0,0
1599647,23,22,1990,10,"male",960,265,115,422,474,422,399,0,75
1599669,22,26,1991,1,"male",674,160,140,0,15,0,0,0,15
1599680,37,30,1976,7,"female",1690,470,302,2387,1213,2386,1004,1,209
1599689,50,15,1963,5,"male",375,59,49,13,4,0,1,13,3
1599710,23,20,1990,6,"male",1026,2352,790,3228,4077,0,1657,3228,2420
1599725,15,31,1998,10,"female",37,52,33,0,2,0,2,0,0
1599766,53,26,1960,9,"female",294,9,4,141,77,134,32,7,45
1599774,44,20,1969,8,"male",51,5,5,2,0,2,0,0,0
1599786,47,3,1966,3,"male",337,184,86,0,0,0,0,0,0
1599799,20,29,1993,4,"male",1647,755,269,25,2,25,2,0,0
1599831,106,3,1907,8,"male",601,347,303,167,60,167,50,0,10
1599850,60,6,1953,9,"female",50,37,19,3,28,0,12,3,16
1599881,49,30,1964,6,"female",215,161,133,104,154,96,133,8,21
1599893,50,30,1963,3,"male",340,87,77,66,3,66,3,0,0
1599898,65,27,1948,11,"female",58,37,27,229,7,229,2,0,5
1599904,26,29,1987,7,"male",501,51,23,3,17,0,3,3,14
1599911,33,22,1980,2,"male",194,34,17,2,2,2,1,0,1
1599925,27,17,1986,7,"male",43,71,60,89,18,89,15,0,3
1599928,27,4,1986,3,"male",1333,404,323,510,463,108,198,402,265
1599952,30,29,1983,4,"male",673,1463,847,60,241,18,104,42,137
1599975,44,26,1969,3,"female",444,165,77,18,13,13,6,5,7
1599979,50,10,1963,5,"female",1280,127,19,34,23,0,2,34,21
1600007,57,18,1956,10,"female",271,6,2,1,2,0,1,1,1
1600011,24,12,1989,3,"female",121,6,3,5,0,0,0,5,0
1600028,25,3,1988,5,"female",38,147,133,826,764,604,535,222,229
1600036,107,25,1906,1,"female",16,33,15,61,22,0,1,61,21
1600039,15,7,1998,4,"male",523,241,198,303,5,171,4,132,1
1600055,19,15,1994,4,"female",1653,3453,627,345,9071,88,7262,257,1809
1600060,20,21,1993,2,"female",100,118,109,120,24,45,7,75,17
1600064,15,25,1998,7,"male",241,531,404,0,0,0,0,0,0
1600073,28,19,1985,8,"female",324,86,43,149,112,126,56,23,56
1600120,16,10,1997,2,"female",174,324,95,187,73,185,30,2,43
1600136,18,25,1995,9,"male",686,87,57,1,1,1,1,0,0
1600137,20,25,1993,7,"female",396,438,261,201,190,184,72,17,118
1600150,51,1,1962,6,"female",1754,183,133,145,283,73,214,72,69
1600165,21,2,1992,7,"female",365,401,250,526,339,526,277,0,62
1600186,19,19,1994,10,"female",392,102,87,4,18,4,6,0,12
1600217,23,18,1990,10,"male",22,0,0,0,0,0,0,0,0
1600218,22,17,1991,6,"female",1040,130,89,44,1,44,1,0,0
1600228,48,16,1965,5,"male",259,49,25,6,2,0,1,6,1
1600234,34,15,1979,4,"female",98,16,9,26,8,26,6,0,2
1600235,54,3,1959,9,"female",437,104,69,4,0,0,0,4,0
1600300,16,11,1997,7,"female",193,241,149,106,68,96,66,10,2
1600301,40,7,1973,5,"male",233,2,2,70,1,16,0,54,1
1600309,38,16,1975,10,"female",155,17,8,5,1,5,0,0,1
1600322,39,30,1974,9,"male",550,85,39,232,300,232,267,0,33
1600358,22,1,1991,7,"female",143,10,7,1635,81,0,15,1635,66
1600377,55,20,1958,4,"female",1937,111,42,19,35,19,34,0,1
1600384,16,25,1997,3,"female",41,105,50,26,17,25,9,1,8
1600391,49,11,1964,8,"male",540,41,18,27,30,27,28,0,2
1600394,17,14,1996,3,"male",13,0,0,0,0,0,0,0,0
1600428,19,17,1994,6,"female",8,146,56,16,363,16,358,0,5
1600471,24,22,1989,6,"male",346,671,590,5,125,5,72,0,53
1600472,60,10,1953,6,"male",633,6,2,0,0,0,0,0,0
1600481,34,23,1979,3,"female",74,201,168,53,47,48,45,5,2
1600541,24,7,1989,7,"female",479,247,194,3096,931,2992,494,104,437
1600550,27,12,1986,10,"female",59,327,160,420,286,420,220,0,66
1600562,64,28,1949,12,"female",981,90,43,237,181,237,115,0,66
1600564,54,10,1959,2,"male",302,142,52,9,17,9,13,0,4
1600580,25,27,1988,8,"male",497,84,18,11,3,11,3,0,0
1600589,49,20,1964,6,"male",393,212,125,92,45,47,35,45,10
1600609,19,6,1994,4,"female",48,0,0,0,0,0,0,0,0
1600642,17,2,1996,2,"male",345,59,47,1,1,0,1,1,0
1600659,24,29,1989,8,"male",75,220,169,18,25,4,6,14,19
1600670,21,18,1992,2,"female",331,686,510,5421,3135,3885,2196,1536,939
1600678,19,5,1994,9,"female",254,186,13,37,31,37,20,0,11
1600692,20,29,1993,11,"male",116,15,10,18,1,18,1,0,0
1600696,20,23,1993,6,"female",707,280,169,130,16,88,10,42,6
1600734,24,3,1989,7,"female",59,74,62,4,16,4,11,0,5
1600741,19,15,1994,7,"male",639,539,405,1,11,1,5,0,6
1600753,17,3,1996,4,"male",493,231,69,1,4,1,4,0,0
1600806,29,20,1984,5,"male",615,116,87,70,112,70,56,0,56
1600821,23,4,1990,7,"male",886,174,71,0,0,0,0,0,0
1600822,30,8,1983,5,"male",171,5,5,0,0,0,0,0,0
1600830,17,27,1996,4,"female",215,41,19,2,2,0,0,2,2
1600873,86,16,1927,11,"male",1268,38,29,3,0,3,0,0,0
1600890,40,18,1973,7,"female",387,117,55,894,473,894,325,0,148
1600895,24,31,1989,7,"male",250,70,50,23,50,23,27,0,23
1600899,50,11,1963,1,"male",811,79,33,600,230,600,181,0,49
1600946,61,13,1952,11,"male",1004,99,31,0,4,0,0,0,4
1600957,32,1,1981,1,"male",839,59,16,12,3,12,1,0,2
1600967,15,13,1998,6,"male",434,519,304,6,62,6,45,0,17
1600970,56,29,1957,7,"female",626,35,22,109,2,109,2,0,0
1600982,25,12,1988,11,"male",1211,803,495,12,13,10,7,2,6
1600998,17,5,1996,3,"female",307,147,50,321,81,321,56,0,25
1601015,54,23,1959,3,"male",839,51,35,34,13,34,12,0,1
1601038,64,14,1949,6,"male",45,260,78,28,26,28,9,0,17
1601042,18,31,1995,10,"female",88,148,65,1,1,1,1,0,0
1601054,38,23,1975,5,"male",432,10,8,0,0,0,0,0,0
1601113,23,2,1990,2,"male",37,28,19,1,0,1,0,0,0
1601133,35,18,1978,8,"male",2157,186,118,7,35,6,30,1,5
1601203,54,19,1959,7,"female",254,136,82,73,231,69,151,4,80
1601212,41,12,1972,11,"female",1610,930,471,2796,2069,1854,1106,942,963
1601214,25,6,1988,10,"male",238,238,170,4,1,4,1,0,0
1601215,36,7,1977,7,"male",659,14,10,7,25,7,15,0,10
1601224,56,21,1957,10,"female",330,151,105,74,77,0,17,74,60
1601230,53,1,1960,5,"female",1343,113,70,424,436,424,262,0,174
1601233,60,28,1953,5,"male",1678,37,13,0,34,0,3,0,31
1601244,19,16,1994,2,"female",577,300,138,0,3,0,2,0,1
1601250,83,19,1930,1,"female",1518,693,352,224,399,141,130,83,269
1601262,59,30,1954,6,"female",472,186,75,120,44,112,27,8,17
1601264,23,16,1990,4,"male",461,3,2,3,4,0,0,3,4
1601267,108,1,1905,1,"male",2329,332,232,87,161,24,38,63,123
1601296,16,4,1997,8,"male",504,226,152,0,14,0,3,0,11
1601352,13,1,2000,8,"male",68,108,96,20,7,0,2,20,5
1601356,26,18,1987,8,"male",147,13,11,0,0,0,0,0,0
1601359,14,21,1999,2,"male",75,5,3,89,0,89,0,0,0
1601392,16,2,1997,4,"male",259,31,21,3,0,2,0,1,0
1601395,25,18,1988,7,"male",259,72,53,2,19,0,10,2,9
1601422,29,28,1984,5,"male",932,191,113,16,5,16,5,0,0
1601424,22,15,1991,10,"female",760,201,64,0,0,0,0,0,0
1601433,20,13,1993,6,"male",478,152,136,64,38,39,20,25,18
1601473,25,2,1988,8,"male",676,195,99,0,4,0,2,0,2
1601489,66,26,1947,4,"female",636,64,33,91,24,91,18,0,6
1601526,22,29,1991,9,"male",809,975,736,164,276,164,245,0,31
1601532,65,26,1948,6,"female",1028,82,27,23,0,0,0,23,0
1601547,23,17,1990,6,"male",506,109,59,21,399,21,394,0,5
1601592,38,1,1975,7,"male",366,1,0,2,0,0,0,2,0
1601598,18,25,1995,4,"male",294,288,276,402,42,402,34,0,8
1601640,19,4,1994,9,"female",370,84,42,314,29,207,11,107,18
1601643,24,5,1989,4,"male",775,246,204,68,0,68,0,0,0
1601670,18,3,1995,1,"male",854,56,20,1,18,1,14,0,4
1601671,22,15,1991,1,"female",89,29,18,7,31,7,30,0,1
1601689,22,6,1991,6,"female",27,0,0,18,1,0,0,18,1
1601695,18,2,1995,5,"female",21,0,0,0,0,0,0,0,0
1601735,28,12,1985,6,"male",351,132,116,0,0,0,0,0,0
1601747,22,16,1991,4,"female",91,0,0,2,0,0,0,2,0
1601751,18,25,1995,9,"male",94,281,67,12,13,12,10,0,3
1601778,21,5,1992,7,"male",264,274,241,0,4,0,0,0,4
1601779,18,3,1995,8,"male",297,72,28,7,4,0,1,7,3
1601791,61,23,1952,8,"female",682,67,30,31,45,25,30,6,15
1601792,19,20,1994,7,"female",51,225,19,7,155,7,122,0,33
1601807,25,19,1988,4,"male",225,47,10,0,0,0,0,0,0
1601808,43,1,1970,5,"male",606,229,81,13,6,13,6,0,0
1601831,101,8,1912,4,"female",2266,438,142,14,73,14,56,0,17
1601832,31,23,1982,9,"male",311,280,207,3,2,0,2,3,0
1601840,25,1,1988,1,"female",242,6,4,17,0,0,0,17,0
1601842,26,30,1987,11,"male",1,0,0,0,0,0,0,0,0
1601845,33,1,1980,1,"male",325,47,33,27,26,24,12,3,14
1601863,29,18,1984,11,"female",109,457,431,607,168,576,60,31,108
1601878,22,12,1991,7,"female",1091,403,264,342,240,323,209,19,31
1601884,14,4,1999,1,"male",13,69,66,1,3,1,3,0,0
1601906,77,18,1936,10,"female",337,42,18,276,230,276,139,0,91
1601920,18,10,1995,10,"male",38,39,22,5,14,5,10,0,4
1601928,26,3,1987,11,"male",27,26,15,156,160,57,37,99,123
1601962,37,5,1976,5,"female",119,107,93,9,29,9,29,0,0
1601996,29,20,1984,11,"male",382,116,77,6,7,3,6,3,1
1602049,39,9,1974,9,"male",321,16,10,0,0,0,0,0,0
1602051,83,8,1930,9,"male",1875,120,86,93,753,42,423,51,330
1602052,34,3,1979,6,"male",891,66,18,20,39,18,35,2,4
1602128,33,26,1980,6,"male",343,81,66,1,0,1,0,0,0
1602143,18,5,1995,3,"female",382,759,229,27,11,0,6,27,5
1602191,30,31,1983,7,"female",169,23,16,4,0,4,0,0,0
1602195,21,27,1992,3,"male",673,42,28,5,7,5,4,0,3
1602221,54,12,1959,6,"female",762,77,28,285,596,285,358,0,238
1602234,108,8,1905,2,"female",925,357,23,6,2,6,1,0,1
1602246,19,6,1994,1,"female",423,37,27,130,210,130,184,0,26
1602262,15,2,1998,5,"male",256,54,49,52,17,48,13,4,4
1602292,15,6,1998,7,"female",571,1741,691,862,5029,862,3719,0,1310
1602310,18,1,1995,8,"male",693,207,112,128,253,32,81,96,172
1602327,21,11,1992,1,"male",404,57,47,0,1,0,1,0,0
1602358,23,14,1990,8,"female",320,1,1,2,0,2,0,0,0
1602383,21,20,1992,12,"female",1165,3257,501,240,2277,144,1528,96,749
1602398,61,27,1952,9,"male",494,4,0,0,1,0,0,0,1
1602407,17,19,1996,4,"female",860,303,202,704,187,683,150,21,37
1602478,19,29,1994,10,"female",148,1116,672,1054,4509,213,1363,841,3146
1602490,39,15,1974,4,"female",269,2,1,0,0,0,0,0,0
1602493,18,18,1995,5,"female",244,0,0,0,0,0,0,0,0
1602494,26,27,1987,8,"male",707,200,156,0,0,0,0,0,0
1602498,49,5,1964,1,"male",534,212,54,230,99,0,55,230,44
1602521,17,3,1996,3,"male",1109,627,510,1,12,1,8,0,4
1602526,68,1,1945,1,"female",674,1241,710,38,109,3,95,35,14
1602540,58,22,1955,5,"male",233,16,15,15,1,0,0,15,1
1602597,25,1,1988,1,"male",229,12,10,6,2,6,2,0,0
1602614,48,11,1965,2,"male",582,35,21,8,185,8,113,0,72
1602616,24,12,1989,12,"male",539,121,74,1,2,1,2,0,0
1602627,31,21,1982,7,"male",457,37,17,0,0,0,0,0,0
1602628,20,22,1993,6,"male",220,4,4,0,0,0,0,0,0
1602681,23,30,1990,11,"male",811,93,34,1,2,1,2,0,0
1602699,63,1,1950,1,"male",282,118,85,8,5,2,0,6,5
1602767,45,7,1968,6,"female",131,9,5,1,1,0,0,1,1
1602779,28,19,1985,9,"male",474,120,80,0,4,0,3,0,1
1602784,18,30,1995,5,"female",1137,580,317,402,37,376,9,26,28
1602833,19,30,1994,7,"male",692,75,46,1,0,0,0,1,0
1602844,28,1,1985,2,"female",404,145,92,0,0,0,0,0,0
1602849,17,9,1996,7,"female",89,76,24,38,9,38,9,0,0
1602910,18,6,1995,6,"female",522,1439,1092,1037,1996,358,1381,679,615
1602914,20,6,1993,3,"male",441,105,75,98,68,3,30,95,38
1602928,34,15,1979,8,"male",314,57,35,23,27,23,26,0,1
1602964,24,4,1989,12,"male",416,60,38,34,1,34,1,0,0
1602988,45,6,1968,7,"male",327,5,2,0,30,0,11,0,19
1603002,29,11,1984,7,"male",799,110,52,5,2,2,1,3,1
1603012,66,28,1947,12,"male",779,108,66,2086,1254,2086,861,0,393
1603022,56,8,1957,10,"female",1314,280,84,322,532,316,291,6,241
1603035,53,25,1960,12,"male",241,16,12,0,1,0,1,0,0
1603054,24,15,1989,10,"male",515,269,178,52,100,4,32,48,68
1603089,50,20,1963,2,"male",634,21,15,56,7,51,7,5,0
1603097,29,1,1984,4,"male",243,11,9,14,1,0,0,14,1
1603128,21,22,1992,12,"female",541,194,31,0,8,0,5,0,3
1603151,17,22,1996,6,"male",301,126,80,25,5,7,3,18,2
1603170,19,25,1994,8,"male",371,436,327,6,8,6,6,0,2
1603180,53,12,1960,12,"male",158,26,8,2,1,1,1,1,0
1603203,103,28,1910,4,"female",605,285,108,28,46,0,22,28,24
1603232,62,14,1951,8,"female",114,198,112,955,1446,1,32,954,1414
1603249,27,10,1986,3,"male",18,40,34,0,1,0,0,0,1
1603255,50,18,1963,4,"female",277,64,40,6,2,6,2,0,0
1603264,18,25,1995,3,"male",396,80,36,8,1,8,1,0,0
1603269,68,29,1945,11,"female",213,133,101,947,160,947,146,0,14
1603287,24,11,1989,8,"male",604,37,22,2,5,2,2,0,3
1603351,23,24,1990,8,"male",504,70,25,0,1,0,1,0,0
1603372,92,18,1921,11,"female",57,8,8,10,1,10,1,0,0
1603390,23,17,1990,10,"male",469,104,40,360,429,320,287,40,142
1603395,22,7,1991,1,"male",263,90,55,43,6,43,2,0,4
1603473,31,13,1982,6,"female",1054,16,7,0,0,0,0,0,0
1603485,32,20,1981,9,"male",447,194,174,0,0,0,0,0,0
1603515,17,16,1996,6,"male",316,20,2,0,0,0,0,0,0
1603540,16,9,1997,2,"male",594,184,84,58,27,7,8,51,19
1603558,25,1,1988,6,"male",186,60,30,3,1,0,0,3,1
1603563,25,13,1988,6,"female",362,31,21,0,0,0,0,0,0
1603566,36,25,1977,8,"male",600,107,83,3,12,3,4,0,8
1603599,66,3,1947,9,"female",1832,109,30,24,6,24,1,0,5
1603615,56,25,1957,1,"female",312,33,17,26,20,26,14,0,6
1603642,103,3,1910,12,"female",416,76,38,284,138,284,133,0,5
1603643,24,19,1989,9,"male",389,398,357,0,0,0,0,0,0
1603652,29,20,1984,2,"male",169,31,20,0,0,0,0,0,0
1603674,22,20,1991,10,"female",344,220,68,6,1,6,1,0,0
1603685,15,8,1998,8,"male",308,85,63,0,0,0,0,0,0
1603701,46,9,1967,6,"male",69,11,5,0,2,0,2,0,0
1603719,34,14,1979,1,"male",1342,61,9,3,3,3,2,0,1
1603722,113,25,1900,12,"male",1809,538,219,93,143,61,73,32,70
1603729,23,3,1990,4,"female",997,26,21,0,0,0,0,0,0
1603757,16,11,1997,11,"male",230,43,21,0,5,0,4,0,1
1603764,16,17,1997,5,"female",338,2673,706,89,290,89,220,0,70
1603774,74,9,1939,2,"female",302,41,16,192,113,192,86,0,27
1603781,49,4,1964,12,"male",1698,124,63,60,181,60,126,0,55
1603793,36,8,1977,4,"female",742,1,1,0,0,0,0,0,0
1603796,15,27,1998,7,"male",527,50,29,0,0,0,0,0,0
1603822,18,25,1995,12,"female",654,335,133,7,3,7,2,0,1
1603824,31,2,1982,2,"male",42,7,5,0,2,0,2,0,0
1603844,17,1,1996,4,"male",358,130,36,0,0,0,0,0,0
1603868,18,28,1995,12,"female",679,117,79,0,0,0,0,0,0
1603887,18,13,1995,12,"male",229,88,54,19,2,0,0,19,2
1603892,103,1,1910,6,"male",1463,551,330,33,67,5,57,28,10
1603926,48,16,1965,7,"female",1969,423,257,997,2397,974,1443,23,954
1603931,49,24,1964,5,"male",192,86,43,9,18,0,10,9,8
1603938,30,1,1983,9,"male",275,146,120,1,26,1,21,0,5
1604025,22,9,1991,2,"female",377,57,41,0,2,0,1,0,1
1604035,34,24,1979,11,"male",535,170,82,11,87,11,37,0,50
1604036,57,18,1956,10,"male",1302,145,44,1,0,0,0,1,0
1604049,55,17,1958,4,"female",1322,243,104,196,65,9,9,187,56
1604102,28,6,1985,10,"female",714,101,77,5,4,2,4,3,0
1604111,50,22,1963,2,"female",741,9,5,9,3,2,2,7,1
1604130,16,5,1997,4,"male",243,126,88,0,0,0,0,0,0
1604140,16,2,1997,9,"female",665,389,138,42,87,29,58,13,29
1604158,108,1,1905,3,"female",887,3579,1076,90,284,90,244,0,40
1604181,16,12,1997,2,"male",276,258,106,166,23,166,15,0,8
1604206,53,4,1960,4,"female",420,27,17,122,8,122,6,0,2
1604230,27,25,1986,2,"male",922,126,52,1,0,0,0,1,0
1604240,19,4,1994,9,"male",50,7,6,0,1,0,1,0,0
1604269,57,11,1956,9,"female",1398,261,177,541,925,541,654,0,271
1604272,49,18,1964,10,"female",249,14,11,42,37,42,36,0,1
1604306,15,8,1998,6,"female",523,564,429,1163,956,448,271,715,685
1604313,25,31,1988,5,"male",622,196,131,4,3,4,0,0,3
1604331,30,24,1983,5,"male",363,108,33,2,5,0,0,2,5
1604338,32,26,1981,11,"male",155,15,8,0,9,0,9,0,0
1604356,37,28,1976,6,"female",145,29,2,0,0,0,0,0,0
1604358,53,21,1960,5,"female",447,64,36,400,87,400,53,0,34
1604360,25,1,1988,1,"female",8,5,5,0,0,0,0,0,0
1604364,35,10,1978,1,"male",223,69,64,6,0,6,0,0,0
1604379,113,12,1900,1,"male",1723,138,72,101,281,0,102,101,179
1604397,32,30,1981,11,"male",89,65,52,66,609,66,608,0,1
1604433,18,17,1995,3,"male",348,225,146,36,4,36,4,0,0
1604448,66,24,1947,10,"female",676,48,24,122,125,0,93,122,32
1604450,33,4,1980,5,"male",569,48,42,1,2,1,2,0,0
1604462,44,18,1969,3,"male",251,22,21,2,1,2,0,0,1
1604463,52,20,1961,12,"male",207,37,11,0,0,0,0,0,0
1604503,24,15,1989,4,"female",374,8,6,0,0,0,0,0,0
1604505,106,1,1907,1,"male",1527,79,39,5,9,0,1,5,8
1604576,23,12,1990,5,"male",574,28,19,0,3,0,3,0,0
1604607,20,31,1993,8,"male",406,415,354,0,5,0,5,0,0
1604619,26,27,1987,10,"female",363,241,104,6,266,6,257,0,9
1604624,69,5,1944,11,"female",684,145,64,505,365,0,90,505,275
1604634,49,9,1964,9,"female",733,166,141,984,316,983,230,1,86
1604636,59,2,1954,8,"female",460,36,13,70,16,0,1,70,15
1604659,18,26,1995,2,"male",205,153,80,13,2,5,2,8,0
1604686,46,30,1967,7,"male",532,87,18,0,0,0,0,0,0
1604691,95,14,1918,5,"female",2630,909,535,227,157,201,126,26,31
1604705,19,22,1994,2,"female",64,78,35,29,79,29,79,0,0
1604718,63,13,1950,10,"female",790,140,84,0,0,0,0,0,0
1604723,24,12,1989,3,"male",75,62,52,4,8,4,8,0,0
1604725,14,25,1999,8,"female",355,329,284,64,37,57,6,7,31
1604737,19,28,1994,10,"male",511,596,318,1102,590,365,198,737,392
1604748,20,18,1993,10,"male",200,180,44,4,3,4,3,0,0
1604758,22,13,1991,3,"male",921,241,107,6,8,6,8,0,0
1604760,16,19,1997,8,"male",344,352,260,47,21,47,9,0,12
1604790,108,10,1905,6,"female",854,3253,669,1329,2088,627,876,702,1212
1604812,26,16,1987,6,"female",1322,26,17,73,34,3,8,70,26
1604891,18,7,1995,7,"male",774,82,40,0,1,0,1,0,0
1604894,20,22,1993,7,"male",414,155,117,16,7,16,5,0,2
1604943,94,20,1919,10,"male",367,57,46,0,6,0,0,0,6
1604960,21,10,1992,10,"male",457,113,85,180,146,98,98,82,48
1604966,22,9,1991,4,"female",255,5,3,12,11,9,4,3,7
1604982,30,13,1983,5,"male",304,142,136,3,0,1,0,2,0
1604986,23,7,1990,7,"female",590,228,115,3,9,3,3,0,6
1605002,21,12,1992,12,"female",303,361,36,20,60,20,14,0,46
1605032,70,24,1943,9,"female",698,22,9,6,44,0,21,6,23
1605033,65,20,1948,2,"female",595,20,7,8,4,8,2,0,2
1605036,16,21,1997,10,"female",419,413,299,2628,1567,2278,1353,350,214
1605131,24,28,1989,6,"male",748,88,46,3,0,3,0,0,0
1605146,80,17,1933,8,"female",639,84,61,9,22,9,11,0,11
1605174,23,1,1990,1,"female",106,235,167,337,269,337,213,0,56
1605178,31,8,1982,10,"male",720,67,15,2,1,2,1,0,0
1605221,28,19,1985,12,"male",54,66,52,49,15,49,13,0,2
1605225,108,9,1905,11,"male",956,657,435,20,8,20,6,0,2
1605264,26,11,1987,12,"female",318,25,8,0,6,0,0,0,6
1605283,108,2,1905,4,"male",890,354,222,79,59,76,55,3,4
1605301,51,6,1962,4,"male",277,2,2,0,0,0,0,0,0
1605307,19,31,1994,3,"male",816,230,210,0,5,0,5,0,0
1605331,21,28,1992,7,"male",213,273,100,260,60,260,45,0,15
1605357,24,9,1989,9,"male",544,116,52,3,6,3,1,0,5
1605374,29,15,1984,1,"female",453,8,5,63,40,52,5,11,35
1605375,19,16,1994,4,"male",356,69,48,2,6,2,3,0,3
1605384,15,8,1998,8,"female",156,104,75,54,31,54,20,0,11
1605388,19,23,1994,11,"male",499,381,333,0,5,0,3,0,2
1605400,32,1,1981,5,"female",322,18,12,19,2,0,0,19,2
1605402,72,22,1941,5,"female",579,33,20,67,48,0,18,67,30
1605406,20,27,1993,12,"male",534,1089,936,164,304,164,228,0,76
1605408,27,16,1986,7,"male",660,322,266,17,10,0,5,17,5
1605412,44,4,1969,6,"female",699,29,20,119,8,119,7,0,1
1605432,29,27,1984,10,"female",721,139,64,849,841,849,602,0,239
1605442,108,18,1905,1,"male",2033,84,48,2,0,0,0,2,0
1605455,54,11,1959,11,"male",1401,19,4,27,9,26,7,1,2
1605456,107,26,1906,2,"female",1406,105,49,158,56,158,41,0,15
1605457,62,12,1951,7,"female",1382,66,37,489,174,48,103,441,71
1605537,46,7,1967,6,"female",1004,33,13,2,1,0,0,2,1
1605539,30,4,1983,8,"male",287,1,1,0,0,0,0,0,0
1605563,44,9,1969,4,"female",337,96,68,237,93,136,45,101,48
1605565,69,22,1944,4,"female",119,329,133,2,1,2,1,0,0
1605605,101,8,1912,11,"male",1198,65,38,2,3,0,0,2,3
1605613,62,14,1951,12,"female",800,274,221,9,1,9,1,0,0
1605643,67,26,1946,4,"female",523,49,35,66,27,0,19,66,8
1605651,27,21,1986,4,"male",443,259,217,2,2,2,0,0,2
1605718,71,5,1942,3,"male",750,722,574,2227,1594,0,250,2227,1344
1605722,38,15,1975,8,"female",267,3,3,12,0,12,0,0,0
1605740,15,31,1998,5,"male",672,43,34,1,0,0,0,1,0
1605753,56,24,1957,9,"male",1312,79,29,125,44,121,34,4,10
1605755,22,19,1991,4,"female",79,40,16,16,13,15,10,1,3
1605772,29,26,1984,6,"male",352,1,0,82,1,82,1,0,0
1605775,23,10,1990,6,"male",320,86,65,1,1,1,1,0,0
1605782,50,26,1963,11,"male",277,302,172,0,2,0,1,0,1
1605790,15,7,1998,12,"male",310,222,146,3,5,3,4,0,1
1605812,37,1,1976,1,"female",404,129,28,0,0,0,0,0,0
1605815,23,12,1990,12,"male",588,65,25,1,1,0,1,1,0
1605816,15,23,1998,8,"male",279,634,388,281,90,141,46,140,44
1605828,107,23,1906,10,"male",1495,304,101,21,24,21,20,0,4
1605841,56,9,1957,11,"female",511,74,69,0,0,0,0,0,0
1605848,35,2,1978,8,"female",149,104,46,66,99,66,96,0,3
1605850,17,12,1996,9,"male",362,104,60,1,0,0,0,1,0
1605870,23,15,1990,7,"female",743,46,19,0,3,0,2,0,1
1605873,89,24,1924,11,"male",1009,368,105,226,139,209,23,17,116
1605874,62,17,1951,12,"female",37,21,19,1,3,0,0,1,3
1605928,34,30,1979,12,"male",509,34,18,0,1,0,1,0,0
1605944,24,8,1989,12,"male",310,72,52,0,3,0,2,0,1
1605955,106,18,1907,12,"female",1065,95,60,12,12,12,10,0,2
1605968,21,20,1992,3,"male",174,18,16,130,3,0,3,130,0
1606000,86,23,1927,3,"male",1807,80,20,0,0,0,0,0,0
1606001,24,27,1989,8,"male",188,0,0,0,0,0,0,0,0
1606002,83,11,1930,6,"female",1753,81,46,7,75,0,26,7,49
1606044,46,21,1967,2,"male",342,34,25,136,24,0,18,136,6
1606055,25,15,1988,7,"male",472,66,50,5,0,5,0,0,0
1606068,51,9,1962,4,"male",714,97,57,13,6,0,1,13,5
1606078,15,12,1998,11,"male",661,17,14,0,2,0,2,0,0
1606084,24,8,1989,12,"male",310,149,110,173,80,25,36,148,44
1606100,38,10,1975,3,"female",369,170,132,268,220,268,161,0,59
1606121,18,21,1995,11,"female",241,482,168,404,329,404,282,0,47
1606124,20,12,1993,10,"male",556,32,16,4,5,4,5,0,0
1606137,19,10,1994,5,"male",1410,640,459,0,2,0,2,0,0
1606154,107,9,1906,10,"male",1477,775,144,98,17,65,14,33,3
1606181,52,5,1961,6,"male",563,56,29,1408,209,1408,128,0,81
1606188,14,10,1999,5,"male",465,487,133,8,61,8,49,0,12
1606214,29,9,1984,2,"female",475,9,7,46,2,0,0,46,2
1606224,43,27,1970,12,"male",207,17,17,0,0,0,0,0,0
1606268,28,11,1985,11,"male",243,34,33,0,0,0,0,0,0
1606270,70,20,1943,1,"male",1088,16,9,13,0,0,0,13,0
1606276,19,9,1994,11,"female",359,350,124,3,6,3,6,0,0
1606297,20,10,1993,9,"female",851,36,15,29,46,29,32,0,14
1606304,25,11,1988,12,"female",543,233,40,28,27,28,23,0,4
1606326,16,9,1997,6,"male",767,4,1,0,0,0,0,0,0
1606349,25,29,1988,4,"male",664,89,64,2,5,2,5,0,0
1606373,19,20,1994,6,"male",57,126,123,7,12,7,6,0,6
1606374,23,1,1990,1,"male",902,45,43,0,0,0,0,0,0
1606382,54,2,1959,3,"male",950,139,40,4,62,4,52,0,10
1606383,22,1,1991,5,"female",74,42,37,0,1,0,1,0,0
1606384,20,30,1993,9,"female",328,42,29,0,0,0,0,0,0
1606385,18,14,1995,6,"male",153,31,31,0,0,0,0,0,0
1606390,64,12,1949,10,"female",25,11,8,10,6,0,3,10,3
1606500,62,3,1951,5,"male",1648,94,40,22,14,21,6,1,8
1606532,18,27,1995,2,"male",224,476,389,2,17,2,9,0,8
1606551,33,13,1980,10,"female",227,6,3,163,10,163,8,0,2
1606560,28,25,1985,6,"male",393,160,140,18,25,18,18,0,7
1606582,43,21,1970,10,"male",593,52,9,63,131,63,109,0,22
1606586,59,21,1954,10,"female",1126,48,29,510,271,510,211,0,60
1606614,20,28,1993,5,"male",290,7,7,0,0,0,0,0,0
1606629,66,24,1947,10,"female",348,30,18,80,19,0,10,80,9
1606672,44,10,1969,1,"male",481,20,12,57,62,57,36,0,26
1606684,14,30,1999,5,"male",196,288,166,142,3,0,0,142,3
1606705,29,21,1984,4,"female",179,1,1,0,0,0,0,0,0
1606716,24,10,1989,9,"male",796,20,19,1,0,0,0,1,0
1606722,17,14,1996,10,"male",346,81,56,11,5,4,3,7,2
1606764,23,10,1990,10,"male",141,38,28,17,2,17,1,0,1
1606768,65,31,1948,1,"female",969,130,78,260,309,0,129,260,180
1606782,17,19,1996,10,"male",186,208,178,18,2,0,0,18,2
1606790,43,23,1970,3,"female",1309,119,37,5,6,0,1,5,5
1606794,25,11,1988,9,"male",328,9,3,0,0,0,0,0,0
1606795,57,26,1956,7,"female",1267,61,42,125,48,125,41,0,7
1606821,108,29,1905,7,"male",1530,357,197,78,37,78,32,0,5
1606862,57,29,1956,1,"female",738,44,19,0,1,0,0,0,1
1606919,28,6,1985,7,"male",537,125,114,1,1,0,1,1,0
1606921,16,29,1997,10,"male",425,104,86,0,0,0,0,0,0
1606927,13,25,2000,7,"female",11,17,15,0,5,0,5,0,0
1606930,31,10,1982,2,"female",589,21,9,1590,316,1590,101,0,215
1606947,18,14,1995,12,"female",428,262,89,9,0,9,0,0,0
1606953,53,3,1960,12,"female",1998,64,20,28,78,13,56,15,22
1606972,21,14,1992,2,"female",483,45,18,1,24,1,21,0,3
1606988,19,1,1994,2,"male",506,266,130,0,1,0,1,0,0
1607017,59,11,1954,3,"female",1699,194,93,17,55,1,45,16,10
1607051,21,9,1992,9,"female",421,152,132,3,0,3,0,0,0
1607061,54,2,1959,10,"male",934,61,20,42,136,40,105,2,31
1607062,85,23,1928,3,"male",1238,60,27,21,22,0,16,21,6
1607069,34,20,1979,2,"female",113,137,104,11,21,11,17,0,4
1607103,18,7,1995,10,"female",673,432,230,271,274,67,172,204,102
1607121,21,11,1992,10,"male",359,255,214,80,172,80,139,0,33
1607158,52,26,1961,12,"female",227,38,35,51,58,44,28,7,30
1607163,106,4,1907,10,"male",1496,195,48,387,170,82,81,305,89
1607177,68,20,1945,4,"male",882,454,348,52,5,52,5,0,0
1607206,100,1,1913,11,"female",1072,450,127,153,152,153,122,0,30
1607236,18,10,1995,10,"female",38,26,17,705,487,468,203,237,284
1607250,64,15,1949,2,"male",624,170,48,0,0,0,0,0,0
1607253,48,14,1965,6,"female",241,63,27,8,0,0,0,8,0
1607255,18,7,1995,3,"male",34,16,10,1,2,0,1,1,1
1607260,17,1,1996,9,"male",70,55,50,84,0,0,0,84,0
1607276,40,2,1973,7,"female",376,301,253,517,358,517,119,0,239
1607311,18,13,1995,4,"male",187,286,273,1,0,1,0,0,0
1607316,20,27,1993,10,"male",670,0,0,0,0,0,0,0,0
1607364,18,5,1995,5,"male",84,34,26,15,8,15,7,0,1
1607422,18,16,1995,2,"male",420,1557,1164,733,964,730,877,3,87
1607435,30,28,1983,3,"male",326,451,281,278,239,200,55,78,184
1607448,22,10,1991,9,"male",523,181,74,0,0,0,0,0,0
1607464,28,15,1985,10,"female",635,12,11,70,63,70,45,0,18
1607467,44,17,1969,3,"female",1527,298,138,122,137,93,56,29,81
1607502,17,23,1996,8,"male",258,63,21,0,0,0,0,0,0
1607557,22,8,1991,3,"female",855,68,40,174,152,155,49,19,103
1607568,16,12,1997,3,"male",627,167,110,29,1,29,0,0,1
1607588,63,15,1950,10,"male",1670,57,21,0,0,0,0,0,0
1607593,20,22,1993,10,"male",748,246,203,0,1,0,1,0,0
1607598,17,4,1996,1,"male",231,102,49,37,19,36,4,1,15
1607627,29,3,1984,9,"male",606,67,15,3,24,3,24,0,0
1607660,47,10,1966,4,"male",456,115,74,1923,253,0,87,1923,166
1607663,63,20,1950,12,"female",1048,36,20,25,10,0,4,25,6
1607669,108,23,1905,4,"male",830,465,276,2,26,2,22,0,4
1607678,23,9,1990,1,"female",522,3,0,1,0,1,0,0,0
1607688,44,20,1969,3,"female",684,232,163,49,9,0,5,49,4
1607726,52,22,1961,11,"female",59,14,13,7,8,0,1,7,7
1607740,14,16,1999,2,"male",261,872,710,1718,3870,84,2278,1634,1592
1607792,31,10,1982,7,"male",288,5,4,2,0,2,0,0,0
1607794,23,10,1990,5,"female",209,12,9,8,7,0,3,8,4
1607822,28,17,1985,8,"female",508,4562,451,438,4691,438,2850,0,1841
1607825,21,5,1992,6,"male",474,57,21,0,0,0,0,0,0
1607837,60,3,1953,12,"female",347,113,89,1023,255,0,22,1023,233
1607848,90,29,1923,10,"female",794,314,29,93,361,82,145,11,216
1607854,27,11,1986,3,"female",1990,901,250,851,2310,666,1336,185,974
1607905,36,6,1977,9,"female",1457,64,44,468,328,416,284,52,44
1607910,103,29,1910,11,"female",418,139,66,61,57,61,38,0,19
1607921,24,14,1989,11,"male",353,87,83,8,0,0,0,8,0
1607930,37,20,1976,8,"male",351,0,0,3,3,3,3,0,0
1607968,31,18,1982,3,"female",603,468,57,3,29,3,7,0,22
1607988,19,7,1994,11,"female",312,87,45,25,9,24,9,1,0
1607994,35,20,1978,5,"male",322,49,18,8,3,8,3,0,0
1608002,23,23,1990,1,"male",241,137,86,98,48,75,34,23,14
1608065,24,25,1989,2,"male",340,890,338,126,266,126,126,0,140
1608070,24,25,1989,5,"male",578,217,98,17,76,4,17,13,59
1608082,27,6,1986,6,"male",150,35,33,15,0,15,0,0,0
1608086,16,15,1997,12,"male",416,4,1,0,0,0,0,0,0
1608089,26,2,1987,3,"female",322,723,62,1058,2872,1058,1728,0,1144
1608090,81,9,1932,12,"female",12,21,19,1,4,0,1,1,3
1608091,23,7,1990,12,"male",265,123,106,0,2,0,0,0,2
1608110,22,21,1991,1,"female",542,90,56,17,14,17,13,0,1
1608114,17,1,1996,2,"male",190,126,93,5,1,5,1,0,0
1608131,21,6,1992,1,"male",649,183,136,29,48,24,23,5,25
1608165,19,2,1994,2,"male",513,313,183,3,36,3,22,0,14
1608171,36,21,1977,10,"male",141,53,31,47,84,47,60,0,24
1608212,27,14,1986,8,"male",106,1,1,4,0,4,0,0,0
1608241,38,8,1975,10,"male",438,152,118,107,61,31,9,76,52
1608257,33,7,1980,10,"male",649,81,59,3,2,3,2,0,0
1608262,43,24,1970,6,"female",760,174,78,2566,3252,1787,2739,779,513
1608273,76,22,1937,7,"male",595,45,35,20,3,0,1,20,2
1608288,16,23,1997,8,"male",613,27,22,0,0,0,0,0,0
1608294,18,6,1995,6,"male",1000,295,224,0,0,0,0,0,0
1608307,53,15,1960,8,"male",1153,51,16,3,0,3,0,0,0
1608329,42,21,1971,11,"male",68,0,0,0,0,0,0,0,0
1608341,28,23,1985,4,"female",600,249,91,1,7,0,2,1,5
1608365,30,30,1983,12,"male",823,242,76,8,11,2,5,6,6
1608398,59,10,1954,9,"female",931,140,48,3,8,3,8,0,0
1608412,23,6,1990,6,"male",658,27,16,0,0,0,0,0,0
1608423,26,7,1987,2,"male",340,201,182,0,4,0,4,0,0
1608435,25,30,1988,9,"female",225,89,40,5,12,5,12,0,0
1608445,48,26,1965,6,"female",1395,175,108,4748,41,2510,27,2238,14
1608454,40,4,1973,4,"male",264,1,0,0,0,0,0,0,0
1608462,63,13,1950,10,"female",1533,77,29,11,3,11,3,0,0
1608474,24,1,1989,3,"male",529,132,116,0,2,0,2,0,0
1608478,31,13,1982,5,"female",372,9,3,1,2,1,2,0,0
1608484,64,12,1949,1,"male",171,119,89,8,3,7,3,1,0
1608494,22,19,1991,9,"male",361,103,70,56,29,19,14,37,15
1608498,16,12,1997,1,"male",34,53,50,0,0,0,0,0,0
1608501,61,17,1952,4,"male",930,13,0,0,1,0,0,0,1
1608502,31,21,1982,10,"female",437,30,22,30,27,30,26,0,1
1608552,14,26,1999,6,"female",315,490,343,68,64,12,37,56,27
1608566,30,28,1983,6,"male",540,122,27,10,28,10,27,0,1
1608581,34,18,1979,8,"female",615,27,23,265,132,265,77,0,55
1608585,20,18,1993,10,"male",700,1352,1025,38,198,31,116,7,82
1608596,28,4,1985,6,"female",182,114,64,219,322,205,94,14,228
1608636,21,16,1992,5,"female",59,35,27,1,0,0,0,1,0
1608707,32,12,1981,3,"female",292,225,201,738,88,156,29,582,59
1608715,20,4,1993,1,"female",383,403,329,79,33,11,25,68,8
1608718,52,18,1961,7,"male",1524,78,62,0,2,0,0,0,2
1608725,49,10,1964,5,"male",553,50,46,9,0,0,0,9,0
1608733,20,23,1993,6,"male",370,249,152,204,133,204,120,0,13
1608799,47,21,1966,8,"female",424,1,0,0,0,0,0,0,0
1608821,23,25,1990,12,"male",277,191,174,9,6,9,2,0,4
1608882,25,1,1988,12,"male",659,18,16,20,3,20,1,0,2
1608907,15,21,1998,2,"male",465,136,51,3,3,0,0,3,3
1608927,43,3,1970,11,"male",208,28,24,16,30,10,16,6,14
1608931,34,14,1979,4,"female",288,141,75,20,50,20,41,0,9
1608950,20,10,1993,12,"male",643,92,52,12,12,12,10,0,2
1608982,31,12,1982,1,"male",176,47,10,23,21,23,16,0,5
1608999,25,1,1988,1,"female",270,16,13,29,21,29,11,0,10
1609042,18,23,1995,1,"male",304,220,145,45,4,45,4,0,0
1609044,49,1,1964,2,"female",671,4,2,3,0,3,0,0,0
1609059,93,23,1920,2,"male",955,268,185,72,393,0,162,72,231
1609064,17,23,1996,2,"male",516,488,170,26,100,11,77,15,23
1609077,33,4,1980,9,"male",388,89,80,35,9,35,6,0,3
1609106,23,19,1990,9,"male",291,237,132,388,174,388,157,0,17
1609123,18,28,1995,5,"female",172,1681,334,20,833,16,627,4,206
1609145,18,19,1995,6,"female",648,268,135,3,0,0,0,3,0
1609256,51,8,1962,10,"male",233,54,34,0,1,0,1,0,0
1609282,25,23,1988,11,"male",338,125,57,15,12,15,7,0,5
1609285,55,29,1958,4,"male",1112,75,28,0,0,0,0,0,0
1609290,44,20,1969,7,"female",820,204,145,0,8,0,8,0,0
1609302,24,1,1989,2,"male",221,253,241,2,20,2,6,0,14
1609331,57,17,1956,7,"female",1044,65,29,805,185,805,126,0,59
1609390,41,26,1972,8,"male",496,109,19,1,4,1,3,0,1
1609424,31,26,1982,9,"male",552,74,41,2,2,0,1,2,1
1609438,24,25,1989,1,"female",453,136,91,264,131,264,127,0,4
1609451,26,1,1987,1,"male",126,70,63,2,0,2,0,0,0
1609494,31,19,1982,12,"male",369,73,72,10,0,0,0,10,0
1609501,47,2,1966,9,"male",107,146,127,29,5,29,1,0,4
1609509,50,31,1963,1,"male",690,41,8,23,5,9,4,14,1
1609521,56,7,1957,6,"male",574,59,33,0,0,0,0,0,0
1609576,26,15,1987,12,"male",449,247,102,33,74,33,55,0,19
1609579,36,3,1977,2,"male",224,35,29,24,9,11,9,13,0
1609600,20,26,1993,11,"female",499,55,51,3,0,0,0,3,0
1609651,77,11,1936,2,"female",469,119,99,194,68,0,37,194,31
1609676,15,2,1998,6,"female",306,296,153,14,52,14,38,0,14
1609688,22,28,1991,4,"male",687,39,28,9,6,9,3,0,3
1609741,21,22,1992,3,"female",1184,1427,718,615,566,539,235,76,331
1609795,24,1,1989,1,"female",539,105,77,297,317,297,169,0,148
1609797,52,9,1961,1,"male",636,14,3,0,0,0,0,0,0
1609803,18,27,1995,7,"female",614,25,14,16,8,16,7,0,1
1609822,23,8,1990,8,"male",417,796,580,85,36,9,14,76,22
1609829,20,23,1993,1,"female",624,1034,347,7,5,0,2,7,3
1609833,16,27,1997,10,"male",59,38,26,0,1,0,0,0,1
1609850,42,16,1971,4,"male",308,104,98,69,1,69,1,0,0
1609865,101,28,1912,7,"male",426,638,574,79,329,79,290,0,39
1609880,34,19,1979,9,"male",264,12,11,9,0,9,0,0,0
1609883,25,18,1988,3,"female",93,74,24,565,839,374,484,191,355
1609912,18,16,1995,3,"male",198,165,111,10,11,10,4,0,7
1609928,38,24,1975,9,"female",988,95,16,8,1,0,0,8,1
1609950,20,17,1993,11,"female",63,368,80,3266,828,3266,491,0,337
1609968,15,14,1998,6,"female",183,475,221,217,329,213,156,4,173
1609979,19,24,1994,9,"male",574,80,53,1,1,1,1,0,0
1610105,14,27,1999,4,"female",469,431,252,47,103,23,83,24,20
1610121,20,29,1993,8,"male",554,1568,1381,7,68,7,56,0,12
1610132,31,11,1982,12,"male",449,59,22,0,0,0,0,0,0
1610167,36,11,1977,11,"male",236,18,8,0,1,0,0,0,1
1610168,75,26,1938,11,"female",875,80,57,0,0,0,0,0,0
1610174,27,28,1986,4,"male",949,58,44,1,1,1,1,0,0
1610185,53,26,1960,9,"female",135,10,5,4,11,4,11,0,0
1610204,24,25,1989,3,"female",366,356,159,1,37,0,19,1,18
1610209,39,6,1974,6,"male",329,121,66,141,71,141,61,0,10
1610254,68,8,1945,8,"female",596,386,119,113,109,113,91,0,18
1610268,31,18,1982,1,"female",483,379,179,95,52,95,34,0,18
1610278,51,21,1962,4,"female",321,88,73,19,55,0,29,19,26
1610290,25,8,1988,8,"male",1118,404,354,0,0,0,0,0,0
1610311,18,25,1995,5,"male",387,7,4,0,0,0,0,0,0
1610346,47,30,1966,10,"male",318,69,54,14,22,0,6,14,16
1610348,17,15,1996,12,"female",372,342,90,566,866,552,713,14,153
1610386,54,29,1959,8,"female",542,31,22,21,5,19,3,2,2
1610422,15,11,1998,10,"male",83,146,75,42,12,42,8,0,4
1610452,60,24,1953,1,"male",780,198,107,0,12,0,8,0,4
1610463,35,24,1978,6,"male",374,46,42,6,0,6,0,0,0
1610466,63,11,1950,7,"male",69,57,50,12,2,12,2,0,0
1610487,75,24,1938,12,"female",858,43,28,49,0,9,0,40,0
1610491,43,7,1970,3,"female",408,40,26,258,25,258,10,0,15
1610519,40,21,1973,1,"male",1019,100,32,1,5,0,3,1,2
1610541,22,8,1991,2,"male",466,188,160,8,10,8,10,0,0
1610565,43,19,1970,6,"male",389,63,33,990,396,990,299,0,97
1610583,27,29,1986,3,"male",422,192,148,102,9,12,8,90,1
1610617,70,18,1943,5,"male",1289,26,12,2,4,0,3,2,1
1610619,24,22,1989,11,"male",482,60,49,2,35,2,26,0,9
1610624,28,18,1985,7,"male",42,12,11,2,0,0,0,2,0
1610633,50,18,1963,2,"female",550,87,75,0,0,0,0,0,0
1610636,70,18,1943,12,"female",1687,29,17,2,3,0,0,2,3
1610653,64,29,1949,3,"female",1619,129,96,884,227,714,99,170,128
1610654,103,1,1910,4,"female",153,166,128,9,65,9,64,0,1
1610656,49,15,1964,7,"female",2154,172,114,51,85,51,62,0,23
1610688,18,28,1995,5,"male",318,104,29,10,0,10,0,0,0
1610729,28,4,1985,4,"female",348,49,42,386,222,386,104,0,118
1610751,93,28,1920,7,"male",843,243,159,4,2,4,0,0,2
1610775,26,10,1987,5,"male",24,17,13,89,8,85,8,4,0
1610783,18,2,1995,1,"male",343,126,115,246,33,83,22,163,11
1610803,24,24,1989,9,"female",188,81,34,1,0,1,0,0,0
1610813,66,2,1947,11,"male",1643,77,52,3,1,3,0,0,1
1610843,43,29,1970,1,"male",1562,16,6,0,0,0,0,0,0
1610859,64,29,1949,6,"male",1381,170,73,45,15,0,8,45,7
1610873,18,1,1995,1,"male",159,113,108,18,0,0,0,18,0
1610894,16,10,1997,4,"male",658,645,244,379,95,0,36,379,59
1610897,21,8,1992,7,"male",561,10,8,0,0,0,0,0,0
1610908,19,6,1994,4,"female",170,7,3,0,0,0,0,0,0
1610913,35,2,1978,1,"male",512,85,37,11,1,11,1,0,0
1610963,80,13,1933,2,"female",121,161,119,127,73,118,71,9,2
1610972,16,6,1997,12,"male",311,114,63,27,0,27,0,0,0
1610998,21,9,1992,4,"male",229,36,27,0,0,0,0,0,0
1611013,20,19,1993,10,"male",427,83,51,1,10,1,4,0,6
1611015,23,3,1990,9,"female",25,19,12,18,43,16,28,2,15
1611042,110,21,1903,5,"female",1862,69,31,8,8,0,3,8,5
1611060,49,16,1964,5,"female",355,55,32,88,11,10,9,78,2
1611090,36,12,1977,4,"male",427,17,15,2,1,2,0,0,1
1611119,29,10,1984,9,"male",393,17,8,1,0,1,0,0,0
1611120,27,24,1986,8,"male",487,59,38,0,0,0,0,0,0
1611150,37,7,1976,1,"female",589,113,82,22,60,22,43,0,17
1611160,31,18,1982,3,"female",560,41,27,9,168,9,120,0,48
1611162,57,19,1956,2,"male",580,28,13,3,2,3,2,0,0
1611164,53,6,1960,5,"female",525,163,97,10,53,0,13,10,40
1611259,54,13,1959,4,"male",495,52,13,100,20,93,8,7,12
1611264,48,31,1965,5,"female",270,30,20,8,5,0,1,8,4
1611296,24,1,1989,10,"male",536,22,15,0,2,0,0,0,2
1611304,18,1,1995,1,"male",291,36,27,1,0,0,0,1,0
1611323,15,14,1998,8,"male",425,94,81,0,1,0,1,0,0
1611376,25,13,1988,11,"male",1487,384,102,19,13,19,5,0,8
1611393,35,1,1978,1,"male",270,7,3,0,3,0,1,0,2
1611414,25,6,1988,5,"female",7,0,0,0,0,0,0,0,0
1611419,17,10,1996,2,"male",322,87,67,302,9,244,9,58,0
1611424,23,2,1990,10,"male",250,39,21,19,26,19,17,0,9
1611442,25,29,1988,12,"male",782,203,126,9,1,9,1,0,0
1611450,108,31,1905,7,"male",1155,259,119,71,12,0,7,71,5
1611475,23,3,1990,8,"female",202,63,16,122,266,83,190,39,76
1611492,41,10,1972,5,"male",726,109,81,2,0,2,0,0,0
1611493,32,29,1981,5,"female",540,67,30,9,4,9,3,0,1
1611510,24,2,1989,2,"male",534,241,213,0,0,0,0,0,0
1611518,30,4,1983,7,"female",300,208,125,682,44,675,23,7,21
1611536,107,11,1906,4,"female",1778,166,64,50,95,50,65,0,30
1611549,100,28,1913,10,"male",872,216,178,112,31,112,26,0,5
1611581,47,7,1966,8,"male",241,52,42,0,3,0,2,0,1
1611596,60,4,1953,7,"male",99,192,181,32,25,32,18,0,7
1611616,32,21,1981,12,"female",227,9,4,0,0,0,0,0,0
1611623,18,12,1995,2,"male",217,148,130,16,0,16,0,0,0
1611627,103,1,1910,1,"male",871,545,173,96,207,0,51,96,156
1611630,14,30,1999,6,"female",391,293,194,873,361,407,222,466,139
1611645,19,20,1994,2,"male",357,87,51,40,31,37,29,3,2
1611673,34,4,1979,3,"male",1658,181,105,6,2,3,1,3,1
1611708,19,3,1994,10,"male",662,207,72,155,227,146,128,9,99
1611712,26,30,1987,9,"female",708,87,50,0,0,0,0,0,0
1611713,25,20,1988,1,"male",82,10,8,2,0,2,0,0,0
1611715,103,22,1910,8,"female",677,4075,611,0,7,0,5,0,2
1611740,93,16,1920,11,"male",814,239,148,52,14,52,10,0,4
1611792,26,1,1987,1,"female",357,27,17,26,35,26,35,0,0
1611799,28,2,1985,7,"male",157,18,16,0,0,0,0,0,0
1611801,17,9,1996,1,"male",524,29,13,0,3,0,0,0,3
1611812,37,20,1976,6,"male",1912,15,10,32,4,32,4,0,0
1611861,55,29,1958,7,"male",622,31,18,190,224,0,62,190,162
1611863,36,8,1977,5,"male",524,56,13,91,126,91,96,0,30
1611866,50,13,1963,1,"male",808,224,27,37,60,35,18,2,42
1611871,19,6,1994,10,"male",894,800,255,313,184,0,36,313,148
1611881,41,25,1972,7,"male",119,41,21,1,6,1,1,0,5
1611888,21,28,1992,10,"female",508,428,248,13,75,13,66,0,9
1611902,36,4,1977,2,"male",292,23,14,0,0,0,0,0,0
1611929,32,25,1981,9,"male",409,48,32,25,22,0,6,25,16
1611941,46,21,1967,8,"female",463,202,137,44,10,44,4,0,6
1611977,35,14,1978,3,"male",482,30,8,1,0,1,0,0,0
1611986,28,17,1985,7,"female",1063,1152,329,5,13,5,11,0,2
1611989,25,5,1988,1,"male",82,21,18,47,43,47,33,0,10
1611993,39,29,1974,5,"female",396,15,4,2,0,2,0,0,0
1611996,21,11,1992,11,"female",398,58,43,13,38,13,33,0,5
1612061,66,7,1947,4,"female",1565,919,204,1958,991,0,124,1958,867
1612068,15,22,1998,7,"female",381,307,182,44,74,23,63,21,11
1612075,15,12,1998,9,"female",575,607,312,452,103,53,33,399,70
1612079,35,9,1978,9,"female",660,177,114,292,154,231,67,61,87
1612094,26,15,1987,8,"female",283,79,63,444,135,275,37,169,98
1612100,19,6,1994,11,"male",597,746,385,20,0,20,0,0,0
1612123,18,19,1995,3,"male",380,206,95,0,5,0,5,0,0
1612127,22,4,1991,1,"male",508,110,75,10,4,10,4,0,0
1612144,46,12,1967,3,"female",401,39,32,62,2,62,2,0,0
1612158,19,24,1994,8,"male",432,1,1,13,2,13,2,0,0
1612164,23,26,1990,12,"male",95,8,6,6,4,3,0,3,4
1612165,53,7,1960,3,"female",259,108,69,782,210,782,189,0,21
1612180,20,28,1993,2,"female",425,393,74,354,77,324,52,30,25
1612185,33,7,1980,9,"female",1923,88,46,1470,1909,643,699,827,1210
1612192,34,2,1979,10,"male",274,58,31,2,1,0,0,2,1
1612197,59,23,1954,8,"female",380,31,16,35,19,6,13,29,6
1612214,24,18,1989,8,"male",626,106,41,3,0,3,0,0,0
1612245,28,18,1985,3,"male",285,48,33,70,53,70,51,0,2
1612247,16,10,1997,7,"female",380,533,348,373,312,338,112,35,200
1612259,65,5,1948,5,"male",27,64,45,138,21,0,9,138,12
1612275,21,27,1992,12,"male",584,95,63,28,0,28,0,0,0
1612278,29,11,1984,6,"female",172,157,124,16,36,16,19,0,17
1612289,66,3,1947,12,"female",1497,126,34,84,262,84,252,0,10
1612311,47,14,1966,9,"male",56,15,10,57,10,57,10,0,0
1612332,20,17,1993,4,"male",370,176,143,0,0,0,0,0,0
1612337,18,24,1995,8,"female",248,290,144,15,1,14,1,1,0
1612340,44,8,1969,2,"male",584,31,11,23,6,16,6,7,0
1612344,40,30,1973,10,"female",714,1104,437,794,1168,794,1023,0,145
1612347,69,24,1944,3,"male",763,692,47,46,21,16,6,30,15
1612378,28,15,1985,10,"male",1171,107,69,41,182,22,125,19,57
1612385,14,9,1999,1,"female",202,379,45,58,55,58,50,0,5
1612407,70,31,1943,10,"male",1742,27,11,2,7,2,4,0,3
1612454,28,12,1985,8,"male",1306,125,104,1,0,1,0,0,0
1612500,25,17,1988,5,"male",259,178,141,36,39,36,30,0,9
1612503,17,8,1996,9,"male",33,250,190,7018,4892,7018,4744,0,148
1612510,19,1,1994,1,"male",592,137,69,0,6,0,6,0,0
1612524,40,1,1973,1,"female",313,8,8,0,0,0,0,0,0
1612552,26,1,1987,1,"male",493,63,41,4,5,4,5,0,0
1612556,45,3,1968,9,"female",1595,233,124,769,1363,761,1245,8,118
1612559,27,13,1986,9,"male",79,13,9,0,0,0,0,0,0
1612573,15,3,1998,7,"male",710,255,205,4,1,0,0,4,1
1612577,61,23,1952,4,"female",586,43,22,1167,439,0,13,1167,426
1612602,13,1,2000,1,"male",401,30,5,11,0,0,0,11,0
1612609,31,4,1982,3,"male",591,1906,1023,1566,788,578,312,988,476
1612625,19,6,1994,11,"male",190,156,118,64,39,31,22,33,17
1612637,18,23,1995,8,"male",103,52,35,18,5,18,4,0,1
1612642,40,23,1973,12,"male",402,174,146,35,2,15,0,20,2
1612654,24,6,1989,4,"male",566,190,164,41,3,41,3,0,0
1612668,29,7,1984,9,"male",391,22,17,12,0,12,0,0,0
1612709,31,2,1982,12,"male",699,96,56,0,1,0,1,0,0
1612719,23,30,1990,1,"male",210,58,20,0,0,0,0,0,0
1612721,53,6,1960,6,"male",526,65,53,42,19,42,4,0,15
1612730,16,31,1997,7,"female",169,240,142,6,3,6,3,0,0
1612800,62,28,1951,11,"male",393,75,70,51,56,51,45,0,11
1612853,20,14,1993,7,"female",300,447,124,5,9,5,7,0,2
1612855,103,8,1910,4,"male",1475,264,198,17,11,17,4,0,7
1612859,23,5,1990,3,"male",441,211,133,3,3,3,1,0,2
1612860,18,12,1995,12,"female",91,85,69,0,0,0,0,0,0
1612868,21,5,1992,3,"female",26,58,34,89,30,73,26,16,4
1612877,61,29,1952,9,"female",295,51,32,120,48,120,40,0,8
1612915,23,23,1990,12,"male",1031,142,72,195,203,158,102,37,101
1612917,58,9,1955,6,"female",276,71,32,35,27,18,13,17,14
1612979,18,25,1995,9,"female",356,354,259,4,4,4,2,0,2
1612986,21,21,1992,12,"male",281,86,50,0,2,0,2,0,0
1613026,26,15,1987,3,"female",96,147,116,238,214,238,209,0,5
1613065,29,11,1984,3,"male",384,502,278,6082,10758,5434,9465,648,1293
1613085,48,16,1965,2,"male",146,18,16,51,3,51,3,0,0
1613116,40,6,1973,3,"male",1471,156,71,3,64,2,38,1,26
1613122,18,10,1995,10,"male",37,1,1,0,1,0,1,0,0
1613128,108,4,1905,8,"female",243,77,48,15,17,0,4,15,13
1613166,21,11,1992,2,"male",646,119,113,1,0,1,0,0,0
1613234,30,1,1983,1,"male",7,29,28,4,0,4,0,0,0
1613239,20,11,1993,2,"female",1169,1065,228,5,31,2,23,3,8
1613262,30,29,1983,12,"male",262,7,5,0,0,0,0,0,0
1613264,18,12,1995,11,"female",467,98,45,0,0,0,0,0,0
1613268,36,28,1977,10,"male",421,8,4,4,9,4,9,0,0
1613280,103,1,1910,1,"female",737,444,250,3,0,3,0,0,0
1613288,23,25,1990,3,"female",231,298,67,178,205,178,125,0,80
1613293,18,10,1995,11,"female",142,168,66,28,155,24,49,4,106
1613313,30,1,1983,2,"male",627,201,92,1,0,1,0,0,0
1613346,27,27,1986,12,"female",501,1,0,5,1,0,0,5,1
1613374,46,28,1967,10,"female",511,550,262,20,149,13,45,7,104
1613389,17,6,1996,4,"male",330,115,68,7,1,7,0,0,1
1613395,51,4,1962,10,"male",547,46,30,1150,10,1150,5,0,5
1613419,46,31,1967,5,"male",154,9,6,0,3,0,0,0,3
1613434,18,5,1995,5,"male",731,256,161,0,0,0,0,0,0
1613491,44,11,1969,12,"female",205,100,48,860,252,860,197,0,55
1613547,60,20,1953,6,"female",2356,113,18,23,17,23,11,0,6
1613572,24,5,1989,3,"male",945,284,164,0,0,0,0,0,0
1613574,42,20,1971,11,"male",654,92,36,20,43,20,38,0,5
1613629,68,10,1945,9,"male",8,11,9,16,17,0,9,16,8
1613665,32,17,1981,2,"female",574,97,33,144,51,140,34,4,17
1613685,62,23,1951,6,"female",1734,1015,243,573,9799,8,1941,565,7858
1613703,37,11,1976,8,"male",412,25,20,3,0,3,0,0,0
1613711,24,26,1989,6,"female",225,152,63,19,24,19,19,0,5
1613715,19,9,1994,9,"male",665,195,78,4,3,4,3,0,0
1613727,22,1,1991,1,"male",486,14,8,0,1,0,1,0,0
1613746,49,6,1964,1,"female",541,148,84,21,2,4,2,17,0
1613777,17,22,1996,12,"male",53,202,157,517,11,436,10,81,1
1613781,41,25,1972,3,"male",245,34,26,2,16,2,7,0,9
1613804,33,17,1980,6,"female",518,31,16,0,0,0,0,0,0
1613821,49,22,1964,6,"female",727,81,30,567,29,567,20,0,9
1613827,37,9,1976,2,"female",420,56,40,17,34,17,28,0,6
1613898,55,23,1958,12,"male",308,10,10,1,2,0,2,1,0
1613909,41,13,1972,7,"female",678,21,9,0,0,0,0,0,0
1613914,45,19,1968,9,"male",318,0,0,0,0,0,0,0,0
1613921,15,2,1998,10,"male",392,98,76,0,1,0,1,0,0
1613946,24,1,1989,1,"male",432,4,2,0,0,0,0,0,0
1613975,26,29,1987,6,"male",490,428,383,0,0,0,0,0,0
1614030,24,8,1989,4,"female",410,35,22,199,64,199,54,0,10
1614032,65,22,1948,1,"female",626,86,56,23,10,0,1,23,9
1614041,23,8,1990,2,"male",382,241,123,9,14,9,12,0,2
1614052,16,2,1997,12,"male",331,11,7,1,0,1,0,0,0
1614099,19,8,1994,4,"female",199,0,0,0,0,0,0,0,0
1614120,15,13,1998,6,"male",216,78,56,0,0,0,0,0,0
1614140,53,26,1960,10,"female",40,28,25,38,98,30,59,8,39
1614153,55,14,1958,10,"female",1393,43,24,79,47,28,16,51,31
1614233,26,10,1987,4,"male",385,684,537,77,85,77,79,0,6
1614255,23,8,1990,4,"male",410,153,82,12,105,12,61,0,44
1614258,23,13,1990,7,"male",798,92,13,11,0,11,0,0,0
1614261,38,12,1975,12,"female",30,37,16,0,0,0,0,0,0
1614275,75,18,1938,6,"female",719,24,18,5,1,0,0,5,1
1614281,18,7,1995,1,"male",256,240,176,23,1,23,1,0,0
1614290,108,24,1905,2,"female",837,432,212,91,60,91,57,0,3
1614308,73,3,1940,3,"female",394,111,55,0,0,0,0,0,0
1614314,27,17,1986,10,"male",147,64,58,0,0,0,0,0,0
1614326,20,4,1993,1,"male",454,153,121,1,2,0,1,1,1
1614360,16,6,1997,10,"male",328,249,208,0,0,0,0,0,0
1614406,18,8,1995,9,"male",791,45,3,0,0,0,0,0,0
1614452,63,17,1950,1,"female",448,281,218,249,315,249,237,0,78
1614465,19,8,1994,2,"male",682,510,239,48,81,0,14,48,67
1614466,75,24,1938,12,"male",648,145,123,48,9,48,4,0,5
1614498,27,3,1986,9,"male",345,289,219,37,27,34,4,3,23
1614518,17,11,1996,9,"male",456,146,134,79,2,50,1,29,1
1614557,15,15,1998,4,"female",159,453,371,877,185,778,132,99,53
1614581,25,27,1988,4,"female",9,19,15,7,45,5,43,2,2
1614609,23,11,1990,5,"male",4,142,142,19,19,16,10,3,9
1614620,23,23,1990,3,"male",461,168,102,5,11,4,5,1,6
1614655,97,15,1916,11,"male",1460,358,286,83,15,83,8,0,7
1614677,46,17,1967,5,"male",340,89,79,0,1,0,0,0,1
1614689,64,18,1949,1,"female",1614,148,74,1762,454,1762,199,0,255
1614694,64,12,1949,7,"male",594,231,147,501,272,501,192,0,80
1614695,108,22,1905,11,"male",1516,159,117,284,41,1,22,283,19
1614710,94,12,1919,8,"male",626,50,29,7,3,7,2,0,1
1614716,49,13,1964,1,"female",560,37,28,1,0,1,0,0,0
1614719,48,15,1965,3,"female",232,233,74,0,4,0,3,0,1
1614736,37,31,1976,12,"male",414,3,1,0,0,0,0,0,0
1614757,25,24,1988,8,"male",999,95,68,8,9,8,4,0,5
1614763,19,27,1994,4,"female",571,759,582,696,287,66,110,630,177
1614783,26,10,1987,10,"female",733,60,51,0,0,0,0,0,0
1614798,24,1,1989,1,"male",263,83,53,0,0,0,0,0,0
1614809,98,1,1915,1,"male",1656,196,39,34,35,18,17,16,18
1614869,25,31,1988,7,"male",385,75,63,865,753,537,87,328,666
1614894,21,29,1992,7,"female",374,281,113,100,31,100,14,0,17
1614896,24,15,1989,6,"female",215,31,9,2,0,2,0,0,0
1614917,54,6,1959,3,"male",757,26,17,0,7,0,6,0,1
1614946,19,4,1994,10,"female",191,294,179,598,990,598,849,0,141
1614963,37,12,1976,8,"male",289,3,2,0,0,0,0,0,0
1614986,21,16,1992,2,"female",437,507,19,24,22,23,20,1,2
1614988,23,19,1990,11,"male",535,6,5,9,0,9,0,0,0
1614996,32,5,1981,11,"male",102,11,6,9,17,9,4,0,13
1615011,27,10,1986,2,"female",303,1,0,0,0,0,0,0,0
1615031,23,11,1990,3,"female",215,30,18,0,2,0,1,0,1
1615033,15,24,1998,12,"female",242,32,29,11,3,2,1,9,2
1615038,25,12,1988,6,"male",100,21,15,75,0,75,0,0,0
1615043,62,1,1951,2,"male",1306,34,9,5,9,0,1,5,8
1615056,110,11,1903,7,"male",1334,40,29,3,1,0,0,3,1
1615077,34,30,1979,6,"female",153,62,49,22,20,22,8,0,12
1615117,25,8,1988,8,"female",177,145,76,48,151,47,70,1,81
1615160,32,27,1981,12,"male",211,169,157,33,95,33,67,0,28
1615163,19,1,1994,1,"male",367,2,1,4,0,4,0,0,0
1615174,38,3,1975,4,"male",556,40,17,78,380,65,348,13,32
1615240,24,11,1989,9,"female",113,332,202,380,227,332,167,48,60
1615254,33,28,1980,11,"male",550,42,25,20,12,0,2,20,10
1615256,22,14,1991,5,"male",566,854,760,333,178,333,168,0,10
1615294,25,5,1988,3,"male",267,34,19,39,4,39,2,0,2
1615345,20,25,1993,10,"male",438,210,157,82,90,82,78,0,12
1615377,23,17,1990,12,"male",328,254,148,1,23,1,18,0,5
1615381,14,1,1999,5,"male",537,1610,781,102,110,87,55,15,55
1615407,42,21,1971,7,"male",393,13,8,0,0,0,0,0,0
1615421,22,22,1991,5,"male",423,59,46,2,0,0,0,2,0
1615509,20,30,1993,12,"male",240,242,184,4,13,4,10,0,3
1615510,73,10,1940,12,"male",1601,57,24,0,0,0,0,0,0
1615516,22,10,1991,2,"female",993,141,9,0,22,0,21,0,1
1615552,44,16,1969,1,"male",164,48,31,113,65,113,49,0,16
1615561,101,28,1912,12,"male",1605,320,138,271,152,271,116,0,36
1615585,25,6,1988,1,"female",160,155,69,218,349,218,327,0,22
1615608,18,8,1995,6,"female",422,267,188,1,41,1,22,0,19
1615609,35,14,1978,6,"male",2203,103,56,0,15,0,5,0,10
1615646,23,26,1990,5,"male",411,203,144,4,0,4,0,0,0
1615662,18,30,1995,6,"male",141,9,6,16,31,14,22,2,9
1615700,15,26,1998,3,"male",291,65,54,2,0,2,0,0,0
1615738,20,8,1993,2,"female",432,214,165,233,164,218,106,15,58
1615755,42,27,1971,12,"male",347,477,449,28,28,0,4,28,24
1615764,40,15,1973,12,"male",708,2,0,33,9,0,0,33,9
1615766,28,15,1985,11,"female",1245,27,10,94,47,94,45,0,2
1615778,95,4,1918,11,"male",1221,303,118,10,3,10,2,0,1
1615824,39,23,1974,6,"male",607,59,51,87,1,87,1,0,0
1615843,23,19,1990,12,"female",996,135,83,58,67,58,18,0,49
1615853,26,12,1987,12,"male",1644,18,10,0,0,0,0,0,0
1615855,53,20,1960,10,"female",417,2,2,0,0,0,0,0,0
1615894,30,29,1983,1,"female",304,276,239,207,248,195,106,12,142
1615903,27,25,1986,1,"male",504,1070,970,0,0,0,0,0,0
1615907,49,6,1964,2,"female",532,539,181,1277,268,608,136,669,132
1615916,21,28,1992,8,"female",171,38,16,14,9,3,6,11,3
1615921,23,16,1990,10,"female",220,131,93,30,23,29,14,1,9
1615922,59,26,1954,4,"male",1126,188,114,102,9,102,9,0,0
1615936,37,23,1976,12,"male",190,33,17,3,6,3,3,0,3
1615953,53,4,1960,5,"female",1198,95,48,835,233,12,155,823,78
1615959,18,29,1995,11,"female",274,538,212,812,902,469,623,343,279
1616009,102,5,1911,1,"male",365,50,38,222,34,222,34,0,0
1616070,34,20,1979,4,"male",93,87,83,494,67,494,50,0,17
1616076,23,13,1990,8,"female",553,399,362,741,242,318,152,423,90
1616084,35,1,1978,1,"male",554,28,23,0,0,0,0,0,0
1616116,43,3,1970,2,"male",296,1,1,10,2,0,0,10,2
1616130,108,20,1905,7,"male",1307,110,63,5,11,5,5,0,6
1616163,19,27,1994,2,"male",242,409,326,6,90,6,74,0,16
1616170,16,28,1997,7,"male",158,194,147,19,1,5,0,14,1
1616200,67,23,1946,10,"female",2281,101,26,10,21,7,8,3,13
1616214,66,13,1947,8,"female",650,12,5,32,0,0,0,32,0
1616215,18,12,1995,7,"female",26,0,0,0,0,0,0,0,0
1616226,22,23,1991,6,"male",668,176,42,3,1,3,1,0,0
1616266,103,28,1910,1,"female",587,384,181,303,1168,303,1055,0,113
1616313,35,13,1978,5,"male",326,108,77,8,0,8,0,0,0
1616350,27,23,1986,9,"male",1498,648,497,1187,1578,0,412,1187,1166
1616358,15,16,1998,10,"male",316,1,0,0,0,0,0,0,0
1616401,31,3,1982,5,"male",1442,354,258,0,0,0,0,0,0
1616431,25,2,1988,7,"female",200,104,74,47,0,47,0,0,0
1616433,50,22,1963,6,"female",2398,42,15,15,2,15,1,0,1
1616439,68,20,1945,9,"male",777,132,129,1,0,1,0,0,0
1616461,41,24,1972,9,"female",226,226,191,54,62,54,52,0,10
1616468,19,24,1994,6,"female",817,860,332,7,287,2,190,5,97
1616483,31,20,1982,4,"female",440,283,249,0,2,0,1,0,1
1616502,48,13,1965,5,"male",530,34,10,1,2,1,2,0,0
1616505,16,28,1997,10,"male",444,230,108,6,22,6,18,0,4
1616521,20,26,1993,2,"male",616,1084,891,17,25,17,23,0,2
1616529,23,30,1990,11,"male",467,78,30,26,0,26,0,0,0
1616552,47,8,1966,9,"male",298,64,59,195,7,195,5,0,2
1616586,14,21,1999,2,"male",335,399,130,180,102,91,49,89,53
1616622,22,22,1991,10,"male",19,47,46,9,77,0,62,9,15
1616642,56,24,1957,1,"male",190,13,12,60,31,0,3,60,28
1616654,36,29,1977,5,"male",419,1,1,0,0,0,0,0,0
1616680,113,17,1900,4,"male",1660,37,5,1,1,0,0,1,1
1616696,25,6,1988,10,"male",366,271,147,21,34,18,20,3,14
1616697,25,30,1988,10,"male",89,73,15,0,0,0,0,0,0
1616708,68,7,1945,7,"female",664,82,40,81,315,42,187,39,128
1616724,30,17,1983,7,"female",608,25,12,15,27,15,22,0,5
1616726,24,3,1989,9,"male",488,141,37,120,78,116,48,4,30
1616727,57,17,1956,12,"female",737,79,48,0,0,0,0,0,0
1616738,20,28,1993,3,"male",353,115,66,2,4,0,4,2,0
1616828,29,11,1984,10,"male",422,18,16,1,0,1,0,0,0
1616834,53,10,1960,10,"male",553,0,0,0,0,0,0,0,0
1616838,46,5,1967,8,"female",160,12,10,3,0,3,0,0,0
1616870,19,23,1994,9,"male",68,70,69,0,63,0,62,0,1
1616921,18,5,1995,10,"female",247,332,266,17,43,17,42,0,1
1616931,59,11,1954,6,"female",1326,95,48,164,63,11,38,153,25
1616943,39,15,1974,11,"male",1462,956,579,106,41,0,18,106,23
1616954,19,18,1994,1,"female",702,250,147,2319,1778,0,358,2319,1420
1616973,23,18,1990,9,"male",347,80,48,0,0,0,0,0,0
1616980,62,11,1951,8,"female",668,513,399,153,40,91,13,62,27
1617020,20,19,1993,2,"male",340,23,21,94,53,5,7,89,46
1617033,48,21,1965,4,"female",242,90,83,317,276,317,137,0,139
1617047,72,22,1941,11,"female",1837,38,17,196,166,1,9,195,157
1617052,56,9,1957,5,"male",928,111,99,2,22,1,16,1,6
1617057,20,8,1993,4,"female",249,74,35,827,79,672,69,155,10
1617113,24,31,1989,10,"male",431,233,133,121,61,121,44,0,17
1617126,24,1,1989,4,"male",432,190,5,5,0,0,0,5,0
1617152,25,25,1988,9,"female",405,182,101,1,0,1,0,0,0
1617173,21,2,1992,1,"male",6,0,0,0,0,0,0,0,0
1617187,66,2,1947,2,"female",304,222,213,3268,174,0,52,3268,122
1617188,15,16,1998,7,"male",32,39,37,0,2,0,2,0,0
1617236,23,17,1990,3,"female",420,94,28,477,471,90,226,387,245
1617238,51,10,1962,6,"female",136,87,52,1033,593,756,233,277,360
1617272,19,1,1994,8,"male",133,1,1,46,7,46,7,0,0
1617274,18,5,1995,9,"male",215,302,251,74,311,25,237,49,74
1617283,21,20,1992,3,"female",156,346,100,143,427,143,379,0,48
1617287,67,28,1946,11,"male",1002,127,83,3,6,1,3,2,3
1617288,18,15,1995,10,"female",294,22,15,0,0,0,0,0,0
1617324,21,21,1992,10,"female",76,10,8,294,33,294,16,0,17
1617337,23,1,1990,1,"male",414,34,26,77,23,0,10,77,13
1617344,46,6,1967,1,"male",16,6,4,1,1,1,0,0,1
1617352,20,5,1993,8,"male",695,0,0,0,0,0,0,0,0
1617376,29,19,1984,1,"male",825,123,65,5,73,5,60,0,13
1617397,16,31,1997,5,"male",351,48,22,11,0,11,0,0,0
1617421,76,15,1937,4,"male",1143,61,37,0,0,0,0,0,0
1617423,18,13,1995,8,"male",649,389,321,265,95,52,27,213,68
1617466,18,23,1995,7,"male",318,661,491,2,27,0,18,2,9
1617495,17,1,1996,12,"female",521,311,179,31,52,31,43,0,9
1617504,63,18,1950,12,"female",1713,36,23,34,3,0,1,34,2
1617518,19,10,1994,10,"male",309,142,57,19,2,0,0,19,2
1617545,28,1,1985,1,"male",198,46,40,2,1,0,1,2,0
1617559,52,7,1961,5,"female",556,35,8,404,510,404,322,0,188
1617576,18,6,1995,10,"female",129,823,33,68,995,68,644,0,351
1617591,22,4,1991,1,"male",355,86,67,0,3,0,0,0,3
1617592,19,21,1994,4,"male",603,46,26,5,3,5,1,0,2
1617593,21,14,1992,2,"male",532,72,10,7,1,7,1,0,0
1617598,15,1,1998,9,"female",279,424,117,138,88,105,33,33,55
1617629,49,21,1964,5,"female",532,148,73,76,124,75,31,1,93
1617663,26,10,1987,7,"male",322,26,24,0,1,0,0,0,1
1617666,25,15,1988,7,"female",269,73,55,81,52,54,29,27,23
1617696,43,23,1970,5,"female",345,6,5,4,0,0,0,4,0
1617704,40,16,1973,9,"male",317,63,32,38,17,35,8,3,9
1617709,38,21,1975,8,"female",529,304,143,65,206,63,61,2,145
1617710,108,1,1905,11,"female",1138,1727,581,0,26,0,20,0,6
1617768,31,7,1982,10,"male",27,63,48,21,90,21,67,0,23
1617788,21,26,1992,11,"male",363,1046,937,10,221,5,188,5,33
1617789,25,1,1988,1,"male",178,13,11,16,0,16,0,0,0
1617807,36,31,1977,12,"male",271,9,3,0,0,0,0,0,0
1617825,64,9,1949,5,"male",1062,89,44,0,0,0,0,0,0
1617844,21,20,1992,9,"male",562,272,182,77,42,77,38,0,4
1617857,73,2,1940,8,"female",1448,41,15,155,14,0,14,155,0
1617908,26,13,1987,12,"male",523,23,18,0,0,0,0,0,0
1617921,108,19,1905,7,"female",1647,827,413,26,135,24,37,2,98
1617942,34,28,1979,8,"female",445,29,20,4,2,4,2,0,0
1618016,48,2,1965,3,"female",490,206,32,30,36,0,5,30,31
1618042,18,14,1995,9,"female",305,299,265,158,65,158,59,0,6
1618044,20,6,1993,10,"male",308,200,159,0,0,0,0,0,0
1618045,39,8,1974,7,"male",129,41,22,50,12,50,7,0,5
1618056,61,19,1952,8,"female",534,320,209,104,41,2,9,102,32
1618077,21,7,1992,3,"male",8,53,52,40,14,40,8,0,6
1618120,105,16,1908,8,"female",500,372,189,1,6,1,5,0,1
1618150,15,28,1998,8,"male",62,139,126,18,10,18,10,0,0
1618169,33,16,1980,4,"male",188,18,18,0,0,0,0,0,0
1618179,33,27,1980,10,"male",417,258,253,324,163,0,129,324,34
1618202,66,26,1947,8,"female",1479,163,55,57,335,13,163,44,172
1618213,20,21,1993,6,"male",92,64,59,36,73,31,20,5,53
1618216,44,22,1969,11,"male",87,54,18,0,2,0,0,0,2
1618218,73,30,1940,10,"female",187,29,24,22,4,0,0,22,4
1618222,41,4,1972,2,"female",685,172,65,117,247,48,55,69,192
1618225,16,16,1997,2,"male",474,228,118,100,12,2,5,98,7
1618226,23,23,1990,3,"male",396,236,64,5,2,0,0,5,2
1618234,14,18,1999,3,"female",208,173,108,112,65,27,37,85,28
1618235,23,25,1990,11,"male",23,25,18,0,1,0,0,0,1
1618238,24,4,1989,1,"male",968,45,30,2,16,2,13,0,3
1618270,40,17,1973,5,"male",422,10,9,5,7,5,7,0,0
1618307,67,24,1946,6,"female",552,14,7,23,3,0,3,23,0
1618310,19,21,1994,1,"male",50,105,75,230,205,81,123,149,82
1618311,58,14,1955,11,"male",1975,119,35,0,0,0,0,0,0
1618335,20,3,1993,2,"male",366,211,165,107,164,103,149,4,15
1618387,17,6,1996,8,"male",693,91,57,18,1,18,1,0,0
1618388,14,18,1999,8,"male",497,639,489,119,127,1,59,118,68
1618397,76,19,1937,3,"female",657,37,26,6,5,4,3,2,2
1618399,17,19,1996,4,"female",319,58,37,1,0,1,0,0,0
1618402,22,12,1991,9,"male",337,205,132,0,0,0,0,0,0
1618405,25,1,1988,1,"male",224,1,1,0,0,0,0,0,0
1618422,33,15,1980,5,"male",150,111,74,36,15,36,6,0,9
1618448,18,10,1995,9,"male",590,1609,1445,71,53,71,43,0,10
1618452,69,25,1944,11,"male",1450,16,9,35,10,24,6,11,4
1618473,23,3,1990,12,"male",783,143,82,32,45,32,34,0,11
1618474,29,2,1984,9,"female",301,58,48,232,308,163,193,69,115
1618486,24,11,1989,11,"female",373,38,0,0,1,0,1,0,0
1618491,22,20,1991,11,"male",258,36,26,2,9,2,0,0,9
1618498,69,24,1944,7,"female",667,46,21,6,11,6,10,0,1
1618503,19,3,1994,5,"male",158,68,52,0,4,0,4,0,0
1618504,52,26,1961,3,"male",1405,293,189,7,69,0,18,7,51
1618534,20,19,1993,8,"female",497,329,183,30,82,30,58,0,24
1618540,36,18,1977,12,"female",838,108,47,79,78,79,61,0,17
1618551,50,2,1963,8,"female",447,18,12,2,14,0,5,2,9
1618572,56,16,1957,1,"male",523,160,34,523,244,503,164,20,80
1618575,62,5,1951,11,"female",852,143,48,176,209,0,52,176,157
1618586,23,28,1990,2,"male",0,0,0,0,0,0,0,0,0
1618590,29,25,1984,5,"male",221,34,22,0,0,0,0,0,0
1618599,34,13,1979,1,"female",499,196,54,1174,332,1174,257,0,75
1618606,25,2,1988,1,"male",205,48,27,25,2,25,1,0,1
1618641,26,13,1987,10,"female",120,91,29,66,114,66,56,0,58
1618649,65,12,1948,8,"female",395,793,466,2436,4192,2436,3766,0,426
1618697,20,25,1993,5,"male",461,190,143,0,0,0,0,0,0
1618702,63,2,1950,9,"male",1222,72,18,36,3,36,2,0,1
1618733,19,14,1994,4,"male",61,34,29,3,0,3,0,0,0
1618741,46,11,1967,11,"female",1027,84,49,122,98,105,53,17,45
1618750,45,7,1968,7,"female",684,8,8,5,3,5,3,0,0
1618771,40,29,1973,5,"male",427,41,24,100,15,100,12,0,3
1618773,33,14,1980,7,"male",333,1,1,0,0,0,0,0,0
1618781,22,23,1991,5,"male",461,107,74,39,17,39,12,0,5
1618800,63,27,1950,4,"female",1164,674,337,1283,1241,293,267,990,974
1618816,46,9,1967,7,"female",123,40,19,48,19,0,3,48,16
1618824,23,31,1990,7,"male",1159,597,284,118,40,5,19,113,21
1618854,33,6,1980,3,"male",316,46,17,33,19,27,16,6,3
1618865,70,11,1943,5,"female",860,132,53,17,174,0,66,17,108
1618884,39,4,1974,3,"male",317,46,22,190,23,190,20,0,3
1618909,20,27,1993,5,"female",570,308,139,0,3,0,1,0,2
1618927,38,24,1975,11,"female",1292,3044,1712,730,2735,707,2531,23,204
1618935,17,5,1996,12,"male",405,111,63,15,0,15,0,0,0
1618944,20,25,1993,11,"male",23,266,40,17,36,17,22,0,14
1618965,53,10,1960,2,"male",457,56,27,101,94,101,37,0,57
1618981,32,11,1981,2,"male",837,101,66,0,0,0,0,0,0
1618990,54,5,1959,2,"male",673,114,71,37,25,37,1,0,24
1619027,78,30,1935,6,"female",1107,40,15,0,0,0,0,0,0
1619028,23,3,1990,4,"male",100,95,78,11,28,11,25,0,3
1619040,25,6,1988,10,"female",158,627,547,128,283,43,168,85,115
1619041,49,10,1964,7,"female",85,298,209,653,967,628,857,25,110
1619042,25,1,1988,1,"male",260,43,26,2,4,2,2,0,2
1619056,17,6,1996,10,"female",479,23,20,31,0,31,0,0,0
1619065,15,21,1998,3,"male",417,65,39,11,0,8,0,3,0
1619092,40,24,1973,2,"male",222,2,1,0,0,0,0,0,0
1619096,30,11,1983,5,"male",280,239,132,193,3,19,3,174,0
1619126,18,30,1995,6,"male",307,214,96,0,26,0,20,0,6
1619135,15,9,1998,5,"male",310,40,31,21,0,21,0,0,0
1619155,34,6,1979,10,"female",553,26,14,64,11,64,7,0,4
1619162,100,21,1913,3,"male",107,48,28,67,33,67,21,0,12
1619167,17,17,1996,12,"male",312,87,60,11,2,11,1,0,1
1619169,25,19,1988,4,"male",420,242,117,2,9,2,9,0,0
1619191,18,15,1995,8,"male",112,43,39,26,11,3,1,23,10
1619197,26,3,1987,9,"female",1661,558,243,1042,231,268,65,774,166
1619206,15,9,1998,1,"female",657,3194,1017,268,767,89,452,179,315
1619237,20,25,1993,2,"male",395,233,215,11,5,11,1,0,4
1619242,45,3,1968,8,"male",105,8,5,0,0,0,0,0,0
1619259,14,28,1999,3,"female",289,157,138,310,71,310,55,0,16
1619297,57,12,1956,9,"male",1571,862,230,3,0,3,0,0,0
1619305,30,11,1983,12,"male",365,49,28,99,10,99,6,0,4
1619308,23,22,1990,1,"male",486,64,43,626,624,626,462,0,162
1619364,32,14,1981,1,"female",611,67,42,0,1,0,0,0,1
1619389,38,5,1975,5,"male",428,173,63,4,12,4,6,0,6
1619408,17,1,1996,2,"female",375,894,665,638,221,638,204,0,17
1619439,30,7,1983,4,"male",148,2,2,7,14,0,12,7,2
1619450,44,23,1969,9,"female",86,0,0,2,0,2,0,0,0
1619452,17,7,1996,12,"female",905,200,132,73,8,73,8,0,0
1619468,18,31,1995,8,"male",541,785,696,61,13,61,9,0,4
1619482,15,28,1998,10,"female",206,296,156,563,582,347,324,216,258
1619484,53,20,1960,12,"female",1083,169,73,12,34,12,30,0,4
1619514,59,9,1954,3,"female",568,85,22,53,14,53,4,0,10
1619564,108,9,1905,6,"male",1571,179,47,6,2,6,2,0,0
1619565,108,7,1905,10,"female",1105,4797,535,1,137,1,31,0,106
1619590,18,2,1995,3,"male",101,150,137,433,64,433,63,0,1
1619606,21,11,1992,6,"female",341,21,4,0,0,0,0,0,0
1619617,66,22,1947,4,"female",1028,12,9,0,0,0,0,0,0
1619656,17,22,1996,10,"female",558,303,226,621,848,592,481,29,367
1619658,36,8,1977,6,"female",463,96,51,22,15,0,4,22,11
1619664,66,7,1947,1,"female",940,160,119,5,35,5,18,0,17
1619669,75,5,1938,6,"female",1400,99,63,524,345,524,55,0,290
1619693,18,25,1995,12,"male",533,966,851,523,232,523,188,0,44
1619727,28,12,1985,5,"male",329,307,253,1632,1206,1632,1123,0,83
1619755,21,9,1992,6,"female",189,188,54,25,76,25,72,0,4
1619774,30,17,1983,9,"female",263,13,7,7,3,0,3,7,0
1619781,34,7,1979,11,"female",388,79,56,0,6,0,4,0,2
1619803,21,17,1992,11,"male",369,218,162,0,2,0,2,0,0
1619808,16,9,1997,8,"female",253,70,26,13,12,13,12,0,0
1619841,39,8,1974,2,"female",94,51,36,86,298,86,237,0,61
1619874,19,21,1994,8,"male",373,227,112,1,2,1,1,0,1
1619940,33,20,1980,1,"female",593,37,12,11,61,11,58,0,3
1619969,53,22,1960,8,"female",455,193,120,633,419,0,117,633,302
1619983,55,1,1958,3,"male",1362,45,30,29,6,29,5,0,1
1619993,65,23,1948,6,"female",484,7,4,0,0,0,0,0,0
1619996,65,23,1948,12,"female",837,84,55,0,13,0,5,0,8
1620004,72,9,1941,3,"female",1625,39,22,217,25,179,23,38,2
1620007,22,28,1991,2,"male",346,231,187,0,0,0,0,0,0
1620012,30,19,1983,12,"male",748,228,124,43,3,24,1,19,2
1620018,59,21,1954,1,"female",1383,226,51,67,324,61,191,6,133
1620022,23,2,1990,12,"male",42,44,22,69,25,69,18,0,7
1620029,99,28,1914,3,"male",272,409,279,33,74,30,53,3,21
1620040,25,27,1988,6,"female",176,35,20,63,43,63,33,0,10
1620051,19,20,1994,1,"male",80,32,21,183,56,153,35,30,21
1620056,24,28,1989,8,"female",147,96,57,2,10,2,6,0,4
1620096,29,13,1984,3,"male",558,180,125,14,68,14,39,0,29
1620102,28,13,1985,1,"female",156,3,2,2,1,0,0,2,1
1620103,82,2,1931,11,"female",1879,733,522,820,1559,414,1109,406,450
1620106,76,5,1937,3,"female",1072,96,49,18,4,0,3,18,1
1620118,16,20,1997,2,"female",511,852,562,1584,1922,1584,1637,0,285
1620122,108,13,1905,4,"male",1016,614,372,1,57,0,9,1,48
1620129,23,30,1990,11,"male",97,9,8,2,0,0,0,2,0
1620132,17,20,1996,6,"male",248,242,172,35,9,31,7,4,2
1620136,59,8,1954,9,"female",584,202,169,133,34,130,14,3,20
1620155,18,24,1995,9,"female",192,530,275,3799,3977,3539,1603,260,2374
1620195,25,1,1988,1,"male",81,58,55,410,90,410,68,0,22
1620206,36,13,1977,7,"male",67,117,72,19,36,19,28,0,8
1620207,22,10,1991,11,"male",263,309,265,1612,1097,1612,1028,0,69
1620210,46,11,1967,2,"female",74,49,36,168,24,168,23,0,1
1620238,70,1,1943,1,"female",1036,42,25,37,119,0,56,37,63
1620269,21,25,1992,8,"male",566,766,646,78,6,0,0,78,6
1620277,14,13,1999,5,"male",383,461,238,40,4,1,3,39,1
1620281,22,21,1991,10,"male",295,120,96,11,3,0,0,11,3
1620286,27,26,1986,11,"male",928,108,76,15,18,15,15,0,3
1620290,30,29,1983,4,"male",1208,74,27,16,5,16,3,0,2
1620291,35,21,1978,11,"male",1096,8,2,3,0,0,0,3,0
1620306,44,14,1969,5,"male",442,53,23,38,3,34,3,4,0
1620309,20,16,1993,1,"male",674,892,734,175,561,128,333,47,228
1620310,14,19,1999,1,"male",386,214,132,0,0,0,0,0,0
1620352,99,22,1914,11,"male",2416,708,208,296,317,17,152,279,165
1620384,44,7,1969,4,"female",650,252,226,326,348,310,193,16,155
1620396,18,29,1995,10,"male",228,32,31,1,1,1,1,0,0
1620401,20,18,1993,10,"male",423,972,863,257,137,115,52,142,85
1620428,27,11,1986,10,"female",591,142,98,163,145,153,72,10,73
1620453,44,13,1969,4,"male",391,2,1,0,0,0,0,0,0
1620463,58,30,1955,9,"male",402,84,54,77,11,0,3,77,8
1620487,18,18,1995,3,"male",69,2,2,1,0,0,0,1,0
1620503,62,24,1951,1,"female",513,66,56,71,32,0,19,71,13
1620529,25,9,1988,9,"male",376,133,105,6,4,6,4,0,0
1620536,46,6,1967,12,"female",442,72,30,21,29,21,20,0,9
1620571,56,2,1957,5,"female",1619,280,147,1,2,0,0,1,2
1620618,19,10,1994,3,"male",1131,300,241,73,79,65,72,8,7
1620630,18,4,1995,7,"male",557,579,300,1301,864,426,423,875,441
1620656,18,29,1995,8,"female",196,55,25,160,45,154,12,6,33
1620668,18,26,1995,9,"male",235,137,101,40,94,0,19,40,75
1620684,34,19,1979,6,"female",193,68,40,71,79,71,69,0,10
1620691,18,1,1995,2,"female",414,88,43,68,259,29,117,39,142
1620718,17,26,1996,1,"male",309,265,143,14,7,1,1,13,6
1620733,65,11,1948,10,"male",1299,166,93,3,12,3,8,0,4
1620763,26,20,1987,8,"male",646,30,6,40,24,40,18,0,6
1620768,72,20,1941,3,"male",811,3,2,0,0,0,0,0,0
1620770,39,15,1974,5,"male",263,9,5,1,0,1,0,0,0
1620781,26,28,1987,9,"male",196,65,45,30,66,16,16,14,50
1620786,103,4,1910,3,"male",692,179,71,2,11,2,9,0,2
1620792,18,16,1995,10,"male",490,48,42,0,0,0,0,0,0
1620806,59,25,1954,5,"male",1314,80,25,1,0,1,0,0,0
1620809,22,30,1991,3,"male",672,316,155,393,123,326,70,67,53
1620823,26,20,1987,7,"male",235,25,22,0,0,0,0,0,0
1620886,21,21,1992,6,"male",38,25,12,2,17,0,13,2,4
1620887,66,25,1947,1,"male",780,121,58,148,25,2,7,146,18
1620907,108,10,1905,9,"male",237,109,90,156,94,156,68,0,26
1620918,83,1,1930,1,"male",2333,295,214,109,66,109,47,0,19
1620921,26,13,1987,6,"female",147,102,44,67,26,63,24,4,2
1620934,61,2,1952,1,"male",761,105,45,22,2,0,0,22,2
1620956,28,8,1985,10,"male",37,63,18,13,17,13,17,0,0
1620958,19,25,1994,6,"male",417,469,209,4,13,4,10,0,3
1621000,48,15,1965,3,"female",278,7,3,4,7,4,1,0,6
1621057,68,20,1945,1,"male",1393,87,36,35,7,35,5,0,2
1621109,48,16,1965,2,"male",731,1,1,0,0,0,0,0,0
1621121,25,1,1988,1,"male",231,14,12,0,0,0,0,0,0
1621150,63,7,1950,7,"male",368,61,28,1,0,0,0,1,0
1621180,29,14,1984,6,"male",491,1,1,0,0,0,0,0,0
1621195,57,4,1956,8,"female",1821,111,52,157,121,1,57,156,64
1621200,25,3,1988,1,"male",222,45,27,0,1,0,1,0,0
1621226,36,30,1977,7,"female",159,60,49,56,7,8,2,48,5
1621230,19,17,1994,12,"male",619,583,424,1,3,1,3,0,0
1621269,26,5,1987,10,"male",237,77,67,1,1,1,1,0,0
1621274,39,9,1974,12,"male",23,25,16,33,14,33,8,0,6
1621292,23,16,1990,2,"male",264,5,1,1,2,0,0,1,2
1621293,108,21,1905,6,"male",1578,104,63,1,0,0,0,1,0
1621309,26,22,1987,11,"male",88,36,30,2,0,2,0,0,0
1621357,17,13,1996,11,"male",433,105,70,22,9,22,3,0,6
1621395,71,26,1942,9,"female",717,26,15,172,37,0,7,172,30
1621412,58,17,1955,3,"female",1211,58,28,2360,220,1924,103,436,117
1621442,19,22,1994,10,"female",278,121,100,78,42,78,37,0,5
1621471,31,22,1982,8,"male",392,140,73,1657,239,1158,90,499,149
1621493,17,4,1996,9,"male",1407,946,165,119,361,2,100,117,261
1621503,32,11,1981,4,"female",231,18,9,20,8,20,6,0,2
1621505,17,5,1996,9,"male",589,925,762,308,472,225,338,83,134
1621514,18,2,1995,3,"male",169,175,156,34,68,34,35,0,33
1621517,44,31,1969,5,"female",992,106,63,15,82,15,53,0,29
1621555,23,25,1990,3,"male",379,110,82,8,6,8,6,0,0
1621566,18,23,1995,3,"male",460,195,141,2,1,2,1,0,0
1621567,21,30,1992,1,"female",658,310,128,157,169,120,83,37,86
1621574,17,7,1996,11,"male",33,86,83,4,1,3,1,1,0
1621584,18,28,1995,10,"male",219,77,61,2,50,0,24,2,26
1621585,24,4,1989,3,"male",154,19,14,15,12,15,11,0,1
1621595,28,21,1985,3,"male",261,16,8,0,1,0,0,0,1
1621643,15,6,1998,12,"male",544,183,106,14,1,14,1,0,0
1621651,23,6,1990,3,"male",807,434,222,10,1,10,1,0,0
1621675,45,1,1968,1,"male",148,30,22,52,33,52,28,0,5
1621695,38,17,1975,11,"male",677,211,124,320,243,294,229,26,14
1621733,29,24,1984,11,"male",798,67,35,1,4,1,1,0,3
1621774,16,26,1997,6,"male",152,9,7,0,0,0,0,0,0
1621803,47,22,1966,7,"male",74,0,0,0,0,0,0,0,0
1621809,18,16,1995,8,"male",28,8,5,16,19,15,6,1,13
1621843,41,15,1972,1,"male",41,70,64,86,398,43,142,43,256
1621852,19,24,1994,9,"male",457,76,64,0,0,0,0,0,0
1621895,21,3,1992,9,"female",437,43,27,4,5,4,1,0,4
1621913,53,3,1960,1,"male",108,118,80,736,228,736,188,0,40
1621940,42,17,1971,6,"female",750,406,215,170,660,0,124,170,536
1621965,69,22,1944,6,"female",10,50,45,22,11,22,10,0,1
1621971,55,28,1958,5,"male",77,18,11,159,12,0,8,159,4
1621974,54,25,1959,11,"female",172,87,62,22,4,22,4,0,0
1621983,23,18,1990,4,"female",814,295,158,18,138,3,91,15,47
1621986,17,18,1996,1,"female",237,214,128,0,27,0,11,0,16
1622006,68,24,1945,3,"male",1092,36,11,58,3,58,0,0,3
1622012,41,9,1972,8,"male",1690,238,61,96,188,64,156,32,32
1622039,58,22,1955,6,"male",1409,115,42,9,61,8,50,1,11
1622041,23,25,1990,7,"female",505,130,17,1,0,1,0,0,0
1622045,58,18,1955,9,"female",642,45,32,464,105,464,98,0,7
1622095,18,10,1995,6,"female",105,258,237,181,209,176,102,5,107
1622111,17,19,1996,9,"female",153,58,30,164,112,164,62,0,50
1622170,60,14,1953,7,"female",672,43,22,205,101,118,83,87,18
1622171,26,15,1987,1,"male",522,170,107,22,21,22,3,0,18
1622224,21,9,1992,1,"male",688,471,340,1,6,1,3,0,3
1622225,13,14,2000,2,"female",64,51,38,44,4,44,2,0,2
1622244,100,25,1913,11,"female",972,1104,576,245,219,241,149,4,70
1622252,62,3,1951,3,"male",1265,226,183,9,20,6,16,3,4
1622258,41,3,1972,3,"male",536,60,37,1,1,1,1,0,0
1622276,41,27,1972,10,"male",368,183,110,93,76,93,69,0,7
1622292,61,21,1952,6,"male",529,41,22,1,0,1,0,0,0
1622338,58,15,1955,8,"female",1500,21,9,0,2,0,2,0,0
1622342,60,4,1953,1,"female",428,55,39,25,3,25,2,0,1
1622345,16,15,1997,2,"male",92,14,13,16,13,0,0,16,13
1622349,20,12,1993,2,"male",187,30,28,0,0,0,0,0,0
1622402,20,3,1993,3,"female",732,1204,802,1192,773,26,369,1166,404
1622409,15,11,1998,10,"female",610,266,113,0,1,0,1,0,0
1622419,26,7,1987,8,"male",8,0,0,0,0,0,0,0,0
1622422,54,13,1959,3,"female",438,38,14,1,10,1,5,0,5
1622445,33,12,1980,11,"male",419,25,21,65,2,58,2,7,0
1622463,64,6,1949,10,"female",466,29,16,0,0,0,0,0,0
1622476,34,23,1979,7,"male",662,14,9,10,0,10,0,0,0
1622497,59,20,1954,6,"male",97,64,59,3,1,0,1,3,0
1622498,69,5,1944,8,"female",667,53,2,181,64,0,21,181,43
1622500,74,23,1939,9,"male",1429,74,48,12,7,12,7,0,0
1622509,73,15,1940,10,"female",1967,52,15,0,0,0,0,0,0
1622514,34,19,1979,6,"male",416,29,23,0,0,0,0,0,0
1622519,41,4,1972,11,"female",625,73,48,198,65,0,10,198,55
1622552,46,30,1967,6,"male",440,217,131,1,4,0,1,1,3
1622582,33,16,1980,4,"male",281,78,70,4,0,4,0,0,0
1622583,103,23,1910,9,"female",761,425,283,561,398,561,310,0,88
1622585,19,28,1994,9,"male",241,47,21,0,0,0,0,0,0
1622618,15,25,1998,12,"male",294,118,81,0,6,0,6,0,0
1622621,103,29,1910,6,"male",1600,367,219,4,38,4,22,0,16
1622622,19,26,1994,11,"female",582,4,4,2,6,2,6,0,0
1622629,34,7,1979,10,"male",667,466,394,134,4,67,2,67,2
1622641,68,29,1945,8,"male",564,273,185,630,1262,574,669,56,593
1622665,20,18,1993,2,"male",490,476,393,1110,137,1110,124,0,13
1622670,60,24,1953,3,"male",449,1,1,0,0,0,0,0,0
1622699,25,1,1988,1,"male",5,0,0,0,0,0,0,0,0
1622703,17,7,1996,4,"male",1008,129,97,0,0,0,0,0,0
1622737,21,30,1992,3,"female",243,53,24,4,0,2,0,2,0
1622768,24,11,1989,10,"male",98,314,297,212,72,212,64,0,8
1622777,43,13,1970,5,"female",376,66,55,1,1,0,0,1,1
1622808,56,8,1957,1,"male",416,42,33,1,2,0,2,1,0
1622836,38,21,1975,10,"male",376,81,58,1,2,0,1,1,1
1622849,113,18,1900,10,"female",1547,70,39,377,337,332,149,45,188
1622889,43,3,1970,6,"male",166,32,23,11,5,11,4,0,1
1622890,22,29,1991,11,"male",306,3,3,9,27,9,27,0,0
1622924,53,5,1960,10,"male",345,1,1,19,3,0,1,19,2
1622975,33,20,1980,4,"female",363,37,37,4,1,4,1,0,0
1622977,31,31,1982,5,"female",161,9,2,23,10,23,10,0,0
1622978,66,5,1947,8,"male",21,14,12,21,5,18,5,3,0
1622987,20,27,1993,7,"female",909,290,132,390,274,323,222,67,52
1622991,58,29,1955,9,"female",717,86,43,125,134,125,93,0,41
1622994,25,10,1988,10,"male",635,174,114,27,17,27,17,0,0
1623024,36,10,1977,6,"male",567,1,1,0,0,0,0,0,0
1623050,45,11,1968,4,"male",325,161,57,4,5,2,3,2,2
1623057,34,3,1979,9,"male",105,16,14,7,7,5,5,2,2
1623081,24,14,1989,3,"male",140,9,3,7,3,7,2,0,1
1623118,28,27,1985,3,"male",261,1,1,13,6,13,5,0,1
1623128,41,10,1972,11,"female",122,27,18,2,0,2,0,0,0
1623133,54,2,1959,8,"male",127,73,47,6,0,6,0,0,0
1623135,17,19,1996,1,"female",361,567,327,7,22,4,20,3,2
1623146,16,22,1997,6,"male",339,55,38,0,0,0,0,0,0
1623211,23,18,1990,11,"male",189,13,8,0,0,0,0,0,0
1623216,26,3,1987,2,"male",410,11,11,1,0,0,0,1,0
1623244,21,5,1992,1,"female",561,2247,1848,0,1,0,1,0,0
1623246,41,10,1972,1,"male",434,97,67,327,165,327,117,0,48
1623295,19,26,1994,2,"male",130,25,21,42,0,42,0,0,0
1623315,86,1,1927,7,"female",466,33,25,0,2,0,2,0,0
1623363,23,2,1990,1,"female",769,1683,624,177,358,177,316,0,42
1623372,20,5,1993,7,"male",808,183,129,1,0,0,0,1,0
1623374,55,27,1958,4,"female",1606,707,198,2070,355,584,180,1486,175
1623382,33,1,1980,9,"male",372,115,58,35,8,35,6,0,2
1623389,26,24,1987,6,"male",1109,698,518,1919,996,1919,929,0,67
1623393,51,27,1962,3,"female",32,18,3,1,2,0,1,1,1
1623415,59,29,1954,11,"male",763,26,20,7,6,6,4,1,2
1623448,16,8,1997,12,"female",157,71,66,0,6,0,1,0,5
1623458,14,1,1999,1,"male",221,12,9,0,17,0,9,0,8
1623468,22,1,1991,1,"female",599,10,7,0,1,0,0,0,1
1623469,28,7,1985,9,"female",32,32,1,8,3,8,3,0,0
1623496,33,29,1980,10,"female",565,19,9,0,0,0,0,0,0
1623543,42,11,1971,11,"male",89,53,33,0,1,0,1,0,0
1623548,22,2,1991,1,"male",223,128,84,1,0,1,0,0,0
1623595,106,18,1907,11,"female",2926,456,209,19,12,0,7,19,5
1623622,33,25,1980,10,"male",62,15,12,6,1,6,0,0,1
1623638,22,29,1991,7,"female",618,612,154,3,72,3,49,0,23
1623661,20,21,1993,5,"female",353,0,0,0,0,0,0,0,0
1623674,46,15,1967,7,"male",912,20,6,0,0,0,0,0,0
1623688,31,31,1982,1,"male",108,29,22,6,18,6,5,0,13
1623697,33,13,1980,3,"female",378,237,163,45,44,45,30,0,14
1623725,86,10,1927,6,"female",553,342,246,382,273,0,142,382,131
1623730,53,1,1960,1,"male",90,57,44,54,169,54,61,0,108
1623755,76,10,1937,6,"male",1799,58,21,9,0,0,0,9,0
1623769,68,7,1945,8,"male",742,42,25,5,5,0,0,5,5
1623794,15,9,1998,8,"male",221,60,41,43,19,43,15,0,4
1623872,17,6,1996,5,"male",554,375,218,76,48,76,25,0,23
1623875,23,16,1990,9,"female",650,137,36,0,0,0,0,0,0
1623885,64,13,1949,7,"male",1976,22,5,1,1,1,1,0,0
1623894,84,7,1929,2,"female",2161,237,149,54,102,0,54,54,48
1623917,16,3,1997,9,"male",339,34,25,3,4,3,3,0,1
1623935,38,5,1975,6,"female",504,40,31,78,134,78,95,0,39
1623943,93,17,1920,3,"female",826,576,23,0,12,0,12,0,0
1623949,54,25,1959,4,"female",217,1,1,0,0,0,0,0,0
1623952,14,3,1999,5,"male",454,281,101,67,261,67,260,0,1
1623962,27,5,1986,1,"male",319,45,23,0,3,0,1,0,2
1623984,51,24,1962,8,"female",335,8,3,48,21,48,17,0,4
1623985,27,25,1986,5,"female",493,176,103,0,0,0,0,0,0
1623987,24,5,1989,3,"male",210,184,140,0,0,0,0,0,0
1624021,54,18,1959,1,"female",570,117,78,352,143,0,100,352,43
1624022,37,18,1976,3,"male",295,17,6,3,3,3,3,0,0
1624038,26,30,1987,4,"male",698,444,190,199,210,197,121,2,89
1624051,52,10,1961,11,"female",505,114,97,304,44,304,44,0,0
1624052,63,26,1950,11,"female",324,4,3,5,0,5,0,0,0
1624077,18,19,1995,3,"male",607,525,344,394,493,393,194,1,299
1624123,17,25,1996,11,"male",952,335,278,6,10,5,4,1,6
1624127,22,2,1991,5,"male",224,144,129,14,6,14,6,0,0
1624136,33,25,1980,1,"male",365,19,16,15,0,15,0,0,0
1624141,23,12,1990,6,"male",381,27,12,1,2,0,2,1,0
1624156,23,21,1990,1,"male",407,126,93,4,2,4,2,0,0
1624164,20,28,1993,3,"male",269,72,54,11,5,11,4,0,1
1624176,50,9,1963,9,"female",211,51,25,39,59,39,31,0,28
1624178,61,21,1952,8,"male",1705,135,47,5,20,5,10,0,10
1624187,32,4,1981,12,"male",193,184,156,1026,61,1026,56,0,5
1624190,22,11,1991,5,"male",257,278,269,322,28,322,26,0,2
1624213,21,22,1992,8,"female",541,157,119,345,190,312,151,33,39
1624223,40,27,1973,8,"male",291,31,25,25,0,25,0,0,0
1624233,27,5,1986,1,"female",555,14,4,2,0,2,0,0,0
1624244,24,19,1989,4,"female",382,115,63,14,19,14,18,0,1
1624275,52,3,1961,2,"male",237,18,17,6,1,4,1,2,0
1624306,15,8,1998,4,"female",237,429,280,252,776,100,247,152,529
1624348,21,6,1992,11,"female",457,278,163,150,130,150,89,0,41
1624358,27,26,1986,2,"male",179,79,56,294,56,294,28,0,28
1624361,24,22,1989,5,"male",273,235,102,13,11,13,7,0,4
1624393,51,23,1962,5,"male",381,12,4,7,0,7,0,0,0
1624397,23,24,1990,10,"male",173,25,14,93,77,36,49,57,28
1624454,14,21,1999,11,"male",126,11,6,0,3,0,0,0,3
1624464,55,1,1958,6,"male",119,9,4,9,0,9,0,0,0
1624473,37,25,1976,12,"female",438,41,32,9,0,0,0,9,0
1624495,49,29,1964,2,"male",840,63,32,9,0,9,0,0,0
1624531,50,19,1963,12,"male",199,16,8,7,4,1,1,6,3
1624556,50,31,1963,3,"male",677,154,130,334,111,132,83,202,28
1624562,112,1,1901,1,"male",1251,89,68,10,39,7,22,3,17
1624586,100,1,1913,1,"female",1746,122,54,5,0,5,0,0,0
1624589,27,5,1986,5,"female",104,7,6,61,41,61,19,0,22
1624599,28,25,1985,12,"female",100,38,35,0,0,0,0,0,0
1624680,55,28,1958,3,"female",882,41,24,0,4,0,4,0,0
1624684,13,22,2000,2,"male",98,0,0,0,0,0,0,0,0
1624689,102,15,1911,10,"female",2261,49,14,250,160,112,41,138,119
1624691,28,19,1985,3,"female",149,3,3,2,0,2,0,0,0
1624704,28,10,1985,10,"male",726,4,3,0,0,0,0,0,0
1624706,20,1,1993,1,"male",123,64,61,0,6,0,5,0,1
1624720,23,3,1990,3,"male",6,8,0,0,0,0,0,0,0
1624731,29,1,1984,1,"male",400,13,10,0,0,0,0,0,0
1624749,26,4,1987,2,"male",724,30,13,0,1,0,1,0,0
1624752,19,22,1994,7,"female",70,195,75,440,311,75,64,365,247
1624779,37,24,1976,10,"male",709,5,4,0,2,0,1,0,1
1624807,30,23,1983,11,"male",94,0,0,3,2,3,2,0,0
1624861,71,25,1942,4,"male",824,3090,567,42,184,0,36,42,148
1624883,24,10,1989,3,"male",995,18,11,1,0,1,0,0,0
1624888,47,7,1966,1,"male",310,32,11,26,62,26,56,0,6
1624892,28,4,1985,11,"female",97,30,3,0,0,0,0,0,0
1624921,108,27,1905,2,"female",2112,98,54,29,28,1,17,28,11
1624954,48,12,1965,9,"female",153,9,4,0,0,0,0,0,0
1624960,52,17,1961,2,"female",447,33,19,143,129,0,9,143,120
1624967,67,24,1946,2,"male",2014,72,14,0,5,0,0,0,5
1624992,38,25,1975,9,"female",671,132,86,913,333,726,166,187,167
1625003,55,18,1958,5,"male",72,1,1,7,0,7,0,0,0
1625011,16,26,1997,8,"female",234,81,55,200,303,128,147,72,156
1625014,25,10,1988,7,"male",37,8,8,3,0,0,0,3,0
1625044,28,6,1985,6,"male",1245,0,0,0,0,0,0,0,0
1625053,22,6,1991,3,"female",204,138,84,23,79,23,72,0,7
1625061,38,30,1975,4,"male",418,4,0,0,0,0,0,0,0
1625074,21,29,1992,8,"male",529,166,6,1,0,1,0,0,0
1625087,108,20,1905,4,"male",1082,368,198,0,4,0,1,0,3
1625098,14,13,1999,11,"female",153,132,82,413,444,413,325,0,119
1625105,14,27,1999,10,"female",364,1194,716,65,146,42,99,23,47
1625115,33,17,1980,12,"female",503,34,28,0,0,0,0,0,0
1625148,16,28,1997,12,"male",640,292,124,15,16,0,5,15,11
1625179,19,6,1994,8,"female",199,12,3,0,0,0,0,0,0
1625221,30,10,1983,2,"female",91,88,34,406,618,406,452,0,166
1625223,48,14,1965,2,"female",1134,392,312,158,55,158,43,0,12
1625262,28,12,1985,2,"male",442,63,18,27,25,27,22,0,3
1625297,18,18,1995,8,"female",715,199,64,18,3,14,2,4,1
1625313,26,22,1987,2,"male",138,91,72,4,1,4,1,0,0
1625329,23,25,1990,11,"male",514,132,70,6,0,6,0,0,0
1625331,50,16,1963,9,"female",1357,15,9,144,184,144,27,0,157
1625337,29,1,1984,8,"male",191,179,141,35,14,35,9,0,5
1625354,17,14,1996,9,"male",479,1385,1260,215,106,3,81,212,25
1625407,59,2,1954,2,"male",252,43,36,0,2,0,1,0,1
1625449,28,3,1985,12,"male",29,130,127,99,56,99,51,0,5
1625467,31,16,1982,10,"female",707,153,82,32,47,32,16,0,31
1625469,31,5,1982,12,"female",414,53,37,246,118,246,45,0,73
1625484,47,10,1966,1,"male",217,6,6,36,3,0,2,36,1
1625487,38,18,1975,3,"female",247,7,2,1,10,1,10,0,0
1625503,31,9,1982,10,"female",743,46,13,189,51,189,41,0,10
1625507,49,9,1964,4,"female",66,3,3,0,0,0,0,0,0
1625510,54,15,1959,6,"female",1355,60,13,64,20,61,16,3,4
1625529,39,19,1974,11,"male",624,14,1,1,0,1,0,0,0
1625534,18,1,1995,11,"male",502,120,111,0,2,0,2,0,0
1625542,17,6,1996,1,"female",177,378,192,210,133,110,41,100,92
1625611,33,4,1980,9,"female",299,94,40,5,33,5,10,0,23
1625613,28,11,1985,9,"male",316,41,18,24,0,24,0,0,0
1625625,24,18,1989,12,"female",187,256,191,55,43,55,42,0,1
1625632,18,4,1995,1,"female",999,1880,597,737,2202,244,750,493,1452
1625661,25,15,1988,11,"female",517,33,8,32,114,29,52,3,62
1625665,35,30,1978,7,"male",843,96,69,11,25,11,25,0,0
1625694,24,27,1989,5,"male",231,46,31,12,3,12,3,0,0
1625716,23,30,1990,9,"male",387,35,22,0,0,0,0,0,0
1625723,39,26,1974,9,"male",316,53,28,0,0,0,0,0,0
1625740,28,1,1985,1,"male",72,7,6,25,25,25,9,0,16
1625758,28,14,1985,3,"male",180,75,45,113,162,113,146,0,16
1625775,50,14,1963,7,"male",397,1,1,0,0,0,0,0,0
1625782,36,8,1977,4,"male",150,69,63,1,2,1,0,0,2
1625801,15,20,1998,1,"female",221,629,366,152,439,34,132,118,307
1625811,107,11,1906,4,"female",1956,846,284,644,342,0,141,644,201
1625817,81,1,1932,3,"female",272,9,7,1,1,0,1,1,0
1625823,57,29,1956,9,"male",55,2,2,2,0,2,0,0,0
1625825,22,10,1991,11,"female",402,68,54,259,263,249,78,10,185
1625834,32,2,1981,4,"male",339,12,7,0,0,0,0,0,0
1625838,14,13,1999,9,"female",462,198,116,147,36,147,31,0,5
1625860,26,4,1987,4,"female",448,14,5,6,16,6,16,0,0
1625868,26,10,1987,8,"male",345,53,43,3,25,3,6,0,19
1625879,25,1,1988,1,"male",168,11,9,0,0,0,0,0,0
1625884,25,20,1988,12,"male",592,124,97,2,0,2,0,0,0
1625901,27,17,1986,2,"female",1468,77,33,603,451,443,228,160,223
1625935,18,7,1995,7,"male",333,37,21,12,5,12,5,0,0
1625941,20,27,1993,9,"male",301,260,187,46,57,41,42,5,15
1625954,27,5,1986,10,"male",284,87,60,0,0,0,0,0,0
1625968,17,13,1996,1,"female",61,94,23,0,33,0,14,0,19
1625991,23,7,1990,6,"male",27,19,19,0,0,0,0,0,0
1626068,23,14,1990,2,"male",408,45,32,0,12,0,1,0,11
1626106,55,18,1958,1,"female",170,40,34,1,0,1,0,0,0
1626109,29,26,1984,11,"female",419,116,74,7,8,7,6,0,2
1626113,25,18,1988,7,"male",883,246,157,134,188,27,153,107,35
1626124,66,5,1947,9,"male",636,33,24,30,40,27,29,3,11
1626129,24,1,1989,1,"male",454,1,1,0,0,0,0,0,0
1626132,17,27,1996,7,"male",132,51,46,0,1,0,1,0,0
1626148,49,29,1964,5,"male",252,9,6,0,0,0,0,0,0
1626150,35,19,1978,7,"female",262,39,6,27,7,10,6,17,1
1626157,46,16,1967,4,"female",755,68,13,0,23,0,6,0,17
1626170,20,2,1993,3,"male",694,2,0,0,0,0,0,0,0
1626184,15,20,1998,10,"male",740,114,40,0,9,0,8,0,1
1626220,40,3,1973,3,"female",271,33,22,39,4,1,3,38,1
1626261,56,17,1957,3,"male",29,40,34,85,37,85,32,0,5
1626292,49,17,1964,4,"male",263,149,27,14,1,14,0,0,1
1626306,38,19,1975,4,"female",338,13,9,11,2,11,0,0,2
1626322,52,21,1961,6,"male",779,61,17,0,0,0,0,0,0
1626333,20,26,1993,10,"female",111,247,128,21,17,20,14,1,3
1626342,18,29,1995,1,"female",584,363,282,436,240,436,181,0,59
1626410,30,28,1983,8,"female",560,22,11,12,1,12,1,0,0
1626428,25,29,1988,1,"male",483,63,49,0,0,0,0,0,0
1626431,28,1,1985,1,"male",809,329,214,1,10,1,9,0,1
1626457,59,22,1954,3,"male",418,20,15,26,6,26,3,0,3
1626514,33,6,1980,5,"female",470,0,0,0,0,0,0,0,0
1626533,65,6,1948,1,"male",1004,110,75,0,0,0,0,0,0
1626536,26,25,1987,1,"male",199,57,45,2,26,2,13,0,13
1626545,19,20,1994,12,"male",287,272,20,0,0,0,0,0,0
1626559,25,1,1988,1,"male",0,0,0,1,0,1,0,0,0
1626575,34,30,1979,4,"female",507,424,182,811,206,811,203,0,3
1626622,15,14,1998,1,"male",264,122,80,1,1,1,1,0,0
1626638,36,4,1977,11,"male",549,6,6,0,0,0,0,0,0
1626646,50,26,1963,2,"female",1694,55,23,90,51,77,39,13,12
1626654,43,6,1970,10,"male",408,89,56,31,10,31,9,0,1
1626698,16,10,1997,5,"female",462,148,107,48,74,47,51,1,23
1626715,48,15,1965,3,"female",954,71,34,412,41,412,27,0,14
1626730,108,25,1905,12,"male",184,49,43,6,2,6,2,0,0
1626774,34,11,1979,4,"female",762,84,45,164,89,164,50,0,39
1626865,103,28,1910,1,"male",585,275,175,242,79,242,57,0,22
1626886,22,14,1991,2,"male",145,81,66,82,36,59,22,23,14
1626915,18,24,1995,11,"female",331,329,151,119,130,3,17,116,113
1626924,65,31,1948,7,"female",890,68,47,1708,815,171,126,1537,689
1626956,44,11,1969,2,"female",203,153,88,48,90,48,30,0,60
1626975,64,28,1949,3,"female",352,9,8,0,0,0,0,0,0
1626988,43,12,1970,12,"male",326,73,58,2,3,2,2,0,1
1627007,18,6,1995,6,"male",193,53,31,0,0,0,0,0,0
1627009,25,19,1988,3,"male",148,66,51,99,33,99,30,0,3
1627026,22,25,1991,1,"male",616,55,28,0,0,0,0,0,0
1627028,25,13,1988,2,"male",26,4,4,1,0,1,0,0,0
1627038,31,31,1982,3,"male",746,189,50,12,0,12,0,0,0
1627039,24,21,1989,5,"male",286,9,0,0,0,0,0,0,0
1627056,44,11,1969,1,"female",1765,217,43,47,19,47,12,0,7
1627067,28,31,1985,12,"male",177,42,16,0,0,0,0,0,0
1627085,16,26,1997,3,"male",108,73,58,46,4,46,3,0,1
1627088,25,13,1988,2,"male",428,92,88,0,1,0,1,0,0
1627089,46,13,1967,7,"male",537,152,123,13,10,13,7,0,3
1627139,28,1,1985,11,"male",343,221,216,7,6,7,5,0,1
1627144,19,10,1994,7,"female",316,209,141,465,152,465,103,0,49
1627164,21,21,1992,12,"male",94,34,27,3,1,3,1,0,0
1627176,63,4,1950,7,"female",1474,51,34,131,64,131,48,0,16
1627200,37,17,1976,9,"female",502,258,168,24,58,24,48,0,10
1627213,32,24,1981,12,"female",660,375,248,0,1,0,1,0,0
1627230,37,4,1976,12,"male",911,199,112,192,21,188,13,4,8
1627246,31,7,1982,7,"female",85,7,4,1,0,1,0,0,0
1627269,29,3,1984,2,"male",262,84,74,146,32,146,28,0,4
1627294,23,6,1990,1,"male",704,5,2,0,0,0,0,0,0
1627318,40,17,1973,9,"male",383,22,14,422,169,368,102,54,67
1627343,44,27,1969,9,"male",728,17,10,1,5,1,2,0,3
1627352,47,21,1966,11,"female",1593,550,206,279,301,218,168,61,133
1627364,21,14,1992,8,"female",385,290,138,106,29,6,17,100,12
1627367,21,24,1992,7,"female",493,279,122,0,1,0,1,0,0
1627375,28,8,1985,5,"male",297,3,2,0,0,0,0,0,0
1627379,22,16,1991,10,"female",1043,1905,832,911,1191,911,900,0,291
1627399,66,4,1947,2,"male",1702,26,11,0,0,0,0,0,0
1627431,41,24,1972,10,"female",539,12,3,3,3,3,2,0,1
1627451,108,1,1905,12,"male",200,67,24,0,0,0,0,0,0
1627508,25,1,1988,1,"male",43,5,4,26,13,0,1,26,12
1627509,38,21,1975,8,"male",341,16,11,1,0,1,0,0,0
1627526,25,10,1988,5,"male",10,12,11,14,7,14,7,0,0
1627574,67,9,1946,6,"female",1206,28,5,2,0,0,0,2,0
1627576,108,28,1905,8,"female",70,33,21,7,4,7,3,0,1
1627579,56,28,1957,9,"female",1291,94,53,4,8,4,5,0,3
1627598,23,29,1990,6,"male",859,154,87,0,0,0,0,0,0
1627624,23,16,1990,9,"male",270,773,655,770,259,770,222,0,37
1627627,19,12,1994,4,"female",261,74,29,6,6,6,5,0,1
1627638,103,4,1910,11,"female",1293,1603,561,9,18,6,17,3,1
1627656,17,4,1996,7,"female",432,283,97,60,13,0,4,60,9
1627702,26,29,1987,9,"female",235,84,78,11,8,11,8,0,0
1627773,26,8,1987,12,"female",509,116,58,274,16,274,13,0,3
1627800,30,17,1983,8,"male",770,3,3,0,0,0,0,0,0
1627805,54,19,1959,9,"female",1084,43,29,20,8,1,0,19,8
1627827,68,2,1945,12,"female",1187,43,23,23,10,22,6,1,4
1627844,29,19,1984,5,"male",216,35,13,11,7,11,7,0,0
1627863,57,1,1956,1,"male",508,14,11,3,0,3,0,0,0
1627885,33,27,1980,11,"male",250,16,6,0,0,0,0,0,0
1627913,57,1,1956,1,"male",141,11,0,0,6,0,6,0,0
1627923,62,18,1951,3,"male",163,35,12,1031,69,1027,24,4,45
1627943,36,7,1977,7,"male",318,19,17,3,0,0,0,3,0
1627948,108,31,1905,5,"male",980,197,67,5,2,0,1,5,1
1627953,28,16,1985,4,"female",26,10,9,15,6,14,1,1,5
1627965,18,5,1995,9,"female",396,382,221,61,21,61,17,0,4
1627981,73,11,1940,1,"female",675,54,41,27,2,27,2,0,0
1627994,29,25,1984,1,"male",816,159,116,7,101,0,42,7,59
1628001,28,4,1985,10,"female",408,82,21,240,279,239,162,1,117
1628004,23,8,1990,10,"male",103,13,12,17,0,17,0,0,0
1628016,16,9,1997,12,"male",303,66,28,0,2,0,0,0,2
1628018,30,24,1983,3,"male",340,20,8,5,9,5,9,0,0
1628021,38,25,1975,1,"male",1110,46,15,1,0,1,0,0,0
1628023,36,1,1977,6,"male",1884,117,46,1,8,0,7,1,1
1628029,18,14,1995,5,"female",206,378,307,513,300,333,166,180,134
1628032,63,11,1950,3,"male",671,50,34,46,21,0,5,46,16
1628058,95,7,1918,4,"male",1397,144,35,15,5,7,1,8,4
1628059,59,28,1954,5,"male",437,28,26,0,0,0,0,0,0
1628066,54,19,1959,2,"female",190,508,228,21,9,21,4,0,5
1628112,28,13,1985,6,"male",514,351,13,67,282,67,250,0,32
1628114,25,1,1988,8,"male",14,12,11,1,10,1,8,0,2
1628128,23,2,1990,5,"male",590,1283,1044,377,478,40,252,337,226
1628141,23,18,1990,4,"male",1175,203,80,10,1,7,1,3,0
1628146,43,25,1970,3,"male",566,38,26,0,1,0,1,0,0
1628170,26,1,1987,8,"male",88,122,66,1,6,0,2,1,4
1628194,24,8,1989,10,"male",266,149,128,1,0,0,0,1,0
1628199,14,1,1999,11,"male",145,163,69,6,51,6,37,0,14
1628206,39,27,1974,8,"female",531,115,57,138,54,2,16,136,38
1628224,74,17,1939,3,"female",182,20,17,31,16,31,16,0,0
1628225,16,24,1997,2,"male",263,151,93,8,1,8,1,0,0
1628242,17,6,1996,3,"male",119,106,93,13,6,13,4,0,2
1628248,23,16,1990,3,"male",394,234,47,1,1,1,1,0,0
1628260,19,7,1994,2,"male",53,137,111,309,290,22,119,287,171
1628285,55,3,1958,7,"female",1286,250,149,523,220,391,162,132,58
1628298,28,18,1985,12,"female",13,115,86,179,158,86,67,93,91
1628337,17,14,1996,11,"female",13,158,20,0,7,0,4,0,3
1628355,21,2,1992,5,"male",518,163,111,3,3,2,3,1,0
1628376,19,4,1994,10,"male",138,0,0,0,0,0,0,0,0
1628435,14,15,1999,12,"female",51,150,105,103,33,98,30,5,3
1628452,19,7,1994,7,"male",571,229,54,2,6,2,4,0,2
1628463,62,3,1951,4,"female",1290,279,100,7,0,6,0,1,0
1628478,20,20,1993,3,"male",758,428,270,4,2,4,2,0,0
1628535,35,11,1978,3,"male",547,151,69,0,0,0,0,0,0
1628571,15,23,1998,9,"female",243,31,16,160,177,56,99,104,78
1628586,15,24,1998,2,"male",275,4,2,0,0,0,0,0,0
1628626,76,19,1937,7,"male",1399,52,38,17,38,0,11,17,27
1628655,25,10,1988,3,"male",285,3,3,2,1,1,0,1,1
1628656,68,1,1945,12,"female",617,23,22,35,49,0,3,35,46
1628666,17,19,1996,8,"female",720,1053,267,9,153,9,123,0,30
1628673,34,2,1979,10,"female",466,12,3,11,19,11,17,0,2
1628679,44,22,1969,2,"male",907,651,431,58,42,12,34,46,8
1628718,23,1,1990,1,"male",211,101,39,88,41,61,24,27,17
1628726,19,11,1994,1,"male",42,1,1,1,0,1,0,0,0
1628730,19,1,1994,1,"male",639,258,194,0,3,0,2,0,1
1628737,20,13,1993,2,"male",168,38,25,0,0,0,0,0,0
1628745,59,9,1954,7,"male",1941,88,12,211,137,207,73,4,64
1628807,52,21,1961,1,"female",924,24,17,29,11,29,10,0,1
1628858,55,26,1958,5,"female",719,61,55,209,114,56,44,153,70
1628859,39,15,1974,10,"female",294,0,0,0,0,0,0,0,0
1628907,43,30,1970,5,"female",402,180,155,1571,161,1571,127,0,34
1628915,16,1,1997,10,"male",236,305,266,334,210,295,147,39,63
1628916,72,22,1941,6,"female",1823,50,13,18,16,12,8,6,8
1628932,50,6,1963,7,"male",2,28,20,97,35,87,11,10,24
1628953,17,12,1996,8,"male",270,742,347,69,55,23,26,46,29
1628959,36,20,1977,12,"male",513,280,205,39,144,39,143,0,1
1629003,39,14,1974,2,"female",425,35,17,18,4,0,0,18,4
1629008,61,4,1952,5,"male",558,30,24,27,40,26,34,1,6
1629035,18,16,1995,10,"male",624,373,339,785,84,785,79,0,5
1629049,55,5,1958,9,"female",387,99,57,9,2,9,2,0,0
1629054,14,6,1999,4,"female",726,407,194,422,222,244,91,178,131
1629082,25,1,1988,1,"male",289,0,0,0,0,0,0,0,0
1629098,57,5,1956,5,"male",1443,131,77,16,36,1,8,15,28
1629111,15,15,1998,7,"female",737,866,517,236,362,122,139,114,223
1629115,20,23,1993,8,"male",233,351,104,237,75,237,71,0,4
1629155,76,12,1937,11,"female",259,25,19,90,34,2,16,88,18
1629157,17,14,1996,2,"male",291,47,36,0,0,0,0,0,0
1629186,21,12,1992,12,"male",928,471,300,0,0,0,0,0,0
1629203,33,12,1980,2,"female",602,84,66,55,2,55,1,0,1
1629204,26,4,1987,10,"male",347,182,93,0,8,0,5,0,3
1629207,21,21,1992,11,"male",609,182,145,0,11,0,6,0,5
1629208,103,5,1910,5,"male",1208,112,104,67,11,63,10,4,1
1629212,70,14,1943,7,"male",157,36,26,8,8,0,4,8,4
1629215,35,10,1978,8,"male",223,176,39,2,9,2,5,0,4
1629268,15,3,1998,6,"female",409,473,343,113,172,33,35,80,137
1629284,73,11,1940,7,"male",117,0,0,0,0,0,0,0,0
1629293,51,23,1962,5,"female",133,79,68,32,49,32,18,0,31
1629318,66,20,1947,12,"male",1551,101,21,0,0,0,0,0,0
1629522,23,10,1990,2,"female",654,340,234,87,84,60,15,27,69
1629533,64,13,1949,9,"male",1111,114,63,36,0,36,0,0,0
1629537,21,4,1992,3,"female",220,64,51,65,5,17,0,48,5
1629556,67,27,1946,2,"male",1195,33,8,1,43,0,3,1,40
1629569,27,10,1986,4,"female",593,45,19,4,72,4,34,0,38
1629583,22,21,1991,7,"male",52,19,18,0,0,0,0,0,0
1629587,13,14,2000,1,"female",247,275,175,37,17,37,14,0,3
1629623,17,9,1996,10,"female",374,0,0,0,0,0,0,0,0
1629628,23,15,1990,9,"male",577,98,75,0,0,0,0,0,0
1629633,20,30,1993,12,"female",519,126,35,74,5,3,1,71,4
1629641,93,8,1920,8,"male",183,60,46,24,1,24,1,0,0
1629649,23,7,1990,7,"male",767,293,85,576,1128,18,226,558,902
1629657,49,15,1964,8,"male",171,29,23,3,1,0,0,3,1
1629661,23,1,1990,3,"male",102,26,17,0,11,0,10,0,1
1629679,17,14,1996,3,"male",178,235,109,291,173,291,102,0,71
1629691,60,7,1953,5,"male",594,45,15,2,1,0,0,2,1
1629717,59,20,1954,11,"male",691,99,44,38,15,0,9,38,6
1629725,69,4,1944,3,"female",126,25,19,11,0,0,0,11,0
1629773,43,1,1970,1,"male",127,37,34,2,23,2,18,0,5
1629780,25,14,1988,8,"male",214,140,130,1,3,1,0,0,3
1629782,27,6,1986,9,"male",1301,379,140,5,14,2,10,3,4
1629848,37,27,1976,8,"male",125,13,13,73,26,73,26,0,0
1629858,22,10,1991,5,"male",81,89,55,302,0,302,0,0,0
1629859,16,26,1997,5,"male",925,42,24,131,60,131,51,0,9
1629868,33,15,1980,5,"male",306,6,6,1,0,1,0,0,0
1629923,41,11,1972,2,"male",297,11,10,21,1,21,1,0,0
1629962,15,4,1998,4,"female",212,143,57,418,33,361,31,57,2
1629980,28,6,1985,6,"female",372,1050,169,1161,2134,1161,1967,0,167
1629987,18,22,1995,7,"female",559,213,71,26,23,26,20,0,3
1629994,15,23,1998,11,"male",467,171,84,15,0,15,0,0,0
1630015,59,2,1954,12,"female",327,118,43,3,31,0,8,3,23
1630036,18,8,1995,2,"female",329,15,7,1,5,0,2,1,3
1630064,35,6,1978,2,"male",443,45,36,0,0,0,0,0,0
1630072,113,30,1900,11,"female",1314,286,114,126,49,126,37,0,12
1630083,31,31,1982,3,"female",551,219,120,14,365,0,34,14,331
1630142,19,8,1994,8,"female",203,112,81,83,116,83,73,0,43
1630143,26,17,1987,10,"male",990,244,7,0,0,0,0,0,0
1630185,15,1,1998,8,"male",459,137,37,0,12,0,8,0,4
1630188,18,21,1995,7,"male",147,22,9,1,0,1,0,0,0
1630193,15,15,1998,8,"female",333,274,133,86,108,55,51,31,57
1630225,14,5,1999,1,"female",127,486,375,1565,1118,1124,551,441,567
1630231,18,18,1995,8,"male",561,748,578,23,80,23,65,0,15
1630257,24,4,1989,2,"male",898,230,95,1,2,0,2,1,0
1630303,49,22,1964,10,"male",294,6,4,8,0,8,0,0,0
1630331,29,18,1984,6,"male",294,29,22,0,3,0,0,0,3
1630338,76,1,1937,9,"female",223,242,129,18,9,18,5,0,4
1630348,33,20,1980,6,"male",492,60,38,0,2,0,1,0,1
1630362,24,9,1989,2,"male",545,112,77,159,48,159,33,0,15
1630372,19,14,1994,9,"male",1014,1375,1032,27,10,1,6,26,4
1630390,54,2,1959,4,"male",126,50,30,160,11,160,2,0,9
1630402,28,9,1985,6,"female",553,287,136,174,144,174,57,0,87
1630406,43,17,1970,12,"male",626,1,1,0,1,0,1,0,0
1630418,18,1,1995,1,"male",398,1556,1181,88,616,8,512,80,104
1630433,103,28,1910,8,"male",649,588,450,1,0,1,0,0,0
1630454,54,14,1959,2,"female",472,55,12,1,7,1,7,0,0
1630455,19,2,1994,2,"female",604,106,36,0,5,0,0,0,5
1630511,47,3,1966,6,"female",262,69,57,994,196,994,152,0,44
1630534,67,10,1946,11,"female",133,26,18,0,2,0,1,0,1
1630551,21,29,1992,2,"male",547,156,79,38,24,33,9,5,15
1630558,47,23,1966,6,"female",251,36,25,52,3,52,2,0,1
1630580,23,19,1990,12,"male",188,65,46,1,4,1,4,0,0
1630593,51,22,1962,8,"female",1961,293,101,28,17,27,11,1,6
1630602,21,25,1992,12,"male",69,2,1,0,0,0,0,0,0
1630660,49,13,1964,5,"female",382,94,62,688,237,388,92,300,145
1630673,31,5,1982,3,"male",447,64,47,0,0,0,0,0,0
1630690,21,18,1992,12,"male",635,479,376,0,44,0,29,0,15
1630718,18,13,1995,4,"male",474,233,176,27,32,27,8,0,24
1630729,101,23,1912,2,"female",2425,118,63,52,12,52,8,0,4
1630741,36,30,1977,9,"male",356,2,2,0,0,0,0,0,0
1630744,19,27,1994,6,"female",217,373,143,735,595,697,406,38,189
1630760,42,21,1971,2,"male",280,42,28,41,18,0,6,41,12
1630785,66,24,1947,10,"male",427,176,141,3,0,0,0,3,0
1630804,48,28,1965,3,"female",20,29,17,3,5,0,1,3,4
1630841,20,12,1993,12,"female",297,26,14,38,181,38,149,0,32
1630886,49,5,1964,5,"female",1950,178,31,8,636,8,347,0,289
1630888,37,4,1976,2,"male",508,128,61,9,19,9,13,0,6
1630891,18,23,1995,8,"female",390,33,20,56,10,0,4,56,6
1630893,51,25,1962,2,"male",141,2,1,1,0,1,0,0,0
1630896,59,14,1954,1,"female",2391,365,179,41,55,35,29,6,26
1630915,25,4,1988,4,"female",99,547,316,4005,5513,4005,3167,0,2346
1630918,18,20,1995,2,"female",216,90,34,626,37,626,37,0,0
1630923,26,31,1987,12,"female",476,115,44,1,2,1,1,0,1
1630943,52,20,1961,10,"male",923,22,11,4,6,0,0,4,6
1630956,69,11,1944,5,"female",53,25,15,51,51,51,17,0,34
1630995,55,14,1958,10,"male",1427,171,40,41,89,0,21,41,68
1631000,28,7,1985,7,"male",611,71,53,12,0,12,0,0,0
1631005,51,10,1962,7,"female",332,4,3,0,0,0,0,0,0
1631009,74,8,1939,10,"female",1183,28,12,0,0,0,0,0,0
1631028,17,4,1996,3,"male",70,8,8,0,2,0,2,0,0
1631059,13,5,2000,5,"male",102,41,20,1,0,1,0,0,0
1631096,21,8,1992,3,"male",72,75,68,22,14,22,11,0,3
1631097,19,1,1994,1,"male",87,20,10,52,0,52,0,0,0
1631138,67,14,1946,1,"female",1021,38,24,76,6,0,2,76,4
1631142,26,23,1987,10,"male",489,108,84,10,39,10,26,0,13
1631155,43,10,1970,3,"male",693,28,21,21,7,0,0,21,7
1631161,49,24,1964,5,"female",647,70,34,984,274,284,101,700,173
1631166,47,26,1966,6,"female",418,124,32,771,241,0,79,771,162
1631230,21,3,1992,1,"male",1199,160,126,9,1,9,1,0,0
1631233,18,20,1995,2,"male",66,105,90,54,16,54,14,0,2
1631235,53,25,1960,3,"male",162,144,37,118,20,33,1,85,19
1631268,21,19,1992,2,"female",359,1,1,0,0,0,0,0,0
1631286,14,14,1999,1,"male",301,25,22,0,0,0,0,0,0
1631287,15,18,1998,8,"female",542,430,269,119,386,102,215,17,171
1631294,21,4,1992,3,"male",764,1022,755,503,248,503,174,0,74
1631297,15,15,1998,7,"male",122,57,37,0,0,0,0,0,0
1631316,23,25,1990,10,"male",726,88,63,217,5,209,4,8,1
1631321,40,4,1973,3,"female",367,88,49,14,0,14,0,0,0
1631333,37,2,1976,1,"female",278,24,7,45,76,45,62,0,14
1631346,23,29,1990,3,"male",428,295,197,4,26,2,6,2,20
1631353,18,16,1995,9,"female",481,262,27,223,148,223,47,0,101
1631358,22,22,1991,9,"male",29,24,22,0,0,0,0,0,0
1631381,59,1,1954,10,"female",774,36,31,69,42,64,27,5,15
1631400,57,18,1956,7,"female",1225,73,45,74,141,0,5,74,136
1631410,103,30,1910,1,"female",1807,135,65,5,6,5,0,0,6
1631422,52,18,1961,8,"male",1122,178,101,1,0,1,0,0,0
1631424,103,16,1910,11,"female",523,125,63,0,3,0,3,0,0
1631428,53,1,1960,6,"female",421,284,82,3,1,3,1,0,0
1631440,17,28,1996,10,"female",258,611,374,184,192,184,100,0,92
1631449,24,4,1989,4,"female",20,41,15,1,1,1,1,0,0
1631453,38,25,1975,6,"female",78,46,21,97,48,97,40,0,8
1631459,31,15,1982,12,"male",85,29,27,0,7,0,1,0,6
1631465,108,4,1905,10,"female",3129,720,282,421,439,176,296,245,143
1631468,18,2,1995,10,"male",267,19,14,15,0,15,0,0,0
1631472,24,23,1989,4,"female",495,112,9,0,0,0,0,0,0
1631480,52,20,1961,11,"male",634,36,10,220,241,218,137,2,104
1631505,18,26,1995,1,"male",437,71,51,6,1,3,1,3,0
1631509,36,10,1977,1,"male",272,4,4,8,3,5,1,3,2
1631513,30,18,1983,7,"female",479,63,38,27,10,27,6,0,4
1631523,57,10,1956,11,"female",1415,67,42,196,102,63,43,133,59
1631526,16,26,1997,10,"male",540,31,21,1,0,1,0,0,0
1631538,17,5,1996,8,"female",716,3738,2060,4790,2475,4269,1716,521,759
1631567,20,2,1993,9,"male",645,170,111,0,0,0,0,0,0
1631592,17,16,1996,9,"male",473,91,54,91,72,3,48,88,24
1631610,36,20,1977,11,"female",2091,280,184,118,311,118,292,0,19
1631634,29,11,1984,4,"female",1396,605,179,529,979,524,873,5,106
1631639,45,31,1968,10,"female",410,59,26,369,85,0,42,369,43
1631664,28,7,1985,6,"female",304,19,9,19,6,19,4,0,2
1631695,46,23,1967,7,"female",322,8,6,44,20,0,3,44,17
1631696,16,5,1997,1,"female",134,12,8,109,104,108,41,1,63
1631701,35,8,1978,6,"male",325,35,16,8,0,8,0,0,0
1631702,23,21,1990,11,"male",188,185,58,0,0,0,0,0,0
1631705,18,4,1995,3,"male",281,217,184,196,20,196,18,0,2
1631715,38,1,1975,1,"female",345,144,127,216,96,93,65,123,31
1631716,55,28,1958,12,"male",530,50,15,8,14,0,0,8,14
1631740,18,13,1995,2,"female",471,283,147,442,340,438,270,4,70
1631822,23,10,1990,6,"male",418,23,6,0,1,0,0,0,1
1631860,14,7,1999,1,"female",81,58,34,10,3,0,2,10,1
1631877,23,23,1990,7,"male",89,63,44,0,1,0,1,0,0
1631882,28,11,1985,2,"male",363,6,5,0,0,0,0,0,0
1631888,61,18,1952,12,"male",2083,64,10,2,0,2,0,0,0
1631894,28,10,1985,10,"male",458,93,67,376,136,245,39,131,97
1631899,18,8,1995,8,"male",179,39,32,0,1,0,1,0,0
1631945,38,20,1975,12,"male",355,29,25,0,1,0,1,0,0
1631955,24,10,1989,12,"male",367,100,87,35,6,35,3,0,3
1632020,19,24,1994,4,"male",665,145,65,41,24,41,23,0,1
1632040,93,23,1920,5,"female",1505,242,78,0,0,0,0,0,0
1632067,18,8,1995,6,"male",119,174,149,0,0,0,0,0,0
1632072,44,7,1969,1,"male",1330,44,12,5,1,5,0,0,1
1632092,50,14,1963,6,"male",912,88,40,80,35,80,29,0,6
1632150,17,30,1996,11,"male",849,919,577,1,7,1,6,0,1
1632155,60,12,1953,9,"female",387,0,0,0,0,0,0,0,0
1632192,55,7,1958,11,"male",551,33,18,0,0,0,0,0,0
1632197,57,20,1956,11,"female",1028,492,382,711,691,345,196,366,495
1632207,22,19,1991,11,"female",360,161,22,2,6,2,4,0,2
1632209,15,10,1998,5,"male",350,235,189,0,1,0,0,0,1
1632214,49,18,1964,8,"female",2207,95,47,155,185,155,119,0,66
1632219,20,15,1993,4,"male",286,2,1,1,1,0,0,1,1
1632228,52,10,1961,9,"female",734,134,92,4,69,0,50,4,19
1632229,77,1,1936,8,"male",581,492,77,176,315,0,55,176,260
1632232,16,8,1997,8,"male",335,2,2,2,1,2,1,0,0
1632239,21,14,1992,3,"male",721,178,113,8,0,8,0,0,0
1632247,63,25,1950,3,"female",1845,59,24,284,95,102,47,182,48
1632256,16,13,1997,3,"female",410,537,398,33,4,21,3,12,1
1632261,60,10,1953,9,"male",1569,77,40,38,33,32,24,6,9
1632293,66,1,1947,1,"male",1136,20,11,1,2,0,1,1,1
1632315,29,5,1984,5,"male",155,26,24,0,1,0,0,0,1
1632341,41,13,1972,1,"male",263,12,10,6,2,6,2,0,0
1632349,18,21,1995,10,"female",195,214,101,69,32,69,32,0,0
1632397,25,29,1988,1,"male",75,35,31,3,0,3,0,0,0
1632432,24,23,1989,6,"male",351,9,9,7,0,7,0,0,0
1632467,35,27,1978,1,"male",636,29,14,4,1,0,0,4,1
1632488,14,12,1999,4,"male",134,83,35,93,32,82,26,11,6
1632500,19,24,1994,6,"female",188,91,41,285,47,265,20,20,27
1632505,63,18,1950,11,"male",143,3,3,0,0,0,0,0,0
1632508,17,13,1996,4,"female",392,211,90,18,31,18,15,0,16
1632536,19,27,1994,5,"male",277,5,4,0,0,0,0,0,0
1632552,31,26,1982,7,"female",788,433,209,71,124,60,107,11,17
1632553,26,18,1987,4,"male",253,21,4,5,1,5,1,0,0
1632581,25,23,1988,3,"male",230,16,13,0,0,0,0,0,0
1632595,26,1,1987,1,"male",81,101,89,0,4,0,1,0,3
1632609,21,12,1992,9,"male",212,73,64,4,0,4,0,0,0
1632613,56,30,1957,12,"female",1028,19,12,63,44,57,38,6,6
1632614,17,19,1996,11,"male",678,63,37,0,1,0,0,0,1
1632637,19,10,1994,7,"male",413,1109,1000,4,4,0,0,4,4
1632680,50,25,1963,3,"female",527,128,64,182,82,182,40,0,42
1632701,42,2,1971,9,"male",704,39,23,0,0,0,0,0,0
1632703,22,4,1991,5,"male",377,81,56,0,0,0,0,0,0
1632705,21,20,1992,3,"male",426,167,160,0,0,0,0,0,0
1632717,16,16,1997,6,"male",364,325,281,0,2,0,2,0,0
1632719,18,23,1995,1,"male",493,252,139,1,0,1,0,0,0
1632766,31,2,1982,3,"female",630,89,56,3,0,0,0,3,0
1632824,18,7,1995,7,"male",153,18,9,54,5,54,2,0,3
1632828,97,4,1916,1,"male",1906,311,137,49,10,49,10,0,0
1632844,16,8,1997,1,"male",25,97,64,0,0,0,0,0,0
1632857,33,17,1980,5,"male",754,156,129,119,28,119,23,0,5
1632880,58,26,1955,5,"male",1354,134,78,19,5,15,2,4,3
1632888,18,30,1995,1,"female",387,190,102,2,2,2,1,0,1
1632892,39,28,1974,2,"male",2055,246,217,300,527,0,143,300,384
1632928,18,6,1995,1,"female",249,1243,228,72,88,9,27,63,61
1632937,25,5,1988,1,"male",173,9,8,0,0,0,0,0,0
1632948,17,1,1996,11,"female",290,229,91,3,4,1,1,2,3
1632974,20,24,1993,8,"male",574,132,117,1,1,1,1,0,0
1632982,38,10,1975,3,"male",396,14,10,3,8,3,8,0,0
1633009,25,1,1988,1,"female",89,22,11,196,71,196,60,0,11
1633021,103,19,1910,9,"male",428,75,49,1,3,1,3,0,0
1633038,103,31,1910,5,"male",1053,560,163,116,32,111,24,5,8
1633057,74,6,1939,6,"female",73,278,76,8,28,0,17,8,11
1633058,25,12,1988,10,"male",251,46,31,3,5,3,5,0,0
1633063,32,9,1981,10,"male",402,152,98,81,1581,66,706,15,875
1633083,15,1,1998,8,"male",216,208,36,1,0,1,0,0,0
1633086,100,7,1913,5,"female",1017,194,97,58,36,58,25,0,11
1633088,25,19,1988,10,"female",448,144,65,0,1,0,0,0,1
1633097,57,16,1956,12,"female",1370,369,185,1064,686,1063,355,1,331
1633101,21,31,1992,3,"male",237,17,16,4,12,4,11,0,1
1633127,100,22,1913,2,"male",467,217,181,557,25,557,9,0,16
1633128,23,8,1990,10,"male",569,63,6,0,0,0,0,0,0
1633159,15,31,1998,1,"female",33,8,3,108,37,108,36,0,1
1633190,30,27,1983,7,"male",118,68,52,96,29,92,11,4,18
1633207,26,28,1987,1,"female",232,37,22,585,360,585,214,0,146
1633208,66,27,1947,3,"male",733,2691,2376,407,299,407,265,0,34
1633233,90,23,1923,12,"male",611,1242,927,1999,257,1999,234,0,23
1633245,44,17,1969,7,"male",573,31,25,18,0,18,0,0,0
1633249,52,1,1961,6,"male",124,60,26,93,20,63,9,30,11
1633257,82,27,1931,5,"female",109,9,6,1,1,1,1,0,0
1633267,33,27,1980,12,"male",532,53,36,45,17,41,10,4,7
1633274,18,21,1995,6,"male",967,231,88,0,0,0,0,0,0
1633279,28,28,1985,5,"male",571,42,4,0,2,0,1,0,1
1633284,18,14,1995,8,"male",448,1221,943,6,49,6,46,0,3
1633293,108,19,1905,10,"male",175,178,151,260,105,260,87,0,18
1633302,27,10,1986,2,"male",241,635,583,4,16,4,15,0,1
1633339,28,17,1985,5,"female",323,68,53,56,103,56,88,0,15
1633348,16,18,1997,11,"female",342,791,140,173,225,171,173,2,52
1633354,23,25,1990,11,"male",514,47,25,2,0,0,0,2,0
1633387,24,30,1989,4,"female",385,81,28,10,5,10,2,0,3
1633388,32,20,1981,7,"female",23,11,2,0,0,0,0,0,0
1633394,17,26,1996,6,"female",658,201,90,529,195,428,115,101,80
1633413,61,7,1952,4,"female",1914,598,281,4749,1806,3507,970,1242,836
1633422,69,6,1944,1,"female",1048,241,86,54,20,0,6,54,14
1633423,51,19,1962,7,"female",218,182,108,26,15,15,11,11,4
1633426,72,18,1941,8,"female",1406,99,60,43,11,28,9,15,2
1633427,21,27,1992,3,"male",594,337,251,77,48,72,39,5,9
1633447,59,4,1954,11,"female",564,332,252,72,169,0,10,72,159
1633483,67,30,1946,11,"female",64,19,15,21,2,21,1,0,1
1633500,37,6,1976,5,"male",129,1,1,38,6,0,6,38,0
1633537,108,26,1905,3,"male",1002,466,89,4,0,4,0,0,0
1633543,21,7,1992,1,"male",917,131,60,7,2,7,2,0,0
1633549,61,28,1952,11,"female",1243,86,49,609,149,609,80,0,69
1633570,18,5,1995,9,"female",805,239,142,511,100,465,55,46,45
1633571,19,2,1994,10,"female",21,206,152,1212,1117,109,369,1103,748
1633609,30,18,1983,11,"male",119,1,1,0,1,0,0,0,1
1633631,35,26,1978,11,"female",280,152,105,66,165,66,93,0,72
1633686,45,1,1968,2,"female",107,665,8,250,579,36,228,214,351
1633705,57,10,1956,7,"male",1203,204,117,37,48,0,13,37,35
1633729,54,9,1959,8,"male",2318,65,9,0,1,0,1,0,0
1633750,63,14,1950,7,"female",639,263,116,46,8,46,7,0,1
1633791,35,1,1978,8,"female",420,68,50,299,32,299,26,0,6
1633818,35,3,1978,2,"female",665,184,145,200,210,142,125,58,85
1633820,25,1,1988,1,"male",71,59,30,26,10,26,2,0,8
1633827,59,6,1954,7,"female",2293,187,47,150,188,149,131,1,57
1633851,18,30,1995,1,"male",341,129,113,1,0,1,0,0,0
1633855,16,6,1997,8,"female",131,337,183,1009,988,284,221,725,767
1633888,38,21,1975,7,"male",827,2542,825,305,1314,198,963,107,351
1633895,26,19,1987,5,"female",496,77,44,1,91,1,55,0,36
1633908,50,10,1963,8,"male",413,243,172,0,2,0,0,0,2
1633915,108,11,1905,3,"female",2251,208,97,135,73,10,35,125,38
1633942,44,28,1969,12,"female",254,42,28,1,1,1,0,0,1
1633943,54,3,1959,4,"female",287,11,8,2,0,1,0,1,0
1633952,25,24,1988,4,"female",774,309,230,19,0,19,0,0,0
1633959,57,23,1956,10,"female",418,295,184,1657,125,0,29,1657,96
1633974,19,3,1994,9,"male",307,262,169,116,66,15,11,101,55
1633975,53,7,1960,2,"female",1739,145,103,317,366,268,165,49,201
1633996,17,4,1996,10,"male",409,141,115,3,8,3,6,0,2
1633998,59,12,1954,9,"male",383,200,185,1,1,0,0,1,1
1634025,17,1,1996,2,"female",403,79,46,0,0,0,0,0,0
1634026,25,8,1988,8,"female",453,374,303,0,14,0,12,0,2
1634058,14,31,1999,5,"male",434,286,204,2,1,2,0,0,1
1634086,25,1,1988,1,"male",262,3,3,0,0,0,0,0,0
1634094,42,18,1971,6,"male",487,5,4,0,0,0,0,0,0
1634104,36,18,1977,3,"female",285,173,142,251,444,251,330,0,114
1634106,58,17,1955,2,"female",1584,141,84,251,15,3,10,248,5
1634110,108,30,1905,12,"male",1161,1316,1075,19,10,19,10,0,0
1634115,33,4,1980,9,"male",533,5,2,0,0,0,0,0,0
1634150,15,3,1998,4,"male",289,776,356,12,54,4,25,8,29
1634171,30,7,1983,10,"female",504,378,136,99,221,15,143,84,78
1634185,39,21,1974,6,"male",616,77,46,139,61,139,53,0,8
1634199,74,12,1939,1,"female",481,33,20,0,0,0,0,0,0
1634214,33,2,1980,2,"male",44,2,2,374,18,337,5,37,13
1634228,21,7,1992,3,"male",222,222,116,41,127,41,95,0,32
1634268,21,13,1992,5,"male",555,89,61,44,11,44,3,0,8
1634277,20,27,1993,10,"female",410,380,191,10,17,1,15,9,2
1634326,19,17,1994,4,"female",287,157,61,20,11,18,6,2,5
1634338,23,22,1990,5,"male",208,1,1,0,0,0,0,0,0
1634349,53,13,1960,7,"female",789,2,1,0,9,0,5,0,4
1634378,79,7,1934,8,"female",296,66,25,1,3,0,1,1,2
1634385,13,14,2000,1,"male",135,55,20,3,4,3,4,0,0
1634388,15,19,1998,2,"female",201,194,103,286,44,19,7,267,37
1634391,22,24,1991,10,"male",137,181,169,45,11,45,11,0,0
1634404,72,20,1941,12,"male",674,46,31,0,0,0,0,0,0
1634420,46,28,1967,7,"male",200,26,19,30,0,0,0,30,0
1634422,19,4,1994,5,"male",279,251,192,295,66,268,61,27,5
1634449,18,15,1995,12,"male",353,131,102,0,1,0,0,0,1
1634463,15,6,1998,1,"female",340,634,127,98,73,98,54,0,19
1634478,39,18,1974,8,"male",117,9,8,0,0,0,0,0,0
1634483,25,22,1988,7,"male",383,0,0,0,0,0,0,0,0
1634658,16,29,1997,9,"female",1017,1107,347,243,596,83,177,160,419
1634672,63,21,1950,11,"male",320,51,25,53,20,0,7,53,13
1634675,18,23,1995,2,"female",510,160,109,72,4,72,4,0,0
1634677,17,20,1996,9,"female",415,103,63,163,21,142,1,21,20
1634697,23,16,1990,5,"male",851,70,35,61,6,7,2,54,4
1634715,21,21,1992,6,"female",375,280,125,139,319,137,223,2,96
1634765,22,20,1991,8,"male",966,7,5,0,0,0,0,0,0
1634770,40,10,1973,11,"male",826,161,16,5,2,5,2,0,0
1634779,21,2,1992,4,"female",74,11,3,9,0,9,0,0,0
1634791,21,6,1992,1,"male",419,209,161,1,0,1,0,0,0
1634798,21,1,1992,4,"female",635,142,58,58,84,44,47,14,37
1634817,38,1,1975,3,"male",922,57,39,59,17,0,15,59,2
1634823,85,29,1928,8,"female",997,32,26,6,2,0,2,6,0
1634852,58,21,1955,3,"female",683,161,68,3142,1052,0,280,3142,772
1634861,80,7,1933,4,"female",85,18,14,56,94,0,12,56,82
1634872,66,15,1947,4,"male",1336,45,21,0,0,0,0,0,0
1634873,32,8,1981,1,"male",438,77,49,0,0,0,0,0,0
1634878,35,5,1978,12,"male",338,55,42,613,108,613,107,0,1
1634894,23,14,1990,4,"male",708,96,57,42,2,42,0,0,2
1634905,18,22,1995,5,"male",1026,438,282,291,114,289,49,2,65
1634915,24,23,1989,10,"female",182,13,6,13,2,0,0,13,2
1634921,17,1,1996,2,"female",6,26,21,29,35,29,15,0,20
1634924,23,10,1990,6,"male",483,1041,828,3097,444,3097,374,0,70
1634927,61,29,1952,10,"female",522,27,11,13,8,13,7,0,1
1634930,28,1,1985,1,"male",444,37,9,3,53,2,29,1,24
1634940,65,10,1948,9,"female",10,35,34,179,17,176,12,3,5
1634964,38,11,1975,6,"male",244,38,22,27,13,27,8,0,5
1634988,22,23,1991,6,"female",930,245,194,44,66,7,6,37,60
1635032,29,24,1984,1,"male",163,105,68,494,212,494,192,0,20
1635076,40,28,1973,7,"female",421,91,68,1,0,0,0,1,0
1635090,27,5,1986,8,"male",726,10,5,0,0,0,0,0,0
1635134,20,8,1993,10,"male",293,5,5,4,0,4,0,0,0
1635166,106,15,1907,7,"female",1025,208,68,32,13,32,1,0,12
1635184,18,24,1995,11,"male",489,845,600,193,414,193,322,0,92
1635193,28,15,1985,5,"female",1103,204,120,184,590,70,548,114,42
1635209,33,18,1980,8,"male",217,14,9,21,1,21,1,0,0
1635212,38,5,1975,12,"male",323,36,9,4,0,4,0,0,0
1635217,21,27,1992,6,"male",558,134,89,59,68,54,51,5,17
1635225,72,30,1941,4,"female",1937,241,42,16,29,16,25,0,4
1635229,20,1,1993,3,"male",356,115,101,2,0,2,0,0,0
1635235,18,18,1995,7,"male",617,68,57,0,2,0,1,0,1
1635236,18,9,1995,11,"female",803,269,158,180,74,180,43,0,31
1635239,49,26,1964,1,"male",269,71,33,3,4,0,3,3,1
1635243,32,20,1981,10,"female",436,22,5,0,0,0,0,0,0
1635300,22,22,1991,4,"female",219,22,9,0,2,0,0,0,2
1635357,49,8,1964,11,"female",633,18,4,23,12,23,7,0,5
1635385,52,2,1961,1,"female",103,57,50,0,40,0,22,0,18
1635398,19,3,1994,5,"male",318,277,201,1,0,1,0,0,0
1635401,28,2,1985,8,"female",228,81,65,1,0,1,0,0,0
1635429,18,1,1995,12,"male",219,471,230,0,0,0,0,0,0
1635441,32,10,1981,2,"male",427,243,126,0,0,0,0,0,0
1635456,53,24,1960,11,"female",29,47,39,2,7,2,6,0,1
1635481,28,7,1985,10,"male",20,17,17,0,0,0,0,0,0
1635499,18,12,1995,5,"male",142,76,59,0,0,0,0,0,0
1635511,42,4,1971,10,"female",484,68,24,161,49,9,11,152,38
1635530,16,17,1997,1,"female",668,1192,682,2,86,2,77,0,9
1635584,23,3,1990,3,"female",47,69,59,3,0,3,0,0,0
1635602,23,14,1990,8,"male",157,12,11,6,0,6,0,0,0
1635614,60,16,1953,9,"female",671,84,61,5,1,0,0,5,1
1635633,23,26,1990,8,"male",295,76,29,8,0,6,0,2,0
1635638,18,9,1995,8,"male",37,135,102,39,4,39,3,0,1
1635648,65,20,1948,9,"male",123,59,37,17,19,17,16,0,3
1635657,42,4,1971,5,"male",376,1,0,0,0,0,0,0,0
1635659,25,31,1988,3,"male",118,40,30,63,66,1,39,62,27
1635697,23,12,1990,11,"male",371,207,104,8,0,8,0,0,0
1635702,19,19,1994,11,"male",347,53,35,0,6,0,2,0,4
1635706,30,20,1983,12,"male",923,791,723,0,2,0,1,0,1
1635723,26,4,1987,11,"female",2168,92,30,42,97,38,54,4,43
1635754,14,27,1999,10,"male",379,420,312,75,139,74,59,1,80
1635781,55,13,1958,6,"male",932,63,21,0,0,0,0,0,0
1635788,24,10,1989,3,"male",552,177,124,3,12,3,10,0,2
1635802,61,29,1952,9,"female",1445,13,4,18,25,18,24,0,1
1635824,29,6,1984,12,"male",1892,122,49,64,24,52,9,12,15
1635826,15,23,1998,2,"female",632,4475,750,120,500,39,260,81,240
1635827,26,30,1987,4,"male",348,8,4,0,0,0,0,0,0
1635865,26,7,1987,6,"male",24,34,7,8,7,8,5,0,2
1635871,20,3,1993,1,"female",276,6,5,0,0,0,0,0,0
1635916,19,10,1994,5,"female",290,280,102,233,389,233,246,0,143
1635931,29,10,1984,10,"male",276,40,35,1,0,1,0,0,0
1635960,25,2,1988,5,"male",93,42,27,1,6,1,6,0,0
1635966,55,30,1958,12,"male",91,101,96,39,23,9,12,30,11
1636008,22,26,1991,12,"male",1452,152,92,0,0,0,0,0,0
1636050,33,26,1980,9,"male",322,64,54,0,0,0,0,0,0
1636075,14,2,1999,2,"female",1082,300,154,42,17,40,13,2,4
1636094,48,13,1965,10,"male",712,127,51,0,3,0,2,0,1
1636108,21,1,1992,5,"female",245,4,2,121,32,115,32,6,0
1636111,58,14,1955,7,"female",167,66,53,35,37,5,22,30,15
1636116,40,24,1973,11,"female",187,13,9,146,48,146,39,0,9
1636134,53,21,1960,11,"female",2328,269,186,220,284,209,148,11,136
1636151,30,11,1983,11,"male",300,66,13,104,3,103,2,1,1
1636155,22,1,1991,5,"female",419,294,242,145,84,64,28,81,56
1636162,19,2,1994,3,"female",490,86,38,23,4,20,0,3,4
1636199,21,3,1992,9,"male",372,117,103,1,1,1,0,0,1
1636216,59,20,1954,9,"male",797,13,10,0,0,0,0,0,0
1636235,44,28,1969,6,"male",240,29,21,0,0,0,0,0,0
1636250,15,9,1998,9,"female",240,190,75,847,1022,826,445,21,577
1636254,57,30,1956,11,"male",1577,33,13,1,0,0,0,1,0
1636278,26,12,1987,10,"male",373,44,38,0,9,0,7,0,2
1636296,46,20,1967,12,"female",1300,90,49,32,31,32,31,0,0
1636315,21,1,1992,4,"male",258,1,1,0,0,0,0,0,0
1636324,14,5,1999,6,"male",508,10,7,0,0,0,0,0,0
1636336,32,12,1981,9,"male",388,56,24,478,4,228,2,250,2
1636346,19,15,1994,4,"male",72,1,0,0,0,0,0,0,0
1636354,43,20,1970,1,"male",746,35,16,75,10,75,6,0,4
1636365,46,15,1967,3,"female",597,25,13,0,0,0,0,0,0
1636381,23,23,1990,4,"male",604,116,81,35,20,2,10,33,10
1636391,93,16,1920,1,"female",1972,913,63,57,64,50,55,7,9
1636395,22,5,1991,10,"female",752,196,53,7,24,7,20,0,4
1636409,24,3,1989,5,"male",298,189,159,1206,163,1206,155,0,8
1636444,16,19,1997,10,"female",186,33,24,1926,488,1895,223,31,265
1636507,23,9,1990,7,"female",190,0,0,0,0,0,0,0,0
1636509,28,1,1985,2,"male",569,9,6,3,3,3,3,0,0
1636518,23,11,1990,10,"male",1695,14,12,10,0,6,0,4,0
1636548,26,22,1987,1,"male",578,148,109,12,9,0,6,12,3
1636555,23,15,1990,3,"female",925,19,13,0,1,0,0,0,1
1636558,20,11,1993,4,"male",299,744,525,36,11,28,10,8,1
1636561,21,19,1992,6,"male",76,138,127,303,263,0,181,303,82
1636562,73,6,1940,9,"female",1145,42,25,27,4,0,0,27,4
1636598,22,7,1991,12,"male",630,193,109,1,0,1,0,0,0
1636627,23,11,1990,1,"female",353,1,1,0,0,0,0,0,0
1636637,22,25,1991,5,"male",1086,292,194,0,1,0,1,0,0
1636638,23,6,1990,2,"female",569,386,262,4,0,2,0,2,0
1636674,21,14,1992,4,"female",21,39,32,22,31,22,26,0,5
1636676,20,8,1993,8,"male",682,252,86,0,0,0,0,0,0
1636692,15,26,1998,3,"female",368,423,298,12,3,12,2,0,1
1636709,51,20,1962,6,"male",1101,221,155,3,1,0,0,3,1
1636713,14,22,1999,10,"female",191,1012,142,10,33,8,23,2,10
1636714,40,1,1973,3,"female",556,78,17,171,162,171,117,0,45
1636718,55,21,1958,12,"female",1696,296,147,287,177,250,147,37,30
1636720,23,2,1990,3,"male",221,26,21,116,3,116,3,0,0
1636723,15,15,1998,7,"female",103,240,204,115,99,103,75,12,24
1636757,23,16,1990,3,"male",67,0,0,0,0,0,0,0,0
1636770,14,19,1999,10,"female",249,502,309,678,482,582,247,96,235
1636773,22,30,1991,11,"male",380,45,18,17,0,17,0,0,0
1636847,21,2,1992,9,"female",368,63,48,41,24,40,3,1,21
1636859,17,30,1996,10,"female",33,52,18,39,28,31,14,8,14
1636865,54,16,1959,4,"female",236,35,11,216,131,216,85,0,46
1636882,62,30,1951,12,"female",392,115,72,2,7,0,1,2,6
1636898,23,5,1990,2,"male",630,280,219,151,222,146,149,5,73
1636899,53,15,1960,8,"male",510,4,2,29,5,0,0,29,5
1636937,43,16,1970,8,"female",804,314,99,1121,847,1121,746,0,101
1636940,21,27,1992,7,"male",401,488,245,0,0,0,0,0,0
1636942,108,1,1905,1,"male",145,28,22,11,9,0,4,11,5
1636956,24,14,1989,1,"male",631,167,55,8,20,8,17,0,3
1636974,45,27,1968,2,"male",643,35,21,25,9,25,4,0,5
1636977,16,2,1997,7,"male",29,34,29,1,1,1,1,0,0
1636987,35,24,1978,11,"female",1144,107,46,121,325,121,169,0,156
1637015,68,27,1945,12,"female",980,52,25,103,43,92,23,11,20
1637030,53,28,1960,5,"female",817,106,29,37,28,20,11,17,17
1637039,18,20,1995,8,"male",307,63,43,5,0,5,0,0,0
1637091,27,24,1986,4,"female",276,288,86,331,222,331,121,0,101
1637092,21,1,1992,4,"male",66,174,157,5,7,5,7,0,0
1637136,19,28,1994,9,"female",502,1375,837,651,404,44,175,607,229
1637139,56,10,1957,7,"female",1600,37,15,508,177,375,116,133,61
1637140,24,24,1989,7,"male",1151,725,535,3,64,3,55,0,9
1637190,18,11,1995,12,"female",207,223,37,8,274,8,216,0,58
1637198,14,9,1999,10,"female",97,12,10,0,0,0,0,0,0
1637207,30,16,1983,1,"male",560,20,2,5,0,5,0,0,0
1637209,35,13,1978,12,"male",73,9,8,0,0,0,0,0,0
1637251,28,8,1985,8,"male",151,171,81,102,220,102,156,0,64
1637264,31,25,1982,9,"female",468,164,95,1091,1260,1089,975,2,285
1637298,52,9,1961,1,"female",1649,109,51,19,12,19,9,0,3
1637311,18,13,1995,2,"female",365,76,66,323,316,171,98,152,218
1637313,52,8,1961,3,"male",251,60,36,1,0,0,0,1,0
1637322,76,27,1937,2,"male",1522,107,57,1,0,1,0,0,0
1637354,24,8,1989,3,"male",266,4,3,0,0,0,0,0,0
1637403,62,17,1951,9,"female",1404,94,44,52,13,16,9,36,4
1637426,28,24,1985,11,"male",378,63,53,6,9,0,0,6,9
1637440,22,13,1991,7,"female",126,0,0,0,0,0,0,0,0
1637442,15,6,1998,10,"male",293,53,34,0,0,0,0,0,0
1637444,104,1,1909,11,"male",754,146,89,216,72,0,12,216,60
1637445,20,8,1993,7,"male",44,14,13,3,9,0,1,3,8
1637448,24,8,1989,7,"female",341,169,51,9,138,6,110,3,28
1637452,52,28,1961,2,"male",1935,41,10,7,29,6,24,1,5
1637463,59,28,1954,6,"female",304,31,18,101,15,101,13,0,2
1637489,18,5,1995,10,"female",89,136,100,150,37,150,25,0,12
1637534,24,29,1989,7,"male",371,25,8,0,0,0,0,0,0
1637558,28,15,1985,4,"male",958,1168,935,441,414,434,341,7,73
1637565,25,4,1988,4,"female",166,174,23,566,709,566,547,0,162
1637571,30,18,1983,4,"female",222,30,19,28,112,2,16,26,96
1637577,30,4,1983,8,"male",322,2,1,0,0,0,0,0,0
1637581,26,1,1987,1,"male",827,156,93,0,0,0,0,0,0
1637664,48,8,1965,7,"male",146,82,73,438,38,438,34,0,4
1637674,76,23,1937,11,"female",160,160,110,15,12,5,0,10,12
1637699,33,11,1980,8,"male",533,95,79,0,883,0,858,0,25
1637704,18,1,1995,1,"male",841,1134,712,19,157,13,83,6,74
1637705,34,16,1979,1,"male",387,228,171,193,281,193,241,0,40
1637716,58,4,1955,4,"male",62,56,55,0,29,0,21,0,8
1637722,16,8,1997,2,"male",478,320,163,274,218,253,129,21,89
1637727,83,1,1930,3,"female",1781,2226,170,29,8,29,7,0,1
1637741,18,1,1995,2,"male",251,118,108,1,1,1,1,0,0
1637753,108,27,1905,10,"female",289,208,67,2,5,2,3,0,2
1637760,48,8,1965,12,"female",717,219,108,411,672,407,465,4,207
1637762,25,1,1988,1,"male",324,1,1,0,0,0,0,0,0
1637763,15,26,1998,10,"male",418,572,368,70,184,21,92,49,92
1637790,29,8,1984,12,"male",291,49,27,8,15,7,9,1,6
1637797,60,20,1953,8,"male",1746,65,3,1,3,1,2,0,1
1637821,26,16,1987,3,"male",309,78,45,0,1,0,1,0,0
1637826,19,5,1994,10,"male",856,2225,1622,8256,16150,4097,11523,4159,4627
1637894,16,22,1997,3,"female",309,396,268,314,337,204,241,110,96
1637901,21,8,1992,10,"male",312,110,64,0,4,0,2,0,2
1637947,36,28,1977,10,"male",22,13,11,4,2,4,0,0,2
1637992,20,24,1993,4,"male",145,136,115,1,0,1,0,0,0
1638003,42,8,1971,6,"male",635,87,72,0,1,0,1,0,0
1638056,30,1,1983,1,"female",292,112,64,1,1,0,1,1,0
1638061,41,18,1972,1,"female",308,0,0,0,0,0,0,0,0
1638073,23,1,1990,1,"male",114,0,0,0,0,0,0,0,0
1638083,24,11,1989,5,"female",410,121,75,0,0,0,0,0,0
1638091,53,23,1960,7,"male",937,94,64,67,151,67,132,0,19
1638114,22,8,1991,3,"female",230,279,228,299,420,270,318,29,102
1638221,31,1,1982,1,"male",135,41,25,12,13,7,3,5,10
1638235,68,9,1945,3,"female",1381,147,75,3,115,0,68,3,47
1638255,100,31,1913,12,"female",1670,1044,258,14,13,3,5,11,8
1638260,54,5,1959,2,"male",328,10,9,0,0,0,0,0,0
1638296,108,29,1905,4,"female",1384,177,96,298,176,202,133,96,43
1638299,15,13,1998,10,"male",719,61,35,0,0,0,0,0,0
1638302,17,11,1996,5,"male",29,125,124,0,0,0,0,0,0
1638327,26,6,1987,1,"female",303,197,151,472,332,255,209,217,123
1638340,40,23,1973,6,"female",29,0,0,3,0,3,0,0,0
1638366,59,28,1954,10,"male",741,40,21,10,9,3,4,7,5
1638371,21,10,1992,12,"female",422,121,94,33,161,33,100,0,61
1638376,59,24,1954,7,"male",115,2051,0,0,43,0,20,0,23
1638377,25,13,1988,2,"male",190,12,10,5,0,5,0,0,0
1638405,38,1,1975,10,"male",253,9,7,9,0,2,0,7,0
1638432,44,21,1969,9,"female",321,29,18,1290,64,1290,40,0,24
1638433,51,19,1962,5,"male",1309,61,32,1,7,1,1,0,6
1638448,27,12,1986,2,"male",631,25,2,1,0,1,0,0,0
1638466,23,12,1990,6,"male",266,75,28,54,33,43,12,11,21
1638521,40,6,1973,12,"female",491,497,238,1054,527,1048,388,6,139
1638562,21,17,1992,11,"female",243,64,34,0,0,0,0,0,0
1638566,103,2,1910,7,"male",1488,1908,600,5,9,0,6,5,3
1638583,20,4,1993,11,"male",510,187,136,1,0,1,0,0,0
1638584,31,1,1982,6,"male",245,39,32,0,0,0,0,0,0
1638614,17,1,1996,9,"female",530,200,144,2,14,2,6,0,8
1638625,15,27,1998,7,"female",545,108,37,9,20,2,9,7,11
1638638,68,1,1945,1,"female",375,205,186,16,42,16,33,0,9
1638639,18,19,1995,11,"male",248,60,48,1,1,1,1,0,0
1638671,76,15,1937,12,"female",695,82,70,50,28,50,21,0,7
1638678,17,6,1996,5,"female",331,356,203,96,294,96,71,0,223
1638698,17,28,1996,12,"male",339,255,135,4,25,0,12,4,13
1638722,48,5,1965,12,"female",394,89,48,2,7,1,7,1,0
1638747,23,23,1990,6,"male",306,738,585,475,770,80,252,395,518
1638793,14,21,1999,1,"female",345,855,299,3,18,0,10,3,8
1638810,108,1,1905,1,"female",1645,32,19,0,0,0,0,0,0
1638829,24,16,1989,8,"male",1405,97,26,0,0,0,0,0,0
1638861,13,14,2000,7,"male",0,0,0,4,1,4,1,0,0
1638905,18,2,1995,1,"male",61,61,42,27,11,0,6,27,5
1638912,14,21,1999,10,"male",341,21,15,0,0,0,0,0,0
1638916,24,18,1989,8,"male",527,216,137,108,75,108,65,0,10
1638924,19,10,1994,3,"female",174,1,1,0,0,0,0,0,0
1638939,15,27,1998,3,"male",493,583,452,7,20,2,13,5,7
1638940,27,11,1986,11,"male",445,136,114,0,1,0,1,0,0
1638963,59,27,1954,8,"female",871,107,40,18,130,0,28,18,102
1638969,59,24,1954,5,"female",975,215,164,107,134,105,77,2,57
1638977,15,1,1998,8,"female",401,43,38,1,0,1,0,0,0
1638995,31,15,1982,4,"male",606,74,25,0,0,0,0,0,0
1639000,23,24,1990,5,"male",282,176,43,4,32,4,8,0,24
1639009,35,17,1978,4,"male",423,97,55,2,2,2,2,0,0
1639040,50,16,1963,5,"female",711,43,34,96,14,40,1,56,13
1639075,15,30,1998,1,"female",220,174,73,272,58,271,44,1,14
1639087,24,10,1989,7,"male",1249,273,224,7,2,4,1,3,1
1639092,19,27,1994,2,"female",387,30,10,18,5,12,3,6,2
1639096,64,26,1949,12,"male",1692,9,5,0,2,0,2,0,0
1639110,49,6,1964,11,"male",719,94,72,0,4,0,4,0,0
1639115,24,2,1989,6,"male",449,239,88,95,46,66,16,29,30
1639116,16,7,1997,9,"female",95,856,612,12848,9615,11921,7798,927,1817
1639161,49,14,1964,4,"female",84,34,27,66,64,33,51,33,13
1639165,56,4,1957,8,"male",533,13,8,0,1,0,1,0,0
1639178,59,1,1954,1,"female",137,7,4,138,38,0,1,138,37
1639187,26,19,1987,8,"male",612,254,148,1,1,1,1,0,0
1639197,104,10,1909,3,"female",1115,568,177,681,458,664,320,17,138
1639213,21,25,1992,4,"male",5,1,1,0,0,0,0,0,0
1639230,31,25,1982,9,"male",162,19,11,18,0,18,0,0,0
1639231,25,9,1988,1,"male",752,70,53,11,8,0,2,11,6
1639233,55,8,1958,3,"male",646,64,45,21,2,0,2,21,0
1639248,19,16,1994,6,"female",1394,804,172,528,348,391,195,137,153
1639253,15,29,1998,6,"male",203,104,91,32,1,32,1,0,0
1639292,18,1,1995,2,"female",836,375,93,27,161,22,123,5,38
1639314,20,1,1993,5,"female",344,1,1,0,0,0,0,0,0
1639326,16,9,1997,9,"male",614,50,30,3,3,0,1,3,2
1639333,63,2,1950,11,"male",795,62,58,58,7,58,6,0,1
1639340,49,8,1964,3,"male",289,1,1,0,0,0,0,0,0
1639342,19,14,1994,8,"female",95,336,262,458,1638,162,994,296,644
1639346,38,3,1975,5,"male",217,22,16,0,0,0,0,0,0
1639367,29,14,1984,7,"male",11,0,0,0,0,0,0,0,0
1639376,21,23,1992,5,"female",138,29,4,9,16,9,9,0,7
1639389,18,6,1995,5,"male",166,231,92,14,1,14,1,0,0
1639400,24,12,1989,1,"female",383,183,61,46,161,46,103,0,58
1639413,30,24,1983,6,"female",692,57,30,32,4,32,4,0,0
1639444,26,14,1987,11,"female",341,47,42,105,11,93,9,12,2
1639475,18,13,1995,3,"male",440,565,459,49,12,41,4,8,8
1639511,35,26,1978,4,"male",1339,113,47,0,12,0,8,0,4
1639565,14,18,1999,5,"male",139,410,392,24,10,18,5,6,5
1639574,108,22,1905,5,"female",973,18,16,19,3,0,3,19,0
1639585,18,28,1995,8,"male",245,121,89,10,3,10,1,0,2
1639599,52,1,1961,12,"male",2,5,5,0,0,0,0,0,0
1639602,24,16,1989,7,"male",593,352,180,0,15,0,14,0,1
1639615,57,31,1956,8,"female",432,85,53,8,1,4,1,4,0
1639625,60,28,1953,10,"male",614,22,12,1,0,1,0,0,0
1639632,24,10,1989,6,"male",531,378,352,2,1,2,1,0,0
1639654,75,15,1938,7,"male",1405,36,15,0,0,0,0,0,0
1639735,17,9,1996,8,"female",265,315,196,426,164,426,92,0,72
1639739,13,13,2000,6,"female",134,137,71,593,38,576,28,17,10
1639745,103,13,1910,1,"male",726,259,223,16,2,3,0,13,2
1639749,37,2,1976,7,"female",48,12,5,3,60,3,56,0,4
1639788,53,1,1960,11,"female",980,25,16,12,1,2,0,10,1
1639797,20,4,1993,5,"male",267,114,85,0,2,0,2,0,0
1639811,19,11,1994,3,"male",171,107,88,47,3,0,0,47,3
1639821,37,28,1976,12,"male",230,2,2,0,2,0,0,0,2
1639860,24,16,1989,7,"male",58,0,0,0,0,0,0,0,0
1639870,18,7,1995,7,"male",653,1218,649,1257,1436,1031,836,226,600
1639871,94,1,1919,1,"male",543,53,21,27,32,20,19,7,13
1639887,16,24,1997,4,"female",480,316,129,475,700,460,509,15,191
1639898,24,16,1989,9,"male",332,154,128,4,13,4,12,0,1
1639918,59,11,1954,11,"female",2259,44,18,28,31,2,16,26,15
1639924,23,3,1990,12,"male",221,22,21,0,1,0,0,0,1
1639954,48,26,1965,8,"female",809,81,68,27,22,27,19,0,3
1639955,25,2,1988,6,"male",511,78,45,0,0,0,0,0,0
1639969,33,9,1980,8,"male",199,56,56,0,1,0,1,0,0
1639983,68,26,1945,3,"male",327,21,14,2,0,1,0,1,0
1639994,20,20,1993,4,"female",80,70,27,19,20,19,20,0,0
1640028,17,17,1996,2,"female",262,80,54,0,6,0,0,0,6
1640057,35,24,1978,7,"male",1029,156,56,0,6,0,1,0,5
1640069,56,13,1957,4,"female",250,40,17,5,20,0,5,5,15
1640076,24,7,1989,12,"male",382,67,62,32,0,32,0,0,0
1640092,14,25,1999,4,"male",173,597,387,8200,1386,8140,862,60,524
1640095,25,8,1988,9,"male",1058,17,10,0,1,0,1,0,0
1640128,23,2,1990,7,"male",445,163,148,23,66,23,55,0,11
1640144,16,14,1997,9,"female",39,207,82,153,91,118,18,35,73
1640148,30,23,1983,5,"male",1326,73,35,7,0,7,0,0,0
1640153,38,4,1975,12,"male",612,20,14,0,6,0,4,0,2
1640168,17,5,1996,1,"male",423,300,219,10,2,10,1,0,1
1640169,21,26,1992,1,"male",53,66,38,222,97,222,74,0,23
1640178,23,1,1990,4,"female",341,54,32,0,0,0,0,0,0
1640206,25,3,1988,4,"female",406,26,10,1,0,0,0,1,0
1640244,22,5,1991,1,"male",43,13,13,7,2,7,2,0,0
1640245,62,30,1951,8,"female",490,49,35,375,22,0,5,375,17
1640261,19,26,1994,10,"female",86,1,0,0,0,0,0,0,0
1640309,83,15,1930,4,"male",1438,471,96,31,16,31,16,0,0
1640323,101,10,1912,4,"male",1204,478,323,20,62,20,35,0,27
1640337,103,5,1910,7,"male",677,395,316,94,10,94,6,0,4
1640345,15,2,1998,2,"female",127,147,123,45,18,45,13,0,5
1640356,34,28,1979,7,"male",97,31,29,34,0,34,0,0,0
1640363,31,12,1982,7,"female",487,118,22,2,0,2,0,0,0
1640383,18,6,1995,6,"male",424,436,138,271,22,271,21,0,1
1640435,24,2,1989,1,"male",227,0,0,0,0,0,0,0,0
1640443,31,16,1982,6,"male",255,112,100,0,0,0,0,0,0
1640447,26,14,1987,10,"female",191,2,1,0,0,0,0,0,0
1640461,19,2,1994,2,"male",476,852,794,81,5,81,4,0,1
1640471,65,4,1948,12,"male",523,5,3,0,0,0,0,0,0
1640493,23,20,1990,7,"male",166,17,14,1,1,0,0,1,1
1640512,97,29,1916,2,"male",1809,75,41,131,123,83,57,48,66
1640523,31,16,1982,2,"female",247,18,11,46,2,40,1,6,1
1640529,28,12,1985,8,"female",335,183,69,522,406,500,307,22,99
1640530,24,16,1989,3,"male",439,223,121,0,95,0,76,0,19
1640531,23,8,1990,10,"male",923,501,330,1,343,1,124,0,219
1640540,55,25,1958,12,"female",1223,35,11,0,3,0,2,0,1
1640567,16,5,1997,3,"male",34,60,31,0,5,0,0,0,5
1640575,21,20,1992,7,"female",195,28,15,0,0,0,0,0,0
1640579,23,4,1990,11,"male",563,1,1,3,0,0,0,3,0
1640588,67,31,1946,7,"male",142,64,47,184,3,184,0,0,3
1640594,26,28,1987,10,"male",523,255,88,12,3,12,3,0,0
1640623,113,19,1900,2,"female",1195,150,82,101,21,0,20,101,1
1640651,29,14,1984,2,"female",113,579,97,292,57,292,52,0,5
1640674,19,12,1994,3,"female",1769,396,272,698,333,195,227,503,106
1640703,31,16,1982,9,"male",275,75,63,114,255,112,233,2,22
1640734,21,4,1992,12,"male",847,513,151,344,61,344,39,0,22
1640746,25,1,1988,1,"female",144,42,38,10,1,10,0,0,1
1640753,22,20,1991,10,"male",84,37,31,297,198,297,121,0,77
1640772,15,25,1998,8,"female",130,240,54,55,7,55,7,0,0
1640797,26,26,1987,12,"male",178,91,68,1,1,1,1,0,0
1640804,21,3,1992,4,"female",442,108,52,83,160,63,82,20,78
1640826,26,14,1987,6,"male",43,44,42,0,0,0,0,0,0
1640841,36,7,1977,7,"male",651,283,279,0,2,0,0,0,2
1640865,61,8,1952,8,"female",1843,614,275,251,243,93,124,158,119
1640873,40,15,1973,11,"female",339,50,41,7,2,7,2,0,0
1640927,23,1,1990,1,"male",153,39,20,0,5,0,4,0,1
1640933,17,14,1996,6,"female",509,133,78,21,2,21,2,0,0
1640941,40,8,1973,5,"male",514,42,32,1,0,0,0,1,0
1640959,43,9,1970,9,"male",1196,11,1,4,0,4,0,0,0
1640977,24,9,1989,7,"male",278,180,168,0,3,0,2,0,1
1640982,28,16,1985,8,"male",119,90,86,53,17,53,16,0,1
1640991,15,26,1998,4,"male",287,59,27,0,0,0,0,0,0
1641004,21,6,1992,3,"male",420,169,125,464,50,446,16,18,34
1641008,27,16,1986,4,"male",492,452,330,171,149,0,129,171,20
1641018,23,1,1990,1,"male",32,15,14,0,0,0,0,0,0
1641026,19,11,1994,10,"male",151,165,74,6,52,6,43,0,9
1641028,33,23,1980,7,"male",324,140,123,0,0,0,0,0,0
1641059,25,14,1988,1,"female",623,265,202,523,677,521,642,2,35
1641062,20,22,1993,10,"male",521,98,73,432,55,424,39,8,16
1641070,16,1,1997,4,"female",227,1090,887,2285,1007,2202,915,83,92
1641094,17,2,1996,3,"female",1024,155,62,180,43,180,29,0,14
1641099,17,30,1996,6,"male",249,104,82,21,1,0,0,21,1
1641123,39,1,1974,1,"male",108,28,12,29,23,29,19,0,4
1641230,22,20,1991,1,"female",233,146,77,304,300,299,282,5,18
1641280,37,12,1976,4,"female",307,29,11,46,23,46,17,0,6
1641283,21,6,1992,8,"female",137,139,121,145,285,13,240,132,45
1641295,62,1,1951,10,"female",391,33,22,2,3,2,2,0,1
1641303,61,11,1952,11,"male",329,60,42,76,47,0,33,76,14
1641326,52,27,1961,10,"male",1151,98,52,380,58,39,22,341,36
1641341,50,22,1963,8,"female",1480,160,58,336,214,336,158,0,56
1641343,25,1,1988,1,"male",8,10,7,1,0,1,0,0,0
1641347,23,16,1990,6,"male",61,11,9,1,1,1,1,0,0
1641349,17,14,1996,6,"male",602,50,28,0,0,0,0,0,0
1641353,27,5,1986,2,"female",225,59,10,17,0,17,0,0,0
1641363,26,24,1987,9,"female",862,68,30,0,0,0,0,0,0
1641386,14,25,1999,6,"female",31,387,318,3924,1145,1160,504,2764,641
1641404,17,19,1996,2,"female",183,225,149,5,3,3,0,2,3
1641409,23,14,1990,2,"male",128,36,24,47,39,37,37,10,2
1641437,68,18,1945,7,"male",983,477,413,3,0,3,0,0,0
1641450,31,21,1982,9,"female",230,107,77,213,102,213,98,0,4
1641454,27,29,1986,11,"male",652,637,480,4,11,4,7,0,4
1641456,18,13,1995,11,"female",696,971,418,508,495,368,271,140,224
1641516,62,3,1951,3,"female",1723,197,21,29,39,29,22,0,17
1641536,22,10,1991,1,"male",281,1069,997,217,46,217,38,0,8
1641551,54,15,1959,7,"female",160,67,58,16,12,16,5,0,7
1641570,26,15,1987,2,"male",1269,318,223,0,0,0,0,0,0
1641583,49,2,1964,12,"female",1827,2360,950,1426,3433,94,1283,1332,2150
1641605,108,25,1905,6,"female",559,251,117,1,1,1,0,0,1
1641612,25,22,1988,3,"male",722,0,0,0,0,0,0,0,0
1641633,55,7,1958,2,"female",849,188,78,153,202,56,46,97,156
1641657,18,12,1995,12,"female",728,750,404,303,267,303,236,0,31
1641661,92,1,1921,1,"male",323,0,0,0,0,0,0,0,0
1641713,16,10,1997,11,"female",27,60,52,1407,1887,505,787,902,1100
1641767,36,19,1977,10,"male",150,8,8,58,0,58,0,0,0
1641779,18,29,1995,6,"female",76,73,70,601,178,431,75,170,103
1641793,36,28,1977,4,"female",437,19,15,0,0,0,0,0,0
1641826,32,20,1981,4,"male",2207,162,156,241,155,230,113,11,42
1641833,22,30,1991,6,"male",180,60,46,0,0,0,0,0,0
1641837,44,31,1969,10,"female",349,0,0,7,0,7,0,0,0
1641844,17,15,1996,1,"male",308,8,4,0,0,0,0,0,0
1641850,29,1,1984,2,"female",360,325,246,0,0,0,0,0,0
1641870,19,13,1994,9,"male",132,49,27,14,19,14,16,0,3
1641874,58,27,1955,9,"male",1250,48,35,10,18,0,2,10,16
1641876,21,11,1992,3,"male",572,121,105,1,0,1,0,0,0
1641929,48,26,1965,11,"female",203,88,17,17,52,17,25,0,27
1641931,22,6,1991,7,"male",592,37,3,0,2,0,1,0,1
1641938,23,26,1990,1,"male",97,39,29,17,43,17,34,0,9
1641940,58,29,1955,3,"male",1159,73,56,23,7,23,6,0,1
1641947,25,20,1988,3,"female",20,10,10,0,7,0,7,0,0
1641948,47,29,1966,12,"male",610,155,69,18,48,18,42,0,6
1641967,22,18,1991,2,"male",493,521,448,1,0,1,0,0,0
1641979,34,22,1979,7,"female",308,161,103,199,152,174,78,25,74
1641981,25,19,1988,6,"female",570,268,215,251,302,19,216,232,86
1641983,97,30,1916,4,"male",755,189,123,3,2,3,1,0,1
1641987,23,18,1990,4,"male",641,718,448,360,155,360,139,0,16
1642014,35,11,1978,12,"male",657,219,69,40,32,40,23,0,9
1642023,19,26,1994,2,"male",257,84,66,4,14,2,7,2,7
1642025,20,11,1993,5,"male",106,0,0,0,0,0,0,0,0
1642058,54,27,1959,8,"male",655,14,6,85,175,0,75,85,100
1642127,16,14,1997,3,"male",121,37,28,1,0,1,0,0,0
1642133,18,16,1995,12,"male",307,346,320,8,1,0,0,8,1
1642150,25,24,1988,11,"male",184,37,32,19,22,19,19,0,3
1642162,29,8,1984,3,"male",370,343,255,12,49,12,34,0,15
1642164,37,3,1976,3,"female",371,170,151,132,261,119,237,13,24
1642168,20,9,1993,4,"male",487,437,211,114,318,26,128,88,190
1642170,16,15,1997,7,"male",448,203,170,0,1,0,1,0,0
1642200,32,28,1981,5,"male",1488,10,6,7,4,7,4,0,0
1642212,75,4,1938,10,"female",1555,91,29,103,16,0,10,103,6
1642253,46,27,1967,4,"female",598,53,22,0,4,0,3,0,1
1642258,25,6,1988,6,"male",237,57,46,46,4,46,4,0,0
1642262,18,9,1995,10,"male",170,34,29,60,13,60,13,0,0
1642273,80,29,1933,7,"male",157,308,251,52,71,40,12,12,59
1642274,21,6,1992,11,"male",705,1659,1360,147,519,67,300,80,219
1642281,28,17,1985,8,"male",284,121,76,2846,550,2846,123,0,427
1642309,49,3,1964,1,"male",812,566,370,12,41,12,29,0,12
1642313,35,3,1978,5,"male",224,157,122,296,146,296,140,0,6
1642323,17,7,1996,10,"female",609,1208,466,162,347,69,200,93,147
1642357,19,19,1994,8,"female",418,604,416,610,102,561,74,49,28
1642379,61,3,1952,8,"male",80,119,116,4,4,0,4,4,0
1642404,39,30,1974,9,"female",254,81,68,29,48,0,10,29,38
1642410,21,26,1992,6,"male",212,21,11,0,3,0,1,0,2
1642415,50,20,1963,3,"male",63,33,25,46,9,46,8,0,1
1642420,31,17,1982,7,"male",311,11,7,0,0,0,0,0,0
1642482,60,11,1953,2,"male",1442,309,141,343,203,290,82,53,121
1642536,19,9,1994,5,"female",300,262,236,2085,618,1890,366,195,252
1642549,48,21,1965,8,"female",311,35,30,0,0,0,0,0,0
1642550,20,9,1993,4,"female",570,783,337,392,597,264,308,128,289
1642553,19,21,1994,7,"male",990,197,82,8,55,8,41,0,14
1642593,51,10,1962,5,"female",472,83,37,105,15,105,12,0,3
1642606,20,1,1993,6,"female",203,270,61,416,619,416,572,0,47
1642631,49,17,1964,7,"male",317,43,40,0,4,0,3,0,1
1642642,58,12,1955,4,"male",740,156,86,675,187,351,40,324,147
1642646,23,20,1990,9,"female",259,14,11,0,0,0,0,0,0
1642692,67,12,1946,7,"male",1673,321,95,664,1211,664,282,0,929
1642702,39,29,1974,8,"female",393,251,172,114,50,106,37,8,13
1642732,55,5,1958,12,"male",1350,127,53,73,71,25,60,48,11
1642758,53,25,1960,4,"male",289,123,107,1,0,0,0,1,0
1642762,19,15,1994,2,"male",578,1159,630,600,667,133,210,467,457
1642782,50,28,1963,6,"male",833,183,116,310,752,23,454,287,298
1642790,26,27,1987,4,"male",1085,41,31,2,0,2,0,0,0
1642794,48,30,1965,11,"female",975,66,14,409,159,230,85,179,74
1642800,63,14,1950,5,"female",987,56,38,119,37,119,15,0,22
1642805,36,21,1977,7,"male",351,290,237,1,8,1,0,0,8
1642815,83,12,1930,7,"female",30,103,91,24,28,24,9,0,19
1642876,13,2,2000,1,"male",272,85,39,31,168,0,102,31,66
1642889,62,12,1951,9,"male",512,35,26,0,1,0,0,0,1
1642913,52,15,1961,2,"male",159,108,87,43,125,41,88,2,37
1642922,43,1,1970,1,"male",235,41,16,2199,149,3,51,2196,98
1642926,19,22,1994,7,"female",202,119,66,427,549,71,285,356,264
1642988,15,1,1998,1,"male",568,75,35,3,74,3,57,0,17
1643022,15,6,1998,12,"female",451,224,151,0,0,0,0,0,0
1643058,66,13,1947,4,"male",583,91,68,0,0,0,0,0,0
1643069,23,5,1990,5,"male",99,42,32,2,0,2,0,0,0
1643082,15,26,1998,6,"male",444,116,67,5,10,5,8,0,2
1643114,18,18,1995,11,"male",575,22,17,0,1,0,1,0,0
1643182,23,7,1990,1,"female",604,154,120,7,6,7,3,0,3
1643195,34,15,1979,8,"male",361,6,3,0,0,0,0,0,0
1643197,22,26,1991,8,"male",340,0,0,0,0,0,0,0,0
1643217,67,28,1946,9,"female",174,47,36,133,96,0,32,133,64
1643243,49,20,1964,9,"male",790,131,98,407,64,334,42,73,22
1643326,14,30,1999,7,"male",247,248,204,4,0,0,0,4,0
1643348,103,11,1910,1,"female",1027,1532,218,240,10658,240,9142,0,1516
1643372,43,10,1970,9,"female",63,2,2,1,0,1,0,0,0
1643377,55,2,1958,1,NA,1977,104,71,113,103,113,74,0,29
1643400,23,1,1990,4,"male",195,219,133,5,5,5,5,0,0
1643401,24,26,1989,4,"male",757,1915,331,0,153,0,118,0,35
1643427,16,1,1997,1,"male",471,25,9,0,0,0,0,0,0
1643432,25,1,1988,1,"male",184,151,66,106,49,95,35,11,14
1643473,41,20,1972,4,"male",534,18,4,4,2,4,2,0,0
1643511,15,8,1998,4,"male",217,293,153,236,78,28,32,208,46
1643532,27,18,1986,3,"male",793,169,95,4,2,4,2,0,0
1643535,23,9,1990,2,"male",200,0,0,5,0,5,0,0,0
1643615,21,1,1992,1,"male",179,0,0,0,0,0,0,0,0
1643616,17,14,1996,10,"female",294,148,60,226,170,221,164,5,6
1643639,14,7,1999,8,"female",309,3303,1284,1819,2384,1781,725,38,1659
1643645,23,10,1990,1,"male",576,225,216,0,0,0,0,0,0
1643652,21,4,1992,1,"female",519,117,56,243,11,243,7,0,4
1643666,56,18,1957,5,"female",175,74,56,5,21,5,15,0,6
1643675,64,16,1949,11,"male",1424,6,3,6,3,4,2,2,1
1643679,39,14,1974,10,"male",377,27,13,51,0,26,0,25,0
1643712,46,14,1967,11,"female",276,45,42,15,2,15,2,0,0
1643730,23,20,1990,3,"female",601,65,23,0,0,0,0,0,0
1643800,32,28,1981,12,"male",474,49,14,7,0,7,0,0,0
1643819,25,26,1988,4,"male",838,44,43,0,2,0,1,0,1
1643823,33,17,1980,11,"female",468,215,179,46,33,46,23,0,10
1643832,29,14,1984,5,"male",8,37,23,13,21,13,5,0,16
1643922,71,5,1942,7,"female",1378,254,151,1452,38,0,16,1452,22
1643925,33,10,1980,7,"male",326,31,23,1,0,1,0,0,0
1643951,26,1,1987,1,"male",208,244,156,17,50,17,13,0,37
1643968,57,21,1956,1,"female",1715,347,216,63,355,58,200,5,155
1643974,17,11,1996,9,"male",331,118,74,254,13,226,13,28,0
1643984,53,14,1960,7,"female",78,36,23,7,3,7,2,0,1
1643993,18,11,1995,12,"male",252,16,12,23,1,0,0,23,1
1643994,32,3,1981,6,"female",96,41,37,2,5,2,5,0,0
1643998,24,14,1989,2,"male",233,10,7,0,0,0,0,0,0
1644003,54,10,1959,2,"male",289,15,8,6,6,6,6,0,0
1644004,25,6,1988,3,"female",117,207,165,133,83,65,56,68,27
1644005,32,15,1981,5,"female",493,47,20,37,7,37,6,0,1
1644026,43,16,1970,10,"male",155,150,43,36,33,27,15,9,18
1644045,22,12,1991,6,"female",370,1,1,1,0,0,0,1,0
1644058,21,20,1992,8,"male",193,86,82,0,0,0,0,0,0
1644069,21,31,1992,7,"female",270,1186,176,15,81,4,58,11,23
1644095,28,31,1985,12,"male",464,146,99,0,2,0,0,0,2
1644109,48,30,1965,10,"male",25,0,0,0,0,0,0,0,0
1644120,27,13,1986,8,"female",626,326,152,0,0,0,0,0,0
1644145,16,12,1997,2,"male",431,542,326,69,185,49,126,20,59
1644202,49,11,1964,5,"male",68,273,153,40,31,40,19,0,12
1644203,46,19,1967,7,"male",590,39,21,0,0,0,0,0,0
1644206,76,22,1937,3,"male",1283,39,12,52,5,0,5,52,0
1644220,22,18,1991,6,"female",244,121,55,5,39,5,22,0,17
1644247,28,15,1985,8,"female",5,0,0,0,0,0,0,0,0
1644313,14,16,1999,3,"male",271,0,0,0,0,0,0,0,0
1644318,43,26,1970,5,"female",220,96,71,99,112,95,69,4,43
1644319,16,29,1997,3,"male",74,46,40,0,0,0,0,0,0
1644331,59,16,1954,8,"male",1891,21,8,0,16,0,15,0,1
1644368,14,9,1999,8,"female",226,258,197,84,11,84,6,0,5
1644369,22,13,1991,4,"male",351,586,504,0,2,0,1,0,1
1644396,63,26,1950,9,"female",448,5,3,0,0,0,0,0,0
1644446,28,16,1985,6,"male",169,82,61,0,0,0,0,0,0
1644482,33,31,1980,10,"female",129,12,10,0,0,0,0,0,0
1644512,55,30,1958,5,"male",473,12,5,12,16,12,0,0,16
1644523,33,7,1980,7,"male",122,31,21,21,0,21,0,0,0
1644528,24,1,1989,4,"male",233,151,104,0,0,0,0,0,0
1644582,29,22,1984,6,"male",604,90,66,38,1,33,1,5,0
1644584,24,11,1989,9,"female",489,11,9,7,0,0,0,7,0
1644591,78,25,1935,3,"male",2330,73,24,12,20,0,6,12,14
1644597,58,1,1955,12,"male",105,32,23,0,1,0,1,0,0
1644635,40,13,1973,4,"male",223,15,3,6,4,6,4,0,0
1644693,58,9,1955,3,"female",557,143,90,1207,415,0,187,1207,228
1644711,23,16,1990,6,"male",496,32,21,3,10,3,8,0,2
1644726,52,10,1961,3,NA,2062,77,65,124,68,124,28,0,40
1644729,53,3,1960,9,"male",335,47,35,1,0,1,0,0,0
1644743,14,31,1999,12,"female",264,189,122,7,14,7,12,0,2
1644745,108,31,1905,12,"male",1079,325,219,39,107,39,102,0,5
1644756,88,18,1925,7,"female",1561,29,20,186,0,184,0,2,0
1644793,27,16,1986,10,"male",431,157,54,754,566,50,105,704,461
1644816,21,7,1992,4,"female",502,153,72,102,223,12,107,90,116
1644832,56,5,1957,11,"male",588,25,14,46,30,40,12,6,18
1644855,72,19,1941,12,"female",924,15,13,4,3,0,0,4,3
1644863,23,21,1990,3,"female",0,0,0,1,0,0,0,1,0
1644878,22,19,1991,8,"male",208,21,17,0,0,0,0,0,0
1644883,31,21,1982,10,"male",285,161,126,0,8,0,3,0,5
1644891,24,18,1989,9,"male",312,192,99,3,7,3,4,0,3
1644898,19,26,1994,12,"male",506,144,99,61,41,0,12,61,29
1644902,34,2,1979,9,"male",1003,307,165,0,9,0,6,0,3
1644903,64,14,1949,7,"male",402,160,132,17,28,0,11,17,17
1644916,15,7,1998,3,"male",319,29,17,21,9,11,2,10,7
1644936,49,14,1964,1,"female",1000,18,14,2,3,2,3,0,0
1644999,15,12,1998,2,"male",353,135,103,59,3,52,2,7,1
1645019,29,18,1984,5,"female",596,7,7,1,2,1,2,0,0
1645029,22,23,1991,4,"male",501,501,411,104,134,14,88,90,46
1645037,17,1,1996,11,"male",875,253,177,10,98,10,66,0,32
1645052,23,12,1990,11,"female",940,547,298,396,351,241,167,155,184
1645054,22,17,1991,10,"male",215,39,30,13,8,0,3,13,5
1645066,15,12,1998,3,"male",432,494,441,32,29,31,8,1,21
1645110,18,29,1995,12,"female",53,4,2,3,4,3,4,0,0
1645121,19,20,1994,9,"female",1177,2507,1610,1746,2458,726,1922,1020,536
1645132,103,8,1910,10,"male",479,80,41,2,1,2,1,0,0
1645134,23,16,1990,4,"female",61,1481,1029,1319,859,202,352,1117,507
1645145,53,23,1960,2,"male",658,9,3,0,0,0,0,0,0
1645154,20,2,1993,10,"male",223,1320,895,1648,1202,219,773,1429,429
1645162,15,18,1998,11,"female",663,1756,463,1752,1230,1083,624,669,606
1645167,53,8,1960,5,"female",719,24,14,50,84,0,73,50,11
1645170,108,15,1905,6,"female",1932,31,13,1,13,0,5,1,8
1645186,33,3,1980,9,"male",232,72,57,8,2,8,2,0,0
1645206,18,18,1995,8,"female",274,113,84,33,38,31,26,2,12
1645215,21,14,1992,1,"male",5,50,41,0,43,0,21,0,22
1645235,38,5,1975,4,"male",300,68,44,59,100,59,88,0,12
1645236,29,12,1984,9,"female",1551,372,276,221,852,206,414,15,438
1645252,53,8,1960,7,"male",544,45,28,12,45,12,21,0,24
1645266,15,15,1998,4,"male",592,39,15,0,0,0,0,0,0
1645290,33,6,1980,2,"male",412,6,3,0,0,0,0,0,0
1645293,106,27,1907,1,"male",849,176,113,171,133,46,65,125,68
1645353,18,11,1995,11,"female",133,103,81,0,0,0,0,0,0
1645378,29,28,1984,8,"female",409,45,38,77,26,77,21,0,5
1645392,60,28,1953,2,"female",918,27,16,0,0,0,0,0,0
1645406,62,20,1951,1,"female",409,216,151,893,205,9,94,884,111
1645428,28,16,1985,5,"female",395,13,4,0,0,0,0,0,0
1645447,59,3,1954,6,"male",344,33,18,1,6,1,6,0,0
1645457,46,22,1967,2,"female",300,113,63,0,1,0,1,0,0
1645458,104,2,1909,8,"male",1394,76,45,0,1,0,1,0,0
1645475,22,18,1991,1,"male",579,241,91,7,7,4,2,3,5
1645517,51,8,1962,5,"male",379,56,32,17,7,0,2,17,5
1645519,106,11,1907,12,"male",983,196,77,1,1,1,1,0,0
1645521,23,7,1990,8,"male",606,392,366,0,15,0,11,0,4
1645528,39,27,1974,12,"female",598,176,143,0,0,0,0,0,0
1645537,37,22,1976,5,"male",412,53,28,42,6,42,5,0,1
1645553,22,24,1991,4,"female",1660,289,130,12,9,5,7,7,2
1645555,26,23,1987,9,"female",166,291,61,12,22,12,21,0,1
1645572,23,20,1990,7,"female",512,189,162,28,21,24,20,4,1
1645589,19,21,1994,8,"female",547,2027,1316,2133,1357,2133,1175,0,182
1645610,22,13,1991,9,"male",97,32,26,0,2,0,0,0,2
1645630,53,22,1960,4,"male",563,9,7,19,1,1,0,18,1
1645675,27,17,1986,12,"male",219,284,269,3,3,3,2,0,1
1645709,48,28,1965,6,"male",333,98,74,2,9,2,7,0,2
1645711,25,1,1988,2,"male",213,12,8,10,9,10,9,0,0
1645713,16,9,1997,7,"female",560,684,402,422,174,422,127,0,47
1645715,16,8,1997,4,"male",242,269,177,17,137,17,93,0,44
1645728,36,31,1977,12,"male",196,20,10,0,0,0,0,0,0
1645752,18,25,1995,9,"male",71,167,110,8,33,8,16,0,17
1645754,40,1,1973,1,"male",971,1070,882,49,30,49,29,0,1
1645756,30,22,1983,9,"female",173,111,70,320,196,229,89,91,107
1645791,18,2,1995,5,"male",1051,174,13,0,0,0,0,0,0
1645807,27,26,1986,4,"male",566,5,5,5,0,5,0,0,0
1645832,66,14,1947,9,"male",735,11,3,0,2,0,1,0,1
1645888,48,5,1965,4,"female",204,23,20,0,0,0,0,0,0
1645900,50,21,1963,2,"female",1286,48,23,1,1,1,0,0,1
1645913,21,31,1992,1,"female",339,69,46,0,0,0,0,0,0
1645915,58,2,1955,11,"female",220,32,28,7,2,0,2,7,0
1645935,103,17,1910,12,"male",732,265,253,1,1,1,1,0,0
1645947,66,8,1947,10,"male",332,46,35,0,0,0,0,0,0
1645953,48,3,1965,7,"female",300,34,29,428,96,428,67,0,29
1645975,19,28,1994,9,"female",138,155,137,53,27,53,25,0,2
1645991,24,12,1989,1,"male",729,203,162,0,0,0,0,0,0
1645995,24,27,1989,2,"male",770,123,41,1,2,1,2,0,0
1646016,19,21,1994,9,"male",315,34,16,4,2,4,0,0,2
1646023,16,12,1997,5,"male",606,232,174,168,46,22,37,146,9
1646043,26,10,1987,8,"female",370,146,95,66,29,66,29,0,0
1646123,16,8,1997,12,"male",308,121,80,3,3,3,3,0,0
1646136,38,7,1975,8,"male",412,185,102,10,182,10,87,0,95
1646183,20,12,1993,9,"male",801,86,60,83,3,83,3,0,0
1646184,73,19,1940,1,"female",1573,24,9,79,6,34,6,45,0
1646194,15,6,1998,1,"female",595,21,17,2,30,2,16,0,14
1646200,21,13,1992,6,"male",474,31,17,78,32,15,17,63,15
1646219,31,3,1982,9,"male",342,132,70,11,21,2,11,9,10
1646271,65,10,1948,3,"male",443,200,148,2,7,2,3,0,4
1646280,15,25,1998,9,"female",192,585,96,103,164,90,123,13,41
1646284,23,1,1990,1,"male",322,178,149,18,30,18,26,0,4
1646317,38,19,1975,12,"female",287,24,19,0,0,0,0,0,0
1646332,34,15,1979,9,"male",422,78,60,0,0,0,0,0,0
1646334,39,13,1974,2,"male",282,4,4,2,1,0,0,2,1
1646347,20,25,1993,7,"male",466,76,51,2,2,2,2,0,0
1646353,34,11,1979,10,"male",770,108,51,0,0,0,0,0,0
1646404,25,5,1988,8,"male",781,283,217,0,0,0,0,0,0
1646410,15,11,1998,5,"female",588,894,404,396,162,389,39,7,123
1646417,44,8,1969,4,"male",386,4,3,0,0,0,0,0,0
1646428,18,19,1995,1,"male",89,50,40,28,27,28,15,0,12
1646430,72,22,1941,2,"female",1489,32,23,165,72,31,11,134,61
1646436,19,3,1994,3,"male",668,127,66,6,22,3,15,3,7
1646437,61,27,1952,5,"female",677,46,23,192,76,192,58,0,18
1646439,46,14,1967,1,"male",608,39,15,216,214,216,17,0,197
1646456,15,24,1998,11,"male",52,0,0,0,0,0,0,0,0
1646470,58,11,1955,4,"male",202,146,130,6,1,0,0,6,1
1646481,20,26,1993,2,"female",434,199,23,0,9,0,9,0,0
1646496,26,1,1987,1,"female",554,33,14,113,201,113,173,0,28
1646524,33,24,1980,11,"female",354,189,118,214,230,1,151,213,79
1646544,32,21,1981,1,"male",326,14,8,60,6,47,3,13,3
1646578,22,11,1991,6,"female",355,166,86,21,28,21,21,0,7
1646591,27,20,1986,4,"female",277,61,32,73,99,63,36,10,63
1646614,24,8,1989,1,"male",408,37,32,0,2,0,1,0,1
1646616,19,24,1994,5,"female",1091,1382,473,2169,4623,1277,1120,892,3503
1646636,26,12,1987,3,"male",153,26,20,29,121,29,103,0,18
1646642,19,4,1994,5,"female",572,406,77,217,176,214,98,3,78
1646718,23,22,1990,10,"male",405,361,333,0,0,0,0,0,0
1646721,64,10,1949,9,"female",1733,252,138,245,182,185,118,60,64
1646750,22,16,1991,10,"male",541,219,102,10,7,10,6,0,1
1646755,60,20,1953,7,"female",121,34,15,6,18,0,7,6,11
1646759,72,8,1941,9,"male",1701,68,28,106,108,106,84,0,24
1646772,42,20,1971,8,"female",280,18,12,102,85,85,75,17,10
1646802,103,9,1910,9,"male",1326,364,206,3,1,3,1,0,0
1646821,39,27,1974,8,"female",437,13,4,6,0,6,0,0,0
1646836,22,15,1991,7,"male",635,52,36,0,0,0,0,0,0
1646871,108,25,1905,4,"male",1639,111,42,198,125,195,84,3,41
1646874,19,12,1994,10,"female",758,227,95,56,36,56,36,0,0
1646887,23,26,1990,6,"male",263,46,38,0,0,0,0,0,0
1646943,34,6,1979,1,"male",300,0,0,0,0,0,0,0,0
1646953,53,15,1960,6,"male",2276,167,88,14,33,14,26,0,7
1646985,26,11,1987,8,"female",185,251,153,2,23,0,1,2,22
1646995,58,11,1955,10,"female",764,103,54,141,84,37,28,104,56
1646997,27,26,1986,4,"male",352,171,146,1,0,1,0,0,0
1647016,47,21,1966,1,"male",208,35,31,4,0,4,0,0,0
1647076,54,15,1959,4,"female",1593,38,10,2,2,0,2,2,0
1647101,17,13,1996,12,"female",720,66,39,10,32,10,20,0,12
1647105,18,20,1995,6,"male",368,167,100,0,0,0,0,0,0
1647150,18,22,1995,1,"female",155,232,50,1,10,1,6,0,4
1647159,65,8,1948,10,"female",2005,324,191,1324,1206,1129,560,195,646
1647174,17,15,1996,3,"male",374,230,97,0,1,0,0,0,1
1647183,53,15,1960,7,"male",655,34,13,13,6,2,1,11,5
1647184,30,24,1983,1,"male",562,0,0,0,0,0,0,0,0
1647257,25,13,1988,8,"male",877,77,65,3,92,3,34,0,58
1647275,20,20,1993,11,"male",506,421,231,36,46,26,6,10,40
1647299,65,7,1948,12,"female",1779,30,17,8,16,8,15,0,1
1647377,21,14,1992,2,"male",319,68,17,9,2,9,2,0,0
1647384,22,31,1991,10,"female",170,96,38,18,13,18,6,0,7
1647400,19,8,1994,7,"male",600,493,375,5,0,1,0,4,0
1647458,38,30,1975,9,"male",449,120,96,32,14,32,9,0,5
1647513,38,21,1975,5,"male",1096,64,34,0,0,0,0,0,0
1647515,22,12,1991,1,"male",409,60,55,0,0,0,0,0,0
1647526,30,25,1983,7,"male",183,34,24,9,2,9,2,0,0
1647532,18,4,1995,2,"male",776,182,123,222,48,222,47,0,1
1647556,37,25,1976,9,"female",650,2,1,1,0,1,0,0,0
1647560,53,7,1960,5,"male",315,3,1,0,0,0,0,0,0
1647572,103,8,1910,8,"male",717,223,211,0,0,0,0,0,0
1647599,18,7,1995,10,"female",301,71,56,24,25,24,9,0,16
1647622,23,4,1990,7,"male",802,95,62,1,2,1,2,0,0
1647630,61,4,1952,10,"male",659,0,0,0,0,0,0,0,0
1647631,38,9,1975,9,"male",129,1,1,77,67,0,0,77,67
1647634,32,5,1981,8,"male",882,34,24,0,3,0,1,0,2
1647686,50,29,1963,3,"female",524,62,58,300,248,47,176,253,72
1647699,49,14,1964,7,"male",160,28,19,1,0,1,0,0,0
1647703,25,22,1988,11,"male",895,148,77,26,4,26,2,0,2
1647704,21,17,1992,5,"male",346,42,31,1,0,1,0,0,0
1647710,84,15,1929,3,"female",48,32,18,0,1,0,1,0,0
1647757,18,16,1995,5,"male",390,104,64,50,3,50,2,0,1
1647767,19,28,1994,1,"male",4,11,11,17,1,7,0,10,1
1647770,24,17,1989,4,"female",29,12,6,12,13,12,13,0,0
1647787,22,15,1991,5,"female",32,38,15,0,1,0,1,0,0
1647789,23,28,1990,6,"male",240,92,90,2,6,1,2,1,4
1647793,40,10,1973,10,"male",215,36,26,1,16,1,12,0,4
1647831,31,22,1982,11,"male",398,27,8,0,0,0,0,0,0
1647844,103,15,1910,10,"female",384,774,578,25,30,25,25,0,5
1647849,38,10,1975,5,"male",824,33,14,1,1,1,1,0,0
1647868,59,18,1954,10,"male",235,9,7,13,0,0,0,13,0
1647887,16,4,1997,11,"male",336,209,133,158,80,1,52,157,28
1647944,66,3,1947,3,"male",264,118,88,57,5,57,3,0,2
1647974,18,22,1995,10,"female",255,70,32,252,34,0,3,252,31
1647978,30,23,1983,10,"female",337,81,42,96,50,95,27,1,23
1648049,64,10,1949,5,"male",2243,59,10,0,0,0,0,0,0
1648074,36,3,1977,4,"male",49,32,16,72,44,72,40,0,4
1648077,65,4,1948,10,"female",1790,106,33,82,32,82,22,0,10
1648093,66,8,1947,6,"female",949,193,101,183,104,183,99,0,5
1648098,19,15,1994,6,"male",416,8,5,16,19,16,10,0,9
1648114,37,18,1976,8,"female",323,189,107,13,11,13,11,0,0
1648142,61,24,1952,11,"male",133,75,66,0,0,0,0,0,0
1648182,61,7,1952,5,"female",999,95,72,24,22,0,12,24,10
1648185,23,23,1990,1,"male",88,3,1,0,0,0,0,0,0
1648220,54,14,1959,1,"male",187,6,5,0,0,0,0,0,0
1648246,19,1,1994,1,"female",397,102,94,0,0,0,0,0,0
1648286,14,10,1999,10,"male",149,74,60,0,0,0,0,0,0
1648298,56,3,1957,1,"female",1032,292,154,636,420,5,161,631,259
1648320,31,1,1982,1,"male",75,40,22,73,2,72,2,1,0
1648340,62,13,1951,9,"male",55,5,5,2,0,2,0,0,0
1648370,22,30,1991,4,"female",203,259,131,434,203,434,178,0,25
1648371,24,1,1989,1,"male",169,14,13,3,1,3,1,0,0
1648391,108,18,1905,6,"male",1189,434,341,0,0,0,0,0,0
1648406,42,7,1971,2,"female",277,8,7,0,0,0,0,0,0
1648422,20,2,1993,12,"male",76,40,28,35,5,35,4,0,1
1648467,18,26,1995,9,"male",233,92,38,6,6,6,2,0,4
1648507,26,15,1987,8,"male",267,24,19,0,1,0,1,0,0
1648560,96,15,1917,2,"male",1540,280,141,8,5,8,5,0,0
1648572,52,14,1961,8,"male",1822,30,13,0,0,0,0,0,0
1648585,16,15,1997,4,"male",817,95,39,33,0,33,0,0,0
1648591,30,4,1983,7,"male",260,98,77,3,8,3,7,0,1
1648599,40,29,1973,9,"female",176,39,19,48,345,47,246,1,99
1648605,14,10,1999,6,"male",36,36,31,0,1,0,1,0,0
1648608,46,6,1967,4,"male",153,57,49,4,9,4,5,0,4
1648621,16,12,1997,4,"male",327,22,14,0,0,0,0,0,0
1648622,30,25,1983,7,"male",533,87,35,15,42,2,23,13,19
1648623,16,1,1997,1,"male",131,10,7,1,0,1,0,0,0
1648624,14,3,1999,8,"male",288,54,39,2,4,2,3,0,1
1648638,23,24,1990,1,"male",736,302,84,11,0,11,0,0,0
1648677,50,21,1963,8,"male",279,69,53,77,24,75,13,2,11
1648709,22,12,1991,7,"male",161,1,1,31,1,0,1,31,0
1648718,20,12,1993,10,"female",578,202,51,0,0,0,0,0,0
1648719,17,16,1996,12,"male",647,585,353,38,46,19,35,19,11
1648764,50,3,1963,7,"female",1410,172,46,234,223,8,13,226,210
1648783,16,1,1997,7,"male",62,64,58,2,3,2,3,0,0
1648786,22,4,1991,10,"female",285,109,25,57,12,31,10,26,2
1648791,24,17,1989,11,"male",635,75,44,4,39,2,18,2,21
1648837,23,5,1990,3,"female",465,211,199,115,67,115,59,0,8
1648847,19,7,1994,9,"female",249,215,73,16,507,12,341,4,166
1648861,28,26,1985,7,"male",380,18,12,0,0,0,0,0,0
1648893,17,26,1996,7,"female",642,317,174,294,525,210,243,84,282
1648900,51,10,1962,1,"male",1127,144,41,0,3,0,0,0,3
1648918,57,3,1956,9,"male",211,312,162,373,189,0,60,373,129
1648920,38,28,1975,9,"female",436,70,60,732,207,726,148,6,59
1648948,81,11,1932,9,"female",238,233,97,0,0,0,0,0,0
1648949,108,1,1905,12,"male",1293,86,64,0,0,0,0,0,0
1648984,43,31,1970,12,"male",271,170,134,59,36,59,34,0,2
1648990,32,1,1981,1,"female",147,1,1,2,2,2,0,0,2
1649025,18,21,1995,3,"female",362,512,398,8,3,8,0,0,3
1649030,54,23,1959,6,"male",273,161,151,470,110,470,34,0,76
1649044,24,29,1989,8,"male",136,1,0,0,0,0,0,0,0
1649055,30,11,1983,3,"male",75,43,29,8,0,8,0,0,0
1649066,21,23,1992,6,"male",312,10,4,0,1,0,0,0,1
1649077,30,15,1983,6,"female",448,221,102,84,22,43,6,41,16
1649078,59,19,1954,3,"male",417,53,11,48,1,45,1,3,0
1649086,40,27,1973,5,"male",264,0,0,0,0,0,0,0,0
1649171,46,7,1967,4,"female",652,106,59,280,135,258,104,22,31
1649191,15,17,1998,4,"male",795,6,4,1,0,0,0,1,0
1649192,28,12,1985,12,"male",52,103,54,71,133,71,104,0,29
1649208,21,1,1992,9,"male",382,51,35,0,0,0,0,0,0
1649224,45,16,1968,10,"male",251,216,91,408,456,408,405,0,51
1649239,34,4,1979,4,"male",218,32,29,12,4,12,4,0,0
1649244,61,6,1952,2,"female",1755,149,103,114,63,42,41,72,22
1649260,54,11,1959,11,"female",1683,145,61,115,86,115,62,0,24
1649285,64,10,1949,1,"female",1072,80,64,287,21,286,6,1,15
1649287,38,11,1975,7,"female",594,44,33,48,21,48,12,0,9
1649303,15,4,1998,4,"female",218,54,41,13,2,13,2,0,0
1649308,63,25,1950,2,"female",522,250,174,44,8,6,3,38,5
1649310,23,15,1990,2,"female",60,31,21,16,51,16,50,0,1
1649314,58,8,1955,5,"female",53,33,32,0,0,0,0,0,0
1649315,31,12,1982,3,"male",541,246,154,1,2,1,0,0,2
1649353,38,12,1975,6,"male",697,411,375,66,92,66,73,0,19
1649368,25,6,1988,9,"male",381,222,127,18,3,18,3,0,0
1649393,33,17,1980,7,"male",48,26,24,1,0,1,0,0,0
1649398,20,14,1993,12,"male",232,142,104,1,0,0,0,1,0
1649425,19,5,1994,4,"male",300,52,41,23,23,23,11,0,12
1649434,17,27,1996,11,"male",988,12,4,0,3,0,0,0,3
1649454,63,27,1950,10,"female",1473,92,20,114,51,114,47,0,4
1649456,108,1,1905,11,"male",1847,76,48,1,18,0,17,1,1
1649467,28,28,1985,4,"female",1299,163,37,0,0,0,0,0,0
1649475,85,17,1928,12,"female",957,1114,486,188,87,0,5,188,82
1649485,18,18,1995,1,"female",316,737,541,590,484,590,437,0,47
1649498,25,9,1988,3,"male",272,164,108,9,0,3,0,6,0
1649532,79,2,1934,8,"male",1570,209,154,270,30,175,25,95,5
1649566,76,10,1937,6,"female",380,57,49,0,0,0,0,0,0
1649572,37,21,1976,6,"female",283,75,59,63,19,63,12,0,7
1649575,73,26,1940,6,"male",257,6,5,0,0,0,0,0,0
1649592,57,15,1956,7,"male",338,88,52,4,8,4,5,0,3
1649594,27,16,1986,7,"male",113,41,35,6,0,6,0,0,0
1649600,18,6,1995,1,"male",769,572,389,52,27,46,7,6,20
1649610,16,24,1997,5,"female",67,274,132,103,558,19,123,84,435
1649624,59,13,1954,10,"female",1785,160,63,406,340,212,185,194,155
1649657,59,4,1954,1,"female",1586,145,88,799,101,797,70,2,31
1649658,25,30,1988,10,"male",303,2,2,0,0,0,0,0,0
1649663,24,29,1989,7,"female",2135,229,92,1,11,1,10,0,1
1649670,16,14,1997,9,"female",164,437,417,146,45,132,38,14,7
1649682,86,29,1927,9,"female",1119,437,179,0,6,0,3,0,3
1649694,54,7,1959,9,"male",887,193,164,196,32,1,3,195,29
1649711,24,2,1989,1,"female",135,44,36,17,61,17,29,0,32
1649723,46,25,1967,2,"female",1793,38,13,93,122,93,103,0,19
1649724,17,23,1996,5,"female",51,211,188,549,534,376,370,173,164
1649725,37,16,1976,7,"male",480,205,96,1,1,1,1,0,0
1649726,15,1,1998,8,"male",123,41,31,56,22,0,7,56,15
1649732,25,19,1988,4,"male",490,250,198,2,12,2,11,0,1
1649753,17,22,1996,7,"female",362,196,139,229,76,151,38,78,38
1649754,14,29,1999,4,"female",22,0,0,0,0,0,0,0,0
1649755,40,15,1973,5,"male",242,14,11,0,0,0,0,0,0
1649775,15,20,1998,10,"female",619,4468,751,959,970,642,854,317,116
1649788,13,18,2000,1,"male",256,76,28,0,1,0,0,0,1
1649810,19,23,1994,7,"male",35,212,202,15,14,15,14,0,0
1649816,38,6,1975,5,"male",72,77,23,3,14,2,11,1,3
1649821,56,23,1957,5,"female",298,37,26,0,0,0,0,0,0
1649824,33,1,1980,3,"female",226,77,53,139,182,128,90,11,92
1649846,53,16,1960,11,"female",544,136,111,2104,391,2104,270,0,121
1649851,46,11,1967,8,"female",1265,186,147,487,206,486,116,1,90
1649852,25,3,1988,10,"female",362,136,97,0,1,0,1,0,0
1649864,36,7,1977,1,"male",467,1,1,0,0,0,0,0,0
1649868,36,17,1977,9,"male",516,61,52,44,0,44,0,0,0
1649882,54,22,1959,10,"male",563,25,23,0,0,0,0,0,0
1649883,25,10,1988,4,"female",452,214,131,7,1,7,1,0,0
1649888,52,20,1961,4,"female",787,39,32,11,10,0,3,11,7
1649905,20,9,1993,5,"male",374,542,367,3087,1919,3087,1632,0,287
1649936,28,3,1985,8,"male",165,128,111,343,409,343,348,0,61
1649939,24,28,1989,3,"female",686,83,49,396,67,396,56,0,11
1649947,22,16,1991,10,"female",205,223,92,184,166,103,58,81,108
1649956,34,12,1979,4,"female",828,74,33,52,70,49,34,3,36
1649986,55,10,1958,11,"male",307,14,11,2,0,2,0,0,0
1649998,58,1,1955,7,"male",1024,186,96,8,9,2,1,6,8
1650010,21,14,1992,9,"male",408,1610,1234,281,731,199,564,82,167
1650012,75,18,1938,11,"male",1038,28,8,0,1,0,0,0,1
1650024,21,1,1992,1,"female",132,36,24,30,11,18,9,12,2
1650051,103,4,1910,12,"female",705,109,15,0,0,0,0,0,0
1650069,30,21,1983,7,"male",612,34,31,11,1,2,0,9,1
1650143,35,24,1978,10,"female",152,54,35,81,33,1,18,80,15
1650145,21,21,1992,6,"male",446,110,35,23,18,23,13,0,5
1650169,28,15,1985,4,"female",556,71,23,82,5,82,5,0,0
1650178,19,22,1994,2,"male",62,3,3,3,1,0,0,3,1
1650200,17,1,1996,6,"female",699,870,747,400,363,28,274,372,89
1650216,14,5,1999,10,"male",251,66,48,3,22,3,11,0,11
1650235,40,13,1973,3,"male",580,94,37,166,50,166,32,0,18
1650279,28,6,1985,8,"male",779,61,41,26,4,26,4,0,0
1650287,28,13,1985,11,"male",1796,1252,566,0,3,0,1,0,2
1650304,19,27,1994,8,"male",256,41,13,141,6,141,6,0,0
1650307,40,5,1973,3,"male",489,20,16,0,0,0,0,0,0
1650315,15,5,1998,8,"female",28,32,19,3,6,3,1,0,5
1650331,26,15,1987,2,"male",443,171,139,0,2,0,2,0,0
1650357,18,17,1995,1,"male",602,14,11,0,0,0,0,0,0
1650359,71,31,1942,12,"male",166,68,41,72,5,0,4,72,1
1650378,103,13,1910,12,"male",951,123,71,15,5,15,5,0,0
1650385,22,29,1991,5,"female",1178,395,176,70,92,66,75,4,17
1650389,108,2,1905,6,"male",885,76,59,25,18,25,15,0,3
1650397,43,19,1970,1,"male",521,131,102,43,45,43,34,0,11
1650410,31,2,1982,12,"male",29,0,0,1,0,0,0,1,0
1650417,48,22,1965,6,"male",27,14,13,1,1,1,1,0,0
1650420,47,26,1966,8,"male",91,11,10,0,0,0,0,0,0
1650435,19,7,1994,12,"male",343,65,26,2,30,2,29,0,1
1650450,30,6,1983,4,"female",1414,107,48,100,129,100,108,0,21
1650465,16,28,1997,11,"female",216,210,113,2,7,2,2,0,5
1650469,18,12,1995,6,"male",870,1505,1267,1450,249,1450,239,0,10
1650517,17,29,1996,8,"male",91,13,11,1,0,1,0,0,0
1650571,61,22,1952,3,"female",660,72,31,14,7,4,4,10,3
1650584,90,12,1923,8,"female",1733,313,97,171,309,171,276,0,33
1650618,16,20,1997,11,"male",125,120,102,8,22,3,1,5,21
1650627,64,17,1949,10,"female",1734,54,25,24,11,24,7,0,4
1650633,15,23,1998,3,"female",593,406,164,27,17,0,6,27,11
1650672,56,15,1957,11,"female",1026,16,9,0,0,0,0,0,0
1650678,23,4,1990,2,"male",320,41,38,2,1,0,1,2,0
1650684,21,1,1992,10,"male",529,849,645,1189,835,867,653,322,182
1650685,62,10,1951,11,"male",1740,87,14,0,2,0,1,0,1
1650689,18,19,1995,2,"female",248,153,77,174,93,174,93,0,0
1650750,18,1,1995,1,"female",291,133,57,2,5,2,2,0,3
1650751,25,29,1988,2,"male",112,16,6,1,3,1,2,0,1
1650762,30,14,1983,11,"female",1777,263,79,116,161,73,114,43,47
1650798,38,5,1975,4,"female",436,167,87,745,302,745,241,0,61
1650799,33,10,1980,4,"male",259,33,26,2,0,0,0,2,0
1650860,57,8,1956,9,"female",780,25,10,1302,769,0,209,1302,560
1650870,20,2,1993,5,"female",272,41,19,188,77,172,54,16,23
1650893,69,12,1944,5,"female",714,50,31,429,237,0,13,429,224
1650900,15,8,1998,1,"male",648,15,11,4,0,1,0,3,0
1650927,16,29,1997,5,"male",459,823,734,0,4,0,3,0,1
1650930,24,29,1989,6,"female",183,273,26,244,109,244,103,0,6
1650983,18,1,1995,1,"male",376,64,55,0,0,0,0,0,0
1650993,28,28,1985,9,"male",215,50,44,0,4,0,3,0,1
1651007,14,12,1999,7,"female",119,315,144,10,36,1,25,9,11
1651008,30,20,1983,4,"male",459,475,443,1,18,1,5,0,13
1651059,14,27,1999,10,"male",316,20,9,22,1,0,1,22,0
1651067,20,11,1993,11,"female",499,94,32,8,18,5,17,3,1
1651097,50,12,1963,1,"male",1107,309,230,2854,3504,1697,1271,1157,2233
1651117,16,10,1997,12,"female",391,167,119,5961,5525,918,1618,5043,3907
1651138,20,13,1993,8,"female",494,10,3,325,0,9,0,316,0
1651160,15,1,1998,1,"female",79,28,22,2,2,2,2,0,0
1651162,18,11,1995,10,"female",8,3,3,19,2,8,0,11,2
1651177,37,14,1976,2,"female",288,20,9,0,2,0,1,0,1
1651181,48,23,1965,5,"male",636,101,59,8,24,2,10,6,14
1651188,19,11,1994,12,"male",321,339,224,461,455,459,280,2,175
1651224,47,10,1966,1,"male",512,25,12,70,6,68,6,2,0
1651248,17,17,1996,5,"male",53,15,13,0,0,0,0,0,0
1651278,60,3,1953,5,"male",559,32,22,0,0,0,0,0,0
1651284,55,28,1958,5,"female",1707,113,61,22,1,22,0,0,1
1651285,31,2,1982,2,"male",727,153,83,7,4,7,3,0,1
1651304,18,7,1995,11,"female",396,137,111,408,602,136,277,272,325
1651326,19,28,1994,3,"female",337,301,177,9,1,8,0,1,1
1651327,48,31,1965,3,"female",403,36,20,6,4,2,4,4,0
1651329,28,22,1985,11,"female",330,26,7,9,11,9,11,0,0
1651347,50,22,1963,7,"male",33,21,12,23,4,23,2,0,2
1651358,50,21,1963,7,"male",315,162,90,371,333,371,170,0,163
1651363,14,22,1999,9,"male",393,97,21,6,0,6,0,0,0
1651400,28,24,1985,1,"female",303,138,94,53,169,33,61,20,108
1651409,62,11,1951,8,"female",2301,256,99,578,1030,0,196,578,834
1651436,37,15,1976,3,"male",876,206,170,0,0,0,0,0,0
1651437,42,8,1971,4,"male",170,367,183,17,45,17,15,0,30
1651451,57,13,1956,3,"male",1470,25,21,0,1,0,1,0,0
1651458,66,27,1947,3,"female",471,27,19,18,4,0,2,18,2
1651463,17,9,1996,1,"female",597,1883,278,24,171,24,151,0,20
1651464,75,9,1938,1,"female",189,34,26,3,0,0,0,3,0
1651465,34,25,1979,1,"male",307,26,9,0,5,0,0,0,5
1651467,17,20,1996,4,"female",460,866,574,183,422,100,274,83,148
1651473,25,7,1988,10,"female",133,139,103,810,770,810,484,0,286
1651476,26,19,1987,12,"male",164,14,12,0,0,0,0,0,0
1651477,25,28,1988,2,"male",51,75,70,3,1,0,0,3,1
1651480,20,13,1993,1,"female",762,356,116,83,64,79,46,4,18
1651486,23,27,1990,8,"female",621,629,320,32,145,32,118,0,27
1651494,39,7,1974,9,"female",1754,826,264,292,1818,181,856,111,962
1651513,14,26,1999,1,"male",285,7,1,0,0,0,0,0,0
1651551,25,24,1988,10,"male",170,52,27,52,19,52,17,0,2
1651565,56,11,1957,12,"female",720,35,15,17,8,17,5,0,3
1651576,48,16,1965,4,"female",114,45,34,0,0,0,0,0,0
1651593,30,3,1983,3,"female",83,5,5,2741,2618,615,355,2126,2263
1651599,19,15,1994,8,"male",396,50,42,2,2,2,2,0,0
1651607,56,5,1957,4,"male",324,19,9,0,0,0,0,0,0
1651616,60,18,1953,7,"female",1549,153,82,27,0,27,0,0,0
1651637,21,5,1992,5,"female",594,362,225,576,627,254,237,322,390
1651656,56,9,1957,11,"female",1018,132,78,146,58,15,27,131,31
1651669,14,12,1999,6,"female",107,45,19,74,5,74,5,0,0
1651706,26,15,1987,10,"female",644,86,50,0,0,0,0,0,0
1651710,15,12,1998,3,"female",282,455,210,934,1216,5,243,929,973
1651714,25,1,1988,1,"female",193,45,23,3,5,3,5,0,0
1651740,27,17,1986,12,"female",18,0,0,0,0,0,0,0,0
1651748,38,28,1975,12,"female",169,3,1,163,22,0,9,163,13
1651771,27,26,1986,12,"male",125,195,91,23,12,23,10,0,2
1651784,100,12,1913,9,"male",236,238,139,0,0,0,0,0,0
1651809,75,21,1938,9,"male",1499,11,3,19,0,0,0,19,0
1651813,19,22,1994,5,"male",809,602,91,651,282,359,265,292,17
1651818,14,23,1999,4,"male",16,6,6,0,0,0,0,0,0
1651819,53,6,1960,8,"male",204,11,5,0,0,0,0,0,0
1651820,23,3,1990,4,"male",234,33,17,0,0,0,0,0,0
1651879,48,6,1965,7,"female",289,244,178,1920,554,1920,456,0,98
1651936,23,16,1990,4,"male",743,1614,1121,46,115,30,89,16,26
1651944,14,9,1999,4,"male",215,261,190,6,1,0,0,6,1
1651957,38,16,1975,12,"male",647,160,69,10,35,10,22,0,13
1651961,29,23,1984,7,"male",508,86,53,4,2,3,1,1,1
1651962,108,17,1905,5,"female",1814,56,21,1,11,0,0,1,11
1651963,25,1,1988,1,"female",220,64,44,6,99,6,90,0,9
1651971,25,1,1988,1,"male",177,13,10,0,0,0,0,0,0
1651972,39,28,1974,9,"male",142,60,49,0,0,0,0,0,0
1652008,17,21,1996,6,"male",442,66,42,1,1,1,1,0,0
1652029,47,12,1966,10,"male",1309,9,4,0,0,0,0,0,0
1652033,19,14,1994,4,"male",478,243,172,5,0,5,0,0,0
1652044,29,21,1984,10,"male",291,116,91,24,36,24,28,0,8
1652054,33,9,1980,1,"male",602,18,12,2,3,2,1,0,2
1652065,23,20,1990,10,"male",410,19,7,7,4,3,1,4,3
1652075,63,22,1950,8,"male",433,47,44,0,5,0,2,0,3
1652083,59,28,1954,4,"male",485,126,95,186,85,186,60,0,25
1652095,22,4,1991,9,"male",941,151,76,56,64,9,25,47,39
1652108,65,24,1948,8,"male",576,378,214,192,507,7,137,185,370
1652129,26,11,1987,8,"male",223,23,20,1,1,1,1,0,0
1652137,22,20,1991,7,"female",1718,1289,750,856,478,668,428,188,50
1652149,15,1,1998,11,"male",364,95,72,0,0,0,0,0,0
1652163,61,6,1952,7,"male",1870,57,35,47,56,39,32,8,24
1652167,23,1,1990,11,"female",151,29,22,1,0,1,0,0,0
1652185,62,30,1951,1,"male",893,91,57,442,204,442,117,0,87
1652209,18,7,1995,4,"male",143,137,119,45,15,45,7,0,8
1652225,35,15,1978,3,"female",459,9,6,6,0,2,0,4,0
1652234,27,21,1986,11,"male",820,96,24,0,0,0,0,0,0
1652243,27,9,1986,8,"male",454,7,4,0,0,0,0,0,0
1652271,62,6,1951,1,"female",261,8,5,2,1,0,0,2,1
1652307,75,17,1938,3,"male",264,517,310,23,416,0,233,23,183
1652333,27,25,1986,7,"male",898,201,99,0,0,0,0,0,0
1652373,44,23,1969,1,"female",339,24,16,0,0,0,0,0,0
1652384,44,16,1969,11,"male",904,24,19,0,0,0,0,0,0
1652386,49,23,1964,11,"female",1150,1761,844,858,2759,25,2172,833,587
1652387,16,27,1997,9,"male",64,100,76,1,9,1,2,0,7
1652420,23,28,1990,2,"male",403,54,31,15,55,11,35,4,20
1652429,51,1,1962,3,"female",637,90,56,47,50,0,10,47,40
1652434,48,21,1965,7,"female",1214,66,19,0,7,0,6,0,1
1652440,57,24,1956,11,"female",329,34,29,31,8,0,0,31,8
1652451,33,1,1980,1,"male",209,0,0,0,0,0,0,0,0
1652453,36,25,1977,6,"female",365,12,1,0,0,0,0,0,0
1652522,82,14,1931,4,"male",1935,122,35,11,13,0,3,11,10
1652529,37,2,1976,10,"female",585,52,29,58,70,58,62,0,8
1652535,104,8,1909,5,"male",1854,414,288,3,48,0,21,3,27
1652540,20,3,1993,7,"male",363,110,84,41,107,21,46,20,61
1652555,48,30,1965,4,"male",769,42,42,82,2,0,1,82,1
1652563,22,9,1991,9,"male",18,41,38,4,6,4,2,0,4
1652581,15,12,1998,11,"male",463,71,0,3,0,3,0,0,0
1652592,49,26,1964,1,"male",403,81,50,21,52,21,43,0,9
1652598,19,1,1994,1,"male",34,18,14,0,1,0,0,0,1
1652663,64,11,1949,6,"female",209,13,12,0,0,0,0,0,0
1652666,59,4,1954,2,"female",399,65,52,342,16,279,12,63,4
1652681,34,23,1979,8,"female",392,2308,242,254,1071,254,915,0,156
1652704,19,20,1994,5,"female",240,169,96,58,19,58,11,0,8
1652713,40,8,1973,10,"male",451,8,7,0,3,0,1,0,2
1652769,42,1,1971,1,"male",37,42,36,26,23,26,20,0,3
1652779,50,21,1963,10,"male",303,16,8,55,11,55,11,0,0
1652782,27,26,1986,10,"male",495,251,169,0,1,0,0,0,1
1652805,108,15,1905,1,"male",1358,175,87,15,11,15,9,0,2
1652809,23,23,1990,6,"female",417,27,16,79,5,79,4,0,1
1652838,37,28,1976,4,"female",1718,334,145,1291,1603,1270,1051,21,552
1652841,103,24,1910,1,"male",1590,521,209,27,43,14,21,13,22
1652846,70,29,1943,7,"male",739,18,12,0,0,0,0,0,0
1652865,57,16,1956,6,"female",825,192,84,261,590,2,229,259,361
1652880,24,10,1989,2,"female",258,2,2,60,5,54,5,6,0
1652889,24,5,1989,1,"female",110,9,6,2,0,2,0,0,0
1652935,23,11,1990,4,"male",684,208,146,0,8,0,4,0,4
1652942,29,11,1984,1,"female",625,86,40,39,1,39,1,0,0
1652947,30,13,1983,2,"male",529,135,109,37,33,37,12,0,21
1652959,41,18,1972,10,"female",204,19,16,0,4,0,2,0,2
1653023,32,4,1981,4,"female",612,71,26,106,76,106,48,0,28
1653027,20,19,1993,12,"male",436,133,99,23,34,7,4,16,30
1653054,18,5,1995,5,"female",267,1010,184,1622,1049,1078,367,544,682
1653060,23,19,1990,10,"female",667,1191,881,69,48,8,13,61,35
1653078,22,19,1991,3,"male",293,317,251,118,96,118,67,0,29
1653102,23,1,1990,1,"male",204,355,333,30,28,30,27,0,1
1653112,63,16,1950,9,"female",572,17,12,9,1,0,1,9,0
1653113,25,15,1988,11,"female",34,37,12,15,64,15,56,0,8
1653127,47,1,1966,1,"male",308,8,5,1,11,1,10,0,1
1653134,36,1,1977,1,"male",153,27,25,0,0,0,0,0,0
1653141,17,16,1996,1,"male",18,96,91,6,23,5,12,1,11
1653166,16,30,1997,10,"male",158,39,34,0,0,0,0,0,0
1653198,46,17,1967,5,"male",198,173,167,1,18,1,15,0,3
1653234,31,6,1982,12,"male",280,0,0,0,0,0,0,0,0
1653235,44,25,1969,3,"male",1901,180,55,8,22,8,20,0,2
1653265,34,1,1979,6,"female",207,42,22,49,10,2,10,47,0
1653302,21,8,1992,2,"male",478,11,9,0,1,0,0,0,1
1653304,23,13,1990,11,"male",490,542,439,0,20,0,3,0,17
1653309,69,15,1944,4,"male",1375,114,46,8,10,7,4,1,6
1653310,23,17,1990,10,"male",1185,66,32,65,5,65,2,0,3
1653316,109,11,1904,9,"male",1458,383,173,8,8,8,6,0,2
1653326,21,8,1992,3,"male",317,88,78,0,0,0,0,0,0
1653357,26,16,1987,5,"female",353,7,3,0,0,0,0,0,0
1653363,15,6,1998,5,"male",246,289,32,0,10,0,1,0,9
1653367,17,13,1996,12,"male",139,125,116,17,8,17,3,0,5
1653371,40,2,1973,2,"male",565,3,1,0,0,0,0,0,0
1653386,21,8,1992,11,"female",600,87,43,0,0,0,0,0,0
1653411,22,8,1991,3,"female",1032,12,7,2,8,2,0,0,8
1653421,25,30,1988,1,"female",167,34,21,7,24,7,14,0,10
1653427,24,10,1989,5,"female",312,200,137,31,107,31,60,0,47
1653486,78,3,1935,10,"female",440,33,22,28,13,0,4,28,9
1653493,29,26,1984,7,"female",616,286,221,204,282,192,189,12,93
1653497,21,29,1992,7,"female",529,23,16,28,3,23,2,5,1
1653506,17,26,1996,6,"male",163,33,27,2,0,2,0,0,0
1653510,20,6,1993,3,"female",1418,214,121,1083,1357,847,1009,236,348
1653519,68,20,1945,8,"male",488,44,17,6,0,6,0,0,0
1653536,28,1,1985,3,"female",461,45,9,23,18,23,18,0,0
1653547,18,3,1995,7,"male",131,1422,695,746,3569,430,2051,316,1518
1653548,18,11,1995,9,"female",404,2973,979,137,240,137,220,0,20
1653551,74,26,1939,11,NA,1949,46,29,46,23,46,21,0,2
1653559,21,16,1992,7,"female",286,124,96,292,194,250,119,42,75
1653567,19,26,1994,2,"male",528,232,20,23,62,17,38,6,24
1653598,102,1,1911,1,"female",1723,135,59,39,5,27,3,12,2
1653603,26,9,1987,10,"male",1153,198,60,1,27,1,18,0,9
1653640,24,5,1989,7,"male",46,90,86,2,0,2,0,0,0
1653642,21,9,1992,9,"female",497,249,77,83,192,83,121,0,71
1653643,53,7,1960,12,"male",54,14,13,2,6,0,1,2,5
1653666,44,6,1969,8,"male",910,10,7,0,0,0,0,0,0
1653674,40,25,1973,8,"female",327,19,11,24,9,24,9,0,0
1653679,38,25,1975,1,"male",189,30,8,1,3,1,2,0,1
1653682,40,18,1973,4,"female",684,35,8,1,1,1,1,0,0
1653683,29,3,1984,2,"female",319,125,85,53,81,47,56,6,25
1653686,24,24,1989,6,"male",51,341,315,1,0,0,0,1,0
1653690,22,22,1991,6,"female",418,420,153,53,101,42,42,11,59
1653712,26,1,1987,6,"male",679,379,100,22,15,20,3,2,12
1653719,14,19,1999,9,"female",202,52,30,4,0,0,0,4,0
1653726,26,18,1987,5,"female",448,255,174,3,35,3,29,0,6
1653772,39,27,1974,4,"male",772,2,0,0,0,0,0,0,0
1653774,22,17,1991,8,"female",489,79,44,1,0,1,0,0,0
1653808,23,5,1990,7,"female",411,391,325,5,9,5,8,0,1
1653818,22,14,1991,9,"female",412,279,178,174,29,174,18,0,11
1653848,29,15,1984,5,"female",281,27,23,155,112,20,17,135,95
1653869,52,3,1961,9,"male",581,781,368,1204,1416,143,241,1061,1175
1653890,22,15,1991,2,"male",437,212,114,196,369,196,365,0,4
1653894,31,12,1982,10,"female",283,88,49,25,16,25,7,0,9
1653901,51,29,1962,1,"male",406,51,35,2,12,0,6,2,6
1653912,96,17,1917,6,"male",936,105,23,32,50,1,34,31,16
1653929,44,21,1969,12,"female",412,16,4,12,2,12,2,0,0
1653953,39,3,1974,2,"male",198,9,4,0,0,0,0,0,0
1653958,32,9,1981,2,"male",35,2,2,7,0,7,0,0,0
1654032,21,14,1992,6,"male",20,7,7,12,0,12,0,0,0
1654039,17,1,1996,1,"male",26,13,7,4,3,4,3,0,0
1654041,24,5,1989,5,"female",291,191,137,191,56,74,18,117,38
1654050,25,22,1988,4,"female",483,317,176,99,110,99,94,0,16
1654051,36,27,1977,7,"male",557,155,97,58,4,58,4,0,0
1654069,93,2,1920,3,"male",390,198,49,40,26,18,10,22,16
1654071,67,8,1946,9,"female",907,107,80,157,15,0,4,157,11
1654074,69,24,1944,7,"male",993,33,19,0,5,0,1,0,4
1654130,25,1,1988,1,"female",232,289,266,220,304,220,294,0,10
1654132,48,25,1965,6,"female",2128,139,48,279,134,279,118,0,16
1654137,49,25,1964,10,"female",45,46,25,324,49,317,33,7,16
1654139,33,1,1980,1,"male",397,59,39,10,16,10,12,0,4
1654142,55,2,1958,8,"female",897,99,84,40,90,37,67,3,23
1654154,25,1,1988,1,"male",141,59,57,3,1,3,0,0,1
1654162,33,10,1980,7,"male",22,352,304,2051,3510,924,3055,1127,455
1654182,43,1,1970,4,"male",329,3,1,16,6,0,2,16,4
1654185,30,27,1983,6,"male",392,131,100,16,13,0,2,16,11
1654266,15,7,1998,4,"female",10,2080,422,1617,2217,705,1746,912,471
1654321,20,1,1993,2,"male",570,21,15,2,13,0,2,2,11
1654331,19,8,1994,4,"male",46,108,86,26,8,26,0,0,8
1654344,62,12,1951,5,"male",1366,357,140,16,164,14,87,2,77
1654392,37,22,1976,12,"male",904,83,35,0,1,0,1,0,0
1654413,16,9,1997,12,"female",150,1724,172,2542,4763,1895,2657,647,2106
1654462,50,13,1963,10,"male",202,177,155,140,80,139,53,1,27
1654475,23,3,1990,10,"male",184,56,24,149,90,24,25,125,65
1654495,53,12,1960,7,"female",307,29,22,24,4,24,4,0,0
1654499,38,27,1975,7,"male",707,102,8,0,0,0,0,0,0
1654501,27,30,1986,1,"female",32,1,0,532,55,500,42,32,13
1654512,45,21,1968,9,"male",801,104,46,0,37,0,34,0,3
1654549,27,22,1986,2,"female",20,28,19,3,7,1,3,2,4
1654552,16,10,1997,4,"male",578,119,68,1,0,1,0,0,0
1654557,20,9,1993,8,"male",9,15,10,2,8,2,2,0,6
1654559,21,16,1992,5,"female",397,1,1,0,0,0,0,0,0
1654565,19,22,1994,2,"female",520,1006,478,2339,2199,2339,1703,0,496
1654590,14,4,1999,6,"female",195,220,80,23,9,4,5,19,4
1654591,74,7,1939,3,"male",2040,380,250,3,13,0,4,3,9
1654608,31,1,1982,7,"male",95,310,225,306,722,219,401,87,321
1654653,18,11,1995,2,"male",299,201,175,344,9,113,5,231,4
1654656,18,1,1995,9,"female",644,1779,607,197,226,197,189,0,37
1654659,16,22,1997,7,"male",473,369,239,44,30,44,20,0,10
1654666,44,13,1969,2,"female",825,212,124,3,9,0,5,3,4
1654671,18,17,1995,1,"female",307,380,168,220,159,67,34,153,125
1654703,15,20,1998,10,"female",568,265,187,903,712,501,258,402,454
1654706,33,26,1980,10,"female",258,38,18,638,119,572,100,66,19
1654714,26,4,1987,7,"male",368,221,167,29,20,29,17,0,3
1654731,63,25,1950,4,"female",563,59,33,29,81,0,10,29,71
1654754,104,25,1909,10,"male",1621,15,10,255,9,139,5,116,4
1654755,42,8,1971,2,"male",1661,99,60,0,0,0,0,0,0
1654764,18,3,1995,4,"male",396,131,60,8,3,5,3,3,0
1654771,49,22,1964,11,"female",171,10,9,2,25,0,1,2,24
1654785,75,4,1938,9,"female",1445,138,88,76,44,56,24,20,20
1654786,38,7,1975,7,"female",494,67,45,36,53,34,28,2,25
1654802,20,1,1993,1,"male",98,110,91,2,7,2,3,0,4
1654810,45,9,1968,9,"male",276,18,6,19,0,19,0,0,0
1654821,23,3,1990,11,"female",831,146,60,0,0,0,0,0,0
1654831,43,19,1970,1,"male",537,56,31,1,0,1,0,0,0
1654832,53,30,1960,9,"female",1272,76,43,545,136,25,39,520,97
1654842,69,11,1944,10,"female",439,9,5,10,12,0,9,10,3
1654852,30,17,1983,6,"male",74,40,39,0,0,0,0,0,0
1654855,34,9,1979,5,"male",414,50,13,1,0,1,0,0,0
1654880,27,18,1986,1,"female",622,22,17,37,116,37,65,0,51
1654883,35,1,1978,7,"male",210,2,2,0,0,0,0,0,0
1654921,30,1,1983,12,"female",720,62,27,0,0,0,0,0,0
1654984,40,23,1973,1,"male",561,4,4,1,0,1,0,0,0
1655010,25,30,1988,10,"male",568,486,272,3,0,0,0,3,0
1655046,31,6,1982,3,"male",861,167,103,66,32,66,17,0,15
1655067,31,29,1982,3,"female",283,261,63,1393,418,1307,305,86,113
1655073,17,16,1996,12,"male",212,151,135,5,2,0,2,5,0
1655126,63,7,1950,6,"male",966,24,13,7,0,6,0,1,0
1655146,16,11,1997,11,"female",494,6,3,73,0,58,0,15,0
1655154,31,1,1982,10,"female",390,21,14,3,0,0,0,3,0
1655155,32,8,1981,11,"male",369,397,346,53,35,53,35,0,0
1655157,21,20,1992,3,"female",216,98,69,294,334,0,112,294,222
1655175,29,5,1984,7,"male",300,1,1,5,0,0,0,5,0
1655191,52,7,1961,6,"male",911,23,5,0,0,0,0,0,0
1655219,44,25,1969,5,"male",236,13,12,1,0,1,0,0,0
1655229,23,15,1990,12,"male",638,56,24,3,10,2,2,1,8
1655230,23,9,1990,3,"male",695,322,227,71,93,71,74,0,19
1655260,24,17,1989,5,"male",268,7,7,0,0,0,0,0,0
1655278,46,20,1967,2,"female",61,104,86,2650,493,0,44,2650,449
1655279,20,14,1993,12,"male",468,202,158,0,19,0,15,0,4
1655339,17,6,1996,6,"male",335,230,98,0,0,0,0,0,0
1655347,30,15,1983,1,"male",825,24,8,12,0,12,0,0,0
1655352,24,5,1989,8,"female",284,201,97,154,108,57,69,97,39
1655403,15,3,1998,5,"male",166,28,21,0,0,0,0,0,0
1655406,16,16,1997,1,"female",332,0,0,0,0,0,0,0,0
1655439,18,1,1995,12,"male",46,16,13,5,0,5,0,0,0
1655444,33,27,1980,12,"female",1500,363,92,256,283,256,227,0,56
1655467,26,8,1987,3,"male",495,65,46,0,0,0,0,0,0
1655486,34,22,1979,11,"male",31,0,0,0,0,0,0,0,0
1655490,57,28,1956,5,"female",2226,2521,909,467,209,348,109,119,100
1655492,56,22,1957,12,"female",292,49,36,582,151,582,100,0,51
1655513,19,25,1994,11,"female",538,177,130,8,3,8,2,0,1
1655554,33,3,1980,5,"male",1680,28,6,5,5,0,0,5,5
1655579,70,8,1943,5,"male",2399,277,129,53,75,53,46,0,29
1655584,19,19,1994,6,"female",820,54,12,0,0,0,0,0,0
1655596,108,9,1905,11,"male",446,351,161,93,114,0,52,93,62
1655613,86,4,1927,4,"male",1223,23,15,0,0,0,0,0,0
1655623,33,5,1980,8,"male",95,16,16,0,0,0,0,0,0
1655654,64,7,1949,1,"male",1392,24,4,10,7,10,4,0,3
1655657,33,12,1980,1,"female",242,277,197,464,693,464,533,0,160
1655669,38,28,1975,5,"male",684,105,77,0,1,0,0,0,1
1655692,32,28,1981,11,"female",45,26,5,28,22,28,21,0,1
1655694,58,7,1955,1,"female",441,26,2,9,4,9,3,0,1
1655748,61,25,1952,10,"female",370,55,49,0,0,0,0,0,0
1655774,27,30,1986,3,"female",390,79,34,9,0,9,0,0,0
1655776,69,12,1944,6,"male",1198,8,4,19,52,0,24,19,28
1655780,18,25,1995,3,"male",288,275,241,95,48,0,2,95,46
1655784,19,3,1994,9,"female",99,64,58,3002,466,2957,194,45,272
1655785,53,19,1960,2,"female",75,2,2,0,0,0,0,0,0
1655811,62,1,1951,4,"male",29,5,5,0,0,0,0,0,0
1655865,22,21,1991,1,"female",698,239,157,23,8,23,4,0,4
1655874,33,10,1980,7,"male",847,30,10,3,0,0,0,3,0
1655919,108,16,1905,7,"male",1470,1275,827,552,170,437,78,115,92
1655947,23,10,1990,10,"male",1068,235,136,0,1,0,0,0,1
1655949,28,20,1985,4,"female",19,195,134,18,470,18,256,0,214
1655952,63,13,1950,4,"male",234,36,21,57,6,0,0,57,6
1655962,45,5,1968,9,"female",411,20,13,5,6,5,4,0,2
1655968,61,14,1952,11,"male",1390,41,18,3,1,0,1,3,0
1655988,31,2,1982,10,"female",422,26,13,22,7,22,7,0,0
1655995,49,15,1964,3,"male",190,85,39,1,5,0,0,1,5
1655997,61,27,1952,3,"female",633,13,10,6,0,0,0,6,0
1656005,27,28,1986,3,"female",526,48,29,5,27,5,25,0,2
1656008,14,28,1999,5,"male",35,6,6,15,1,15,0,0,1
1656026,52,4,1961,8,"male",551,52,39,8,1,8,1,0,0
1656083,31,26,1982,6,"male",397,5,4,0,0,0,0,0,0
1656099,32,18,1981,10,"male",461,321,205,678,60,362,29,316,31
1656152,30,15,1983,8,"male",225,40,30,10,2,10,2,0,0
1656199,42,16,1971,6,"female",423,60,12,5,8,5,8,0,0
1656228,17,28,1996,12,"male",51,1,1,4,0,4,0,0,0
1656232,21,5,1992,2,"male",117,216,167,6,11,6,1,0,10
1656239,15,14,1998,6,"female",113,63,60,24,9,20,5,4,4
1656255,20,7,1993,9,"male",38,1,0,0,0,0,0,0,0
1656270,45,25,1968,1,"male",263,12,8,0,0,0,0,0,0
1656273,22,20,1991,8,"male",146,232,195,91,8,0,2,91,6
1656291,24,9,1989,11,"female",41,810,56,0,11,0,10,0,1
1656305,22,5,1991,7,"male",982,189,142,0,0,0,0,0,0
1656312,20,12,1993,10,"female",448,415,210,313,113,313,108,0,5
1656409,21,12,1992,12,"male",622,212,103,1668,1001,1424,387,244,614
1656431,29,25,1984,11,"female",510,335,275,73,58,73,27,0,31
1656435,61,31,1952,12,"male",1026,44,22,1,4,0,1,1,3
1656477,18,29,1995,10,"female",198,136,97,2,2,0,0,2,2
1656488,43,5,1970,6,"male",483,51,11,0,11,0,2,0,9
1656534,33,5,1980,10,"female",530,218,135,49,18,0,1,49,17
1656542,66,6,1947,2,"female",1544,83,36,23,80,23,71,0,9
1656548,23,5,1990,12,"male",373,105,39,24,1,24,0,0,1
1656559,21,17,1992,3,"female",77,378,349,468,668,123,261,345,407
1656638,23,21,1990,1,"female",36,48,45,5,116,5,48,0,68
1656650,22,6,1991,4,"male",76,0,0,0,0,0,0,0,0
1656685,33,30,1980,1,"male",1360,99,46,6,131,6,105,0,26
1656687,31,9,1982,10,"female",442,30,23,2,12,0,9,2,3
1656710,102,29,1911,4,"female",1712,291,169,78,31,4,15,74,16
1656714,16,18,1997,10,"female",89,514,452,1022,1897,798,1342,224,555
1656726,77,13,1936,10,"female",1323,947,550,0,14,0,7,0,7
1656738,103,1,1910,7,"female",1570,240,133,127,87,0,33,127,54
1656837,15,2,1998,4,"male",622,100,66,33,13,20,9,13,4
1656838,62,9,1951,3,"male",194,22,19,2,1,1,1,1,0
1656844,58,18,1955,9,"female",1700,192,57,83,224,31,83,52,141
1656860,50,15,1963,10,"male",646,97,61,10,27,0,11,10,16
1656875,15,2,1998,7,"male",98,67,40,0,9,0,5,0,4
1656883,39,8,1974,7,"male",498,17,14,0,1,0,0,0,1
1656920,23,30,1990,12,"male",731,1031,936,0,7,0,1,0,6
1656964,49,2,1964,9,"male",704,99,57,8,3,8,3,0,0
1656968,44,18,1969,11,"male",181,12,11,25,20,25,15,0,5
1656969,27,8,1986,6,"male",36,8,6,1,0,1,0,0,0
1656971,28,25,1985,2,"male",418,41,24,0,3,0,3,0,0
1656976,50,27,1963,11,"female",1600,362,240,193,505,78,199,115,306
1656997,17,18,1996,2,"male",805,804,575,231,249,160,140,71,109
1657039,42,9,1971,5,"male",43,35,30,0,0,0,0,0,0
1657101,25,7,1988,8,"female",504,264,204,35,10,35,9,0,1
1657110,49,20,1964,12,"male",1090,14,2,1,0,1,0,0,0
1657123,59,4,1954,4,"female",2114,145,71,1684,940,212,731,1472,209
1657134,30,15,1983,4,"male",540,27,17,1,0,1,0,0,0
1657141,17,4,1996,5,"male",354,502,357,296,98,295,36,1,62
1657143,30,5,1983,10,"female",572,176,76,76,65,76,38,0,27
1657154,19,7,1994,11,"male",893,1200,894,73,29,0,10,73,19
1657184,17,26,1996,8,"male",255,1,0,2,0,2,0,0,0
1657232,18,10,1995,3,"male",353,285,238,193,11,23,7,170,4
1657235,15,26,1998,9,"male",252,203,91,16,26,15,24,1,2
1657236,15,18,1998,3,"male",176,195,100,21,0,21,0,0,0
1657246,36,11,1977,1,"male",1438,0,0,2,1,0,0,2,1
1657258,21,7,1992,2,"male",672,441,260,6,4,6,2,0,2
1657283,113,19,1900,11,"female",1186,23,3,0,0,0,0,0,0
1657287,20,25,1993,3,"female",300,54,24,0,24,0,12,0,12
1657301,19,5,1994,3,"male",83,8,7,23,0,21,0,2,0
1657321,113,25,1900,2,"male",1819,159,90,8,21,0,15,8,6
1657336,72,7,1941,7,"male",1427,60,37,45,58,44,32,1,26
1657340,65,20,1948,5,"male",336,7,5,56,0,0,0,56,0
1657351,54,10,1959,6,"female",197,29,4,81,24,0,2,81,22
1657373,15,6,1998,7,"male",4,0,0,0,0,0,0,0,0
1657374,23,8,1990,2,"male",629,537,499,15,29,14,24,1,5
1657401,19,23,1994,1,"female",379,667,453,755,667,707,609,48,58
1657422,27,26,1986,5,"male",1389,125,106,81,161,51,122,30,39
1657423,21,1,1992,1,"male",90,157,130,448,198,448,193,0,5
1657446,15,5,1998,9,"female",417,4191,382,1253,3937,413,2032,840,1905
1657455,74,8,1939,10,"female",92,19,14,5,5,0,2,5,3
1657500,27,8,1986,5,"male",396,33,21,0,1,0,0,0,1
1657508,20,4,1993,5,"female",1693,1775,570,579,659,530,310,49,349
1657516,23,27,1990,10,"male",1406,988,532,55,423,55,340,0,83
1657519,73,7,1940,9,"male",386,0,0,0,0,0,0,0,0
1657520,25,5,1988,1,"male",10,0,0,0,0,0,0,0,0
1657522,102,1,1911,1,"male",220,16,10,129,6,129,5,0,1
1657530,20,8,1993,7,"female",565,254,145,1,8,1,5,0,3
1657561,51,1,1962,1,"female",306,34,30,7,1,4,1,3,0
1657578,24,14,1989,11,"male",287,111,66,187,248,187,153,0,95
1657600,68,18,1945,2,"male",1751,265,96,1,1,0,0,1,1
1657602,18,29,1995,1,"female",283,23,18,7,8,7,4,0,4
1657617,20,10,1993,4,"female",350,138,72,7,32,7,16,0,16
1657618,22,14,1991,10,"male",445,43,33,1,0,0,0,1,0
1657662,23,17,1990,8,"male",557,113,65,2,0,2,0,0,0
1657669,26,16,1987,12,"male",292,10,8,0,0,0,0,0,0
1657699,18,14,1995,2,"male",6,8,8,2,1,2,1,0,0
1657710,23,5,1990,5,"male",541,68,61,10,1,0,0,10,1
1657725,19,3,1994,5,"male",361,14,9,66,1,25,1,41,0
1657732,64,20,1949,11,"male",218,48,32,1,4,0,3,1,1
1657749,19,15,1994,2,"female",264,85,72,5,0,5,0,0,0
1657771,22,15,1991,4,"female",509,185,87,18,40,15,30,3,10
1657775,108,13,1905,4,"male",1460,1264,1114,1218,482,1214,390,4,92
1657788,26,17,1987,7,"male",1069,61,14,0,1,0,1,0,0
1657796,24,11,1989,4,"male",1606,515,331,0,1,0,0,0,1
1657823,85,29,1928,6,"male",198,19,19,2,0,0,0,2,0
1657841,108,4,1905,4,"male",1055,768,693,5,3,5,3,0,0
1657857,20,15,1993,6,"male",584,135,82,0,0,0,0,0,0
1657872,45,5,1968,10,"female",537,101,72,122,87,114,77,8,10
1657907,59,5,1954,4,"female",424,55,35,15,11,2,8,13,3
1657929,17,4,1996,7,"male",382,15,9,0,0,0,0,0,0
1657935,31,16,1982,10,"male",616,214,176,269,26,268,19,1,7
1657948,19,28,1994,8,"female",665,1330,802,95,363,95,190,0,173
1657970,23,4,1990,10,"female",1654,326,184,1378,979,848,593,530,386
1657976,40,6,1973,10,"female",125,36,12,662,380,639,91,23,289
1658003,41,27,1972,2,"male",295,113,67,7,9,0,3,7,6
1658023,27,29,1986,10,"male",713,108,60,6,1,6,0,0,1
1658031,27,24,1986,7,"male",194,28,17,0,5,0,5,0,0
1658046,19,8,1994,8,"male",298,20,9,0,0,0,0,0,0
1658068,19,31,1994,3,"male",130,171,160,2,1,2,1,0,0
1658107,20,5,1993,6,"male",480,166,137,142,6,125,5,17,1
1658115,61,26,1952,5,"male",164,8,5,0,0,0,0,0,0
1658169,50,8,1963,7,"female",116,11,8,6,1,6,1,0,0
1658191,29,21,1984,5,"male",441,2,2,55,5,0,0,55,5
1658197,35,25,1978,7,"male",261,78,36,0,0,0,0,0,0
1658231,43,18,1970,12,"female",323,6,5,0,0,0,0,0,0
1658253,28,21,1985,3,"male",139,31,24,2,0,2,0,0,0
1658255,21,12,1992,5,"male",386,153,111,7,45,7,39,0,6
1658258,33,23,1980,3,"female",981,31,17,1,1,0,1,1,0
1658287,56,19,1957,4,"female",811,53,30,3,15,3,7,0,8
1658310,18,24,1995,3,"female",557,87,40,5,10,5,6,0,4
1658360,81,11,1932,10,"male",561,162,53,36,168,31,125,5,43
1658361,15,31,1998,1,"female",458,1493,568,139,193,2,123,137,70
1658371,58,12,1955,7,"male",397,170,118,131,58,0,8,131,50
1658403,62,14,1951,7,"female",1516,83,27,461,54,461,34,0,20
1658428,23,14,1990,10,"male",444,133,76,117,56,117,36,0,20
1658437,35,3,1978,9,"female",893,180,121,37,2,34,1,3,1
1658453,37,5,1976,2,"female",705,24,15,3,1,3,1,0,0
1658489,51,29,1962,7,"male",365,4,3,0,0,0,0,0,0
1658530,20,3,1993,3,"male",425,357,169,1,2,1,2,0,0
1658544,30,13,1983,3,"male",6,0,0,0,0,0,0,0,0
1658549,50,29,1963,12,"female",757,41,31,244,167,244,48,0,119
1658562,18,6,1995,3,"male",730,329,301,1,0,1,0,0,0
1658578,16,15,1997,4,"male",563,210,195,0,2,0,2,0,0
1658586,22,24,1991,4,"male",855,537,345,725,1012,270,777,455,235
1658589,54,27,1959,9,"female",1814,276,159,150,135,83,58,67,77
1658597,28,12,1985,11,"female",316,73,47,216,187,184,41,32,146
1658598,22,15,1991,12,"male",922,1,1,0,0,0,0,0,0
1658605,30,30,1983,4,"female",42,62,41,9,30,9,19,0,11
1658607,22,8,1991,3,"female",1069,1430,696,2133,17495,1883,8651,250,8844
1658628,19,5,1994,11,"female",557,64,28,0,1,0,0,0,1
1658634,35,16,1978,11,"male",96,182,166,1,6,1,3,0,3
1658659,35,1,1978,3,"male",806,8,2,0,0,0,0,0,0
1658662,108,17,1905,10,"female",423,2287,152,108,1530,108,1108,0,422
1658687,27,30,1986,10,"male",506,112,24,78,118,78,100,0,18
1658698,51,18,1962,2,"male",209,11,11,0,0,0,0,0,0
1658702,59,3,1954,6,"male",447,30,23,1,12,0,12,1,0
1658729,103,1,1910,12,"female",436,2483,621,543,1921,543,1638,0,283
1658774,26,27,1987,9,"male",453,52,47,6,0,6,0,0,0
1658798,37,31,1976,7,"female",424,109,84,83,23,82,9,1,14
1658801,68,21,1945,7,"male",97,12,8,0,0,0,0,0,0
1658829,22,29,1991,4,"female",37,56,8,75,98,59,66,16,32
1658844,38,22,1975,5,"male",1245,23,9,1,4,1,4,0,0
1658853,21,21,1992,11,"male",218,919,260,184,387,112,172,72,215
1658873,21,28,1992,2,"male",377,77,45,55,47,45,22,10,25
1658897,39,29,1974,10,"male",483,12,4,3,2,3,2,0,0
1658898,17,30,1996,10,"male",262,42,28,0,2,0,2,0,0
1658913,19,15,1994,8,"male",253,41,18,0,5,0,4,0,1
1658952,44,8,1969,3,"male",213,64,60,23,3,23,2,0,1
1659001,52,30,1961,12,"male",560,71,58,76,53,54,36,22,17
1659016,24,23,1989,9,"male",554,25,11,0,4,0,2,0,2
1659024,28,20,1985,8,"male",322,334,239,1193,773,1172,620,21,153
1659107,18,19,1995,10,"female",655,1384,295,6334,1293,6294,758,40,535
1659132,28,20,1985,2,"female",306,82,47,29,62,29,38,0,24
1659134,58,2,1955,7,"female",577,113,75,1653,80,0,13,1653,67
1659155,27,11,1986,6,"female",477,0,0,0,0,0,0,0,0
1659197,41,15,1972,6,"female",319,2,2,1,2,0,0,1,2
1659211,23,19,1990,9,"male",822,218,88,0,0,0,0,0,0
1659247,17,6,1996,6,"female",381,4,0,0,0,0,0,0,0
1659280,24,25,1989,10,"female",472,91,47,0,0,0,0,0,0
1659344,13,19,2000,7,"male",61,20,17,4,1,0,1,4,0
1659371,41,30,1972,3,"female",420,179,71,190,345,62,161,128,184
1659382,23,27,1990,7,"female",125,73,64,19,6,0,2,19,4
1659396,43,12,1970,10,"male",673,5,5,0,0,0,0,0,0
1659397,18,27,1995,3,"male",329,853,736,76,80,6,48,70,32
1659422,51,22,1962,11,"female",723,64,30,150,25,80,19,70,6
1659435,26,3,1987,9,"male",792,43,21,24,4,12,0,12,4
1659440,38,11,1975,8,"male",300,106,70,0,40,0,14,0,26
1659446,29,28,1984,8,"male",158,40,27,3,4,3,2,0,2
1659507,23,1,1990,11,"male",34,164,158,1,0,1,0,0,0
1659509,18,28,1995,10,"female",247,139,114,218,164,218,114,0,50
1659557,47,11,1966,7,"female",184,82,69,461,139,461,63,0,76
1659599,21,30,1992,6,"female",57,192,152,140,393,140,373,0,20
1659611,20,16,1993,3,"male",232,418,225,140,380,140,348,0,32
1659618,16,12,1997,8,"female",233,7,5,2,31,2,31,0,0
1659636,14,29,1999,5,"male",133,274,46,937,1072,819,630,118,442
1659642,14,26,1999,10,"male",303,304,206,22,2,0,1,22,1
1659654,30,13,1983,8,"male",134,46,24,0,0,0,0,0,0
1659672,23,7,1990,11,"male",672,31,14,7,5,6,2,1,3
1659678,31,18,1982,4,"female",530,126,45,0,28,0,20,0,8
1659682,54,14,1959,7,"female",696,660,342,518,1099,0,226,518,873
1659736,23,3,1990,7,"male",262,93,50,75,5,75,4,0,1
1659738,26,18,1987,3,"male",480,83,77,35,1,0,0,35,1
1659747,28,17,1985,2,"female",372,31,14,23,12,23,11,0,1
1659785,23,29,1990,3,"female",153,76,54,56,44,53,25,3,19
1659814,46,1,1967,7,"female",114,120,63,100,83,100,60,0,23
1659815,19,1,1994,1,"male",426,74,53,24,5,24,5,0,0
1659824,39,21,1974,1,"female",1409,10,4,0,0,0,0,0,0
1659825,14,6,1999,4,"female",583,200,111,0,1,0,0,0,1
1659864,30,15,1983,7,"male",657,739,465,22,30,7,20,15,10
1659893,16,3,1997,6,"female",437,73,46,42,17,1,2,41,15
1659920,73,14,1940,3,"female",773,7,5,0,0,0,0,0,0
1659945,108,1,1905,1,"female",1956,126,53,9,2,9,2,0,0
1659994,24,8,1989,1,"male",277,267,109,0,1,0,1,0,0
1660005,51,26,1962,9,"female",1370,306,119,96,27,0,7,96,20
1660033,41,1,1972,1,"male",188,33,20,0,0,0,0,0,0
1660045,25,16,1988,12,"male",529,124,72,27,1,27,1,0,0
1660047,42,3,1971,11,"male",600,218,143,1,7,1,6,0,1
1660081,33,11,1980,6,"female",188,43,36,199,39,198,24,1,15
1660092,50,24,1963,3,"female",239,16,9,14,15,0,8,14,7
1660095,17,7,1996,8,"female",494,178,99,65,116,56,63,9,53
1660137,49,28,1964,11,"female",404,591,469,665,265,45,128,620,137
1660162,51,3,1962,4,"female",890,104,55,174,52,0,42,174,10
1660165,51,24,1962,6,"male",319,165,56,34,14,0,7,34,7
1660207,25,27,1988,5,"male",285,22,14,0,0,0,0,0,0
1660223,50,27,1963,1,"female",1893,225,124,247,49,245,35,2,14
1660227,15,19,1998,4,"male",119,50,39,14,37,7,11,7,26
1660241,93,13,1920,10,"male",508,280,258,1,4,0,0,1,4
1660245,22,5,1991,5,"female",111,53,32,6,9,6,4,0,5
1660252,25,22,1988,8,"female",301,29,28,17,0,0,0,17,0
1660270,29,5,1984,2,"female",255,245,190,0,10,0,6,0,4
1660276,51,19,1962,9,"male",490,40,37,1,0,1,0,0,0
1660293,22,5,1991,6,"male",424,160,35,39,171,38,109,1,62
1660304,71,25,1942,3,"male",1715,21,5,1,0,0,0,1,0
1660326,61,21,1952,3,"female",280,56,36,62,1,35,1,27,0
1660389,28,13,1985,3,"female",378,70,49,1,35,1,22,0,13
1660401,30,12,1983,11,"male",521,113,86,4,20,4,12,0,8
1660403,55,27,1958,6,"female",113,98,81,6,50,6,37,0,13
1660416,56,17,1957,10,"male",537,22,10,5,6,5,6,0,0
1660418,52,24,1961,4,"male",402,26,19,0,0,0,0,0,0
1660419,23,1,1990,11,"male",672,42,24,1,3,0,1,1,2
1660436,16,19,1997,10,"male",29,109,100,2,2,2,2,0,0
1660450,48,13,1965,11,"male",429,34,30,0,0,0,0,0,0
1660462,25,2,1988,6,"female",589,371,215,618,1294,21,532,597,762
1660467,20,1,1993,1,"male",312,240,102,1,15,1,12,0,3
1660470,61,26,1952,7,"female",295,4,2,0,4,0,4,0,0
1660493,40,6,1973,6,"male",329,52,39,6,16,6,15,0,1
1660513,27,6,1986,3,"male",607,50,38,11,6,3,6,8,0
1660530,21,20,1992,9,"male",984,311,216,257,4,249,0,8,4
1660581,26,3,1987,9,"female",614,97,33,32,0,32,0,0,0
1660584,18,3,1995,1,"female",588,1800,833,282,1264,18,725,264,539
1660603,18,20,1995,4,"male",148,411,393,0,0,0,0,0,0
1660637,32,22,1981,5,"female",231,80,52,115,30,115,30,0,0
1660657,21,2,1992,2,"female",112,20,13,9,4,8,2,1,2
1660680,21,23,1992,2,"female",591,434,311,272,113,65,41,207,72
1660728,19,24,1994,2,"male",548,292,171,4,0,0,0,4,0
1660743,64,7,1949,3,"male",841,197,137,147,7,131,6,16,1
1660764,27,21,1986,9,"male",900,455,305,0,3,0,3,0,0
1660785,29,21,1984,11,"female",616,1527,557,532,421,261,167,271,254
1660811,14,17,1999,5,"male",153,1,1,4,0,0,0,4,0
1660835,77,17,1936,10,"female",1595,127,69,209,208,0,58,209,150
1660865,37,15,1976,5,"male",221,153,57,134,257,35,87,99,170
1660879,22,28,1991,3,"male",545,275,182,1352,726,1352,141,0,585
1660892,22,26,1991,6,"male",554,49,34,0,15,0,11,0,4
1660953,41,16,1972,9,"male",28,50,32,28,20,28,19,0,1
1660981,26,26,1987,10,"female",743,152,120,0,0,0,0,0,0
1661034,55,26,1958,1,"male",223,12,4,699,0,699,0,0,0
1661046,108,18,1905,10,"male",1282,499,393,264,25,238,17,26,8
1661064,15,18,1998,10,"female",817,475,346,1312,290,1250,177,62,113
1661070,18,14,1995,7,"female",153,164,89,6,9,6,4,0,5
1661085,67,10,1946,9,"male",1339,26,8,0,0,0,0,0,0
1661090,53,15,1960,5,"male",689,94,31,42,16,34,9,8,7
1661111,53,31,1960,12,"male",25,1,0,32,1,23,0,9,1
1661116,33,14,1980,9,"male",554,140,99,0,0,0,0,0,0
1661187,40,4,1973,3,"female",447,82,52,31,2,31,2,0,0
1661193,23,26,1990,6,"female",251,291,66,38,2,38,2,0,0
1661201,70,1,1943,1,"male",2034,253,215,31,4,0,2,31,2
1661206,19,8,1994,3,"male",448,419,335,14,6,0,2,14,4
1661218,18,1,1995,9,"male",53,32,25,0,1,0,0,0,1
1661235,16,10,1997,4,"male",673,796,581,296,496,296,287,0,209
1661260,16,11,1997,2,"male",34,10,9,2,0,0,0,2,0
1661265,37,5,1976,9,"female",406,36,23,0,0,0,0,0,0
1661283,108,2,1905,11,"male",1031,428,308,35,7,35,7,0,0
1661302,33,19,1980,6,"male",104,345,207,94,395,94,343,0,52
1661308,41,16,1972,5,"male",638,265,182,22,16,19,15,3,1
1661312,36,3,1977,1,"female",49,7,6,29,12,16,9,13,3
1661353,21,5,1992,5,"female",312,171,118,38,1,38,0,0,1
1661369,24,12,1989,5,"female",358,52,29,115,52,115,36,0,16
1661381,16,20,1997,11,"female",521,1162,629,241,86,103,45,138,41
1661404,17,13,1996,12,"male",266,127,77,134,108,123,55,11,53
1661425,21,10,1992,12,"female",1046,576,338,1278,1706,1268,1311,10,395
1661433,29,10,1984,10,"male",463,89,87,2,2,2,1,0,1
1661434,25,31,1988,12,"male",179,47,30,135,1,135,1,0,0
1661445,17,21,1996,1,"female",380,1321,562,67,322,3,200,64,122
1661466,19,28,1994,9,"male",643,231,213,2,2,0,0,2,2
1661475,54,6,1959,5,"female",307,49,46,255,45,255,44,0,1
1661498,94,16,1919,6,"female",85,95,7,10,45,10,40,0,5
1661526,57,12,1956,2,"female",1274,162,69,33,14,27,5,6,9
1661529,23,31,1990,7,"male",159,26,18,0,1,0,0,0,1
1661563,103,23,1910,5,"female",2180,522,189,6,13,0,11,6,2
1661579,18,12,1995,6,"male",182,157,70,4261,1096,2434,993,1827,103
1661580,29,1,1984,4,"male",528,63,34,6,7,6,6,0,1
1661590,68,17,1945,8,"male",977,41,17,3,1,3,1,0,0
1661609,19,5,1994,6,"female",139,31,18,59,70,59,52,0,18
1661627,64,13,1949,2,"male",36,26,16,12,9,0,5,12,4
1661632,40,15,1973,7,"male",423,1,0,0,0,0,0,0,0
1661635,19,15,1994,3,"female",183,370,221,496,471,145,183,351,288
1661669,30,4,1983,2,"male",515,157,96,1,4,1,3,0,1
1661688,19,4,1994,8,"male",100,10,7,56,54,40,17,16,37
1661691,21,1,1992,1,"male",121,4,4,0,0,0,0,0,0
1661738,34,22,1979,9,"male",445,7,5,0,0,0,0,0,0
1661748,45,10,1968,7,"female",547,76,45,100,50,99,29,1,21
1661755,68,21,1945,4,"female",610,1387,251,803,1353,316,948,487,405
1661759,13,31,2000,1,"female",0,0,0,2,1,2,1,0,0
1661769,31,18,1982,8,"male",284,146,45,40,39,40,12,0,27
1661778,15,19,1998,2,"male",713,19,18,8,1,0,0,8,1
1661787,63,12,1950,7,"male",1873,109,25,11,11,0,6,11,5
1661790,17,11,1996,10,"female",162,313,227,150,154,91,85,59,69
1661810,21,15,1992,4,"female",202,0,0,0,0,0,0,0,0
1661843,22,18,1991,12,"male",393,29,24,0,24,0,23,0,1
1661865,18,8,1995,3,"male",326,104,60,3,0,0,0,3,0
1661873,50,14,1963,7,"male",269,39,26,4,24,3,2,1,22
1661874,39,28,1974,5,"male",597,63,48,317,16,302,10,15,6
1661883,21,5,1992,4,"male",519,191,138,2,74,0,46,2,28
1661891,54,24,1959,4,"male",646,121,65,0,0,0,0,0,0
1661914,21,2,1992,2,"male",1175,30,26,3,3,0,1,3,2
1661948,113,1,1900,1,"female",2302,688,538,61,138,1,24,60,114
1661951,28,14,1985,12,"male",167,18,8,0,0,0,0,0,0
1661967,42,28,1971,8,"male",330,43,12,0,0,0,0,0,0
1661997,32,8,1981,5,"male",437,110,40,27,19,27,19,0,0
1662004,54,29,1959,7,"female",1705,232,108,206,76,141,37,65,39
1662032,31,8,1982,8,"female",163,40,26,1,0,1,0,0,0
1662054,50,6,1963,7,"female",593,30,9,11,6,11,4,0,2
1662082,14,18,1999,3,"female",175,272,158,414,396,414,359,0,37
1662114,44,1,1969,12,"male",1351,41,27,15,1,15,1,0,0
1662141,15,8,1998,1,"male",34,1,1,0,0,0,0,0,0
1662142,15,30,1998,12,"female",823,684,349,63,229,0,93,63,136
1662153,35,28,1978,5,"female",360,129,71,140,102,90,62,50,40
1662159,24,19,1989,10,"male",6,8,8,1,0,1,0,0,0
1662188,108,9,1905,4,"male",1421,298,72,6,8,6,5,0,3
1662232,15,1,1998,4,"male",261,239,172,50,36,50,36,0,0
1662236,17,17,1996,11,"male",328,63,46,0,0,0,0,0,0
1662237,42,19,1971,1,"male",830,65,40,17,7,17,2,0,5
1662240,22,2,1991,8,"male",603,12,9,0,0,0,0,0,0
1662252,22,23,1991,6,"female",740,468,168,39,100,38,86,1,14
1662255,20,28,1993,6,"male",489,30,14,0,0,0,0,0,0
1662266,58,5,1955,4,"male",649,56,31,8,16,8,15,0,1
1662301,26,16,1987,12,"male",284,17,10,2,0,0,0,2,0
1662313,21,22,1992,12,"male",222,12,7,1,0,1,0,0,0
1662338,26,9,1987,10,"male",257,76,67,1,0,1,0,0,0
1662378,51,14,1962,2,"male",2163,103,20,1,0,0,0,1,0
1662387,48,4,1965,9,"male",887,47,23,41,118,13,96,28,22
1662412,18,30,1995,1,"female",633,724,522,261,437,173,134,88,303
1662439,96,2,1917,2,"male",1680,914,445,16,12,15,8,1,4
1662444,17,5,1996,5,"female",254,3735,486,852,929,163,412,689,517
1662446,17,28,1996,1,"male",486,40,19,21,1,0,0,21,1
1662453,43,15,1970,10,"male",1029,272,178,17,11,17,10,0,1
1662503,16,9,1997,10,"male",509,137,51,8,27,8,22,0,5
1662547,27,18,1986,9,"male",30,0,0,0,0,0,0,0,0
1662572,23,19,1990,3,"female",557,210,46,0,0,0,0,0,0
1662584,58,23,1955,11,"female",224,396,298,35,39,0,4,35,35
1662645,25,10,1988,7,"female",429,99,67,17,23,0,5,17,18
1662647,29,19,1984,2,"male",793,26,14,2,3,2,1,0,2
1662721,24,6,1989,8,"female",1198,783,518,142,280,141,139,1,141
1662732,22,25,1991,12,"male",584,444,341,3926,2004,3926,1153,0,851
1662734,41,19,1972,7,"male",1312,37,11,0,0,0,0,0,0
1662750,14,12,1999,1,"male",133,136,97,7,5,7,5,0,0
1662762,63,16,1950,4,"male",515,42,30,192,112,30,7,162,105
1662772,14,12,1999,6,"male",1,1,1,19,3,0,2,19,1
1662774,18,14,1995,11,"female",520,583,439,825,247,149,56,676,191
1662829,18,11,1995,5,"male",448,223,195,12,6,12,3,0,3
1662838,24,14,1989,7,"male",507,34,13,5,6,2,0,3,6
1662849,18,29,1995,7,"female",1581,1940,897,156,1151,52,89,104,1062
1662857,22,10,1991,6,"male",55,8,8,2,0,2,0,0,0
1662867,46,21,1967,1,"male",248,284,180,383,545,383,435,0,110
1662905,105,11,1908,8,"female",1361,857,148,270,670,0,123,270,547
1662918,21,8,1992,3,"male",734,991,499,138,676,61,540,77,136
1662925,108,11,1905,10,"male",1482,577,467,12,51,9,24,3,27
1662926,35,8,1978,8,"male",402,65,52,0,0,0,0,0,0
1662951,26,15,1987,4,"male",380,242,164,96,4,96,3,0,1
1662971,16,27,1997,1,"female",267,243,123,27,1,27,0,0,1
1662979,50,29,1963,4,"male",1525,1528,786,3469,5263,1677,2045,1792,3218
1662984,43,5,1970,6,"male",284,7,2,191,24,191,24,0,0
1662989,64,16,1949,12,"female",699,297,190,270,78,218,39,52,39
1663052,21,21,1992,1,"male",27,15,2,0,0,0,0,0,0
1663073,40,11,1973,2,"male",56,21,16,9,61,9,47,0,14
1663076,60,2,1953,4,"male",636,124,89,1,0,1,0,0,0
1663097,66,13,1947,5,"female",802,77,29,2,1,0,0,2,1
1663101,32,25,1981,12,"male",961,222,141,1,3,1,3,0,0
1663103,18,6,1995,1,"female",249,61,28,4,5,4,5,0,0
1663114,22,28,1991,10,"female",833,745,480,125,29,125,15,0,14
1663115,41,7,1972,1,"male",666,107,51,0,8,0,6,0,2
1663146,30,21,1983,8,"male",559,59,4,0,0,0,0,0,0
1663173,65,21,1948,9,"female",1770,195,72,77,67,77,36,0,31
1663259,62,20,1951,2,"male",827,62,19,4,10,2,9,2,1
1663269,31,25,1982,12,"male",442,41,29,32,8,30,5,2,3
1663275,74,1,1939,9,"male",1751,225,60,31,44,0,13,31,31
1663291,16,9,1997,1,"male",210,53,43,15,4,15,4,0,0
1663292,22,29,1991,5,"female",1385,280,108,92,99,92,89,0,10
1663299,67,4,1946,5,"female",762,31,19,4,4,0,1,4,3
1663333,42,4,1971,12,"male",49,9,5,44,17,0,5,44,12
1663344,62,23,1951,2,"female",1930,108,27,244,84,0,37,244,47
1663360,18,1,1995,1,"male",88,40,34,39,8,0,3,39,5
1663365,62,25,1951,11,"female",1779,124,71,661,352,456,140,205,212
1663386,26,1,1987,1,"female",380,37,25,1,0,1,0,0,0
1663422,23,1,1990,1,"male",640,46,28,0,0,0,0,0,0
1663433,18,7,1995,10,"male",586,77,56,4,50,0,44,4,6
1663444,68,12,1945,3,"male",676,342,71,41,28,41,26,0,2
1663476,28,28,1985,4,"female",249,199,68,4,5,4,4,0,1
1663483,56,12,1957,10,"female",710,21,9,0,0,0,0,0,0
1663494,21,6,1992,8,"male",408,297,161,1,0,1,0,0,0
1663529,28,31,1985,5,"female",296,144,81,112,1,112,0,0,1
1663552,22,21,1991,4,"female",647,198,139,5,1,5,1,0,0
1663563,23,1,1990,9,"male",76,66,32,181,361,181,333,0,28
1663566,18,15,1995,3,"female",274,53,17,4,4,4,3,0,1
1663571,19,24,1994,10,"male",499,243,217,15,0,0,0,15,0
1663599,58,7,1955,10,"female",287,21,15,10,16,0,5,10,11
1663653,66,12,1947,7,"male",1777,324,230,275,102,183,44,92,58
1663666,68,10,1945,3,"male",1416,476,354,77,69,70,40,7,29
1663710,50,3,1963,3,"male",883,122,73,855,260,855,187,0,73
1663739,96,30,1917,3,"male",151,363,251,929,2,0,1,929,1
1663741,108,25,1905,1,"male",265,54,23,82,220,20,61,62,159
1663744,33,7,1980,12,"male",147,184,136,623,1370,599,1251,24,119
1663763,53,30,1960,5,"female",436,175,145,3937,1043,3937,953,0,90
1663765,27,1,1986,1,"male",360,514,449,18,0,18,0,0,0
1663802,54,1,1959,8,"male",937,91,15,1,25,0,8,1,17
1663807,14,12,1999,10,"male",293,512,447,39,32,39,28,0,4
1663837,52,10,1961,1,"male",115,6,2,5,0,3,0,2,0
1663850,22,20,1991,7,"male",1014,253,89,56,10,47,2,9,8
1663858,34,25,1979,7,"male",77,22,20,51,8,51,5,0,3
1663880,50,25,1963,8,"male",337,35,10,10,89,10,81,0,8
1663885,76,13,1937,12,"female",817,27,12,12,7,8,2,4,5
1663890,23,1,1990,1,"male",137,24,20,1,14,0,10,1,4
1663901,26,1,1987,1,"male",475,1,1,0,0,0,0,0,0
1663919,108,23,1905,9,"male",153,135,72,28,51,28,51,0,0
1663920,61,1,1952,12,"male",1183,45,25,52,72,0,13,52,59
1663926,55,25,1958,1,"male",690,211,133,20,36,0,3,20,33
1663941,17,24,1996,6,"female",563,334,288,63,32,11,7,52,25
1663946,14,31,1999,10,"male",163,44,23,14,3,14,1,0,2
1663956,28,8,1985,10,"female",347,55,26,4052,4955,3920,2950,132,2005
1663969,37,1,1976,12,"male",278,29,18,69,73,0,21,69,52
1663991,14,25,1999,6,"female",15,461,68,10,305,10,132,0,173
1664001,22,6,1991,11,"male",701,177,39,15,26,15,24,0,2
1664013,42,8,1971,2,"male",150,7,5,5,0,5,0,0,0
1664044,16,30,1997,10,"male",390,964,821,0,15,0,11,0,4
1664066,24,2,1989,2,"male",996,63,46,0,0,0,0,0,0
1664068,20,15,1993,6,"male",164,10,10,1,0,1,0,0,0
1664073,18,18,1995,9,"male",750,279,221,1,0,1,0,0,0
1664075,52,15,1961,12,"female",1273,45,34,25,4,0,3,25,1
1664096,41,25,1972,7,"female",590,179,146,20,74,15,9,5,65
1664129,27,13,1986,3,"male",131,202,151,782,658,216,115,566,543
1664154,69,4,1944,4,"male",789,73,58,34,27,0,6,34,21
1664167,23,31,1990,3,"male",417,48,42,151,56,28,19,123,37
1664186,22,8,1991,2,"male",1122,141,106,0,0,0,0,0,0
1664237,100,21,1913,3,"female",1969,369,173,2,1,2,1,0,0
1664240,23,3,1990,1,"male",657,345,286,0,29,0,21,0,8
1664243,41,6,1972,6,"male",116,167,82,2,22,0,4,2,18
1664248,21,1,1992,6,"male",281,6,3,0,0,0,0,0,0
1664281,25,27,1988,1,"male",280,454,156,7,18,7,15,0,3
1664286,16,2,1997,7,"male",132,17,9,1,0,1,0,0,0
1664294,65,3,1948,12,"female",396,1,1,0,0,0,0,0,0
1664304,15,13,1998,1,"female",668,1211,648,155,44,155,39,0,5
1664329,16,15,1997,5,"female",310,78,58,60,90,60,80,0,10
1664347,77,30,1936,10,"female",1263,49,30,85,18,0,3,85,15
1664395,28,11,1985,3,"male",672,88,73,0,0,0,0,0,0
1664406,27,24,1986,10,"male",220,137,90,7,1,7,1,0,0
1664407,52,24,1961,8,"male",5,23,22,3,5,0,4,3,1
1664417,60,17,1953,5,"male",979,93,46,0,0,0,0,0,0
1664466,40,28,1973,12,"female",390,86,34,73,36,73,21,0,15
1664474,57,23,1956,9,"male",1049,3,3,0,0,0,0,0,0
1664476,51,11,1962,6,"female",328,41,25,57,1,57,1,0,0
1664477,66,19,1947,7,"female",386,14,5,0,2,0,0,0,2
1664495,32,9,1981,11,"male",1063,56,24,0,0,0,0,0,0
1664519,25,21,1988,5,"male",265,203,52,293,308,132,100,161,208
1664530,25,4,1988,8,"male",177,16,15,0,0,0,0,0,0
1664534,36,2,1977,6,"female",1908,161,61,607,1349,249,825,358,524
1664538,29,11,1984,2,"male",27,64,57,19,41,14,12,5,29
1664540,16,17,1997,7,"female",387,335,253,252,394,159,189,93,205
1664550,61,30,1952,4,"female",413,107,66,30,0,30,0,0,0
1664552,42,11,1971,1,"male",286,81,66,1,0,1,0,0,0
1664593,45,8,1968,7,"male",1025,231,72,5,12,5,11,0,1
1664599,28,5,1985,12,"female",307,303,227,31,25,31,11,0,14
1664606,71,21,1942,10,"male",390,22,15,6,0,0,0,6,0
1664650,34,24,1979,3,"male",523,56,36,3,1,0,1,3,0
1664690,65,2,1948,12,"female",940,196,146,113,17,113,9,0,8
1664695,21,16,1992,2,"male",636,306,188,39,42,37,23,2,19
1664705,17,8,1996,5,"female",281,115,45,105,7,105,7,0,0
1664722,30,2,1983,4,"female",131,3,2,2,0,0,0,2,0
1664726,18,1,1995,2,"male",561,1323,738,6,2,0,1,6,1
1664732,20,17,1993,1,"male",381,96,90,1,0,0,0,1,0
1664742,16,8,1997,8,"male",515,745,663,7,5,1,1,6,4
1664813,52,18,1961,4,"male",1338,65,44,18,8,0,0,18,8
1664842,14,24,1999,1,"male",138,135,123,7,0,1,0,6,0
1664899,31,20,1982,5,"female",341,1,1,0,0,0,0,0,0
1664920,17,26,1996,4,"male",494,124,58,78,38,78,36,0,2
1664960,26,1,1987,1,"male",335,26,17,0,0,0,0,0,0
1664984,19,18,1994,11,"female",263,136,71,51,17,51,12,0,5
1665033,15,9,1998,1,"male",764,204,94,0,0,0,0,0,0
1665036,25,6,1988,1,"female",52,20,15,49,37,49,35,0,2
1665052,58,11,1955,10,"female",206,74,32,285,51,0,7,285,44
1665098,37,28,1976,6,"female",437,140,74,6,13,6,10,0,3
1665157,63,2,1950,1,"male",1099,1113,411,204,37,166,14,38,23
1665161,18,1,1995,9,"male",283,86,78,6,0,6,0,0,0
1665165,56,10,1957,7,"female",160,85,60,25,12,0,6,25,6
1665183,59,25,1954,6,"male",2198,105,49,65,40,61,21,4,19
1665192,30,14,1983,3,"male",936,605,488,830,262,670,220,160,42
1665197,23,17,1990,11,"male",177,85,72,0,0,0,0,0,0
1665221,54,22,1959,6,"male",1640,58,12,0,12,0,0,0,12
1665249,18,14,1995,8,"female",822,956,230,24,50,24,33,0,17
1665250,43,31,1970,1,"male",511,1899,755,111,11902,86,8724,25,3178
1665251,106,8,1907,4,"female",2282,986,422,146,103,91,97,55,6
1665269,37,9,1976,2,"male",465,72,37,50,53,44,40,6,13
1665309,36,29,1977,6,"male",102,100,65,1,12,1,9,0,3
1665345,87,22,1926,4,"female",550,42,17,30,12,30,2,0,10
1665354,48,12,1965,7,"female",499,645,514,616,153,409,44,207,109
1665367,60,6,1953,8,"female",605,58,41,1,10,1,10,0,0
1665382,21,2,1992,9,"male",497,155,96,85,24,37,17,48,7
1665396,40,17,1973,11,"male",244,77,74,6,2,6,2,0,0
1665412,42,22,1971,6,"female",278,11,8,0,0,0,0,0,0
1665418,29,15,1984,2,"female",794,418,197,5,9,2,2,3,7
1665420,35,1,1978,7,"male",427,4,4,0,0,0,0,0,0
1665510,13,22,2000,2,"female",219,174,71,220,87,203,46,17,41
1665518,19,11,1994,9,"female",216,768,525,310,462,46,263,264,199
1665554,49,27,1964,8,"male",1514,32,24,2,2,1,1,1,1
1665573,36,24,1977,10,"male",135,54,29,1,2,1,0,0,2
1665621,22,19,1991,12,"female",776,302,212,8,22,8,7,0,15
1665635,33,11,1980,4,"male",595,180,83,413,568,412,521,1,47
1665650,44,23,1969,4,"male",304,186,93,21,55,9,38,12,17
1665670,103,8,1910,2,"male",1184,208,122,48,42,48,23,0,19
1665687,21,24,1992,7,"male",616,327,197,7,186,7,135,0,51
1665699,25,13,1988,4,"male",163,115,93,0,0,0,0,0,0
1665745,45,12,1968,4,"male",443,67,51,185,152,157,118,28,34
1665754,53,3,1960,3,"female",280,23,17,15,1,15,0,0,1
1665770,22,6,1991,3,"male",399,86,33,2,16,2,11,0,5
1665788,62,21,1951,5,"male",379,1,1,6,1,0,0,6,1
1665797,66,22,1947,12,"male",1630,1177,203,31,178,31,116,0,62
1665839,45,12,1968,6,"male",641,179,139,3,2,3,1,0,1
1665888,15,5,1998,8,"female",440,96,21,210,10,210,7,0,3
1665890,22,8,1991,8,"male",733,265,129,25,25,25,23,0,2
1665896,22,4,1991,1,"male",896,816,699,407,333,407,281,0,52
1665954,16,15,1997,5,"female",992,1517,542,2203,803,1580,483,623,320
1665955,21,7,1992,11,"male",394,93,56,25,2,25,2,0,0
1665958,20,7,1993,7,"male",262,20,8,0,0,0,0,0,0
1665963,53,24,1960,6,"female",1137,40,19,292,137,0,84,292,53
1665991,64,6,1949,1,"male",800,62,7,20,30,9,15,11,15
1666023,19,28,1994,9,"female",480,854,761,1247,268,700,133,547,135
1666042,104,16,1909,12,"female",1674,177,75,34,64,0,17,34,47
1666051,18,17,1995,8,"male",248,463,338,2,19,1,16,1,3
1666072,28,9,1985,1,"male",526,35,26,0,0,0,0,0,0
1666081,26,31,1987,10,"male",1222,143,28,0,1,0,1,0,0
1666087,26,30,1987,8,"female",960,193,113,182,171,102,50,80,121
1666099,25,1,1988,1,"female",194,25,16,8,1,8,0,0,1
1666102,19,3,1994,8,"male",368,134,63,2,2,0,0,2,2
1666176,26,20,1987,6,"male",591,172,136,5,33,1,19,4,14
1666179,24,16,1989,9,"female",249,546,355,37,113,37,102,0,11
1666204,45,25,1968,7,"female",459,24,14,8,28,8,18,0,10
1666216,15,31,1998,7,"male",395,347,285,117,3,117,1,0,2
1666245,53,12,1960,8,"male",233,2,2,81,2,0,0,81,2
1666255,108,2,1905,6,"male",983,227,173,114,95,114,82,0,13
1666257,108,13,1905,5,"female",2063,263,72,63,55,6,16,57,39
1666261,46,25,1967,5,"male",335,50,29,1,1,1,1,0,0
1666274,68,17,1945,8,"male",630,61,27,18,7,18,3,0,4
1666279,66,12,1947,1,"female",35,17,11,8,13,1,2,7,11
1666336,55,27,1958,7,"female",597,120,70,277,74,237,56,40,18
1666343,102,6,1911,6,"female",1228,910,619,60,1,52,0,8,1
1666347,17,24,1996,12,"male",813,102,42,1,2,1,1,0,1
1666349,22,24,1991,2,"female",135,390,317,342,573,323,195,19,378
1666356,63,14,1950,7,"female",1694,30,12,1,19,1,7,0,12
1666390,100,30,1913,3,"male",233,316,283,174,42,174,38,0,4
1666393,51,20,1962,4,"male",291,0,0,0,0,0,0,0,0
1666406,31,9,1982,6,"female",497,109,66,73,36,73,35,0,1
1666437,34,28,1979,4,"female",400,27,16,2,1,2,0,0,1
1666439,52,10,1961,7,"female",250,133,33,7424,2090,0,250,7424,1840
1666447,18,5,1995,5,"female",760,24,14,2,18,2,3,0,15
1666459,44,15,1969,7,"female",390,84,49,83,52,38,36,45,16
1666482,23,10,1990,5,"male",166,55,27,180,46,180,39,0,7
1666487,58,19,1955,5,"female",824,11,9,36,5,36,3,0,2
1666544,18,17,1995,3,"male",382,89,77,6,15,6,13,0,2
1666560,19,2,1994,12,"male",324,103,61,15,16,15,12,0,4
1666561,28,30,1985,1,"male",406,0,0,0,0,0,0,0,0
1666583,40,1,1973,2,"male",204,97,61,2,0,2,0,0,0
1666588,48,11,1965,6,"female",698,36,24,248,18,248,14,0,4
1666617,23,1,1990,1,"male",221,1,1,0,0,0,0,0,0
1666625,18,11,1995,6,"male",369,235,201,0,2,0,0,0,2
1666650,28,22,1985,11,"female",135,58,47,0,0,0,0,0,0
1666674,20,14,1993,4,"female",380,238,108,39,30,39,29,0,1
1666688,48,7,1965,1,"female",401,13,9,26,26,26,11,0,15
1666708,93,29,1920,4,"male",1623,207,108,141,4,141,4,0,0
1666716,17,17,1996,12,"male",259,35,15,0,0,0,0,0,0
1666721,60,21,1953,1,"male",616,4,3,1,0,1,0,0,0
1666742,18,12,1995,5,"male",197,131,119,6,2,6,1,0,1
1666780,57,23,1956,10,"male",1821,38,14,5,9,3,9,2,0
1666786,58,14,1955,3,"female",1682,110,38,2,23,0,1,2,22
1666830,24,1,1989,8,"male",536,69,26,13,13,12,10,1,3
1666832,57,7,1956,5,"male",144,239,210,153,18,0,3,153,15
1666858,18,25,1995,12,"male",940,713,518,388,551,388,511,0,40
1666859,108,23,1905,8,"female",213,128,108,239,18,9,4,230,14
1666878,42,8,1971,1,"male",589,73,62,33,44,16,18,17,26
1666890,22,11,1991,1,"male",653,833,686,0,47,0,43,0,4
1666915,19,8,1994,10,"male",360,432,368,6,38,0,29,6,9
1666960,16,25,1997,2,"female",815,173,63,19,63,7,25,12,38
1666981,56,12,1957,4,"male",664,18,16,19,9,19,8,0,1
1666983,55,26,1958,1,"male",681,46,36,0,12,0,4,0,8
1666986,22,17,1991,3,"female",404,360,231,64,5,64,4,0,1
1667010,66,23,1947,10,"female",1873,52,16,303,88,273,21,30,67
1667029,22,26,1991,8,"male",873,88,28,18,5,18,4,0,1
1667033,21,23,1992,3,"male",1575,319,179,94,77,94,31,0,46
1667036,18,16,1995,2,"male",345,92,64,1,0,1,0,0,0
1667041,57,8,1956,11,"female",339,90,30,38,69,0,16,38,53
1667044,23,11,1990,6,"female",294,10,0,0,0,0,0,0,0
1667053,14,29,1999,9,"male",38,20,7,15,9,15,0,0,9
1667075,103,24,1910,4,"female",899,4597,331,28,1223,28,645,0,578
1667103,36,28,1977,12,"female",569,83,71,131,7,126,0,5,7
1667116,43,8,1970,4,"female",314,23,4,0,0,0,0,0,0
1667156,20,19,1993,9,"female",407,292,234,69,295,69,224,0,71
1667166,51,23,1962,9,"female",130,66,47,371,414,371,380,0,34
1667170,62,6,1951,5,"female",1150,76,46,62,15,62,14,0,1
1667178,17,6,1996,9,"male",273,183,144,0,0,0,0,0,0
1667182,17,11,1996,2,"female",5,146,123,49,43,12,12,37,31
1667189,25,5,1988,6,"male",268,37,34,2,26,2,18,0,8
1667220,33,14,1980,2,"male",805,371,216,4,1,4,1,0,0
1667239,52,31,1961,7,"female",395,182,157,176,79,0,19,176,60
1667286,26,20,1987,6,"female",517,72,44,0,0,0,0,0,0
1667338,63,13,1950,4,"female",347,0,0,0,0,0,0,0,0
1667352,107,6,1906,2,"male",1417,253,192,423,346,423,286,0,60
1667391,20,11,1993,10,"female",778,284,63,28,36,28,34,0,2
1667402,30,1,1983,10,"male",395,41,21,18,14,15,7,3,7
1667417,18,4,1995,1,"female",429,46,28,65,76,11,24,54,52
1667423,29,8,1984,7,"male",441,284,232,5,12,5,8,0,4
1667468,35,21,1978,4,"male",607,55,37,15,2,15,1,0,1
1667494,23,1,1990,1,"male",213,62,45,68,5,68,5,0,0
1667502,21,20,1992,8,"male",221,132,106,87,60,86,30,1,30
1667507,40,4,1973,4,"male",729,80,69,17,35,17,29,0,6
1667511,31,27,1982,2,"female",81,63,45,18,22,0,11,18,11
1667520,58,22,1955,2,"female",1796,377,123,173,207,173,145,0,62
1667531,25,28,1988,12,"male",754,2,2,0,0,0,0,0,0
1667582,102,1,1911,1,"female",1845,52,11,2,5,1,3,1,2
1667588,25,10,1988,5,"female",456,78,25,16,33,16,26,0,7
1667616,26,9,1987,10,"male",628,365,297,15,3,14,3,1,0
1667618,23,7,1990,8,"male",404,42,25,12,1,12,0,0,1
1667626,83,30,1930,3,"female",1317,14,9,0,0,0,0,0,0
1667629,23,9,1990,10,"female",335,20,4,2,0,2,0,0,0
1667684,14,9,1999,11,"female",255,200,65,6,18,6,14,0,4
1667687,26,8,1987,10,"female",1181,4,4,0,0,0,0,0,0
1667711,20,17,1993,1,"male",583,268,126,247,174,247,126,0,48
1667732,86,20,1927,11,"female",1503,87,43,70,37,20,18,50,19
1667741,26,20,1987,6,"female",202,101,61,40,78,40,70,0,8
1667756,21,5,1992,6,"male",41,37,30,2,0,2,0,0,0
1667765,15,1,1998,1,"female",251,21,15,0,0,0,0,0,0
1667767,108,20,1905,1,"male",46,241,218,11,39,9,14,2,25
1667788,68,10,1945,4,"female",508,38,23,41,14,0,2,41,12
1667824,103,14,1910,9,"male",1283,1800,319,8,128,0,51,8,77
1667841,24,5,1989,1,"female",608,27,10,30,4,30,3,0,1
1667848,71,27,1942,1,"male",1327,65,25,108,49,108,31,0,18
1667888,22,24,1991,4,"male",118,125,58,243,35,181,27,62,8
1667904,16,10,1997,10,"male",127,10,4,319,0,0,0,319,0
1667915,55,24,1958,1,"female",1347,112,98,270,45,270,25,0,20
1667928,35,21,1978,12,"female",757,85,49,52,1,36,1,16,0
1667943,26,1,1987,1,"female",494,0,0,0,0,0,0,0,0
1667948,30,19,1983,4,"female",315,14,8,1,0,1,0,0,0
1668024,43,19,1970,3,"female",361,66,45,134,74,0,20,134,54
1668051,29,14,1984,2,"male",163,69,44,1,0,1,0,0,0
1668055,27,5,1986,5,"male",446,35,32,6,0,6,0,0,0
1668065,28,31,1985,10,"male",425,93,50,19,45,19,45,0,0
1668072,35,12,1978,9,"male",74,34,31,0,0,0,0,0,0
1668092,54,4,1959,10,"male",1829,86,58,32,71,31,40,1,31
1668096,41,28,1972,7,"male",617,61,32,9,2,9,0,0,2
1668124,24,7,1989,3,"male",23,3,3,1,2,1,2,0,0
1668129,65,24,1948,11,"female",1562,85,55,302,130,292,27,10,103
1668139,18,12,1995,1,"male",311,31,11,50,0,50,0,0,0
1668150,17,1,1996,1,"male",418,202,171,0,61,0,47,0,14
1668183,64,6,1949,9,"male",831,85,70,18,15,4,5,14,10
1668206,21,25,1992,8,"female",711,265,148,81,84,72,81,9,3
1668210,18,5,1995,8,"male",290,181,118,197,98,57,48,140,50
1668232,84,29,1929,12,"female",1008,119,79,278,173,278,154,0,19
1668233,24,9,1989,6,"male",1210,157,123,3,2,3,2,0,0
1668258,16,2,1997,8,"male",195,1,0,0,0,0,0,0,0
1668281,91,14,1922,2,"female",1241,158,74,114,181,111,134,3,47
1668308,31,2,1982,11,"female",331,6,6,1,0,1,0,0,0
1668336,40,3,1973,6,"male",417,58,32,5,2,5,2,0,0
1668381,15,10,1998,4,"female",293,58,6,57,33,57,28,0,5
1668391,15,2,1998,2,"male",900,723,440,469,595,379,318,90,277
1668397,56,29,1957,11,"male",141,180,58,86,19,86,11,0,8
1668400,42,7,1971,9,"female",972,217,196,37,166,37,118,0,48
1668425,41,15,1972,1,"female",1875,171,102,224,499,76,371,148,128
1668433,14,20,1999,7,"female",387,184,147,1331,729,1318,628,13,101
1668434,72,18,1941,4,"female",1699,61,21,102,28,93,15,9,13
1668492,43,1,1970,5,"female",1760,184,64,168,52,129,26,39,26
1668508,27,10,1986,8,"male",646,28,20,0,0,0,0,0,0
1668511,16,7,1997,2,"male",587,81,52,31,5,0,3,31,2
1668524,58,21,1955,1,"male",427,22,16,23,24,0,6,23,18
1668530,41,5,1972,8,"female",1041,105,72,0,3,0,3,0,0
1668551,93,6,1920,1,"male",1662,317,55,18,95,18,61,0,34
1668557,63,4,1950,11,"female",1242,78,30,6,2,6,2,0,0
1668566,16,1,1997,1,"male",505,36,18,45,0,10,0,35,0
1668587,31,12,1982,3,"male",547,210,167,5,13,5,12,0,1
1668590,62,4,1951,12,"male",646,63,28,190,22,0,5,190,17
1668642,20,27,1993,12,"female",8,50,10,6,1,6,1,0,0
1668643,13,12,2000,1,"male",40,145,131,0,0,0,0,0,0
1668695,40,18,1973,12,"female",932,150,85,73,103,46,57,27,46
1668718,59,13,1954,7,"male",984,7,4,0,0,0,0,0,0
1668729,27,2,1986,4,"male",169,12,8,0,0,0,0,0,0
1668732,16,15,1997,6,"female",21,59,15,0,50,0,35,0,15
1668743,46,18,1967,2,"male",307,0,0,0,0,0,0,0,0
1668748,18,23,1995,4,"female",387,179,153,10,25,10,20,0,5
1668772,37,4,1976,11,"male",717,1,0,0,0,0,0,0,0
1668775,19,5,1994,8,"male",882,8,6,0,0,0,0,0,0
1668781,26,25,1987,4,"male",3,25,20,2,0,2,0,0,0
1668786,15,14,1998,7,"male",390,423,157,70,26,32,14,38,12
1668798,37,3,1976,10,"female",899,83,37,0,0,0,0,0,0
1668815,68,17,1945,8,"male",553,184,163,653,288,653,273,0,15
1668874,54,22,1959,4,"male",1176,71,37,3,65,2,47,1,18
1668881,57,10,1956,9,"female",840,10,7,26,18,26,16,0,2
1668897,25,16,1988,5,"female",149,1,1,0,0,0,0,0,0
1668910,38,20,1975,6,"female",354,83,52,89,95,43,59,46,36
1668942,25,16,1988,5,"male",258,39,23,0,1,0,1,0,0
1668944,103,31,1910,7,"female",1614,655,381,12,11,0,9,12,2
1668946,18,25,1995,7,"female",620,269,155,229,333,229,292,0,41
1668972,31,16,1982,4,"male",9,21,1,2,15,2,15,0,0
1668980,19,12,1994,1,"male",218,1,0,1,0,1,0,0,0
1669035,22,1,1991,9,"male",354,161,155,11,4,9,4,2,0
1669062,23,7,1990,10,"male",73,300,272,591,280,375,137,216,143
1669065,28,25,1985,10,"male",62,30,8,1,6,1,5,0,1
1669075,16,3,1997,3,"male",647,626,360,43,32,43,30,0,2
1669088,18,30,1995,11,"female",293,224,150,33,77,32,57,1,20
1669091,34,12,1979,9,"female",142,52,35,264,110,264,110,0,0
1669099,64,7,1949,12,"male",982,47,24,201,381,29,250,172,131
1669121,48,10,1965,9,"male",602,99,5,149,60,0,28,149,32
1669144,41,15,1972,10,"male",214,51,19,0,0,0,0,0,0
1669154,18,3,1995,5,"female",645,43,26,79,10,79,10,0,0
1669165,65,7,1948,7,"female",165,0,0,1,1,0,0,1,1
1669167,21,1,1992,9,"male",893,108,64,20,3,8,1,12,2
1669192,54,2,1959,1,"female",456,33,22,1,2,1,2,0,0
1669202,26,14,1987,9,"male",537,176,133,159,87,159,59,0,28
1669208,15,20,1998,6,"male",271,66,40,55,20,0,4,55,16
1669211,21,23,1992,1,"male",513,436,388,0,11,0,4,0,7
1669260,18,5,1995,5,"female",471,280,62,31,139,0,41,31,98
1669266,42,4,1971,5,"female",673,0,0,0,0,0,0,0,0
1669304,46,20,1967,6,"male",768,97,36,3,0,1,0,2,0
1669305,67,24,1946,7,"male",1,16,15,14,1,0,0,14,1
1669344,19,11,1994,7,"male",615,201,55,0,0,0,0,0,0
1669345,24,4,1989,4,"male",144,220,178,165,65,165,58,0,7
1669396,38,27,1975,6,"female",491,9,7,9,0,9,0,0,0
1669412,20,20,1993,6,"male",648,285,209,23,7,22,0,1,7
1669427,33,1,1980,1,"male",577,78,72,0,0,0,0,0,0
1669439,51,20,1962,1,"female",1290,139,68,281,160,127,127,154,33
1669445,59,17,1954,2,"female",288,226,173,23,208,0,48,23,160
1669480,17,17,1996,10,"male",329,364,139,119,31,18,14,101,17
1669497,73,7,1940,4,"male",1090,140,127,3,14,0,1,3,13
1669521,42,24,1971,12,"male",552,61,27,1,0,1,0,0,0
1669561,21,1,1992,1,"male",7,1,0,0,0,0,0,0,0
1669562,26,2,1987,6,"male",94,37,29,55,23,46,16,9,7
1669579,18,16,1995,5,"female",283,235,78,8,52,7,37,1,15
1669586,48,6,1965,7,"female",628,38,23,0,0,0,0,0,0
1669607,41,14,1972,7,"female",265,12,9,59,7,59,5,0,2
1669635,38,14,1975,7,"male",837,48,21,15,25,15,9,0,16
1669636,20,7,1993,9,"female",559,206,146,1051,614,1032,174,19,440
1669669,16,12,1997,5,"female",191,156,146,0,7,0,1,0,6
1669675,25,12,1988,7,"male",502,133,93,4,9,4,9,0,0
1669679,22,12,1991,9,"male",137,284,269,9,13,9,4,0,9
1669698,53,31,1960,8,"female",490,28,22,5,11,1,6,4,5
1669708,16,27,1997,7,"male",192,418,394,113,71,43,58,70,13
1669710,23,5,1990,9,"female",602,205,165,100,16,24,5,76,11
1669725,65,5,1948,2,"female",1727,55,15,25,3,7,2,18,1
1669770,23,1,1990,1,"male",167,22,21,9,0,6,0,3,0
1669792,65,27,1948,4,"female",1349,201,46,99,16,0,9,99,7
1669831,19,12,1994,9,"female",118,19,3,0,3,0,2,0,1
1669834,20,1,1993,1,"female",413,26,16,178,236,178,154,0,82
1669845,29,27,1984,3,"female",508,165,109,128,128,128,116,0,12
1669865,15,19,1998,2,"female",437,627,445,368,391,368,320,0,71
1669869,20,25,1993,5,"male",324,486,413,11,110,11,84,0,26
1669899,24,1,1989,1,"male",295,44,43,4,0,4,0,0,0
1669910,16,4,1997,1,"male",401,187,54,234,71,185,52,49,19
1669972,56,16,1957,2,"female",385,33,30,127,0,127,0,0,0
1669978,22,7,1991,8,"male",257,36,4,6,0,0,0,6,0
1669979,24,5,1989,5,"male",183,131,101,38,7,2,4,36,3
1669983,21,28,1992,11,"female",67,50,41,23,19,23,15,0,4
1669984,34,18,1979,10,"male",1216,322,209,81,7,46,4,35,3
1670015,25,17,1988,8,"male",474,85,48,0,0,0,0,0,0
1670016,23,26,1990,11,"male",1025,221,141,69,89,41,47,28,42
1670041,20,22,1993,1,"male",233,66,58,0,0,0,0,0,0
1670056,60,24,1953,3,"female",625,41,27,8,7,0,4,8,3
1670070,53,27,1960,4,"male",1022,219,137,0,0,0,0,0,0
1670099,63,20,1950,1,"female",250,45,23,9,6,4,6,5,0
1670106,63,22,1950,8,"female",1590,12,8,350,6,0,1,350,5
1670115,23,15,1990,2,"male",184,35,23,0,0,0,0,0,0
1670123,16,22,1997,9,"male",173,4,4,112,0,0,0,112,0
1670133,66,15,1947,7,"female",1556,78,44,1068,137,8,49,1060,88
1670154,18,17,1995,2,"female",36,76,26,65,28,64,28,1,0
1670156,27,1,1986,1,"male",251,50,37,11,33,11,13,0,20
1670187,64,16,1949,1,"male",233,28,17,28,0,0,0,28,0
1670229,53,10,1960,1,"female",629,71,24,2,27,0,15,2,12
1670239,18,6,1995,1,"male",499,311,272,0,0,0,0,0,0
1670240,19,9,1994,9,"female",840,237,141,340,670,267,325,73,345
1670255,17,5,1996,1,"male",434,41,30,3,1,3,1,0,0
1670268,31,26,1982,2,"female",185,116,107,6,1,6,1,0,0
1670272,25,24,1988,12,"male",550,76,76,0,0,0,0,0,0
1670293,22,11,1991,10,"male",116,82,65,0,0,0,0,0,0
1670299,27,4,1986,5,"female",1082,1383,226,611,1316,405,404,206,912
1670366,20,6,1993,5,"female",301,61,41,16,9,9,5,7,4
1670383,44,5,1969,5,"female",478,55,46,0,0,0,0,0,0
1670416,103,11,1910,2,"female",459,78,34,0,0,0,0,0,0
1670417,18,2,1995,2,"female",758,211,90,1780,953,1728,573,52,380
1670448,52,12,1961,12,"male",359,286,200,148,17,148,11,0,6
1670486,31,11,1982,3,"male",564,7,2,0,0,0,0,0,0
1670502,31,26,1982,6,"male",428,0,0,0,0,0,0,0,0
1670550,25,20,1988,12,"male",6,6,5,0,0,0,0,0,0
1670552,54,24,1959,10,"female",926,14,8,0,14,0,14,0,0
1670580,14,23,1999,2,"female",536,203,49,107,24,107,23,0,1
1670581,17,8,1996,7,"male",9,20,17,0,0,0,0,0,0
1670596,23,10,1990,7,"male",263,95,89,2,0,2,0,0,0
1670626,68,15,1945,7,"female",421,26,23,282,143,0,31,282,112
1670629,30,29,1983,9,"male",1369,401,124,33,2,16,0,17,2
1670646,30,1,1983,6,"male",1722,269,95,25,23,25,22,0,1
1670650,20,13,1993,7,"male",1435,533,234,16,101,16,87,0,14
1670674,16,30,1997,6,"male",150,242,104,27,31,27,29,0,2
1670683,18,10,1995,5,"female",559,614,317,91,121,33,61,58,60
1670707,18,27,1995,7,"male",482,27,20,0,3,0,0,0,3
1670717,53,1,1960,4,"female",516,69,30,1,5,1,5,0,0
1670738,56,25,1957,12,"female",1310,103,11,13,20,0,14,13,6
1670750,37,23,1976,5,"male",236,22,6,301,28,301,28,0,0
1670778,19,16,1994,5,"male",400,173,149,0,25,0,6,0,19
1670785,55,15,1958,10,"female",419,125,95,3,13,0,6,3,7
1670790,36,28,1977,7,"male",535,79,46,11,1,0,0,11,1
1670804,18,21,1995,9,"female",118,9,9,0,0,0,0,0,0
1670863,38,24,1975,8,"female",438,69,59,59,1,47,1,12,0
1670875,36,5,1977,11,"male",1498,25,12,15,30,5,17,10,13
1670914,34,24,1979,5,"male",956,9,0,0,0,0,0,0,0
1670918,37,27,1976,11,"female",296,51,12,62,69,62,61,0,8
1670926,19,11,1994,2,"male",35,32,24,35,7,35,4,0,3
1670933,23,2,1990,9,"male",114,72,41,21,21,21,19,0,2
1670937,25,26,1988,4,"female",155,7,7,34,8,34,6,0,2
1670969,71,26,1942,11,"male",478,14,12,0,0,0,0,0,0
1670970,36,20,1977,9,"male",237,99,48,0,0,0,0,0,0
1670983,24,27,1989,1,"male",1146,3,2,0,0,0,0,0,0
1671000,74,4,1939,12,"female",1517,79,31,205,43,202,12,3,31
1671046,27,28,1986,8,"female",267,178,57,6,14,6,9,0,5
1671056,27,6,1986,6,"male",153,49,33,61,47,61,45,0,2
1671062,30,8,1983,8,"male",1048,59,21,58,35,43,13,15,22
1671065,48,20,1965,6,"female",646,106,37,96,124,96,77,0,47
1671093,19,25,1994,3,"male",285,54,46,19,0,0,0,19,0
1671126,23,9,1990,4,"male",669,623,456,147,482,95,247,52,235
1671131,18,12,1995,6,"female",378,1155,205,3786,3045,3786,2646,0,399
1671132,72,26,1941,4,"male",1736,50,12,1,12,0,6,1,6
1671150,18,12,1995,9,"male",89,112,73,264,111,264,104,0,7
1671157,31,31,1982,1,"female",397,505,472,198,207,108,123,90,84
1671165,23,26,1990,8,"female",287,58,25,158,119,101,94,57,25
1671166,20,27,1993,9,"male",155,50,44,94,27,94,21,0,6
1671170,24,1,1989,2,"male",395,81,39,0,0,0,0,0,0
1671190,56,27,1957,3,"female",1878,348,199,452,980,443,494,9,486
1671192,44,1,1969,5,"male",497,92,25,236,26,236,22,0,4
1671194,52,20,1961,6,"male",198,17,13,0,0,0,0,0,0
1671197,30,18,1983,5,"female",326,168,75,71,440,70,172,1,268
1671218,23,16,1990,1,"female",525,402,126,18,201,2,96,16,105
1671225,19,23,1994,9,"male",383,597,381,669,470,261,234,408,236
1671228,33,3,1980,10,"female",130,2,1,0,0,0,0,0,0
1671257,25,13,1988,9,"male",487,495,386,133,34,58,25,75,9
1671286,35,27,1978,5,"male",937,41,5,0,0,0,0,0,0
1671288,14,11,1999,6,"female",122,80,63,111,36,111,9,0,27
1671293,17,27,1996,11,"female",833,654,366,39,10,39,9,0,1
1671301,48,25,1965,12,"female",1694,148,94,93,138,46,106,47,32
1671325,21,19,1992,5,"female",731,1315,689,59,220,36,170,23,50
1671345,25,3,1988,11,"male",518,112,64,0,2,0,2,0,0
1671347,23,4,1990,3,"male",11,18,17,3,3,0,1,3,2
1671354,18,14,1995,2,"male",69,39,13,1,0,1,0,0,0
1671364,43,1,1970,1,"male",158,13,12,8,2,8,2,0,0
1671373,38,1,1975,1,"male",23,14,13,4,1,0,0,4,1
1671415,14,24,1999,3,"male",288,481,427,6,11,4,4,2,7
1671417,28,1,1985,1,"male",283,40,32,53,19,1,9,52,10
1671427,62,5,1951,10,"male",321,570,284,151,228,0,70,151,158
1671443,33,12,1980,5,"male",51,21,15,34,4,28,2,6,2
1671447,67,8,1946,5,"male",772,64,39,486,274,486,175,0,99
1671458,16,11,1997,8,"female",93,164,114,57,127,56,99,1,28
1671462,49,26,1964,6,"male",644,6,5,6,3,0,1,6,2
1671513,19,30,1994,6,"male",247,95,77,6,12,0,7,6,5
1671519,29,9,1984,4,"female",23,15,14,0,5,0,5,0,0
1671532,26,9,1987,2,"female",334,215,141,15,27,15,26,0,1
1671534,20,10,1993,1,"female",200,747,388,818,264,644,98,174,166
1671535,69,31,1944,7,"female",1209,58,26,183,61,183,49,0,12
1671537,18,31,1995,8,"male",67,27,27,0,0,0,0,0,0
1671564,25,12,1988,11,"male",192,59,50,1,2,1,1,0,1
1671567,45,13,1968,6,"female",486,2,0,0,0,0,0,0,0
1671595,75,3,1938,12,"male",551,23,14,12,0,12,0,0,0
1671629,59,16,1954,1,"female",1016,106,52,20,59,16,48,4,11
1671630,59,6,1954,5,"female",1222,151,79,44,29,2,17,42,12
1671662,28,12,1985,4,"male",1468,95,32,3,4,3,4,0,0
1671671,16,11,1997,11,"male",644,2669,2195,111,1515,16,978,95,537
1671696,46,22,1967,3,"male",180,312,289,77,8,72,8,5,0
1671721,56,13,1957,12,"female",232,38,28,569,359,569,115,0,244
1671739,19,17,1994,5,"male",356,250,213,0,3,0,2,0,1
1671857,21,12,1992,11,"female",224,53,41,17,2,9,2,8,0
1671869,33,1,1980,1,"female",212,0,0,0,0,0,0,0,0
1671939,65,4,1948,8,"female",1530,23,11,204,62,203,11,1,51
1671947,14,23,1999,7,"female",167,77,64,248,48,221,45,27,3
1671949,22,6,1991,11,"female",54,139,130,149,177,147,154,2,23
1671952,14,4,1999,10,"female",152,755,263,1,4,0,4,1,0
1671983,52,25,1961,5,"female",973,14,12,2,8,1,8,1,0
1672028,49,17,1964,11,"male",242,127,91,50,32,50,27,0,5
1672030,103,17,1910,5,"male",669,202,124,1,0,1,0,0,0
1672054,68,25,1945,3,"female",197,20,14,2,0,2,0,0,0
1672058,48,28,1965,10,"male",1626,342,277,1,31,0,18,1,13
1672109,21,31,1992,10,"female",573,263,110,80,119,80,95,0,24
1672111,17,23,1996,5,"female",392,101,13,20,5,15,1,5,4
1672113,53,18,1960,3,"male",742,172,80,377,631,328,486,49,145
1672140,67,28,1946,7,"female",662,50,32,28,21,0,0,28,21
1672185,37,29,1976,9,"female",440,31,25,0,0,0,0,0,0
1672189,19,13,1994,6,"male",612,1026,804,5318,2000,5269,1757,49,243
1672264,29,15,1984,10,"male",290,20,11,0,6,0,6,0,0
1672347,26,14,1987,9,"male",389,58,34,29,0,0,0,29,0
1672359,50,14,1963,4,"female",1295,56,27,97,13,97,12,0,1
1672361,40,29,1973,12,"male",405,51,42,2,1,2,1,0,0
1672362,18,2,1995,5,"female",27,88,13,87,61,87,43,0,18
1672412,58,7,1955,11,"female",403,88,65,90,65,0,22,90,43
1672462,42,9,1971,7,"male",392,58,30,160,10,160,10,0,0
1672478,103,18,1910,12,"male",899,256,200,3,34,3,31,0,3
1672483,47,7,1966,5,"female",381,74,18,20,2,3,2,17,0
1672485,38,9,1975,10,"male",1688,36,22,6,14,0,0,6,14
1672492,44,7,1969,7,"male",1076,3,2,0,0,0,0,0,0
1672501,18,30,1995,9,"male",140,9,8,2,2,2,0,0,2
1672528,28,3,1985,11,"female",366,52,19,0,0,0,0,0,0
1672553,56,31,1957,8,"female",153,36,29,24,1,24,0,0,1
1672579,16,21,1997,9,"female",271,100,81,9,0,0,0,9,0
1672595,72,21,1941,8,"female",611,10,6,1,15,0,1,1,14
1672610,16,2,1997,8,"female",655,2758,1153,386,3592,358,1956,28,1636
1672645,55,31,1958,12,"male",1976,1238,531,8,29,8,26,0,3
1672656,90,19,1923,6,"female",602,93,82,8,3,2,1,6,2
1672713,23,5,1990,8,"female",433,183,136,29,15,29,10,0,5
1672751,23,15,1990,8,"male",602,396,345,1823,684,619,201,1204,483
1672753,27,2,1986,4,"male",143,157,135,329,124,329,114,0,10
1672756,26,27,1987,7,"male",307,85,48,45,0,45,0,0,0
1672759,17,22,1996,3,"male",590,1,1,0,0,0,0,0,0
1672766,25,15,1988,10,"male",702,168,45,8,50,8,50,0,0
1672768,14,31,1999,10,"female",330,153,89,0,2,0,1,0,1
1672805,29,1,1984,12,"female",693,22,14,121,93,121,88,0,5
1672806,27,18,1986,10,"female",88,46,28,132,76,132,59,0,17
1672827,22,26,1991,5,"female",100,18,16,0,2,0,2,0,0
1672841,25,8,1988,8,"male",337,1,1,0,0,0,0,0,0
1672883,23,29,1990,1,"female",389,31,7,2,1,2,1,0,0
1672924,49,2,1964,7,"male",25,11,11,6,2,6,0,0,2
1672946,40,8,1973,8,"female",1048,116,25,2,15,2,10,0,5
1672957,30,25,1983,12,"male",592,381,329,0,0,0,0,0,0
1672972,18,26,1995,2,"male",311,190,76,0,0,0,0,0,0
1672986,28,25,1985,3,"female",458,119,48,843,1098,838,939,5,159
1672991,19,3,1994,5,"male",189,220,174,0,1,0,1,0,0
1673017,26,4,1987,3,"male",309,577,467,2,0,2,0,0,0
1673020,17,1,1996,5,"female",976,3683,755,10478,42449,246,27353,10232,15096
1673021,32,14,1981,12,"male",879,2,2,0,0,0,0,0,0
1673022,43,20,1970,12,"female",307,0,0,0,0,0,0,0,0
1673035,43,12,1970,12,"male",1188,272,197,53,277,50,80,3,197
1673115,58,17,1955,5,"female",208,14,9,71,0,71,0,0,0
1673146,46,27,1967,6,"female",743,178,107,62,233,24,105,38,128
1673192,23,1,1990,1,"male",416,1,1,0,0,0,0,0,0
1673194,21,15,1992,2,"female",285,88,39,42,55,4,14,38,41
1673206,38,31,1975,1,"male",708,189,103,62,82,59,46,3,36
1673226,28,1,1985,2,"male",183,117,45,269,51,269,41,0,10
1673242,19,16,1994,10,"male",128,24,20,0,2,0,1,0,1
1673250,32,15,1981,10,"female",74,0,0,0,0,0,0,0,0
1673261,17,30,1996,5,"male",512,28,24,0,1,0,1,0,0
1673265,38,18,1975,12,"female",408,28,20,15,6,14,3,1,3
1673274,65,5,1948,4,"female",596,198,50,2,2,2,1,0,1
1673328,25,23,1988,11,"male",21,15,6,2,7,2,5,0,2
1673353,14,26,1999,9,"male",371,120,89,133,7,98,6,35,1
1673374,56,15,1957,3,"female",176,139,117,1052,686,999,493,53,193
1673387,15,14,1998,8,"male",344,977,731,3651,2053,3510,1936,141,117
1673404,46,29,1967,12,"female",2255,231,126,314,243,29,129,285,114
1673412,40,15,1973,3,"female",540,88,60,11,7,11,0,0,7
1673475,27,20,1986,10,"male",221,39,35,0,0,0,0,0,0
1673495,28,23,1985,12,"male",191,49,22,564,57,564,30,0,27
1673497,24,30,1989,6,"female",671,90,20,35,2,35,2,0,0
1673552,51,7,1962,9,"female",577,55,24,4,12,4,4,0,8
1673576,14,15,1999,9,"female",301,292,176,432,202,300,98,132,104
1673583,47,15,1966,8,"male",218,40,36,1,0,1,0,0,0
1673589,15,2,1998,8,"female",279,199,131,34,59,34,41,0,18
1673592,18,3,1995,1,"male",243,97,65,119,77,110,35,9,42
1673597,14,14,1999,9,"male",391,521,435,9,7,0,1,9,6
1673612,24,30,1989,7,"male",121,189,180,0,0,0,0,0,0
1673670,36,11,1977,2,"male",335,38,19,4,15,3,13,1,2
1673672,21,9,1992,12,"male",443,28,20,0,1,0,1,0,0
1673679,25,8,1988,8,"male",149,23,21,0,0,0,0,0,0
1673695,44,16,1969,10,"female",225,93,80,1281,541,1281,439,0,102
1673751,38,14,1975,7,"female",421,231,165,122,218,101,165,21,53
1673753,38,2,1975,4,"male",1,1,1,2,0,2,0,0,0
1673754,23,21,1990,5,"female",49,9,5,54,16,54,10,0,6
1673763,50,11,1963,1,"female",1590,282,199,56,81,56,29,0,52
1673764,51,29,1962,9,"male",261,90,50,0,4,0,0,0,4
1673803,15,6,1998,6,"female",401,1096,570,759,485,660,374,99,111
1673807,55,4,1958,3,"male",756,1,0,1,0,0,0,1,0
1673870,103,11,1910,8,"female",1000,249,102,13,105,13,36,0,69
1673872,17,28,1996,9,"male",992,387,327,0,5,0,0,0,5
1673889,20,8,1993,10,"male",355,279,146,12,18,0,15,12,3
1673941,58,23,1955,4,"female",506,42,10,4,2,3,1,1,1
1673944,16,6,1997,12,"female",229,132,64,52,18,52,16,0,2
1673964,57,29,1956,6,"female",1635,317,164,1118,214,1091,96,27,118
1673985,28,11,1985,6,"male",599,121,81,1,2,1,0,0,2
1674000,21,11,1992,2,"male",169,86,76,0,0,0,0,0,0
1674002,18,25,1995,5,"female",41,49,32,49,60,39,51,10,9
1674017,41,21,1972,7,"male",85,51,34,7,13,7,5,0,8
1674048,24,8,1989,8,"male",877,315,263,98,42,97,33,1,9
1674059,26,25,1987,5,"male",359,69,46,1,2,0,1,1,1
1674096,27,26,1986,2,"male",419,44,36,0,13,0,11,0,2
1674103,59,3,1954,12,"male",414,45,39,7,6,0,5,7,1
1674104,45,28,1968,10,"female",699,86,69,31,19,0,8,31,11
1674129,23,6,1990,1,"male",2,0,0,0,0,0,0,0,0
1674131,49,25,1964,7,"male",75,22,10,92,31,92,16,0,15
1674149,103,29,1910,7,"female",301,127,73,23,55,23,35,0,20
1674220,25,21,1988,12,"female",500,50,36,35,29,35,24,0,5
1674264,34,5,1979,11,"male",162,25,23,4,5,4,4,0,1
1674327,20,3,1993,6,"female",733,2029,885,11,38,11,28,0,10
1674334,15,12,1998,4,"male",209,179,168,0,0,0,0,0,0
1674338,43,18,1970,5,"male",172,193,167,21,64,11,48,10,16
1674345,63,23,1950,7,"male",423,6,3,0,0,0,0,0,0
1674377,23,7,1990,11,"male",284,513,385,49,17,12,1,37,16
1674381,54,4,1959,12,"male",27,0,0,4,0,3,0,1,0
1674405,18,10,1995,9,"male",72,14,7,26,0,13,0,13,0
1674410,50,25,1963,1,"male",155,0,0,0,0,0,0,0,0
1674423,30,27,1983,12,"female",851,36,17,92,18,76,14,16,4
1674434,29,19,1984,12,"male",397,450,397,196,107,164,34,32,73
1674438,23,8,1990,5,"male",323,120,90,10,5,2,4,8,1
1674474,36,19,1977,2,"male",395,18,15,2,12,2,12,0,0
1674502,20,18,1993,8,"male",179,117,99,0,5,0,3,0,2
1674523,14,9,1999,2,"male",248,101,60,0,0,0,0,0,0
1674583,28,4,1985,1,"male",323,54,31,3,43,3,37,0,6
1674585,16,19,1997,9,"female",236,714,445,274,7,184,5,90,2
1674620,55,1,1958,10,"male",744,83,47,0,1,0,1,0,0
1674694,31,22,1982,6,"male",19,10,6,6,4,1,2,5,2
1674703,20,30,1993,6,"female",674,232,113,233,254,192,140,41,114
1674739,70,4,1943,11,"female",1675,80,40,2556,331,2552,120,4,211
1674751,17,1,1996,5,"male",987,54,25,0,0,0,0,0,0
1674784,21,1,1992,1,"male",382,154,127,1,0,0,0,1,0
1674805,56,29,1957,5,"male",390,238,54,0,0,0,0,0,0
1674813,23,14,1990,2,"male",263,290,208,2,0,2,0,0,0
1674815,13,10,2000,7,"female",102,34,25,0,0,0,0,0,0
1674833,23,28,1990,8,"male",389,57,33,0,0,0,0,0,0
1674837,44,17,1969,8,"female",52,20,11,1,2,1,2,0,0
1674845,33,1,1980,2,"male",806,6,6,0,0,0,0,0,0
1674910,27,10,1986,6,"male",424,42,24,3,0,3,0,0,0
1674952,54,18,1959,7,"male",236,11,7,0,0,0,0,0,0
1674970,13,23,2000,2,"female",298,21,10,0,1,0,1,0,0
1674996,37,27,1976,11,"male",264,25,19,55,1,55,0,0,1
1674997,36,21,1977,6,"female",213,36,30,64,19,57,8,7,11
1675019,19,12,1994,8,"male",412,292,148,31,61,17,55,14,6
1675034,22,18,1991,9,"female",286,1,0,0,0,0,0,0,0
1675043,21,22,1992,9,"female",461,34,29,3,0,1,0,2,0
1675087,43,1,1970,1,"female",164,19,14,24,0,0,0,24,0
1675135,71,16,1942,4,"male",824,46,36,59,16,0,5,59,11
1675158,15,7,1998,9,"male",489,76,33,0,0,0,0,0,0
1675185,22,1,1991,1,"male",498,33,32,0,0,0,0,0,0
1675207,46,10,1967,7,"male",1160,56,28,1,33,0,21,1,12
1675210,21,1,1992,12,"female",462,225,115,49,129,49,57,0,72
1675255,67,6,1946,4,"male",1665,86,35,128,31,2,17,126,14
1675274,41,16,1972,3,"male",1081,39,27,4,11,4,11,0,0
1675278,65,11,1948,9,"male",895,85,36,2,2,0,1,2,1
1675285,15,4,1998,8,"male",89,30,25,1,1,1,1,0,0
1675323,55,25,1958,7,"female",257,39,20,191,88,191,39,0,49
1675336,32,12,1981,9,"male",545,11,2,4,0,0,0,4,0
1675338,53,15,1960,9,"female",428,105,56,373,395,252,329,121,66
1675339,28,8,1985,8,"male",372,12,10,3,2,3,1,0,1
1675479,34,13,1979,2,"female",191,551,376,0,1,0,1,0,0
1675546,18,12,1995,11,"male",399,103,50,30,12,30,11,0,1
1675547,58,25,1955,2,"female",870,36,21,83,92,83,83,0,9
1675553,16,2,1997,3,"female",299,40,20,4,1,0,0,4,1
1675555,40,28,1973,3,"male",275,29,8,25,24,25,20,0,4
1675576,64,17,1949,1,"female",1109,33,18,20,9,20,8,0,1
1675606,18,15,1995,3,"male",479,167,97,3403,3511,3267,2314,136,1197
1675642,103,3,1910,5,"female",2430,407,196,17,13,4,8,13,5
1675649,19,13,1994,8,"female",510,955,284,47,53,30,31,17,22
1675659,21,17,1992,2,"male",129,62,52,3,2,0,1,3,1
1675685,70,28,1943,2,"female",1611,129,47,13,34,13,16,0,18
1675703,111,1,1902,1,"female",1895,30,12,5,1,4,0,1,1
1675735,61,23,1952,1,"male",200,0,0,0,0,0,0,0,0
1675756,13,7,2000,1,"male",199,418,360,0,8,0,5,0,3
1675771,19,11,1994,11,"male",487,519,304,41,176,39,120,2,56
1675787,37,14,1976,2,"female",477,6,5,0,1,0,1,0,0
1675814,18,2,1995,4,"female",387,226,213,155,226,155,126,0,100
1675828,41,16,1972,6,"male",532,24,4,0,16,0,6,0,10
1675834,35,10,1978,2,"female",622,123,37,8,29,7,26,1,3
1675846,33,7,1980,11,"male",215,71,62,0,0,0,0,0,0
1675849,43,19,1970,12,"male",25,3,3,9,1,9,0,0,1
1675861,32,30,1981,3,"male",348,0,0,0,0,0,0,0,0
1675871,16,8,1997,10,"male",81,0,0,0,0,0,0,0,0
1675903,20,6,1993,6,"male",440,133,107,1,0,0,0,1,0
1675907,64,21,1949,10,"female",1474,101,63,6,18,6,1,0,17
1675909,21,15,1992,9,"male",594,115,94,0,2,0,0,0,2
1675920,17,29,1996,9,"male",451,127,76,54,3,19,2,35,1
1675941,15,28,1998,8,"male",223,194,147,2,0,2,0,0,0
1675955,28,1,1985,1,"female",120,34,27,18,1,0,0,18,1
1675983,57,4,1956,6,"male",340,124,42,1,16,1,4,0,12
1675996,27,29,1986,9,"male",218,23,12,11,8,11,5,0,3
1676001,26,28,1987,12,"male",517,110,102,0,39,0,6,0,33
1676004,18,1,1995,1,"male",278,66,55,0,0,0,0,0,0
1676028,56,1,1957,4,"male",295,368,268,31,45,31,13,0,32
1676042,64,1,1949,2,"male",331,33,14,0,0,0,0,0,0
1676063,35,29,1978,10,"male",57,9,7,0,6,0,0,0,6
1676066,18,27,1995,11,"male",80,0,0,0,0,0,0,0,0
1676081,41,8,1972,6,"male",240,1,1,0,0,0,0,0,0
1676083,29,25,1984,2,"male",438,51,48,20,3,16,3,4,0
1676092,21,27,1992,1,"female",225,367,248,402,673,284,262,118,411
1676109,22,1,1991,1,"female",408,113,59,139,145,139,123,0,22
1676119,18,28,1995,6,"male",302,144,139,1,0,1,0,0,0
1676120,62,28,1951,10,"male",979,28,15,1,0,1,0,0,0
1676138,31,10,1982,3,"male",143,18,13,2,0,2,0,0,0
1676174,71,31,1942,7,"female",1393,83,40,12,181,0,127,12,54
1676226,13,10,2000,8,"female",82,273,190,10,17,7,13,3,4
1676235,45,25,1968,4,"male",243,46,37,3,2,3,2,0,0
1676271,33,26,1980,5,"male",753,17,9,0,0,0,0,0,0
1676278,43,16,1970,9,"female",134,2,1,1,0,1,0,0,0
1676290,102,1,1911,1,"male",1469,229,125,15,62,0,55,15,7
1676291,23,15,1990,4,"female",436,76,39,26,29,26,20,0,9
1676335,18,14,1995,8,"female",111,385,186,140,613,140,413,0,200
1676355,64,14,1949,5,"female",1543,41,23,4,6,0,3,4,3
1676364,27,3,1986,2,"male",467,69,50,0,0,0,0,0,0
1676383,42,18,1971,5,"female",557,145,50,1,1,0,1,1,0
1676409,19,18,1994,8,"female",546,294,114,11,28,11,17,0,11
1676411,16,29,1997,10,"female",536,288,234,997,205,996,172,1,33
1676413,15,1,1998,6,"male",87,79,70,8,7,8,4,0,3
1676422,18,30,1995,3,"male",216,77,54,41,73,41,54,0,19
1676467,17,22,1996,4,"female",521,89,38,12,16,9,5,3,11
1676468,24,13,1989,12,"male",259,60,26,3,1,3,1,0,0
1676482,38,14,1975,2,"female",623,16,2,8,30,8,27,0,3
1676526,16,30,1997,7,"male",436,65,29,2,0,2,0,0,0
1676536,21,20,1992,4,"female",1920,130,80,15,43,15,36,0,7
1676596,26,11,1987,2,"male",351,13,8,1,0,1,0,0,0
1676605,27,12,1986,9,"female",71,46,26,63,37,36,29,27,8
1676607,54,21,1959,7,"male",358,37,26,3,0,0,0,3,0
1676627,52,14,1961,11,"female",334,37,17,6,1,6,1,0,0
1676636,56,16,1957,10,"male",11,45,40,8,1,7,0,1,1
1676642,16,22,1997,2,"male",538,175,120,917,772,896,489,21,283
1676643,21,8,1992,8,"male",208,53,19,0,0,0,0,0,0
1676663,19,8,1994,6,"male",629,216,198,0,0,0,0,0,0
1676677,18,18,1995,8,"female",45,50,29,106,69,27,10,79,59
1676680,50,18,1963,10,"male",1955,59,18,0,0,0,0,0,0
1676692,23,10,1990,10,"male",281,6,6,0,0,0,0,0,0
1676716,22,17,1991,6,"male",245,102,42,8,9,8,9,0,0
1676747,25,10,1988,10,"male",381,0,0,0,0,0,0,0,0
1676754,24,15,1989,3,"male",279,338,295,206,148,205,143,1,5
1676763,18,3,1995,10,"female",197,504,275,84,48,41,39,43,9
1676810,32,26,1981,9,"male",26,14,5,1,1,1,0,0,1
1676815,66,4,1947,8,"female",1742,97,41,21,13,15,7,6,6
1676821,31,15,1982,3,"male",603,418,293,113,654,59,574,54,80
1676822,30,23,1983,4,"female",93,36,26,51,35,0,11,51,24
1676874,21,21,1992,1,"female",984,412,68,17,139,15,58,2,81
1676875,22,18,1991,2,"male",789,23,3,0,0,0,0,0,0
1676891,51,1,1962,1,"female",1468,107,29,27,11,27,7,0,4
1676904,103,25,1910,1,"male",2019,408,138,51,7,0,3,51,4
1676909,48,6,1965,9,"female",1083,109,73,106,82,54,39,52,43
1676920,100,6,1913,11,"male",751,1947,1154,3447,2087,3368,1387,79,700
1676932,32,5,1981,7,"female",1917,163,87,104,105,104,90,0,15
1676939,52,14,1961,8,"male",541,70,31,2,15,0,10,2,5
1676948,74,1,1939,3,"male",142,50,38,33,0,33,0,0,0
1676951,29,9,1984,11,"female",747,39,11,8,7,8,5,0,2
1676957,41,3,1972,9,"male",349,0,0,0,0,0,0,0,0
1676958,54,23,1959,7,"male",146,33,16,521,105,521,56,0,49
1676967,32,20,1981,6,"female",224,213,161,148,114,148,92,0,22
1676971,20,4,1993,12,"female",210,1161,892,1211,301,1147,218,64,83
1676974,16,10,1997,12,"female",659,230,36,6,0,6,0,0,0
1676994,24,21,1989,10,"female",639,193,87,228,185,228,181,0,4
1677011,17,1,1996,8,"male",115,171,125,15,12,15,11,0,1
1677012,22,6,1991,4,"male",363,195,175,2,24,2,16,0,8
1677040,29,9,1984,9,"male",550,31,10,0,0,0,0,0,0
1677055,24,20,1989,9,"female",569,1371,544,6593,5944,2189,3825,4404,2119
1677057,25,8,1988,11,"female",492,479,313,220,326,220,275,0,51
1677086,15,9,1998,8,"male",190,240,199,245,99,245,77,0,22
1677091,47,10,1966,1,"male",1041,0,0,0,0,0,0,0,0
1677101,26,23,1987,10,"male",108,51,33,0,9,0,8,0,1
1677142,19,10,1994,9,"male",379,215,61,0,5,0,0,0,5
1677189,20,23,1993,8,"male",370,302,281,55,5,55,5,0,0
1677196,26,27,1987,10,"male",513,49,33,1,1,0,0,1,1
1677207,18,2,1995,5,"female",263,81,46,158,72,1,7,157,65
1677213,21,30,1992,3,"female",666,318,213,225,162,5,33,220,129
1677218,67,13,1946,8,"female",684,103,11,4,0,0,0,4,0
1677222,19,6,1994,6,"male",316,33,1,58,5,0,0,58,5
1677228,62,10,1951,4,"female",125,27,21,43,11,43,8,0,3
1677247,28,8,1985,8,"male",93,52,26,155,36,155,31,0,5
1677300,106,9,1907,6,"female",822,838,284,59,60,59,45,0,15
1677307,49,8,1964,11,"male",222,75,42,42,17,38,3,4,14
1677316,44,6,1969,8,"male",381,1,1,0,0,0,0,0,0
1677323,33,31,1980,5,"female",228,178,138,1594,2202,1572,1932,22,270
1677325,55,2,1958,8,"female",361,930,694,156,1057,156,955,0,102
1677326,22,29,1991,12,"male",574,351,224,78,138,72,105,6,33
1677330,39,16,1974,4,"female",263,0,0,0,0,0,0,0,0
1677332,25,28,1988,3,"male",531,107,68,0,0,0,0,0,0
1677373,19,10,1994,9,"male",45,6,6,2,1,2,1,0,0
1677406,24,20,1989,3,"female",74,53,25,5,9,5,7,0,2
1677407,71,23,1942,9,"female",1946,39,16,23,2,20,2,3,0
1677442,37,22,1976,5,"female",989,128,100,1231,692,783,236,448,456
1677457,18,4,1995,4,"male",301,21,9,0,0,0,0,0,0
1677485,18,29,1995,7,"male",346,252,60,4,28,4,19,0,9
1677524,48,12,1965,12,"male",353,116,63,91,170,91,75,0,95
1677542,25,18,1988,7,"female",513,46,30,4,4,4,3,0,1
1677549,34,26,1979,2,"female",126,15,7,7,5,7,3,0,2
1677574,45,24,1968,5,"male",230,25,19,91,28,0,24,91,4
1677591,19,20,1994,3,"male",174,101,87,13,7,8,4,5,3
1677608,54,2,1959,2,"male",445,0,0,0,0,0,0,0,0
1677619,25,8,1988,8,"male",474,1349,1014,44,13,42,9,2,4
1677621,23,18,1990,10,"male",82,2,2,1,1,0,0,1,1
1677625,26,11,1987,11,"male",380,87,67,45,17,45,14,0,3
1677662,21,28,1992,8,"female",185,262,117,789,1298,789,1146,0,152
1677669,25,1,1988,1,"male",157,95,81,1,23,1,16,0,7
1677704,19,4,1994,9,"male",444,20,15,2,2,0,0,2,2
1677726,34,12,1979,11,"female",503,104,39,35,12,14,12,21,0
1677741,106,24,1907,8,"male",1763,514,276,27,14,23,8,4,6
1677755,61,3,1952,7,"female",302,45,33,68,56,42,40,26,16
1677800,24,1,1989,9,"female",203,14,10,20,13,0,3,20,10
1677808,68,17,1945,8,"male",297,40,37,0,0,0,0,0,0
1677812,59,6,1954,3,"male",1137,51,11,0,2,0,1,0,1
1677829,103,28,1910,10,"female",1717,211,60,4,139,1,77,3,62
1677839,20,17,1993,8,"female",472,116,36,60,192,37,19,23,173
1677842,26,14,1987,8,"female",1640,343,109,96,136,96,62,0,74
1677844,47,26,1966,3,"male",532,25,13,24,2,24,2,0,0
1677855,64,23,1949,4,"female",1796,326,180,1185,1043,627,467,558,576
1677867,53,23,1960,1,"female",497,121,81,64,62,13,14,51,48
1677885,42,24,1971,12,"female",444,99,54,294,30,294,24,0,6
1677952,76,23,1937,8,"male",1277,32,13,107,32,7,6,100,26
1677957,46,21,1967,11,"male",34,51,49,2,0,2,0,0,0
1677972,22,28,1991,8,"female",222,2,2,4,4,4,4,0,0
1677977,42,18,1971,6,"female",1770,449,247,1504,556,1435,392,69,164
1677980,23,15,1990,11,"male",182,55,24,27,5,27,3,0,2
1677981,29,10,1984,6,"female",139,312,132,169,121,169,79,0,42
1678002,18,29,1995,1,"female",436,109,84,34,8,27,4,7,4
1678003,43,23,1970,5,"male",594,161,118,7,5,3,4,4,1
1678024,15,1,1998,3,"male",211,8,1,0,0,0,0,0,0
1678029,94,16,1919,7,"female",729,634,315,204,212,156,108,48,104
1678031,25,2,1988,6,"male",106,135,109,4183,84,4183,78,0,6
1678061,19,5,1994,10,"male",175,613,455,143,15,0,1,143,14
1678062,28,25,1985,10,"male",122,30,20,6,0,6,0,0,0
1678067,63,2,1950,6,"female",312,45,25,10,18,0,8,10,10
1678087,36,10,1977,6,"male",9,11,8,2,4,2,4,0,0
1678097,24,10,1989,5,"male",149,60,39,124,98,124,69,0,29
1678149,36,11,1977,12,"male",280,45,26,2,1,2,1,0,0
1678161,20,1,1993,12,"male",253,80,65,3,0,3,0,0,0
1678179,23,7,1990,12,"male",707,12,11,2,5,0,3,2,2
1678191,44,26,1969,3,"male",625,723,176,58,370,25,131,33,239
1678196,22,14,1991,4,"male",201,884,538,799,2637,470,1702,329,935
1678207,72,9,1941,4,"female",290,20,12,2,3,0,3,2,0
1678222,40,27,1973,7,"female",90,116,23,3630,898,3630,847,0,51
1678235,27,8,1986,11,"female",299,138,81,13,6,13,4,0,2
1678304,56,24,1957,7,"female",232,62,43,364,291,364,198,0,93
1678308,30,22,1983,12,"female",577,144,109,216,350,216,313,0,37
1678326,24,1,1989,1,"male",438,0,0,0,0,0,0,0,0
1678332,38,22,1975,6,"male",431,1,0,0,0,0,0,0,0
1678346,19,11,1994,10,"female",101,0,0,0,0,0,0,0,0
1678376,40,21,1973,6,"male",239,238,95,2,7,2,5,0,2
1678393,18,6,1995,1,"male",183,56,48,0,1,0,1,0,0
1678396,27,11,1986,11,"male",92,23,15,3,1,0,1,3,0
1678401,17,27,1996,9,"male",459,44,29,49,40,46,30,3,10
1678443,14,3,1999,6,"male",142,172,145,2,0,2,0,0,0
1678444,47,22,1966,10,"female",399,67,53,60,82,60,57,0,25
1678492,23,21,1990,6,"female",57,25,21,1,0,1,0,0,0
1678523,29,5,1984,9,"male",275,46,44,1,0,0,0,1,0
1678530,40,3,1973,12,"male",178,26,24,0,2,0,0,0,2
1678538,47,23,1966,10,"female",1708,460,346,84,208,1,80,83,128
1678540,17,16,1996,7,"male",487,64,35,25,34,25,22,0,12
1678594,53,12,1960,8,"female",225,33,24,29,30,29,9,0,21
1678612,14,26,1999,12,"male",60,53,43,0,0,0,0,0,0
1678614,15,21,1998,8,"male",512,833,667,364,79,362,58,2,21
1678632,58,1,1955,1,"male",1172,50,44,0,0,0,0,0,0
1678686,93,14,1920,11,"female",497,105,72,0,9,0,5,0,4
1678713,31,29,1982,1,"male",1518,52,32,0,1,0,1,0,0
1678715,28,18,1985,11,"male",506,124,58,217,34,217,32,0,2
1678721,70,31,1943,10,"female",73,75,43,676,104,676,76,0,28
1678745,100,13,1913,12,"female",1795,145,18,283,99,164,61,119,38
1678763,76,29,1937,6,"male",271,42,34,0,4,0,0,0,4
1678779,51,15,1962,2,"male",564,286,261,8,6,8,6,0,0
1678786,49,24,1964,12,"female",191,93,26,1,5,1,0,0,5
1678796,50,16,1963,6,"male",2285,110,34,40,66,20,41,20,25
1678798,17,31,1996,5,"female",728,2015,607,3922,5664,1938,3791,1984,1873
1678829,25,7,1988,9,"male",217,76,63,1,1,1,1,0,0
1678839,18,15,1995,3,"male",602,615,372,563,641,563,587,0,54
1678864,28,7,1985,12,"male",101,2,2,1,0,0,0,1,0
1678889,24,5,1989,3,"female",662,1774,364,96,134,96,126,0,8
1678912,57,9,1956,11,"male",107,24,19,3,1,3,1,0,0
1678954,39,3,1974,3,"female",163,40,21,9,46,9,21,0,25
1678958,33,6,1980,4,"male",261,53,49,1,2,1,2,0,0
1678971,26,24,1987,9,"female",462,101,45,103,58,103,32,0,26
1678987,68,19,1945,9,"male",1228,59,21,0,2,0,1,0,1
1678998,62,1,1951,11,"female",1385,26,16,0,0,0,0,0,0
1679028,33,21,1980,12,"male",190,81,43,0,0,0,0,0,0
1679030,35,16,1978,11,"female",627,43,20,204,66,76,23,128,43
1679040,21,23,1992,1,"male",767,86,39,0,0,0,0,0,0
1679083,21,29,1992,2,"female",562,1353,979,308,550,308,333,0,217
1679085,100,7,1913,9,"female",459,71,36,70,3,70,3,0,0
1679177,24,16,1989,2,"male",232,35,16,7,7,7,6,0,1
1679199,104,26,1909,11,"female",1211,1311,291,195,156,182,143,13,13
1679202,104,9,1909,8,"female",538,2043,184,174,271,130,89,44,182
1679218,103,9,1910,7,"female",484,503,165,22,22,22,20,0,2
1679229,27,25,1986,3,"female",986,260,80,0,2,0,2,0,0
1679249,65,17,1948,2,"female",943,90,45,86,34,0,17,86,17
1679253,27,15,1986,5,"male",175,57,52,5,7,5,5,0,2
1679265,50,22,1963,1,"female",999,90,22,106,117,106,83,0,34
1679300,23,10,1990,6,"male",496,62,48,0,5,0,4,0,1
1679301,24,30,1989,10,"female",35,4,1,0,0,0,0,0,0
1679309,53,1,1960,10,"male",190,67,50,0,2,0,1,0,1
1679321,25,13,1988,2,"female",195,6,3,14,27,14,1,0,26
1679360,51,17,1962,7,"male",278,246,162,18,91,4,66,14,25
1679380,24,21,1989,2,"male",421,37,21,0,0,0,0,0,0
1679423,15,25,1998,7,"female",806,440,226,17,142,16,67,1,75
1679425,61,4,1952,6,"female",323,69,30,159,15,0,10,159,5
1679437,22,22,1991,7,"female",393,48,23,1,2,1,1,0,1
1679446,29,3,1984,12,"female",354,115,65,169,121,169,107,0,14
1679451,58,28,1955,10,"male",1058,254,150,5,4,0,0,5,4
1679472,14,2,1999,10,"female",7,0,0,0,0,0,0,0,0
1679477,43,12,1970,9,"male",1169,457,193,1926,684,614,312,1312,372
1679506,34,16,1979,1,"male",486,48,37,0,0,0,0,0,0
1679530,43,13,1970,3,"male",33,33,19,9,9,9,0,0,9
1679536,20,24,1993,7,"female",366,209,79,8,10,6,3,2,7
1679552,18,17,1995,6,"female",563,214,80,17,1,17,1,0,0
1679579,108,1,1905,1,"female",21,11,4,1,7,1,7,0,0
1679616,100,13,1913,4,"male",1752,731,513,123,191,123,131,0,60
1679683,103,10,1910,10,"male",445,8,7,40,0,14,0,26,0
1679684,28,15,1985,6,"male",246,17,10,0,0,0,0,0,0
1679729,29,10,1984,10,"male",646,0,0,0,0,0,0,0,0
1679765,14,6,1999,1,"female",378,212,149,7,4,4,2,3,2
1679779,18,8,1995,1,"male",165,124,39,20,20,8,6,12,14
1679793,45,21,1968,11,"male",91,41,36,0,0,0,0,0,0
1679816,25,1,1988,1,"male",36,24,22,4,2,4,1,0,1
1679820,67,1,1946,6,"male",979,85,41,8,0,0,0,8,0
1679869,108,3,1905,6,"male",1512,656,353,2,1,0,1,2,0
1679873,51,14,1962,9,"female",483,40,27,49,42,49,38,0,4
1679914,58,1,1955,1,"male",903,18,4,10,30,2,10,8,20
1679989,33,29,1980,8,"male",533,85,72,7,1,7,0,0,1
1680013,54,19,1959,7,"male",312,56,25,27,6,27,6,0,0
1680019,23,17,1990,8,"male",566,533,273,63,26,63,20,0,6
1680021,57,5,1956,3,"female",154,53,51,29,9,29,5,0,4
1680023,23,8,1990,5,"female",223,109,56,3,26,2,2,1,24
1680045,25,13,1988,12,"male",432,90,75,3,3,3,3,0,0
1680047,28,20,1985,5,"female",435,1,0,0,0,0,0,0,0
1680063,19,2,1994,3,"female",293,75,33,0,0,0,0,0,0
1680116,47,16,1966,3,"female",638,75,60,45,19,0,13,45,6
1680138,25,5,1988,5,"male",489,41,15,0,0,0,0,0,0
1680150,43,27,1970,10,"male",80,64,53,33,81,33,57,0,24
1680171,77,23,1936,3,"male",311,129,42,35,48,0,7,35,41
1680185,24,29,1989,11,"male",45,49,24,18,32,18,21,0,11
1680204,21,23,1992,7,"male",1159,808,329,2,8,2,5,0,3
1680216,52,3,1961,1,"male",1167,45,5,0,1,0,1,0,0
1680217,23,21,1990,3,"female",580,746,529,19,19,19,14,0,5
1680227,15,19,1998,3,"female",244,701,215,9,39,9,36,0,3
1680228,56,4,1957,8,"male",1583,18,6,0,0,0,0,0,0
1680230,36,4,1977,8,"female",518,104,51,2057,510,2057,225,0,285
1680244,19,29,1994,5,"female",604,192,73,178,246,173,92,5,154
1680305,17,24,1996,9,"male",62,21,8,1,0,1,0,0,0
1680317,44,1,1969,10,"male",956,63,31,7,28,4,22,3,6
1680330,103,2,1910,2,"female",458,439,99,28,20,28,16,0,4
1680342,26,15,1987,10,"male",629,176,136,0,0,0,0,0,0
1680349,54,3,1959,6,"female",439,116,61,27,61,27,28,0,33
1680353,23,13,1990,8,"male",368,95,77,13,3,9,1,4,2
1680361,24,16,1989,6,"female",515,179,134,11,8,11,5,0,3
1680366,21,20,1992,7,"female",971,1208,546,1677,963,1677,864,0,99
1680369,29,17,1984,8,"male",57,1,0,0,0,0,0,0,0
1680372,14,11,1999,1,"female",93,126,102,44,41,37,3,7,38
1680384,18,19,1995,2,"female",284,12,10,0,0,0,0,0,0
1680417,60,19,1953,1,"male",221,30,15,23,60,23,54,0,6
1680433,13,10,2000,3,"female",545,515,274,560,326,436,222,124,104
1680446,25,22,1988,9,"male",126,13,10,33,6,33,4,0,2
1680454,25,1,1988,1,"male",22,33,31,15,8,15,6,0,2
1680478,72,3,1941,7,"female",334,14,10,0,2,0,2,0,0
1680495,20,18,1993,4,"female",293,241,172,17,15,17,13,0,2
1680513,73,16,1940,9,"male",1121,43,13,19,16,18,13,1,3
1680548,28,13,1985,5,"female",429,92,48,5,32,5,32,0,0
1680549,52,5,1961,5,"male",603,239,68,37,23,16,7,21,16
1680551,46,19,1967,1,"male",362,164,130,14,1,14,0,0,1
1680558,16,30,1997,8,"male",310,271,265,9,2,9,2,0,0
1680565,88,12,1925,10,"male",623,421,283,254,210,222,159,32,51
1680601,42,15,1971,10,"male",369,98,42,3,1,0,0,3,1
1680618,68,15,1945,9,"female",48,27,16,0,0,0,0,0,0
1680628,19,31,1994,5,"male",172,24,21,19,0,0,0,19,0
1680642,61,2,1952,6,"female",2145,45,23,39,21,39,10,0,11
1680645,46,16,1967,3,"male",1919,26,13,0,0,0,0,0,0
1680647,86,10,1927,8,"male",1698,252,180,34,36,34,27,0,9
1680654,42,14,1971,11,"female",223,127,47,71,82,71,61,0,21
1680655,55,26,1958,10,"female",116,21,18,173,60,0,26,173,34
1680658,19,12,1994,4,"male",303,1073,993,28,157,28,127,0,30
1680674,103,31,1910,1,"male",769,1174,890,61,29,61,19,0,10
1680677,15,19,1998,5,"male",133,152,80,12,11,7,6,5,5
1680720,31,26,1982,9,"male",154,78,70,92,12,92,6,0,6
1680735,108,10,1905,6,"male",1209,1055,558,67,85,13,75,54,10
1680750,61,10,1952,10,"female",632,19,7,0,0,0,0,0,0
1680752,33,1,1980,12,"male",151,5,0,0,0,0,0,0,0
1680773,59,4,1954,9,"female",1524,949,321,2041,1247,2041,1161,0,86
1680791,38,28,1975,5,"male",328,79,42,136,17,129,4,7,13
1680794,101,1,1912,1,"male",155,284,15,96,356,96,328,0,28
1680821,22,16,1991,3,"male",326,56,33,1,0,1,0,0,0
1680848,24,27,1989,6,"male",536,75,64,36,5,33,4,3,1
1680852,27,17,1986,11,"female",215,162,106,278,274,235,154,43,120
1680862,48,15,1965,9,"female",485,219,81,302,312,131,204,171,108
1680871,108,27,1905,1,"male",401,262,147,6,15,0,3,6,12
1680872,38,4,1975,10,"female",994,118,72,190,165,190,112,0,53
1680877,19,6,1994,4,"female",338,2,1,13,1,10,1,3,0
1680883,20,21,1993,3,"female",149,155,139,248,165,248,64,0,101
1680884,29,15,1984,8,"male",565,325,243,5,1,5,1,0,0
1680909,67,20,1946,9,"female",1742,72,29,40,4,19,2,21,2
1680911,28,1,1985,1,"male",434,20,11,2,1,0,0,2,1
1680918,30,1,1983,12,"female",319,9,5,0,0,0,0,0,0
1680924,45,22,1968,7,"male",541,1,0,0,0,0,0,0,0
1680946,18,23,1995,4,"female",48,20,13,5,15,5,10,0,5
1680960,56,20,1957,1,"male",1068,65,17,4,6,0,5,4,1
1680971,13,4,2000,3,"female",130,817,290,2037,2484,1064,1890,973,594
1680974,25,4,1988,10,"female",382,4,2,0,0,0,0,0,0
1680983,103,28,1910,9,"female",709,291,156,1,25,1,25,0,0
1680984,113,21,1900,5,"male",1199,110,82,65,15,0,4,65,11
1680987,14,30,1999,1,"male",197,141,83,0,9,0,2,0,7
1681032,19,14,1994,1,"male",561,1478,853,9,14,9,14,0,0
1681044,72,31,1941,5,"female",1516,52,38,50,1,50,1,0,0
1681051,61,15,1952,10,"female",300,93,82,151,84,150,42,1,42
1681108,16,7,1997,12,"female",391,244,55,143,72,137,35,6,37
1681120,20,19,1993,10,"female",625,76,49,119,23,119,23,0,0
1681132,28,2,1985,2,"male",243,19,4,67,1,67,1,0,0
1681169,70,30,1943,12,"female",1015,52,19,3,0,3,0,0,0
1681189,26,5,1987,10,"female",226,112,92,64,47,64,17,0,30
1681191,34,12,1979,2,"male",209,60,34,1,0,0,0,1,0
1681201,25,2,1988,10,"female",215,11,10,16,0,16,0,0,0
1681204,39,21,1974,3,"female",603,9,7,29,9,29,9,0,0
1681248,34,25,1979,4,"female",1010,304,198,9,40,9,37,0,3
1681250,13,27,2000,6,"male",336,127,39,3,3,0,2,3,1
1681258,34,7,1979,11,"male",222,31,22,0,0,0,0,0,0
1681292,22,30,1991,4,"female",653,825,206,549,686,171,462,378,224
1681332,103,17,1910,4,"male",520,202,63,5,8,5,6,0,2
1681341,31,30,1982,4,"female",1458,57,20,175,109,169,60,6,49
1681372,59,6,1954,5,"male",1706,227,173,1349,693,677,351,672,342
1681392,26,1,1987,11,"male",336,3,3,4,2,4,0,0,2
1681394,23,2,1990,2,"male",363,62,52,0,5,0,2,0,3
1681396,22,1,1991,12,"female",174,175,146,15,18,1,6,14,12
1681425,16,20,1997,7,"male",233,24,18,1,0,1,0,0,0
1681434,68,2,1945,6,"female",449,76,32,9,23,0,3,9,20
1681474,19,20,1994,4,"male",67,12,7,5,0,1,0,4,0
1681486,21,5,1992,8,"male",220,60,48,8,2,3,1,5,1
1681508,15,16,1998,12,"male",775,528,393,38,14,37,8,1,6
1681521,64,21,1949,10,"female",2202,696,495,1803,1621,1226,950,577,671
1681532,41,15,1972,6,"female",386,85,56,0,4,0,1,0,3
1681544,16,9,1997,6,"male",131,199,190,0,10,0,6,0,4
1681560,26,24,1987,9,"female",264,240,205,13,3,13,2,0,1
1681582,53,15,1960,1,"female",363,357,237,1426,615,748,375,678,240
1681600,24,26,1989,4,"male",224,131,76,38,14,38,2,0,12
1681606,26,7,1987,7,"male",285,59,39,23,54,23,7,0,47
1681621,22,1,1991,1,"female",32,1,0,2,0,2,0,0,0
1681627,23,1,1990,1,"female",423,11,9,4,0,2,0,2,0
1681637,28,26,1985,5,"male",235,135,39,11,43,5,11,6,32
1681666,28,25,1985,3,"male",664,126,92,8,53,8,31,0,22
1681689,21,28,1992,10,"female",398,589,110,328,404,199,259,129,145
1681706,24,5,1989,10,"female",153,25,8,0,0,0,0,0,0
1681707,22,18,1991,12,"male",4,0,0,0,0,0,0,0,0
1681740,32,12,1981,3,"female",476,8,2,4,1,4,1,0,0
1681747,34,3,1979,12,"male",509,154,90,0,0,0,0,0,0
1681753,19,1,1994,8,"male",29,4,3,19,1,19,1,0,0
1681797,48,22,1965,3,"female",221,8,6,4,0,4,0,0,0
1681799,61,26,1952,2,"female",812,62,31,26,8,26,7,0,1
1681805,19,7,1994,12,"male",260,58,41,10,30,10,11,0,19
1681818,58,8,1955,8,"female",957,14,6,1,3,1,1,0,2
1681836,53,18,1960,10,"male",1203,35,11,8,5,0,2,8,3
1681847,83,4,1930,3,"female",471,213,77,9,51,9,32,0,19
1681914,40,15,1973,3,"male",194,0,0,0,0,0,0,0,0
1681945,18,11,1995,12,"male",521,805,440,3,56,3,44,0,12
1681969,51,29,1962,12,"female",843,17,13,44,16,0,0,44,16
1681972,44,4,1969,3,"male",735,2,1,0,0,0,0,0,0
1681983,21,22,1992,6,"male",392,3,2,1,0,0,0,1,0
1681993,16,23,1997,7,"female",211,40,18,21,28,21,3,0,25
1682011,43,20,1970,1,"male",78,69,67,333,30,50,22,283,8
1682033,108,1,1905,1,"male",940,40,34,2,4,1,1,1,3
1682103,73,25,1940,10,"male",68,16,15,10,8,10,8,0,0
1682125,16,20,1997,1,"female",85,382,131,89,243,28,233,61,10
1682156,31,10,1982,6,"male",300,8,8,0,0,0,0,0,0
1682210,25,1,1988,12,"male",61,3,3,0,0,0,0,0,0
1682241,27,25,1986,4,"female",106,7,6,0,0,0,0,0,0
1682244,24,17,1989,11,"male",684,246,138,59,58,59,46,0,12
1682255,64,4,1949,3,"female",1230,67,40,6,2,3,0,3,2
1682256,20,10,1993,2,"female",58,1,0,0,0,0,0,0,0
1682262,19,10,1994,6,"male",560,164,86,447,24,447,24,0,0
1682265,38,16,1975,5,"male",374,6,4,0,1,0,0,0,1
1682287,30,24,1983,8,"female",448,77,39,932,565,5,292,927,273
1682306,20,8,1993,7,"male",417,403,247,44,37,37,33,7,4
1682336,18,26,1995,9,"male",379,269,151,30,29,30,4,0,25
1682347,18,16,1995,6,"male",76,346,307,36,44,14,30,22,14
1682388,22,7,1991,8,"male",65,46,25,0,2,0,1,0,1
1682401,28,3,1985,10,"female",289,428,280,26,104,26,99,0,5
1682408,25,20,1988,1,"male",148,3,2,3,0,0,0,3,0
1682429,73,2,1940,3,"male",1196,917,748,93,121,93,101,0,20
1682454,15,23,1998,3,"female",503,415,185,240,697,177,394,63,303
1682467,23,10,1990,10,"male",59,27,19,2,1,2,1,0,0
1682477,55,26,1958,2,"female",696,18,11,0,1,0,1,0,0
1682478,18,30,1995,6,"female",416,3386,735,733,1557,733,808,0,749
1682496,52,27,1961,12,"female",287,55,32,26,39,26,20,0,19
1682582,45,1,1968,7,"female",311,34,27,1,6,1,5,0,1
1682615,20,28,1993,11,"male",926,1,0,6,1,3,1,3,0
1682623,44,2,1969,7,"female",661,84,72,2,12,0,1,2,11
1682632,21,28,1992,4,"male",248,69,50,0,7,0,4,0,3
1682640,71,12,1942,10,"female",580,51,13,0,0,0,0,0,0
1682673,22,22,1991,10,"female",240,24,10,0,0,0,0,0,0
1682693,21,17,1992,9,"female",537,371,246,804,585,804,517,0,68
1682730,47,20,1966,2,"female",150,24,19,5,10,4,7,1,3
1682745,20,11,1993,7,"female",926,2843,1042,3547,2317,3276,1262,271,1055
1682772,17,14,1996,11,"female",545,218,163,113,63,73,26,40,37
1682780,22,24,1991,11,"male",1114,121,52,34,35,33,31,1,4
1682786,23,5,1990,9,"male",53,33,21,18,21,18,6,0,15
1682796,17,15,1996,9,"male",238,1,1,1,0,1,0,0,0
1682800,47,18,1966,11,"male",247,79,31,32,9,0,1,32,8
1682828,35,18,1978,6,"male",501,167,132,1,0,1,0,0,0
1682839,19,18,1994,12,"male",478,208,118,2,17,0,13,2,4
1682844,53,1,1960,1,"male",1517,96,48,0,2,0,2,0,0
1682860,13,2,2000,4,"female",199,7,7,0,0,0,0,0,0
1682875,26,27,1987,7,"male",57,30,23,30,7,30,6,0,1
1682886,57,11,1956,8,"female",1745,115,47,98,61,80,20,18,41
1682908,26,8,1987,10,"male",85,0,0,0,0,0,0,0,0
1682918,58,15,1955,8,"female",910,45,19,34,13,20,5,14,8
1682943,19,1,1994,4,"male",445,68,22,1,2,0,1,1,1
1682949,50,28,1963,5,"female",390,143,22,24,59,23,32,1,27
1683004,45,2,1968,9,"male",348,67,37,84,50,3,24,81,26
1683006,17,13,1996,7,"male",273,182,89,0,29,0,25,0,4
1683012,48,17,1965,6,"female",383,64,33,45,64,1,35,44,29
1683023,21,23,1992,9,"male",527,1726,1381,47,157,47,146,0,11
1683033,33,9,1980,8,"male",448,138,106,0,30,0,28,0,2
1683056,21,30,1992,10,"male",580,53,50,0,6,0,1,0,5
1683102,17,26,1996,5,"male",151,22,15,7,0,7,0,0,0
1683116,45,21,1968,12,"female",322,5,5,0,0,0,0,0,0
1683150,108,11,1905,6,"male",1779,426,299,787,912,86,492,701,420
1683151,37,3,1976,11,"male",60,80,74,194,141,37,64,157,77
1683163,17,3,1996,1,"male",698,559,372,332,60,36,14,296,46
1683167,18,1,1995,1,"male",287,106,65,33,3,10,1,23,2
1683181,69,4,1944,4,"male",744,28,15,0,0,0,0,0,0
1683185,29,30,1984,5,"male",897,17,17,1,0,1,0,0,0
1683186,55,28,1958,2,"female",288,11,3,3,0,3,0,0,0
1683203,30,21,1983,4,"male",1270,28,23,0,0,0,0,0,0
1683204,19,29,1994,11,"female",679,510,345,1038,126,1038,84,0,42
1683228,36,28,1977,4,"male",215,32,14,0,3,0,3,0,0
1683236,15,1,1998,12,"male",736,288,127,22,36,22,33,0,3
1683274,61,12,1952,2,"female",453,1,1,0,0,0,0,0,0
1683299,24,13,1989,7,"male",565,96,68,24,43,24,31,0,12
1683313,18,12,1995,10,"male",239,338,281,116,141,67,39,49,102
1683349,66,1,1947,1,"male",694,62,44,2,9,1,6,1,3
1683384,23,10,1990,7,"female",285,16,12,0,0,0,0,0,0
1683387,20,14,1993,2,"male",587,216,40,166,147,166,130,0,17
1683407,54,4,1959,6,"female",355,17,8,1,1,1,1,0,0
1683434,19,6,1994,6,"female",485,226,91,0,0,0,0,0,0
1683435,18,7,1995,12,"male",136,24,12,1,1,1,1,0,0
1683438,32,31,1981,10,"male",235,92,51,0,1,0,0,0,1
1683439,28,12,1985,12,"male",573,1,1,0,0,0,0,0,0
1683476,43,24,1970,8,"male",372,1,0,17,18,0,0,17,18
1683481,50,8,1963,1,"female",1953,933,737,657,943,19,365,638,578
1683489,22,22,1991,3,"male",651,67,50,76,142,44,104,32,38
1683493,61,5,1952,1,"male",1731,39,20,0,0,0,0,0,0
1683494,37,14,1976,7,"male",345,69,29,3,1,2,1,1,0
1683511,25,30,1988,9,"female",318,132,79,216,168,20,85,196,83
1683516,39,11,1974,10,"male",309,8,3,7,1,7,0,0,1
1683531,23,31,1990,1,"female",320,6,6,15,2,0,1,15,1
1683541,28,10,1985,12,"female",23,21,17,1,19,1,17,0,2
1683551,108,19,1905,6,"male",1581,350,218,42,28,0,8,42,20
1683579,16,7,1997,3,"male",534,4,3,1,0,1,0,0,0
1683580,20,18,1993,10,"female",268,25,8,22,22,0,15,22,7
1683610,48,8,1965,3,"female",566,113,44,14,12,2,3,12,9
1683621,47,12,1966,4,"female",736,44,23,55,54,55,46,0,8
1683630,36,25,1977,9,"male",272,56,7,0,4,0,1,0,3
1683635,23,12,1990,12,"male",536,113,76,2,2,2,2,0,0
1683656,18,26,1995,11,"female",172,167,84,480,173,480,108,0,65
1683659,18,26,1995,5,"male",321,15,12,0,0,0,0,0,0
1683673,34,6,1979,11,"female",535,16,4,0,0,0,0,0,0
1683677,32,27,1981,1,"female",220,21,20,20,78,12,59,8,19
1683684,23,7,1990,5,"male",320,10,9,17,64,17,10,0,54
1683695,75,23,1938,8,"female",1551,54,31,41,0,40,0,1,0
1683707,16,22,1997,11,"female",486,475,242,149,100,134,87,15,13
1683710,51,8,1962,10,"male",132,11,6,25,0,25,0,0,0
1683728,44,9,1969,10,"male",699,63,42,12,19,12,17,0,2
1683735,26,2,1987,6,"male",313,25,17,39,19,39,19,0,0
1683737,32,15,1981,6,"male",269,92,29,54,55,54,22,0,33
1683779,46,17,1967,4,"male",20,3,3,14,8,14,8,0,0
1683790,61,19,1952,12,"male",209,0,0,0,0,0,0,0,0
1683805,61,15,1952,8,"male",1232,35,13,3,15,3,9,0,6
1683823,16,19,1997,11,"male",303,200,127,13,2,1,0,12,2
1683827,16,22,1997,7,"male",463,4,1,0,0,0,0,0,0
1683830,17,8,1996,10,"male",202,7,5,0,0,0,0,0,0
1683843,32,10,1981,10,"male",383,280,252,186,45,186,44,0,1
1683880,60,21,1953,4,"male",671,121,80,0,0,0,0,0,0
1683889,43,10,1970,8,"female",472,8,5,3,0,1,0,2,0
1683890,64,15,1949,10,"male",86,39,21,58,41,48,20,10,21
1683895,39,9,1974,6,"male",56,288,216,5,8,5,6,0,2
1683900,57,30,1956,6,"female",979,61,32,248,129,235,71,13,58
1683908,20,13,1993,11,"female",31,38,29,2,17,2,12,0,5
1683921,29,4,1984,8,"female",820,87,13,86,82,84,78,2,4
1683923,18,6,1995,4,"male",397,353,223,206,62,201,43,5,19
1683926,54,23,1959,4,"female",572,137,76,11,37,0,9,11,28
1683966,98,1,1915,1,"male",168,92,92,10,1,10,0,0,1
1683986,28,6,1985,10,"male",426,297,268,22,193,22,33,0,160
1684027,19,2,1994,10,"male",287,187,125,208,62,205,34,3,28
1684029,27,26,1986,7,"male",212,277,236,55,3,39,3,16,0
1684055,20,28,1993,6,"male",457,260,101,71,6,71,6,0,0
1684066,100,12,1913,8,"female",940,35,13,46,6,46,4,0,2
1684070,49,7,1964,9,"female",261,41,26,112,65,112,53,0,12
1684107,58,16,1955,12,"female",937,95,47,109,22,8,12,101,10
1684110,55,6,1958,4,"female",1121,72,47,16,14,0,1,16,13
1684132,25,15,1988,11,"male",724,363,221,0,0,0,0,0,0
1684133,56,29,1957,12,"female",865,6,2,4,2,4,1,0,1
1684157,20,29,1993,1,"female",274,508,61,115,452,115,358,0,94
1684159,56,6,1957,1,"male",222,40,30,3,3,3,3,0,0
1684177,68,2,1945,12,"female",977,3025,945,17,186,17,138,0,48
1684195,33,8,1980,7,"female",447,412,294,152,243,152,190,0,53
1684204,43,29,1970,3,"female",416,81,68,214,35,214,35,0,0
1684225,48,23,1965,6,"male",477,144,129,8,1,8,1,0,0
1684229,36,15,1977,6,"male",450,22,15,0,0,0,0,0,0
1684255,15,20,1998,8,"female",117,305,98,59,172,57,141,2,31
1684262,19,23,1994,2,"female",448,412,197,225,167,112,79,113,88
1684286,48,20,1965,8,"female",604,85,37,20,13,20,13,0,0
1684288,19,6,1994,12,"male",243,0,0,0,0,0,0,0,0
1684299,18,17,1995,8,"male",226,310,246,117,153,54,36,63,117
1684323,15,11,1998,4,"male",213,178,94,21,14,0,2,21,12
1684325,20,10,1993,9,"female",955,31,22,0,0,0,0,0,0
1684326,14,4,1999,4,"female",305,66,50,187,6,176,3,11,3
1684354,25,1,1988,1,"male",163,38,29,67,19,67,18,0,1
1684370,35,28,1978,4,"male",845,335,159,56,61,56,46,0,15
1684411,45,6,1968,3,"female",324,28,18,1,1,1,1,0,0
1684420,17,20,1996,3,"female",1270,1458,1039,5494,4388,1400,1974,4094,2414
1684425,33,27,1980,8,"female",788,104,70,324,1179,226,970,98,209
1684441,61,25,1952,3,"female",462,15,6,16,22,0,14,16,8
1684444,33,14,1980,12,"male",522,43,18,45,43,36,24,9,19
1684469,24,25,1989,3,"male",64,18,17,1,0,1,0,0,0
1684470,21,28,1992,10,"male",156,20,16,5,5,5,3,0,2
1684484,43,12,1970,12,"male",461,96,65,3,9,3,7,0,2
1684491,52,21,1961,12,"male",228,10,4,7,0,7,0,0,0
1684508,24,23,1989,10,"male",538,24,11,151,29,151,28,0,1
1684520,60,30,1953,3,"female",1070,126,16,544,265,535,43,9,222
1684524,26,25,1987,7,"male",657,275,92,0,1,0,0,0,1
1684538,24,25,1989,8,"male",156,428,250,157,69,154,56,3,13
1684547,39,13,1974,1,"female",736,18,7,7,5,7,5,0,0
1684569,28,25,1985,6,"male",378,34,19,0,39,0,14,0,25
1684572,20,1,1993,9,"male",234,234,98,0,1,0,1,0,0
1684582,21,28,1992,8,"male",441,236,185,1,1,1,1,0,0
1684585,24,1,1989,1,"male",226,8,6,1,0,1,0,0,0
1684591,25,20,1988,7,"male",287,26,5,0,0,0,0,0,0
1684611,20,10,1993,7,"male",336,93,83,0,0,0,0,0,0
1684618,16,17,1997,11,"male",347,507,466,3,4,3,3,0,1
1684626,43,26,1970,2,"male",623,20,17,0,3,0,1,0,2
1684649,26,1,1987,1,"male",180,3,3,0,0,0,0,0,0
1684654,27,11,1986,3,"male",165,71,57,4,13,1,8,3,5
1684657,26,17,1987,1,"female",290,287,187,42,78,42,62,0,16
1684665,30,24,1983,9,"male",485,250,209,2,2,0,1,2,1
1684670,22,25,1991,4,"female",1392,285,79,1,2,1,0,0,2
1684680,16,25,1997,3,"female",397,522,323,1500,373,1461,220,39,153
1684687,45,28,1968,7,"male",970,156,93,0,0,0,0,0,0
1684695,19,3,1994,12,"male",543,206,57,20,47,20,24,0,23
1684697,39,21,1974,10,"male",832,85,27,0,1,0,1,0,0
1684704,30,6,1983,2,"male",203,201,141,19,90,9,48,10,42
1684717,26,22,1987,12,"male",1153,635,572,16,8,16,4,0,4
1684726,90,1,1923,10,"male",381,96,39,0,0,0,0,0,0
1684728,61,1,1952,7,"female",1230,39,20,70,65,0,39,70,26
1684746,69,14,1944,7,"female",442,13,2,20,1,16,1,4,0
1684754,18,5,1995,9,"male",62,32,29,0,5,0,2,0,3
1684786,40,13,1973,8,"male",788,94,81,2,6,2,0,0,6
1684830,20,19,1993,12,"male",221,4,1,5,0,5,0,0,0
1684833,27,20,1986,6,"male",258,29,17,0,2,0,2,0,0
1684840,17,13,1996,5,"female",272,71,22,197,9,52,1,145,8
1684878,41,21,1972,10,"female",657,32,15,0,2,0,2,0,0
1684885,54,3,1959,4,"male",781,86,56,5,3,0,0,5,3
1684887,18,31,1995,12,"male",400,408,393,69,17,2,10,67,7
1684940,24,23,1989,5,"male",650,103,86,0,0,0,0,0,0
1684943,51,11,1962,9,"female",640,41,34,91,34,4,5,87,29
1684948,52,4,1961,9,"male",1725,67,16,44,35,44,30,0,5
1684975,26,23,1987,10,"female",674,23,3,5,30,5,17,0,13
1684986,19,15,1994,11,"female",650,177,58,233,56,233,52,0,4
1685003,26,12,1987,12,"male",423,203,155,488,181,488,171,0,10
1685026,33,1,1980,1,"male",69,11,10,25,0,25,0,0,0
1685034,24,21,1989,11,"female",163,115,73,122,29,122,15,0,14
1685060,66,28,1947,5,"female",792,370,145,99,120,0,67,99,53
1685065,23,22,1990,5,"male",563,69,31,5,6,0,5,5,1
1685078,33,11,1980,12,"male",188,36,29,2,1,0,0,2,1
1685123,18,15,1995,7,"male",36,51,45,24,12,3,3,21,9
1685134,29,1,1984,1,"male",282,27,27,0,0,0,0,0,0
1685163,16,16,1997,3,"male",127,40,35,7,32,7,26,0,6
1685170,17,21,1996,3,"male",366,32,28,0,0,0,0,0,0
1685172,25,22,1988,2,"male",352,2,1,0,0,0,0,0,0
1685187,73,23,1940,7,"male",1233,65,38,746,43,0,23,746,20
1685245,15,20,1998,9,"female",163,363,221,36,167,31,105,5,62
1685252,13,19,2000,1,"male",257,32,23,1,0,0,0,1,0
1685264,26,1,1987,1,"male",383,2,0,0,0,0,0,0,0
1685283,65,22,1948,4,"male",1317,23,11,0,0,0,0,0,0
1685286,15,19,1998,11,"male",477,893,837,180,201,149,121,31,80
1685310,20,2,1993,2,"female",251,249,18,0,5,0,5,0,0
1685336,37,30,1976,5,"male",372,7,0,2,2,0,0,2,2
1685350,18,29,1995,7,"male",191,137,123,1,1,1,1,0,0
1685371,28,16,1985,1,"male",296,60,41,31,50,0,31,31,19
1685373,34,19,1979,2,"male",77,124,103,185,22,185,22,0,0
1685387,14,4,1999,6,"male",372,94,72,0,1,0,1,0,0
1685413,15,19,1998,11,"male",47,20,16,5,1,5,1,0,0
1685433,20,30,1993,12,"male",624,305,234,17,59,8,46,9,13
1685451,32,21,1981,7,"male",815,140,66,8,0,8,0,0,0
1685461,39,10,1974,4,"male",759,202,182,9,1,9,1,0,0
1685471,37,25,1976,3,"male",687,6,2,0,0,0,0,0,0
1685497,16,12,1997,1,"male",230,87,23,1,0,1,0,0,0
1685500,21,26,1992,5,"male",497,135,58,10,36,10,29,0,7
1685507,77,4,1936,4,"female",1562,16,2,20,0,0,0,20,0
1685522,74,6,1939,2,"male",827,34,25,1,15,0,14,1,1
1685573,33,19,1980,4,"female",313,11,9,40,0,40,0,0,0
1685598,17,20,1996,5,"male",429,887,571,238,10,68,4,170,6
1685605,21,8,1992,4,"male",529,43,21,6,1,0,0,6,1
1685615,45,25,1968,7,"male",837,16,9,13,3,0,3,13,0
1685626,100,8,1913,7,"female",1607,255,144,38,37,32,11,6,26
1685644,50,22,1963,7,"male",268,9,6,7,0,0,0,7,0
1685680,21,22,1992,8,"male",204,43,36,13,39,12,28,1,11
1685685,47,20,1966,10,"male",392,18,6,20,80,0,8,20,72
1685701,19,1,1994,1,"male",39,10,10,1,0,0,0,1,0
1685710,21,23,1992,11,"female",589,821,319,643,1585,200,674,443,911
1685711,29,2,1984,3,"male",398,7,4,0,0,0,0,0,0
1685752,20,13,1993,6,"male",332,3,3,0,0,0,0,0,0
1685761,72,27,1941,5,"female",1776,59,26,33,5,10,3,23,2
1685765,19,17,1994,4,"female",333,994,422,15,68,15,63,0,5
1685801,18,3,1995,3,"male",192,43,41,0,0,0,0,0,0
1685804,25,2,1988,8,"male",670,1290,1105,2,16,2,12,0,4
1685812,108,9,1905,2,"male",1689,120,62,3,1,0,0,3,1
1685830,17,16,1996,1,"male",50,8,6,1,1,1,1,0,0
1685858,20,9,1993,1,"male",345,164,105,45,22,45,15,0,7
1685860,65,26,1948,10,"female",441,60,56,7,36,0,21,7,15
1685889,25,6,1988,9,"female",47,23,20,1,1,1,1,0,0
1685931,34,3,1979,10,"male",195,10,6,0,2,0,0,0,2
1685932,20,11,1993,3,"male",365,426,278,406,186,406,180,0,6
1685943,31,16,1982,7,"female",522,206,146,111,405,83,127,28,278
1685952,24,1,1989,1,"male",21,3,2,5,0,5,0,0,0
1685966,25,13,1988,2,"male",677,154,53,0,2,0,0,0,2
1685970,23,27,1990,1,"male",1159,280,172,0,0,0,0,0,0
1685996,18,13,1995,6,"female",389,198,120,6,83,6,52,0,31
1686001,14,3,1999,2,"female",252,391,82,57,107,57,97,0,10
1686002,25,1,1988,1,"male",39,38,31,39,27,39,27,0,0
1686006,59,1,1954,11,"female",871,57,33,3,4,0,1,3,3
1686018,27,2,1986,3,"male",246,0,0,0,0,0,0,0,0
1686025,16,24,1997,5,"male",877,97,74,0,1,0,0,0,1
1686047,15,8,1998,10,"male",543,81,53,142,100,142,71,0,29
1686052,20,18,1993,10,"male",14,24,22,0,0,0,0,0,0
1686074,52,25,1961,8,"female",442,1,1,4,0,4,0,0,0
1686076,14,2,1999,4,"male",283,94,12,11,1,8,0,3,1
1686094,15,9,1998,9,"male",146,127,77,120,4,120,4,0,0
1686097,18,18,1995,8,"male",226,65,20,16,3,0,2,16,1
1686098,46,1,1967,12,"female",417,1,1,0,0,0,0,0,0
1686109,14,20,1999,6,"female",410,289,226,504,184,504,149,0,35
1686119,24,8,1989,8,"male",413,135,87,7,7,7,7,0,0
1686120,76,10,1937,12,"male",1014,22,13,1,0,1,0,0,0
1686127,43,25,1970,8,"female",1052,57,27,1693,399,1581,285,112,114
1686195,56,1,1957,1,"male",178,235,194,9,5,0,0,9,5
1686233,20,6,1993,2,"male",365,267,147,13,195,13,150,0,45
1686238,80,13,1933,2,"male",265,141,70,54,134,0,40,54,94
1686245,17,20,1996,7,"male",585,273,187,0,0,0,0,0,0
1686249,91,17,1922,4,"female",1080,163,36,1,5,1,3,0,2
1686277,28,9,1985,2,"male",896,19,17,0,0,0,0,0,0
1686288,26,1,1987,1,"female",213,18,11,2061,3547,1,1458,2060,2089
1686298,65,11,1948,8,"male",1400,40,14,6,34,6,6,0,28
1686308,46,28,1967,2,"male",955,135,100,17,18,17,16,0,2
1686372,28,9,1985,12,"female",339,35,34,2,0,1,0,1,0
1686375,106,18,1907,2,"female",2712,514,120,14,1,9,1,5,0
1686394,63,1,1950,3,"male",1612,157,97,35,55,0,9,35,46
1686398,25,5,1988,1,"female",111,86,69,166,33,166,24,0,9
1686423,108,21,1905,3,"female",1483,109,64,1676,486,1552,377,124,109
1686449,23,10,1990,5,"female",393,110,14,0,0,0,0,0,0
1686457,23,18,1990,7,"male",268,314,268,96,150,43,94,53,56
1686473,23,31,1990,8,"male",28,13,9,26,17,20,14,6,3
1686487,21,10,1992,3,"female",599,900,549,1907,951,1707,547,200,404
1686542,20,19,1993,1,"female",329,97,64,22,19,8,15,14,4
1686578,61,6,1952,2,"female",1862,284,208,271,259,2,35,269,224
1686615,77,28,1936,10,"female",22,34,22,11,20,0,4,11,16
1686628,53,1,1960,10,"female",264,23,14,2,1,0,0,2,1
1686633,28,25,1985,10,"male",868,358,173,8,35,8,10,0,25
1686638,31,24,1982,4,"female",1,1,1,0,0,0,0,0,0
1686646,16,9,1997,3,"male",104,50,38,1,0,1,0,0,0
1686692,45,15,1968,3,"female",551,61,40,217,1,217,1,0,0
1686735,98,15,1915,11,"female",723,3,2,109,0,0,0,109,0
1686752,19,16,1994,11,"female",435,435,107,336,421,195,243,141,178
1686755,32,12,1981,12,"female",197,41,16,385,102,385,49,0,53
1686767,19,15,1994,5,"male",1083,114,43,3,0,0,0,3,0
1686771,20,25,1993,5,"male",129,62,34,0,0,0,0,0,0
1686784,56,28,1957,5,"male",531,22,20,55,4,55,3,0,1
1686785,81,23,1932,5,"female",1090,38,34,1,1,0,1,1,0
1686791,17,20,1996,3,"female",918,397,207,242,272,242,195,0,77
1686792,27,13,1986,2,"male",16,22,12,109,14,74,11,35,3
1686794,108,16,1905,8,"female",481,28,25,20,8,19,6,1,2
1686811,37,15,1976,4,"male",1174,98,41,14,2,14,2,0,0
1686847,33,30,1980,6,"male",249,38,19,1,3,1,2,0,1
1686877,31,8,1982,6,"male",43,19,10,59,29,59,17,0,12
1686903,19,17,1994,4,"male",405,192,96,36,9,0,3,36,6
1686949,68,5,1945,6,"female",224,105,51,25,51,25,26,0,25
1686973,60,10,1953,9,"male",539,171,33,3,48,3,20,0,28
1686977,20,1,1993,1,"female",322,56,20,4,5,4,5,0,0
1686997,36,1,1977,1,"female",333,62,34,187,44,187,41,0,3
1687005,64,11,1949,3,"male",1331,737,352,7,12,0,5,7,7
1687006,30,24,1983,5,"female",377,93,37,9,20,9,13,0,7
1687024,22,20,1991,10,"female",703,65,24,0,0,0,0,0,0
1687041,35,28,1978,12,"male",393,55,44,0,0,0,0,0,0
1687066,38,8,1975,9,"male",792,8,7,7,11,7,6,0,5
1687094,113,13,1900,4,"male",1731,789,396,6,0,0,0,6,0
1687131,16,10,1997,6,"female",623,4524,1999,370,2459,152,2035,218,424
1687136,61,11,1952,9,"female",84,21,19,1,0,0,0,1,0
1687142,19,14,1994,8,"female",337,21,3,31,16,31,4,0,12
1687150,16,22,1997,3,"male",22,9,8,5,1,5,1,0,0
1687158,51,19,1962,1,"female",473,89,65,19,0,1,0,18,0
1687159,23,2,1990,8,"male",16,71,52,2,19,2,19,0,0
1687166,22,18,1991,3,"female",173,4,3,0,0,0,0,0,0
1687167,39,1,1974,3,"male",362,2,1,0,0,0,0,0,0
1687170,67,28,1946,9,"female",538,14,5,0,0,0,0,0,0
1687178,71,30,1942,11,"male",900,73,67,4,2,4,0,0,2
1687183,34,30,1979,10,"female",232,138,102,142,42,4,28,138,14
1687197,68,9,1945,11,"male",614,46,30,11,1,0,0,11,1
1687208,21,23,1992,1,"male",1242,1516,1230,61,264,55,189,6,75
1687220,15,22,1998,9,"female",350,118,87,0,0,0,0,0,0
1687260,21,10,1992,1,"male",555,46,16,0,0,0,0,0,0
1687270,18,7,1995,1,"male",13,15,14,1,1,1,1,0,0
1687277,19,17,1994,7,"male",421,90,52,44,52,29,23,15,29
1687306,100,23,1913,2,"female",1854,141,63,71,50,60,37,11,13
1687308,57,27,1956,7,"male",657,29,11,1,1,0,1,1,0
1687318,69,12,1944,11,"female",1831,723,282,375,1096,256,510,119,586
1687319,46,26,1967,5,"male",284,28,20,1,0,1,0,0,0
1687347,71,13,1942,5,"female",1828,112,57,16,0,3,0,13,0
1687352,18,27,1995,12,"male",274,295,245,4,0,0,0,4,0
1687354,74,1,1939,2,"female",1590,87,23,191,35,191,20,0,15
1687355,19,24,1994,8,"male",227,1079,874,2225,2517,588,1215,1637,1302
1687361,18,10,1995,2,"male",463,538,252,201,197,201,102,0,95
1687366,18,6,1995,3,"female",51,67,45,448,212,438,131,10,81
1687397,71,19,1942,4,"male",1543,19,6,19,1,14,0,5,1
1687420,16,27,1997,1,"female",552,627,334,286,295,268,88,18,207
1687424,26,22,1987,7,"male",254,1,1,0,0,0,0,0,0
1687455,27,29,1986,5,"male",303,1,0,0,0,0,0,0,0
1687469,26,3,1987,6,"male",991,299,184,15,3,3,2,12,1
1687473,30,29,1983,3,"female",508,54,12,52,28,52,24,0,4
1687479,28,5,1985,10,"female",531,192,92,192,256,33,51,159,205
1687489,37,2,1976,2,"female",874,37,22,0,1,0,1,0,0
1687492,18,9,1995,8,"female",423,142,65,53,11,48,11,5,0
1687494,25,13,1988,3,"male",276,90,56,4,0,4,0,0,0
1687509,103,21,1910,10,"male",723,208,147,0,5,0,1,0,4
1687515,57,1,1956,12,"male",570,0,0,0,0,0,0,0,0
1687519,24,21,1989,1,"male",222,22,14,11,11,0,1,11,10
1687530,18,18,1995,7,"male",15,0,0,0,1,0,0,0,1
1687546,19,18,1994,11,"female",179,242,87,559,210,391,122,168,88
1687563,15,26,1998,12,"female",241,3532,269,1202,3676,1149,3348,53,328
1687580,59,30,1954,11,"male",1082,100,70,70,4,0,1,70,3
1687588,18,5,1995,4,"female",567,137,52,1659,1078,1,139,1658,939
1687614,14,9,1999,12,"female",91,77,39,6,12,6,8,0,4
1687632,45,25,1968,7,"female",395,132,120,72,2,70,1,2,1
1687636,30,3,1983,10,"male",56,0,0,0,0,0,0,0,0
1687642,18,22,1995,3,"male",363,42,35,18,0,18,0,0,0
1687653,57,16,1956,6,"female",827,433,410,14,80,14,75,0,5
1687668,73,1,1940,11,"female",873,163,121,9,8,0,5,9,3
1687670,30,9,1983,7,"male",191,346,296,11,7,11,7,0,0
1687685,18,12,1995,8,"male",546,113,99,11,16,11,13,0,3
1687699,20,27,1993,2,"male",100,109,101,399,79,399,63,0,16
1687711,28,3,1985,9,"male",658,150,124,1,7,1,4,0,3
1687754,21,10,1992,12,"male",407,143,76,7,2,7,2,0,0
1687764,50,3,1963,6,"female",903,66,34,5,7,5,5,0,2
1687808,18,20,1995,6,"female",184,43,24,53,23,53,7,0,16
1687860,24,5,1989,7,"female",729,1139,762,440,265,440,230,0,35
1687865,32,29,1981,11,"male",615,90,80,7,49,0,21,7,28
1687868,23,7,1990,8,"male",0,0,0,0,0,0,0,0,0
1687880,32,29,1981,4,"male",472,105,76,7,1,5,1,2,0
1687892,23,15,1990,12,"female",1496,502,235,162,1044,24,522,138,522
1687897,41,16,1972,12,"female",580,269,132,211,76,211,60,0,16
1687917,31,16,1982,5,"male",292,3,3,32,0,32,0,0,0
1687924,25,8,1988,2,"male",651,188,99,97,13,97,8,0,5
1687933,83,8,1930,12,"male",760,384,300,11,2,11,0,0,2
1687969,53,22,1960,8,"male",422,22,14,1,1,0,0,1,1
1687985,39,9,1974,11,"female",1924,348,153,642,461,241,222,401,239
1687992,47,5,1966,9,"female",444,99,48,145,66,145,50,0,16
1687994,52,7,1961,8,"male",340,692,340,469,725,413,350,56,375
1688003,26,8,1987,6,"male",475,131,50,6,30,6,27,0,3
1688010,36,23,1977,3,"male",29,68,63,20,3,20,3,0,0
1688023,14,21,1999,3,"male",129,3,2,0,0,0,0,0,0
1688057,20,24,1993,1,"male",257,197,103,3,1,1,1,2,0
1688098,24,14,1989,3,"female",190,100,94,0,0,0,0,0,0
1688107,16,1,1997,10,"female",70,105,57,46,1,46,1,0,0
1688127,96,17,1917,8,"male",1319,89,41,0,1,0,1,0,0
1688160,31,22,1982,6,"male",402,157,127,497,721,440,362,57,359
1688170,46,1,1967,1,"female",262,44,17,53,14,53,12,0,2
1688190,31,5,1982,11,"female",235,1,0,3,0,3,0,0,0
1688210,29,8,1984,2,"male",362,14,4,0,0,0,0,0,0
1688223,16,14,1997,3,"male",294,124,118,3,4,3,2,0,2
1688246,28,7,1985,8,"male",272,33,18,0,0,0,0,0,0
1688269,74,9,1939,11,"female",1048,55,23,75,8,73,5,2,3
1688277,48,12,1965,6,"female",458,158,115,110,133,94,59,16,74
1688283,49,9,1964,10,"female",951,9,5,44,1,44,0,0,1
1688285,18,15,1995,2,"male",311,479,266,210,80,210,71,0,9
1688300,108,10,1905,6,"male",1028,50,19,37,34,37,28,0,6
1688333,19,28,1994,8,"male",288,56,47,0,0,0,0,0,0
1688410,16,3,1997,3,"female",487,384,275,1247,1209,124,665,1123,544
1688412,61,30,1952,3,"female",318,71,42,327,154,0,68,327,86
1688426,102,21,1911,9,"male",1402,181,98,130,23,125,19,5,4
1688467,23,1,1990,3,"female",1007,40,31,2,0,2,0,0,0
1688481,23,22,1990,11,"male",313,8,3,1,1,0,0,1,1
1688494,32,22,1981,3,"male",13,1,1,0,0,0,0,0,0
1688520,24,1,1989,3,"female",146,114,21,2,7,2,1,0,6
1688526,59,16,1954,8,"female",1550,160,47,51,8,51,6,0,2
1688544,29,3,1984,5,"male",17,14,13,1,5,1,5,0,0
1688546,26,4,1987,1,"male",333,103,51,0,0,0,0,0,0
1688558,58,30,1955,3,"male",1231,6,4,0,0,0,0,0,0
1688565,34,3,1979,12,"female",1414,464,354,602,349,374,284,228,65
1688574,61,1,1952,3,"male",159,49,25,1,3,1,1,0,2
1688578,32,9,1981,3,"male",666,27,22,3,7,3,6,0,1
1688615,59,9,1954,1,"female",1384,141,30,58,61,38,19,20,42
1688616,20,6,1993,1,"male",27,0,0,0,0,0,0,0,0
1688630,29,8,1984,1,"male",88,20,17,1,6,0,0,1,6
1688644,35,24,1978,6,"female",33,76,28,224,327,174,186,50,141
1688671,21,20,1992,9,"female",558,88,41,0,5,0,1,0,4
1688697,34,11,1979,12,"male",481,66,44,0,0,0,0,0,0
1688703,25,10,1988,10,"male",341,124,48,684,520,684,422,0,98
1688708,68,20,1945,4,"male",19,3,3,1,0,0,0,1,0
1688714,18,21,1995,11,"female",303,100,62,125,35,125,14,0,21
1688723,27,22,1986,12,"male",168,48,39,0,26,0,15,0,11
1688736,37,14,1976,9,"male",557,3,2,0,4,0,0,0,4
1688738,24,1,1989,1,"male",269,96,25,1,1,0,0,1,1
1688764,13,15,2000,2,"female",280,72,51,13,61,0,18,13,43
1688769,50,9,1963,9,"male",412,29,16,510,181,510,143,0,38
1688771,16,5,1997,10,"male",46,34,29,6,10,5,7,1,3
1688772,19,10,1994,9,"female",427,656,337,34,311,31,234,3,77
1688802,17,11,1996,7,"male",789,148,64,28,1,28,1,0,0
1688812,22,25,1991,4,"male",260,129,68,19,0,0,0,19,0
1688828,22,14,1991,8,"male",512,33,16,13,3,13,2,0,1
1688856,73,11,1940,4,"male",1391,120,27,1,118,0,90,1,28
1688891,15,12,1998,1,"female",272,1491,327,376,358,376,308,0,50
1688899,23,4,1990,2,"male",343,109,99,0,0,0,0,0,0
1688912,28,4,1985,4,"male",324,65,32,6,33,0,23,6,10
1688929,18,9,1995,12,"male",5,3,2,1,0,1,0,0,0
1688955,50,8,1963,6,"male",607,146,72,383,227,383,113,0,114
1688956,26,31,1987,1,"female",40,39,29,2,0,2,0,0,0
1688963,21,12,1992,6,"male",331,207,153,0,0,0,0,0,0
1689015,26,1,1987,1,"male",488,3,2,0,0,0,0,0,0
1689033,30,20,1983,7,"male",113,30,13,0,0,0,0,0,0
1689069,20,7,1993,9,"female",904,115,21,7,18,7,17,0,1
1689097,17,8,1996,2,"male",530,400,353,0,0,0,0,0,0
1689105,65,3,1948,8,"male",389,107,71,27,210,0,38,27,172
1689109,45,29,1968,9,"male",470,136,100,132,142,105,65,27,77
1689121,62,6,1951,3,"male",433,5,3,0,0,0,0,0,0
1689142,23,18,1990,8,"male",297,62,39,3,8,2,7,1,1
1689199,19,13,1994,10,"female",143,23,7,2,10,2,8,0,2
1689205,28,10,1985,9,"male",103,18,13,0,0,0,0,0,0
1689207,48,23,1965,12,"female",839,233,107,1552,1420,1458,653,94,767
1689228,45,11,1968,9,"male",272,2,2,0,0,0,0,0,0
1689232,16,13,1997,11,"female",660,4279,612,299,4278,299,3789,0,489
1689249,15,27,1998,12,"male",484,208,128,23,53,21,19,2,34
1689268,22,19,1991,2,"male",396,143,91,3,3,3,3,0,0
1689311,27,5,1986,10,"female",283,111,75,217,466,212,198,5,268
1689312,24,30,1989,1,"female",218,118,66,99,182,70,73,29,109
1689315,16,15,1997,12,"male",369,135,85,37,54,0,20,37,34
1689345,69,28,1944,11,"male",1227,29,13,14,14,0,6,14,8
1689348,29,23,1984,9,"male",143,86,65,0,0,0,0,0,0
1689361,36,19,1977,10,"male",239,114,80,116,117,113,85,3,32
1689421,36,1,1977,1,"male",66,29,28,107,3,107,3,0,0
1689439,20,27,1993,9,"female",462,100,39,4,1,4,0,0,1
1689462,17,13,1996,9,"male",289,178,105,3,24,3,23,0,1
1689482,18,1,1995,1,"male",78,22,19,0,0,0,0,0,0
1689486,61,19,1952,5,"male",936,196,97,40,103,12,43,28,60
1689514,25,30,1988,5,"female",429,84,25,1,0,1,0,0,0
1689523,25,29,1988,12,"male",302,130,117,24,3,24,3,0,0
1689550,25,23,1988,9,"male",233,19,18,0,0,0,0,0,0
1689552,14,2,1999,7,"female",18,41,13,0,0,0,0,0,0
1689567,67,7,1946,5,"male",20,15,14,10,9,10,8,0,1
1689577,14,10,1999,3,"female",592,455,324,166,18,133,16,33,2
1689582,29,6,1984,1,"female",201,319,73,147,204,147,161,0,43
1689593,30,1,1983,1,"female",327,0,0,0,0,0,0,0,0
1689611,16,17,1997,9,"male",468,65,27,0,13,0,3,0,10
1689626,17,13,1996,1,"male",604,140,73,0,0,0,0,0,0
1689668,23,9,1990,7,"male",252,72,51,34,3,34,2,0,1
1689717,18,19,1995,3,"male",178,2,1,0,0,0,0,0,0
1689737,42,8,1971,10,"male",490,93,58,24,24,22,21,2,3
1689761,58,1,1955,1,"male",945,37,31,0,3,0,1,0,2
1689764,58,24,1955,12,"female",618,58,56,192,4,0,0,192,4
1689768,31,3,1982,1,"female",315,144,104,88,14,41,3,47,11
1689780,15,28,1998,5,"male",426,177,148,0,0,0,0,0,0
1689830,20,14,1993,10,"male",292,226,211,21,6,5,3,16,3
1689869,80,8,1933,8,"female",884,35,20,4,26,0,14,4,12
1689920,25,18,1988,6,"female",437,19,6,0,0,0,0,0,0
1689937,20,1,1993,2,"male",1313,12,5,1,0,1,0,0,0
1689942,24,10,1989,6,"male",165,69,66,0,0,0,0,0,0
1689943,33,16,1980,8,"male",355,7,5,6,0,6,0,0,0
1689955,29,30,1984,9,"male",24,1,1,0,0,0,0,0,0
1690002,54,2,1959,9,"female",600,19,10,1,8,0,5,1,3
1690006,38,12,1975,8,"male",133,1,1,56,2,56,2,0,0
1690011,18,8,1995,8,"female",346,74,60,0,0,0,0,0,0
1690021,18,2,1995,12,"male",153,32,25,0,0,0,0,0,0
1690045,35,17,1978,10,"female",510,82,37,4,3,4,3,0,0
1690055,20,24,1993,5,"male",447,34,6,2,1,2,1,0,0
1690056,92,1,1921,12,"male",1311,76,25,16,5,0,0,16,5
1690058,60,13,1953,3,"female",1566,63,43,13,9,0,3,13,6
1690114,78,8,1935,8,"female",1331,33,18,1,1,0,1,1,0
1690155,18,25,1995,7,"female",296,275,58,144,294,144,253,0,41
1690163,84,2,1929,8,"male",296,66,57,1,7,0,3,1,4
1690167,31,29,1982,11,"female",162,99,59,75,60,23,44,52,16
1690172,26,28,1987,2,"female",273,35,18,47,36,47,16,0,20
1690201,60,14,1953,3,"male",973,26,6,20,3,20,2,0,1
1690211,37,28,1976,11,"male",1101,27,10,1,0,1,0,0,0
1690218,68,2,1945,10,"male",2090,88,51,66,104,66,59,0,45
1690226,61,14,1952,8,"female",142,29,18,28,2,1,1,27,1
1690256,33,22,1980,12,"male",51,2,2,1,0,1,0,0,0
1690258,104,2,1909,2,"female",179,642,552,360,289,360,234,0,55
1690285,23,24,1990,10,"female",821,229,129,144,156,144,129,0,27
1690322,21,29,1992,2,"male",628,55,43,0,0,0,0,0,0
1690345,69,14,1944,10,"female",1397,101,59,122,278,4,72,118,206
1690369,19,9,1994,3,"female",37,1,1,238,67,8,6,230,61
1690398,68,5,1945,6,"male",770,62,38,49,60,0,16,49,44
1690399,61,26,1952,2,"male",1182,617,484,158,24,158,13,0,11
1690450,34,11,1979,7,"female",283,79,54,530,156,345,51,185,105
1690471,34,31,1979,12,"male",29,3,3,0,0,0,0,0,0
1690484,15,10,1998,2,"male",247,101,83,14,9,14,9,0,0
1690487,41,27,1972,8,"female",211,41,39,0,0,0,0,0,0
1690488,73,4,1940,2,"male",1510,34,9,0,0,0,0,0,0
1690497,26,5,1987,1,"female",297,9,5,0,0,0,0,0,0
1690542,21,30,1992,10,"female",183,42,22,0,0,0,0,0,0
1690559,20,2,1993,3,"female",466,520,397,392,429,370,264,22,165
1690587,68,2,1945,6,"female",467,15,4,0,1,0,0,0,1
1690612,35,12,1978,6,"male",232,1128,600,7819,1134,7819,1001,0,133
1690621,34,4,1979,8,"female",41,40,36,1,0,1,0,0,0
1690640,25,1,1988,9,"female",419,280,132,22,200,22,58,0,142
1690652,16,1,1997,1,"male",10,1,1,0,0,0,0,0,0
1690655,21,1,1992,1,"male",175,72,51,136,123,108,69,28,54
1690662,20,20,1993,12,"female",814,1191,807,231,358,49,88,182,270
1690667,14,4,1999,6,"female",293,9,9,0,20,0,0,0,20
1690673,58,19,1955,12,"female",363,192,101,80,129,80,75,0,54
1690679,16,17,1997,10,"female",190,640,187,35,26,35,21,0,5
1690691,20,25,1993,5,"male",187,2,2,1,0,0,0,1,0
1690700,68,11,1945,2,"female",986,29,22,10,1,8,1,2,0
1690729,24,17,1989,10,"male",11,5,1,0,1,0,1,0,0
1690739,55,20,1958,2,"male",1509,248,175,128,2497,107,1093,21,1404
1690743,14,29,1999,9,"male",165,19,16,1,1,0,0,1,1
1690790,17,29,1996,4,"male",950,187,125,6,4,1,1,5,3
1690794,25,29,1988,4,"male",226,9,7,1,4,1,2,0,2
1690801,17,6,1996,2,"male",512,34,28,0,0,0,0,0,0
1690807,19,25,1994,7,"female",279,136,42,29,171,29,168,0,3
1690815,32,30,1981,3,"male",616,315,252,0,0,0,0,0,0
1690839,38,23,1975,11,"male",318,38,27,66,4,66,4,0,0
1690859,18,17,1995,8,"female",646,431,348,60,34,32,28,28,6
1690867,19,4,1994,2,"male",288,87,42,0,1,0,1,0,0
1690872,64,22,1949,2,"male",1626,70,23,1,9,0,3,1,6
1690875,53,31,1960,12,"male",137,24,8,8,14,0,8,8,6
1690910,17,5,1996,3,"female",449,671,177,476,504,49,118,427,386
1690988,31,24,1982,3,"male",398,215,189,14,3,14,1,0,2
1690999,25,20,1988,1,"female",645,162,52,0,0,0,0,0,0
1691017,15,6,1998,3,"female",222,9,4,0,6,0,6,0,0
1691028,63,31,1950,12,"male",89,3,3,5,0,5,0,0,0
1691035,61,29,1952,6,"female",627,48,23,256,136,192,50,64,86
1691055,25,1,1988,1,"male",124,92,87,0,25,0,25,0,0
1691089,53,26,1960,3,"female",419,8,6,0,0,0,0,0,0
1691106,38,17,1975,3,"male",496,76,15,2,2,1,2,1,0
1691129,37,15,1976,9,"male",504,35,17,0,0,0,0,0,0
1691142,40,17,1973,7,"male",570,56,34,8,0,8,0,0,0
1691147,23,2,1990,3,"male",334,71,35,38,3,38,2,0,1
1691170,23,6,1990,9,"male",585,59,31,4,0,0,0,4,0
1691178,51,14,1962,8,"female",1261,245,143,713,638,219,272,494,366
1691192,57,15,1956,2,"male",141,11,8,303,191,0,48,303,143
1691194,49,16,1964,11,"male",394,152,52,55,25,0,17,55,8
1691201,30,9,1983,9,"male",33,4,4,61,2,43,1,18,1
1691203,87,6,1926,9,"female",2198,374,138,19,12,0,3,19,9
1691206,54,29,1959,9,"female",1745,22,5,13,0,12,0,1,0
1691217,16,24,1997,3,"female",252,99,68,0,0,0,0,0,0
1691236,38,17,1975,9,"female",324,215,52,176,173,176,138,0,35
1691294,33,1,1980,1,"female",88,79,56,6,31,6,17,0,14
1691331,23,23,1990,5,"female",324,11,5,0,0,0,0,0,0
1691338,14,30,1999,10,"female",816,1174,749,8326,5792,1561,3778,6765,2014
1691361,58,15,1955,10,"male",907,58,23,0,10,0,4,0,6
1691362,74,29,1939,8,"male",1538,31,13,9,8,0,7,9,1
1691368,49,7,1964,12,"female",291,286,211,2263,919,1910,257,353,662
1691374,18,11,1995,3,"male",445,896,745,1146,1029,860,544,286,485
1691396,24,17,1989,11,"male",298,250,140,0,2,0,2,0,0
1691400,22,27,1991,12,"male",1023,105,72,21,0,0,0,21,0
1691401,38,14,1975,9,"male",262,75,64,0,0,0,0,0,0
1691460,64,1,1949,4,"female",1782,62,35,106,59,102,41,4,18
1691462,53,9,1960,5,"female",91,14,3,15,0,15,0,0,0
1691491,33,17,1980,5,"male",237,33,23,0,1,0,0,0,1
1691492,17,16,1996,6,"female",1151,767,386,1315,1182,1198,994,117,188
1691519,27,2,1986,12,"female",483,165,91,54,24,38,8,16,16
1691524,19,31,1994,3,"female",231,396,142,6,309,6,277,0,32
1691568,25,1,1988,6,"male",3,3,0,0,0,0,0,0,0
1691578,103,19,1910,2,"male",715,372,198,31,12,31,12,0,0
1691587,18,1,1995,1,"male",223,63,29,0,8,0,8,0,0
1691622,66,7,1947,11,"male",1005,188,90,2,80,0,17,2,63
1691639,45,8,1968,11,"female",1307,150,79,190,265,190,156,0,109
1691666,22,26,1991,10,"male",387,35,22,6,0,6,0,0,0
1691670,26,2,1987,6,"male",1356,263,179,0,14,0,4,0,10
1691699,18,13,1995,6,"male",160,238,41,1,1,1,1,0,0
1691705,29,8,1984,7,"male",360,263,189,660,326,649,194,11,132
1691727,26,2,1987,1,"male",1073,186,76,0,0,0,0,0,0
1691730,43,9,1970,7,"female",161,63,46,0,2,0,2,0,0
1691738,19,5,1994,3,"female",588,40,31,336,206,151,157,185,49
1691741,64,7,1949,8,"female",1138,33,16,18,29,18,23,0,6
1691750,34,5,1979,10,"male",108,26,21,19,3,19,3,0,0
1691752,24,4,1989,12,"female",740,57,18,0,0,0,0,0,0
1691761,25,19,1988,9,"female",121,39,36,0,0,0,0,0,0
1691770,26,16,1987,6,"male",95,17,7,1,0,0,0,1,0
1691777,21,29,1992,2,"male",545,10,6,0,0,0,0,0,0
1691787,28,21,1985,4,"male",374,24,10,1,1,1,0,0,1
1691788,103,8,1910,1,"male",1754,164,81,9,0,9,0,0,0
1691791,16,27,1997,1,"male",268,81,48,13,4,10,2,3,2
1691792,13,16,2000,7,"female",53,140,83,748,561,283,404,465,157
1691797,58,9,1955,10,"male",613,18,2,5,10,5,10,0,0
1691800,70,1,1943,1,"female",1112,16,6,8,2,0,1,8,1
1691814,16,8,1997,9,"female",454,132,84,3,1,0,0,3,1
1691844,25,27,1988,3,"male",51,71,65,260,130,260,98,0,32
1691867,20,19,1993,1,"male",555,3,3,0,0,0,0,0,0
1691887,45,29,1968,4,"male",436,77,43,3,36,0,7,3,29
1691902,62,14,1951,12,"male",226,6,0,0,2,0,2,0,0
1691903,20,19,1993,3,"male",580,88,63,2356,289,0,22,2356,267
1691906,33,17,1980,7,"male",1970,589,396,3,79,3,16,0,63
1691948,66,1,1947,3,"male",581,72,58,3,0,0,0,3,0
1691970,17,22,1996,12,"female",400,257,171,0,0,0,0,0,0
1691972,18,1,1995,1,"male",461,5,5,0,0,0,0,0,0
1691975,20,10,1993,7,"male",509,1,0,0,0,0,0,0,0
1691988,61,22,1952,5,"female",1618,28,13,38,20,38,6,0,14
1691996,21,7,1992,1,"female",407,2553,1767,2415,5345,2415,4461,0,884
1692010,23,17,1990,10,"male",225,26,13,9,0,9,0,0,0
1692051,62,27,1951,1,"male",492,79,26,64,142,0,30,64,112
1692056,28,14,1985,7,"female",680,20,16,216,0,0,0,216,0
1692059,17,15,1996,3,"female",234,1,0,0,0,0,0,0,0
1692097,22,29,1991,7,"male",123,276,42,8,27,8,23,0,4
1692143,64,25,1949,12,"female",759,32,21,78,2,0,1,78,1
1692145,18,6,1995,2,"female",370,43,19,3457,521,3457,452,0,69
1692196,23,17,1990,9,"male",296,278,178,3,22,0,2,3,20
1692237,31,25,1982,7,"male",368,33,6,0,0,0,0,0,0
1692240,103,10,1910,2,"female",1517,1516,948,1651,964,1633,795,18,169
1692260,33,6,1980,7,"male",478,176,85,217,43,217,31,0,12
1692271,22,20,1991,1,"male",431,372,21,23,18,23,13,0,5
1692286,80,25,1933,9,"female",267,239,85,8,6,1,5,7,1
1692316,22,11,1991,12,"female",498,33,22,2378,3060,20,885,2358,2175
1692319,25,30,1988,9,"female",358,41,23,2,0,2,0,0,0
1692391,30,2,1983,1,"male",118,47,20,0,3,0,1,0,2
1692428,24,17,1989,4,"male",448,1063,930,338,409,195,375,143,34
1692451,20,17,1993,10,"male",1066,361,130,21,9,4,4,17,5
1692475,16,2,1997,6,"male",445,120,84,1,3,0,2,1,1
1692485,20,31,1993,1,"male",205,345,161,1,1,1,1,0,0
1692486,33,12,1980,3,"female",318,1,1,0,0,0,0,0,0
1692503,14,19,1999,7,"male",318,71,29,0,3,0,3,0,0
1692539,54,18,1959,11,"male",680,11,10,0,0,0,0,0,0
1692556,15,6,1998,10,"female",280,35,9,1485,1912,1413,681,72,1231
1692568,29,13,1984,4,"male",572,275,134,259,387,1,115,258,272
1692578,29,16,1984,12,"male",725,35,25,2,0,0,0,2,0
1692584,62,18,1951,12,"female",573,59,45,10,10,0,7,10,3
1692590,14,16,1999,4,"male",263,285,172,1,5,0,2,1,3
1692608,30,4,1983,1,"female",490,101,56,0,3,0,2,0,1
1692614,18,11,1995,7,"female",105,56,53,15,22,15,19,0,3
1692638,16,1,1997,1,"male",35,2,2,0,0,0,0,0,0
1692711,46,24,1967,12,"male",30,6,5,0,0,0,0,0,0
1692793,24,15,1989,12,"male",556,66,40,0,10,0,5,0,5
1692803,81,2,1932,11,"female",580,89,84,82,12,82,8,0,4
1692822,107,4,1906,11,"male",356,197,109,95,69,36,53,59,16
1692845,19,30,1994,8,"male",540,192,97,68,16,63,6,5,10
1692860,44,28,1969,5,"female",564,46,12,290,88,290,73,0,15
1692864,112,28,1901,1,"male",1497,312,75,13,4,0,4,13,0
1692916,28,24,1985,1,"male",423,62,25,47,25,38,18,9,7
1692931,16,4,1997,8,"female",353,1630,922,13,75,13,45,0,30
1692943,68,1,1945,4,"male",901,233,205,7,1,0,0,7,1
1692958,68,29,1945,1,"female",743,4724,1149,496,1630,424,1321,72,309
1692964,19,20,1994,8,"female",387,208,125,432,372,428,329,4,43
1692991,53,10,1960,2,"male",616,286,216,150,513,12,90,138,423
1692995,21,20,1992,4,"female",542,262,72,5,7,5,6,0,1
1693005,23,30,1990,10,"female",44,198,11,14,107,14,41,0,66
1693009,72,23,1941,11,"female",1302,65,42,3,29,0,2,3,27
1693019,17,14,1996,2,"male",259,119,95,12,1,12,1,0,0
1693021,16,9,1997,5,"male",196,230,152,3,3,0,1,3,2
1693035,108,30,1905,7,"male",43,53,46,7,8,7,3,0,5
1693038,60,25,1953,4,"female",431,10,6,13,1,13,1,0,0
1693042,55,24,1958,7,"female",25,90,61,13,10,13,7,0,3
1693052,18,27,1995,7,"male",109,90,33,46,16,4,6,42,10
1693074,30,1,1983,3,"male",726,532,447,5,2,5,1,0,1
1693084,47,19,1966,2,"male",463,13,11,0,0,0,0,0,0
1693118,63,25,1950,5,"female",1569,64,33,275,64,0,19,275,45
1693136,22,1,1991,4,"female",185,428,252,565,989,496,748,69,241
1693197,30,9,1983,1,"female",50,84,65,127,345,2,173,125,172
1693198,26,10,1987,9,"male",90,68,61,0,5,0,0,0,5
1693224,20,3,1993,3,"male",335,743,662,0,0,0,0,0,0
1693269,21,10,1992,10,"female",223,79,43,2,1,2,1,0,0
1693280,18,3,1995,5,"female",42,76,52,286,122,286,82,0,40
1693285,15,15,1998,8,"female",19,641,128,134,44,134,42,0,2
1693301,32,29,1981,1,"female",213,6,3,0,0,0,0,0,0
1693313,30,15,1983,4,"female",1643,713,355,609,587,606,450,3,137
1693321,19,23,1994,11,"female",574,159,98,133,91,133,73,0,18
1693341,42,19,1971,6,"female",518,54,28,17,8,3,3,14,5
1693371,65,29,1948,9,"female",375,69,20,13,14,13,14,0,0
1693432,61,12,1952,8,"female",1268,179,70,332,539,332,322,0,217
1693434,24,4,1989,3,"female",574,116,78,8,63,8,38,0,25
1693448,74,12,1939,2,"female",173,26,23,1145,21,1145,17,0,4
1693459,59,7,1954,2,"female",911,107,76,6,21,3,12,3,9
1693461,28,26,1985,10,"female",478,28,11,26,0,26,0,0,0
1693462,65,5,1948,9,"female",44,60,50,101,78,0,31,101,47
1693469,16,15,1997,9,"male",57,43,28,2,1,2,0,0,1
1693482,18,30,1995,7,"female",130,412,272,345,583,345,358,0,225
1693513,20,2,1993,7,"male",444,113,69,7,0,7,0,0,0
1693530,64,19,1949,6,"male",1541,48,30,0,2,0,2,0,0
1693544,21,28,1992,2,"male",169,0,0,0,0,0,0,0,0
1693555,108,4,1905,3,"male",1696,244,58,10,7,0,4,10,3
1693572,17,8,1996,11,"male",273,185,173,17,7,17,7,0,0
1693582,74,14,1939,5,"female",1531,232,133,3677,1297,774,441,2903,856
1693583,26,1,1987,1,"male",55,21,12,0,1,0,0,0,1
1693605,55,29,1958,9,"female",1942,83,49,445,528,237,304,208,224
1693620,18,20,1995,10,"male",489,105,49,3,9,3,9,0,0
1693627,19,8,1994,6,"male",106,155,53,0,0,0,0,0,0
1693672,33,11,1980,7,"female",569,418,323,893,335,893,273,0,62
1693684,18,21,1995,10,"female",221,336,84,22,24,19,7,3,17
1693685,44,29,1969,9,"male",240,72,52,34,9,34,7,0,2
1693688,59,5,1954,7,"female",378,173,125,106,10,0,3,106,7
1693690,53,22,1960,2,"female",1027,50,15,299,46,299,29,0,17
1693695,15,23,1998,8,"female",198,394,262,1100,755,108,256,992,499
1693720,17,7,1996,8,"male",619,1099,898,4731,351,4731,294,0,57
1693722,27,15,1986,10,"male",160,1,1,0,0,0,0,0,0
1693732,20,10,1993,10,"male",33,13,10,0,0,0,0,0,0
1693746,44,16,1969,5,"male",414,309,210,6,10,4,5,2,5
1693755,91,21,1922,1,"female",328,105,59,36,30,3,7,33,23
1693772,36,7,1977,8,"female",949,127,54,47,25,47,23,0,2
1693776,20,7,1993,2,"male",141,22,9,0,0,0,0,0,0
1693817,48,10,1965,5,"female",272,136,62,380,145,380,107,0,38
1693834,58,8,1955,2,"female",1792,177,93,325,128,70,28,255,100
1693844,19,29,1994,1,"female",478,519,452,127,240,49,85,78,155
1693858,65,4,1948,3,"female",740,72,47,382,107,194,54,188,53
1693906,25,24,1988,2,"male",127,24,9,0,0,0,0,0,0
1693913,18,7,1995,7,"male",79,75,44,23,7,23,5,0,2
1693924,24,1,1989,12,"male",303,790,756,5,23,3,14,2,9
1693930,15,25,1998,4,"female",350,324,107,405,247,50,76,355,171
1693946,41,26,1972,1,"male",268,181,76,1,3,0,0,1,3
1693959,73,25,1940,7,"female",645,25,12,106,37,104,21,2,16
1693966,16,10,1997,2,"male",317,213,125,282,62,282,45,0,17
1693967,103,20,1910,8,"male",945,71,43,10,18,10,12,0,6
1693980,17,3,1996,2,"male",1258,742,362,12,0,12,0,0,0
1693981,40,21,1973,1,"female",715,909,386,2382,3203,1949,1529,433,1674
1693988,25,23,1988,10,"male",330,21,9,0,0,0,0,0,0
1694003,68,17,1945,8,"female",23,34,19,79,17,79,16,0,1
1694012,31,27,1982,4,"male",408,40,23,11,2,0,0,11,2
1694016,24,19,1989,8,"female",301,17,5,71,27,71,24,0,3
1694027,53,4,1960,8,"female",1041,71,23,0,2,0,0,0,2
1694042,24,24,1989,10,"male",71,11,10,2,0,0,0,2,0
1694069,26,1,1987,1,"male",650,26,4,0,0,0,0,0,0
1694073,32,23,1981,8,"female",123,7,5,0,0,0,0,0,0
1694090,105,15,1908,4,"female",1809,307,138,51,47,18,39,33,8
1694094,44,5,1969,6,"male",251,1,1,0,0,0,0,0,0
1694126,24,29,1989,1,"male",672,86,46,50,15,50,13,0,2
1694143,33,20,1980,2,"female",656,27,16,38,26,38,25,0,1
1694167,20,11,1993,4,"female",179,25,8,0,0,0,0,0,0
1694248,37,1,1976,1,"male",168,19,10,0,0,0,0,0,0
1694256,16,22,1997,2,"male",218,134,110,2,204,2,200,0,4
1694257,19,11,1994,2,"female",322,56,38,1,5,1,0,0,5
1694269,18,3,1995,11,"female",592,715,260,2022,2495,1443,1411,579,1084
1694285,108,31,1905,1,"male",52,342,234,170,199,61,80,109,119
1694316,23,14,1990,6,"male",160,46,12,5,6,5,5,0,1
1694321,19,8,1994,8,"male",234,402,336,11,3,1,1,10,2
1694341,19,15,1994,10,"female",66,468,299,666,390,666,363,0,27
1694349,20,14,1993,2,"male",175,116,99,3,13,3,10,0,3
1694364,30,16,1983,6,"male",171,54,46,16,1,16,1,0,0
1694378,23,5,1990,5,"male",140,56,32,18,0,18,0,0,0
1694383,43,26,1970,6,"male",411,72,45,0,17,0,16,0,1
1694384,18,1,1995,10,"female",571,332,169,1134,509,662,351,472,158
1694423,21,2,1992,12,"male",90,7,7,0,0,0,0,0,0
1694431,15,6,1998,10,"female",309,404,225,502,588,4,76,498,512
1694452,18,23,1995,3,"male",152,263,214,10,5,10,4,0,1
1694462,37,2,1976,3,"male",337,29,23,0,1,0,1,0,0
1694466,72,16,1941,2,"male",288,25,17,5,2,0,0,5,2
1694476,77,6,1936,8,"female",632,34,23,1,20,0,2,1,18
1694521,52,15,1961,12,"male",582,35,33,0,8,0,8,0,0
1694527,27,10,1986,8,"male",527,0,0,0,0,0,0,0,0
1694541,17,31,1996,10,"female",529,619,239,355,451,256,340,99,111
1694589,29,4,1984,2,"female",462,1,1,0,0,0,0,0,0
1694593,18,12,1995,2,"female",141,112,26,67,70,58,39,9,31
1694612,34,26,1979,9,"male",177,7,7,0,0,0,0,0,0
1694624,33,17,1980,10,"female",495,215,154,49,15,0,3,49,12
1694625,14,4,1999,5,"male",81,66,40,24,13,24,10,0,3
1694631,35,9,1978,4,"male",382,64,26,41,14,0,1,41,13
1694641,64,18,1949,10,"male",1071,73,55,2,16,2,14,0,2
1694696,45,20,1968,12,"male",1850,199,87,15,36,13,8,2,28
1694703,50,9,1963,5,"female",343,39,24,95,36,0,22,95,14
1694711,18,26,1995,4,"female",277,1801,739,1603,1824,1599,1357,4,467
1694743,25,22,1988,5,"male",16,11,10,0,0,0,0,0,0
1694776,42,8,1971,10,"female",2224,429,237,817,608,764,122,53,486
1694779,21,29,1992,4,"male",480,113,79,32,8,0,7,32,1
1694793,96,13,1917,5,"female",202,1455,452,4,695,0,95,4,600
1694795,19,9,1994,11,"female",435,474,247,3,2,3,2,0,0
1694800,96,10,1917,3,"female",150,88,76,516,24,0,10,516,14
1694814,40,3,1973,11,"female",860,100,59,14,0,14,0,0,0
1694845,59,28,1954,4,"male",1490,194,150,92,8,92,4,0,4
1694856,24,15,1989,10,"male",918,244,223,2,24,2,24,0,0
1694883,55,25,1958,7,"male",243,59,26,26,19,26,15,0,4
1694884,53,20,1960,8,"female",486,54,25,31,31,26,16,5,15
1694896,101,17,1912,11,"male",354,62,41,0,0,0,0,0,0
1694944,15,12,1998,8,"male",199,197,49,0,0,0,0,0,0
1694947,15,26,1998,3,"female",117,1459,48,20,102,6,62,14,40
1694951,37,18,1976,8,"female",329,183,93,38,416,38,327,0,89
1694968,36,28,1977,9,"male",180,31,25,0,0,0,0,0,0
1694975,58,13,1955,8,"male",843,34,20,2,4,2,4,0,0
1694978,37,26,1976,8,"male",101,1,1,4,5,4,5,0,0
1694979,35,25,1978,2,"male",698,289,153,25,14,25,12,0,2
1694999,25,22,1988,6,"male",665,987,705,36,1,36,1,0,0
1695024,18,25,1995,11,"female",135,69,33,6943,814,6943,704,0,110
1695067,25,10,1988,2,"female",89,7,6,3,9,3,7,0,2
1695077,22,8,1991,11,"male",611,208,126,169,24,156,16,13,8
1695085,62,5,1951,1,"female",646,96,59,6,0,0,0,6,0
1695120,20,9,1993,10,"male",728,106,98,0,6,0,6,0,0
1695121,16,7,1997,7,"male",32,42,41,0,4,0,3,0,1
1695126,15,29,1998,4,"male",547,57,9,70,163,70,121,0,42
1695129,26,27,1987,2,"female",41,12,10,25,17,25,17,0,0
1695141,18,20,1995,5,"male",22,6,6,10,12,10,12,0,0
1695153,58,25,1955,3,"female",838,65,40,26,17,26,12,0,5
1695167,30,3,1983,3,"male",46,4,2,4,0,4,0,0,0
1695173,93,5,1920,6,"female",6,6,6,14,4,14,4,0,0
1695183,35,1,1978,1,"male",490,16,14,0,1,0,1,0,0
1695197,33,20,1980,7,"male",325,6,5,0,0,0,0,0,0
1695232,48,3,1965,5,"female",964,161,121,1666,375,1666,326,0,49
1695247,20,16,1993,12,"female",1145,211,133,1262,1073,579,734,683,339
1695259,28,1,1985,3,"female",644,521,210,326,969,326,599,0,370
1695262,22,8,1991,7,"male",333,238,84,0,0,0,0,0,0
1695267,35,27,1978,11,"male",261,235,72,71,39,23,6,48,33
1695284,34,21,1979,4,"male",402,2,1,38,0,21,0,17,0
1695303,108,1,1905,10,"male",157,89,62,36,0,9,0,27,0
1695313,23,1,1990,1,"male",0,0,0,0,0,0,0,0,0
1695317,35,31,1978,8,"male",938,24,4,19,5,7,0,12,5
1695357,58,20,1955,6,"female",311,83,46,142,118,0,78,142,40
1695410,14,1,1999,1,"female",578,0,0,0,0,0,0,0,0
1695417,17,17,1996,7,"female",226,1483,1024,420,252,383,130,37,122
1695444,108,25,1905,1,"female",2055,44,23,30,28,29,27,1,1
1695518,34,20,1979,3,"male",525,79,34,0,0,0,0,0,0
1695529,50,18,1963,2,"male",261,64,33,22,50,22,27,0,23
1695533,28,1,1985,2,"female",493,20,14,59,8,17,6,42,2
1695559,18,27,1995,4,"male",218,42,35,7,25,7,11,0,14
1695564,33,28,1980,3,"male",440,50,37,48,2,48,2,0,0
1695575,40,28,1973,10,"female",369,123,97,115,157,11,73,104,84
1695584,20,24,1993,9,"male",295,205,110,225,137,215,127,10,10
1695602,23,14,1990,12,"male",212,624,435,438,375,438,362,0,13
1695613,21,30,1992,4,"male",645,261,197,14,0,14,0,0,0
1695634,16,18,1997,9,"male",255,333,287,53,7,42,6,11,1
1695700,21,11,1992,9,"male",556,12,6,0,0,0,0,0,0
1695726,108,11,1905,9,"male",1392,79,39,59,21,0,15,59,6
1695767,20,4,1993,2,"male",247,58,26,3,0,3,0,0,0
1695793,18,7,1995,7,"male",108,37,31,0,2,0,2,0,0
1695810,83,7,1930,3,"female",1529,347,239,15,18,8,7,7,11
1695840,48,12,1965,5,"female",566,25,6,22,0,22,0,0,0
1695847,40,1,1973,1,"male",145,75,44,0,1,0,0,0,1
1695851,18,20,1995,7,"male",309,19,5,106,20,106,2,0,18
1695903,71,13,1942,1,"female",282,29,24,57,73,0,18,57,55
1695909,25,9,1988,3,"female",483,146,19,46,61,46,20,0,41
1695911,38,23,1975,12,"male",910,1189,492,462,1383,240,403,222,980
1695967,30,24,1983,11,"male",220,0,0,0,0,0,0,0,0
1696008,20,5,1993,5,"female",164,46,39,3,24,0,3,3,21
1696053,14,16,1999,2,"male",357,155,59,9,12,0,1,9,11
1696068,24,28,1989,5,"female",375,378,36,1375,1451,1375,795,0,656
1696074,27,26,1986,6,"male",415,56,37,0,0,0,0,0,0
1696081,42,19,1971,7,"male",672,79,63,28,30,28,28,0,2
1696125,24,14,1989,3,"male",246,3,3,0,0,0,0,0,0
1696132,24,9,1989,11,"female",460,27,12,59,13,59,13,0,0
1696140,30,3,1983,5,"female",65,15,13,5,3,4,2,1,1
1696150,84,25,1929,10,"female",1367,109,25,5,10,5,10,0,0
1696178,26,12,1987,10,"female",1306,170,77,6,7,6,6,0,1
1696204,25,4,1988,8,"male",789,362,187,172,202,119,126,53,76
1696245,19,5,1994,12,"female",329,85,44,0,0,0,0,0,0
1696272,24,15,1989,8,"female",689,25,4,0,10,0,0,0,10
1696285,25,3,1988,6,"male",393,3,3,0,0,0,0,0,0
1696325,20,27,1993,1,"male",497,645,576,1,9,1,0,0,9
1696338,16,18,1997,2,"male",714,185,93,7,0,7,0,0,0
1696344,15,12,1998,12,"male",29,8,7,0,0,0,0,0,0
1696360,50,21,1963,2,"female",799,63,41,1,2,1,2,0,0
1696392,25,1,1988,1,"male",73,0,0,0,0,0,0,0,0
1696418,19,18,1994,7,"male",150,3,2,3,0,2,0,1,0
1696434,25,1,1988,7,"female",205,48,31,1130,1235,1114,488,16,747
1696436,108,25,1905,1,"male",1540,219,41,9,35,0,30,9,5
1696449,67,5,1946,1,"female",93,36,27,48,29,48,7,0,22
1696470,108,30,1905,6,"male",1011,85,51,168,219,152,113,16,106
1696471,53,14,1960,3,"male",423,333,262,189,46,189,41,0,5
1696487,16,17,1997,11,"male",274,9,3,0,2,0,2,0,0
1696499,22,8,1991,2,"male",1062,383,219,37,39,18,28,19,11
1696512,19,12,1994,10,"female",443,246,168,206,17,141,4,65,13
1696514,83,14,1930,11,"female",1470,1007,487,63,90,1,38,62,52
1696539,17,21,1996,8,"female",505,176,46,0,0,0,0,0,0
1696564,17,11,1996,12,"female",294,77,57,0,0,0,0,0,0
1696608,23,15,1990,10,"male",248,1,1,2,2,0,0,2,2
1696627,23,21,1990,11,"male",492,187,124,88,79,86,29,2,50
1696629,20,22,1993,7,"female",388,112,52,39,43,39,41,0,2
1696657,13,5,2000,3,"male",132,51,44,7,9,7,9,0,0
1696718,35,20,1978,6,"female",502,59,43,26,35,26,10,0,25
1696753,23,1,1990,1,"male",961,21,16,0,0,0,0,0,0
1696756,20,8,1993,6,"female",546,315,62,2,1,2,1,0,0
1696775,24,13,1989,11,"male",19,14,14,4,1,4,1,0,0
1696784,21,11,1992,11,"male",767,583,487,1,10,1,7,0,3
1696795,17,10,1996,7,"male",426,473,415,0,0,0,0,0,0
1696822,79,25,1934,7,"male",282,1,0,4,0,4,0,0,0
1696830,22,2,1991,2,"male",509,220,72,231,0,231,0,0,0
1696839,66,23,1947,9,"female",643,41,20,48,28,0,25,48,3
1696857,66,2,1947,9,"male",121,94,0,33,49,33,49,0,0
1696888,23,12,1990,5,"female",583,83,54,1,2,1,1,0,1
1696889,16,1,1997,8,"female",290,855,490,452,542,396,403,56,139
1696892,23,19,1990,12,"male",167,38,31,15,2,14,1,1,1
1696895,16,28,1997,3,"female",641,1576,247,22,78,5,66,17,12
1696912,24,2,1989,2,"male",279,68,57,0,5,0,1,0,4
1696935,95,17,1918,8,"male",103,177,152,4,20,4,10,0,10
1696956,20,1,1993,10,"male",1136,58,34,4,2,4,0,0,2
1696960,31,2,1982,2,"female",223,1019,406,6071,4064,6071,3330,0,734
1696972,25,13,1988,11,"male",282,29,25,4,4,0,2,4,2
1696989,48,6,1965,8,"female",404,9,6,1,5,1,5,0,0
1696999,18,1,1995,1,"male",48,12,10,0,0,0,0,0,0
1697000,40,22,1973,2,"male",128,49,44,2,23,0,1,2,22
1697031,15,26,1998,7,"male",94,27,21,45,25,45,8,0,17
1697079,24,23,1989,10,"female",76,3,1,2,0,2,0,0,0
1697139,21,9,1992,4,"male",302,0,0,0,0,0,0,0,0
1697155,58,13,1955,7,"female",541,47,24,45,62,15,18,30,44
1697205,68,3,1945,1,"male",1124,94,37,24,7,24,7,0,0
1697217,21,5,1992,10,"male",108,302,252,42,42,42,41,0,1
1697229,53,20,1960,10,"female",335,178,63,79,109,79,100,0,9
1697230,21,8,1992,8,"male",655,40,25,2,0,2,0,0,0
1697243,20,28,1993,5,"male",418,342,282,237,166,237,114,0,52
1697267,42,24,1971,4,"male",925,41,11,0,0,0,0,0,0
1697305,103,27,1910,10,"male",1510,21,16,0,0,0,0,0,0
1697308,68,20,1945,4,"male",753,42,22,1,3,0,0,1,3
1697309,43,15,1970,12,"male",280,69,39,13,2,4,2,9,0
1697316,44,20,1969,3,"male",339,82,59,4,50,3,48,1,2
1697343,28,3,1985,5,"male",1318,57,30,0,0,0,0,0,0
1697351,25,14,1988,9,"female",195,102,28,16,77,9,68,7,9
1697358,20,11,1993,4,"female",714,54,41,0,5,0,2,0,3
1697368,19,26,1994,12,"female",308,97,63,45,6,29,4,16,2
1697451,19,2,1994,2,"male",164,22,21,0,0,0,0,0,0
1697499,28,1,1985,1,"female",548,77,20,0,0,0,0,0,0
1697506,45,24,1968,10,"male",1394,820,579,15,75,4,6,11,69
1697536,18,1,1995,1,"female",498,256,63,30,16,30,15,0,1
1697564,31,22,1982,7,"female",446,94,49,80,113,80,67,0,46
1697569,29,3,1984,1,"male",728,150,84,349,294,349,278,0,16
1697593,61,28,1952,11,"female",621,10,7,1,1,0,1,1,0
1697605,21,22,1992,8,"female",506,191,87,29,49,11,37,18,12
1697631,25,13,1988,7,"female",535,742,242,318,214,318,197,0,17
1697643,65,11,1948,3,"female",323,131,117,504,262,504,121,0,141
1697646,83,5,1930,6,"female",1391,30,12,2,0,0,0,2,0
1697665,31,5,1982,1,"male",250,110,92,56,79,40,47,16,32
1697669,40,30,1973,1,"female",241,47,31,4,0,1,0,3,0
1697684,31,19,1982,10,"male",1991,225,131,1018,1594,385,817,633,777
1697688,46,12,1967,11,"male",1766,341,244,19,82,15,61,4,21
1697701,15,13,1998,5,"male",219,158,131,173,49,139,33,34,16
1697718,21,25,1992,11,"male",161,1,1,0,0,0,0,0,0
1697732,103,14,1910,1,"male",1020,449,435,1,6,1,4,0,2
1697767,50,18,1963,10,"female",325,750,318,41,18,4,9,37,9
1697787,19,8,1994,1,"male",329,301,110,0,0,0,0,0,0
1697800,43,15,1970,10,"male",76,8,7,1,1,1,1,0,0
1697802,46,2,1967,4,"female",667,175,100,239,74,0,15,239,59
1697820,23,10,1990,10,"male",66,0,0,1,1,0,1,1,0
1697838,56,21,1957,10,"female",280,66,42,71,124,62,58,9,66
1697874,22,11,1991,12,"female",128,123,102,42,58,10,16,32,42
1697886,50,29,1963,10,"male",406,34,7,0,0,0,0,0,0
1697909,14,21,1999,3,"male",3,66,61,19,31,17,13,2,18
1697918,14,5,1999,2,"male",35,31,22,3,7,0,2,3,5
1697929,19,18,1994,6,"male",634,107,69,144,106,144,70,0,36
1697960,78,3,1935,9,"male",20,3,2,73,8,0,7,73,1
1697992,48,16,1965,10,"male",1630,49,25,88,121,74,92,14,29
1698001,34,15,1979,2,"male",1328,15,4,0,0,0,0,0,0
1698023,20,8,1993,12,"female",420,16,15,8,8,8,6,0,2
1698044,20,11,1993,8,"female",477,65,26,0,0,0,0,0,0
1698071,43,23,1970,9,"male",187,20,19,17,0,17,0,0,0
1698105,52,1,1961,9,"female",463,8,5,0,0,0,0,0,0
1698127,20,13,1993,10,"male",230,374,331,3,19,3,17,0,2
1698133,30,6,1983,4,"female",29,46,32,462,326,27,175,435,151
1698145,46,16,1967,2,"female",11,30,16,2,6,0,1,2,5
1698157,65,4,1948,7,"male",1325,81,22,234,61,0,18,234,43
1698158,14,31,1999,1,"female",438,126,56,84,77,60,57,24,20
1698176,59,23,1954,10,"female",848,116,55,191,79,115,51,76,28
1698219,18,13,1995,7,"female",489,339,214,216,258,82,52,134,206
1698245,20,11,1993,5,"male",1106,706,480,607,129,376,79,231,50
1698255,29,7,1984,12,"female",388,6,6,9,4,7,0,2,4
1698270,57,30,1956,9,"female",552,720,283,1739,263,453,205,1286,58
1698301,26,25,1987,1,"female",22,17,13,4,6,4,3,0,3
1698306,17,8,1996,2,"female",47,44,4,38,26,38,11,0,15
1698322,24,18,1989,5,"female",374,34,23,0,1,0,1,0,0
1698407,20,28,1993,3,"male",286,317,129,1,0,1,0,0,0
1698425,32,22,1981,3,"female",413,10,7,0,0,0,0,0,0
1698426,16,3,1997,9,"male",130,163,115,11,5,11,4,0,1
1698456,49,14,1964,11,"female",2023,601,387,568,555,240,344,328,211
1698458,38,24,1975,11,"female",772,53,6,2,7,2,6,0,1
1698482,33,30,1980,4,"male",513,80,47,0,2,0,2,0,0
1698489,38,12,1975,4,"male",194,58,30,51,28,51,16,0,12
1698500,32,20,1981,3,"male",665,33,13,12,0,12,0,0,0
1698504,21,26,1992,4,"male",615,201,148,3,1,0,0,3,1
1698518,17,6,1996,6,"male",40,3,1,0,0,0,0,0,0
1698553,43,13,1970,9,"female",161,60,54,55,2,55,1,0,1
1698583,25,8,1988,9,"female",10,0,0,0,0,0,0,0,0
1698628,113,1,1900,1,"male",1177,13,3,0,0,0,0,0,0
1698649,19,10,1994,1,"male",425,237,196,0,0,0,0,0,0
1698688,22,27,1991,2,"male",813,255,109,29,3,26,3,3,0
1698729,22,5,1991,12,"female",229,14,10,41,38,22,9,19,29
1698760,23,16,1990,3,"male",80,50,36,2,2,2,2,0,0
1698780,23,1,1990,1,"male",237,42,36,0,1,0,0,0,1
1698781,76,3,1937,9,"male",1535,24,11,20,7,19,6,1,1
1698786,43,16,1970,1,"male",944,61,7,11,12,11,6,0,6
1698792,29,6,1984,1,"male",1673,23,18,5,3,0,0,5,3
1698801,17,9,1996,4,"male",490,282,70,264,89,264,72,0,17
1698826,105,1,1908,1,"female",2224,243,124,61,21,0,15,61,6
1698841,63,5,1950,6,"female",1843,92,34,523,92,388,57,135,35
1698853,39,8,1974,7,"male",269,1,0,0,0,0,0,0,0
1698914,19,18,1994,8,"male",399,1321,1106,268,38,268,30,0,8
1698946,22,3,1991,3,"female",279,54,40,48,21,0,7,48,14
1698989,16,19,1997,6,"male",668,114,17,75,13,75,13,0,0
1699012,59,7,1954,3,"female",178,6,5,53,7,13,0,40,7
1699018,18,1,1995,1,"male",400,310,253,0,8,0,8,0,0
1699037,54,16,1959,2,"male",523,221,179,12,21,0,10,12,11
1699044,83,5,1930,6,"female",2289,194,62,59,21,0,13,59,8
1699053,103,2,1910,1,"male",880,607,438,35,18,35,15,0,3
1699062,24,20,1989,10,"female",634,154,126,128,129,128,87,0,42
1699101,27,11,1986,12,"male",563,41,30,0,0,0,0,0,0
1699112,59,9,1954,12,"male",544,38,32,0,0,0,0,0,0
1699114,66,5,1947,5,"female",1112,97,55,124,27,9,5,115,22
1699124,113,10,1900,10,"male",1262,1950,1544,167,188,167,67,0,121
1699132,41,18,1972,11,"female",159,15,11,1,0,1,0,0,0
1699148,64,1,1949,2,"male",1226,25,18,53,37,53,13,0,24
1699193,19,19,1994,12,"male",394,90,56,11,9,11,7,0,2
1699206,39,7,1974,4,"female",52,2,1,28,6,0,1,28,5
1699211,23,3,1990,12,"female",686,402,210,315,420,166,261,149,159
1699212,23,6,1990,12,"male",52,55,23,11,0,11,0,0,0
1699235,15,15,1998,10,"male",371,121,89,0,1,0,0,0,1
1699251,17,22,1996,9,"male",139,212,186,8,33,8,20,0,13
1699265,28,27,1985,5,"female",559,138,61,0,0,0,0,0,0
1699284,33,5,1980,2,"male",89,51,31,13,0,13,0,0,0
1699318,19,2,1994,2,"female",52,2,1,2,4,2,0,0,4
1699329,19,10,1994,4,"female",324,406,255,333,263,295,112,38,151
1699330,53,5,1960,7,"male",319,194,179,0,0,0,0,0,0
1699332,76,21,1937,5,"male",1023,34,22,0,13,0,10,0,3
1699347,24,24,1989,2,"male",756,996,812,14,38,5,19,9,19
1699399,28,5,1985,9,"male",728,102,93,4,5,4,3,0,2
1699403,37,1,1976,1,"male",292,162,132,28,32,28,31,0,1
1699455,49,25,1964,5,"female",249,31,19,4,79,4,48,0,31
1699481,20,24,1993,1,"male",535,161,133,1,0,1,0,0,0
1699544,38,14,1975,10,"female",1938,252,173,482,695,482,383,0,312
1699625,23,29,1990,12,"male",963,197,147,1,1,1,1,0,0
1699636,17,30,1996,8,"male",55,123,112,5,4,5,2,0,2
1699649,18,8,1995,2,"male",966,539,72,46,75,37,35,9,40
1699667,24,22,1989,1,"male",868,43,41,0,1,0,0,0,1
1699671,52,11,1961,2,"female",579,12,8,14,4,13,4,1,0
1699698,73,3,1940,10,"female",1025,41,22,1,4,1,4,0,0
1699746,14,23,1999,6,"male",143,62,31,0,0,0,0,0,0
1699755,82,15,1931,7,"male",1685,259,173,113,23,16,15,97,8
1699816,19,23,1994,12,"female",578,688,237,105,257,102,182,3,75
1699826,48,25,1965,1,"male",5,28,15,4,17,4,15,0,2
1699846,50,1,1963,1,"female",9,4,4,0,0,0,0,0,0
1699876,46,28,1967,4,"female",308,25,9,201,37,201,24,0,13
1699884,113,15,1900,11,"male",1979,207,101,38,14,2,7,36,7
1699885,61,18,1952,5,"female",854,395,129,695,167,632,69,63,98
1699886,15,27,1998,5,"female",502,512,361,16,69,3,39,13,30
1699890,105,18,1908,11,"male",1090,16,8,11,12,11,10,0,2
1699901,67,18,1946,9,"female",152,12,10,75,24,5,1,70,23
1699907,30,22,1983,11,"male",506,98,68,52,27,52,22,0,5
1699920,29,5,1984,2,"male",100,17,12,145,117,133,59,12,58
1699944,29,10,1984,10,"female",705,5,0,1,1,1,0,0,1
1699955,61,25,1952,2,"male",357,24,7,68,4,68,4,0,0
1699964,42,9,1971,8,"male",285,368,294,199,270,199,226,0,44
1699976,28,31,1985,10,"female",468,176,56,191,496,191,401,0,95
1699981,18,10,1995,3,"female",449,1964,681,50,252,50,212,0,40
1699997,24,27,1989,6,"male",494,16,11,0,2,0,2,0,0
1700027,23,13,1990,2,"male",257,113,40,1,1,1,1,0,0
1700039,61,10,1952,8,"female",1351,106,47,235,36,235,24,0,12
1700057,21,23,1992,8,"female",490,339,223,0,0,0,0,0,0
1700067,20,14,1993,11,"male",582,140,81,33,0,33,0,0,0
1700088,23,24,1990,1,"male",840,594,379,37,20,32,0,5,20
1700096,23,14,1990,1,"female",489,54,38,15,4,0,1,15,3
1700101,15,16,1998,12,"male",101,39,17,2,3,2,1,0,2
1700102,100,2,1913,10,"female",1815,145,83,30,30,26,21,4,9
1700141,25,30,1988,4,"female",367,122,34,2,117,2,45,0,72
1700162,24,29,1989,5,"female",592,0,0,0,0,0,0,0,0
1700173,19,25,1994,12,"male",367,130,66,50,21,8,6,42,15
1700202,78,21,1935,3,"female",1070,26,18,0,0,0,0,0,0
1700204,18,18,1995,2,"male",200,45,23,0,0,0,0,0,0
1700235,58,27,1955,4,"male",215,34,31,434,43,0,1,434,42
1700263,40,29,1973,3,"female",547,85,11,25,8,25,8,0,0
1700271,72,9,1941,9,"female",60,17,17,25,9,0,4,25,5
1700272,44,26,1969,5,"female",431,38,18,1,2,1,1,0,1
1700307,20,3,1993,10,"female",420,273,96,9,12,6,8,3,4
1700317,19,9,1994,9,"male",428,264,77,9,1,9,1,0,0
1700322,53,26,1960,9,"male",699,11,5,2,0,2,0,0,0
1700342,19,21,1994,3,"male",437,262,151,1,4,1,2,0,2
1700345,30,18,1983,4,"male",602,12,12,148,16,144,12,4,4
1700357,24,11,1989,3,"female",110,279,101,308,427,308,332,0,95
1700361,46,4,1967,8,"male",34,25,22,2,9,2,3,0,6
1700379,17,17,1996,6,"male",267,63,39,24,0,4,0,20,0
1700387,28,13,1985,9,"male",159,84,58,7,0,7,0,0,0
1700439,15,7,1998,4,"male",35,61,57,3,1,3,0,0,1
1700443,27,12,1986,8,"female",406,303,158,124,83,124,75,0,8
1700492,19,16,1994,8,"male",1527,1597,1001,393,1236,132,603,261,633
1700505,23,4,1990,12,"male",303,0,0,0,0,0,0,0,0
1700522,19,27,1994,3,"female",683,431,374,1,3,1,2,0,1
1700526,17,4,1996,9,"male",593,409,275,645,102,603,96,42,6
1700539,31,7,1982,5,"male",248,226,198,264,2,1,1,263,1
1700555,24,17,1989,3,"male",386,654,585,241,227,0,44,241,183
1700557,26,15,1987,11,"female",487,215,191,128,114,121,63,7,51
1700577,17,17,1996,4,"female",607,705,385,158,189,158,121,0,68
1700612,23,1,1990,1,"male",476,16,8,5,1,4,0,1,1
1700616,22,5,1991,2,"male",244,77,46,16,45,3,44,13,1
1700668,27,15,1986,11,"female",295,292,175,29,26,21,20,8,6
1700689,35,25,1978,9,"male",414,35,25,19,4,0,1,19,3
1700691,62,21,1951,1,"female",300,39,22,12,6,12,6,0,0
1700708,16,20,1997,8,"female",125,216,26,0,2,0,0,0,2
1700718,33,8,1980,3,"male",294,7,1,0,0,0,0,0,0
1700721,28,12,1985,5,"female",499,76,54,12,65,12,35,0,30
1700730,23,14,1990,8,"female",658,829,681,260,256,255,195,5,61
1700731,55,22,1958,6,"male",1388,39,12,0,15,0,8,0,7
1700768,58,15,1955,5,"male",1401,35,18,2,59,2,54,0,5
1700773,31,3,1982,12,"male",415,138,58,16,16,16,13,0,3
1700775,33,28,1980,10,"female",551,41,22,41,16,38,13,3,3
1700779,23,22,1990,1,"male",234,72,43,0,0,0,0,0,0
1700790,31,15,1982,7,"male",657,214,162,0,2,0,0,0,2
1700831,33,1,1980,6,"male",611,46,45,1,0,0,0,1,0
1700864,108,23,1905,11,"male",2065,476,203,73,6,42,5,31,1
1700875,35,29,1978,11,"male",179,83,69,57,3,57,0,0,3
1700877,50,5,1963,3,"female",646,32,19,3,9,0,4,3,5
1700883,56,21,1957,3,"female",1332,248,133,2898,113,2898,43,0,70
1700905,25,1,1988,1,"male",216,412,387,3,10,3,8,0,2
1700907,21,28,1992,1,"male",707,270,185,0,3,0,3,0,0
1700926,18,30,1995,11,"male",767,94,48,0,0,0,0,0,0
1700928,108,31,1905,12,"male",933,688,440,77,111,0,21,77,90
1700955,103,13,1910,5,"female",687,266,157,257,154,92,50,165,104
1700964,22,27,1991,9,"male",264,277,202,788,115,788,79,0,36
1700968,108,8,1905,11,"female",1568,104,43,23,9,1,2,22,7
1700971,53,21,1960,1,"male",639,65,46,2,0,2,0,0,0
1701015,33,11,1980,5,"male",118,25,21,6,2,6,1,0,1
1701047,59,1,1954,5,"male",970,41,10,33,31,33,8,0,23
1701050,29,26,1984,6,NA,218,41,12,0,0,0,0,0,0
1701078,89,19,1924,3,"male",1625,367,171,318,152,3,88,315,64
1701081,37,5,1976,2,"female",422,105,46,105,26,0,15,105,11
1701118,42,9,1971,5,"male",671,74,40,1,45,1,41,0,4
1701148,38,25,1975,2,"female",227,93,62,188,223,188,212,0,11
1701156,56,27,1957,2,"male",225,4,4,0,0,0,0,0,0
1701160,35,7,1978,2,"female",216,4,3,10,6,10,6,0,0
1701175,27,29,1986,8,"female",398,194,171,0,1,0,1,0,0
1701177,23,11,1990,2,"male",308,103,33,25,3,24,1,1,2
1701193,50,18,1963,10,"female",705,72,57,2432,201,2432,127,0,74
1701199,59,6,1954,3,"male",96,35,25,0,0,0,0,0,0
1701211,43,29,1970,4,"male",792,18,18,35,3,35,3,0,0
1701222,29,12,1984,6,"male",391,20,16,3,2,3,2,0,0
1701223,27,27,1986,2,"female",806,279,212,89,82,68,39,21,43
1701229,28,19,1985,7,"female",305,32,28,0,2,0,0,0,2
1701243,59,15,1954,7,"male",787,79,57,22,5,1,3,21,2
1701252,19,5,1994,7,"male",554,151,115,32,33,32,24,0,9
1701255,46,7,1967,7,"female",941,189,116,665,399,387,110,278,289
1701310,20,19,1993,11,"male",43,109,101,550,140,550,59,0,81
1701335,14,17,1999,8,"female",410,824,224,10,12,0,12,10,0
1701344,18,28,1995,11,"male",431,356,150,62,82,38,32,24,50
1701359,15,22,1998,10,"male",179,52,31,10,4,10,1,0,3
1701410,19,19,1994,12,"male",418,252,228,2,1,2,1,0,0
1701416,42,17,1971,5,"female",369,104,49,14,8,14,7,0,1
1701437,19,20,1994,5,"male",211,165,84,408,369,408,318,0,51
1701443,25,28,1988,3,"female",6,9,9,0,0,0,0,0,0
1701444,22,3,1991,10,"male",554,144,143,0,0,0,0,0,0
1701446,55,17,1958,1,"female",766,141,100,8,33,8,32,0,1
1701447,19,22,1994,11,"female",380,219,83,100,262,100,100,0,162
1701466,51,14,1962,8,"male",482,30,24,118,6,118,3,0,3
1701492,35,20,1978,4,"male",294,154,117,33,11,0,2,33,9
1701527,58,26,1955,5,"female",303,6,3,3,0,0,0,3,0
1701530,25,1,1988,7,"male",688,259,219,3,0,3,0,0,0
1701543,33,24,1980,1,"female",238,44,22,27,5,0,3,27,2
1701598,79,3,1934,2,"female",1235,126,52,70,13,0,9,70,4
1701600,16,26,1997,1,"male",704,96,83,0,3,0,3,0,0
1701635,33,30,1980,4,"male",597,117,94,53,80,29,49,24,31
1701638,32,24,1981,4,"female",1900,207,152,121,497,109,335,12,162
1701666,24,3,1989,11,"male",181,144,74,1120,189,1108,139,12,50
1701711,63,1,1950,1,"male",990,45,11,459,264,0,40,459,224
1701713,62,24,1951,6,"female",1288,33,13,2,0,2,0,0,0
1701725,16,7,1997,1,"female",688,2243,559,332,2931,287,1861,45,1070
1701731,19,13,1994,6,"female",526,738,597,152,8,152,8,0,0
1701761,14,25,1999,6,"male",191,189,172,0,3,0,3,0,0
1701764,21,16,1992,4,"female",628,177,106,95,62,91,59,4,3
1701854,35,2,1978,8,"female",427,210,138,165,27,165,23,0,4
1701871,32,28,1981,4,"male",290,87,63,40,79,27,24,13,55
1701874,20,24,1993,1,"male",248,88,50,158,55,158,22,0,33
1701875,44,28,1969,5,"male",1000,38,24,4,2,4,0,0,2
1701878,14,2,1999,5,"male",209,74,34,0,0,0,0,0,0
1701880,27,10,1986,1,"male",805,135,88,10,5,10,5,0,0
1701885,58,11,1955,7,"female",493,125,106,750,319,438,241,312,78
1701894,16,22,1997,5,"female",384,573,340,102,22,102,11,0,11
1701897,13,14,2000,2,"female",126,2,1,0,0,0,0,0,0
1701905,24,5,1989,9,"female",442,909,520,327,214,91,52,236,162
1701914,18,23,1995,12,"female",214,224,175,561,4,561,4,0,0
1701922,16,9,1997,6,"male",134,225,182,1420,200,8,105,1412,95
1701931,22,12,1991,6,"male",416,757,722,905,524,905,263,0,261
1701966,17,16,1996,12,"female",1082,4464,1716,2049,17159,681,9657,1367,7502
1701972,108,2,1905,6,"female",1233,67,35,58,34,58,29,0,5
1701976,16,25,1997,11,"female",626,572,401,578,542,34,216,544,326
1701978,28,13,1985,7,"male",333,99,50,0,0,0,0,0,0
1701997,18,18,1995,11,"male",320,104,74,35,8,35,4,0,4
1702005,19,6,1994,2,"male",424,109,87,0,0,0,0,0,0
1702012,68,29,1945,12,"female",733,91,61,224,62,224,39,0,23
1702044,43,20,1970,5,"female",210,40,25,0,0,0,0,0,0
1702049,19,31,1994,10,"female",340,37,3,0,0,0,0,0,0
1702057,76,29,1937,9,"male",1071,178,136,27,4,0,2,27,2
1702078,40,5,1973,4,"male",122,16,13,99,13,60,12,39,1
1702081,20,1,1993,1,"male",222,62,36,27,3,0,1,27,2
1702102,86,2,1927,2,"female",228,34,32,7,2,0,1,7,1
1702113,18,4,1995,8,"female",104,290,30,436,211,332,145,104,66
1702124,94,18,1919,10,"male",1857,278,101,102,54,63,25,39,29
1702171,23,26,1990,11,"female",53,239,196,102,125,14,80,88,45
1702188,34,29,1979,12,"male",195,44,17,0,0,0,0,0,0
1702206,26,9,1987,10,"female",100,10,4,77,110,77,41,0,69
1702215,15,31,1998,1,"male",133,55,18,0,0,0,0,0,0
1702223,26,29,1987,9,"female",276,285,216,352,395,352,351,0,44
1702283,55,5,1958,2,"female",1295,33,16,20,2,19,1,1,1
1702300,47,16,1966,3,"female",187,90,47,2691,1557,2691,1013,0,544
1702314,14,2,1999,10,"male",84,344,317,0,1,0,0,0,1
1702317,33,1,1980,1,"male",82,25,21,0,1,0,0,0,1
1702321,26,1,1987,10,"male",62,29,16,1,0,0,0,1,0
1702342,20,1,1993,2,"male",197,49,44,0,0,0,0,0,0
1702364,95,11,1918,9,"male",2168,216,112,30,5,30,5,0,0
1702412,20,8,1993,3,"male",359,902,668,105,57,105,51,0,6
1702439,24,23,1989,5,"male",527,200,135,63,34,63,24,0,10
1702476,19,6,1994,1,"female",230,76,55,57,15,0,2,57,13
1702491,27,19,1986,6,"female",883,164,77,0,2,0,2,0,0
1702502,25,27,1988,11,"female",729,283,207,316,168,296,155,20,13
1702509,23,27,1990,4,"female",136,87,48,43,29,43,28,0,1
1702530,48,28,1965,6,"male",600,43,25,2,16,2,13,0,3
1702566,24,21,1989,1,"female",23,0,0,0,0,0,0,0,0
1702584,24,16,1989,9,"female",444,19,9,25,14,21,11,4,3
1702586,45,3,1968,6,"female",395,56,33,33,8,33,4,0,4
1702597,61,1,1952,1,"male",567,28,20,403,47,403,46,0,1
1702602,15,23,1998,1,"female",830,238,154,171,41,43,31,128,10
1702612,26,13,1987,11,"male",113,49,38,1,1,1,1,0,0
1702661,19,29,1994,6,"female",609,745,530,11,1,11,1,0,0
1702665,18,8,1995,8,"male",455,46,38,9,1,7,1,2,0
1702694,57,24,1956,6,"male",141,20,17,22,21,6,2,16,19
1702709,20,2,1993,9,"male",223,53,27,33,2,2,2,31,0
1702728,29,9,1984,9,"male",148,40,37,25,0,25,0,0,0
1702741,55,24,1958,2,"male",100,13,11,0,1,0,0,0,1
1702744,23,1,1990,1,"male",170,27,9,4,13,4,9,0,4
1702766,38,21,1975,2,"male",238,115,70,6,3,0,1,6,2
1702770,21,2,1992,8,"female",412,15,5,6,4,6,3,0,1
1702775,59,1,1954,2,"female",435,44,22,859,607,832,159,27,448
1702807,20,19,1993,8,"male",45,3,3,18,3,3,1,15,2
1702856,56,11,1957,7,"female",670,20,8,30,9,0,4,30,5
1702868,22,6,1991,4,"female",56,66,10,1,0,1,0,0,0
1702870,15,26,1998,2,"male",192,98,69,4,2,4,2,0,0
1702902,77,1,1936,6,"male",1632,133,51,59,165,59,132,0,33
1702912,63,1,1950,9,"female",649,77,24,10,8,0,3,10,5
1702918,44,8,1969,4,"male",166,30,12,22,4,22,1,0,3
1702946,61,28,1952,6,"male",759,4,2,2,1,0,1,2,0
1702960,21,12,1992,1,"male",644,9,8,0,0,0,0,0,0
1702961,44,4,1969,11,"male",721,32,24,301,43,301,35,0,8
1702973,29,7,1984,3,"male",601,96,50,109,33,109,32,0,1
1702977,30,23,1983,8,"male",344,171,59,40,52,40,37,0,15
1703036,17,3,1996,4,"female",331,138,108,492,67,386,27,106,40
1703050,31,9,1982,10,"male",795,75,53,34,2,26,2,8,0
1703058,18,24,1995,12,"female",417,58,35,0,11,0,4,0,7
1703086,47,21,1966,7,"male",601,76,26,3,45,0,28,3,17
1703089,14,17,1999,6,"female",160,216,153,8,2,7,1,1,1
1703131,57,23,1956,1,"female",1276,130,73,20,22,13,16,7,6
1703196,24,3,1989,3,"female",544,45,32,20,11,0,1,20,10
1703233,71,19,1942,3,"female",977,57,29,134,14,0,0,134,14
1703236,69,18,1944,10,"male",185,0,0,0,0,0,0,0,0
1703251,28,1,1985,1,"male",120,88,46,9,48,1,14,8,34
1703255,60,25,1953,6,"male",650,78,41,3,1,3,1,0,0
1703272,20,14,1993,4,"male",167,127,90,24,0,24,0,0,0
1703284,27,3,1986,11,"male",322,198,157,0,0,0,0,0,0
1703316,18,18,1995,12,"male",106,4,3,0,0,0,0,0,0
1703320,108,5,1905,5,"male",1259,670,352,0,0,0,0,0,0
1703323,28,16,1985,7,"male",330,393,369,64,22,64,17,0,5
1703367,60,1,1953,12,"male",1832,71,13,8,3,0,1,8,2
1703368,30,17,1983,8,"male",194,336,109,133,225,133,183,0,42
1703424,27,18,1986,2,"female",438,14,9,0,1,0,1,0,0
1703449,15,5,1998,5,"female",135,185,50,0,0,0,0,0,0
1703454,25,1,1988,1,"male",535,27,21,0,0,0,0,0,0
1703466,22,22,1991,7,"male",145,214,193,30,17,6,5,24,12
1703474,21,20,1992,10,"female",245,47,29,2,4,2,4,0,0
1703540,24,22,1989,2,"female",339,8,6,0,0,0,0,0,0
1703547,16,5,1997,3,"male",365,374,244,5,8,5,6,0,2
1703553,27,9,1986,4,"male",78,43,37,31,31,30,17,1,14
1703560,18,10,1995,2,"female",60,43,37,105,231,35,111,70,120
1703563,15,4,1998,8,"male",285,2,0,0,0,0,0,0,0
1703601,19,5,1994,9,"male",452,6,5,0,0,0,0,0,0
1703626,17,2,1996,3,"male",43,81,66,0,1,0,1,0,0
1703629,18,8,1995,3,"male",432,195,101,3,2,1,2,2,0
1703637,64,14,1949,8,"female",1681,121,91,53,44,11,9,42,35
1703650,70,2,1943,1,NA,2165,70,35,1,1,1,0,0,1
1703653,62,19,1951,2,"male",752,266,150,49,255,5,126,44,129
1703770,17,26,1996,10,"female",243,241,182,44,108,32,49,12,59
1703812,20,27,1993,2,"male",268,103,58,3,0,3,0,0,0
1703816,23,15,1990,5,"male",455,161,40,10,7,10,7,0,0
1703827,49,7,1964,6,"male",587,113,80,0,1,0,1,0,0
1703844,14,8,1999,3,"male",349,77,41,0,1,0,1,0,0
1703869,20,5,1993,3,"male",166,1,1,1,0,1,0,0,0
1703905,20,28,1993,6,"male",463,211,171,0,1,0,0,0,1
1703907,23,18,1990,5,"female",495,139,102,18,98,18,87,0,11
1703917,17,21,1996,5,"female",688,167,51,1027,104,1027,19,0,85
1703984,18,9,1995,8,"female",261,386,119,13,9,13,9,0,0
1704007,45,1,1968,1,"male",4,0,0,0,0,0,0,0,0
1704022,54,16,1959,9,"male",781,99,26,53,154,52,100,1,54
1704055,25,4,1988,10,"female",22,4,3,0,2,0,2,0,0
1704065,18,2,1995,6,"female",637,578,352,27,117,27,77,0,40
1704083,20,2,1993,1,"female",712,239,81,19,0,19,0,0,0
1704085,15,2,1998,10,"male",308,105,62,88,22,82,17,6,5
1704086,79,19,1934,11,"female",887,162,68,510,225,500,192,10,33
1704087,31,24,1982,6,"male",526,1,0,0,0,0,0,0,0
1704094,67,10,1946,6,"female",1783,206,109,170,134,170,89,0,45
1704119,18,10,1995,9,"male",267,223,159,20,13,20,11,0,2
1704158,52,28,1961,6,"female",1225,159,71,3,3,0,1,3,2
1704164,57,29,1956,1,"male",263,320,259,4578,873,0,334,4578,539
1704182,31,17,1982,4,"male",150,19,16,54,9,54,7,0,2
1704194,37,3,1976,4,"male",266,63,36,3,32,0,18,3,14
1704202,37,29,1976,10,"male",344,59,31,0,1,0,1,0,0
1704204,21,1,1992,1,"male",23,8,8,0,0,0,0,0,0
1704208,26,19,1987,7,"male",1002,107,82,0,7,0,5,0,2
1704214,18,30,1995,12,"female",720,644,271,14,15,14,15,0,0
1704246,21,22,1992,7,"male",427,244,175,0,0,0,0,0,0
1704251,31,14,1982,4,"female",219,24,15,237,40,150,38,87,2
1704254,37,18,1976,9,"female",219,36,19,113,38,113,33,0,5
1704287,20,5,1993,3,"female",443,158,117,338,198,338,180,0,18
1704291,70,27,1943,10,"female",1637,24,14,23,0,0,0,23,0
1704326,18,27,1995,6,"male",244,4,4,0,0,0,0,0,0
1704359,25,11,1988,10,"male",188,70,57,1,9,0,4,1,5
1704365,22,15,1991,9,"female",254,63,23,45,16,45,8,0,8
1704394,19,10,1994,8,"female",376,290,99,649,324,528,162,121,162
1704396,23,4,1990,3,"female",1922,203,67,1034,397,996,273,38,124
1704397,50,12,1963,1,"male",650,0,0,0,0,0,0,0,0
1704415,27,30,1986,1,"male",212,45,29,253,97,253,77,0,20
1704416,30,18,1983,6,"male",626,1375,1093,0,9,0,4,0,5
1704432,58,22,1955,10,"female",129,138,135,13,3,13,1,0,2
1704433,17,15,1996,5,"female",283,353,114,35,51,35,31,0,20
1704439,33,25,1980,4,"female",266,49,28,47,52,47,45,0,7
1704465,18,4,1995,12,"male",150,77,70,0,0,0,0,0,0
1704469,26,13,1987,2,"male",435,80,50,47,42,5,14,42,28
1704481,53,5,1960,5,"female",179,9,9,0,0,0,0,0,0
1704518,66,8,1947,6,"female",503,24,9,3,10,2,7,1,3
1704524,23,28,1990,11,"female",413,9,6,0,0,0,0,0,0
1704557,62,27,1951,3,"male",2493,166,44,0,0,0,0,0,0
1704576,55,10,1958,10,"female",1212,167,101,20,15,0,7,20,8
1704579,19,17,1994,7,"male",349,91,58,0,26,0,4,0,22
1704580,28,27,1985,1,"male",371,413,262,78,33,78,28,0,5
1704583,28,17,1985,7,NA,1864,27,16,16,47,13,29,3,18
1704587,37,4,1976,6,"male",353,37,30,0,29,0,21,0,8
1704599,29,29,1984,8,"female",381,190,129,1,30,1,23,0,7
1704605,70,4,1943,4,"female",1571,35,14,1,10,0,4,1,6
1704620,19,28,1994,2,"male",60,44,36,5,0,5,0,0,0
1704642,42,28,1971,2,"male",387,7,4,0,0,0,0,0,0
1704649,23,19,1990,5,"male",529,48,38,12,7,12,7,0,0
1704659,18,3,1995,5,"female",238,1120,655,5191,2738,4875,1098,316,1640
1704669,21,9,1992,12,"male",501,264,164,112,170,53,70,59,100
1704701,103,31,1910,10,"female",1790,161,83,410,320,7,97,403,223
1704709,53,7,1960,1,"male",504,380,248,20,142,20,102,0,40
1704732,24,25,1989,9,"female",162,204,62,54,33,54,14,0,19
1704740,24,9,1989,2,"male",480,80,41,0,1,0,0,0,1
1704763,101,6,1912,12,"female",1145,929,538,386,807,386,473,0,334
1704800,58,26,1955,5,"male",556,55,51,1,1,0,1,1,0
1704821,29,12,1984,3,"male",134,12,11,0,0,0,0,0,0
1704839,17,4,1996,9,"female",497,300,152,0,2,0,1,0,1
1704899,64,5,1949,6,"female",329,70,51,0,0,0,0,0,0
1704903,23,13,1990,3,"male",269,172,154,8,1,8,1,0,0
1704911,30,21,1983,6,"male",425,38,29,0,0,0,0,0,0
1704949,24,17,1989,6,"male",663,106,95,23,5,12,2,11,3
1704951,18,5,1995,1,"male",606,151,135,0,0,0,0,0,0
1704961,49,14,1964,7,"male",345,23,12,1,2,1,0,0,2
1704979,15,29,1998,6,"male",150,124,85,26,8,26,8,0,0
1704996,22,21,1991,4,"male",471,354,297,133,6,133,6,0,0
1704998,24,13,1989,11,"male",650,306,71,2,9,0,5,2,4
1705001,43,2,1970,5,"female",277,118,83,10,76,10,55,0,21
1705011,100,13,1913,9,"female",251,52,40,886,332,886,270,0,62
1705022,16,18,1997,2,"female",570,304,207,447,260,49,138,398,122
1705055,19,23,1994,4,"female",318,129,93,2671,31,2671,28,0,3
1705060,21,9,1992,1,"male",177,10,7,1,1,1,1,0,0
1705062,22,29,1991,1,"male",342,161,95,653,40,653,28,0,12
1705128,39,12,1974,2,"female",116,45,24,4,29,3,21,1,8
1705139,50,2,1963,1,"male",693,27,8,0,0,0,0,0,0
1705142,24,10,1989,6,"male",34,81,78,106,10,106,6,0,4
1705220,41,26,1972,12,"male",169,5,5,0,0,0,0,0,0
1705230,16,6,1997,5,"female",278,281,193,361,385,73,131,288,254
1705241,59,3,1954,12,"female",159,52,28,323,23,323,22,0,1
1705254,15,1,1998,12,"female",100,406,294,549,804,547,762,2,42
1705272,70,9,1943,2,"female",251,63,21,16,24,16,18,0,6
1705312,20,14,1993,8,"male",114,30,27,3,1,0,1,3,0
1705355,60,23,1953,10,"female",603,26,13,9,21,9,18,0,3
1705395,61,29,1952,11,"female",370,72,38,389,107,0,27,389,80
1705398,28,1,1985,2,"male",73,2,2,64,6,64,6,0,0
1705421,32,27,1981,11,"male",792,387,330,134,276,134,214,0,62
1705454,27,21,1986,3,"male",752,252,114,19,1,19,1,0,0
1705462,81,24,1932,6,"female",1747,43,14,182,17,0,7,182,10
1705466,60,4,1953,11,"male",1061,224,81,1,0,1,0,0,0
1705480,56,13,1957,2,"male",597,49,40,0,2,0,1,0,1
1705485,18,20,1995,2,"female",61,139,123,760,1072,748,840,12,232
1705502,17,14,1996,5,"female",404,291,202,390,347,107,157,283,190
1705510,49,18,1964,10,"male",344,98,74,314,63,314,50,0,13
1705512,37,17,1976,10,"female",119,393,144,586,931,279,302,307,629
1705522,58,2,1955,7,"female",1443,76,45,20,8,0,0,20,8
1705524,68,20,1945,1,"male",293,495,263,0,0,0,0,0,0
1705525,17,10,1996,5,"male",438,142,100,0,18,0,15,0,3
1705531,25,21,1988,7,"male",660,55,21,2,3,2,2,0,1
1705546,65,21,1948,9,"female",968,40,27,116,12,0,5,116,7
1705547,24,5,1989,6,"female",365,652,225,758,736,752,293,6,443
1705561,55,9,1958,4,"male",983,520,135,187,247,62,139,125,108
1705598,21,6,1992,6,"male",566,76,50,8,13,8,2,0,11
1705605,16,1,1997,1,"female",301,9,5,63,19,63,7,0,12
1705612,32,30,1981,4,"male",214,137,22,0,0,0,0,0,0
1705640,70,21,1943,7,"male",1424,19,13,1,5,0,0,1,5
1705661,23,15,1990,2,"female",279,117,89,50,34,50,17,0,17
1705669,23,7,1990,12,"male",146,248,121,6,14,0,1,6,13
1705678,24,3,1989,6,"male",718,30,23,191,19,182,13,9,6
1705711,108,30,1905,1,"male",1074,914,814,56,68,0,51,56,17
1705721,100,18,1913,7,"female",1873,251,118,23,7,0,6,23,1
1705726,41,8,1972,5,"male",844,194,133,3,11,3,11,0,0
1705745,26,22,1987,6,"female",43,3,2,0,0,0,0,0,0
1705773,22,1,1991,9,"female",281,54,45,12,19,12,3,0,16
1705796,37,24,1976,12,"male",545,16,5,5,0,5,0,0,0
1705832,19,18,1994,12,"female",718,800,552,35,85,35,60,0,25
1705857,39,29,1974,8,"male",438,10,7,7,2,7,2,0,0
1705862,21,17,1992,9,"female",968,3279,2693,1402,2226,1346,1976,56,250
1705866,86,13,1927,9,"female",2389,173,76,24,45,7,25,17,20
1705889,98,14,1915,10,"male",1736,145,73,26,31,0,8,26,23
1705914,100,7,1913,9,"female",168,60,34,2048,177,2048,115,0,62
1705922,21,19,1992,8,"male",1067,184,28,8,12,8,3,0,9
1705937,43,7,1970,4,"male",197,14,12,2,0,2,0,0,0
1705944,39,10,1974,6,"male",151,59,52,54,81,54,77,0,4
1706004,29,5,1984,4,"female",460,242,164,398,133,398,94,0,39
1706008,30,24,1983,9,"female",889,98,61,1,0,1,0,0,0
1706016,46,11,1967,1,"male",525,437,327,13,12,5,4,8,8
1706044,17,25,1996,8,"male",538,82,63,0,1,0,1,0,0
1706048,44,4,1969,2,"female",396,70,53,46,3,0,0,46,3
1706054,39,24,1974,6,"male",271,36,15,92,15,92,14,0,1
1706124,24,5,1989,11,"male",308,167,161,2,14,2,13,0,1
1706133,25,13,1988,9,"female",913,696,136,111,401,82,350,29,51
1706143,53,12,1960,11,"male",1319,124,81,16,2,13,1,3,1
1706149,61,28,1952,11,"male",2132,181,100,92,384,47,221,45,163
1706174,17,4,1996,5,"male",157,99,37,194,23,194,13,0,10
1706177,17,10,1996,7,"male",425,199,31,4,0,4,0,0,0
1706193,18,6,1995,1,"male",775,849,599,38,166,38,134,0,32
1706201,24,8,1989,5,"female",252,146,118,83,16,83,11,0,5
1706234,19,6,1994,7,"male",711,205,136,0,0,0,0,0,0
1706258,18,25,1995,10,"male",200,422,151,0,1,0,1,0,0
1706262,28,8,1985,5,"male",1667,67,29,8,19,8,9,0,10
1706284,31,5,1982,5,"male",454,85,58,14,17,7,2,7,15
1706290,24,3,1989,8,"female",654,292,115,0,0,0,0,0,0
1706294,18,10,1995,12,"female",610,139,64,605,1072,221,208,384,864
1706302,30,28,1983,12,"male",537,42,16,0,1,0,0,0,1
1706380,16,19,1997,5,"female",216,333,168,446,442,446,171,0,271
1706381,108,17,1905,10,"male",258,570,396,928,436,896,258,32,178
1706398,27,22,1986,5,"male",479,301,143,8,47,8,24,0,23
1706422,14,10,1999,10,"female",299,13,8,0,0,0,0,0,0
1706425,24,16,1989,9,"male",326,132,84,3,2,3,0,0,2
1706543,67,24,1946,1,"female",1552,119,66,422,716,236,89,186,627
1706544,51,7,1962,3,"female",84,2,2,4,2,4,2,0,0
1706647,25,1,1988,1,"male",0,0,0,0,0,0,0,0,0
1706664,26,10,1987,2,"female",682,331,190,35,77,16,41,19,36
1706728,24,17,1989,12,"female",277,202,125,45,69,45,57,0,12
1706855,14,14,1999,7,"male",128,153,122,0,0,0,0,0,0
1706868,73,27,1940,8,"female",546,94,58,1,14,1,7,0,7
1706874,27,17,1986,10,"male",598,83,35,1,6,1,6,0,0
1706925,55,25,1958,9,"male",30,30,23,233,4,233,3,0,1
1706929,18,9,1995,2,"female",547,290,75,8,7,8,6,0,1
1706937,41,29,1972,7,"female",438,11,6,71,3,71,3,0,0
1706949,40,16,1973,5,"male",1451,101,45,3,3,3,3,0,0
1706958,18,16,1995,2,"male",120,121,74,29,7,15,3,14,4
1706969,53,19,1960,2,"male",222,29,19,0,17,0,12,0,5
1706976,26,11,1987,2,"female",238,9,4,0,0,0,0,0,0
1707025,20,31,1993,10,"female",389,367,201,30,8,0,2,30,6
1707028,51,1,1962,10,"male",1011,25,19,1,1,0,0,1,1
1707075,17,15,1996,2,"male",613,119,65,0,0,0,0,0,0
1707082,17,9,1996,5,"female",410,70,26,1,3,1,1,0,2
1707134,43,22,1970,10,"male",148,2,1,0,0,0,0,0,0
1707144,17,20,1996,7,"male",97,170,160,82,18,82,18,0,0
1707203,22,16,1991,5,"female",550,253,165,266,220,266,198,0,22
1707204,54,31,1959,5,"male",573,128,65,0,0,0,0,0,0
1707224,42,9,1971,1,"male",676,58,37,4,4,0,4,4,0
1707239,21,6,1992,6,"male",795,18,7,1,1,0,1,1,0
1707248,33,29,1980,9,"female",197,92,45,5,76,5,50,0,26
1707253,30,5,1983,6,"male",1104,93,44,98,41,10,34,88,7
1707256,17,16,1996,6,"female",480,953,739,18,201,18,164,0,37
1707261,17,8,1996,9,"male",682,205,95,4,0,4,0,0,0
1707278,55,7,1958,7,"female",1841,93,27,273,95,126,56,147,39
1707292,14,9,1999,4,"male",490,145,97,0,0,0,0,0,0
1707331,37,4,1976,6,"male",167,19,6,0,1,0,1,0,0
1707345,71,26,1942,5,"male",729,69,45,113,82,0,20,113,62
1707379,31,9,1982,8,"male",202,107,52,35,6,0,2,35,4
1707398,29,13,1984,2,"male",391,78,73,195,0,190,0,5,0
1707399,30,15,1983,1,"female",492,74,14,0,0,0,0,0,0
1707406,57,3,1956,4,"female",1629,319,117,1125,46,1125,37,0,9
1707422,47,28,1966,2,"male",325,33,13,14,0,0,0,14,0
1707429,61,8,1952,7,"male",946,50,29,1,10,0,3,1,7
1707439,41,5,1972,7,"male",292,12,7,0,1,0,0,0,1
1707445,34,11,1979,2,"female",223,29,5,0,1,0,0,0,1
1707455,16,17,1997,11,"male",68,15,15,0,0,0,0,0,0
1707457,53,13,1960,5,"male",98,58,52,2,3,2,2,0,1
1707467,32,9,1981,6,"male",790,19,6,0,0,0,0,0,0
1707489,25,27,1988,6,"male",4,9,8,6,0,6,0,0,0
1707497,39,24,1974,1,"female",154,39,32,95,120,95,60,0,60
1707504,23,7,1990,4,"female",291,1728,660,3897,4233,3897,3899,0,334
1707518,18,4,1995,10,"male",108,255,157,794,383,794,323,0,60
1707520,67,12,1946,7,"male",1570,25,4,29,1,29,1,0,0
1707534,23,17,1990,2,"male",310,14,14,0,0,0,0,0,0
1707546,55,26,1958,8,"male",706,33,27,1,0,0,0,1,0
1707564,59,11,1954,5,"male",893,37,24,8,0,0,0,8,0
1707619,36,18,1977,3,"female",446,112,45,33,82,33,33,0,49
1707628,23,10,1990,4,"male",127,116,104,41,20,38,11,3,9
1707654,24,10,1989,10,"female",248,207,113,53,41,11,11,42,30
1707683,17,2,1996,2,"male",526,62,47,0,0,0,0,0,0
1707699,17,17,1996,3,"male",563,585,510,3,10,3,8,0,2
1707732,26,2,1987,10,"female",430,49,35,20,21,20,13,0,8
1707735,26,17,1987,7,"male",142,203,177,32,52,32,37,0,15
1707750,33,23,1980,5,"male",74,25,9,47,7,0,2,47,5
1707752,19,24,1994,5,"male",1252,90,36,9,0,9,0,0,0
1707759,19,16,1994,2,"male",178,72,68,0,0,0,0,0,0
1707779,16,13,1997,10,"male",14,12,10,1,1,1,1,0,0
1707787,39,8,1974,12,"female",496,0,0,0,0,0,0,0,0
1707840,58,7,1955,4,"male",1420,1619,882,129,404,121,210,8,194
1707848,67,15,1946,12,"female",1937,24,13,16,49,14,25,2,24
1707857,23,10,1990,10,"male",277,412,378,5,64,5,42,0,22
1707872,33,16,1980,8,"male",35,48,41,6,3,6,3,0,0
1707908,39,13,1974,11,"male",1571,402,166,11,28,7,22,4,6
1707912,41,10,1972,12,"female",629,89,50,40,74,8,28,32,46
1707922,31,19,1982,4,"female",2040,424,79,168,300,108,180,60,120
1707928,22,7,1991,5,"male",706,188,29,8,11,8,5,0,6
1707963,15,11,1998,11,"female",466,1843,1133,974,1469,142,427,832,1042
1707969,65,30,1948,8,"female",1068,133,105,657,62,657,47,0,15
1707988,53,25,1960,4,"female",1250,390,95,992,331,197,112,795,219
1708048,62,21,1951,3,"male",1370,106,55,0,1,0,0,0,1
1708055,101,6,1912,12,"male",450,81,47,14,7,14,7,0,0
1708070,34,29,1979,1,"female",315,95,19,7,260,7,91,0,169
1708092,43,15,1970,2,"female",585,33,12,16,40,0,27,16,13
1708100,21,11,1992,6,"female",189,27,16,26,37,26,24,0,13
1708115,19,1,1994,1,"male",179,47,40,0,1,0,1,0,0
1708119,32,3,1981,12,"male",698,87,32,0,0,0,0,0,0
1708124,56,20,1957,10,"female",1300,70,17,178,46,0,21,178,25
1708128,27,23,1986,3,"male",181,9,4,0,2,0,0,0,2
1708154,47,1,1966,12,"female",614,130,75,6,0,6,0,0,0
1708179,25,29,1988,3,"female",1058,496,310,217,332,201,182,16,150
1708257,59,5,1954,10,"female",1746,103,31,221,93,220,59,1,34
1708269,49,9,1964,4,"male",437,18,17,0,0,0,0,0,0
1708305,28,15,1985,2,"male",525,108,72,5,4,5,3,0,1
1708325,23,14,1990,9,"female",581,71,39,11,9,11,4,0,5
1708375,19,1,1994,4,"female",287,256,55,0,5,0,1,0,4
1708379,51,16,1962,7,"male",387,46,15,3,3,3,3,0,0
1708386,54,25,1959,6,"female",1408,93,60,577,65,539,41,38,24
1708398,43,1,1970,7,"male",220,0,0,0,0,0,0,0,0
1708410,31,9,1982,11,"male",597,295,130,3,0,3,0,0,0
1708447,48,16,1965,11,"female",522,30,22,184,78,147,36,37,42
1708453,56,31,1957,8,"male",1842,522,309,168,342,105,116,63,226
1708455,23,1,1990,1,"male",179,73,32,8,13,8,10,0,3
1708460,58,26,1955,9,"female",663,67,19,3,15,3,15,0,0
1708488,28,19,1985,3,"male",343,42,32,0,0,0,0,0,0
1708528,33,1,1980,10,"male",141,1,1,50,60,38,15,12,45
1708546,22,3,1991,7,"male",842,644,440,18,2,0,0,18,2
1708553,70,25,1943,12,"female",2172,252,139,136,69,20,40,116,29
1708594,14,29,1999,4,"male",463,372,128,10,42,5,7,5,35
1708629,30,9,1983,3,"male",706,9,7,83,6,74,6,9,0
1708630,100,10,1913,4,"male",189,51,31,59,13,59,12,0,1
1708655,47,28,1966,10,"male",655,4,1,0,0,0,0,0,0
1708656,71,1,1942,10,"male",247,12,10,0,2,0,1,0,1
1708674,23,8,1990,8,"male",174,90,65,4,4,4,4,0,0
1708704,18,30,1995,10,"male",514,229,192,0,0,0,0,0,0
1708726,17,25,1996,7,"male",254,166,127,224,240,92,135,132,105
1708746,62,15,1951,8,"female",432,21,17,69,0,69,0,0,0
1708754,15,26,1998,7,"male",277,353,288,343,338,209,222,134,116
1708776,57,20,1956,3,"male",572,73,56,46,23,7,18,39,5
1708792,31,24,1982,12,"male",50,64,43,18,0,18,0,0,0
1708793,100,13,1913,1,"female",1606,74,31,65,5,65,5,0,0
1708895,15,8,1998,9,"female",390,358,297,0,0,0,0,0,0
1708900,60,24,1953,9,"male",649,108,72,0,7,0,2,0,5
1708903,18,1,1995,1,"male",141,257,100,46,3,9,3,37,0
1708920,31,19,1982,7,"male",305,3,3,0,0,0,0,0,0
1708922,18,20,1995,2,"female",536,209,72,46,2,26,2,20,0
1708943,24,17,1989,1,"female",988,182,49,5,39,0,21,5,18
1708959,33,8,1980,6,"male",98,48,39,4,6,4,5,0,1
1708962,38,6,1975,5,"male",304,95,52,0,1,0,1,0,0
1708964,113,7,1900,4,"male",1164,213,166,86,51,86,35,0,16
1708978,21,2,1992,2,"female",339,79,31,197,159,1,27,196,132
1708979,26,27,1987,5,"male",290,52,28,0,1,0,1,0,0
1708998,18,21,1995,1,"male",622,191,120,0,0,0,0,0,0
1709052,30,29,1983,9,"male",223,37,30,11,5,11,5,0,0
1709078,18,1,1995,1,"female",330,124,33,222,786,222,473,0,313
1709109,55,30,1958,3,"female",621,74,35,4,9,0,4,4,5
1709128,28,7,1985,2,"male",330,11,1,0,0,0,0,0,0
1709183,37,16,1976,2,"male",243,10,3,0,3,0,3,0,0
1709201,23,21,1990,4,"male",498,62,53,2,0,0,0,2,0
1709220,15,1,1998,1,"male",311,255,153,0,3,0,2,0,1
1709243,32,23,1981,4,"male",553,43,25,36,49,31,34,5,15
1709262,24,21,1989,4,"male",69,75,55,1,3,1,3,0,0
1709263,91,26,1922,6,"female",538,12,11,0,0,0,0,0,0
1709302,64,1,1949,7,"male",1029,178,111,67,8,0,6,67,2
1709340,53,5,1960,12,"female",652,340,197,1113,193,396,65,717,128
1709353,26,26,1987,8,"female",492,40,23,1,1,1,1,0,0
1709355,55,12,1958,12,"female",575,0,0,0,0,0,0,0,0
1709362,20,30,1993,1,"male",1583,315,82,36,110,36,92,0,18
1709391,21,5,1992,11,"male",443,471,346,34,131,34,115,0,16
1709392,27,14,1986,6,"female",612,3,3,0,0,0,0,0,0
1709398,20,14,1993,6,"male",293,13,6,1,0,0,0,1,0
1709406,42,24,1971,11,"male",183,22,14,35,45,35,45,0,0
1709409,49,16,1964,6,"female",563,83,41,262,140,262,72,0,68
1709420,24,29,1989,8,"male",451,209,167,1,1,1,1,0,0
1709436,57,7,1956,9,"female",1695,256,119,456,365,328,248,128,117
1709441,15,13,1998,3,"male",311,53,31,0,0,0,0,0,0
1709482,68,22,1945,2,"male",1203,447,227,23,47,23,31,0,16
1709535,51,2,1962,7,"male",844,82,23,0,10,0,6,0,4
1709566,68,20,1945,7,"female",1698,125,64,103,116,83,71,20,45
1709578,30,19,1983,1,"male",254,22,20,0,0,0,0,0,0
1709591,25,8,1988,8,"male",59,86,80,19,4,6,4,13,0
1709608,31,5,1982,1,"female",255,107,90,2,20,0,9,2,11
1709641,27,14,1986,6,"male",126,5,4,0,0,0,0,0,0
1709664,61,2,1952,5,"male",806,22,12,8,0,0,0,8,0
1709670,15,3,1998,5,"male",200,14,5,0,0,0,0,0,0
1709673,44,18,1969,1,"female",416,19,7,0,1,0,1,0,0
1709713,38,22,1975,1,"male",453,19,12,31,2,31,2,0,0
1709742,31,4,1982,4,"male",7,22,18,0,0,0,0,0,0
1709754,18,31,1995,5,"male",157,168,97,16,3,4,1,12,2
1709812,51,21,1962,8,"male",558,32,19,51,28,51,22,0,6
1709824,75,1,1938,2,"female",441,21,19,5,3,0,2,5,1
1709832,52,9,1961,7,"male",752,69,22,123,153,122,135,1,18
1709838,62,9,1951,3,"male",1713,139,83,3,29,0,6,3,23
1709872,26,15,1987,5,"male",154,101,77,0,0,0,0,0,0
1709885,16,29,1997,8,"female",524,474,232,413,323,335,211,78,112
1709899,27,5,1986,7,"female",124,9,4,0,5,0,2,0,3
1709906,31,6,1982,9,"male",418,214,132,42,176,33,112,9,64
1709913,15,1,1998,9,"male",96,55,37,0,2,0,2,0,0
1709920,58,1,1955,2,"female",932,90,31,207,15,207,7,0,8
1709930,29,13,1984,2,"female",360,20,10,0,0,0,0,0,0
1709939,19,18,1994,3,"male",442,103,69,20,22,20,14,0,8
1709949,17,11,1996,5,"male",793,155,36,3,3,3,2,0,1
1709953,25,6,1988,4,"male",108,218,193,11,15,11,13,0,2
1709970,29,26,1984,6,"male",307,79,53,14,96,14,79,0,17
1710003,49,8,1964,7,"female",895,18,11,1,9,0,4,1,5
1710009,24,10,1989,4,"female",254,436,19,468,1246,468,1185,0,61
1710028,19,19,1994,3,"female",592,749,309,987,1080,278,594,709,486
1710044,34,7,1979,2,"male",411,130,112,3,1,0,0,3,1
1710049,58,1,1955,11,"female",1358,307,56,30,34,30,16,0,18
1710077,24,18,1989,3,"female",1319,315,83,0,7,0,7,0,0
1710086,26,17,1987,11,"male",861,39,26,0,0,0,0,0,0
1710101,21,9,1992,8,"male",151,31,14,7,5,7,2,0,3
1710122,26,17,1987,3,"male",643,142,77,0,5,0,0,0,5
1710123,113,10,1900,6,"female",2192,237,151,561,514,306,282,255,232
1710141,61,27,1952,6,"female",390,47,30,357,132,132,80,225,52
1710158,22,18,1991,10,"male",195,15,12,2,7,2,7,0,0
1710167,23,3,1990,4,"male",154,10,7,0,0,0,0,0,0
1710170,14,20,1999,2,"female",502,25,14,6,0,6,0,0,0
1710202,103,28,1910,4,"male",128,35,26,1,0,0,0,1,0
1710207,24,18,1989,6,"female",86,54,41,6,3,0,0,6,3
1710231,48,12,1965,1,"female",1657,74,46,31,73,31,61,0,12
1710282,26,20,1987,12,"male",683,408,203,729,510,374,303,355,207
1710291,41,23,1972,2,"female",492,7,6,0,0,0,0,0,0
1710311,26,23,1987,12,"female",421,386,235,3,35,3,32,0,3
1710348,51,4,1962,10,"male",4,15,13,6,0,6,0,0,0
1710374,55,2,1958,6,"female",672,30,24,0,0,0,0,0,0
1710380,21,11,1992,12,"male",229,8,4,0,0,0,0,0,0
1710396,47,11,1966,10,"female",115,9,2,0,0,0,0,0,0
1710404,18,21,1995,6,"male",325,286,179,12,41,12,41,0,0
1710418,50,16,1963,2,"female",544,161,20,93,21,93,12,0,9
1710476,25,29,1988,10,"male",190,162,82,2,81,2,49,0,32
1710502,13,9,2000,7,"female",507,46,13,14,0,0,0,14,0
1710508,17,17,1996,2,"male",197,43,30,3,0,0,0,3,0
1710512,15,7,1998,2,"male",667,611,460,1652,840,1619,576,33,264
1710514,14,13,1999,3,"male",236,155,118,0,0,0,0,0,0
1710524,18,1,1995,2,"male",231,208,158,6,34,6,33,0,1
1710528,17,11,1996,4,"male",276,397,305,0,0,0,0,0,0
1710535,65,10,1948,10,"female",726,16,4,35,17,0,2,35,15
1710549,27,24,1986,6,"female",717,46,19,0,0,0,0,0,0
1710563,49,10,1964,7,"male",339,1,0,0,0,0,0,0,0
1710586,58,18,1955,9,"female",413,16,11,10,0,0,0,10,0
1710590,27,13,1986,4,"male",1011,102,70,2,9,2,8,0,1
1710598,66,21,1947,10,"male",1013,87,11,0,12,0,6,0,6
1710601,74,3,1939,12,"male",835,75,51,31,10,13,2,18,8
1710625,18,24,1995,6,"female",551,3014,1028,226,3037,182,1809,44,1228
1710632,32,16,1981,10,"male",284,908,602,119,39,119,30,0,9
1710645,25,1,1988,7,"female",288,26,8,1,3,1,3,0,0
1710689,94,1,1919,1,"male",8,42,9,1,4,1,4,0,0
1710749,90,2,1923,11,"female",359,50,34,1,1,0,0,1,1
1710778,108,11,1905,9,"female",1269,160,86,508,40,508,24,0,16
1710783,42,22,1971,10,"male",434,47,22,337,181,336,124,1,57
1710792,20,5,1993,4,"male",38,85,78,19,45,19,8,0,37
1710879,36,10,1977,12,"male",397,13,12,7,0,0,0,7,0
1710881,43,29,1970,3,"male",229,41,18,0,0,0,0,0,0
1710885,26,28,1987,10,"female",671,303,226,128,374,93,202,35,172
1710898,51,6,1962,9,"female",899,20,9,6,10,5,9,1,1
1710903,23,10,1990,10,"female",235,648,93,272,85,259,50,13,35
1710919,19,8,1994,4,"male",235,874,708,48,3,48,3,0,0
1710929,27,18,1986,10,"male",370,154,121,4,4,4,2,0,2
1710989,47,21,1966,4,"male",1472,79,8,18,36,0,21,18,15
1711015,59,6,1954,3,"female",374,32,25,51,4,51,3,0,1
1711059,57,11,1956,12,"female",948,157,116,177,71,0,16,177,55
1711070,23,12,1990,12,"male",472,81,67,68,4,7,1,61,3
1711077,23,3,1990,4,"male",1253,27,18,0,2,0,1,0,1
1711083,19,4,1994,9,"female",664,92,71,18,46,18,24,0,22
1711091,26,1,1987,1,"female",485,65,47,7,15,0,7,7,8
1711106,26,4,1987,10,"male",613,58,55,31,14,31,14,0,0
1711135,29,31,1984,8,"male",333,6,5,0,0,0,0,0,0
1711156,58,26,1955,5,"male",648,6,5,1,0,0,0,1,0
1711172,58,16,1955,7,"male",167,103,84,5,2,5,1,0,1
1711185,30,20,1983,7,"male",417,621,483,402,217,342,66,60,151
1711205,20,23,1993,1,"female",282,119,38,29,2,29,1,0,1
1711218,18,8,1995,8,"male",684,295,79,1,27,1,26,0,1
1711249,65,13,1948,9,"male",332,64,51,60,17,0,9,60,8
1711268,24,8,1989,9,"male",54,3,2,1,0,1,0,0,0
1711280,45,22,1968,6,"female",622,727,516,1144,1083,20,449,1124,634
1711299,54,5,1959,6,"female",702,176,84,191,190,191,95,0,95
1711306,105,1,1908,1,"male",1577,75,30,0,0,0,0,0,0
1711314,61,5,1952,6,"female",657,136,119,62,28,0,9,62,19
1711316,23,1,1990,1,"female",27,0,0,0,0,0,0,0,0
1711320,31,27,1982,9,"male",28,44,40,155,94,155,84,0,10
1711333,103,3,1910,11,"male",895,401,268,302,365,2,57,300,308
1711336,21,7,1992,7,"male",16,10,10,4,0,4,0,0,0
1711343,28,22,1985,6,"male",298,84,61,54,121,54,106,0,15
1711355,60,31,1953,8,"male",1216,480,152,3,17,3,15,0,2
1711361,31,21,1982,8,"female",491,46,31,704,373,704,234,0,139
1711375,22,22,1991,5,"female",419,76,26,9,14,9,14,0,0
1711382,30,6,1983,5,"male",662,283,71,3,34,3,13,0,21
1711384,21,26,1992,4,"male",268,108,48,1,0,1,0,0,0
1711390,71,27,1942,12,"female",2026,412,222,745,509,739,268,6,241
1711399,38,14,1975,2,"male",337,14,14,0,0,0,0,0,0
1711400,16,17,1997,10,"male",282,133,117,9,8,9,8,0,0
1711417,34,26,1979,8,"female",757,75,52,1,0,1,0,0,0
1711465,21,7,1992,6,"male",717,78,54,0,0,0,0,0,0
1711482,20,17,1993,10,"male",129,62,23,23,12,18,10,5,2
1711488,16,7,1997,4,"male",27,5,3,1,0,1,0,0,0
1711495,16,25,1997,4,"male",453,62,37,0,17,0,8,0,9
1711518,29,11,1984,1,"male",282,128,105,0,0,0,0,0,0
1711521,25,11,1988,8,"male",294,150,106,7,2,7,2,0,0
1711549,101,6,1912,9,"male",779,236,133,34,2,34,2,0,0
1711591,25,1,1988,6,"male",223,84,46,22,64,22,22,0,42
1711603,103,17,1910,12,"female",1226,141,69,18,9,5,0,13,9
1711610,25,18,1988,11,"male",85,1,0,0,0,0,0,0,0
1711656,14,31,1999,3,"male",95,244,169,523,113,523,84,0,29
1711693,17,16,1996,4,"male",419,696,591,0,0,0,0,0,0
1711723,77,30,1936,3,"female",1480,29,6,0,0,0,0,0,0
1711739,49,2,1964,8,"male",535,113,72,3,3,0,0,3,3
1711746,22,8,1991,5,"female",469,48,32,9,6,9,6,0,0
1711747,62,23,1951,6,"male",274,4,3,1,2,0,0,1,2
1711764,16,8,1997,2,"male",184,119,90,0,5,0,4,0,1
1711778,16,19,1997,5,"female",489,153,7,75,3,73,3,2,0
1711798,51,16,1962,12,"male",987,123,36,12,29,12,23,0,6
1711803,55,22,1958,3,"male",1764,45,41,35,3,0,1,35,2
1711821,16,14,1997,9,"female",455,37,19,9,3,9,0,0,3
1711823,17,10,1996,8,"female",634,202,132,177,40,177,40,0,0
1711826,105,9,1908,7,"male",926,116,52,75,12,75,10,0,2
1711832,21,2,1992,2,"male",275,454,378,9,26,8,7,1,19
1711851,63,1,1950,7,"female",200,78,74,17,21,0,7,17,14
1711882,22,6,1991,11,"female",580,170,67,2,11,2,7,0,4
1711890,37,2,1976,8,"male",137,96,45,5,13,5,12,0,1
1711906,20,22,1993,9,"female",1500,409,278,555,215,423,122,132,93
1711937,50,14,1963,5,"female",426,126,64,265,166,12,102,253,64
1711940,25,9,1988,8,"male",404,64,42,0,5,0,2,0,3
1711971,65,3,1948,12,"male",1366,58,26,26,62,26,37,0,25
1711996,16,29,1997,3,"female",232,504,387,16,0,16,0,0,0
1711997,21,20,1992,3,"male",393,16,16,0,6,0,6,0,0
1712000,16,14,1997,1,"male",609,701,444,119,67,42,25,77,42
1712036,66,14,1947,1,"male",287,69,44,1,2,0,0,1,2
1712037,34,4,1979,5,"male",330,76,59,0,1,0,1,0,0
1712038,17,20,1996,3,"female",50,170,38,355,226,355,119,0,107
1712082,100,14,1913,5,"male",1038,242,162,28,9,28,8,0,1
1712102,14,5,1999,7,"female",442,381,228,857,399,857,91,0,308
1712125,56,1,1957,12,"male",356,0,0,0,0,0,0,0,0
1712148,34,11,1979,4,"male",311,212,208,2,23,2,7,0,16
1712161,21,24,1992,9,"male",623,43,29,84,189,42,39,42,150
1712171,66,29,1947,5,"male",1311,74,24,0,22,0,5,0,17
1712179,53,22,1960,5,"male",192,3,1,0,0,0,0,0,0
1712181,20,20,1993,9,"male",627,165,88,0,0,0,0,0,0
1712197,67,7,1946,12,"female",263,38,35,0,0,0,0,0,0
1712200,61,16,1952,10,"male",16,35,35,54,22,0,9,54,13
1712204,56,4,1957,3,"male",1762,216,37,70,132,64,80,6,52
1712217,25,1,1988,1,"male",296,28,12,0,6,0,2,0,4
1712229,16,5,1997,7,"male",395,59,56,0,0,0,0,0,0
1712247,22,6,1991,1,"female",271,45,19,0,0,0,0,0,0
1712267,33,4,1980,4,"male",119,96,51,1,2,1,2,0,0
1712268,16,15,1997,11,"female",198,154,132,0,0,0,0,0,0
1712292,45,22,1968,10,"male",655,214,161,893,212,893,132,0,80
1712300,19,31,1994,1,"male",503,2404,1993,4,515,4,450,0,65
1712337,26,29,1987,8,"male",472,14,12,0,0,0,0,0,0
1712338,78,15,1935,7,"female",725,32,12,2,11,0,1,2,10
1712339,63,25,1950,12,"female",1390,31,12,14,1,14,1,0,0
1712372,25,11,1988,5,"female",614,70,29,4,2,4,2,0,0
1712392,27,7,1986,4,"male",195,34,26,106,15,106,2,0,13
1712413,19,25,1994,10,"male",913,77,40,4,154,4,109,0,45
1712417,45,6,1968,12,"male",22,71,52,1,18,1,9,0,9
1712423,25,1,1988,1,"female",174,9,6,0,0,0,0,0,0
1712428,33,18,1980,2,"female",316,72,49,11,17,11,5,0,12
1712480,17,30,1996,7,"female",394,2590,1240,245,486,1,152,244,334
1712483,18,1,1995,1,"female",153,44,23,2,4,2,4,0,0
1712484,18,17,1995,9,"male",235,111,82,0,0,0,0,0,0
1712507,17,26,1996,5,"male",471,42,32,0,0,0,0,0,0
1712536,23,2,1990,1,"male",665,493,156,2765,1736,2765,1580,0,156
1712553,25,1,1988,7,"male",578,116,80,34,86,31,38,3,48
1712567,30,10,1983,6,"female",392,128,67,106,65,106,38,0,27
1712570,25,12,1988,11,"male",1068,179,54,171,216,133,99,38,117
1712573,60,31,1953,8,"female",215,5,4,0,0,0,0,0,0
1712578,16,14,1997,4,"female",598,987,633,13,82,13,68,0,14
1712594,58,25,1955,12,"male",6,105,90,486,161,486,160,0,1
1712634,28,25,1985,7,"male",328,0,0,0,0,0,0,0,0
1712637,17,31,1996,5,"male",361,328,221,340,131,340,111,0,20
1712642,24,8,1989,8,"male",11,14,13,33,7,33,7,0,0
1712643,20,27,1993,11,"female",449,105,62,13,18,4,7,9,11
1712647,52,4,1961,5,"female",887,990,832,331,78,331,41,0,37
1712648,32,4,1981,2,"male",902,33,13,8,0,8,0,0,0
1712649,61,5,1952,10,"male",1558,197,93,601,1579,46,1097,555,482
1712673,29,7,1984,9,"female",492,198,123,401,11,401,10,0,1
1712677,33,17,1980,8,"male",234,72,39,4,6,4,2,0,4
1712682,19,26,1994,8,"female",514,77,60,419,147,336,79,83,68
1712733,18,4,1995,11,"male",173,127,118,0,0,0,0,0,0
1712774,27,6,1986,10,"female",334,130,100,120,216,120,214,0,2
1712779,30,24,1983,6,"male",623,132,39,0,1,0,1,0,0
1712800,45,21,1968,9,"female",996,407,217,35,95,35,71,0,24
1712829,21,23,1992,7,"male",149,5,4,2,0,2,0,0,0
1712881,70,22,1943,9,"female",904,65,40,0,0,0,0,0,0
1712908,30,25,1983,4,"male",522,40,31,6,6,6,6,0,0
1712914,16,31,1997,10,"female",407,87,33,105,21,20,6,85,15
1712917,33,26,1980,8,"male",23,5,5,0,1,0,1,0,0
1712919,79,23,1934,9,"female",1625,82,21,5,5,5,4,0,1
1712939,51,20,1962,6,"male",1225,14,4,5,1,5,1,0,0
1712944,32,9,1981,8,"male",242,78,55,47,17,47,12,0,5
1712950,40,8,1973,11,"male",723,42,26,2,0,2,0,0,0
1712962,22,10,1991,4,"male",265,66,32,17,14,11,12,6,2
1712979,89,30,1924,8,"female",1433,1524,271,780,856,774,518,6,338
1713007,72,9,1941,12,"male",1126,16,9,0,5,0,5,0,0
1713035,40,18,1973,5,"male",490,98,82,120,37,120,5,0,32
1713036,41,1,1972,1,"female",141,22,17,1,2,1,2,0,0
1713074,23,21,1990,8,"female",740,1,1,0,0,0,0,0,0
1713098,41,2,1972,11,"male",760,27,7,0,0,0,0,0,0
1713100,15,16,1998,9,"male",551,238,162,139,0,139,0,0,0
1713114,21,5,1992,9,"male",303,131,101,13,13,13,3,0,10
1713127,108,26,1905,3,"female",1403,318,106,161,139,152,92,9,47
1713136,27,1,1986,4,"male",316,31,21,134,11,134,8,0,3
1713137,20,16,1993,6,"male",56,55,46,6,11,6,10,0,1
1713168,20,25,1993,4,"female",327,708,201,844,1629,844,1575,0,54
1713194,47,8,1966,5,"male",451,19,18,0,0,0,0,0,0
1713209,35,25,1978,12,"male",150,25,19,0,3,0,1,0,2
1713210,27,22,1986,5,"female",111,2,0,0,0,0,0,0,0
1713215,57,9,1956,8,"male",1028,38,21,0,0,0,0,0,0
1713256,52,27,1961,1,"female",580,110,56,19,14,19,13,0,1
1713265,60,12,1953,8,"male",8,0,0,0,0,0,0,0,0
1713268,28,9,1985,2,"male",546,34,10,0,17,0,11,0,6
1713298,52,27,1961,10,"female",1763,167,92,144,253,79,161,65,92
1713336,24,26,1989,3,"female",921,244,124,138,50,0,27,138,23
1713337,108,10,1905,5,"male",1008,444,186,0,2,0,0,0,2
1713351,19,4,1994,11,"female",190,1747,131,851,1132,381,597,470,535
1713398,20,15,1993,8,"male",96,19,9,0,3,0,3,0,0
1713427,23,8,1990,5,"male",34,14,14,64,8,0,1,64,7
1713451,23,15,1990,12,"male",754,298,150,434,190,431,117,3,73
1713461,22,17,1991,7,"female",661,347,215,628,433,73,82,555,351
1713485,51,8,1962,11,"female",498,65,22,37,39,37,16,0,23
1713494,45,15,1968,3,"male",72,45,33,10,18,10,6,0,12
1713565,20,6,1993,10,"male",431,202,162,28,13,28,13,0,0
1713568,21,16,1992,12,"female",313,149,106,73,9,73,8,0,1
1713571,25,2,1988,2,"male",191,116,83,74,110,74,72,0,38
1713583,18,18,1995,6,"male",292,249,63,52,49,4,22,48,27
1713585,35,17,1978,6,"female",401,8,4,0,0,0,0,0,0
1713613,14,4,1999,8,"female",408,1438,690,100,119,100,81,0,38
1713616,108,1,1905,1,"female",17,6,5,28,7,0,0,28,7
1713620,68,26,1945,6,"female",794,13,11,11,2,0,2,11,0
1713633,33,21,1980,12,"male",420,138,91,1,1,1,1,0,0
1713643,28,1,1985,1,"male",351,1,1,3,0,0,0,3,0
1713656,23,7,1990,12,"male",276,148,98,2,0,1,0,1,0
1713663,22,1,1991,9,"male",543,216,63,5,0,5,0,0,0
1713708,60,21,1953,3,"female",251,36,36,1,1,1,1,0,0
1713735,21,11,1992,3,"male",338,3,1,17,0,14,0,3,0
1713752,72,20,1941,2,"female",333,66,46,538,181,538,119,0,62
1713786,31,5,1982,5,"male",192,71,34,35,26,35,25,0,1
1713817,65,27,1948,9,"female",963,38,18,0,0,0,0,0,0
1713822,39,1,1974,1,"male",1071,78,28,8,18,8,10,0,8
1713824,15,5,1998,12,"male",330,64,23,0,1,0,1,0,0
1713872,88,25,1925,2,"male",1425,70,22,1,21,0,8,1,13
1713880,15,22,1998,5,"female",68,366,25,3,7,3,6,0,1
1713917,17,25,1996,8,"male",345,959,781,7,0,7,0,0,0
1713951,40,15,1973,10,"female",656,70,56,228,82,70,14,158,68
1713952,53,8,1960,1,"male",333,10,7,2,1,2,1,0,0
1713959,44,12,1969,12,"female",391,98,93,16,0,0,0,16,0
1713978,21,8,1992,8,"female",105,19,14,11,8,0,0,11,8
1713981,22,26,1991,7,"female",528,201,170,100,55,89,42,11,13
1713983,44,4,1969,12,"female",526,18,10,18,24,18,23,0,1
1713984,54,24,1959,1,"male",369,48,45,3,1,0,0,3,1
1714005,18,2,1995,4,"male",532,524,301,212,90,174,64,38,26
1714032,66,17,1947,2,"male",2114,163,55,6,33,1,2,5,31
1714033,70,3,1943,11,"female",1078,62,10,30,4,0,2,30,2
1714042,32,7,1981,5,"female",236,32,25,28,12,22,3,6,9
1714053,108,13,1905,3,"male",1500,202,24,12,4,2,2,10,2
1714065,21,31,1992,12,"male",42,30,8,0,0,0,0,0,0
1714081,74,11,1939,11,"male",1938,551,418,4,135,0,115,4,20
1714144,102,1,1911,1,"male",537,169,135,0,2,0,2,0,0
1714149,33,27,1980,10,"male",808,138,95,0,0,0,0,0,0
1714161,36,1,1977,10,"male",2,0,0,0,0,0,0,0,0
1714173,34,17,1979,1,"female",614,44,20,43,71,43,18,0,53
1714174,24,18,1989,7,"male",427,180,84,3,8,0,2,3,6
1714193,16,29,1997,4,"female",368,914,127,0,2,0,2,0,0
1714206,39,5,1974,6,"male",356,46,20,1,2,1,1,0,1
1714222,39,9,1974,3,"male",16,20,15,2,0,2,0,0,0
1714254,19,29,1994,7,"male",772,1080,710,310,77,222,57,88,20
1714262,59,14,1954,8,"female",2200,39,16,67,14,67,13,0,1
1714290,29,10,1984,5,"male",773,82,6,10,5,10,5,0,0
1714384,18,12,1995,8,"female",153,100,3,92,236,3,62,89,174
1714390,24,27,1989,7,"male",289,217,68,76,35,42,18,34,17
1714404,50,6,1963,10,"female",330,42,21,230,64,0,10,230,54
1714421,23,30,1990,6,"female",4,7,7,4,14,4,12,0,2
1714475,30,9,1983,11,"male",83,104,78,5,48,5,36,0,12
1714480,23,6,1990,9,"male",63,7,4,0,0,0,0,0,0
1714511,49,27,1964,8,"female",307,35,31,29,18,29,11,0,7
1714532,16,15,1997,6,"male",217,25,24,2,0,2,0,0,0
1714552,31,25,1982,1,"male",60,0,0,0,0,0,0,0,0
1714572,75,19,1938,10,"female",272,52,33,215,72,5,50,210,22
1714587,18,27,1995,9,"male",452,292,265,0,10,0,7,0,3
1714625,26,17,1987,3,"female",361,32,19,58,11,0,1,58,10
1714629,99,7,1914,10,"male",1555,169,144,8,6,0,3,8,3
1714636,20,20,1993,3,"male",540,325,310,2,1,2,0,0,1
1714645,33,1,1980,1,"female",340,18,13,48,1,48,1,0,0
1714661,57,26,1956,2,"male",148,2,2,2,3,0,0,2,3
1714669,67,5,1946,4,"female",497,143,129,508,240,0,40,508,200
1714685,68,11,1945,3,"male",822,725,397,41,125,41,109,0,16
1714718,17,1,1996,11,"female",379,202,84,276,217,276,132,0,85
1714722,24,21,1989,9,"male",816,426,312,1,0,1,0,0,0
1714743,25,7,1988,8,"male",178,45,44,118,47,118,33,0,14
1714769,37,2,1976,8,"female",731,49,13,310,116,0,22,310,94
1714774,54,1,1959,11,"female",965,67,43,62,51,7,10,55,41
1714849,16,28,1997,11,"male",514,352,233,8,12,0,8,8,4
1714877,61,5,1952,5,"female",97,82,40,73,114,73,90,0,24
1714880,60,9,1953,7,"female",574,274,199,66,158,0,21,66,137
1714895,19,1,1994,3,"female",735,1311,829,193,127,193,112,0,15
1714897,45,11,1968,2,"female",407,648,435,75,167,25,78,50,89
1714916,18,24,1995,11,"male",404,307,271,0,0,0,0,0,0
1714953,16,27,1997,7,"female",414,244,73,0,0,0,0,0,0
1714965,16,18,1997,8,"female",146,29,16,5,41,5,26,0,15
1714969,24,28,1989,9,"male",393,549,494,122,282,122,268,0,14
1714972,22,5,1991,3,"female",99,126,115,686,427,598,305,88,122
1714990,63,3,1950,6,"female",1576,19,9,11,35,0,19,11,16
1714993,26,20,1987,5,"male",289,0,0,0,0,0,0,0,0
1715003,22,11,1991,4,"male",128,150,81,0,3,0,0,0,3
1715029,34,9,1979,3,"male",404,351,219,4,70,4,69,0,1
1715031,27,25,1986,1,"female",1964,130,57,173,242,173,217,0,25
1715033,25,13,1988,7,NA,185,15,12,1,0,0,0,1,0
1715038,103,27,1910,10,"female",1609,37,11,279,145,11,89,268,56
1715044,19,13,1994,4,"male",65,131,62,16,4,13,4,3,0
1715048,108,19,1905,9,"male",125,146,135,6,5,0,0,6,5
1715098,35,22,1978,7,"male",46,6,3,0,0,0,0,0,0
1715139,51,17,1962,2,"female",57,36,33,151,64,151,43,0,21
1715178,38,6,1975,2,"female",470,1,0,0,0,0,0,0,0
1715184,25,27,1988,11,"male",103,45,33,12,0,12,0,0,0
1715224,23,15,1990,2,"male",370,32,21,0,0,0,0,0,0
1715248,27,7,1986,6,"male",371,142,100,65,36,65,27,0,9
1715249,65,12,1948,11,"female",744,58,25,29,5,28,2,1,3
1715255,108,10,1905,12,"female",95,6,4,56,58,0,0,56,58
1715257,29,27,1984,12,"female",8,4,1,77,42,0,9,77,33
1715291,30,9,1983,3,"male",163,3,0,0,0,0,0,0,0
1715309,19,21,1994,11,"female",199,79,49,29,12,28,7,1,5
1715337,31,11,1982,8,"female",212,47,45,1,0,1,0,0,0
1715347,58,15,1955,2,"male",658,29,24,5,13,0,12,5,1
1715354,33,15,1980,2,"male",394,407,361,0,8,0,2,0,6
1715384,20,16,1993,8,"male",270,454,373,51,86,42,43,9,43
1715386,38,28,1975,11,"male",376,134,79,2,1,0,0,2,1
1715398,62,3,1951,3,"male",1642,24,9,5,16,0,6,5,10
1715402,64,20,1949,4,"female",496,389,175,0,20,0,13,0,7
1715428,28,10,1985,11,"male",519,5,2,9,10,0,10,9,0
1715440,17,13,1996,6,"male",252,229,132,37,43,24,19,13,24
1715465,25,4,1988,10,"male",385,8,7,0,0,0,0,0,0
1715469,103,25,1910,2,"female",792,57,33,227,60,227,21,0,39
1715479,29,31,1984,7,"female",827,465,277,178,282,10,133,168,149
1715506,14,1,1999,12,"female",10,7,7,2,0,2,0,0,0
1715522,63,26,1950,1,"female",299,25,24,10,8,10,6,0,2
1715537,23,24,1990,5,"male",629,99,56,127,229,88,143,39,86
1715544,108,10,1905,5,"female",238,274,196,337,281,292,157,45,124
1715584,19,31,1994,12,"male",273,197,92,12,1,11,1,1,0
1715617,18,1,1995,7,"male",409,134,74,106,122,106,102,0,20
1715648,17,19,1996,9,"male",840,2091,1368,1188,871,755,586,433,285
1715661,57,19,1956,8,"female",847,41,39,4,2,0,0,4,2
1715681,16,21,1997,8,"male",375,179,131,92,51,92,10,0,41
1715689,29,26,1984,4,"male",507,78,57,6,1,0,0,6,1
1715696,61,8,1952,5,"female",735,79,33,488,156,486,77,2,79
1715716,24,20,1989,7,"male",158,77,72,15,1,0,0,15,1
1715742,15,1,1998,4,"female",212,629,131,48,58,29,43,19,15
1715745,53,3,1960,6,"female",348,43,22,9,3,3,3,6,0
1715788,24,16,1989,8,"male",338,181,159,4,3,3,3,1,0
1715812,57,20,1956,11,"male",312,108,47,3,15,2,9,1,6
1715813,56,26,1957,7,"male",390,161,105,166,33,164,26,2,7
1715831,28,17,1985,3,"male",498,255,150,5,0,0,0,5,0
1715832,23,21,1990,8,"female",56,30,21,227,106,221,69,6,37
1715870,42,10,1971,10,"male",471,106,69,4,27,2,9,2,18
1715873,36,21,1977,11,"male",481,34,19,0,0,0,0,0,0
1715876,52,13,1961,2,"female",246,87,75,60,86,0,7,60,79
1715881,25,4,1988,4,"male",720,172,108,26,58,8,47,18,11
1715901,107,8,1906,5,"male",160,1,1,0,0,0,0,0,0
1715904,18,23,1995,12,"female",359,241,151,1528,939,682,572,846,367
1715935,20,22,1993,11,"male",637,315,187,76,35,53,21,23,14
1715939,27,8,1986,12,"male",484,53,26,2,0,2,0,0,0
1715992,21,27,1992,10,"male",367,160,108,528,22,528,15,0,7
1716042,30,1,1983,4,"male",443,18,14,0,0,0,0,0,0
1716060,23,13,1990,12,"female",482,61,31,14,49,1,22,13,27
1716082,14,23,1999,1,"male",365,78,39,34,1,0,0,34,1
1716097,43,18,1970,1,"male",348,43,25,0,3,0,0,0,3
1716103,22,18,1991,3,"male",605,3,2,0,0,0,0,0,0
1716155,25,1,1988,1,"male",251,78,50,1,1,1,1,0,0
1716172,20,26,1993,4,"female",410,81,44,29,27,13,17,16,10
1716174,25,8,1988,7,"male",7,10,10,0,0,0,0,0,0
1716204,51,4,1962,5,"female",1595,485,298,1622,722,1007,413,615,309
1716210,31,15,1982,2,"female",232,219,152,0,0,0,0,0,0
1716261,27,22,1986,10,"female",308,28,19,17,12,17,5,0,7
1716317,42,1,1971,1,"male",117,85,59,176,217,176,64,0,153
1716329,25,5,1988,5,"male",106,67,47,37,16,13,5,24,11
1716331,49,19,1964,11,"male",421,48,19,0,0,0,0,0,0
1716379,54,3,1959,1,"female",111,15,10,65,49,65,33,0,16
1716384,18,31,1995,8,"male",214,14,10,1,0,0,0,1,0
1716421,108,1,1905,1,"male",437,118,102,773,304,0,117,773,187
1716432,18,29,1995,3,"male",168,54,29,60,9,2,3,58,6
1716441,16,13,1997,2,"male",215,133,70,7,3,0,0,7,3
1716457,59,6,1954,8,"female",810,69,32,40,24,3,18,37,6
1716498,29,4,1984,3,"female",132,490,372,703,1091,500,99,203,992
1716503,13,8,2000,7,"male",47,13,13,29,6,29,4,0,2
1716532,21,10,1992,10,"female",204,687,16,0,0,0,0,0,0
1716533,50,25,1963,9,"female",314,167,153,165,3,165,3,0,0
1716542,46,19,1967,5,"male",345,109,53,24,28,15,25,9,3
1716550,58,2,1955,1,"male",479,10,2,0,0,0,0,0,0
1716565,19,23,1994,10,"male",529,554,499,74,9,17,4,57,5
1716592,18,28,1995,11,"male",70,104,89,0,5,0,5,0,0
1716631,18,3,1995,10,"male",297,103,88,6,6,6,5,0,1
1716632,68,17,1945,12,"male",221,295,255,0,0,0,0,0,0
1716666,22,5,1991,5,"male",13,81,75,63,19,63,9,0,10
1716695,28,21,1985,12,"male",1249,0,0,0,0,0,0,0,0
1716755,16,28,1997,9,"female",695,1535,916,12,36,2,32,10,4
1716793,61,26,1952,5,"female",628,6,3,6,3,6,3,0,0
1716806,16,24,1997,7,"female",486,538,440,0,0,0,0,0,0
1716822,14,6,1999,1,"female",392,14,13,4,6,0,6,4,0
1716825,16,5,1997,6,"male",65,660,631,346,24,346,21,0,3
1716866,64,10,1949,9,"female",1112,38,2,1,1,0,1,1,0
1716892,35,22,1978,11,"male",223,219,179,208,126,208,106,0,20
1716901,22,15,1991,12,"female",386,320,212,407,968,407,877,0,91
1716917,44,5,1969,9,"female",125,116,102,324,10,319,2,5,8
1716926,19,12,1994,2,"male",494,275,209,68,63,68,61,0,2
1716937,15,4,1998,5,"female",358,30,15,125,55,0,7,125,48
1716946,19,18,1994,9,"male",592,693,375,66,18,66,11,0,7
1717026,29,24,1984,6,"female",586,75,31,2,28,1,11,1,17
1717035,62,12,1951,1,"female",1347,70,57,341,61,340,48,1,13
1717061,29,5,1984,10,"male",183,9,9,48,3,48,3,0,0
1717082,19,5,1994,5,"female",86,28,20,0,0,0,0,0,0
1717083,51,7,1962,9,"female",513,83,57,172,60,172,46,0,14
1717088,22,18,1991,8,"male",673,0,0,0,0,0,0,0,0
1717154,72,17,1941,7,"female",573,299,143,72,51,35,35,37,16
1717159,20,25,1993,2,"male",277,98,75,2,0,2,0,0,0
1717172,16,9,1997,1,"male",223,513,502,0,1,0,1,0,0
1717180,37,9,1976,6,"female",670,14,7,3,2,3,1,0,1
1717207,14,12,1999,1,"male",258,65,33,263,169,211,121,52,48
1717214,30,5,1983,5,"male",791,103,33,0,0,0,0,0,0
1717229,20,15,1993,2,"male",851,769,730,0,0,0,0,0,0
1717235,54,21,1959,8,"female",875,24,24,160,105,155,75,5,30
1717271,38,26,1975,2,"male",537,246,164,158,298,158,268,0,30
1717297,19,4,1994,4,"male",483,584,320,1423,544,1423,508,0,36
1717311,24,6,1989,8,"female",335,83,31,1,11,1,11,0,0
1717318,19,3,1994,5,"female",399,1353,962,199,781,4,485,195,296
1717328,20,22,1993,7,"male",388,170,72,94,96,94,65,0,31
1717389,53,30,1960,5,"female",88,56,47,32,13,0,7,32,6
1717397,22,28,1991,2,"male",266,24,15,0,0,0,0,0,0
1717398,81,27,1932,9,"male",223,20,12,146,2,1,2,145,0
1717407,87,2,1926,1,"female",1596,319,139,1146,1141,1140,790,6,351
1717419,15,21,1998,12,"female",329,399,308,10,14,1,10,9,4
1717434,25,8,1988,3,"male",652,119,79,0,0,0,0,0,0
1717446,46,15,1967,10,"male",536,88,42,10,19,0,4,10,15
1717470,25,2,1988,8,"male",453,93,74,24,2,24,2,0,0
1717475,26,13,1987,12,"female",832,95,34,315,344,246,200,69,144
1717499,19,17,1994,12,"male",955,285,196,0,0,0,0,0,0
1717516,17,10,1996,1,"male",815,862,572,2,19,0,7,2,12
1717550,19,12,1994,6,"male",168,18,17,0,0,0,0,0,0
1717556,30,12,1983,2,"male",9,10,8,1,10,0,6,1,4
1717559,40,6,1973,5,"female",413,9,4,84,11,84,4,0,7
1717561,21,23,1992,9,"male",1047,823,667,201,43,200,30,1,13
1717562,61,16,1952,4,"female",1779,178,102,379,121,33,0,346,121
1717563,15,4,1998,3,"male",193,25,8,12,0,11,0,1,0
1717571,18,19,1995,10,"male",30,82,68,1,0,1,0,0,0
1717617,25,20,1988,10,"male",27,48,34,46,12,46,11,0,1
1717646,58,3,1955,4,"female",1707,45,28,8,2,2,2,6,0
1717673,103,1,1910,1,"female",968,1824,621,36,11,11,10,25,1
1717707,19,24,1994,12,"male",621,84,71,0,3,0,3,0,0
1717713,25,20,1988,8,"male",243,181,147,7,52,7,26,0,26
1717740,57,22,1956,2,"female",351,7,4,2,0,0,0,2,0
1717742,29,24,1984,7,"female",533,40,13,2,0,0,0,2,0
1717761,20,10,1993,12,"male",97,69,45,8,5,8,3,0,2
1717765,23,13,1990,9,"female",346,11,9,0,0,0,0,0,0
1717769,32,13,1981,4,"male",1820,580,228,220,153,16,93,204,60
1717785,67,14,1946,3,"male",53,21,19,1,0,1,0,0,0
1717791,18,21,1995,7,"female",301,181,83,25,25,24,15,1,10
1717821,18,3,1995,10,"male",328,641,576,0,31,0,20,0,11
1717845,35,31,1978,3,"female",850,286,141,70,121,32,97,38,24
1717889,29,30,1984,9,"female",250,4,1,0,0,0,0,0,0
1717937,25,5,1988,10,"female",86,163,145,17,179,17,138,0,41
1717946,42,18,1971,7,"female",1681,176,122,175,175,146,128,29,47
1717953,98,14,1915,5,"male",1685,334,211,51,29,0,20,51,9
1718021,37,30,1976,6,"male",243,124,82,131,70,131,31,0,39
1718075,31,24,1982,9,"male",245,115,62,454,285,410,216,44,69
1718129,29,21,1984,4,"female",631,108,85,29,24,29,19,0,5
1718148,18,27,1995,8,"female",458,470,360,357,110,240,53,117,57
1718171,21,24,1992,1,"female",33,160,142,1324,740,1025,473,299,267
1718176,20,26,1993,12,"male",388,64,22,2,17,2,12,0,5
1718193,43,20,1970,4,"female",505,182,123,28,33,22,15,6,18
1718194,19,2,1994,12,"female",210,3,2,35,10,35,1,0,9
1718202,22,10,1991,9,"male",125,18,10,0,0,0,0,0,0
1718219,24,10,1989,9,"male",240,116,92,0,0,0,0,0,0
1718231,35,14,1978,8,"female",757,126,54,0,0,0,0,0,0
1718233,33,28,1980,8,"female",21,24,14,14,0,0,0,14,0
1718236,93,20,1920,11,"male",2173,240,143,10,8,10,7,0,1
1718273,74,19,1939,9,"female",26,1775,155,310,209,310,204,0,5
1718276,68,5,1945,8,"male",121,32,27,12,9,1,3,11,6
1718312,21,26,1992,12,"female",716,1268,562,1252,784,1249,545,3,239
1718317,96,22,1917,2,"male",1311,1226,659,204,344,89,193,115,151
1718322,57,1,1956,3,"female",474,59,27,108,67,90,41,18,26
1718350,13,27,2000,7,"female",342,240,173,41,32,35,18,6,14
1718370,61,21,1952,5,"male",688,44,23,12,61,12,34,0,27
1718377,39,28,1974,1,"male",222,137,121,0,6,0,2,0,4
1718379,64,8,1949,4,"female",599,57,26,278,189,0,51,278,138
1718386,34,3,1979,9,"male",236,32,30,1,1,1,1,0,0
1718394,58,4,1955,2,"female",1535,23,18,10,3,10,1,0,2
1718395,19,9,1994,11,"female",434,4189,3594,927,2859,528,1290,399,1569
1718408,29,20,1984,4,"male",666,91,45,1,0,1,0,0,0
1718477,90,17,1923,8,"female",1034,209,51,3,4,3,2,0,2
1718488,27,27,1986,5,"male",295,14,10,17,4,0,2,17,2
1718492,81,16,1932,11,"female",600,108,56,10,131,1,28,9,103
1718519,53,1,1960,4,"female",594,33,14,79,143,5,75,74,68
1718537,65,14,1948,9,"female",445,54,39,1,2,0,0,1,2
1718557,14,27,1999,5,"male",30,4,1,1,0,1,0,0,0
1718593,14,17,1999,2,"male",55,49,42,0,0,0,0,0,0
1718610,31,26,1982,1,"male",291,45,38,16,1,16,0,0,1
1718631,18,25,1995,12,"female",414,725,589,375,418,318,263,57,155
1718638,23,25,1990,12,"female",390,36,20,165,1,85,1,80,0
1718648,34,1,1979,3,"male",550,1,0,0,0,0,0,0,0
1718692,35,14,1978,3,"female",112,142,124,381,421,381,398,0,23
1718708,30,25,1983,7,"female",706,2,2,0,0,0,0,0,0
1718739,24,12,1989,9,"male",119,45,39,32,1,32,1,0,0
1718752,16,6,1997,1,"male",11,150,70,2121,425,2121,391,0,34
1718754,24,13,1989,8,"female",411,7,3,0,0,0,0,0,0
1718791,74,1,1939,9,"female",1085,36,21,29,5,12,4,17,1
1718814,19,21,1994,12,"female",651,1338,611,3065,1585,1901,738,1164,847
1718820,24,14,1989,7,"female",198,24,22,1,6,1,6,0,0
1718827,17,28,1996,7,"male",497,73,42,191,95,51,36,140,59
1718830,18,16,1995,2,"female",219,59,23,73,31,73,28,0,3
1718844,35,6,1978,9,"female",938,722,434,158,279,81,206,77,73
1718877,49,23,1964,9,"female",328,26,17,54,25,54,19,0,6
1718901,16,1,1997,1,"male",35,32,30,2,0,2,0,0,0
1718905,16,14,1997,10,"female",797,79,62,0,0,0,0,0,0
1718907,18,29,1995,8,"male",616,4431,188,509,6103,40,2362,469,3741
1718911,20,17,1993,8,"female",317,145,79,34,125,33,106,1,19
1718943,23,11,1990,11,"female",53,46,40,69,129,0,21,69,108
1718992,24,1,1989,5,"male",480,241,176,4,11,4,2,0,9
1719065,17,23,1996,8,"female",10,23,23,9,91,9,81,0,10
1719081,23,26,1990,5,"female",352,0,0,2,0,2,0,0,0
1719083,18,14,1995,11,"female",130,171,149,52,15,0,9,52,6
1719092,26,20,1987,9,"female",548,221,24,12,1,0,1,12,0
1719134,70,5,1943,4,"male",217,44,27,34,51,0,14,34,37
1719143,20,28,1993,2,"male",390,20,18,0,0,0,0,0,0
1719146,37,28,1976,7,"male",296,249,199,0,1,0,1,0,0
1719191,28,3,1985,2,"male",265,28,21,0,0,0,0,0,0
1719219,63,7,1950,2,"female",1245,34,17,34,3,34,3,0,0
1719235,15,2,1998,9,"female",496,423,152,49,149,19,72,30,77
1719261,14,21,1999,7,"female",161,127,100,1,19,0,2,1,17
1719299,24,14,1989,10,"female",261,18,8,0,0,0,0,0,0
1719302,20,4,1993,5,"male",423,39,23,0,2,0,0,0,2
1719307,58,2,1955,12,"female",268,125,93,85,120,3,37,82,83
1719328,62,5,1951,2,"female",517,62,35,616,558,532,481,84,77
1719333,64,1,1949,10,"female",1863,223,143,572,363,159,198,413,165
1719357,15,7,1998,8,"female",130,514,354,264,478,264,429,0,49
1719373,18,26,1995,3,"female",236,588,268,892,764,852,538,40,226
1719403,26,4,1987,1,"male",306,24,22,4,2,4,1,0,1
1719417,17,24,1996,9,"female",480,161,69,0,1,0,1,0,0
1719418,65,15,1948,12,"female",1947,185,118,985,726,1,202,984,524
1719423,31,20,1982,8,"male",16,24,23,7,10,7,10,0,0
1719435,108,22,1905,3,"male",907,232,151,10,8,0,1,10,7
1719467,23,1,1990,1,"female",1618,1052,578,1141,869,314,502,827,367
1719482,16,22,1997,3,"male",79,256,237,272,273,270,241,2,32
1719509,45,13,1968,10,"male",488,101,83,2,0,2,0,0,0
1719537,26,4,1987,2,"male",245,130,65,9,44,3,37,6,7
1719539,29,5,1984,11,"male",773,448,313,0,0,0,0,0,0
1719589,57,13,1956,10,"female",1012,163,91,122,29,100,20,22,9
1719594,41,27,1972,12,"male",331,30,6,16,1,0,1,16,0
1719628,49,16,1964,7,"female",1868,82,44,352,540,347,353,5,187
1719647,22,23,1991,10,"female",818,2274,482,1,64,1,59,0,5
1719663,15,3,1998,6,"male",129,30,21,0,0,0,0,0,0
1719674,52,1,1961,1,"male",746,122,71,177,72,138,26,39,46
1719679,17,1,1996,5,"male",134,78,73,6,6,6,6,0,0
1719687,49,9,1964,11,"male",304,10,7,14,7,14,6,0,1
1719700,33,23,1980,5,"female",745,295,155,59,67,59,51,0,16
1719732,18,7,1995,3,"male",1236,208,139,0,0,0,0,0,0
1719750,20,17,1993,12,"male",512,116,85,0,5,0,0,0,5
1719755,58,20,1955,11,"male",459,92,71,9,21,0,4,9,17
1719780,19,3,1994,3,"male",358,180,144,2,17,2,12,0,5
1719832,18,4,1995,8,"female",392,314,159,202,349,131,144,71,205
1719839,59,22,1954,7,"male",111,30,26,12,8,12,8,0,0
1719852,100,18,1913,7,"male",1755,268,178,23,48,23,17,0,31
1719894,43,7,1970,8,"male",186,125,120,1,42,1,40,0,2
1719905,73,6,1940,8,"female",1612,83,44,27,16,0,7,27,9
1719916,61,27,1952,8,"male",855,353,243,899,253,899,240,0,13
1719929,32,1,1981,10,"female",525,575,298,385,868,385,495,0,373
1719944,18,20,1995,2,"female",254,27,17,8,19,0,11,8,8
1719963,43,20,1970,8,"male",113,2,2,0,0,0,0,0,0
1720030,54,23,1959,6,"female",183,74,48,154,87,0,23,154,64
1720037,51,4,1962,4,"female",262,39,28,35,24,20,5,15,19
1720040,31,18,1982,11,"male",144,64,49,419,180,419,149,0,31
1720043,64,30,1949,3,"male",112,40,27,32,22,2,3,30,19
1720051,49,7,1964,8,"female",303,67,36,185,31,185,27,0,4
1720052,73,11,1940,11,"male",307,204,124,17,0,0,0,17,0
1720080,27,7,1986,8,"male",527,804,719,1685,544,1456,427,229,117
1720119,31,25,1982,10,"male",34,13,5,50,50,50,48,0,2
1720132,18,5,1995,4,"female",133,3,3,2,0,0,0,2,0
1720142,18,22,1995,9,"female",888,4733,519,16583,16743,1718,10104,14865,6639
1720173,69,25,1944,4,"male",1675,460,211,58,11,57,10,1,1
1720182,22,19,1991,4,"female",514,199,107,793,86,793,40,0,46
1720201,108,21,1905,7,"female",683,390,316,16,10,16,4,0,6
1720203,27,19,1986,11,"male",337,147,45,16,1,16,0,0,1
1720207,34,28,1979,5,"male",33,30,29,0,2,0,0,0,2
1720282,17,26,1996,12,"male",104,72,53,1,0,1,0,0,0
1720347,17,27,1996,8,"male",509,374,290,1,1,0,0,1,1
1720363,18,24,1995,8,"male",258,58,32,35,13,34,3,1,10
1720366,14,12,1999,5,"female",81,207,130,13,11,13,6,0,5
1720371,58,7,1955,1,"female",265,23,11,11,53,7,30,4,23
1720381,25,13,1988,8,"female",263,80,64,0,0,0,0,0,0
1720387,75,15,1938,4,"female",2322,102,45,835,201,834,143,1,58
1720400,38,28,1975,5,"male",453,140,83,627,521,6,73,621,448
1720411,45,2,1968,2,"female",519,40,23,12,21,12,2,0,19
1720429,103,5,1910,12,"female",1218,299,56,11,117,11,101,0,16
1720439,65,26,1948,3,"female",1662,65,31,170,24,58,7,112,17
1720499,22,30,1991,1,"female",160,350,228,42,90,35,48,7,42
1720514,108,5,1905,5,"male",1205,11,9,8,2,8,2,0,0
1720516,28,6,1985,12,"male",115,1,1,16,1,10,1,6,0
1720519,51,15,1962,3,"male",882,23,10,13,0,13,0,0,0
1720526,50,2,1963,3,"male",893,355,260,125,108,125,107,0,1
1720556,57,28,1956,4,"female",1620,91,52,3,0,3,0,0,0
1720587,18,15,1995,2,"female",293,366,254,12,19,12,19,0,0
1720601,61,20,1952,3,"female",821,21,2,2,87,0,22,2,65
1720602,56,19,1957,5,"female",383,72,35,15,9,8,6,7,3
1720697,20,1,1993,6,"male",800,245,171,0,0,0,0,0,0
1720700,69,7,1944,11,"male",221,20,9,8,4,0,3,8,1
1720705,19,3,1994,3,"female",91,2,1,8,0,0,0,8,0
1720708,17,18,1996,10,"male",18,9,5,3,0,3,0,0,0
1720711,14,7,1999,12,"female",296,945,306,132,110,64,35,68,75
1720721,77,26,1936,10,"female",1764,65,19,166,242,162,124,4,118
1720742,25,1,1988,1,"male",248,5,3,0,0,0,0,0,0
1720746,28,12,1985,1,"female",542,281,148,129,67,13,17,116,50
1720748,51,1,1962,8,"male",1772,142,24,16,1,0,0,16,1
1720786,62,1,1951,1,"male",16,91,67,46,8,46,7,0,1
1720795,15,9,1998,4,"male",363,336,279,42,6,0,2,42,4
1720805,41,24,1972,4,"female",363,18,4,32,0,32,0,0,0
1720834,25,17,1988,2,"male",567,10,8,3,1,3,1,0,0
1720847,113,1,1900,7,"female",1476,439,275,129,71,118,65,11,6
1720863,17,22,1996,2,"male",10,209,45,27,122,4,103,23,19
1720877,22,6,1991,6,"male",726,35,29,0,0,0,0,0,0
1720881,29,6,1984,3,"male",367,317,174,5,25,0,8,5,17
1720889,20,20,1993,4,"male",155,50,23,19,7,14,0,5,7
1720906,21,10,1992,8,"female",497,22,13,389,130,385,37,4,93
1720913,49,14,1964,8,"female",189,201,16,33,11,33,5,0,6
1720919,42,4,1971,12,"female",111,8,6,0,0,0,0,0,0
1720920,47,6,1966,6,"male",564,1,1,0,1,0,0,0,1
1720923,56,11,1957,12,"male",311,148,68,37,45,0,25,37,20
1720953,96,30,1917,11,"male",822,840,492,17,4,17,4,0,0
1720956,17,21,1996,9,"female",258,122,40,0,3,0,3,0,0
1720959,25,9,1988,4,"male",418,289,226,70,32,70,28,0,4
1720962,25,19,1988,7,"male",224,46,31,0,0,0,0,0,0
1720971,19,20,1994,11,"male",468,190,156,1,5,0,0,1,5
1720990,15,18,1998,3,"male",60,52,43,0,13,0,9,0,4
1721006,38,8,1975,3,"male",522,9,4,1,1,1,1,0,0
1721020,68,30,1945,8,"male",321,8,4,2,2,1,0,1,2
1721027,21,24,1992,8,"male",19,26,20,22,8,22,4,0,4
1721032,18,1,1995,11,"male",82,385,324,77,695,77,464,0,231
1721035,19,5,1994,6,"male",409,191,169,1,0,1,0,0,0
1721049,26,1,1987,1,"male",502,561,483,5,10,3,5,2,5
1721052,40,28,1973,8,"male",217,161,118,32,7,32,2,0,5
1721067,90,2,1923,3,"female",735,168,125,3928,1852,3913,1654,15,198
1721081,47,5,1966,9,"female",71,52,25,8,32,8,25,0,7
1721094,39,29,1974,5,"male",304,87,59,1,0,1,0,0,0
1721113,30,15,1983,7,"female",155,428,342,200,217,200,136,0,81
1721125,39,5,1974,7,"male",544,113,88,0,0,0,0,0,0
1721132,25,16,1988,6,"male",45,2,2,2,0,2,0,0,0
1721140,19,24,1994,2,"male",232,533,363,177,250,157,152,20,98
1721142,49,23,1964,5,"female",1986,67,31,118,153,29,45,89,108
1721169,28,9,1985,4,"male",896,18,3,0,0,0,0,0,0
1721179,61,9,1952,2,"male",950,115,42,201,69,0,43,201,26
1721202,61,8,1952,10,"male",1061,19,15,40,32,6,30,34,2
1721203,25,30,1988,10,"male",404,43,37,42,5,42,5,0,0
1721211,20,24,1993,10,"female",492,1473,80,526,243,526,184,0,59
1721212,41,12,1972,11,"male",394,42,19,1,0,1,0,0,0
1721221,27,1,1986,11,"female",479,83,47,62,51,62,35,0,16
1721222,18,2,1995,4,"male",131,580,511,25,67,25,59,0,8
1721251,24,9,1989,2,"male",340,131,97,32,79,21,57,11,22
1721263,15,8,1998,1,"male",304,17,12,0,3,0,3,0,0
1721290,22,18,1991,10,"male",221,56,17,1,2,0,2,1,0
1721332,26,4,1987,2,"male",75,5,5,1,0,1,0,0,0
1721351,41,1,1972,1,"male",272,45,34,114,19,114,19,0,0
1721359,37,1,1976,5,"female",845,110,55,32,97,32,73,0,24
1721375,16,25,1997,2,"female",551,1023,669,1225,1297,1225,1106,0,191
1721377,35,13,1978,11,"male",885,41,19,0,2,0,2,0,0
1721379,16,22,1997,9,"female",200,737,507,1628,436,1628,294,0,142
1721394,58,3,1955,12,"male",769,97,56,2,7,2,7,0,0
1721400,24,9,1989,8,"male",435,527,340,4058,661,4058,583,0,78
1721411,19,7,1994,5,"male",209,175,80,56,395,35,171,21,224
1721419,24,4,1989,5,"male",1078,709,595,0,5,0,5,0,0
1721426,16,26,1997,1,"male",132,162,132,405,0,405,0,0,0
1721443,108,31,1905,3,"female",1528,162,73,1,3,0,2,1,1
1721465,16,24,1997,2,"male",192,128,70,9,16,9,11,0,5
1721473,25,26,1988,2,"male",210,55,36,201,50,201,39,0,11
1721479,29,24,1984,5,"female",664,44,26,28,53,25,30,3,23
1721523,35,12,1978,8,"male",34,5,4,3,0,3,0,0,0
1721525,23,3,1990,7,"female",567,66,45,291,268,101,95,190,173
1721579,19,1,1994,7,"female",511,2954,1069,4217,3696,2828,2242,1389,1454
1721656,64,4,1949,4,"male",304,707,627,15,0,0,0,15,0
1721658,67,3,1946,4,"female",731,117,97,2,18,0,7,2,11
1721671,28,4,1985,3,"female",1454,613,172,246,1149,246,1108,0,41
1721773,75,2,1938,1,"female",1503,155,66,0,0,0,0,0,0
1721833,19,18,1994,8,"female",326,238,205,2,18,0,0,2,18
1721841,19,13,1994,6,"male",293,340,199,1326,1556,843,1144,483,412
1721842,16,14,1997,2,"female",589,2972,1717,1319,2864,355,971,964,1893
1721859,18,15,1995,1,"female",1470,1058,383,1399,1519,539,1212,860,307
1721866,21,10,1992,3,"male",342,224,123,9,4,9,4,0,0
1721885,113,1,1900,1,"female",1520,63,26,0,2,0,2,0,0
1721901,16,13,1997,3,"female",514,318,155,386,342,328,145,58,197
1721912,20,10,1993,11,"male",651,1070,676,2138,519,278,227,1860,292
1721914,62,6,1951,1,"female",374,30,20,330,41,0,29,330,12
1721932,48,21,1965,3,"female",435,88,41,250,274,103,116,147,158
1721951,62,11,1951,3,"male",1097,512,114,159,41,37,6,122,35
1721978,39,3,1974,10,"female",914,110,66,967,1296,55,216,912,1080
1722049,27,15,1986,1,"female",567,554,160,50,38,24,19,26,19
1722067,24,30,1989,7,"male",885,84,33,2,0,2,0,0,0
1722070,69,24,1944,11,"female",1304,42,19,0,1,0,1,0,0
1722083,30,3,1983,3,"male",77,22,21,10,1,10,1,0,0
1722109,40,4,1973,1,"male",460,5,5,0,0,0,0,0,0
1722122,45,6,1968,12,"male",511,39,22,361,55,361,24,0,31
1722130,24,21,1989,2,"female",410,1,1,194,16,1,4,193,12
1722201,18,10,1995,11,"male",633,77,59,27,11,27,9,0,2
1722210,57,31,1956,7,"female",1708,175,91,896,277,0,58,896,219
1722216,20,28,1993,8,"male",411,566,279,1,17,0,6,1,11
1722244,52,6,1961,6,"male",559,22,10,0,0,0,0,0,0
1722281,34,29,1979,12,"female",405,2,0,84,7,0,5,84,2
1722286,18,18,1995,5,"male",527,256,203,2,9,2,7,0,2
1722311,17,27,1996,9,"female",80,134,77,305,97,305,87,0,10
1722327,32,18,1981,3,"female",650,93,61,219,63,219,37,0,26
1722343,23,11,1990,11,"male",284,35,20,0,2,0,2,0,0
1722352,33,18,1980,12,"male",720,40,0,0,1,0,1,0,0
1722392,102,31,1911,3,"male",2093,626,253,265,86,265,46,0,40
1722396,17,8,1996,4,"female",291,332,178,189,219,168,112,21,107
1722405,25,1,1988,1,"female",401,176,47,23,35,23,33,0,2
1722432,73,29,1940,5,"male",271,192,144,0,0,0,0,0,0
1722460,52,27,1961,2,"female",1058,77,25,527,520,0,171,527,349
1722480,21,7,1992,9,"male",59,49,31,1,0,1,0,0,0
1722490,34,9,1979,5,"male",97,1,1,52,105,52,105,0,0
1722526,36,10,1977,6,"male",485,19,12,30,15,30,5,0,10
1722543,22,29,1991,11,"female",101,68,26,5,36,5,35,0,1
1722544,48,19,1965,2,"female",456,78,46,6,10,4,6,2,4
1722546,21,21,1992,7,"male",465,244,176,0,1,0,0,0,1
1722572,28,9,1985,4,"male",796,128,91,117,92,93,62,24,30
1722573,68,20,1945,8,"male",1755,488,60,21,0,21,0,0,0
1722575,17,18,1996,2,"male",293,227,98,9,13,0,5,9,8
1722576,20,1,1993,10,"male",232,172,141,1,5,1,2,0,3
1722590,43,29,1970,1,"male",724,1,0,0,0,0,0,0,0
1722591,16,7,1997,4,"male",615,211,37,8,25,8,23,0,2
1722608,43,3,1970,8,"male",559,401,77,7,7,7,3,0,4
1722691,24,22,1989,11,"female",706,91,64,3800,6219,2877,4283,923,1936
1722701,31,10,1982,3,"male",577,61,29,4,6,0,3,4,3
1722735,19,24,1994,1,"male",641,1015,941,7,21,7,19,0,2
1722740,67,19,1946,5,"male",1540,52,17,0,0,0,0,0,0
1722741,20,1,1993,4,"female",511,197,109,1,46,1,12,0,34
1722791,53,18,1960,4,"male",1091,7,4,0,0,0,0,0,0
1722816,25,9,1988,10,"male",408,48,37,52,5,52,1,0,4
1722822,27,19,1986,2,"male",967,67,43,2,0,2,0,0,0
1722871,20,31,1993,1,"male",610,176,55,0,1,0,1,0,0
1722877,20,19,1993,3,"female",339,197,56,30,14,10,7,20,7
1722952,103,30,1910,8,"male",287,465,362,3,2,3,1,0,1
1722986,32,7,1981,5,"male",1386,146,64,128,163,127,93,1,70
1722993,19,29,1994,5,"female",712,257,143,115,492,9,159,106,333
1723011,48,7,1965,4,"male",328,83,79,12,3,12,3,0,0
1723020,19,23,1994,11,"male",376,59,45,14,1,0,0,14,1
1723028,35,23,1978,10,"male",195,5,5,1,2,1,2,0,0
1723033,55,2,1958,6,"female",2163,69,42,77,82,62,67,15,15
1723035,21,6,1992,6,"male",319,111,23,0,0,0,0,0,0
1723045,25,15,1988,8,"male",670,119,52,1,0,1,0,0,0
1723046,24,3,1989,5,"female",27,2,2,2,0,2,0,0,0
1723070,40,9,1973,8,"male",139,29,24,1,0,1,0,0,0
1723080,29,14,1984,8,"male",287,25,20,3,6,3,4,0,2
1723087,19,12,1994,10,"female",144,18,11,2,1,1,0,1,1
1723098,27,25,1986,11,"male",312,178,137,125,31,125,15,0,16
1723143,34,6,1979,10,"female",1365,344,200,144,240,103,140,41,100
1723157,18,11,1995,4,"male",289,74,32,1,0,0,0,1,0
1723192,43,4,1970,5,"male",70,1,1,0,0,0,0,0,0
1723198,17,11,1996,9,"male",163,44,41,6,0,6,0,0,0
1723334,54,11,1959,11,"female",756,37,21,11,11,11,7,0,4
1723339,23,13,1990,8,"male",426,83,60,0,0,0,0,0,0
1723340,71,21,1942,7,"female",972,47,30,49,6,34,4,15,2
1723351,19,14,1994,9,"male",447,325,124,1,5,0,1,1,4
1723438,49,16,1964,12,"female",468,78,42,538,342,523,208,15,134
1723520,18,4,1995,3,"female",1575,732,450,195,746,176,372,19,374
1723534,29,20,1984,2,"male",656,41,32,3,4,3,2,0,2
1723558,21,25,1992,4,"female",205,39,6,2,0,2,0,0,0
1723596,56,9,1957,10,"female",317,65,48,0,4,0,1,0,3
1723616,17,22,1996,5,"male",353,178,85,0,16,0,11,0,5
1723630,25,10,1988,10,"male",569,18,17,20,10,16,9,4,1
1723631,28,8,1985,11,"female",454,36,19,561,37,561,35,0,2
1723643,30,17,1983,10,"female",864,428,235,1021,594,660,292,361,302
1723649,21,8,1992,8,"female",586,453,339,405,302,394,234,11,68
1723651,16,30,1997,10,"male",803,345,233,49,22,24,19,25,3
1723665,15,29,1998,4,"male",212,1072,868,429,466,65,166,364,300
1723684,74,24,1939,12,"male",196,14,10,7,1,7,1,0,0
1723706,58,15,1955,1,"female",940,94,48,5,32,5,27,0,5
1723737,14,1,1999,1,"female",170,2,1,2,0,0,0,2,0
1723744,18,27,1995,11,"male",56,74,66,40,45,24,29,16,16
1723751,22,20,1991,4,"female",551,774,262,637,753,94,294,543,459
1723795,50,7,1963,2,"female",1272,283,159,1244,912,1161,407,83,505
1723798,19,11,1994,3,"female",317,191,119,4,5,4,5,0,0
1723806,49,21,1964,1,"female",201,20,16,0,1,0,0,0,1
1723813,15,24,1998,12,"male",217,232,90,233,83,0,21,233,62
1723826,21,20,1992,4,"female",99,29,21,10,4,10,2,0,2
1723827,108,9,1905,7,"male",1009,987,573,9,51,0,4,9,47
1723828,103,9,1910,5,"female",1248,2843,158,2,164,2,124,0,40
1723866,15,22,1998,12,"male",537,217,150,10,5,10,5,0,0
1723886,33,9,1980,2,"male",409,88,81,6,46,6,29,0,17
1723919,113,21,1900,11,"male",1257,523,361,11,5,11,2,0,3
1723931,32,26,1981,7,"female",367,1,1,2,1,2,1,0,0
1723935,15,8,1998,9,"male",572,48,29,18,4,0,2,18,2
1723968,18,10,1995,8,"male",438,211,37,1,1,0,1,1,0
1723979,22,21,1991,5,"male",510,55,35,0,0,0,0,0,0
1724000,21,13,1992,3,"male",340,103,60,46,26,13,11,33,15
1724022,45,2,1968,1,"male",70,20,18,0,3,0,0,0,3
1724032,31,21,1982,7,"female",327,48,21,0,0,0,0,0,0
1724060,34,2,1979,11,"male",48,108,97,48,98,48,73,0,25
1724067,19,5,1994,12,"male",196,60,34,1,0,1,0,0,0
1724083,26,2,1987,1,"male",664,123,97,0,0,0,0,0,0
1724117,60,22,1953,3,"male",61,4,4,0,3,0,3,0,0
1724137,28,10,1985,12,"male",1237,72,57,0,4,0,4,0,0
1724185,27,2,1986,3,"male",23,34,27,34,13,34,11,0,2
1724186,100,15,1913,4,"male",388,75,41,18,33,18,30,0,3
1724224,26,1,1987,3,"female",511,90,35,0,3,0,2,0,1
1724272,60,9,1953,4,"male",83,0,0,0,0,0,0,0,0
1724277,21,11,1992,1,"female",327,80,73,9,8,9,5,0,3
1724300,16,3,1997,10,"male",199,91,37,164,113,124,89,40,24
1724332,15,30,1998,10,"male",462,173,129,11,0,7,0,4,0
1724334,103,1,1910,6,"male",684,344,150,842,457,585,315,257,142
1724341,17,15,1996,3,"male",393,1166,1116,0,0,0,0,0,0
1724354,14,19,1999,9,"female",1061,4418,1128,1338,2758,144,1179,1194,1579
1724362,63,8,1950,8,"male",1212,1287,519,76,53,28,20,48,33
1724365,20,17,1993,11,"female",274,199,127,0,0,0,0,0,0
1724378,19,15,1994,4,"female",164,73,26,12,0,12,0,0,0
1724391,44,29,1969,3,"female",615,74,27,185,229,6,91,179,138
1724395,16,7,1997,2,"male",213,25,25,0,1,0,0,0,1
1724408,41,1,1972,1,"male",553,14,6,22,1,21,1,1,0
1724415,31,5,1982,3,"female",840,260,204,28,111,22,53,6,58
1724444,67,31,1946,1,"female",1143,751,347,13622,2299,2545,1875,11077,424
1724457,36,22,1977,3,"male",398,30,13,0,0,0,0,0,0
1724461,50,6,1963,11,"male",1108,132,55,0,1,0,1,0,0
1724481,59,5,1954,11,"female",731,20,10,24,7,0,2,24,5
1724510,33,11,1980,12,"male",645,785,687,6,9,5,9,1,0
1724517,13,4,2000,4,"female",32,39,17,7,37,6,36,1,1
1724541,35,16,1978,5,"male",23,13,12,1,0,1,0,0,0
1724544,25,16,1988,3,"male",176,138,128,0,0,0,0,0,0
1724547,46,24,1967,10,"male",600,69,35,24,27,24,17,0,10
1724556,19,6,1994,7,"male",410,331,195,9,31,9,23,0,8
1724558,16,12,1997,12,"female",89,61,50,198,4,198,3,0,1
1724607,61,29,1952,8,"male",393,49,33,142,147,128,63,14,84
1724645,29,10,1984,8,"female",419,54,26,676,335,676,262,0,73
1724666,108,14,1905,8,"male",26,101,86,3,5,0,0,3,5
1724709,38,13,1975,3,"female",460,112,53,23,203,12,122,11,81
1724730,54,27,1959,6,"male",599,170,142,129,98,129,58,0,40
1724773,25,17,1988,3,"male",530,64,52,0,0,0,0,0,0
1724777,33,29,1980,12,"male",165,1,1,0,0,0,0,0,0
1724784,23,25,1990,8,"female",20,33,7,232,116,230,72,2,44
1724789,63,11,1950,2,"female",1554,201,53,1465,1255,1465,477,0,778
1724802,21,20,1992,5,"female",629,612,402,389,485,389,451,0,34
1724817,56,18,1957,5,"male",16,32,30,123,149,123,77,0,72
1724823,108,9,1905,7,"female",2223,519,291,132,137,125,72,7,65
1724844,41,9,1972,5,"female",1696,144,93,456,375,357,277,99,98
1724847,19,23,1994,2,"male",624,226,77,0,0,0,0,0,0
1724864,28,11,1985,12,"male",109,47,32,0,0,0,0,0,0
1724877,56,16,1957,4,"female",360,2,1,0,0,0,0,0,0
1724883,25,24,1988,1,"male",1547,20,11,1,1,0,1,1,0
1724891,16,13,1997,5,"male",341,1331,818,414,1079,414,682,0,397
1724914,77,5,1936,8,"female",329,14,11,0,0,0,0,0,0
1724933,79,17,1934,10,"male",257,156,105,7,13,0,3,7,10
1724934,27,10,1986,10,"male",412,29,24,1,0,1,0,0,0
1724945,63,26,1950,9,"male",274,82,63,0,0,0,0,0,0
1724960,108,2,1905,2,"male",390,130,102,25,12,25,10,0,2
1724980,16,19,1997,9,"male",428,710,535,150,3,150,3,0,0
1724981,29,22,1984,8,"male",180,207,193,4,4,4,4,0,0
1724983,67,3,1946,5,"female",311,56,22,543,58,0,23,543,35
1725027,18,21,1995,4,"female",136,182,93,223,460,171,234,52,226
1725028,26,9,1987,4,"male",338,45,27,3,21,3,18,0,3
1725054,18,22,1995,6,"male",125,27,20,19,0,0,0,19,0
1725083,24,12,1989,1,"male",97,10,9,0,0,0,0,0,0
1725106,47,8,1966,10,"male",1313,114,76,22,22,22,14,0,8
1725110,18,23,1995,6,"male",213,142,112,0,0,0,0,0,0
1725121,18,10,1995,7,"male",220,14,9,0,1,0,0,0,1
1725125,18,1,1995,1,"male",33,285,281,0,1,0,0,0,1
1725154,45,3,1968,2,"male",1177,66,42,142,137,91,85,51,52
1725156,96,23,1917,4,"male",1066,558,220,34,69,5,13,29,56
1725192,44,21,1969,6,"male",318,65,51,74,43,64,20,10,23
1725211,19,23,1994,4,"male",416,138,102,1,1,1,1,0,0
1725218,16,15,1997,4,"female",21,425,26,22,193,22,142,0,51
1725229,22,17,1991,1,"male",374,160,130,21,32,21,30,0,2
1725262,63,25,1950,8,"female",268,81,45,62,7,62,5,0,2
1725264,55,10,1958,5,"female",486,34,24,9,19,0,0,9,19
1725326,23,6,1990,11,"female",211,153,108,19,52,19,43,0,9
1725332,34,20,1979,3,"male",594,163,84,77,44,77,37,0,7
1725337,22,14,1991,7,"male",450,20,15,24,5,4,3,20,2
1725344,108,19,1905,6,"male",1626,367,211,0,0,0,0,0,0
1725345,19,19,1994,3,"female",571,114,47,18,15,13,3,5,12
1725349,23,13,1990,11,"male",458,223,133,474,70,228,23,246,47
1725357,62,6,1951,5,"male",1369,29,11,2,0,2,0,0,0
1725383,19,4,1994,6,"female",484,859,515,34,399,34,300,0,99
1725395,27,11,1986,7,"female",559,180,41,40,402,28,139,12,263
1725399,17,29,1996,6,"male",577,110,61,51,4,9,1,42,3
1725408,44,20,1969,5,"male",71,18,16,29,1,0,1,29,0
1725419,60,16,1953,5,"male",99,77,52,3,14,3,11,0,3
1725433,21,2,1992,2,"female",490,319,166,95,23,1,3,94,20
1725468,20,7,1993,12,"female",255,37,20,112,8,3,1,109,7
1725485,18,7,1995,9,"male",534,71,44,28,9,2,3,26,6
1725509,108,25,1905,4,"male",1699,250,162,130,20,0,5,130,15
1725517,17,9,1996,2,"female",71,283,83,64,96,64,72,0,24
1725539,18,15,1995,5,"male",288,141,83,47,8,20,1,27,7
1725561,108,7,1905,3,"female",1612,474,236,1445,1069,0,156,1445,913
1725567,21,5,1992,4,"female",603,95,18,2,3,2,2,0,1
1725571,20,12,1993,4,"male",170,641,544,105,229,105,187,0,42
1725598,26,25,1987,11,"male",735,113,84,2,2,2,2,0,0
1725609,55,25,1958,5,"male",812,5,3,3,0,2,0,1,0
1725639,19,31,1994,5,"male",583,316,240,64,79,64,57,0,22
1725641,22,15,1991,4,"male",237,33,23,0,0,0,0,0,0
1725656,59,24,1954,8,"female",426,14,10,0,0,0,0,0,0
1725686,24,13,1989,4,"female",164,123,107,9,2,9,2,0,0
1725714,37,14,1976,12,"male",659,173,125,362,301,356,241,6,60
1725715,24,19,1989,3,"male",578,141,20,0,0,0,0,0,0
1725768,21,24,1992,4,"male",207,457,217,5,3,0,2,5,1
1725783,45,11,1968,2,"male",183,124,103,9,8,9,2,0,6
1725803,20,10,1993,6,"male",225,141,125,19,3,19,1,0,2
1725806,56,3,1957,8,"female",1757,379,283,1840,710,1631,470,209,240
1725860,31,22,1982,1,"female",668,106,76,354,245,308,161,46,84
1725863,29,26,1984,5,"male",143,27,25,2,0,1,0,1,0
1725878,19,25,1994,3,"male",967,369,253,144,1,144,0,0,1
1725892,25,29,1988,7,"male",1020,256,99,0,0,0,0,0,0
1725900,16,24,1997,12,"male",321,228,141,28,3,0,1,28,2
1725917,31,15,1982,4,"female",647,40,28,9,22,9,14,0,8
1725932,37,23,1976,7,"male",286,11,3,19,8,19,6,0,2
1725937,56,7,1957,6,"male",990,111,91,0,0,0,0,0,0
1725948,39,5,1974,3,"male",318,129,26,8,39,8,39,0,0
1725964,33,2,1980,11,"female",31,3,3,0,0,0,0,0,0
1725965,19,5,1994,1,"male",829,880,730,129,169,13,45,116,124
1725982,26,5,1987,1,"male",152,4,4,0,0,0,0,0,0
1725983,23,17,1990,5,"male",693,267,108,9,6,9,6,0,0
1726004,49,21,1964,1,"male",1257,30,9,37,12,13,2,24,10
1726017,28,17,1985,2,"female",31,2,2,65,2,57,0,8,2
1726043,53,29,1960,11,"male",426,18,16,1,0,1,0,0,0
1726050,43,5,1970,7,"female",422,65,38,109,63,109,38,0,25
1726061,16,20,1997,2,"female",500,1277,905,24,129,24,117,0,12
1726065,31,4,1982,11,"female",286,135,94,737,209,716,91,21,118
1726074,15,13,1998,6,"female",90,129,98,166,432,166,144,0,288
1726081,31,30,1982,4,"male",233,67,42,6,0,6,0,0,0
1726110,66,1,1947,12,"male",1342,136,89,194,205,136,81,58,124
1726127,18,2,1995,1,"female",322,52,34,9,2,0,0,9,2
1726155,30,1,1983,11,"female",119,40,34,116,30,110,12,6,18
1726169,42,6,1971,8,"female",279,323,213,1466,2554,1144,1272,322,1282
1726176,17,30,1996,4,"male",630,624,516,418,62,418,17,0,45
1726232,83,10,1930,10,"male",482,59,23,0,1,0,0,0,1
1726238,22,5,1991,4,"male",268,325,130,39,24,38,11,1,13
1726239,39,26,1974,8,"male",526,51,32,0,2,0,2,0,0
1726250,56,30,1957,12,"female",140,28,23,13,15,13,9,0,6
1726269,53,5,1960,4,"male",1317,39,16,84,209,84,142,0,67
1726289,17,17,1996,4,"male",544,208,136,1,10,1,10,0,0
1726296,23,3,1990,5,"male",753,207,134,401,5,401,4,0,1
1726303,25,22,1988,1,"male",619,9,7,3,0,2,0,1,0
1726315,21,6,1992,1,"male",385,120,13,0,8,0,0,0,8
1726320,23,25,1990,3,"female",103,34,17,0,1,0,1,0,0
1726341,30,1,1983,1,"male",46,11,8,0,0,0,0,0,0
1726356,15,11,1998,9,"female",565,1641,658,867,1028,126,236,741,792
1726366,50,1,1963,3,"male",182,76,35,530,1911,0,307,530,1604
1726373,16,19,1997,12,"female",265,103,64,132,92,132,77,0,15
1726419,58,22,1955,12,"female",69,52,41,44,42,44,27,0,15
1726429,40,7,1973,12,"male",688,8,6,0,0,0,0,0,0
1726485,44,1,1969,1,"male",224,18,15,4,7,1,1,3,6
1726522,28,1,1985,5,"male",232,54,29,65,113,65,52,0,61
1726530,21,27,1992,10,"female",274,357,65,65,162,61,115,4,47
1726551,62,26,1951,7,"female",1489,248,128,1268,463,852,285,416,178
1726561,33,1,1980,2,"female",1684,505,144,142,1897,128,1490,14,407
1726570,36,30,1977,4,"female",255,28,11,66,58,66,33,0,25
1726577,37,3,1976,10,"male",196,1,1,1,1,1,1,0,0
1726583,18,2,1995,2,"male",174,130,78,2,14,2,12,0,2
1726592,32,29,1981,1,"male",446,50,23,1,0,1,0,0,0
1726613,50,16,1963,1,"male",303,148,132,1,20,0,3,1,17
1726625,23,22,1990,1,"male",296,56,31,0,0,0,0,0,0
1726629,25,1,1988,1,"female",130,744,55,497,1698,497,1348,0,350
1726631,51,28,1962,6,"male",150,33,31,24,16,24,13,0,3
1726685,63,16,1950,4,"male",2296,58,20,0,5,0,4,0,1
1726687,27,19,1986,10,"male",41,0,0,0,0,0,0,0,0
1726698,18,11,1995,9,"female",131,131,74,3,57,3,47,0,10
1726704,51,12,1962,2,"female",962,64,42,3,13,1,6,2,7
1726706,108,8,1905,9,"female",868,505,135,43,4,18,4,25,0
1726719,21,14,1992,2,"male",172,20,14,0,0,0,0,0,0
1726731,61,22,1952,7,"female",296,221,162,215,178,0,67,215,111
1726752,16,14,1997,8,"male",231,47,44,0,3,0,2,0,1
1726757,16,12,1997,7,"male",269,79,14,1,1,1,1,0,0
1726794,19,5,1994,1,"female",92,330,214,207,549,207,473,0,76
1726798,43,12,1970,2,"male",353,9,6,6,0,6,0,0,0
1726829,27,15,1986,5,"male",203,59,53,1,4,1,4,0,0
1726835,18,15,1995,9,"female",245,209,132,215,160,215,97,0,63
1726842,25,1,1988,1,"female",271,11,4,0,2,0,2,0,0
1726843,30,27,1983,7,"male",428,30,19,7,3,7,2,0,1
1726850,33,17,1980,12,"male",461,52,34,14,14,13,13,1,1
1726862,17,9,1996,9,"male",186,503,330,52,230,47,36,5,194
1726897,51,29,1962,5,"female",14,35,34,13,15,13,15,0,0
1726907,61,26,1952,12,"male",1661,58,33,0,0,0,0,0,0
1726925,16,12,1997,1,"male",111,22,17,2,0,2,0,0,0
1726927,23,24,1990,5,"male",760,6,2,0,0,0,0,0,0
1726959,40,18,1973,3,"female",516,124,87,2,4,1,3,1,1
1726978,17,10,1996,9,"female",120,100,50,3,5,0,2,3,3
1726993,51,1,1962,9,"female",505,121,102,378,249,378,207,0,42
1727011,24,9,1989,9,"male",1068,2143,1504,69,48,41,39,28,9
1727036,20,2,1993,9,"female",506,359,188,651,508,470,304,181,204
1727040,40,12,1973,3,"female",401,101,66,7,7,7,7,0,0
1727061,46,9,1967,9,"female",1113,95,57,441,337,41,165,400,172
1727065,17,19,1996,2,"female",429,460,110,348,158,348,128,0,30
1727067,23,8,1990,11,"male",369,96,59,2,1,2,0,0,1
1727090,24,6,1989,12,"female",312,772,270,73,148,71,130,2,18
1727095,108,27,1905,7,"female",21,97,85,50,31,0,4,50,27
1727108,44,31,1969,3,"male",217,60,41,4,0,3,0,1,0
1727113,78,29,1935,9,"female",859,3727,862,2559,3723,2022,2230,537,1493
1727124,17,5,1996,9,"female",1436,3299,441,236,667,16,123,220,544
1727138,24,26,1989,10,"male",1024,301,190,0,0,0,0,0,0
1727151,24,7,1989,5,"female",566,361,192,794,455,794,387,0,68
1727174,45,28,1968,2,"female",1205,134,55,138,243,138,177,0,66
1727189,15,18,1998,10,"female",263,8,2,148,39,91,29,57,10
1727208,38,5,1975,1,"male",364,72,70,67,13,67,7,0,6
1727210,47,11,1966,4,"female",621,66,32,40,49,40,41,0,8
1727213,107,26,1906,11,"male",876,464,218,35,168,35,132,0,36
1727229,29,23,1984,5,"male",460,54,21,6,14,6,10,0,4
1727263,61,21,1952,3,"male",1725,49,10,0,0,0,0,0,0
1727266,23,29,1990,7,"female",443,49,42,78,104,77,87,1,17
1727267,18,17,1995,2,"male",537,191,26,12,12,0,6,12,6
1727285,33,1,1980,11,"male",569,88,73,2,2,0,2,2,0
1727288,76,10,1937,1,"female",2078,73,28,23,30,12,5,11,25
1727299,108,31,1905,8,"male",1069,124,73,4,24,0,8,4,16
1727316,34,3,1979,1,"female",387,62,26,61,32,61,25,0,7
1727342,101,12,1912,12,"female",1439,937,703,97,50,97,37,0,13
1727362,31,25,1982,11,"female",522,259,221,14,9,14,4,0,5
1727367,25,1,1988,1,"male",193,54,34,175,45,171,31,4,14
1727398,18,19,1995,12,"female",526,117,64,8,97,8,78,0,19
1727403,20,7,1993,1,"female",295,110,70,34,7,18,0,16,7
1727447,29,9,1984,3,"male",277,6,6,0,0,0,0,0,0
1727473,103,31,1910,12,"female",2313,169,92,48,141,7,91,41,50
1727482,24,15,1989,7,"male",100,0,0,0,0,0,0,0,0
1727499,31,6,1982,8,"female",504,35,24,67,7,50,6,17,1
1727502,14,21,1999,5,"male",525,123,69,4,0,1,0,3,0
1727513,15,6,1998,1,"male",16,45,40,2,40,0,6,2,34
1727517,67,3,1946,10,"female",860,94,53,150,6,0,1,150,5
1727528,16,9,1997,6,"female",146,324,115,433,319,137,122,296,197
1727538,16,21,1997,11,"male",361,144,56,12,9,11,8,1,1
1727555,32,15,1981,6,"male",26,11,7,0,0,0,0,0,0
1727557,28,12,1985,5,"male",268,33,11,0,3,0,3,0,0
1727562,53,1,1960,1,"male",316,3,1,3,3,3,3,0,0
1727588,23,4,1990,9,"male",606,138,66,11,2,8,1,3,1
1727597,31,3,1982,5,"female",663,239,102,381,289,349,86,32,203
1727605,19,23,1994,5,"male",391,1429,1164,27,95,27,78,0,17
1727630,16,10,1997,3,"male",352,4,1,0,0,0,0,0,0
1727644,31,20,1982,2,"male",152,34,15,1,1,0,1,1,0
1727665,25,8,1988,11,"female",462,95,72,9,14,9,12,0,2
1727675,24,22,1989,5,"female",305,22,14,0,1,0,0,0,1
1727676,30,9,1983,7,"male",65,18,16,18,18,18,3,0,15
1727682,14,1,1999,7,"male",52,495,462,1285,584,1285,490,0,94
1727706,50,2,1963,3,"female",1977,58,22,45,48,39,40,6,8
1727730,55,11,1958,3,"female",645,67,30,688,117,688,94,0,23
1727735,13,3,2000,1,"female",255,545,62,37,37,37,13,0,24
1727736,15,15,1998,6,"female",179,644,405,1033,611,457,249,576,362
1727751,34,13,1979,1,"male",226,5,4,31,0,14,0,17,0
1727767,25,27,1988,9,"male",96,214,209,0,2,0,2,0,0
1727772,15,10,1998,7,"male",324,155,85,10,0,10,0,0,0
1727788,32,10,1981,6,"female",180,14,13,2,0,2,0,0,0
1727817,75,20,1938,6,"female",745,15,4,0,0,0,0,0,0
1727845,19,28,1994,5,"female",405,158,84,0,0,0,0,0,0
1727862,108,1,1905,9,"female",1630,230,91,471,267,471,251,0,16
1727864,28,17,1985,1,"male",418,48,25,13,0,11,0,2,0
1727895,70,7,1943,11,"female",214,44,37,11,13,1,12,10,1
1727899,45,7,1968,7,"male",244,39,17,0,5,0,4,0,1
1727905,19,3,1994,2,"female",168,4,4,0,0,0,0,0,0
1727956,69,22,1944,7,"female",1171,78,50,276,207,0,25,276,182
1727958,31,27,1982,1,"male",234,9,3,0,0,0,0,0,0
1727961,59,28,1954,5,"female",284,19,16,0,0,0,0,0,0
1727965,22,24,1991,10,"male",314,25,13,4,1,4,1,0,0
1727986,25,17,1988,12,"male",589,1668,1215,557,728,434,493,123,235
1728001,19,5,1994,5,"male",369,116,65,166,117,166,49,0,68
1728040,31,21,1982,6,"female",141,49,38,0,0,0,0,0,0
1728067,72,27,1941,10,"male",572,49,34,0,0,0,0,0,0
1728079,30,20,1983,8,"male",515,48,34,0,0,0,0,0,0
1728106,23,13,1990,5,"male",211,65,55,116,4,43,0,73,4
1728111,29,12,1984,1,"male",410,43,42,4,2,4,2,0,0
1728127,61,13,1952,6,"female",1592,242,116,1376,537,1376,213,0,324
1728137,19,17,1994,8,"male",145,76,58,2,2,2,2,0,0
1728150,57,10,1956,3,"female",319,24,6,8,2,0,1,8,1
1728151,29,28,1984,7,"female",424,615,282,1563,608,1563,564,0,44
1728188,19,17,1994,2,"male",281,37,34,101,43,101,34,0,9
1728190,24,26,1989,7,"female",171,5,3,3,1,3,1,0,0
1728200,32,23,1981,2,"female",354,16,10,1,1,1,1,0,0
1728212,36,24,1977,2,"female",734,64,55,176,181,176,170,0,11
1728213,23,14,1990,10,"male",33,84,77,10,25,10,17,0,8
1728242,25,27,1988,7,"male",488,95,49,3,0,3,0,0,0
1728252,23,5,1990,4,"female",414,206,161,189,233,48,138,141,95
1728258,29,24,1984,2,"female",890,120,44,21,8,21,7,0,1
1728276,17,26,1996,3,"female",1204,688,272,10,33,0,12,10,21
1728280,31,22,1982,12,"male",134,17,17,13,9,13,5,0,4
1728283,64,5,1949,4,"male",105,194,173,60,61,60,40,0,21
1728302,47,9,1966,2,"female",426,54,10,48,62,48,40,0,22
1728318,17,28,1996,1,"male",213,325,122,37,36,37,16,0,20
1728326,35,1,1978,11,"male",717,53,17,1,8,1,4,0,4
1728335,30,24,1983,9,"male",637,16,13,0,0,0,0,0,0
1728350,43,13,1970,3,"male",200,21,14,37,19,37,12,0,7
1728351,61,23,1952,7,"male",533,29,22,2,0,0,0,2,0
1728367,108,16,1905,2,"male",354,161,129,0,20,0,18,0,2
1728368,27,1,1986,9,"male",802,69,68,0,3,0,3,0,0
1728376,45,24,1968,7,"male",550,143,73,4,9,4,7,0,2
1728383,18,2,1995,11,"male",70,18,14,0,0,0,0,0,0
1728415,33,19,1980,10,"male",532,31,10,8,0,8,0,0,0
1728437,29,16,1984,10,"male",685,19,9,0,4,0,1,0,3
1728452,108,10,1905,9,"female",1118,831,359,1351,517,1348,231,3,286
1728468,42,12,1971,10,"male",235,330,74,216,124,216,62,0,62
1728476,58,4,1955,4,"female",201,44,12,106,26,106,21,0,5
1728481,13,24,2000,5,"male",64,123,112,37,43,37,40,0,3
1728487,108,5,1905,1,"male",1966,279,111,0,0,0,0,0,0
1728493,20,26,1993,1,"male",272,150,57,60,11,22,7,38,4
1728501,42,1,1971,1,"male",485,0,0,0,0,0,0,0,0
1728518,33,15,1980,1,"female",301,44,18,0,13,0,3,0,10
1728522,26,13,1987,5,"male",804,14,11,0,0,0,0,0,0
1728523,71,5,1942,7,"male",250,23,8,3,72,0,66,3,6
1728537,21,10,1992,4,"male",289,9,8,1,0,1,0,0,0
1728569,42,2,1971,2,"male",542,81,60,0,0,0,0,0,0
1728572,43,12,1970,8,"male",98,19,18,0,0,0,0,0,0
1728595,47,1,1966,2,"male",667,127,91,1,2,0,1,1,1
1728615,33,5,1980,7,"male",994,82,71,24,22,20,17,4,5
1728617,23,12,1990,9,"male",54,76,75,0,0,0,0,0,0
1728637,17,23,1996,4,"male",720,591,331,853,1510,657,1285,196,225
1728652,13,17,2000,4,"male",121,41,21,6,4,1,3,5,1
1728653,108,26,1905,11,"male",47,8,8,0,0,0,0,0,0
1728693,45,7,1968,9,"male",440,52,40,112,136,112,113,0,23
1728716,18,1,1995,3,"female",623,831,409,80,142,17,73,63,69
1728744,58,11,1955,7,"female",631,89,53,16,59,14,39,2,20
1728753,67,3,1946,2,"male",1020,13,8,2,0,0,0,2,0
1728767,18,1,1995,1,"male",45,29,26,32,10,32,10,0,0
1728805,25,1,1988,1,"female",136,71,64,1,7,1,5,0,2
1728811,16,12,1997,10,"male",559,89,39,384,34,384,23,0,11
1728828,18,10,1995,9,"male",667,175,81,0,0,0,0,0,0
1728838,14,9,1999,9,"male",350,42,41,0,0,0,0,0,0
1728855,25,23,1988,8,"male",554,188,108,0,4,0,0,0,4
1728877,17,13,1996,7,"male",265,192,22,0,15,0,3,0,12
1728885,21,10,1992,2,"male",536,139,125,0,0,0,0,0,0
1728895,20,14,1993,10,"male",438,74,64,15,13,15,10,0,3
1728907,23,4,1990,10,"female",686,65,20,1434,1140,1434,771,0,369
1728913,43,1,1970,1,"male",1081,42,37,2,0,2,0,0,0
1728931,43,5,1970,5,"female",413,46,12,0,0,0,0,0,0
1728943,26,8,1987,7,"female",553,385,296,0,0,0,0,0,0
1728944,16,13,1997,11,"male",834,208,145,3,0,2,0,1,0
1728964,63,18,1950,6,"female",1338,83,36,0,1,0,1,0,0
1728997,30,30,1983,5,"female",151,135,101,181,155,83,53,98,102
1729005,65,12,1948,8,"male",1262,114,77,0,0,0,0,0,0
1729016,17,18,1996,10,"male",190,127,88,0,9,0,5,0,4
1729019,44,14,1969,8,"male",784,56,38,0,1,0,0,0,1
1729034,60,4,1953,11,"female",268,204,146,690,20,672,9,18,11
1729054,36,7,1977,11,"male",1599,44,6,0,2,0,1,0,1
1729067,22,3,1991,3,"male",238,55,37,0,8,0,1,0,7
1729110,25,18,1988,12,"male",480,393,295,5,7,0,5,5,2
1729125,23,1,1990,1,"female",149,5,5,15,9,15,8,0,1
1729126,46,31,1967,1,"male",1770,153,86,3,27,2,12,1,15
1729142,22,9,1991,4,"male",480,82,75,1,0,1,0,0,0
1729157,18,10,1995,9,"male",534,156,31,11,10,1,6,10,4
1729158,31,13,1982,3,"male",347,0,0,0,0,0,0,0,0
1729169,48,16,1965,10,"male",96,1,1,0,0,0,0,0,0
1729173,47,22,1966,5,"female",1723,507,150,132,47,100,21,32,26
1729182,35,22,1978,11,"male",290,44,21,0,0,0,0,0,0
1729184,16,27,1997,12,"male",527,610,518,0,0,0,0,0,0
1729186,26,16,1987,5,"male",969,359,163,0,4,0,2,0,2
1729207,32,3,1981,9,"male",311,134,105,1,5,1,4,0,1
1729224,25,14,1988,9,"male",461,160,103,166,244,166,106,0,138
1729233,19,17,1994,4,"male",366,86,50,228,132,228,61,0,71
1729244,42,17,1971,3,"female",395,45,23,31,3,0,2,31,1
1729275,80,30,1933,7,"female",984,134,49,0,7,0,2,0,5
1729315,32,17,1981,2,"female",1568,249,123,52,142,52,60,0,82
1729327,40,3,1973,8,"male",170,34,29,21,3,21,0,0,3
1729330,100,31,1913,8,"female",293,952,824,429,461,429,361,0,100
1729341,33,21,1980,9,"female",13,29,27,0,0,0,0,0,0
1729347,25,31,1988,8,"male",886,1,1,0,0,0,0,0,0
1729348,15,23,1998,6,"female",348,276,139,15,0,13,0,2,0
1729385,30,8,1983,10,"female",483,271,173,8,9,5,0,3,9
1729391,23,27,1990,9,"male",718,287,193,5,2,0,0,5,2
1729395,35,23,1978,2,"male",746,192,97,1,21,0,7,1,14
1729412,25,10,1988,10,"male",201,8,6,0,9,0,1,0,8
1729453,58,23,1955,1,"female",505,109,85,97,0,0,0,97,0
1729457,14,3,1999,6,"male",734,71,34,37,3,32,0,5,3
1729472,74,28,1939,12,"male",1024,113,30,15,35,0,18,15,17
1729488,20,6,1993,7,"male",6,8,8,0,2,0,1,0,1
1729515,20,18,1993,11,"male",490,177,138,0,10,0,7,0,3
1729521,45,13,1968,7,"male",763,228,1,519,154,519,104,0,50
1729528,15,1,1998,3,"male",27,65,57,4,6,4,6,0,0
1729548,23,24,1990,12,"male",346,116,94,16,7,16,6,0,1
1729555,13,28,2000,1,"male",414,230,145,10,0,4,0,6,0
1729557,53,20,1960,8,"female",203,4,2,0,0,0,0,0,0
1729559,20,2,1993,2,"male",366,49,31,8,0,8,0,0,0
1729561,24,29,1989,7,"female",270,119,72,126,553,105,305,21,248
1729566,14,13,1999,12,"male",23,31,20,1,18,1,9,0,9
1729601,65,3,1948,6,"female",912,33,22,61,41,61,30,0,11
1729619,49,17,1964,12,"male",808,733,208,295,450,250,168,45,282
1729633,103,21,1910,6,"male",1382,928,361,4,16,4,8,0,8
1729635,62,8,1951,12,"female",1841,237,157,586,34,126,24,460,10
1729651,26,17,1987,12,"female",294,169,39,45,49,44,44,1,5
1729703,15,1,1998,4,"male",579,273,113,4,0,4,0,0,0
1729709,31,15,1982,6,"female",210,52,34,22,18,22,16,0,2
1729753,17,4,1996,9,"male",44,921,664,4415,2953,4303,2305,112,648
1729804,21,10,1992,5,"female",385,77,57,6,0,0,0,6,0
1729807,33,17,1980,1,"male",485,11,8,0,0,0,0,0,0
1729809,38,21,1975,2,"male",480,19,15,3,0,3,0,0,0
1729812,15,6,1998,7,"female",214,560,261,13,0,13,0,0,0
1729857,49,22,1964,12,"male",244,3,3,1,0,1,0,0,0
1729860,58,24,1955,12,"male",353,25,15,0,0,0,0,0,0
1729861,27,20,1986,12,"male",417,255,84,235,79,116,28,119,51
1729877,108,3,1905,3,"male",1822,296,133,3,6,3,3,0,3
1729886,16,30,1997,3,"female",222,812,164,303,1321,302,836,1,485
1729898,53,7,1960,10,"male",362,33,14,14,17,14,15,0,2
1729912,16,1,1997,11,"male",608,64,43,298,46,298,35,0,11
1729937,50,27,1963,1,"female",188,63,49,1,2,0,0,1,2
1729951,16,10,1997,8,"male",467,222,162,15,8,15,7,0,1
1729969,23,6,1990,3,"female",0,0,0,0,0,0,0,0,0
1729999,33,26,1980,6,"female",537,219,146,20,52,20,9,0,43
1730006,48,6,1965,3,"female",77,50,36,558,360,558,267,0,93
1730016,34,27,1979,11,"male",756,21,18,1,0,1,0,0,0
1730024,63,22,1950,4,"female",818,37,18,0,3,0,2,0,1
1730031,16,11,1997,5,"male",531,227,16,10,11,10,5,0,6
1730035,39,14,1974,11,"male",102,31,16,55,1,55,1,0,0
1730037,31,7,1982,5,"male",399,287,220,145,44,145,33,0,11
1730041,49,14,1964,5,"female",931,17,8,14,4,0,0,14,4
1730047,36,1,1977,7,"male",131,0,0,0,0,0,0,0,0
1730049,18,2,1995,4,"female",310,265,177,66,0,66,0,0,0
1730062,16,2,1997,11,"female",464,754,362,2944,1289,2904,1010,40,279
1730080,62,6,1951,10,"female",1933,180,89,271,164,181,66,90,98
1730085,23,9,1990,2,"male",636,429,399,13,8,13,8,0,0
1730088,15,8,1998,2,"male",261,47,26,14,39,13,5,1,34
1730097,18,28,1995,12,"male",351,570,411,154,114,154,88,0,26
1730107,37,5,1976,10,"male",309,144,112,2,3,2,3,0,0
1730116,18,28,1995,2,"female",216,214,113,1004,850,1004,547,0,303
1730131,13,6,2000,6,"female",316,74,40,15,12,0,4,15,8
1730152,28,3,1985,12,"male",32,8,7,0,0,0,0,0,0
1730164,24,28,1989,6,"male",635,12,5,1,0,0,0,1,0
1730167,102,29,1911,10,"female",2223,477,288,7,7,7,3,0,4
1730169,25,18,1988,8,"female",702,261,95,6,46,6,20,0,26
1730178,57,25,1956,1,"female",370,29,13,4,3,0,0,4,3
1730189,23,1,1990,1,"male",475,57,27,17,3,17,2,0,1
1730211,29,1,1984,1,"male",220,9,7,36,2,36,0,0,2
1730227,29,16,1984,12,"female",712,224,67,1556,337,890,239,666,98
1730242,18,21,1995,3,"male",20,0,0,0,0,0,0,0,0
1730244,66,9,1947,9,"male",45,53,44,5,7,0,2,5,5
1730265,54,20,1959,8,"female",137,44,41,243,40,0,22,243,18
1730271,44,14,1969,11,"female",271,4,4,0,0,0,0,0,0
1730342,22,31,1991,12,"male",435,10,3,96,81,84,78,12,3
1730367,21,16,1992,1,"female",627,426,151,1201,1711,1201,1438,0,273
1730384,50,11,1963,2,"female",451,67,52,1642,1150,872,380,770,770
1730407,57,18,1956,9,"female",138,73,58,370,82,0,2,370,80
1730442,33,18,1980,11,"female",991,0,0,0,0,0,0,0,0
1730447,17,23,1996,10,"male",597,218,35,3,9,3,9,0,0
1730455,17,19,1996,11,"male",297,442,358,47,6,39,2,8,4
1730470,29,2,1984,10,"male",463,148,113,0,0,0,0,0,0
1730483,33,10,1980,2,"male",114,31,28,3,0,3,0,0,0
1730491,113,10,1900,11,"female",1473,114,72,315,332,210,126,105,206
1730523,21,26,1992,5,"female",579,121,68,0,3,0,2,0,1
1730578,18,10,1995,2,"male",261,132,66,385,29,385,28,0,1
1730589,26,11,1987,5,"male",50,0,0,0,0,0,0,0,0
1730639,69,16,1944,3,"female",1482,69,12,597,195,0,48,597,147
1730659,80,7,1933,8,"female",26,81,72,243,236,243,212,0,24
1730669,45,2,1968,4,"male",486,53,43,0,0,0,0,0,0
1730670,48,31,1965,3,"male",432,16,7,0,60,0,10,0,50
1730674,23,15,1990,5,"female",124,0,0,0,0,0,0,0,0
1730748,31,22,1982,1,"female",401,137,80,217,146,215,101,2,45
1730765,56,12,1957,9,"female",40,13,11,27,118,0,21,27,97
1730768,51,17,1962,6,"female",994,66,56,36,138,20,103,16,35
1730769,16,9,1997,10,"male",323,279,236,7,1,7,0,0,1
1730778,20,4,1993,6,"male",237,202,194,0,0,0,0,0,0
1730779,19,5,1994,4,"male",446,28,23,0,0,0,0,0,0
1730795,27,23,1986,10,"male",684,16,15,0,0,0,0,0,0
1730849,29,24,1984,6,"female",693,729,152,619,822,619,627,0,195
1730851,35,10,1978,10,"male",430,11,6,1,8,1,7,0,1
1730869,26,14,1987,9,"female",20,80,34,2,7,2,0,0,7
1730874,19,25,1994,2,"male",607,369,335,1,1,0,0,1,1
1730880,16,12,1997,12,"male",233,38,16,0,0,0,0,0,0
1730947,36,4,1977,11,"female",500,1,1,0,0,0,0,0,0
1730981,17,2,1996,2,"female",275,46,19,6,0,6,0,0,0
1730987,48,22,1965,6,"male",176,11,10,0,0,0,0,0,0
1730988,25,1,1988,2,"male",0,0,0,3,0,3,0,0,0
1731023,20,12,1993,12,"male",1041,763,451,27,40,18,25,9,15
1731036,50,9,1963,3,"female",333,34,28,1,1,1,1,0,0
1731138,45,1,1968,1,"male",221,2,2,1,0,1,0,0,0
1731155,25,5,1988,5,"female",448,68,37,113,135,113,113,0,22
1731180,99,14,1914,3,"male",1278,116,40,426,66,426,16,0,50
1731195,18,22,1995,6,"male",318,150,136,1,0,0,0,1,0
1731200,34,16,1979,9,"male",436,162,95,32,41,4,15,28,26
1731201,46,14,1967,10,"male",211,79,34,10,5,10,2,0,3
1731211,14,10,1999,5,"male",406,209,86,0,0,0,0,0,0
1731239,16,22,1997,10,"female",718,3412,583,530,1649,248,635,282,1014
1731244,64,4,1949,3,"male",641,146,47,0,0,0,0,0,0
1731250,49,22,1964,5,"female",295,50,44,731,478,0,165,731,313
1731277,42,3,1971,5,"male",456,0,0,0,0,0,0,0,0
1731278,28,28,1985,4,"female",346,64,43,1,2,0,0,1,2
1731280,68,2,1945,5,"female",1755,188,117,48,105,0,42,48,63
1731340,39,22,1974,10,"male",396,32,26,14,13,0,3,14,10
1731341,66,5,1947,10,"female",620,19,9,76,2,67,0,9,2
1731365,20,4,1993,9,"female",135,294,136,51,242,50,171,1,71
1731377,34,26,1979,2,"male",501,21,9,5,0,5,0,0,0
1731380,40,26,1973,7,"female",342,23,13,40,1,40,1,0,0
1731387,61,25,1952,3,"female",412,33,5,1,0,1,0,0,0
1731414,64,28,1949,8,"male",579,6,2,0,0,0,0,0,0
1731427,60,24,1953,5,"female",66,19,2,6,3,6,3,0,0
1731429,32,10,1981,9,"male",107,21,8,4,13,4,8,0,5
1731439,23,2,1990,9,"male",524,339,166,1,1,1,1,0,0
1731446,36,30,1977,10,"male",101,40,29,70,0,70,0,0,0
1731447,23,13,1990,2,"female",489,740,57,1551,548,1350,525,201,23
1731449,34,14,1979,12,"male",583,194,134,138,306,68,98,70,208
1731454,21,12,1992,12,"female",530,609,292,3504,1749,3159,775,345,974
1731460,19,22,1994,8,"male",126,127,105,76,138,34,84,42,54
1731463,56,1,1957,12,"female",1342,167,59,986,123,986,42,0,81
1731497,22,31,1991,5,"female",352,34,22,0,0,0,0,0,0
1731499,43,22,1970,2,"male",47,31,25,21,13,20,11,1,2
1731504,23,28,1990,2,"female",274,54,29,1,2,1,2,0,0
1731582,52,9,1961,10,"male",2341,104,17,0,0,0,0,0,0
1731599,53,19,1960,9,"female",85,69,57,36,157,9,59,27,98
1731635,19,17,1994,12,"male",74,13,10,1,5,1,5,0,0
1731658,49,21,1964,10,"male",1372,283,119,18,25,13,14,5,11
1731667,47,1,1966,8,"female",970,130,21,226,970,5,306,221,664
1731682,23,15,1990,6,"male",946,506,333,41,47,41,42,0,5
1731691,27,4,1986,8,"male",561,498,228,0,6,0,1,0,5
1731701,31,4,1982,1,"female",319,75,27,1,12,1,11,0,1
1731703,17,5,1996,10,"female",269,135,124,8,14,8,14,0,0
1731727,45,24,1968,6,"male",579,251,155,38,41,0,18,38,23
1731776,20,18,1993,11,"male",1112,290,165,1,0,1,0,0,0
1731783,62,14,1951,10,"male",1713,55,11,23,42,23,26,0,16
1731818,78,4,1935,2,"male",1042,84,20,1,1,0,0,1,1
1731825,38,30,1975,8,"male",763,34,19,0,0,0,0,0,0
1731826,68,11,1945,4,"male",1348,180,10,0,0,0,0,0,0
1731841,17,2,1996,2,"male",672,603,458,169,188,95,89,74,99
1731842,18,19,1995,2,"male",328,337,249,15,59,3,10,12,49
1731858,20,1,1993,9,"female",139,68,55,1027,977,105,152,922,825
1731879,108,5,1905,8,"male",995,485,210,32,13,32,11,0,2
1731887,43,24,1970,6,"male",730,2,0,0,0,0,0,0,0
1731906,24,23,1989,9,"male",13,19,15,29,5,29,3,0,2
1731960,23,11,1990,3,"male",521,170,132,12,10,12,5,0,5
1731962,27,8,1986,12,"male",583,247,179,0,16,0,16,0,0
1731968,100,14,1913,8,"female",2068,106,36,67,3,67,3,0,0
1731987,15,31,1998,12,"male",175,563,60,3,34,1,1,2,33
1731991,24,31,1989,7,"male",557,152,119,1,80,1,44,0,36
1732002,60,7,1953,1,"male",1685,168,91,244,99,40,59,204,40
1732004,28,7,1985,9,"male",255,12,8,1,0,1,0,0,0
1732018,27,29,1986,9,"male",466,240,200,2,1,2,0,0,1
1732020,22,7,1991,9,"male",158,4,3,0,0,0,0,0,0
1732035,69,29,1944,5,"male",316,312,19,35,75,0,33,35,42
1732119,15,17,1998,2,"male",188,583,565,21,3,20,3,1,0
1732134,21,9,1992,6,"female",153,39,19,74,44,74,35,0,9
1732163,101,21,1912,5,"male",900,264,139,5,18,4,12,1,6
1732187,24,2,1989,4,"male",222,149,86,0,0,0,0,0,0
1732205,23,26,1990,7,"male",482,64,27,259,14,259,12,0,2
1732229,19,10,1994,5,"female",442,793,280,904,969,147,700,757,269
1732278,19,16,1994,10,"female",48,35,9,9,32,9,16,0,16
1732295,38,18,1975,2,"male",586,26,5,12,2,12,1,0,1
1732307,21,8,1992,11,"female",23,2,2,5,79,5,56,0,23
1732312,58,8,1955,1,"female",146,42,26,21,57,21,34,0,23
1732320,28,3,1985,9,"female",336,248,41,7,1,0,1,7,0
1732330,89,12,1924,5,"male",1282,523,296,386,117,224,29,162,88
1732363,68,31,1945,3,"female",1314,48,26,10,12,9,7,1,5
1732385,26,30,1987,4,"male",840,106,61,3,4,3,4,0,0
1732398,20,18,1993,8,"male",254,63,42,29,18,11,6,18,12
1732414,15,8,1998,2,"male",214,51,29,0,2,0,1,0,1
1732436,33,7,1980,7,"female",116,48,45,33,43,33,33,0,10
1732437,24,11,1989,12,"female",453,84,24,1,0,1,0,0,0
1732440,26,1,1987,1,"male",345,76,53,0,1,0,0,0,1
1732442,25,21,1988,6,"female",388,426,334,786,293,783,201,3,92
1732445,58,2,1955,7,"male",6,0,0,1,0,1,0,0,0
1732458,32,30,1981,1,"female",978,86,27,142,60,142,41,0,19
1732479,24,3,1989,7,"male",232,58,22,0,0,0,0,0,0
1732510,38,26,1975,7,"female",641,19,11,117,115,117,83,0,32
1732511,56,27,1957,2,"female",1802,207,49,1029,224,219,117,810,107
1732564,15,28,1998,2,"male",375,641,542,30,54,30,41,0,13
1732570,101,1,1912,6,"male",1169,89,77,21,1,0,0,21,1
1732573,24,4,1989,8,"male",498,1684,1464,10,27,2,23,8,4
1732577,22,10,1991,4,"male",90,51,41,4,0,4,0,0,0
1732590,23,15,1990,10,"male",497,33,17,16,5,5,4,11,1
1732643,39,16,1974,6,"female",157,30,23,7,23,5,12,2,11
1732645,30,2,1983,5,"male",174,126,88,216,34,216,33,0,1
1732649,18,19,1995,12,"male",816,716,523,2236,3858,691,1685,1545,2173
1732658,65,13,1948,6,"female",1365,82,26,111,94,98,41,13,53
1732664,20,13,1993,4,"female",465,33,26,338,175,330,137,8,38
1732691,26,1,1987,1,"female",183,31,22,3,18,3,6,0,12
1732693,48,19,1965,7,"female",552,2,1,0,0,0,0,0,0
1732717,18,10,1995,3,"female",241,203,115,46,84,12,27,34,57
1732792,23,1,1990,1,"male",249,39,13,0,0,0,0,0,0
1732801,21,2,1992,2,"male",357,314,269,34,148,34,65,0,83
1732806,31,16,1982,1,"male",452,105,94,18,6,18,3,0,3
1732813,69,23,1944,12,"male",842,6,3,0,0,0,0,0,0
1732830,23,2,1990,7,"male",256,100,46,24,2,24,2,0,0
1732849,31,23,1982,11,"male",352,20,20,1,0,0,0,1,0
1732866,16,26,1997,11,"female",336,489,25,7,153,7,96,0,57
1732928,26,2,1987,6,"male",462,93,68,9,45,9,27,0,18
1732935,14,24,1999,12,"male",150,14,7,114,3,44,0,70,3
1732957,49,21,1964,9,"female",719,795,573,2586,2497,215,1138,2371,1359
1732964,26,1,1987,7,"male",307,22,19,88,8,83,5,5,3
1732985,52,20,1961,10,"female",244,56,32,12,3,12,2,0,1
1733001,58,15,1955,12,"female",1977,470,401,2398,545,0,128,2398,417
1733006,23,18,1990,7,"female",405,454,72,69,48,65,22,4,26
1733042,15,18,1998,9,"male",377,62,36,0,0,0,0,0,0
1733065,46,10,1967,4,"male",530,77,61,0,0,0,0,0,0
1733113,18,10,1995,6,"female",381,400,231,9,40,9,15,0,25
1733136,27,29,1986,5,"female",618,192,112,102,326,101,266,1,60
1733164,17,31,1996,5,"male",385,153,100,50,32,50,24,0,8
1733203,66,8,1947,1,"male",1523,78,28,193,121,173,55,20,66
1733210,42,30,1971,5,"male",747,1,1,0,0,0,0,0,0
1733239,66,21,1947,10,"female",278,6,5,0,0,0,0,0,0
1733245,18,8,1995,5,"female",417,1205,859,434,284,336,227,98,57
1733248,52,5,1961,8,"female",242,85,48,1,103,1,93,0,10
1733266,56,13,1957,5,"female",488,52,22,10,1,0,0,10,1
1733288,17,3,1996,12,"male",312,77,41,0,0,0,0,0,0
1733313,53,18,1960,8,"female",606,83,22,1,7,1,3,0,4
1733315,35,23,1978,5,"male",1173,55,21,10,5,10,3,0,2
1733332,35,5,1978,9,"female",598,935,453,15,972,15,835,0,137
1733336,29,10,1984,10,"female",403,61,37,12,40,12,37,0,3
1733386,17,28,1996,12,"female",374,487,266,102,19,102,13,0,6
1733399,108,8,1905,8,"male",2035,477,292,56,190,19,136,37,54
1733406,20,15,1993,1,"male",600,16,12,0,0,0,0,0,0
1733407,33,17,1980,11,"female",358,10,1,1,0,1,0,0,0
1733442,38,1,1975,1,"male",1030,0,0,0,0,0,0,0,0
1733451,38,2,1975,7,"female",1124,101,74,64,20,64,12,0,8
1733455,37,24,1976,1,"male",298,55,38,0,0,0,0,0,0
1733514,22,24,1991,3,"male",755,573,367,12,13,12,13,0,0
1733524,55,1,1958,8,"female",1611,73,33,114,39,44,26,70,13
1733544,24,15,1989,11,"male",275,131,88,0,38,0,9,0,29
1733564,35,1,1978,1,"male",315,92,59,2,9,2,9,0,0
1733573,62,31,1951,3,"female",1269,255,203,55,59,39,17,16,42
1733579,21,4,1992,3,"male",299,230,80,24,14,24,12,0,2
1733607,65,8,1948,3,"male",990,15,5,0,0,0,0,0,0
1733614,100,31,1913,12,"male",157,223,90,2,0,2,0,0,0
1733623,40,6,1973,10,"male",331,150,82,23,7,23,7,0,0
1733659,26,15,1987,11,"male",489,536,361,2,1,1,1,1,0
1733662,16,1,1997,1,"female",77,186,40,63,173,63,171,0,2
1733692,17,14,1996,2,"male",178,130,117,117,2,0,0,117,2
1733697,23,13,1990,3,"female",183,407,319,1471,1442,1469,1062,2,380
1733732,64,5,1949,9,"female",1380,380,235,0,2,0,2,0,0
1733747,19,7,1994,11,"male",341,116,102,1,2,0,0,1,2
1733750,19,30,1994,5,"male",363,336,306,511,194,511,111,0,83
1733754,29,8,1984,9,"male",195,52,46,0,0,0,0,0,0
1733777,43,7,1970,4,"female",530,85,27,164,74,164,14,0,60
1733790,21,15,1992,9,"male",567,521,412,249,649,32,44,217,605
1733797,17,23,1996,7,"female",294,306,251,488,147,481,86,7,61
1733809,23,22,1990,8,"male",66,21,18,9,3,9,2,0,1
1733853,18,26,1995,4,"female",898,853,422,261,228,189,142,72,86
1733881,21,2,1992,11,"male",14,26,26,1,1,1,1,0,0
1733883,19,8,1994,8,"male",236,86,68,0,0,0,0,0,0
1733889,24,12,1989,1,"male",444,45,36,1,1,1,0,0,1
1733902,28,10,1985,12,"male",356,573,507,1,0,1,0,0,0
1733905,18,22,1995,10,"male",380,188,144,69,111,68,80,1,31
1733934,48,18,1965,11,"male",392,4272,26,8,561,8,421,0,140
1733941,52,2,1961,8,"male",252,11,4,0,0,0,0,0,0
1733942,54,6,1959,10,"female",265,23,13,1,2,0,1,1,1
1733948,22,15,1991,11,"female",129,539,102,149,503,149,210,0,293
1733986,23,29,1990,9,"male",386,65,58,3,1,3,1,0,0
1734014,86,18,1927,9,"female",425,364,108,1,11,0,8,1,3
1734023,25,24,1988,9,"female",475,236,51,231,193,0,72,231,121
1734030,21,14,1992,4,"female",242,237,178,211,253,172,75,39,178
1734052,18,13,1995,9,"male",261,73,57,4,1,0,0,4,1
1734078,31,5,1982,9,"female",673,208,111,280,381,280,240,0,141
1734084,45,11,1968,1,"female",2076,335,78,301,143,301,90,0,53
1734093,19,1,1994,2,"male",341,7,7,4,0,4,0,0,0
1734106,65,1,1948,10,"male",399,29,16,150,12,150,8,0,4
1734158,51,1,1962,6,"female",87,13,13,2,0,0,0,2,0
1734165,50,20,1963,5,"male",1432,25,9,16,2,12,1,4,1
1734177,24,31,1989,7,"female",1618,1532,511,757,688,757,596,0,92
1734186,28,26,1985,7,"male",288,103,78,35,2,32,0,3,2
1734200,21,20,1992,9,"male",107,5,4,0,0,0,0,0,0
1734208,16,14,1997,7,"male",417,185,159,27,3,6,2,21,1
1734231,53,26,1960,7,"male",1202,16,12,51,5,51,1,0,4
1734252,18,4,1995,2,"male",307,44,32,0,0,0,0,0,0
1734264,25,4,1988,5,"male",41,39,34,1,6,1,6,0,0
1734298,94,12,1919,1,"male",634,175,49,2,1,0,0,2,1
1734314,18,7,1995,2,"male",550,1,0,0,0,0,0,0,0
1734320,59,7,1954,5,"female",206,36,10,96,8,96,3,0,5
1734333,32,12,1981,3,"male",241,1,0,0,0,0,0,0,0
1734361,21,10,1992,2,"male",439,73,56,0,1,0,0,0,1
1734397,29,18,1984,1,"male",745,36,19,13,81,13,55,0,26
1734412,20,27,1993,10,"male",480,1105,929,230,127,184,91,46,36
1734429,100,2,1913,5,"female",1495,2493,527,8,34,8,26,0,8
1734431,58,16,1955,7,"male",1643,8,1,2,2,0,2,2,0
1734434,22,20,1991,11,"male",139,112,94,76,52,20,25,56,27
1734435,42,7,1971,7,"male",243,73,47,22,10,0,8,22,2
1734450,94,25,1919,7,"female",254,37,28,20,15,20,12,0,3
1734487,21,2,1992,2,"male",207,99,55,8,12,8,12,0,0
1734493,25,19,1988,4,"female",224,197,76,1,31,0,7,1,24
1734553,48,16,1965,10,"female",1569,52,16,17,8,0,8,17,0
1734599,18,9,1995,10,"female",366,280,65,769,362,769,228,0,134
1734611,25,1,1988,1,"male",338,1,1,0,0,0,0,0,0
1734624,20,1,1993,1,"male",841,25,22,19,10,19,6,0,4
1734636,65,29,1948,9,"female",1865,144,83,6,26,6,18,0,8
1734664,29,25,1984,2,"male",53,15,13,0,0,0,0,0,0
1734681,56,16,1957,5,"female",578,43,17,79,45,1,25,78,20
1734687,18,20,1995,6,"male",313,40,11,62,0,52,0,10,0
1734706,52,22,1961,1,"female",436,87,69,353,200,0,32,353,168
1734707,23,1,1990,1,"male",411,71,68,0,2,0,1,0,1
1734733,23,14,1990,4,"male",547,140,105,0,0,0,0,0,0
1734778,57,9,1956,1,"male",796,125,75,16,26,0,8,16,18
1734793,64,24,1949,11,"female",367,3,2,0,0,0,0,0,0
1734809,35,8,1978,1,"male",16,2,0,0,0,0,0,0,0
1734815,21,7,1992,12,"male",505,54,32,89,11,57,11,32,0
1734817,57,12,1956,4,"male",745,74,63,0,16,0,13,0,3
1734858,20,3,1993,2,"female",639,688,323,130,474,130,275,0,199
1734871,24,13,1989,6,"female",234,61,41,104,65,97,51,7,14
1734891,16,19,1997,10,"female",569,53,32,0,0,0,0,0,0
1734902,66,30,1947,11,"female",220,33,18,9,38,1,18,8,20
1734910,19,14,1994,7,"male",414,19,12,1,6,1,4,0,2
1734925,65,23,1948,3,"male",2020,27,11,14,14,0,5,14,9
1734926,23,24,1990,1,"male",1051,1,0,0,0,0,0,0,0
1734935,59,21,1954,10,"male",422,240,142,281,111,0,41,281,70
1734971,113,27,1900,5,"female",2307,88,48,1,0,0,0,1,0
1735012,16,19,1997,6,"male",739,13,10,36,2,26,0,10,2
1735021,54,6,1959,5,"male",366,1,1,0,0,0,0,0,0
1735038,31,13,1982,12,"male",612,200,6,0,31,0,16,0,15
1735056,106,15,1907,6,"male",1184,214,152,92,98,85,73,7,25
1735063,18,3,1995,3,"female",175,343,297,61,66,61,65,0,1
1735071,63,1,1950,1,"female",556,9,1,7,17,0,0,7,17
1735074,22,25,1991,3,"male",658,127,73,0,2,0,2,0,0
1735082,19,1,1994,4,"male",403,165,48,34,22,0,4,34,18
1735086,47,8,1966,2,"male",304,42,26,7,6,7,2,0,4
1735091,20,15,1993,5,"male",696,168,108,0,5,0,2,0,3
1735149,29,29,1984,11,"female",265,6,1,0,0,0,0,0,0
1735172,51,4,1962,10,"female",72,10,6,6,5,6,1,0,4
1735248,25,1,1988,10,"female",205,18,10,83,41,82,21,1,20
1735271,19,6,1994,12,"female",1222,142,119,189,208,105,157,84,51
1735281,19,1,1994,1,"male",353,276,242,0,0,0,0,0,0
1735371,19,12,1994,12,"female",12,13,13,1,1,1,1,0,0
1735406,18,25,1995,6,"male",60,4,3,24,0,24,0,0,0
1735409,15,14,1998,1,"male",379,381,351,10,0,0,0,10,0
1735417,24,7,1989,1,"male",75,48,42,0,0,0,0,0,0
1735424,43,14,1970,11,"male",368,156,119,83,10,0,2,83,8
1735429,30,23,1983,2,"male",110,35,19,300,26,300,26,0,0
1735443,60,28,1953,6,"female",538,69,31,39,30,5,15,34,15
1735457,17,26,1996,8,"male",36,37,30,19,55,19,55,0,0
1735494,107,19,1906,6,"female",7,38,31,0,0,0,0,0,0
1735498,29,20,1984,4,"male",185,0,0,0,0,0,0,0,0
1735502,103,9,1910,2,"female",806,362,82,586,826,576,462,10,364
1735546,21,8,1992,6,"male",360,216,168,148,12,0,4,148,8
1735572,108,24,1905,12,"male",286,182,151,0,0,0,0,0,0
1735615,46,27,1967,3,"female",106,37,29,61,149,61,134,0,15
1735619,108,29,1905,1,"female",1234,1261,544,57,24,57,18,0,6
1735637,41,6,1972,9,"female",1497,315,203,891,710,674,443,217,267
1735656,36,22,1977,9,"male",618,461,70,1,0,1,0,0,0
1735679,43,29,1970,6,"female",1263,240,100,164,220,48,65,116,155
1735685,19,29,1994,11,"female",513,882,759,16,36,16,22,0,14
1735688,22,2,1991,5,"female",465,100,78,7,1,7,0,0,1
1735709,54,5,1959,1,"female",309,73,54,37,0,37,0,0,0
1735731,22,14,1991,10,"male",587,108,84,1,0,1,0,0,0
1735748,37,1,1976,1,"male",308,61,53,2189,142,1296,123,893,19
1735751,43,25,1970,3,"female",1642,38,11,0,0,0,0,0,0
1735778,35,24,1978,7,"male",385,37,20,0,0,0,0,0,0
1735783,30,11,1983,7,"female",419,389,325,657,175,650,86,7,89
1735807,67,28,1946,4,"female",397,95,72,521,114,269,46,252,68
1735822,100,27,1913,2,"male",320,169,118,47,31,47,13,0,18
1735858,21,9,1992,5,"female",353,285,208,12,15,12,9,0,6
1735870,59,12,1954,5,"female",1027,154,89,627,42,398,26,229,16
1735881,36,4,1977,5,"male",532,69,59,3,0,2,0,1,0
1735886,16,14,1997,5,"male",758,714,249,222,938,52,463,170,475
1735899,27,15,1986,4,"male",454,121,52,3,13,3,13,0,0
1735917,17,25,1996,3,"male",868,450,301,6,7,6,5,0,2
1735941,32,7,1981,11,"female",136,94,18,33,100,33,89,0,11
1735951,27,11,1986,10,"male",155,29,18,30,22,30,10,0,12
1735968,45,13,1968,1,"male",453,0,0,1,0,0,0,1,0
1735974,22,22,1991,10,"male",614,333,80,5,8,5,8,0,0
1735984,22,13,1991,6,"male",541,213,182,7,30,7,29,0,1
1736025,20,18,1993,8,"female",580,243,135,26,21,26,20,0,1
1736034,13,14,2000,1,"female",530,206,183,118,13,4,4,114,9
1736051,40,21,1973,12,"male",1195,29,10,0,0,0,0,0,0
1736085,53,15,1960,9,"male",957,154,136,12,268,0,6,12,262
1736092,21,5,1992,3,"female",242,61,41,6,3,5,3,1,0
1736095,52,9,1961,8,"male",668,289,261,82,86,6,34,76,52
1736097,19,30,1994,6,"female",259,62,25,209,0,208,0,1,0
1736109,53,7,1960,8,"male",1638,179,70,5,10,5,2,0,8
1736139,20,8,1993,7,"female",605,48,31,481,1170,258,419,223,751
1736166,63,17,1950,8,"female",250,57,22,22,0,22,0,0,0
1736170,48,20,1965,1,"female",433,91,42,59,314,59,285,0,29
1736183,16,7,1997,10,"male",514,489,403,15,13,15,9,0,4
1736189,19,5,1994,1,"female",519,722,376,151,509,64,210,87,299
1736193,47,15,1966,11,"female",1140,183,135,104,103,104,76,0,27
1736201,15,1,1998,5,"male",7,4,2,1,0,1,0,0,0
1736203,20,23,1993,5,"male",606,26,4,2,0,2,0,0,0
1736209,30,30,1983,5,"female",451,70,15,1,9,1,6,0,3
1736225,22,17,1991,8,"female",541,259,107,133,177,127,72,6,105
1736244,28,1,1985,2,"male",639,140,117,0,0,0,0,0,0
1736249,23,31,1990,10,"female",85,65,53,1,7,1,4,0,3
1736259,35,1,1978,1,"female",708,360,211,787,340,201,167,586,173
1736263,50,25,1963,8,"female",558,1,1,0,0,0,0,0,0
1736275,20,3,1993,1,"male",416,96,50,0,0,0,0,0,0
1736283,57,6,1956,6,"male",43,9,8,0,0,0,0,0,0
1736290,23,11,1990,6,"male",703,161,102,0,1,0,1,0,0
1736293,28,19,1985,12,"female",182,31,19,24,13,24,11,0,2
1736296,20,12,1993,2,"female",354,699,140,74,241,74,99,0,142
1736305,26,1,1987,1,"male",68,39,34,2,6,2,4,0,2
1736311,25,1,1988,1,"male",201,2,0,0,0,0,0,0,0
1736366,19,22,1994,8,"female",166,2,0,4,1,3,1,1,0
1736387,24,23,1989,1,"male",607,125,74,6,45,6,36,0,9
1736451,49,26,1964,6,"female",541,29,13,1,1,1,0,0,1
1736468,87,8,1926,2,"male",275,46,26,3,25,3,22,0,3
1736475,73,15,1940,5,"male",1397,176,76,2,5,0,2,2,3
1736499,101,30,1912,8,"female",2370,213,108,47,139,0,56,47,83
1736519,67,8,1946,8,"female",1467,41,20,25,9,0,4,25,5
1736520,108,1,1905,1,"male",157,2,2,14,4,2,4,12,0
1736531,25,1,1988,5,"male",40,104,101,4,4,4,4,0,0
1736551,28,16,1985,1,"male",733,277,180,6,9,6,3,0,6
1736555,69,3,1944,11,"female",1540,9,5,10,1,0,1,10,0
1736611,25,1,1988,1,"male",128,21,18,1,0,1,0,0,0
1736635,29,3,1984,2,"male",330,7,0,0,0,0,0,0,0
1736644,19,24,1994,2,"female",402,158,123,13,21,7,11,6,10
1736659,59,1,1954,5,"male",1546,26,4,1,4,1,4,0,0
1736703,26,28,1987,6,"female",674,388,190,0,1,0,0,0,1
1736715,97,26,1916,9,"female",1489,382,156,272,82,272,45,0,37
1736727,23,12,1990,7,"male",431,44,33,0,2,0,2,0,0
1736765,52,6,1961,12,"male",698,124,70,10,10,10,6,0,4
1736769,16,20,1997,6,"male",239,110,84,0,9,0,4,0,5
1736788,26,6,1987,8,"male",774,37,30,0,0,0,0,0,0
1736795,48,29,1965,4,"female",177,137,44,9,41,5,14,4,27
1736798,14,1,1999,1,"female",97,69,25,42,90,42,52,0,38
1736801,20,24,1993,6,"male",157,37,27,1,1,1,1,0,0
1736817,16,18,1997,1,"male",34,56,52,77,13,77,10,0,3
1736833,18,13,1995,12,"male",25,0,0,0,0,0,0,0,0
1736848,22,16,1991,6,"male",661,107,40,28,16,1,6,27,10
1736883,22,8,1991,3,"female",1039,495,123,486,659,486,478,0,181
1736884,74,20,1939,8,"male",1640,92,65,34,12,34,10,0,2
1736896,60,27,1953,1,"female",2276,38,27,18,1,18,0,0,1
1736940,63,19,1950,9,"male",519,193,17,4,0,0,0,4,0
1736953,70,1,1943,7,"female",313,20,14,7,3,0,3,7,0
1736978,47,27,1966,6,"male",1782,74,10,4,1,4,1,0,0
1737000,31,6,1982,4,"female",246,32,15,7,47,7,38,0,9
1737015,25,12,1988,4,"male",460,96,76,96,45,69,33,27,12
1737029,19,5,1994,11,"male",374,141,119,6,2,0,0,6,2
1737056,25,1,1988,2,"female",148,1,1,7,1,7,1,0,0
1737063,36,3,1977,4,"male",242,23,17,0,0,0,0,0,0
1737079,54,21,1959,2,"male",214,12,8,11,6,0,2,11,4
1737084,32,5,1981,12,"female",228,18,13,18,1,18,1,0,0
1737089,41,10,1972,9,"male",1417,697,426,33,35,26,4,7,31
1737116,29,6,1984,10,"male",594,295,164,3,5,3,2,0,3
1737159,21,2,1992,8,"female",284,620,327,127,298,83,198,44,100
1737161,27,24,1986,7,"male",133,26,22,3,0,3,0,0,0
1737185,24,30,1989,8,"female",228,4,2,0,0,0,0,0,0
1737197,74,13,1939,5,"male",1011,61,34,1,5,0,4,1,1
1737235,69,26,1944,5,"female",314,63,49,694,147,694,126,0,21
1737237,25,11,1988,4,"female",512,14,10,43,101,43,73,0,28
1737239,25,5,1988,12,"male",609,296,202,33,87,32,28,1,59
1737252,19,15,1994,10,"male",684,84,46,0,0,0,0,0,0
1737288,29,21,1984,12,"female",577,217,160,404,230,327,156,77,74
1737307,26,5,1987,11,"male",187,220,187,1968,726,1968,694,0,32
1737336,24,24,1989,3,"male",455,738,713,11,1,11,1,0,0
1737359,20,5,1993,1,"male",385,175,86,21,1,4,0,17,1
1737367,45,17,1968,9,"female",659,133,51,998,756,961,304,37,452
1737372,27,17,1986,8,"male",173,66,51,421,51,420,50,1,1
1737378,19,1,1994,4,"male",285,19,13,0,0,0,0,0,0
1737387,72,18,1941,6,"female",1305,341,232,536,167,0,53,536,114
1737397,15,27,1998,8,"male",158,57,31,10,8,10,8,0,0
1737405,23,3,1990,2,"male",1100,14,8,3743,123,2673,48,1070,75
1737427,57,17,1956,4,"female",822,78,30,1,0,0,0,1,0
1737445,33,14,1980,8,"male",448,365,348,16,1,10,0,6,1
1737470,22,24,1991,4,"male",285,41,29,0,14,0,4,0,10
1737477,94,23,1919,12,"male",1716,528,386,22,11,19,4,3,7
1737483,53,26,1960,12,"female",263,104,84,122,15,0,4,122,11
1737496,16,5,1997,8,"male",53,0,0,0,0,0,0,0,0
1737519,30,15,1983,10,"male",355,230,154,25,15,25,15,0,0
1737520,59,16,1954,2,"female",786,53,33,158,58,158,15,0,43
1737532,67,1,1946,2,"male",233,396,283,1,4,0,1,1,3
1737546,27,30,1986,6,"male",362,65,54,317,56,317,52,0,4
1737557,66,5,1947,6,"male",131,0,0,0,0,0,0,0,0
1737576,70,1,1943,10,"female",1518,85,41,11,5,11,5,0,0
1737611,17,24,1996,9,"male",585,72,58,5,1,2,1,3,0
1737629,25,1,1988,1,"male",299,66,31,18,34,18,34,0,0
1737656,16,2,1997,3,"male",174,230,141,0,2,0,1,0,1
1737665,37,27,1976,12,"male",428,1,1,37,0,37,0,0,0
1737676,20,30,1993,4,"male",233,1,0,0,0,0,0,0,0
1737688,76,4,1937,12,"female",478,149,12,9,12,9,11,0,1
1737716,14,10,1999,11,"male",181,66,42,0,0,0,0,0,0
1737723,16,29,1997,6,"male",438,2052,1046,1043,588,241,208,802,380
1737731,44,10,1969,11,"male",317,1,1,0,0,0,0,0,0
1737736,30,12,1983,1,"female",526,257,27,2,9,2,5,0,4
1737785,57,6,1956,12,"female",9,1,1,1,0,0,0,1,0
1737810,35,16,1978,7,"male",855,36,9,0,1,0,1,0,0
1737818,16,29,1997,11,"male",623,871,578,5490,2468,5487,1853,3,615
1737825,59,30,1954,7,"female",464,7,5,0,1,0,0,0,1
1737828,45,6,1968,7,"female",1729,290,166,223,255,223,129,0,126
1737848,32,8,1981,3,"female",108,103,87,240,351,240,136,0,215
1737856,18,12,1995,5,"female",309,521,313,3968,1725,3953,1405,15,320
1737864,42,17,1971,5,"female",559,55,19,880,521,880,367,0,154
1737869,23,15,1990,7,"male",394,540,485,12,0,12,0,0,0
1737872,42,4,1971,4,"male",986,38,21,43,19,35,19,8,0
1737875,14,2,1999,5,"female",135,104,54,25,14,24,6,1,8
1737910,48,17,1965,6,"male",368,67,46,0,3,0,0,0,3
1737913,30,11,1983,3,"male",309,145,71,26,7,26,7,0,0
1737985,33,15,1980,6,"male",200,22,14,70,11,70,11,0,0
1738053,23,3,1990,3,"female",355,63,44,46,56,29,21,17,35
1738109,47,4,1966,10,"female",187,126,95,1041,102,1040,61,1,41
1738144,18,11,1995,12,"male",583,314,208,35,18,35,14,0,4
1738150,50,19,1963,5,"female",1757,411,246,424,478,279,336,145,142
1738162,23,12,1990,6,"male",333,314,110,0,1,0,1,0,0
1738185,94,7,1919,3,"female",1299,72,25,6,8,0,1,6,7
1738189,38,30,1975,11,"male",191,244,224,0,0,0,0,0,0
1738196,14,17,1999,3,"male",545,852,596,952,646,267,236,685,410
1738199,27,8,1986,10,"male",139,99,74,39,2,33,1,6,1
1738204,18,12,1995,8,"female",217,205,30,22,31,22,31,0,0
1738230,59,12,1954,7,"male",427,170,39,0,0,0,0,0,0
1738245,37,5,1976,9,"male",440,185,159,2,1,2,1,0,0
1738253,82,6,1931,9,NA,2016,178,133,399,109,33,75,366,34
1738273,23,28,1990,12,"female",75,42,41,36,12,36,12,0,0
1738304,22,29,1991,10,"male",265,99,76,52,5,0,0,52,5
1738306,19,30,1994,6,"male",131,231,208,0,3,0,3,0,0
1738320,26,17,1987,3,"female",366,39,20,0,0,0,0,0,0
1738340,27,9,1986,9,"male",130,36,25,17,10,6,3,11,7
1738385,16,23,1997,6,"female",137,551,467,56,137,55,99,1,38
1738430,44,18,1969,10,"female",1681,176,26,1254,989,628,475,626,514
1738438,64,16,1949,4,"male",507,123,81,513,96,485,60,28,36
1738468,43,25,1970,12,"male",531,6,3,0,0,0,0,0,0
1738481,30,15,1983,6,"male",392,77,67,4,2,4,2,0,0
1738507,58,4,1955,9,"female",326,5,1,0,0,0,0,0,0
1738508,21,16,1992,7,"female",592,146,66,134,94,134,27,0,67
1738511,93,16,1920,11,"female",1098,258,174,303,132,0,28,303,104
1738520,68,25,1945,12,"male",350,1090,591,1580,1553,122,816,1458,737
1738525,58,9,1955,6,"female",713,7,5,6,0,6,0,0,0
1738592,39,17,1974,8,"female",163,4,4,72,2,65,1,7,1
1738595,14,19,1999,2,"male",227,0,0,0,0,0,0,0,0
1738611,25,30,1988,12,"male",433,265,184,29,28,29,28,0,0
1738616,38,26,1975,2,"male",538,115,62,45,151,23,61,22,90
1738623,67,25,1946,6,"male",435,0,0,1,0,1,0,0,0
1738634,27,20,1986,10,"male",516,132,38,43,21,0,4,43,17
1738677,25,1,1988,1,"male",374,0,0,0,0,0,0,0,0
1738678,15,21,1998,1,"male",640,282,147,7,0,0,0,7,0
1738687,33,9,1980,3,"female",1535,228,73,123,179,113,58,10,121
1738688,20,19,1993,7,"male",582,47,19,0,7,0,5,0,2
1738696,19,18,1994,5,"male",279,392,212,4,21,1,14,3,7
1738697,14,1,1999,10,"female",282,518,291,2164,1702,0,746,2164,956
1738708,103,11,1910,3,"female",1876,377,132,23,17,1,11,22,6
1738733,18,28,1995,9,"male",395,476,218,36,116,25,63,11,53
1738741,16,20,1997,7,"male",460,1467,998,2241,302,2241,172,0,130
1738744,26,2,1987,5,"male",289,286,220,85,37,69,26,16,11
1738746,71,23,1942,9,"female",1661,339,153,1,19,1,15,0,4
1738763,29,1,1984,1,"male",143,30,25,14,8,14,8,0,0
1738764,21,26,1992,7,"female",599,82,68,5,26,5,24,0,2
1738765,51,19,1962,1,"male",519,123,107,90,34,0,4,90,30
1738772,25,17,1988,2,"male",1256,255,138,32,3,18,3,14,0
1738780,24,3,1989,2,"male",486,356,244,6,14,0,4,6,10
1738801,19,14,1994,4,"female",297,177,23,0,0,0,0,0,0
1738812,37,18,1976,11,"male",518,19,6,0,1,0,1,0,0
1738817,15,9,1998,6,"female",241,70,24,13,13,13,5,0,8
1738819,22,3,1991,6,"male",1277,35,19,0,0,0,0,0,0
1738842,22,5,1991,12,"male",355,19,13,0,0,0,0,0,0
1738846,52,20,1961,2,"female",612,15,7,2,0,2,0,0,0
1738849,23,9,1990,7,"female",718,203,38,52,27,52,13,0,14
1738854,60,4,1953,11,"male",2051,97,20,72,162,1,76,71,86
1738873,69,31,1944,1,"male",1186,73,42,0,0,0,0,0,0
1738882,16,12,1997,1,"male",122,267,224,827,131,65,97,762,34
1738884,17,1,1996,1,"male",412,348,289,0,0,0,0,0,0
1738887,58,18,1955,6,"male",216,14,12,0,0,0,0,0,0
1738901,44,22,1969,12,"male",626,34,21,4,2,4,1,0,1
1738913,14,29,1999,3,"female",647,894,654,100,61,96,43,4,18
1738922,18,3,1995,8,"female",360,450,227,3,11,3,9,0,2
1738934,19,18,1994,2,"male",272,26,20,9,25,9,23,0,2
1738940,20,1,1993,6,"male",298,261,162,51,65,22,34,29,31
1738971,17,6,1996,2,"female",18,12,11,0,0,0,0,0,0
1738987,24,9,1989,9,"male",138,12,10,0,1,0,1,0,0
1739041,21,9,1992,7,"male",472,739,367,360,115,360,99,0,16
1739046,113,14,1900,2,"female",1873,561,281,11,10,11,5,0,5
1739051,27,15,1986,2,"male",525,95,46,10,14,10,3,0,11
1739078,30,1,1983,1,"male",112,55,26,2,3,2,3,0,0
1739091,30,28,1983,12,"male",389,85,39,0,0,0,0,0,0
1739107,28,10,1985,4,"male",1177,225,197,0,121,0,102,0,19
1739108,17,15,1996,1,"male",364,4,2,0,0,0,0,0,0
1739113,17,13,1996,6,"female",117,197,149,183,115,133,107,50,8
1739151,44,12,1969,11,"female",493,53,18,4,6,3,6,1,0
1739153,33,18,1980,10,"female",442,21,16,53,22,53,22,0,0
1739167,58,6,1955,9,"female",39,27,26,1,0,1,0,0,0
1739198,20,13,1993,6,"female",274,22,1,0,0,0,0,0,0
1739212,14,8,1999,9,"female",73,245,138,69,104,14,40,55,64
1739217,19,23,1994,7,"female",659,75,49,37,116,37,98,0,18
1739219,19,24,1994,12,"male",348,200,188,2,0,2,0,0,0
1739227,55,7,1958,3,"female",385,52,40,1,12,0,9,1,3
1739248,31,24,1982,4,"female",95,48,30,4,2,4,1,0,1
1739251,93,17,1920,4,"male",919,54,19,188,61,188,40,0,21
1739264,24,18,1989,10,"female",252,348,220,930,1338,930,1148,0,190
1739337,29,17,1984,12,"female",603,213,65,0,0,0,0,0,0
1739338,17,25,1996,8,"male",88,37,35,0,0,0,0,0,0
1739358,34,23,1979,11,"female",734,879,513,47,48,32,25,15,23
1739373,25,24,1988,9,"female",524,126,36,14,44,14,44,0,0
1739422,27,2,1986,7,"female",143,318,291,346,508,278,267,68,241
1739446,108,15,1905,9,"female",1663,422,154,108,75,48,26,60,49
1739457,36,29,1977,6,"female",696,97,45,41,24,29,3,12,21
1739473,50,31,1963,5,"female",1279,17,8,2,3,0,3,2,0
1739474,14,26,1999,5,"male",151,181,153,0,1,0,1,0,0
1739510,19,3,1994,4,"male",569,1811,1511,319,214,319,192,0,22
1739520,103,19,1910,8,"male",1301,356,244,126,186,114,118,12,68
1739562,15,20,1998,7,"female",349,76,20,9,0,0,0,9,0
1739583,48,11,1965,11,"female",703,252,121,146,450,70,144,76,306
1739601,32,9,1981,6,"male",471,64,22,263,68,0,22,263,46
1739602,52,14,1961,10,"male",866,4,0,0,0,0,0,0,0
1739616,35,17,1978,5,"female",474,69,50,3,1,3,1,0,0
1739658,37,19,1976,1,"male",346,193,139,3,22,1,15,2,7
1739659,39,15,1974,11,"female",644,169,136,184,140,95,104,89,36
1739671,18,8,1995,8,"female",211,129,100,656,97,568,67,88,30
1739691,44,15,1969,1,"male",464,58,37,299,142,299,117,0,25
1739709,26,15,1987,1,"female",883,406,265,8,0,8,0,0,0
1739714,29,11,1984,1,"female",463,190,91,112,204,112,81,0,123
1739727,29,15,1984,3,"male",1144,496,376,0,35,0,24,0,11
1739733,28,24,1985,7,"female",661,34,26,244,39,244,33,0,6
1739741,113,9,1900,8,"male",1458,519,118,12,34,3,22,9,12
1739748,17,28,1996,8,"female",290,96,66,40,34,13,14,27,20
1739749,25,5,1988,3,"male",269,85,63,98,24,98,14,0,10
1739786,19,4,1994,9,"male",427,140,115,5,2,5,2,0,0
1739796,65,14,1948,7,"female",214,37,33,25,3,24,2,1,1
1739827,20,12,1993,2,"male",460,109,59,1,1,1,0,0,1
1739847,35,29,1978,9,"male",572,19,14,29,15,29,12,0,3
1739848,17,9,1996,7,"female",367,42,29,3,1,0,0,3,1
1739866,20,27,1993,4,"male",434,340,217,35,29,35,27,0,2
1739869,53,10,1960,1,"female",366,231,148,2,4,2,3,0,1
1739879,26,1,1987,1,"male",1402,655,344,43,18,43,17,0,1
1739913,20,3,1993,4,"male",389,38,26,10,5,9,4,1,1
1739920,40,21,1973,9,"male",335,85,80,1,1,1,1,0,0
1739926,25,5,1988,8,"male",387,52,4,1,13,1,7,0,6
1739930,16,12,1997,1,"female",369,194,118,99,47,99,45,0,2
1739933,18,3,1995,8,"male",410,88,75,0,12,0,3,0,9
1739936,23,27,1990,7,"male",1242,362,310,9,0,9,0,0,0
1739944,28,10,1985,9,"male",474,36,25,0,0,0,0,0,0
1739945,63,9,1950,7,"male",156,54,18,5,23,5,12,0,11
1739953,24,4,1989,9,"male",930,111,68,4,1,4,1,0,0
1739971,23,19,1990,12,"male",33,1,0,0,0,0,0,0,0
1739975,59,6,1954,8,"female",2206,274,96,566,146,556,95,10,51
1739981,29,10,1984,9,"male",412,110,72,4,2,0,2,4,0
1739985,32,14,1981,3,"male",297,47,41,0,2,0,2,0,0
1740016,42,10,1971,1,"female",567,88,48,8,1,8,0,0,1
1740050,25,24,1988,2,"male",346,59,25,9,5,6,2,3,3
1740056,25,11,1988,8,"male",667,3820,2836,835,377,107,106,728,271
1740076,28,16,1985,3,"male",272,420,368,194,566,194,460,0,106
1740085,26,6,1987,8,"male",312,46,35,2,8,0,7,2,1
1740123,34,25,1979,10,"female",728,125,72,417,141,376,96,41,45
1740126,41,10,1972,1,"male",232,9,9,6,0,0,0,6,0
1740163,28,10,1985,7,"male",495,121,98,9,3,1,3,8,0
1740170,49,23,1964,5,"male",548,103,68,8,46,8,27,0,19
1740171,71,1,1942,12,"female",487,70,41,74,26,0,15,74,11
1740199,19,21,1994,9,"female",390,310,228,146,63,53,18,93,45
1740213,39,7,1974,4,"male",383,329,283,1,0,0,0,1,0
1740221,16,7,1997,10,"female",391,130,59,95,76,71,46,24,30
1740228,17,30,1996,7,"male",461,343,285,3,51,3,46,0,5
1740246,18,18,1995,11,"male",734,201,159,0,2,0,2,0,0
1740252,22,8,1991,9,"female",938,1518,987,62,48,62,45,0,3
1740257,18,18,1995,3,"male",631,512,344,61,253,28,101,33,152
1740310,15,16,1998,2,"female",97,7,5,0,0,0,0,0,0
1740313,38,12,1975,2,"male",795,0,0,0,0,0,0,0,0
1740342,51,12,1962,2,"female",452,62,25,23,7,23,7,0,0
1740364,29,13,1984,7,"male",182,83,76,5,1,0,0,5,1
1740386,19,16,1994,2,"male",548,159,105,0,8,0,2,0,6
1740405,15,1,1998,7,"female",133,647,165,3,44,3,21,0,23
1740406,40,25,1973,12,"male",297,172,82,7,16,7,13,0,3
1740420,57,28,1956,7,"female",771,117,24,132,73,81,28,51,45
1740432,29,20,1984,7,"female",740,256,198,139,135,139,103,0,32
1740469,56,19,1957,12,"male",1036,15,3,4,0,0,0,4,0
1740501,13,21,2000,6,"male",198,102,79,95,41,95,26,0,15
1740522,68,20,1945,7,"female",848,62,26,1,7,0,4,1,3
1740584,46,24,1967,1,"female",857,134,37,225,21,116,10,109,11
1740589,43,11,1970,11,"female",493,224,105,106,120,3,31,103,89
1740595,113,30,1900,8,"female",1678,208,95,196,28,181,15,15,13
1740596,23,25,1990,1,"female",1050,3504,1598,43,206,43,117,0,89
1740636,32,27,1981,7,"female",236,64,48,0,0,0,0,0,0
1740692,74,6,1939,2,"female",232,7,6,13,4,8,2,5,2
1740708,59,5,1954,4,"male",2,3,1,0,0,0,0,0,0
1740741,18,1,1995,2,"male",46,10,4,0,1,0,0,0,1
1740754,23,26,1990,4,"female",365,212,168,8,4,8,2,0,2
1740781,20,10,1993,9,"female",670,231,158,0,1,0,0,0,1
1740799,27,19,1986,3,"female",430,227,76,377,273,94,150,283,123
1740808,39,10,1974,3,"female",272,57,40,115,4,115,4,0,0
1740834,60,25,1953,5,"male",640,326,283,1270,28,1270,24,0,4
1740865,47,21,1966,6,"female",384,2,2,5,1,0,0,5,1
1740881,103,21,1910,10,"male",550,238,108,1,0,1,0,0,0
1740882,26,8,1987,12,"male",258,61,53,1,0,1,0,0,0
1740893,27,10,1986,7,"male",147,33,29,7,1,0,0,7,1
1740924,28,20,1985,3,"male",401,131,91,3,41,3,27,0,14
1740931,37,6,1976,11,"female",428,311,108,139,700,139,442,0,258
1740947,44,28,1969,7,"male",1145,204,39,124,457,76,225,48,232
1740956,56,6,1957,2,"female",206,13,7,1,39,1,36,0,3
1740962,34,6,1979,6,"male",297,4,3,0,0,0,0,0,0
1740977,36,20,1977,9,"female",785,200,20,1,0,1,0,0,0
1741048,54,31,1959,8,"female",98,15,2,145,12,145,6,0,6
1741066,23,1,1990,1,"female",491,363,272,130,88,64,64,66,24
1741068,60,19,1953,7,"female",170,18,17,119,4,0,0,119,4
1741089,108,1,1905,1,"male",1694,465,266,20,70,0,54,20,16
1741091,48,26,1965,2,"male",280,41,20,3,5,3,5,0,0
1741107,33,3,1980,7,"female",1726,27,20,5,14,5,9,0,5
1741140,23,17,1990,8,"male",264,330,292,2,2,2,2,0,0
1741162,21,21,1992,6,"male",195,153,141,44,61,44,46,0,15
1741179,23,15,1990,12,"male",387,44,11,0,2,0,0,0,2
1741181,16,2,1997,2,"male",52,91,80,21,0,21,0,0,0
1741184,103,11,1910,9,"male",1373,704,372,165,349,5,69,160,280
1741214,69,6,1944,6,"male",292,425,75,885,1142,124,558,761,584
1741224,35,7,1978,8,"male",258,46,39,81,11,81,9,0,2
1741262,22,15,1991,5,"male",889,465,304,1099,206,185,47,914,159
1741263,14,7,1999,6,"male",112,175,144,4,2,4,2,0,0
1741294,23,27,1990,8,"female",388,159,95,141,314,74,106,67,208
1741297,22,10,1991,4,"female",621,1,1,1,0,1,0,0,0
1741370,34,20,1979,6,"female",564,200,76,27,8,24,6,3,2
1741371,31,1,1982,11,"male",118,15,14,0,0,0,0,0,0
1741381,32,28,1981,4,"male",328,59,12,21,3,21,2,0,1
1741397,75,17,1938,5,"female",452,19,16,60,1,0,1,60,0
1741409,30,23,1983,5,"female",400,83,68,147,162,85,65,62,97
1741435,39,12,1974,5,"male",742,228,170,2,61,1,19,1,42
1741461,64,25,1949,11,"female",68,3,0,0,0,0,0,0,0
1741480,74,14,1939,8,"male",476,76,49,28,9,28,1,0,8
1741511,33,1,1980,1,"male",405,15,3,0,0,0,0,0,0
1741520,28,18,1985,11,"male",614,244,119,7,49,7,17,0,32
1741527,26,20,1987,1,"female",431,50,22,127,127,118,40,9,87
1741535,19,1,1994,1,"female",111,95,34,14,72,3,55,11,17
1741558,23,2,1990,3,"male",512,111,83,0,0,0,0,0,0
1741561,27,4,1986,3,"male",1249,241,179,59,41,59,24,0,17
1741566,108,6,1905,4,"male",1187,398,199,771,381,85,279,686,102
1741577,78,14,1935,8,"male",2182,41,18,4,6,0,4,4,2
1741623,25,16,1988,5,"female",158,23,20,148,240,148,199,0,41
1741646,26,3,1987,1,"male",655,182,106,13,78,13,46,0,32
1741648,48,12,1965,9,"female",975,54,15,80,28,77,11,3,17
1741687,65,15,1948,11,"male",322,26,22,1,0,0,0,1,0
1741756,18,29,1995,10,"male",503,245,206,394,7,330,6,64,1
1741766,21,7,1992,10,"female",302,36,11,70,48,47,34,23,14
1741769,21,18,1992,5,"male",434,216,150,62,18,62,16,0,2
1741813,40,6,1973,2,"male",12,1,1,0,0,0,0,0,0
1741828,33,10,1980,6,"female",672,19,12,22,33,22,32,0,1
1741843,26,16,1987,1,"female",869,100,81,14,18,0,7,14,11
1741869,59,16,1954,2,"female",2049,170,96,889,545,794,367,95,178
1741885,21,27,1992,4,"female",318,68,53,12,1,7,0,5,1
1741920,23,19,1990,9,"female",453,171,98,46,93,39,56,7,37
1741931,21,27,1992,1,"female",245,1,1,0,0,0,0,0,0
1741946,18,8,1995,2,"male",272,65,53,0,17,0,12,0,5
1741969,51,3,1962,7,"male",674,73,35,71,74,71,43,0,31
1741974,25,24,1988,3,"male",646,98,81,0,6,0,6,0,0
1741988,24,13,1989,8,"female",603,392,175,469,608,469,262,0,346
1742005,21,24,1992,1,"male",631,472,305,53,4,51,2,2,2
1742015,19,13,1994,11,"male",490,1302,1033,162,220,162,152,0,68
1742020,15,29,1998,8,"female",198,78,14,38,1,38,1,0,0
1742037,47,9,1966,5,"female",1549,148,51,2084,1123,1771,591,313,532
1742043,45,4,1968,8,"male",127,37,26,3,6,1,1,2,5
1742052,24,14,1989,9,"male",315,68,23,41,90,37,28,4,62
1742074,51,27,1962,9,"male",1416,170,145,775,302,775,253,0,49
1742084,56,15,1957,8,"female",1596,146,65,11,7,5,2,6,5
1742093,18,8,1995,9,"male",567,66,51,28,40,23,35,5,5
1742126,20,14,1993,3,"female",762,165,101,15,2,14,1,1,1
1742128,21,13,1992,1,"male",472,34,19,0,2,0,2,0,0
1742153,23,16,1990,12,"male",149,50,40,10,0,10,0,0,0
1742179,78,15,1935,10,"female",612,84,28,18,5,0,2,18,3
1742188,22,17,1991,11,"male",416,204,76,4,19,4,18,0,1
1742195,18,15,1995,1,"male",659,358,265,3,9,3,7,0,2
1742217,16,29,1997,12,"male",392,274,271,0,7,0,7,0,0
1742223,41,15,1972,5,"female",450,20,15,18,22,18,17,0,5
1742244,20,10,1993,2,"female",42,0,0,0,0,0,0,0,0
1742252,34,24,1979,11,"male",151,118,110,138,4,138,0,0,4
1742253,71,16,1942,9,"male",883,169,65,1,1,0,1,1,0
1742271,58,26,1955,5,"male",673,27,9,0,0,0,0,0,0
1742277,34,23,1979,9,"female",510,360,215,578,673,12,484,566,189
1742388,30,10,1983,7,"male",417,40,21,1,0,1,0,0,0
1742391,19,10,1994,4,"male",1287,669,327,8,2,6,0,2,2
1742403,31,5,1982,11,"female",327,165,124,0,12,0,2,0,10
1742408,18,28,1995,2,"male",600,45,22,823,709,4,81,819,628
1742415,27,6,1986,8,"male",352,68,59,0,0,0,0,0,0
1742421,30,17,1983,11,"female",522,78,57,217,55,217,51,0,4
1742438,19,1,1994,12,"female",176,79,61,2,5,2,5,0,0
1742442,20,25,1993,4,"male",742,358,175,15,31,0,8,15,23
1742475,25,13,1988,4,"male",199,0,0,0,0,0,0,0,0
1742505,20,11,1993,8,"female",602,620,155,3,5,3,5,0,0
1742519,21,17,1992,8,"female",169,369,81,460,245,460,160,0,85
1742536,65,27,1948,10,"female",344,94,80,506,15,506,11,0,4
1742559,24,24,1989,3,"male",381,46,19,0,0,0,0,0,0
1742571,61,10,1952,3,"female",1022,186,84,17,37,2,22,15,15
1742600,83,15,1930,9,"female",832,918,574,248,172,146,55,102,117
1742615,18,15,1995,3,"male",160,24,16,20,24,1,2,19,22
1742621,25,2,1988,9,"male",486,177,95,70,48,70,37,0,11
1742677,46,30,1967,5,"male",354,19,5,1,3,1,3,0,0
1742681,14,2,1999,2,"male",530,201,127,0,2,0,2,0,0
1742712,21,3,1992,8,"male",346,208,54,37,79,37,65,0,14
1742720,28,30,1985,10,"male",184,114,87,78,43,74,29,4,14
1742767,53,15,1960,4,"female",460,159,87,148,51,14,7,134,44
1742811,25,1,1988,1,"male",43,2,2,14,0,14,0,0,0
1742814,25,21,1988,1,"male",272,131,98,1,0,1,0,0,0
1742836,21,2,1992,10,"male",617,624,444,38,236,38,175,0,61
1742870,50,4,1963,10,"male",620,4,1,0,0,0,0,0,0
1742871,24,10,1989,5,"male",542,128,77,0,4,0,1,0,3
1742903,21,1,1992,8,"female",842,202,84,191,75,160,60,31,15
1742930,18,1,1995,1,"male",517,369,308,432,291,239,161,193,130
1742942,16,26,1997,2,"male",438,40,26,13,9,13,8,0,1
1742959,94,9,1919,7,"female",622,422,247,62,77,62,71,0,6
1742963,34,31,1979,12,"female",8,3,3,0,0,0,0,0,0
1742973,44,7,1969,5,"male",691,27,10,0,2,0,1,0,1
1742976,22,19,1991,2,"male",649,30,27,7,7,7,7,0,0
1742984,94,20,1919,3,"male",436,115,91,0,6,0,6,0,0
1743002,23,9,1990,2,"male",1072,39,7,5,58,5,25,0,33
1743005,20,20,1993,9,"male",918,889,776,59,50,34,34,25,16
1743013,15,5,1998,2,"male",3,28,27,0,11,0,10,0,1
1743019,38,16,1975,7,"female",432,521,251,100,133,97,104,3,29
1743034,32,21,1981,1,"female",302,49,15,1,7,1,1,0,6
1743074,22,25,1991,8,"male",1,2,2,1,1,1,1,0,0
1743106,31,13,1982,2,"male",415,67,53,165,9,165,5,0,4
1743107,25,1,1988,1,"male",210,1,1,11,1,11,1,0,0
1743158,28,5,1985,1,"female",544,37,23,134,76,128,59,6,17
1743213,15,3,1998,12,"female",660,175,94,10,0,0,0,10,0
1743238,50,13,1963,2,"female",1967,324,211,431,132,431,52,0,80
1743241,78,21,1935,2,"female",611,39,10,0,0,0,0,0,0
1743245,19,6,1994,2,"male",362,79,49,0,0,0,0,0,0
1743257,24,29,1989,3,"male",539,92,79,0,0,0,0,0,0
1743280,20,7,1993,5,"female",751,18,8,0,0,0,0,0,0
1743283,17,14,1996,2,"male",134,94,92,2,56,2,37,0,19
1743292,27,3,1986,3,"male",539,200,86,5,12,0,8,5,4
1743303,33,1,1980,1,"male",408,69,39,8,1,8,0,0,1
1743328,40,21,1973,8,"female",1240,2,2,3,2,3,0,0,2
1743332,25,5,1988,5,"male",442,150,115,1,25,1,2,0,23
1743336,33,7,1980,1,"male",446,233,178,1,8,1,8,0,0
1743365,19,6,1994,8,"male",323,269,199,17,25,5,1,12,24
1743369,21,19,1992,12,"male",244,73,52,167,119,68,91,99,28
1743373,28,4,1985,6,"male",235,55,37,4,1,4,1,0,0
1743377,14,7,1999,7,"male",262,325,282,91,92,74,44,17,48
1743396,17,28,1996,12,"female",248,502,160,2604,409,2604,111,0,298
1743401,37,20,1976,3,"male",890,317,220,549,464,300,74,249,390
1743440,21,14,1992,12,"female",246,76,52,2,64,1,31,1,33
1743454,26,8,1987,3,"male",600,20,6,2,4,0,0,2,4
1743475,21,11,1992,9,"male",302,83,60,1,0,1,0,0,0
1743496,27,20,1986,8,"male",112,100,38,22,24,22,14,0,10
1743498,59,8,1954,1,"male",465,0,0,0,0,0,0,0,0
1743499,18,27,1995,10,"male",243,186,128,0,0,0,0,0,0
1743537,20,12,1993,12,"female",343,218,169,4,19,1,2,3,17
1743549,29,5,1984,7,"male",298,243,202,23,16,23,7,0,9
1743552,18,7,1995,12,"male",71,21,10,10,0,2,0,8,0
1743555,26,22,1987,1,"male",355,84,58,23,2,23,2,0,0
1743563,31,30,1982,9,"female",470,155,34,0,0,0,0,0,0
1743565,20,9,1993,2,"female",386,231,166,177,264,130,117,47,147
1743645,29,21,1984,2,"male",622,151,56,196,6,0,0,196,6
1743657,34,2,1979,7,"male",445,27,23,0,0,0,0,0,0
1743700,26,12,1987,5,"male",1130,5,3,0,13,0,4,0,9
1743708,21,3,1992,2,"female",405,22,11,119,128,116,62,3,66
1743714,39,7,1974,9,"female",618,53,24,84,98,82,91,2,7
1743715,35,9,1978,5,"male",255,39,25,63,38,51,31,12,7
1743720,28,8,1985,10,"male",473,57,26,3,21,3,21,0,0
1743730,23,1,1990,1,"male",404,15,15,3,0,3,0,0,0
1743732,30,14,1983,10,"male",547,442,273,1665,3292,1356,2828,309,464
1743756,21,28,1992,2,"male",262,258,189,0,14,0,14,0,0
1743776,31,31,1982,3,"male",319,64,54,19,6,19,4,0,2
1743779,52,20,1961,9,"male",928,126,75,0,0,0,0,0,0
1743788,29,1,1984,7,"male",117,32,15,0,1,0,1,0,0
1743809,38,21,1975,5,"male",117,56,34,35,1,35,1,0,0
1743814,21,12,1992,12,"male",489,473,318,27,28,27,26,0,2
1743837,16,24,1997,9,"male",200,63,32,0,19,0,13,0,6
1743839,36,23,1977,9,"male",38,40,35,5,0,0,0,5,0
1743845,18,27,1995,3,"male",318,600,464,51,58,47,53,4,5
1743886,55,12,1958,11,"male",160,33,16,211,88,211,61,0,27
1743893,17,24,1996,1,"female",11,146,138,188,37,188,29,0,8
1743948,53,24,1960,9,"male",1360,1169,783,631,1516,319,746,312,770
1743957,23,6,1990,7,"male",71,0,0,0,0,0,0,0,0
1743965,26,24,1987,7,"female",1000,174,91,0,0,0,0,0,0
1743968,41,14,1972,1,"male",292,25,18,2,3,2,3,0,0
1743976,22,4,1991,9,"male",44,18,1,0,0,0,0,0,0
1743987,39,1,1974,1,"male",345,17,16,0,0,0,0,0,0
1744001,17,4,1996,1,"female",92,230,46,60,76,60,67,0,9
1744015,20,9,1993,8,"male",319,11,9,0,0,0,0,0,0
1744067,25,17,1988,1,"female",241,119,74,2,1,2,1,0,0
1744078,35,31,1978,8,"female",1077,113,52,203,88,203,55,0,33
1744091,28,11,1985,8,"female",315,11,8,4,1,0,0,4,1
1744104,54,6,1959,7,"female",313,355,168,328,650,31,202,297,448
1744126,73,28,1940,11,"female",322,5,3,2,4,2,4,0,0
1744132,38,17,1975,10,"male",259,15,15,0,1,0,1,0,0
1744138,18,17,1995,2,"female",97,663,559,54,53,54,47,0,6
1744179,24,7,1989,6,"male",535,80,56,0,6,0,2,0,4
1744204,24,12,1989,12,"female",780,350,157,465,815,353,582,112,233
1744230,24,29,1989,12,"male",493,85,36,23,2,15,2,8,0
1744235,55,17,1958,9,"male",913,146,76,28,11,28,11,0,0
1744244,58,9,1955,12,"male",321,40,35,107,14,107,13,0,1
1744270,29,24,1984,8,"male",510,10,7,0,0,0,0,0,0
1744277,48,8,1965,11,"male",12,87,55,9,6,9,5,0,1
1744285,20,24,1993,1,"male",64,192,177,62,150,55,83,7,67
1744308,29,5,1984,8,"female",299,141,103,78,2,58,2,20,0
1744309,39,19,1974,2,"male",445,13,11,0,0,0,0,0,0
1744310,55,21,1958,2,"male",115,55,34,6,0,6,0,0,0
1744315,69,4,1944,7,"female",898,150,64,209,445,99,107,110,338
1744332,37,6,1976,8,"male",363,140,88,6,117,0,56,6,61
1744360,40,15,1973,10,"female",86,164,142,83,55,82,27,1,28
1744369,24,23,1989,2,"male",431,94,82,3,1,0,1,3,0
1744388,24,15,1989,11,"female",82,125,89,152,95,152,83,0,12
1744395,20,17,1993,11,"male",471,673,590,45,4,45,4,0,0
1744397,29,1,1984,5,"male",516,22,16,18,33,18,20,0,13
1744412,20,20,1993,7,"female",96,22,16,0,0,0,0,0,0
1744415,14,22,1999,5,"female",189,309,66,2,6,2,4,0,2
1744418,28,5,1985,5,"male",307,13,5,12,4,12,3,0,1
1744441,31,20,1982,3,"female",818,90,44,59,47,57,26,2,21
1744446,21,6,1992,5,"male",275,334,275,132,121,0,27,132,94
1744484,37,14,1976,1,"female",907,114,57,24,37,24,27,0,10
1744489,20,12,1993,8,"male",178,20,12,1,0,1,0,0,0
1744513,108,1,1905,7,"male",1417,1252,784,467,95,434,30,33,65
1744526,67,26,1946,9,"male",1415,308,192,6,96,0,18,6,78
1744529,17,28,1996,8,"male",493,780,618,1586,642,1586,431,0,211
1744532,33,11,1980,3,"male",325,45,34,1,1,1,1,0,0
1744542,38,15,1975,8,"female",736,106,56,286,77,286,71,0,6
1744545,93,30,1920,9,"male",858,1243,880,3536,359,1575,94,1961,265
1744580,27,5,1986,5,"female",387,9,5,1,1,0,1,1,0
1744600,76,8,1937,7,"male",1523,138,38,10,14,0,3,10,11
1744609,23,1,1990,1,"male",29,11,10,18,5,18,5,0,0
1744615,35,1,1978,7,"male",533,0,0,0,0,0,0,0,0
1744616,27,7,1986,9,"male",79,32,19,3,1,3,1,0,0
1744642,53,17,1960,6,"female",352,24,20,16,0,0,0,16,0
1744654,15,7,1998,4,"male",35,107,74,677,89,643,52,34,37
1744676,63,1,1950,8,"female",686,80,70,54,29,5,6,49,23
1744679,21,30,1992,10,"male",149,141,127,3,6,3,1,0,5
1744704,18,13,1995,10,"male",138,23,17,1,39,1,32,0,7
1744709,31,5,1982,7,"male",289,18,8,0,0,0,0,0,0
1744723,64,6,1949,10,"female",166,30,9,3,5,3,2,0,3
1744728,30,24,1983,1,"male",208,72,37,1,0,1,0,0,0
1744762,19,1,1994,5,"female",392,262,179,1073,238,1000,124,73,114
1744795,28,1,1985,1,"male",239,38,22,135,27,135,26,0,1
1744811,36,10,1977,12,"female",82,5,4,1,1,0,0,1,1
1744815,14,5,1999,2,"male",7,151,150,3,3,0,1,3,2
1744829,22,6,1991,3,"female",499,64,53,95,92,95,68,0,24
1744843,41,1,1972,1,"male",109,3,3,56,0,0,0,56,0
1744847,73,29,1940,10,"male",565,135,109,235,38,0,17,235,21
1744867,21,2,1992,12,"female",551,918,458,60,110,53,54,7,56
1744882,32,19,1981,8,"male",594,104,87,43,33,43,32,0,1
1744906,30,13,1983,4,"male",299,227,33,7,4,7,3,0,1
1744930,33,22,1980,8,"male",132,0,0,0,0,0,0,0,0
1744968,64,17,1949,9,"male",1060,41,7,5,0,5,0,0,0
1744991,23,19,1990,1,"female",0,0,0,0,0,0,0,0,0
1745020,29,10,1984,1,"male",446,113,69,22,74,8,36,14,38
1745039,29,29,1984,12,"male",664,292,155,3,97,0,62,3,35
1745056,26,24,1987,12,"female",668,28,19,175,111,154,63,21,48
1745066,32,3,1981,7,"female",228,69,25,135,43,135,20,0,23
1745067,20,25,1993,3,"male",323,20,5,0,0,0,0,0,0
1745069,39,28,1974,7,"female",341,116,89,58,72,53,41,5,31
1745135,18,2,1995,2,"male",146,35,30,3,24,1,14,2,10
1745161,21,23,1992,9,"male",129,196,155,3,5,2,1,1,4
1745168,31,24,1982,3,"male",110,17,5,4,0,4,0,0,0
1745185,32,8,1981,7,"male",127,11,9,12,0,12,0,0,0
1745202,28,29,1985,1,"male",83,63,51,5,0,5,0,0,0
1745209,57,29,1956,4,"male",440,45,12,16,18,6,13,10,5
1745234,16,30,1997,12,"female",4,17,5,36,53,36,47,0,6
1745249,108,22,1905,7,"female",1205,551,284,1,2,1,2,0,0
1745277,18,21,1995,11,"male",507,249,100,744,687,594,179,150,508
1745300,30,20,1983,9,"male",375,188,153,1,3,1,1,0,2
1745315,23,17,1990,6,"female",256,154,85,525,301,520,134,5,167
1745318,43,28,1970,11,"male",325,65,52,18,26,1,10,17,16
1745327,53,19,1960,4,"male",281,192,42,0,13,0,4,0,9
1745334,68,22,1945,7,"male",1052,202,135,49,38,40,26,9,12
1745338,21,24,1992,4,"male",188,97,75,0,0,0,0,0,0
1745353,14,28,1999,5,"male",495,16,13,32,5,30,3,2,2
1745403,23,5,1990,6,"male",212,296,188,35,87,26,36,9,51
1745407,41,14,1972,12,"male",543,226,169,67,0,67,0,0,0
1745457,23,8,1990,8,"female",699,40,34,7,18,7,17,0,1
1745461,26,27,1987,2,"male",452,95,11,7,3,7,2,0,1
1745465,70,25,1943,7,"female",1755,44,19,1,7,0,1,1,6
1745482,14,30,1999,4,"male",135,171,109,80,14,79,10,1,4
1745507,58,24,1955,1,"male",445,107,38,293,351,293,148,0,203
1745520,23,15,1990,12,"male",799,287,151,20,13,4,4,16,9
1745528,103,14,1910,5,"male",1400,1202,943,58,49,52,38,6,11
1745553,18,19,1995,5,"male",503,841,338,284,239,183,143,101,96
1745557,21,1,1992,1,"male",394,36,34,3,0,0,0,3,0
1745579,51,22,1962,4,"female",1011,61,23,90,41,90,33,0,8
1745585,33,30,1980,7,"female",69,68,29,1,2,1,1,0,1
1745589,46,28,1967,2,"male",394,137,117,1,0,1,0,0,0
1745594,103,16,1910,1,"female",767,82,78,4,3,4,3,0,0
1745606,18,18,1995,1,"female",285,175,134,11,0,3,0,8,0
1745624,16,1,1997,7,"male",518,129,81,3,1,0,0,3,1
1745625,27,18,1986,2,"female",418,98,54,230,110,230,59,0,51
1745645,108,31,1905,12,"male",441,1416,1278,1506,730,58,375,1448,355
1745649,66,20,1947,11,"female",141,51,40,111,1,111,0,0,1
1745681,49,4,1964,4,"male",974,43,27,3,1,0,1,3,0
1745723,61,27,1952,9,"male",124,98,89,313,0,182,0,131,0
1745754,39,28,1974,8,"male",413,79,50,7,14,5,7,2,7
1745804,18,3,1995,12,"female",271,222,55,505,491,14,253,491,238
1745816,38,26,1975,10,"female",470,17,3,1,0,1,0,0,0
1745824,55,1,1958,9,"female",155,29,25,14,3,14,3,0,0
1745834,20,30,1993,7,"male",233,82,63,1,0,1,0,0,0
1745852,17,23,1996,6,"female",570,2081,710,952,3297,124,1182,828,2115
1745893,34,1,1979,10,"female",397,0,0,1,1,1,1,0,0
1745898,53,14,1960,2,"female",333,101,63,702,312,702,262,0,50
1745918,91,13,1922,9,"male",1401,35,12,542,6,0,2,542,4
1745946,32,19,1981,3,"female",254,131,62,64,30,64,25,0,5
1745973,23,3,1990,12,"female",664,1831,840,1298,549,537,170,761,379
1745978,19,19,1994,1,"male",261,12,9,68,13,0,1,68,12
1746024,34,3,1979,6,"male",159,24,14,2,4,0,0,2,4
1746085,56,19,1957,11,"female",447,154,35,531,121,0,14,531,107
1746134,27,20,1986,4,"male",340,270,189,63,102,63,44,0,58
1746145,15,18,1998,2,"female",385,53,34,6,5,0,4,6,1
1746155,56,2,1957,4,"male",781,3,2,7,0,0,0,7,0
1746163,29,1,1984,1,"female",574,16,15,0,0,0,0,0,0
1746170,24,21,1989,5,"female",373,1,1,0,0,0,0,0,0
1746172,26,14,1987,3,"male",190,24,17,8,0,5,0,3,0
1746173,19,19,1994,3,"male",234,178,111,6,158,6,115,0,43
1746176,20,17,1993,8,"female",467,342,285,54,1,41,1,13,0
1746180,33,1,1980,1,"male",327,72,57,95,17,95,5,0,12
1746186,21,19,1992,2,"male",670,764,609,0,131,0,119,0,12
1746220,57,20,1956,11,"male",496,146,114,670,98,670,45,0,53
1746221,16,27,1997,4,"male",756,35,21,7,13,7,7,0,6
1746243,23,14,1990,9,"male",690,522,395,58,80,58,71,0,9
1746247,21,24,1992,5,"male",549,770,315,2,43,2,38,0,5
1746262,33,11,1980,12,"male",323,13,9,0,0,0,0,0,0
1746270,70,8,1943,4,"female",1609,82,20,6,84,0,45,6,39
1746298,34,16,1979,1,"female",462,36,8,37,13,36,12,1,1
1746305,38,8,1975,12,"male",820,125,77,12,22,0,11,12,11
1746311,29,2,1984,8,"male",115,33,25,220,232,220,157,0,75
1746334,59,11,1954,5,"female",165,49,34,21,17,21,14,0,3
1746357,15,23,1998,10,"female",271,116,30,1000,80,1000,56,0,24
1746435,83,8,1930,6,"male",428,148,72,0,2,0,2,0,0
1746451,24,3,1989,10,"female",605,572,333,3,27,2,18,1,9
1746468,33,1,1980,2,"female",201,18,4,58,2,58,1,0,1
1746477,23,1,1990,1,"male",484,75,36,0,0,0,0,0,0
1746493,55,28,1958,12,"male",387,251,193,206,158,206,105,0,53
1746496,17,1,1996,10,"male",318,37,6,0,0,0,0,0,0
1746503,22,20,1991,8,"male",150,196,82,24,79,24,25,0,54
1746553,17,1,1996,1,"male",249,26,24,0,0,0,0,0,0
1746613,31,13,1982,6,"male",394,189,74,41,86,41,43,0,43
1746617,26,20,1987,12,"female",244,90,41,16,46,0,33,16,13
1746675,27,30,1986,10,"female",896,16,12,0,0,0,0,0,0
1746676,108,28,1905,3,"male",32,31,28,20,32,0,10,20,22
1746704,19,10,1994,12,"female",470,59,23,0,0,0,0,0,0
1746708,32,18,1981,3,"male",655,207,134,1,16,0,14,1,2
1746710,24,16,1989,10,"male",282,124,83,1,13,1,11,0,2
1746714,55,27,1958,3,"male",860,190,134,735,1506,86,1101,649,405
1746717,17,24,1996,6,"female",162,81,18,0,0,0,0,0,0
1746718,77,27,1936,8,"female",1074,172,74,0,0,0,0,0,0
1746722,21,7,1992,3,"male",290,107,85,0,0,0,0,0,0
1746735,79,30,1934,10,"female",688,491,334,87,181,0,57,87,124
1746770,52,25,1961,3,"female",861,102,59,153,42,2,3,151,39
1746781,56,11,1957,10,"male",1298,155,63,11,19,11,17,0,2
1746790,18,8,1995,4,"male",775,191,77,1,0,1,0,0,0
1746802,68,4,1945,3,"female",377,2772,454,1740,1718,637,564,1103,1154
1746806,29,15,1984,2,"male",529,197,95,24,10,0,2,24,8
1746848,22,2,1991,5,"male",104,191,112,1,5,1,3,0,2
1746856,14,17,1999,8,"male",393,36,33,37,14,37,14,0,0
1746872,23,8,1990,3,"female",478,356,183,102,148,58,82,44,66
1746895,19,29,1994,7,"male",630,75,36,2,0,1,0,1,0
1746918,16,10,1997,10,"male",65,12,10,0,2,0,2,0,0
1746919,55,6,1958,7,"male",226,282,230,4783,3794,3098,2466,1685,1328
1746923,35,21,1978,3,"male",210,54,44,0,3,0,0,0,3
1746934,36,16,1977,4,"male",577,125,97,5,9,5,2,0,7
1746950,52,26,1961,6,"male",64,16,6,0,0,0,0,0,0
1746963,30,1,1983,1,"male",204,10,1,0,0,0,0,0,0
1746970,40,11,1973,3,"male",901,112,61,1,7,1,6,0,1
1746998,20,8,1993,7,"male",220,2,2,0,0,0,0,0,0
1747001,63,20,1950,3,"male",1741,32,11,3,2,0,2,3,0
1747011,23,11,1990,4,"male",221,47,30,1,0,1,0,0,0
1747017,25,20,1988,4,"male",714,3,2,0,0,0,0,0,0
1747020,21,2,1992,4,"female",635,289,131,6,102,5,76,1,26
1747033,56,12,1957,9,"female",716,207,106,300,407,300,274,0,133
1747046,28,15,1985,4,"male",120,98,75,0,25,0,23,0,2
1747088,26,4,1987,2,"female",1495,199,127,86,180,4,73,82,107
1747095,15,1,1998,4,"male",95,114,102,61,18,61,17,0,1
1747152,17,16,1996,4,"male",95,164,161,63,45,48,44,15,1
1747205,70,7,1943,5,"female",225,26,17,31,4,4,2,27,2
1747206,43,8,1970,2,"male",89,1,0,0,0,0,0,0,0
1747227,15,21,1998,2,"male",412,625,403,98,87,27,52,71,35
1747231,22,8,1991,5,"male",452,34,19,0,0,0,0,0,0
1747233,41,17,1972,9,"female",188,72,58,12,30,12,20,0,10
1747273,21,29,1992,5,"male",409,169,51,0,1,0,1,0,0
1747282,15,1,1998,1,"male",612,170,101,0,0,0,0,0,0
1747291,32,15,1981,10,"male",200,16,12,24,0,24,0,0,0
1747328,59,25,1954,3,"male",1452,24,3,8,11,7,2,1,9
1747339,45,2,1968,9,"female",242,27,15,140,95,140,90,0,5
1747347,29,3,1984,11,"male",676,63,38,38,1,38,1,0,0
1747361,31,17,1982,8,"female",444,207,125,1146,766,828,517,318,249
1747397,40,20,1973,10,"male",311,106,60,4,9,4,8,0,1
1747406,30,27,1983,11,"male",380,102,65,61,27,61,21,0,6
1747418,33,12,1980,6,"male",116,7,3,0,0,0,0,0,0
1747444,105,19,1908,11,"female",1530,183,45,2,0,0,0,2,0
1747473,25,30,1988,4,"male",547,230,129,9,62,1,15,8,47
1747476,18,22,1995,8,"female",640,269,140,101,270,101,250,0,20
1747498,28,31,1985,1,"female",380,284,191,1245,247,1241,183,4,64
1747507,18,16,1995,6,"female",1154,1150,513,5726,4183,5484,2333,242,1850
1747512,18,31,1995,8,"male",19,10,5,8,15,2,6,6,9
1747529,26,29,1987,12,"female",257,12,4,0,3,0,1,0,2
1747537,28,5,1985,6,"female",620,63,8,0,0,0,0,0,0
1747547,18,10,1995,3,"female",652,121,51,902,29,902,26,0,3
1747651,37,26,1976,1,"male",58,1,0,43,0,43,0,0,0
1747667,21,13,1992,9,"female",178,0,0,0,0,0,0,0,0
1747676,80,14,1933,3,"female",780,37,27,21,2,0,1,21,1
1747697,22,16,1991,5,"male",592,96,82,17,0,17,0,0,0
1747722,22,14,1991,10,"male",189,13,1,135,22,129,17,6,5
1747735,50,24,1963,2,"female",696,74,44,82,71,82,56,0,15
1747752,71,22,1942,3,"female",317,47,17,2,1,2,1,0,0
1747760,33,13,1980,4,"female",2247,172,118,41,248,39,123,2,125
1747763,29,19,1984,3,"male",301,0,0,0,0,0,0,0,0
1747784,64,19,1949,7,"male",1753,34,18,0,7,0,7,0,0
1747797,14,12,1999,9,"male",243,99,31,0,5,0,5,0,0
1747806,31,12,1982,1,"male",166,38,34,3,0,3,0,0,0
1747820,16,13,1997,5,"male",384,1,1,0,0,0,0,0,0
1747844,23,18,1990,4,"male",708,91,21,0,0,0,0,0,0
1747856,14,4,1999,12,"female",449,55,32,20,30,19,19,1,11
1747864,79,6,1934,10,"female",1510,18,13,1,37,0,14,1,23
1747903,19,24,1994,7,"male",383,64,20,6,1,6,1,0,0
1747921,30,18,1983,1,"male",143,74,57,0,3,0,0,0,3
1747929,50,21,1963,5,"male",489,75,51,22,4,22,3,0,1
1747960,67,30,1946,12,"male",1058,60,20,0,0,0,0,0,0
1747977,88,26,1925,8,"male",1611,828,524,206,262,205,187,1,75
1747987,25,28,1988,5,"male",486,7,4,0,1,0,1,0,0
1748010,23,3,1990,7,"male",123,39,22,1,2,1,2,0,0
1748089,13,2,2000,3,"male",227,63,40,0,3,0,3,0,0
1748112,23,17,1990,9,"female",414,242,205,66,97,57,55,9,42
1748113,33,11,1980,11,"male",311,20,2,0,0,0,0,0,0
1748116,19,18,1994,7,"female",415,389,260,344,456,317,322,27,134
1748144,17,6,1996,4,"female",868,884,417,753,755,139,313,614,442
1748147,93,23,1920,11,"male",828,330,249,272,43,240,26,32,17
1748191,19,25,1994,7,"female",574,714,462,140,242,140,188,0,54
1748210,95,14,1918,5,"male",441,251,109,2,8,2,8,0,0
1748219,24,1,1989,3,"male",353,1,1,4,0,0,0,4,0
1748225,27,15,1986,9,"female",479,9,6,0,1,0,1,0,0
1748235,16,10,1997,12,"female",535,987,358,114,130,7,32,107,98
1748246,16,15,1997,7,"male",558,320,125,0,7,0,4,0,3
1748260,79,14,1934,6,"female",890,38,31,11,2,3,1,8,1
1748261,47,25,1966,8,"female",376,13,10,7,1,7,0,0,1
1748263,51,25,1962,2,"female",358,68,39,13,30,0,10,13,20
1748294,21,11,1992,10,"male",337,19,19,0,0,0,0,0,0
1748301,44,22,1969,8,"female",195,53,39,91,13,91,8,0,5
1748320,31,16,1982,12,"male",137,10,9,1,0,0,0,1,0
1748353,40,24,1973,3,"male",361,10,8,2,2,2,2,0,0
1748355,51,12,1962,6,"male",522,18,6,3,2,3,2,0,0
1748361,69,21,1944,3,"male",1143,40,28,26,33,0,6,26,27
1748371,14,5,1999,5,"female",237,1,0,0,0,0,0,0,0
1748374,24,24,1989,7,"male",125,12,10,1,1,1,1,0,0
1748382,21,24,1992,6,"male",185,69,64,7,2,7,2,0,0
1748405,61,1,1952,3,"male",1224,205,69,23,1,0,1,23,0
1748408,21,5,1992,8,"male",450,327,260,0,2,0,2,0,0
1748426,24,18,1989,8,"female",486,110,60,7,2,0,1,7,1
1748433,18,12,1995,9,"female",607,319,174,60,104,3,31,57,73
1748450,89,10,1924,11,"male",1625,432,268,9,12,0,4,9,8
1748463,18,20,1995,12,"male",227,18,16,9,1,6,1,3,0
1748474,28,26,1985,9,"female",651,44,19,0,0,0,0,0,0
1748491,77,1,1936,1,"male",1019,107,52,18,39,0,23,18,16
1748523,23,8,1990,8,"female",270,424,149,2642,1362,2642,1200,0,162
1748528,22,1,1991,1,"male",703,906,750,2,14,2,7,0,7
1748536,58,28,1955,8,"female",224,71,63,1,6,1,3,0,3
1748557,17,10,1996,3,"male",769,413,228,8,0,1,0,7,0
1748575,19,22,1994,9,"male",353,211,118,66,12,66,12,0,0
1748582,19,1,1994,1,"male",46,26,18,1,0,1,0,0,0
1748632,13,26,2000,1,"female",476,198,64,79,25,74,22,5,3
1748662,23,24,1990,7,"male",228,62,51,0,0,0,0,0,0
1748666,71,20,1942,6,"male",1494,134,72,2,0,0,0,2,0
1748670,49,4,1964,9,"female",373,93,55,2,4,0,0,2,4
1748672,46,27,1967,7,"male",152,29,24,0,0,0,0,0,0
1748677,27,5,1986,6,"male",276,58,39,25,13,22,10,3,3
1748704,37,8,1976,7,"male",489,158,108,1,3,1,0,0,3
1748710,14,13,1999,9,"female",47,194,157,1463,140,1463,117,0,23
1748715,19,4,1994,10,"male",127,10,10,0,0,0,0,0,0
1748721,27,3,1986,1,"female",2174,505,293,360,416,295,301,65,115
1748734,22,2,1991,8,"male",120,318,283,7,25,7,20,0,5
1748739,15,26,1998,3,"female",317,131,100,6,34,5,23,1,11
1748760,83,8,1930,5,"male",70,83,76,17,1,17,1,0,0
1748768,51,21,1962,3,"female",380,26,1,1,0,1,0,0,0
1748769,69,12,1944,9,"female",469,23,19,91,2,0,0,91,2
1748772,26,22,1987,9,"female",361,313,89,8021,4152,8021,3194,0,958
1748789,24,10,1989,8,"male",183,57,40,99,26,99,25,0,1
1748811,56,16,1957,2,"male",702,24,11,7,60,7,26,0,34
1748818,22,19,1991,4,"male",323,488,185,0,0,0,0,0,0
1748833,14,1,1999,1,"male",95,10,9,12,3,3,0,9,3
1748839,26,22,1987,12,"male",135,9,8,1,1,1,1,0,0
1748853,17,24,1996,7,"female",629,3505,1224,861,846,836,748,25,98
1748854,56,2,1957,4,"male",290,20,12,72,58,57,38,15,20
1748868,62,2,1951,7,"female",1709,39,24,1,3,0,2,1,1
1748880,27,5,1986,1,"female",73,4,4,0,0,0,0,0,0
1748921,25,1,1988,1,"male",70,7,6,1,1,1,1,0,0
1748959,21,20,1992,9,"male",601,35,21,4,0,0,0,4,0
1748963,61,5,1952,5,"male",81,22,22,0,0,0,0,0,0
1748965,16,30,1997,1,"female",452,403,201,4501,4091,4486,3274,15,817
1748980,103,18,1910,8,"female",734,66,46,522,297,520,216,2,81
1748993,32,5,1981,2,"female",709,15,12,0,0,0,0,0,0
1748996,56,14,1957,4,"female",415,181,80,90,26,0,6,90,20
1749023,63,19,1950,11,"female",360,177,118,10,2,10,1,0,1
1749026,18,8,1995,4,"female",52,310,34,70,354,65,125,5,229
1749037,14,4,1999,3,"male",254,196,148,379,69,379,54,0,15
1749050,25,24,1988,5,"male",66,12,9,0,0,0,0,0,0
1749058,21,6,1992,7,"male",356,253,196,13,7,0,1,13,6
1749090,29,14,1984,6,"male",402,236,197,33,72,0,30,33,42
1749100,42,3,1971,4,"female",778,446,227,1207,1416,886,953,321,463
1749102,19,24,1994,4,"female",536,551,310,918,328,666,228,252,100
1749146,48,28,1965,6,"male",78,1,1,0,0,0,0,0,0
1749176,26,10,1987,12,"male",451,94,60,1,0,1,0,0,0
1749181,39,17,1974,9,"male",270,13,3,0,0,0,0,0,0
1749191,31,30,1982,5,"female",355,123,101,635,1120,463,801,172,319
1749197,108,27,1905,3,"male",1338,256,146,269,269,269,231,0,38
1749209,21,10,1992,12,"male",676,215,54,0,2,0,0,0,2
1749228,20,16,1993,6,"male",144,133,116,433,20,433,20,0,0
1749231,72,13,1941,1,"female",67,4,1,0,0,0,0,0,0
1749233,58,4,1955,4,"female",1452,324,135,384,143,384,125,0,18
1749265,28,3,1985,7,"male",478,98,92,0,1,0,0,0,1
1749268,66,10,1947,4,"male",1098,607,410,336,202,0,75,336,127
1749276,27,22,1986,12,"female",147,35,31,0,0,0,0,0,0
1749301,43,1,1970,1,"male",362,14,10,0,0,0,0,0,0
1749308,33,1,1980,1,"male",544,214,175,24,11,24,8,0,3
1749359,25,16,1988,10,"male",58,36,34,139,44,139,44,0,0
1749363,17,20,1996,9,"female",294,44,18,16,5,16,3,0,2
1749371,23,23,1990,1,"female",807,150,81,15,4,0,0,15,4
1749382,34,19,1979,10,"female",177,24,17,12,56,12,44,0,12
1749391,21,21,1992,6,"female",194,113,88,795,43,229,19,566,24
1749429,18,11,1995,11,"female",413,251,162,14,21,0,7,14,14
1749446,18,10,1995,6,"female",639,186,129,0,1,0,1,0,0
1749448,30,27,1983,7,"male",114,66,48,0,59,0,51,0,8
1749464,24,13,1989,2,"male",97,87,81,1,0,1,0,0,0
1749477,21,21,1992,11,"male",661,184,144,1,22,0,4,1,18
1749490,65,5,1948,7,"female",1607,113,50,2277,690,0,406,2277,284
1749503,28,13,1985,4,"female",366,95,68,322,359,315,296,7,63
1749525,49,3,1964,3,"male",249,96,50,346,386,17,255,329,131
1749535,18,14,1995,5,"male",321,199,97,1,34,1,11,0,23
1749537,16,28,1997,6,"male",540,305,179,9,24,9,20,0,4
1749541,25,1,1988,1,"female",92,216,155,177,204,177,187,0,17
1749559,101,5,1912,2,"male",1269,218,82,96,21,96,12,0,9
1749584,22,4,1991,12,"male",286,124,81,14,6,2,0,12,6
1749624,19,3,1994,1,"male",587,2274,2040,44,15,3,8,41,7
1749642,44,8,1969,12,"female",565,67,13,57,11,57,11,0,0
1749645,48,13,1965,4,"female",180,168,91,110,189,2,36,108,153
1749658,27,27,1986,4,"female",530,379,357,0,0,0,0,0,0
1749684,64,7,1949,8,"female",2043,71,42,70,50,3,19,67,31
1749746,41,7,1972,5,"male",1004,0,0,0,0,0,0,0,0
1749763,36,4,1977,6,"male",248,88,79,53,31,51,11,2,20
1749791,52,23,1961,11,"male",274,4,4,26,2,23,0,3,2
1749824,29,12,1984,6,"male",142,0,0,0,0,0,0,0,0
1749829,33,10,1980,3,"male",113,10,5,9,2,9,1,0,1
1749834,28,10,1985,11,"female",542,306,238,821,544,99,214,722,330
1749840,74,27,1939,11,"female",706,79,57,568,351,568,237,0,114
1749854,103,13,1910,3,"female",370,149,58,3,1,3,1,0,0
1749866,20,10,1993,10,"male",498,352,148,12,4,0,4,12,0
1749893,23,3,1990,7,"male",256,52,40,1,0,1,0,0,0
1749895,26,13,1987,4,"male",353,44,31,0,7,0,1,0,6
1749901,32,11,1981,11,"male",829,69,46,3,3,3,3,0,0
1749936,43,1,1970,10,"female",249,5,1,2,1,2,1,0,0
1749958,27,30,1986,12,"male",285,301,257,33,24,33,24,0,0
1749972,23,10,1990,11,"male",441,184,99,135,43,135,27,0,16
1749974,19,5,1994,2,"female",567,597,369,215,407,215,397,0,10
1749986,19,6,1994,3,"female",430,33,10,5,8,5,3,0,5
1749991,20,8,1993,8,"male",283,43,38,0,1,0,1,0,0
1750057,39,8,1974,6,"male",216,23,4,96,71,96,69,0,2
1750066,67,30,1946,8,"female",1083,143,70,556,252,1,54,555,198
1750080,27,27,1986,3,"male",528,47,27,3,0,3,0,0,0
1750099,44,3,1969,6,"male",388,17,9,1,1,0,0,1,1
1750108,64,22,1949,4,"male",218,172,81,101,6,88,4,13,2
1750118,25,1,1988,1,"male",15,0,0,0,0,0,0,0,0
1750122,20,2,1993,4,"male",523,157,133,2,2,1,2,1,0
1750147,51,1,1962,11,"male",684,13,11,6,2,6,2,0,0
1750156,26,16,1987,5,"female",404,4,2,0,0,0,0,0,0
1750157,31,16,1982,4,"female",406,77,59,182,100,182,100,0,0
1750170,52,24,1961,6,"male",851,62,23,55,67,55,40,0,27
1750175,15,31,1998,1,"male",357,63,40,3,1,3,1,0,0
1750181,43,1,1970,3,"male",628,20,9,1,3,1,1,0,2
1750188,20,29,1993,1,"male",536,141,72,2,0,2,0,0,0
1750232,25,21,1988,5,"female",6,1,0,7,2,6,2,1,0
1750236,50,18,1963,8,"female",1013,100,60,7,16,5,13,2,3
1750280,27,25,1986,12,"male",306,18,12,2,1,2,1,0,0
1750322,27,28,1986,5,"female",746,2,0,0,0,0,0,0,0
1750405,36,8,1977,2,"female",481,65,52,32,0,2,0,30,0
1750411,18,12,1995,2,"male",152,360,175,124,215,62,84,62,131
1750412,39,21,1974,10,"male",190,72,64,1,0,1,0,0,0
1750433,18,29,1995,4,"female",1189,1912,918,418,1087,0,426,418,661
1750440,29,31,1984,10,"male",320,109,87,7,18,7,12,0,6
1750487,29,22,1984,6,"male",261,40,32,77,30,77,15,0,15
1750491,52,23,1961,3,"female",23,0,0,0,0,0,0,0,0
1750493,105,26,1908,11,"male",1449,162,79,133,24,85,14,48,10
1750502,53,8,1960,2,"female",1085,288,65,163,406,162,236,1,170
1750506,52,13,1961,1,"male",607,45,31,60,68,1,39,59,29
1750519,58,21,1955,9,"female",173,49,28,12,12,12,3,0,9
1750522,56,1,1957,4,"male",604,1,1,0,0,0,0,0,0
1750564,43,31,1970,12,"male",418,7,4,0,0,0,0,0,0
1750586,25,10,1988,9,"female",203,34,34,8,1,8,0,0,1
1750605,19,10,1994,6,"male",786,437,332,141,29,141,26,0,3
1750629,15,9,1998,5,"male",603,152,60,44,13,4,0,40,13
1750639,47,5,1966,8,"female",153,22,15,17,1,17,1,0,0
1750665,59,26,1954,6,"male",362,30,29,0,0,0,0,0,0
1750666,48,3,1965,1,"female",300,699,599,1866,1425,448,964,1418,461
1750678,40,14,1973,11,"female",479,43,31,7,0,7,0,0,0
1750684,24,5,1989,9,"male",245,125,80,32,5,32,2,0,3
1750695,68,13,1945,8,"male",840,35,18,23,0,23,0,0,0
1750697,53,3,1960,6,"male",611,346,108,202,24,198,8,4,16
1750734,24,8,1989,2,"male",786,53,30,7,5,7,4,0,1
1750740,27,7,1986,8,"male",566,13,6,0,0,0,0,0,0
1750758,16,23,1997,7,"male",157,5,1,0,0,0,0,0,0
1750772,21,6,1992,11,"female",975,144,13,36,38,36,32,0,6
1750796,36,16,1977,2,"male",580,4,3,0,0,0,0,0,0
1750800,108,23,1905,4,"male",2124,162,26,168,156,141,78,27,78
1750818,53,28,1960,2,"male",118,72,58,1115,3,1115,3,0,0
1750827,21,2,1992,4,"female",20,182,114,923,1235,752,595,171,640
1750867,15,16,1998,12,"male",60,3,1,0,0,0,0,0,0
1750873,48,27,1965,2,"female",277,8,5,12,0,0,0,12,0
1750930,51,21,1962,11,"female",184,25,6,0,6,0,5,0,1
1750936,24,22,1989,2,"male",543,42,39,8,0,0,0,8,0
1750967,24,1,1989,8,"female",717,142,120,282,284,180,82,102,202
1750985,30,25,1983,3,"male",741,124,59,154,33,154,31,0,2
1751021,46,4,1967,9,"female",1437,370,247,153,148,19,52,134,96
1751032,30,15,1983,12,"male",1913,142,67,9,12,9,12,0,0
1751033,32,26,1981,4,"male",318,2,1,2,15,0,0,2,15
1751035,107,1,1906,3,"male",1100,844,536,4,2,3,2,1,0
1751048,67,28,1946,3,"female",1004,78,44,159,27,0,1,159,26
1751098,48,16,1965,1,"female",1456,90,47,4,3,4,3,0,0
1751111,18,10,1995,11,"female",496,3,2,0,0,0,0,0,0
1751138,26,6,1987,5,"male",634,152,105,99,30,82,5,17,25
1751177,46,1,1967,1,"male",616,48,31,4,9,0,3,4,6
1751191,18,11,1995,5,"male",186,115,90,5,2,5,1,0,1
1751219,18,5,1995,7,"male",311,133,82,23,7,23,5,0,2
1751233,59,8,1954,12,"male",759,7,5,3,10,0,5,3,5
1751235,44,14,1969,2,"male",634,2,2,0,0,0,0,0,0
1751271,66,24,1947,6,"female",1513,60,25,10,27,0,11,10,16
1751283,39,22,1974,8,"female",242,32,18,14,27,14,9,0,18
1751292,14,1,1999,1,"female",430,41,31,0,0,0,0,0,0
1751301,55,20,1958,11,"male",413,39,12,0,1,0,1,0,0
1751302,31,31,1982,5,"male",211,184,90,35,1,2,1,33,0
1751355,58,4,1955,1,"male",808,18,13,15,29,0,0,15,29
1751356,18,21,1995,12,"female",423,681,127,57,182,57,62,0,120
1751373,17,11,1996,4,"male",147,21,8,1,0,1,0,0,0
1751396,37,13,1976,3,"female",600,114,54,10,8,10,6,0,2
1751438,59,4,1954,1,"female",1128,45,16,1,3,1,3,0,0
1751441,27,11,1986,5,"male",829,115,60,0,0,0,0,0,0
1751445,25,1,1988,1,"male",59,55,48,0,0,0,0,0,0
1751448,44,23,1969,1,"male",727,68,44,1,8,1,7,0,1
1751458,18,11,1995,11,"male",533,154,94,0,4,0,2,0,2
1751490,33,2,1980,3,"female",574,211,135,234,93,157,29,77,64
1751492,18,10,1995,5,"male",114,1,0,0,0,0,0,0,0
1751499,77,30,1936,6,"female",1587,86,48,10,3,10,0,0,3
1751500,73,4,1940,1,"male",1633,100,36,4,2,2,2,2,0
1751553,33,5,1980,8,"male",541,54,28,14,18,14,9,0,9
1751602,35,5,1978,5,"male",877,86,62,1,53,1,42,0,11
1751606,21,4,1992,4,"female",546,531,146,11,0,0,0,11,0
1751614,53,20,1960,5,"female",366,60,42,94,10,24,2,70,8
1751617,19,5,1994,7,"male",347,186,137,95,46,95,17,0,29
1751622,20,29,1993,9,"male",221,66,41,3,2,3,2,0,0
1751627,19,4,1994,4,"male",199,33,26,6,5,6,5,0,0
1751666,21,10,1992,3,"male",43,15,13,5,0,5,0,0,0
1751672,22,1,1991,1,"male",642,225,138,38,74,35,35,3,39
1751676,14,22,1999,6,"female",28,63,40,160,77,160,12,0,65
1751711,61,17,1952,8,"female",1054,110,72,83,37,83,22,0,15
1751712,50,1,1963,7,"female",1466,342,186,28,65,23,57,5,8
1751722,70,7,1943,10,"female",1192,52,32,35,7,34,2,1,5
1751726,16,30,1997,1,"female",2,11,8,0,0,0,0,0,0
1751766,56,2,1957,9,"male",391,21,18,0,0,0,0,0,0
1751793,18,24,1995,8,"female",616,1031,455,8,73,8,60,0,13
1751813,49,2,1964,12,"male",1020,38,11,0,0,0,0,0,0
1751821,108,18,1905,9,"male",1100,218,99,12,2,3,2,9,0
1751857,63,15,1950,4,"female",2049,187,65,102,291,0,66,102,225
1751875,32,28,1981,1,"female",693,36,20,88,16,88,16,0,0
1751892,20,2,1993,4,"male",62,99,44,9,2,9,1,0,1
1751895,60,26,1953,6,"female",265,10,8,0,0,0,0,0,0
1751914,19,19,1994,12,"male",393,86,55,0,1,0,0,0,1
1751925,29,5,1984,12,"male",618,62,42,177,141,177,140,0,1
1751941,31,4,1982,1,"male",331,14,5,0,0,0,0,0,0
1751962,57,21,1956,9,"female",162,31,19,297,91,297,82,0,9
1752002,58,7,1955,2,"female",163,198,85,117,179,6,75,111,104
1752007,22,23,1991,7,"female",852,329,248,1081,672,766,345,315,327
1752033,24,25,1989,11,"male",594,4,4,0,0,0,0,0,0
1752048,25,13,1988,1,"female",640,151,93,544,74,544,72,0,2
1752059,25,5,1988,2,"male",53,43,31,4,0,4,0,0,0
1752080,67,24,1946,11,"female",1887,89,44,384,263,288,168,96,95
1752082,22,3,1991,8,"male",616,31,17,0,0,0,0,0,0
1752083,64,13,1949,5,"female",1975,54,14,17,22,0,19,17,3
1752097,70,11,1943,10,"male",1771,12,5,0,2,0,0,0,2
1752119,14,21,1999,8,"female",248,19,13,6,11,0,1,6,10
1752133,14,1,1999,8,"male",281,680,364,3,21,3,5,0,16
1752158,27,9,1986,9,"male",60,5,0,0,0,0,0,0,0
1752164,60,7,1953,7,"male",651,78,51,142,26,1,11,141,15
1752223,23,19,1990,5,"male",341,959,437,681,676,681,283,0,393
1752253,31,6,1982,1,"male",675,35,6,0,0,0,0,0,0
1752275,22,24,1991,12,"female",745,30,17,104,1,104,1,0,0
1752284,24,3,1989,8,"male",1748,754,399,45,163,25,115,20,48
1752289,68,10,1945,6,"female",1153,72,36,445,97,346,59,99,38
1752291,35,22,1978,6,"male",646,143,74,0,0,0,0,0,0
1752301,67,14,1946,9,"female",1516,64,24,16,5,14,1,2,4
1752306,52,10,1961,7,"male",676,21,6,11,1,11,1,0,0
1752319,30,10,1983,10,"male",321,48,42,0,0,0,0,0,0
1752321,41,5,1972,7,"female",72,0,0,0,0,0,0,0,0
1752322,26,1,1987,1,"male",582,61,40,1,1,1,0,0,1
1752345,18,1,1995,9,"male",280,286,221,330,28,243,22,87,6
1752362,15,19,1998,4,"male",350,358,285,411,3,0,1,411,2
1752380,25,10,1988,8,"female",533,156,66,14,17,13,10,1,7
1752397,106,10,1907,6,"male",1135,213,120,33,46,33,19,0,27
1752401,54,30,1959,9,"female",1009,38,19,27,2,3,1,24,1
1752421,19,6,1994,7,"female",157,0,0,0,0,0,0,0,0
1752426,15,1,1998,1,"male",461,207,196,4,3,4,3,0,0
1752451,26,18,1987,5,"male",112,319,204,157,353,65,188,92,165
1752486,19,9,1994,5,"male",105,82,74,0,2,0,1,0,1
1752497,17,20,1996,4,"female",1,11,11,7,22,7,3,0,19
1752514,15,14,1998,8,"male",402,214,159,30,4,1,0,29,4
1752523,43,26,1970,7,"female",466,25,12,9,27,7,20,2,7
1752552,18,21,1995,10,"male",164,97,69,22,5,22,3,0,2
1752594,27,17,1986,6,"male",141,289,216,2,27,2,21,0,6
1752615,19,21,1994,8,"female",43,112,47,99,64,97,49,2,15
1752671,20,8,1993,8,"male",263,258,205,2,1,2,1,0,0
1752763,50,14,1963,10,"male",133,1,0,0,0,0,0,0,0
1752776,53,4,1960,11,"male",1373,42,14,0,0,0,0,0,0
1752778,26,1,1987,3,"male",300,24,22,0,9,0,5,0,4
1752781,68,22,1945,7,"male",584,838,285,62,71,62,54,0,17
1752809,15,1,1998,5,"male",249,789,685,3,5,3,5,0,0
1752817,43,10,1970,7,"male",241,0,0,0,0,0,0,0,0
1752828,23,20,1990,4,"male",229,31,17,0,0,0,0,0,0
1752840,50,6,1963,10,"female",381,18,9,5,2,5,2,0,0
1752844,22,1,1991,1,"female",140,166,99,417,400,416,365,1,35
1752863,65,11,1948,8,"male",913,13,1,0,0,0,0,0,0
1752887,19,24,1994,6,"female",369,149,63,0,1,0,1,0,0
1752893,70,8,1943,8,"female",986,15,12,2,1,0,0,2,1
1752908,22,11,1991,11,"male",352,111,76,4,1,4,0,0,1
1752925,45,23,1968,11,"male",456,42,15,3,5,3,5,0,0
1752931,73,3,1940,8,"female",1133,46,23,16,5,0,2,16,3
1752975,66,10,1947,1,"male",868,375,194,323,178,302,123,21,55
1752980,29,25,1984,7,"male",345,74,36,0,0,0,0,0,0
1752982,23,5,1990,7,"female",354,163,107,191,3,186,3,5,0
1752990,100,10,1913,6,"female",1197,675,159,73,83,73,70,0,13
1753017,54,5,1959,6,"female",616,22,11,548,2,548,0,0,2
1753077,20,27,1993,7,"male",267,116,90,0,8,0,3,0,5
1753095,29,3,1984,12,"female",262,33,32,102,1,102,1,0,0
1753099,47,3,1966,10,"female",683,210,127,225,200,0,70,225,130
1753115,29,10,1984,2,"male",56,9,9,4,0,0,0,4,0
1753146,62,5,1951,6,"female",1087,149,45,227,22,0,16,227,6
1753151,18,11,1995,9,"female",126,101,49,91,138,14,50,77,88
1753154,73,8,1940,10,"male",1015,56,30,0,1,0,1,0,0
1753167,16,6,1997,5,"male",542,392,186,270,361,0,72,270,289
1753197,20,29,1993,1,"female",1096,886,510,1055,903,417,497,638,406
1753206,34,20,1979,11,"male",79,97,70,509,135,415,107,94,28
1753220,35,3,1978,8,"male",543,39,15,0,3,0,0,0,3
1753222,77,27,1936,12,"male",627,9,2,1,4,0,1,1,3
1753251,66,19,1947,7,"female",422,2,0,1,0,0,0,1,0
1753253,44,12,1969,10,"male",1031,69,40,0,1,0,1,0,0
1753264,24,27,1989,10,"female",1193,615,332,139,173,110,116,29,57
1753334,29,10,1984,4,"male",1481,555,380,3,3,3,3,0,0
1753338,16,2,1997,4,"female",658,4705,282,518,699,385,363,133,336
1753380,19,4,1994,2,"male",215,51,48,4,2,0,0,4,2
1753432,28,3,1985,9,"male",661,92,78,0,25,0,5,0,20
1753473,62,12,1951,1,"female",1144,72,15,18,77,18,58,0,19
1753476,24,14,1989,8,"male",242,112,46,19,1,6,1,13,0
1753484,15,1,1998,11,"female",77,337,154,109,180,98,123,11,57
1753496,18,17,1995,10,"male",191,65,61,0,8,0,8,0,0
1753516,26,1,1987,1,"male",487,187,123,0,3,0,3,0,0
1753520,24,3,1989,9,"male",305,232,178,221,217,205,203,16,14
1753532,64,20,1949,9,"female",497,2,1,3,0,0,0,3,0
1753537,32,8,1981,12,"female",186,41,20,46,49,40,24,6,25
1753554,25,6,1988,3,"male",916,173,101,0,2,0,2,0,0
1753560,30,3,1983,3,"male",504,105,84,2,0,0,0,2,0
1753584,47,20,1966,6,"female",395,3,3,18,0,0,0,18,0
1753611,27,14,1986,6,"male",1086,277,94,60,65,60,51,0,14
1753612,67,30,1946,1,"male",1570,353,206,3,6,0,2,3,4
1753613,18,15,1995,4,"male",403,1038,586,152,439,72,109,80,330
1753616,30,13,1983,5,"male",364,24,8,0,0,0,0,0,0
1753643,24,25,1989,3,"female",322,124,63,24,47,0,22,24,25
1753675,22,11,1991,6,"male",234,48,38,72,33,0,13,72,20
1753692,63,1,1950,4,"male",1292,44,10,2,44,2,41,0,3
1753712,26,24,1987,4,"male",1261,126,8,12,3,4,1,8,2
1753714,21,22,1992,5,"male",480,160,97,0,1,0,0,0,1
1753720,43,15,1970,5,"male",650,17,11,0,0,0,0,0,0
1753721,49,9,1964,8,"female",895,0,0,0,0,0,0,0,0
1753726,21,2,1992,2,"male",224,8,4,0,19,0,11,0,8
1753739,18,9,1995,5,"male",705,511,369,13,23,13,19,0,4
1753745,45,4,1968,12,"male",1485,287,223,5,0,4,0,1,0
1753773,23,1,1990,1,"male",154,123,111,0,1,0,1,0,0
1753790,31,9,1982,7,"male",75,86,69,140,48,135,36,5,12
1753794,67,24,1946,8,"female",1078,227,147,33,172,0,15,33,157
1753807,20,28,1993,9,"male",348,16,10,0,0,0,0,0,0
1753834,52,16,1961,7,"female",621,116,95,16,67,0,18,16,49
1753850,32,28,1981,4,"male",478,1,0,0,1,0,0,0,1
1753876,20,29,1993,3,"male",40,40,38,11,2,11,2,0,0
1753914,19,20,1994,12,"male",871,640,329,406,229,242,119,164,110
1753924,47,6,1966,4,"male",484,17,9,0,6,0,3,0,3
1753944,23,7,1990,6,"male",43,125,123,38,7,38,7,0,0
1753972,32,20,1981,3,"female",1388,256,242,383,197,127,161,256,36
1754033,19,10,1994,6,"male",199,70,37,0,0,0,0,0,0
1754101,22,5,1991,8,"male",231,49,31,24,0,24,0,0,0
1754103,20,28,1993,12,"female",838,196,123,6,202,4,81,2,121
1754125,22,18,1991,11,"male",510,60,25,12,30,12,19,0,11
1754139,20,2,1993,7,"female",352,38,15,1,0,1,0,0,0
1754153,20,1,1993,1,"male",821,423,144,3,11,3,8,0,3
1754179,42,15,1971,10,"male",21,1,0,0,0,0,0,0,0
1754206,30,26,1983,9,"female",297,279,213,539,275,178,99,361,176
1754208,31,23,1982,8,"male",651,97,70,94,80,94,57,0,23
1754209,67,11,1946,8,"male",1440,41,21,1,0,1,0,0,0
1754224,29,18,1984,3,"male",595,36,24,0,1,0,1,0,0
1754242,17,28,1996,6,"female",279,783,285,102,235,86,96,16,139
1754243,20,1,1993,5,"female",218,23,19,0,20,0,17,0,3
1754252,17,11,1996,5,"female",408,18,9,2,0,2,0,0,0
1754270,21,21,1992,3,"male",507,319,102,211,167,12,117,199,50
1754294,32,11,1981,6,"male",1158,34,24,0,0,0,0,0,0
1754301,27,1,1986,1,"male",183,0,0,0,0,0,0,0,0
1754302,61,30,1952,9,"female",941,96,45,48,111,11,60,37,51
1754309,18,4,1995,7,"male",202,270,217,13,1,13,0,0,1
1754310,24,3,1989,8,"male",359,4,2,0,0,0,0,0,0
1754327,22,24,1991,4,"male",429,16,14,0,0,0,0,0,0
1754329,18,5,1995,10,"female",415,17,8,11,13,11,5,0,8
1754330,20,2,1993,8,"male",278,352,327,27,0,27,0,0,0
1754332,61,27,1952,5,"male",534,196,144,3,24,3,22,0,2
1754341,26,20,1987,11,"male",371,26,17,5,2,5,2,0,0
1754355,33,26,1980,10,"female",825,1896,837,1369,2518,1369,2355,0,163
1754366,32,31,1981,3,"female",181,8,1,355,50,0,3,355,47
1754430,51,14,1962,9,"female",1423,425,282,762,509,27,104,735,405
1754438,19,1,1994,4,"male",16,5,4,19,5,19,5,0,0
1754450,39,27,1974,11,"female",715,61,30,75,147,60,53,15,94
1754473,25,8,1988,9,"female",1656,340,171,911,332,251,143,660,189
1754491,17,8,1996,6,"male",96,69,64,10,18,10,10,0,8
1754502,17,8,1996,11,"female",1300,1347,302,542,125,487,71,55,54
1754521,26,31,1987,5,"male",353,102,84,9,0,9,0,0,0
1754531,103,1,1910,1,"male",804,214,159,0,11,0,7,0,4
1754547,31,10,1982,4,"male",183,2,0,0,0,0,0,0,0
1754574,20,1,1993,8,"female",303,41,14,72,111,72,40,0,71
1754582,32,10,1981,1,"female",359,107,63,176,120,110,104,66,16
1754594,57,24,1956,6,"female",2093,254,188,1,2,0,2,1,0
1754601,48,28,1965,11,"female",1993,179,63,6,21,6,1,0,20
1754610,103,13,1910,4,"male",1081,1054,378,40,29,40,26,0,3
1754682,20,8,1993,11,"male",518,567,496,784,241,784,169,0,72
1754684,30,3,1983,2,"male",323,59,40,8,19,0,12,8,7
1754697,16,27,1997,2,"female",190,42,31,0,0,0,0,0,0
1754699,20,19,1993,11,"female",294,112,85,0,1,0,0,0,1
1754719,16,10,1997,5,"male",438,270,168,65,83,54,58,11,25
1754725,25,7,1988,4,"female",66,43,25,1,0,1,0,0,0
1754727,42,1,1971,5,"female",548,19,6,12,3,12,3,0,0
1754795,13,17,2000,1,"male",221,4,2,11,0,0,0,11,0
1754810,16,8,1997,12,"female",324,701,470,91,5,29,2,62,3
1754863,24,27,1989,3,"male",405,162,89,43,48,43,26,0,22
1754865,22,1,1991,1,"male",1446,6,4,0,3,0,3,0,0
1754873,35,30,1978,12,"male",150,15,11,2,1,2,1,0,0
1754892,22,20,1991,6,"male",495,142,100,6,36,6,34,0,2
1754909,18,12,1995,10,"male",417,16,11,2,1,2,1,0,0
1754935,33,6,1980,4,"male",394,98,54,3,72,0,34,3,38
1754957,21,9,1992,9,"male",440,27,24,28,5,28,4,0,1
1754984,18,31,1995,5,"male",276,97,63,49,16,49,14,0,2
1755033,18,12,1995,10,"female",255,3318,545,21,183,21,149,0,34
1755055,23,19,1990,5,"male",585,36,10,0,1,0,0,0,1
1755056,49,26,1964,7,"female",1521,79,67,751,261,0,95,751,166
1755058,51,3,1962,4,"male",628,97,71,70,46,0,12,70,34
1755060,42,13,1971,12,"female",426,128,68,488,481,287,244,201,237
1755106,34,21,1979,1,"female",598,49,29,2,7,2,6,0,1
1755139,31,8,1982,5,"male",776,138,73,0,2,0,1,0,1
1755140,42,18,1971,10,"male",603,59,38,0,0,0,0,0,0
1755148,47,20,1966,9,"male",194,3,2,15,11,0,9,15,2
1755155,17,3,1996,5,"female",195,211,189,8,0,8,0,0,0
1755198,34,8,1979,8,"male",761,105,72,1,4,1,4,0,0
1755220,18,17,1995,8,"male",206,475,433,0,0,0,0,0,0
1755231,29,8,1984,11,"female",22,23,13,74,27,74,23,0,4
1755243,33,5,1980,2,"female",173,24,16,34,20,34,18,0,2
1755307,71,30,1942,4,"female",546,36,26,8,2,8,2,0,0
1755314,20,12,1993,7,"female",550,496,389,50,74,50,57,0,17
1755331,39,24,1974,11,"female",450,62,46,3,12,2,8,1,4
1755340,21,30,1992,11,"male",130,69,41,0,0,0,0,0,0
1755370,38,19,1975,8,"male",648,176,134,0,0,0,0,0,0
1755385,14,20,1999,6,"female",89,62,38,21,0,15,0,6,0
1755410,55,24,1958,10,"female",36,191,167,164,131,82,57,82,74
1755428,21,22,1992,10,"male",85,27,23,0,0,0,0,0,0
1755446,18,27,1995,10,"male",316,158,77,24,26,24,26,0,0
1755472,55,13,1958,2,"male",237,43,43,574,365,574,180,0,185
1755499,37,17,1976,8,"male",775,40,25,1,2,0,0,1,2
1755518,26,6,1987,12,"female",51,27,11,30,1,30,1,0,0
1755524,40,3,1973,3,"male",318,0,0,0,0,0,0,0,0
1755528,19,16,1994,5,"male",77,215,209,174,332,174,320,0,12
1755582,16,19,1997,4,"male",476,286,254,0,2,0,2,0,0
1755598,19,20,1994,7,"male",486,208,93,12,3,12,3,0,0
1755603,28,18,1985,9,"male",74,33,19,136,73,136,72,0,1
1755609,31,23,1982,4,"female",351,129,104,544,778,544,509,0,269
1755611,24,1,1989,3,"male",335,65,54,0,0,0,0,0,0
1755631,38,3,1975,6,"male",1445,448,88,9,1,9,0,0,1
1755654,22,1,1991,1,"female",590,257,149,0,0,0,0,0,0
1755661,21,26,1992,4,"male",302,26,17,0,0,0,0,0,0
1755679,108,30,1905,7,"female",1022,818,264,38,40,7,11,31,29
1755689,14,15,1999,6,"male",399,32,19,13,8,3,3,10,5
1755691,15,29,1998,7,"male",474,199,135,41,6,41,4,0,2
1755705,24,1,1989,4,"female",368,267,197,910,551,910,344,0,207
1755714,23,11,1990,8,"male",376,81,70,16,4,11,4,5,0
1755715,43,16,1970,1,"female",520,296,140,343,205,343,123,0,82
1755731,18,1,1995,2,"male",42,56,53,0,0,0,0,0,0
1755741,23,3,1990,9,"female",332,109,52,35,46,35,44,0,2
1755743,14,3,1999,9,"male",376,137,63,7,11,3,10,4,1
1755745,23,7,1990,12,"female",97,138,44,77,350,77,242,0,108
1755769,25,2,1988,12,"male",45,58,28,428,147,428,77,0,70
1755774,29,8,1984,9,"male",216,69,47,26,11,10,5,16,6
1755802,43,1,1970,11,"female",195,53,33,51,41,35,34,16,7
1755832,15,9,1998,12,"male",310,241,160,274,1,274,1,0,0
1755842,38,14,1975,4,"male",138,25,21,13,4,13,2,0,2
1755845,25,7,1988,11,"female",256,60,44,12,56,12,43,0,13
1755854,26,13,1987,8,"female",188,570,448,458,247,458,222,0,25
1755855,16,13,1997,11,"female",272,217,72,11,0,0,0,11,0
1755870,103,1,1910,7,"female",757,540,266,143,117,50,30,93,87
1755923,22,29,1991,9,"female",404,212,61,102,63,102,33,0,30
1755929,20,26,1993,3,"male",201,64,36,2,22,0,4,2,18
1755947,24,11,1989,12,"female",278,69,33,2,0,2,0,0,0
1755951,28,22,1985,1,"male",397,60,18,0,3,0,1,0,2
1755986,38,5,1975,8,"female",568,58,18,3,2,3,2,0,0
1756020,56,23,1957,4,"female",522,15,8,1,5,0,4,1,1
1756032,108,18,1905,12,"male",1111,4089,510,372,398,9,102,363,296
1756045,56,13,1957,5,"female",126,60,41,34,41,6,21,28,20
1756051,58,9,1955,2,"female",1454,21,6,0,8,0,0,0,8
1756058,29,12,1984,12,"male",1507,7,4,0,0,0,0,0,0
1756077,18,24,1995,4,"male",709,542,434,330,50,153,43,177,7
1756084,17,1,1996,9,"female",577,1837,251,43,62,43,53,0,9
1756095,57,19,1956,12,"female",17,87,80,24,26,24,23,0,3
1756102,24,10,1989,1,"male",512,121,87,3,4,3,3,0,1
1756162,33,15,1980,6,"male",608,28,23,0,1,0,0,0,1
1756167,36,27,1977,10,"male",75,40,39,2,3,0,0,2,3
1756168,38,10,1975,9,"female",180,9,7,15,8,15,4,0,4
1756183,38,16,1975,11,"male",163,6,3,12,3,12,2,0,1
1756255,55,17,1958,4,"female",133,42,36,5,4,0,1,5,3
1756257,48,18,1965,4,"female",81,13,12,9,0,9,0,0,0
1756302,27,1,1986,8,"male",548,69,43,0,1,0,0,0,1
1756307,52,29,1961,10,"female",565,59,38,340,381,340,335,0,46
1756317,70,7,1943,3,"male",1057,57,34,18,13,18,6,0,7
1756330,42,21,1971,7,"female",264,19,12,4,0,4,0,0,0
1756339,33,18,1980,7,"male",676,21,7,9,57,9,42,0,15
1756348,52,7,1961,4,"female",45,5,1,0,0,0,0,0,0
1756352,28,23,1985,5,"male",417,597,560,15,10,3,6,12,4
1756358,25,23,1988,9,"female",340,101,70,194,258,194,211,0,47
1756371,42,14,1971,3,"male",464,10,8,1,0,1,0,0,0
1756399,16,28,1997,4,"male",81,63,44,5,0,5,0,0,0
1756401,35,14,1978,1,"male",497,32,11,22,40,22,37,0,3
1756438,57,6,1956,1,"female",951,77,11,320,91,320,68,0,23
1756446,40,5,1973,5,"female",10,1,1,47,1,47,1,0,0
1756486,22,15,1991,6,"male",423,167,142,167,96,73,42,94,54
1756501,37,15,1976,4,"male",618,80,56,2,0,2,0,0,0
1756545,54,26,1959,10,"female",169,30,27,58,2,58,2,0,0
1756580,25,8,1988,11,"female",549,72,20,58,46,1,14,57,32
1756582,23,1,1990,1,"female",167,4,4,29,105,29,10,0,95
1756591,58,4,1955,1,"female",589,21,17,46,16,46,12,0,4
1756613,19,18,1994,10,"female",276,52,42,7,19,4,10,3,9
1756627,24,8,1989,8,"male",187,143,130,71,5,71,5,0,0
1756645,15,15,1998,10,"female",272,5,2,3,0,3,0,0,0
1756646,64,28,1949,12,"female",658,11,11,0,0,0,0,0,0
1756647,63,3,1950,2,"female",1658,10,3,0,0,0,0,0,0
1756673,26,18,1987,2,"male",253,77,77,22,5,12,0,10,5
1756682,23,7,1990,3,"male",184,1,0,94,0,0,0,94,0
1756691,23,18,1990,10,"female",540,1100,513,3,2,3,2,0,0
1756714,55,23,1958,4,"male",443,164,121,11,1,11,1,0,0
1756717,16,30,1997,9,"male",476,222,146,15,2,0,0,15,2
1756758,30,12,1983,7,"female",536,157,86,105,120,93,34,12,86
1756768,61,30,1952,1,"male",583,1,1,6,0,0,0,6,0
1756773,63,4,1950,2,"female",1506,195,132,190,24,0,13,190,11
1756775,62,6,1951,10,"female",1192,71,32,223,54,0,11,223,43
1756788,52,12,1961,9,"male",1515,70,30,3,4,3,4,0,0
1756804,30,10,1983,5,"male",624,40,22,134,30,89,6,45,24
1756820,22,1,1991,1,"female",205,3,2,1,1,1,1,0,0
1756822,29,14,1984,4,"male",22,60,60,133,22,125,15,8,7
1756843,103,30,1910,9,"male",1277,553,485,22,8,22,8,0,0
1756868,66,9,1947,6,"female",1690,21,10,11,7,11,0,0,7
1756911,23,10,1990,7,"male",58,40,29,5,5,5,4,0,1
1756913,17,23,1996,12,"male",802,565,384,290,139,0,105,290,34
1756945,20,12,1993,12,"male",224,221,81,3,0,2,0,1,0
1756967,26,24,1987,9,"male",559,2,1,10,0,9,0,1,0
1756975,55,28,1958,9,"female",143,119,90,53,16,53,14,0,2
1756986,24,19,1989,8,"male",174,5,4,3,2,0,1,3,1
1757022,21,10,1992,9,"male",922,1,1,1,0,1,0,0,0
1757030,22,21,1991,5,"female",681,278,119,0,0,0,0,0,0
1757037,69,10,1944,9,"female",1697,106,37,136,47,136,41,0,6
1757054,18,28,1995,11,"female",69,121,104,2,10,2,10,0,0
1757063,33,1,1980,1,"male",94,43,36,6,38,6,9,0,29
1757102,34,7,1979,4,"female",521,103,52,5,2,4,1,1,1
1757130,48,16,1965,12,"female",1243,388,311,410,395,380,163,30,232
1757132,24,1,1989,1,"male",342,131,98,642,179,642,118,0,61
1757144,20,3,1993,1,"male",303,149,92,1,0,1,0,0,0
1757188,49,22,1964,1,"male",104,67,63,2,0,0,0,2,0
1757213,30,16,1983,6,"male",608,78,28,6,1,6,1,0,0
1757225,80,28,1933,2,"male",1734,9,6,0,1,0,1,0,0
1757231,29,6,1984,5,"female",394,2,2,0,0,0,0,0,0
1757244,24,29,1989,7,"male",690,64,17,6,0,6,0,0,0
1757253,59,3,1954,12,"male",1092,1,1,113,1,1,0,112,1
1757261,19,21,1994,8,"female",598,219,151,0,3,0,2,0,1
1757269,53,3,1960,4,"male",702,21,16,0,0,0,0,0,0
1757295,25,3,1988,1,"male",252,143,32,0,0,0,0,0,0
1757310,103,24,1910,6,"female",1314,105,45,31,49,0,20,31,29
1757394,61,16,1952,9,"female",852,53,24,15,21,13,4,2,17
1757405,27,15,1986,5,"female",78,15,9,44,3,44,3,0,0
1757417,105,5,1908,7,"male",90,68,65,3,0,0,0,3,0
1757442,42,20,1971,5,"female",299,38,36,23,32,23,31,0,1
1757447,25,8,1988,7,"female",485,1,1,5,2,0,0,5,2
1757453,23,3,1990,2,"male",263,186,142,0,8,0,8,0,0
1757455,20,12,1993,10,"female",1761,429,134,439,1298,437,928,2,370
1757459,53,9,1960,10,"male",1340,5,2,64,14,64,2,0,12
1757460,27,21,1986,11,"male",23,16,15,18,8,18,8,0,0
1757468,80,20,1933,2,"female",1858,53,37,1,2,1,2,0,0
1757498,26,5,1987,11,"male",175,88,51,1,5,1,1,0,4
1757500,50,13,1963,11,"female",206,25,16,0,4,0,3,0,1
1757540,18,27,1995,9,"female",165,491,423,135,86,130,16,5,70
1757556,50,25,1963,10,"male",248,1,1,0,0,0,0,0,0
1757567,21,13,1992,9,"male",575,1067,747,637,800,44,240,593,560
1757580,20,19,1993,11,"female",0,0,0,12,54,0,0,12,54
1757581,27,31,1986,8,"male",520,4,1,0,0,0,0,0,0
1757605,45,10,1968,10,"male",467,15,4,0,0,0,0,0,0
1757626,25,22,1988,5,"female",323,2,1,0,0,0,0,0,0
1757627,108,21,1905,3,"female",1056,1560,399,274,174,202,107,72,67
1757642,51,17,1962,9,"female",612,204,162,3,3,3,3,0,0
1757672,16,15,1997,5,"male",1495,140,33,0,0,0,0,0,0
1757691,23,13,1990,3,"female",241,378,168,46,130,46,67,0,63
1757694,25,1,1988,1,"female",59,49,33,0,1,0,1,0,0
1757710,39,4,1974,7,"male",598,20,2,0,1,0,1,0,0
1757753,63,22,1950,11,"male",68,0,0,0,0,0,0,0,0
1757770,31,1,1982,1,"male",345,15,9,9,0,9,0,0,0
1757788,18,11,1995,4,"male",37,15,7,4,3,4,3,0,0
1757801,23,20,1990,4,"male",497,2733,2044,412,832,412,503,0,329
1757812,38,8,1975,6,"female",627,148,97,157,21,11,3,146,18
1757817,14,30,1999,6,"male",376,237,158,812,186,797,114,15,72
1757852,14,3,1999,6,"male",0,0,0,0,0,0,0,0,0
1757866,18,17,1995,10,"male",512,802,465,23,39,0,20,23,19
1757870,18,18,1995,9,"female",736,187,112,631,820,440,390,191,430
1757873,18,13,1995,4,"male",568,296,119,3,0,3,0,0,0
1757886,42,14,1971,2,"male",773,2,2,0,0,0,0,0,0
1757911,54,26,1959,11,"female",1357,39,10,3,7,3,5,0,2
1758025,22,26,1991,5,"male",110,484,457,268,174,178,61,90,113
1758084,36,27,1977,1,"female",406,11,8,137,6,137,2,0,4
1758100,31,10,1982,4,"male",922,1605,295,1,1,1,1,0,0
1758163,27,12,1986,6,"male",304,73,37,16,1,4,1,12,0
1758165,64,17,1949,12,"female",344,37,10,12,19,0,9,12,10
1758196,45,19,1968,7,"male",474,163,90,8,77,0,30,8,47
1758206,108,13,1905,9,"male",1568,1481,1012,114,101,109,64,5,37
1758221,55,5,1958,2,"female",328,37,27,16,5,0,3,16,2
1758228,33,28,1980,8,"male",259,156,125,152,100,33,58,119,42
1758246,47,12,1966,7,"female",355,109,78,112,35,85,28,27,7
1758312,29,6,1984,8,"male",758,54,34,14,25,14,22,0,3
1758362,40,20,1973,4,"female",172,41,26,8,25,6,16,2,9
1758363,25,25,1988,5,"female",9,0,0,0,0,0,0,0,0
1758379,20,23,1993,7,"female",187,635,477,201,230,33,129,168,101
1758389,21,26,1992,2,"female",21,1,1,0,0,0,0,0,0
1758443,24,19,1989,7,"male",439,241,143,752,397,691,249,61,148
1758453,58,29,1955,5,"male",628,93,51,4,31,0,8,4,23
1758473,22,28,1991,2,"female",1049,477,388,287,54,85,12,202,42
1758523,63,27,1950,7,"female",597,16,5,0,0,0,0,0,0
1758559,20,15,1993,4,"female",188,106,46,338,130,302,69,36,61
1758571,18,1,1995,1,"male",2,8,8,0,0,0,0,0,0
1758581,61,3,1952,9,"female",248,19,8,0,1,0,1,0,0
1758584,108,10,1905,6,"female",1458,691,361,121,117,0,75,121,42
1758593,17,15,1996,10,"male",1037,401,337,2,0,1,0,1,0
1758608,27,24,1986,1,"male",340,103,76,26,29,26,15,0,14
1758628,23,1,1990,5,"male",27,78,65,0,0,0,0,0,0
1758632,18,27,1995,7,"female",115,4,3,40,11,0,2,40,9
1758675,49,11,1964,4,"male",735,88,76,22,16,2,11,20,5
1758724,31,12,1982,5,"male",126,2,1,1,0,1,0,0,0
1758744,19,12,1994,12,"female",245,101,78,532,579,486,393,46,186
1758757,26,10,1987,7,"female",184,37,23,2,8,1,5,1,3
1758758,68,23,1945,5,"male",910,54,14,0,1,0,0,0,1
1758804,36,3,1977,5,"male",174,14,14,2,0,2,0,0,0
1758828,19,1,1994,11,"male",427,146,105,0,0,0,0,0,0
1758890,70,27,1943,12,"female",355,31,22,8,18,0,3,8,15
1758946,20,17,1993,4,"male",364,67,45,1,0,1,0,0,0
1759010,39,21,1974,10,"female",190,37,32,0,0,0,0,0,0
1759013,43,19,1970,6,"male",38,0,0,0,0,0,0,0,0
1759035,28,6,1985,7,"male",469,72,62,6,14,6,11,0,3
1759036,41,23,1972,1,"male",140,98,78,28,6,28,4,0,2
1759064,36,25,1977,12,"female",1212,115,51,147,129,147,111,0,18
1759078,113,20,1900,6,"male",2131,971,518,227,353,30,121,197,232
1759105,41,28,1972,7,"male",512,27,23,5,5,5,5,0,0
1759113,30,7,1983,12,"male",224,5,5,2,0,0,0,2,0
1759140,46,1,1967,8,"male",762,4,2,2,0,2,0,0,0
1759147,25,20,1988,12,"male",705,231,124,0,1,0,1,0,0
1759157,33,25,1980,3,"female",317,321,295,114,191,114,121,0,70
1759200,23,22,1990,8,"male",78,51,41,6,9,0,8,6,1
1759224,15,16,1998,3,"female",253,69,58,2,2,2,2,0,0
1759247,66,10,1947,7,"male",1680,37,9,1,1,0,0,1,1
1759307,21,26,1992,5,"male",1499,350,222,71,47,71,43,0,4
1759323,26,4,1987,4,"male",397,1,1,0,0,0,0,0,0
1759326,21,1,1992,7,"female",559,398,169,97,189,41,38,56,151
1759331,40,17,1973,1,"female",226,8,6,87,20,0,0,87,20
1759332,22,27,1991,9,"female",325,120,62,2,3,2,3,0,0
1759337,21,19,1992,1,"male",326,90,80,2,0,2,0,0,0
1759338,39,1,1974,1,"male",213,0,0,0,0,0,0,0,0
1759356,79,24,1934,12,"male",884,173,45,141,42,117,10,24,32
1759362,30,12,1983,7,"male",620,421,164,70,12,68,11,2,1
1759372,25,8,1988,11,"male",1204,26,7,0,0,0,0,0,0
1759430,23,10,1990,10,"male",395,223,188,0,0,0,0,0,0
1759452,20,20,1993,11,"male",355,213,43,0,0,0,0,0,0
1759468,26,13,1987,5,"male",638,0,0,0,0,0,0,0,0
1759481,22,21,1991,9,"female",192,36,28,31,7,31,7,0,0
1759502,17,14,1996,11,"male",198,153,105,2,0,2,0,0,0
1759503,20,14,1993,2,"male",16,9,9,0,0,0,0,0,0
1759519,72,10,1941,8,"male",170,19,13,40,9,40,4,0,5
1759524,20,14,1993,2,"male",17,27,23,9,17,9,14,0,3
1759530,49,18,1964,1,"female",505,13,10,25,11,0,1,25,10
1759540,25,22,1988,11,"male",256,89,54,0,15,0,9,0,6
1759556,15,22,1998,7,"female",688,426,234,307,127,39,92,268,35
1759566,14,15,1999,10,"male",28,7,4,51,1,14,0,37,1
1759617,58,1,1955,7,"male",165,36,28,27,28,0,1,27,27
1759621,32,2,1981,11,"female",1111,272,197,2714,2609,2637,2137,77,472
1759665,19,26,1994,6,"male",548,477,396,0,4,0,4,0,0
1759687,108,29,1905,5,"female",1287,37,16,3,3,0,0,3,3
1759734,15,9,1998,2,"male",218,740,73,39,106,0,37,39,69
1759747,16,12,1997,10,"female",311,116,75,23,19,23,15,0,4
1759765,13,14,2000,7,"male",110,136,51,66,0,66,0,0,0
1759769,16,5,1997,8,"male",37,55,19,0,0,0,0,0,0
1759775,26,2,1987,10,"male",237,2,2,0,0,0,0,0,0
1759785,49,5,1964,3,"female",369,3,3,0,0,0,0,0,0
1759786,18,6,1995,6,"male",223,102,91,3,1,0,0,3,1
1759788,17,1,1996,1,"male",134,740,627,330,314,330,296,0,18
1759806,20,1,1993,2,"female",231,5,4,2,2,2,2,0,0
1759808,27,10,1986,6,"male",782,76,31,0,0,0,0,0,0
1759810,18,14,1995,4,"female",318,1014,496,4044,5513,4044,4754,0,759
1759830,20,4,1993,10,"female",297,877,242,110,768,1,482,109,286
1759838,43,25,1970,2,"female",695,303,233,48,64,38,36,10,28
1759840,36,7,1977,2,"male",224,55,46,2,0,0,0,2,0
1759850,42,2,1971,8,"female",239,73,25,6399,1494,6397,801,2,693
1759872,33,1,1980,1,"male",133,4,0,0,0,0,0,0,0
1759875,22,10,1991,3,"male",590,1539,1307,84,273,4,157,80,116
1759877,51,4,1962,11,"female",242,18,13,0,0,0,0,0,0
1759887,42,20,1971,3,"male",394,2,0,53,28,0,0,53,28
1759897,30,27,1983,1,"male",489,22,9,1,0,1,0,0,0
1759911,41,4,1972,1,"male",414,163,92,70,29,70,18,0,11
1759917,28,21,1985,11,"male",275,22,18,1,1,1,1,0,0
1759920,23,19,1990,11,"male",178,2,2,0,0,0,0,0,0
1759950,30,29,1983,9,"female",415,0,0,0,0,0,0,0,0
1759962,59,1,1954,12,"female",387,35,25,37,25,37,16,0,9
1759983,30,3,1983,5,"male",531,80,62,15,7,0,2,15,5
1760016,58,6,1955,9,"female",26,14,9,0,0,0,0,0,0
1760041,57,21,1956,2,"male",686,45,30,26,12,0,2,26,10
1760050,55,6,1958,8,"female",1033,109,61,405,222,246,74,159,148
1760071,19,11,1994,10,"female",748,276,205,961,235,748,123,213,112
1760076,20,8,1993,10,"male",67,15,2,11,10,11,6,0,4
1760109,25,26,1988,10,"male",193,337,322,897,640,49,284,848,356
1760137,19,2,1994,9,"male",540,144,111,25,1,0,1,25,0
1760146,27,7,1986,2,"male",497,21,15,0,0,0,0,0,0
1760173,17,30,1996,10,NA,230,96,43,9,6,3,1,6,5
1760176,26,27,1987,6,"female",793,111,46,203,406,123,304,80,102
1760214,103,8,1910,9,"female",1862,879,431,70,134,14,40,56,94
1760236,33,10,1980,2,"female",31,89,83,2409,1549,2409,784,0,765
1760239,53,14,1960,7,"female",638,673,318,36,1510,8,302,28,1208
1760241,102,26,1911,12,"male",1112,684,405,27,38,27,29,0,9
1760243,28,1,1985,2,"male",361,1,1,0,0,0,0,0,0
1760259,50,1,1963,6,"female",177,16,14,28,11,28,10,0,1
1760277,15,3,1998,2,"male",592,121,81,17,50,17,38,0,12
1760304,37,8,1976,9,"female",112,57,50,45,26,45,21,0,5
1760346,28,11,1985,12,"female",394,60,20,7,14,7,12,0,2
1760367,20,6,1993,12,"male",696,31,17,0,0,0,0,0,0
1760396,18,11,1995,8,"male",7,2,2,0,0,0,0,0,0
1760442,30,26,1983,11,"female",734,225,110,131,124,74,70,57,54
1760472,14,2,1999,2,"male",511,139,82,2,27,0,1,2,26
1760488,43,12,1970,12,"female",50,32,24,15,0,15,0,0,0
1760517,20,13,1993,11,"male",342,182,155,1,1,0,0,1,1
1760556,21,8,1992,11,"male",685,195,111,4,167,3,123,1,44
1760616,31,29,1982,10,"male",61,82,77,1,0,1,0,0,0
1760628,54,19,1959,3,"female",233,7,4,1,1,1,1,0,0
1760633,57,29,1956,2,"male",1297,42,23,0,0,0,0,0,0
1760642,47,10,1966,11,"male",928,1,0,0,0,0,0,0,0
1760663,14,7,1999,6,"male",246,94,49,26,8,0,6,26,2
1760672,55,18,1958,11,"female",1575,232,136,247,48,0,11,247,37
1760713,69,31,1944,12,"male",1691,144,47,86,136,9,43,77,93
1760730,21,24,1992,1,"male",768,72,52,2,0,2,0,0,0
1760734,80,8,1933,1,"female",2097,57,9,117,13,0,11,117,2
1760737,85,1,1928,1,"male",700,130,76,3,3,3,3,0,0
1760749,27,17,1986,8,"male",386,70,64,0,0,0,0,0,0
1760773,34,24,1979,9,"female",178,4,2,13,1,10,0,3,1
1760783,27,9,1986,4,"male",328,87,41,1,7,1,3,0,4
1760799,14,6,1999,12,"male",260,233,175,15,6,1,2,14,4
1760849,23,23,1990,12,"female",697,107,77,9,3,9,3,0,0
1760870,19,29,1994,8,"female",303,156,110,637,603,588,222,49,381
1760879,25,13,1988,6,"female",374,24,19,1,0,1,0,0,0
1760927,26,9,1987,12,"male",270,72,49,4,6,4,6,0,0
1760930,63,29,1950,11,"male",236,112,49,2,79,2,72,0,7
1760937,20,7,1993,4,"male",502,452,303,5,0,5,0,0,0
1760942,22,23,1991,6,"male",252,42,20,6,9,6,7,0,2
1760954,19,17,1994,7,"female",759,42,20,273,340,0,9,273,331
1760966,23,14,1990,3,"male",469,61,33,15,33,15,33,0,0
1760998,14,26,1999,8,"male",52,112,100,40,18,40,17,0,1
1761007,39,18,1974,3,"male",3,1,1,1,2,1,2,0,0
1761029,29,24,1984,4,"female",563,161,115,20,60,20,28,0,32
1761031,18,11,1995,10,"female",30,73,44,8,552,8,415,0,137
1761055,21,19,1992,8,"female",1093,95,56,219,55,125,22,94,33
1761059,36,16,1977,6,"male",1,7,7,1,4,1,4,0,0
1761080,26,5,1987,12,"male",314,82,17,0,7,0,7,0,0
1761096,23,11,1990,4,"male",266,81,43,61,5,61,2,0,3
1761113,19,13,1994,11,"male",98,46,43,3,5,0,2,3,3
1761115,45,13,1968,5,"female",291,38,26,25,41,0,19,25,22
1761117,29,16,1984,11,"female",566,305,162,65,4,65,4,0,0
1761126,50,11,1963,11,"female",629,9,3,28,2,3,2,25,0
1761178,27,14,1986,11,"male",182,18,18,1,0,0,0,1,0
1761193,45,1,1968,2,"female",264,55,35,108,51,8,11,100,40
1761197,57,13,1956,2,"male",1010,3,0,21,0,0,0,21,0
1761218,61,26,1952,4,"female",1743,80,33,31,49,27,32,4,17
1761239,18,5,1995,3,"female",564,1733,865,849,1170,239,681,610,489
1761256,56,30,1957,8,"female",146,16,10,13,8,13,3,0,5
1761259,20,1,1993,1,"male",136,36,28,0,5,0,4,0,1
1761289,30,21,1983,4,"male",786,172,123,7,1,7,1,0,0
1761298,16,27,1997,4,"male",75,63,46,0,0,0,0,0,0
1761327,23,22,1990,1,"male",450,41,21,0,3,0,2,0,1
1761338,14,1,1999,1,"male",222,77,59,1,2,1,1,0,1
1761340,16,1,1997,12,"male",331,1218,1018,90,3,29,3,61,0
1761368,16,11,1997,9,"female",249,168,92,1376,577,1368,224,8,353
1761394,13,15,2000,1,"male",227,422,388,18,1,18,1,0,0
1761441,23,21,1990,9,"male",19,44,39,49,0,49,0,0,0
1761454,20,8,1993,1,"male",25,15,8,4,0,4,0,0,0
1761459,27,6,1986,11,"male",590,207,129,8,2,3,1,5,1
1761464,18,30,1995,6,"female",917,510,352,640,482,441,262,199,220
1761471,23,1,1990,1,"male",315,74,54,1,3,1,3,0,0
1761484,18,25,1995,11,"male",43,46,23,83,34,82,23,1,11
1761497,44,2,1969,1,"male",547,83,36,0,0,0,0,0,0
1761509,19,13,1994,4,"female",355,51,11,2,0,2,0,0,0
1761517,20,11,1993,2,"male",341,21,20,36,12,0,7,36,5
1761524,99,27,1914,2,"male",1572,182,50,0,0,0,0,0,0
1761539,30,27,1983,5,"male",445,149,77,5,2,5,2,0,0
1761625,67,5,1946,5,"male",2173,49,21,108,158,53,76,55,82
1761627,24,1,1989,7,"female",298,37,26,27,4,10,2,17,2
1761650,17,19,1996,6,"male",80,69,65,7,0,7,0,0,0
1761653,18,29,1995,12,"female",420,270,146,257,77,257,31,0,46
1761658,55,2,1958,3,"male",668,33,11,0,0,0,0,0,0
1761663,26,22,1987,8,"male",379,2,0,0,0,0,0,0,0
1761668,71,3,1942,12,"female",114,33,17,308,94,308,92,0,2
1761681,56,15,1957,8,"female",810,222,133,46,101,46,43,0,58
1761692,27,25,1986,2,"male",68,5,4,0,0,0,0,0,0
1761700,25,1,1988,1,"male",242,53,26,115,67,115,60,0,7
1761701,57,27,1956,1,"male",769,83,58,77,67,77,22,0,45
1761720,24,31,1989,1,"female",777,394,280,13,27,13,23,0,4
1761725,38,17,1975,2,"female",170,22,20,105,96,105,80,0,16
1761741,18,6,1995,7,"male",316,150,119,12,12,10,4,2,8
1761751,28,5,1985,9,"male",524,277,204,133,190,133,121,0,69
1761769,24,10,1989,6,"female",512,196,158,88,190,26,108,62,82
1761775,30,14,1983,9,"female",1125,610,493,0,0,0,0,0,0
1761791,46,3,1967,3,"female",438,42,31,66,19,66,17,0,2
1761801,26,17,1987,8,"male",444,73,48,0,0,0,0,0,0
1761810,95,11,1918,9,"male",776,433,345,7,0,1,0,6,0
1761814,18,17,1995,9,"male",277,292,267,30,149,29,98,1,51
1761815,26,3,1987,1,"female",356,45,25,59,54,59,10,0,44
1761832,21,5,1992,3,"female",1860,1000,484,242,458,43,242,199,216
1761846,59,28,1954,12,"male",27,4,4,7,8,7,7,0,1
1761864,24,23,1989,3,"male",389,45,17,14,71,14,67,0,4
1761869,22,10,1991,2,"female",323,8,6,8,2,8,2,0,0
1761879,14,8,1999,6,"female",67,0,0,0,0,0,0,0,0
1761890,13,6,2000,6,"male",55,54,38,50,28,50,20,0,8
1761898,30,17,1983,1,"female",320,42,36,51,62,51,36,0,26
1761909,61,12,1952,6,"female",484,218,167,406,96,259,64,147,32
1761917,28,3,1985,5,"male",103,214,79,119,1,0,0,119,1
1761934,51,12,1962,2,"male",431,20,11,29,1,29,1,0,0
1761961,35,12,1978,9,"male",184,1,1,0,0,0,0,0,0
1761964,30,26,1983,6,"female",178,20,18,1,11,1,5,0,6
1761977,22,22,1991,4,"female",570,1,1,0,0,0,0,0,0
1761988,108,13,1905,3,"female",1190,208,84,459,113,0,57,459,56
1761989,23,14,1990,2,"male",598,322,298,16,0,14,0,2,0
1762047,108,22,1905,4,"male",145,86,50,0,0,0,0,0,0
1762059,52,17,1961,9,"female",1486,32,11,0,0,0,0,0,0
1762085,66,23,1947,9,"female",1873,74,37,0,0,0,0,0,0
1762092,26,9,1987,7,"male",150,77,43,0,0,0,0,0,0
1762111,18,22,1995,1,"female",405,164,48,7,12,7,9,0,3
1762135,22,3,1991,8,"female",500,32,23,78,11,78,3,0,8
1762145,17,18,1996,12,"male",144,55,18,0,23,0,12,0,11
1762151,26,3,1987,9,"male",305,106,68,22,23,18,11,4,12
1762192,43,14,1970,7,"male",605,61,40,1,3,1,2,0,1
1762200,43,7,1970,12,"male",700,123,75,9,2,8,1,1,1
1762212,17,1,1996,2,"female",367,410,390,9,10,9,8,0,2
1762237,33,5,1980,5,"male",152,26,19,0,0,0,0,0,0
1762250,17,9,1996,1,"male",33,25,6,0,1,0,1,0,0
1762255,24,5,1989,8,"male",119,78,77,1,6,1,2,0,4
1762266,52,2,1961,10,"male",890,262,209,832,1240,832,925,0,315
1762320,16,9,1997,5,"male",146,79,66,1,0,1,0,0,0
1762327,18,25,1995,1,"female",274,218,158,194,1319,186,443,8,876
1762357,42,29,1971,5,"male",61,16,16,0,0,0,0,0,0
1762380,19,19,1994,10,"male",364,479,410,144,145,141,85,3,60
1762398,63,20,1950,3,"female",39,22,11,16,9,0,0,16,9
1762419,16,19,1997,3,"female",482,1818,289,241,402,240,267,1,135
1762430,18,28,1995,3,"male",413,1020,783,708,1181,708,983,0,198
1762446,54,16,1959,10,"male",157,6,3,0,0,0,0,0,0
1762468,18,25,1995,4,"male",284,72,44,2,13,2,12,0,1
1762484,21,24,1992,6,"female",668,414,236,97,84,97,66,0,18
1762512,20,7,1993,8,"male",20,5,4,4,3,4,3,0,0
1762518,17,8,1996,9,"female",524,29,14,44,16,44,16,0,0
1762520,33,15,1980,5,"female",98,5,2,0,0,0,0,0,0
1762527,50,19,1963,12,"male",482,116,89,1,1,0,0,1,1
1762561,25,18,1988,9,"male",563,217,145,0,6,0,6,0,0
1762567,67,8,1946,11,"male",1060,45,22,0,1,0,1,0,0
1762577,15,10,1998,1,"male",324,54,47,1,13,1,10,0,3
1762579,41,16,1972,10,"female",343,66,49,20,11,20,1,0,10
1762645,17,28,1996,8,"male",62,26,23,43,6,43,4,0,2
1762680,108,1,1905,4,"male",2009,23,8,0,0,0,0,0,0
1762683,40,13,1973,1,"male",455,111,23,34,58,34,36,0,22
1762699,28,18,1985,7,"male",852,290,22,2,1,0,1,2,0
1762706,21,11,1992,2,"male",216,1,1,0,0,0,0,0,0
1762715,16,1,1997,2,"male",817,81,43,6,5,6,3,0,2
1762769,31,21,1982,4,"female",236,12,1,1,0,1,0,0,0
1762772,49,5,1964,5,"male",892,158,88,95,297,72,161,23,136
1762791,34,1,1979,6,"male",473,11,7,8,15,0,0,8,15
1762805,26,5,1987,7,"male",577,117,96,70,71,22,18,48,53
1762807,23,10,1990,4,"male",600,22,4,1,0,0,0,1,0
1762817,25,9,1988,9,"male",822,30,23,0,5,0,3,0,2
1762889,25,27,1988,5,"male",763,199,142,23,22,5,13,18,9
1762910,34,31,1979,3,"male",230,90,49,12,12,12,9,0,3
1762961,32,1,1981,12,"male",303,35,20,0,0,0,0,0,0
1763012,50,4,1963,8,"female",461,35,16,42,93,35,68,7,25
1763018,46,10,1967,10,"male",1115,20,9,3,5,2,2,1,3
1763033,21,15,1992,6,"male",590,12,7,0,0,0,0,0,0
1763035,46,2,1967,11,"female",189,99,50,44,46,44,40,0,6
1763036,18,18,1995,8,"female",85,109,26,84,244,3,152,81,92
1763047,77,26,1936,6,"male",591,67,44,0,0,0,0,0,0
1763055,53,23,1960,8,"female",11,89,87,145,100,0,42,145,58
1763059,64,27,1949,10,"female",1432,147,126,0,0,0,0,0,0
1763065,18,24,1995,12,"male",386,213,137,1,53,1,47,0,6
1763066,22,28,1991,7,"female",29,4,3,59,44,59,27,0,17
1763069,26,13,1987,3,"male",337,47,21,22,3,22,2,0,1
1763081,32,13,1981,12,"female",155,41,36,15,2,0,1,15,1
1763100,47,9,1966,10,"female",62,53,13,148,81,79,63,69,18
1763110,17,22,1996,2,"male",50,2,2,0,0,0,0,0,0
1763157,26,1,1987,1,"male",453,14,3,0,0,0,0,0,0
1763160,28,17,1985,7,"female",948,67,40,1458,1152,221,351,1237,801
1763164,23,1,1990,12,"female",674,4371,768,21,23,21,17,0,6
1763193,23,14,1990,1,"male",263,909,244,170,638,168,450,2,188
1763234,49,17,1964,6,"female",2205,196,53,157,47,27,28,130,19
1763242,38,3,1975,8,"female",969,162,62,429,222,74,144,355,78
1763267,19,14,1994,2,"female",374,263,80,34,56,34,46,0,10
1763303,17,8,1996,4,"male",596,82,32,1,4,1,3,0,1
1763348,16,11,1997,7,"female",201,579,49,0,7,0,6,0,1
1763368,39,3,1974,6,"male",560,68,5,0,1,0,1,0,0
1763391,23,14,1990,5,"female",404,0,0,0,0,0,0,0,0
1763423,26,7,1987,1,"female",1002,82,36,26,10,26,10,0,0
1763427,18,10,1995,9,"male",297,722,478,59,336,58,195,1,141
1763461,28,3,1985,9,"male",1021,34,10,1,1,0,1,1,0
1763464,40,25,1973,8,"female",876,313,145,423,388,249,102,174,286
1763500,35,4,1978,12,"female",183,682,76,5880,1375,5880,1340,0,35
1763523,58,10,1955,3,"male",767,51,33,33,10,0,9,33,1
1763549,19,16,1994,10,"female",991,227,165,216,199,216,195,0,4
1763553,15,23,1998,3,"female",361,1114,151,107,80,100,24,7,56
1763565,57,26,1956,10,"male",1196,151,77,0,0,0,0,0,0
1763590,25,9,1988,4,"male",300,72,36,0,0,0,0,0,0
1763592,22,22,1991,4,"female",66,135,29,6,28,6,28,0,0
1763662,18,12,1995,8,"female",942,1263,702,3793,4487,3730,4245,63,242
1763665,70,10,1943,8,"female",87,15,3,1,3,0,3,1,0
1763671,69,17,1944,9,"female",304,58,26,1,17,0,9,1,8
1763674,18,25,1995,9,"female",273,306,40,0,0,0,0,0,0
1763679,20,15,1993,8,"male",87,19,5,1,8,1,2,0,6
1763681,15,16,1998,12,"male",335,82,78,13,1,13,1,0,0
1763742,58,15,1955,5,"female",525,12,3,7,0,7,0,0,0
1763787,103,4,1910,2,"male",881,132,93,6,5,6,5,0,0
1763792,44,12,1969,12,"female",508,49,21,86,50,86,43,0,7
1763813,108,1,1905,1,"male",41,13,0,3,113,0,4,3,109
1763844,35,29,1978,9,"male",122,227,183,1,9,1,6,0,3
1763847,28,4,1985,3,"male",68,41,33,0,0,0,0,0,0
1763856,18,5,1995,4,"male",24,1,1,0,0,0,0,0,0
1763875,24,1,1989,2,"female",486,246,192,446,322,436,211,10,111
1763918,18,6,1995,2,"male",200,160,40,5,9,5,4,0,5
1763938,20,14,1993,11,"female",165,1964,99,146,1706,146,1547,0,159
1763948,67,23,1946,10,"female",613,41,32,0,0,0,0,0,0
1763969,21,18,1992,7,"female",165,2,1,46,16,12,0,34,16
1763978,53,22,1960,8,"male",381,35,15,0,2,0,2,0,0
1763989,36,3,1977,10,"male",72,19,15,13,7,13,3,0,4
1763995,15,15,1998,9,"male",313,68,64,154,2,0,0,154,2
1764024,58,20,1955,12,"female",623,29,15,71,39,71,37,0,2
1764031,25,17,1988,6,"female",515,127,109,29,49,29,40,0,9
1764053,20,23,1993,2,"female",144,84,68,278,168,219,26,59,142
1764056,49,14,1964,5,"female",165,34,24,9,17,0,14,9,3
1764063,39,16,1974,6,"male",646,77,61,9,5,9,3,0,2
1764100,55,30,1958,6,"male",704,12,9,0,0,0,0,0,0
1764125,53,1,1960,5,"male",802,60,14,9,20,4,7,5,13
1764144,25,1,1988,1,"female",27,7,5,82,8,82,8,0,0
1764161,53,21,1960,8,"female",1794,296,169,918,165,632,75,286,90
1764182,20,31,1993,7,"female",95,1,1,1,0,1,0,0,0
1764206,32,11,1981,4,"female",194,348,283,561,373,561,287,0,86
1764213,75,18,1938,3,"female",1579,92,58,81,13,0,7,81,6
1764224,33,13,1980,3,"male",449,0,0,0,0,0,0,0,0
1764242,20,1,1993,1,"female",346,76,19,0,0,0,0,0,0
1764245,29,7,1984,12,"female",502,63,28,6,5,6,4,0,1
1764249,22,13,1991,11,"male",41,86,76,1,1,1,1,0,0
1764254,51,6,1962,6,"male",635,447,287,31,34,27,29,4,5
1764271,63,23,1950,6,"female",450,84,68,3,75,0,18,3,57
1764294,19,21,1994,7,"male",92,109,72,0,0,0,0,0,0
1764334,27,5,1986,3,"male",313,80,72,6,14,6,12,0,2
1764337,21,7,1992,11,"male",114,16,16,0,0,0,0,0,0
1764354,103,24,1910,11,"female",423,77,44,3,1,3,1,0,0
1764384,33,19,1980,12,"male",235,19,16,0,0,0,0,0,0
1764393,72,14,1941,2,"male",1002,13,6,22,1,0,1,22,0
1764417,33,22,1980,8,"male",215,165,39,496,66,496,43,0,23
1764425,22,30,1991,1,"female",504,1822,134,62,427,62,290,0,137
1764442,41,5,1972,2,"female",229,62,34,48,59,48,9,0,50
1764450,33,9,1980,4,"male",209,10,10,5,2,5,2,0,0
1764471,29,5,1984,6,"female",813,150,57,461,357,149,187,312,170
1764498,18,10,1995,7,"female",526,1533,422,7799,4520,7547,3534,252,986
1764505,48,10,1965,1,"female",411,57,43,19,76,19,68,0,8
1764526,41,27,1972,11,"female",825,65,22,525,270,525,190,0,80
1764528,17,10,1996,10,"female",20,234,66,27,85,27,58,0,27
1764531,62,15,1951,6,"male",1576,195,25,5,25,5,16,0,9
1764546,24,15,1989,4,"female",300,114,64,21,69,21,54,0,15
1764549,27,30,1986,4,"female",385,71,31,30,20,16,6,14,14
1764571,23,15,1990,5,"male",758,1,0,0,1,0,0,0,1
1764574,33,1,1980,1,"male",9,20,19,1,5,1,1,0,4
1764596,76,25,1937,1,"male",1782,207,58,35,179,31,83,4,96
1764639,33,3,1980,9,"female",189,35,25,631,309,631,165,0,144
1764650,66,4,1947,9,"female",588,19,10,31,6,31,5,0,1
1764691,22,25,1991,10,"male",229,128,106,21,6,0,3,21,3
1764717,24,18,1989,9,"male",353,174,133,0,12,0,8,0,4
1764734,64,18,1949,1,"male",334,133,78,663,135,0,20,663,115
1764741,26,1,1987,1,"male",66,28,26,8,0,8,0,0,0
1764783,18,14,1995,6,"female",433,229,97,9,0,9,0,0,0
1764785,55,4,1958,10,"female",866,78,49,348,39,237,35,111,4
1764796,68,29,1945,10,"female",1285,4358,1809,131,1024,131,543,0,481
1764821,14,23,1999,8,"female",50,2,2,0,3,0,3,0,0
1764854,29,19,1984,10,"female",168,72,49,247,86,247,83,0,3
1764883,19,19,1994,9,"female",392,39,19,20,23,20,14,0,9
1764884,24,2,1989,2,"male",75,39,31,14,13,7,8,7,5
1764885,29,4,1984,10,"female",16,1,1,0,1,0,1,0,0
1764886,38,27,1975,12,"male",624,13,8,19,3,19,2,0,1
1764912,30,6,1983,12,"male",18,20,5,15,34,15,4,0,30
1764936,90,3,1923,3,"male",1724,400,359,1026,1030,1026,611,0,419
1764969,54,31,1959,5,"female",2206,229,102,753,642,283,384,470,258
1764974,23,11,1990,5,"male",232,558,520,654,51,654,36,0,15
1764984,16,13,1997,6,"male",203,175,114,0,43,0,43,0,0
1765004,74,3,1939,5,"male",1573,32,12,0,0,0,0,0,0
1765041,30,23,1983,9,"male",0,0,0,1,0,1,0,0,0
1765077,25,9,1988,9,"female",291,20,17,88,3,88,2,0,1
1765078,46,9,1967,4,"female",563,89,51,126,12,6,4,120,8
1765082,29,18,1984,10,"female",323,10,10,0,5,0,1,0,4
1765096,25,21,1988,10,"female",333,263,134,99,139,99,90,0,49
1765102,20,13,1993,7,"female",317,290,248,20,12,20,1,0,11
1765117,26,26,1987,3,"female",415,100,67,11,109,0,15,11,94
1765127,60,31,1953,7,"female",1059,345,162,249,701,248,215,1,486
1765129,24,10,1989,10,"male",491,67,23,71,4,12,2,59,2
1765134,22,22,1991,12,"male",783,367,256,4,4,0,0,4,4
1765178,40,14,1973,9,"female",338,21,9,51,47,44,36,7,11
1765194,25,8,1988,3,"female",1617,268,46,0,15,0,11,0,4
1765204,61,17,1952,2,"female",426,40,23,647,373,647,144,0,229
1765216,14,19,1999,3,"male",245,26,23,30,5,30,5,0,0
1765225,26,20,1987,2,"male",259,89,20,16,13,16,12,0,1
1765230,16,17,1997,12,"female",146,93,48,0,0,0,0,0,0
1765251,68,23,1945,5,"female",144,33,23,10,2,6,1,4,1
1765259,19,21,1994,10,"female",241,112,70,179,277,178,189,1,88
1765260,27,10,1986,12,"male",277,85,55,9,61,3,49,6,12
1765281,50,8,1963,8,"male",286,47,18,4,5,4,3,0,2
1765284,106,2,1907,6,"male",1247,257,114,6,5,1,1,5,4
1765290,77,5,1936,3,"female",1612,22,7,3,1,0,1,3,0
1765304,17,14,1996,4,"male",291,70,57,2,1,2,1,0,0
1765307,17,14,1996,10,"male",175,48,44,0,0,0,0,0,0
1765317,56,22,1957,11,"female",903,28,22,30,0,30,0,0,0
1765389,17,3,1996,3,"female",381,75,37,0,5,0,4,0,1
1765396,17,10,1996,10,"male",157,308,287,49,2,49,0,0,2
1765397,25,29,1988,3,"male",312,40,38,0,8,0,0,0,8
1765418,21,12,1992,8,"male",261,51,37,9,42,9,39,0,3
1765437,23,22,1990,10,"male",489,130,77,110,25,103,18,7,7
1765445,54,18,1959,3,"male",202,37,31,1,7,1,4,0,3
1765503,19,1,1994,2,"female",696,269,139,41,24,41,23,0,1
1765541,61,23,1952,7,"male",461,342,296,57,21,0,1,57,20
1765555,20,4,1993,4,"female",197,18,7,0,0,0,0,0,0
1765572,32,7,1981,5,"female",559,523,279,159,108,150,25,9,83
1765587,18,8,1995,3,"female",471,416,281,1410,902,1300,647,110,255
1765592,23,29,1990,4,"male",517,1245,1069,55,34,55,32,0,2
1765593,27,30,1986,7,"female",89,95,37,12,1,12,1,0,0
1765598,64,1,1949,1,"male",205,147,142,0,0,0,0,0,0
1765626,19,16,1994,2,"female",192,75,61,38,30,38,30,0,0
1765632,21,21,1992,4,"female",503,442,262,210,160,210,151,0,9
1765637,22,22,1991,2,"male",687,285,244,0,0,0,0,0,0
1765643,55,21,1958,12,"male",1812,199,90,352,636,306,352,46,284
1765647,28,1,1985,6,"female",494,0,0,0,0,0,0,0,0
1765654,48,13,1965,10,"male",542,1,1,0,0,0,0,0,0
1765666,16,1,1997,1,"male",9,10,10,0,0,0,0,0,0
1765671,21,29,1992,7,"female",975,2861,1106,563,973,362,493,201,480
1765684,65,1,1948,12,"female",471,26,22,12,0,0,0,12,0
1765721,51,1,1962,2,"female",351,58,40,364,108,355,43,9,65
1765767,72,11,1941,5,"female",526,37,28,0,1,0,0,0,1
1765793,41,1,1972,1,"male",395,25,10,0,1,0,1,0,0
1765801,20,6,1993,9,"male",91,1,1,4,3,4,3,0,0
1765804,32,26,1981,4,"female",505,79,37,48,230,48,171,0,59
1765841,48,15,1965,9,"female",371,47,29,18,1,17,0,1,1
1765852,17,1,1996,8,"female",14,0,0,0,0,0,0,0,0
1765863,25,20,1988,1,"female",646,117,54,64,158,57,146,7,12
1765868,20,24,1993,9,"female",572,1746,830,2985,5786,594,4843,2391,943
1765913,49,22,1964,10,"male",312,11,4,1,0,1,0,0,0
1765922,78,24,1935,2,"male",122,28,17,0,8,0,2,0,6
1765961,62,5,1951,2,"male",777,32,17,3,2,2,1,1,1
1766004,60,4,1953,7,"male",1579,205,160,8,6,1,5,7,1
1766048,106,13,1907,9,"female",1488,264,185,225,126,212,92,13,34
1766058,36,4,1977,11,"male",258,63,15,1,0,1,0,0,0
1766082,14,13,1999,9,"male",214,926,695,1155,544,1155,471,0,73
1766087,25,10,1988,8,"male",574,197,174,3,14,3,10,0,4
1766089,20,5,1993,7,"male",638,144,80,56,10,38,4,18,6
1766116,57,5,1956,6,"female",1930,68,50,4,6,0,4,4,2
1766158,14,24,1999,6,"female",41,174,14,30,18,29,11,1,7
1766188,17,23,1996,5,"female",207,545,428,93,12,10,1,83,11
1766231,55,21,1958,1,"male",530,49,39,4,42,0,18,4,24
1766274,60,15,1953,2,"male",1709,369,191,153,129,99,46,54,83
1766276,34,14,1979,6,"male",237,123,81,67,4,67,3,0,1
1766285,21,19,1992,3,"female",1269,2047,640,5155,4077,1770,2522,3385,1555
1766297,26,6,1987,9,"male",84,1,1,28,0,1,0,27,0
1766317,103,22,1910,5,"female",1023,338,179,2,138,0,126,2,12
1766329,23,4,1990,6,"female",474,116,42,18,37,18,24,0,13
1766348,23,27,1990,4,"female",236,894,111,223,655,223,545,0,110
1766350,22,21,1991,9,"female",348,54,20,8,22,7,1,1,21
1766366,41,9,1972,5,"male",242,128,102,2,29,2,13,0,16
1766379,47,9,1966,12,"female",582,129,84,139,164,81,121,58,43
1766396,68,3,1945,2,"male",1009,728,462,33,28,33,22,0,6
1766408,81,4,1932,5,"female",1562,466,111,57,534,24,380,33,154
1766412,34,7,1979,10,"female",9,29,20,15,10,15,9,0,1
1766451,53,24,1960,11,"female",708,205,133,8,133,0,8,8,125
1766452,46,10,1967,6,"male",1008,26,9,19,2,18,2,1,0
1766460,18,23,1995,2,"male",365,136,77,1,0,1,0,0,0
1766468,14,5,1999,2,"male",95,233,195,121,6,121,3,0,3
1766476,24,3,1989,7,"male",367,434,328,47,162,47,105,0,57
1766497,38,25,1975,12,"male",207,12,12,34,3,34,3,0,0
1766512,14,9,1999,6,"male",455,93,26,1,0,1,0,0,0
1766548,33,9,1980,2,"male",396,238,216,5,5,5,4,0,1
1766567,16,3,1997,4,"female",156,234,82,82,45,82,30,0,15
1766597,14,10,1999,10,"female",140,50,29,61,7,0,2,61,5
1766604,24,12,1989,1,"male",12,0,0,0,0,0,0,0,0
1766641,23,24,1990,3,NA,965,474,335,0,4,0,2,0,2
1766669,16,29,1997,8,"male",28,38,33,7,24,7,8,0,16
1766684,58,30,1955,6,NA,2090,39,17,60,62,60,43,0,19
1766686,28,26,1985,8,"male",368,182,92,68,27,68,13,0,14
1766723,54,4,1959,8,"female",704,50,31,11,44,0,13,11,31
1766742,63,7,1950,9,"male",942,39,19,0,1,0,1,0,0
1766765,60,6,1953,4,"female",847,122,85,404,10,398,5,6,5
1766792,42,30,1971,4,"male",205,1,0,0,0,0,0,0,0
1766810,18,3,1995,9,"female",99,87,57,8593,5674,719,1144,7874,4530
1766829,25,26,1988,7,"female",361,74,25,39,63,39,44,0,19
1766834,21,11,1992,6,"male",172,0,0,0,0,0,0,0,0
1766843,17,26,1996,4,"female",606,4759,1507,420,1190,4,866,416,324
1766847,19,10,1994,11,"male",54,2,2,2,2,2,2,0,0
1766875,66,10,1947,8,"male",220,57,4,20,15,8,8,12,7
1766876,20,30,1993,4,"male",266,630,590,109,77,51,58,58,19
1766880,40,29,1973,11,"male",813,170,60,0,0,0,0,0,0
1766888,15,25,1998,9,"male",353,133,71,9,14,0,1,9,13
1766889,108,25,1905,4,"female",906,25,17,83,24,0,4,83,20
1766931,16,28,1997,7,"female",437,265,109,18,57,0,12,18,45
1766935,52,3,1961,3,"female",868,28,20,32,101,32,61,0,40
1766950,28,20,1985,2,"male",347,90,64,7,34,0,14,7,20
1766963,21,10,1992,7,"male",550,8,5,0,0,0,0,0,0
1766969,33,18,1980,4,"male",273,46,35,0,2,0,0,0,2
1766978,25,5,1988,1,"female",131,351,88,16732,4913,16732,4679,0,234
1766981,18,12,1995,9,"male",24,29,22,0,0,0,0,0,0
1766991,18,22,1995,9,"female",137,80,54,206,331,206,187,0,144
1767028,26,1,1987,1,"female",412,0,0,0,0,0,0,0,0
1767052,26,25,1987,2,"male",237,155,131,12,5,12,5,0,0
1767090,43,1,1970,1,"female",235,162,80,233,893,233,422,0,471
1767109,22,29,1991,10,"male",177,123,98,24,93,24,86,0,7
1767129,57,20,1956,8,"male",628,52,45,4,1,4,0,0,1
1767150,15,14,1998,5,"male",284,382,258,1,0,1,0,0,0
1767161,27,16,1986,3,"male",299,91,17,5,10,5,5,0,5
1767178,26,4,1987,4,"male",469,157,120,2,7,2,4,0,3
1767188,23,13,1990,5,"male",250,551,266,73,190,3,64,70,126
1767208,54,29,1959,10,"female",1186,12,5,1,5,0,2,1,3
1767217,38,25,1975,1,"male",194,70,29,0,5,0,3,0,2
1767243,29,25,1984,10,"male",339,31,13,2,3,2,3,0,0
1767300,16,16,1997,12,"female",323,98,56,833,333,833,32,0,301
1767309,30,2,1983,4,"male",257,125,119,0,12,0,2,0,10
1767338,19,9,1994,11,"male",598,873,688,86,55,86,49,0,6
1767356,24,10,1989,10,"male",253,42,10,0,0,0,0,0,0
1767357,17,13,1996,8,"female",328,597,370,2797,1007,2527,760,270,247
1767359,42,10,1971,1,"male",46,3,3,4,3,4,3,0,0
1767375,17,22,1996,8,"female",266,308,77,180,228,180,113,0,115
1767378,52,21,1961,6,"female",531,29,17,89,15,0,3,89,12
1767379,22,21,1991,4,"male",678,473,447,1,37,1,23,0,14
1767398,34,28,1979,10,"female",735,202,67,1630,1214,898,458,732,756
1767402,23,15,1990,10,"male",258,162,89,31,11,31,10,0,1
1767414,19,10,1994,7,"female",646,114,45,7,10,7,6,0,4
1767419,16,17,1997,9,"male",299,20,14,5,0,5,0,0,0
1767503,69,18,1944,6,"male",383,120,40,228,102,0,31,228,71
1767504,31,30,1982,3,"female",800,142,105,289,75,285,51,4,24
1767523,30,3,1983,1,"male",153,4,3,0,0,0,0,0,0
1767525,18,24,1995,10,"male",252,86,50,3,3,3,3,0,0
1767540,53,7,1960,5,"female",368,16,14,51,5,0,1,51,4
1767544,16,8,1997,2,"male",334,5,5,5,0,0,0,5,0
1767625,19,25,1994,7,"female",236,122,78,13,9,13,7,0,2
1767632,76,26,1937,11,"female",1268,44,25,13,5,0,4,13,1
1767642,20,17,1993,1,"female",126,115,31,96,231,96,185,0,46
1767680,57,14,1956,3,"female",176,14,13,0,0,0,0,0,0
1767682,78,28,1935,11,"female",174,38,24,1,1,0,1,1,0
1767692,20,18,1993,6,"female",476,3599,2198,7594,15413,5373,6189,2221,9224
1767707,43,3,1970,3,"female",210,21,17,0,0,0,0,0,0
1767722,20,18,1993,12,"male",215,12,6,0,0,0,0,0,0
1767728,18,11,1995,6,"male",114,754,511,529,935,487,837,42,98
1767784,14,21,1999,7,"male",329,170,88,1,16,1,16,0,0
1767788,25,19,1988,9,"female",176,562,464,494,442,494,391,0,51
1767799,19,24,1994,12,"female",427,84,57,41,13,31,4,10,9
1767838,18,21,1995,7,"male",1033,1038,716,152,851,101,629,51,222
1767925,20,20,1993,11,"female",220,298,233,764,1072,248,591,516,481
1767928,26,25,1987,4,"male",237,109,103,6,0,6,0,0,0
1767940,57,11,1956,12,"female",377,2,1,2,0,2,0,0,0
1767992,32,7,1981,3,"male",550,4,1,0,2,0,2,0,0
1767994,20,1,1993,1,"male",367,159,142,149,23,149,20,0,3
1768041,22,16,1991,2,"female",852,443,248,96,240,78,185,18,55
1768042,25,14,1988,10,"male",450,45,3,3,2,3,2,0,0
1768088,24,7,1989,7,"male",32,42,28,21,2,21,1,0,1
1768096,34,26,1979,7,"female",600,36,26,204,40,204,33,0,7
1768114,50,3,1963,1,"female",567,54,24,25,3,1,3,24,0
1768135,24,7,1989,12,"female",394,37,10,10,33,8,24,2,9
1768142,19,1,1994,5,"female",301,377,208,48,270,25,122,23,148
1768170,15,11,1998,11,"male",28,0,0,0,0,0,0,0,0
1768179,26,19,1987,5,"male",374,251,237,22,3,22,3,0,0
1768188,19,7,1994,2,"female",35,59,38,1,10,0,7,1,3
1768239,34,22,1979,8,"male",535,37,37,9,3,5,3,4,0
1768247,21,30,1992,7,"male",62,75,60,0,0,0,0,0,0
1768274,23,1,1990,6,"male",311,30,20,10,3,10,3,0,0
1768356,91,10,1922,12,"male",2301,535,62,197,278,114,161,83,117
1768364,53,16,1960,2,"female",113,0,0,0,0,0,0,0,0
1768393,53,13,1960,5,"male",424,89,55,25,13,0,6,25,7
1768416,33,25,1980,8,"female",1224,18,12,2,0,2,0,0,0
1768422,25,25,1988,1,"male",515,48,38,0,9,0,9,0,0
1768453,15,14,1998,3,"female",190,354,227,50,45,44,13,6,32
1768459,23,28,1990,9,"male",125,31,27,4,4,4,2,0,2
1768467,34,6,1979,4,"female",719,497,372,1113,262,1112,167,1,95
1768468,108,20,1905,12,"male",238,136,106,23,1,0,0,23,1
1768495,16,14,1997,8,"male",720,107,49,0,0,0,0,0,0
1768550,51,13,1962,3,"female",179,92,76,29,236,29,196,0,40
1768557,76,5,1937,5,"male",4,0,0,0,0,0,0,0,0
1768562,35,8,1978,12,"male",54,79,71,48,14,48,8,0,6
1768581,53,21,1960,11,"male",284,96,80,14,8,0,5,14,3
1768627,57,2,1956,2,"male",1445,120,25,16,14,16,13,0,1
1768632,19,22,1994,1,"male",34,23,19,0,0,0,0,0,0
1768646,56,24,1957,7,"male",1037,102,29,23,7,23,2,0,5
1768657,18,8,1995,9,"female",604,4655,1597,52,247,52,204,0,43
1768661,20,22,1993,9,"male",490,161,132,131,28,130,22,1,6
1768674,20,4,1993,8,"male",623,212,93,9,3,0,2,9,1
1768698,49,21,1964,3,"male",279,17,15,41,6,0,0,41,6
1768716,28,15,1985,12,"female",274,81,40,103,26,103,24,0,2
1768717,25,10,1988,10,"female",414,118,87,0,0,0,0,0,0
1768726,36,10,1977,10,"female",164,65,17,6,54,6,7,0,47
1768730,27,24,1986,11,"male",287,2,1,3,0,3,0,0,0
1768760,22,14,1991,7,"male",237,245,212,838,830,469,475,369,355
1768775,19,4,1994,9,"male",683,237,134,1,3,1,0,0,3
1768777,16,15,1997,5,"male",433,112,91,0,4,0,1,0,3
1768840,22,30,1991,5,"female",76,136,123,2380,33,2313,19,67,14
1768843,16,30,1997,6,"male",289,131,75,45,2,45,2,0,0
1768844,52,10,1961,3,"female",851,15,14,1,0,1,0,0,0
1768850,103,4,1910,12,"male",1250,462,281,299,94,0,12,299,82
1768881,35,12,1978,3,"male",356,83,36,36,17,36,0,0,17
1768886,25,6,1988,8,"male",632,483,222,48,35,48,30,0,5
1768914,103,25,1910,5,"male",780,1662,1137,9,11,9,8,0,3
1768936,53,28,1960,1,"male",462,64,48,55,5,55,5,0,0
1768964,14,14,1999,11,"male",297,256,164,0,0,0,0,0,0
1768974,25,23,1988,1,"female",581,98,60,0,3,0,0,0,3
1768975,21,26,1992,12,"male",535,56,41,6,2,6,2,0,0
1769001,16,16,1997,5,"female",374,0,0,0,0,0,0,0,0
1769010,15,15,1998,11,"male",21,111,110,0,0,0,0,0,0
1769021,18,10,1995,4,"male",368,461,140,659,82,128,62,531,20
1769026,19,25,1994,1,"female",704,1935,542,928,1043,916,900,12,143
1769036,24,29,1989,9,"male",325,94,82,0,6,0,6,0,0
1769109,20,25,1993,6,"male",390,164,90,9,20,0,3,9,17
1769114,108,7,1905,4,"male",1952,3048,1233,132,852,132,805,0,47
1769150,52,19,1961,6,"male",646,150,79,685,326,685,261,0,65
1769158,20,1,1993,7,"male",51,93,58,7,15,7,12,0,3
1769162,28,14,1985,4,"female",432,129,70,917,594,792,253,125,341
1769166,20,16,1993,9,"male",481,471,330,667,96,0,38,667,58
1769186,21,13,1992,6,"male",66,13,13,221,245,66,136,155,109
1769193,19,19,1994,8,"male",234,64,31,0,6,0,6,0,0
1769214,106,14,1907,4,"male",385,135,100,3,21,3,21,0,0
1769220,23,7,1990,2,"male",203,226,148,8,61,8,34,0,27
1769240,23,3,1990,7,"female",557,26,13,17,18,17,16,0,2
1769244,43,11,1970,7,"male",168,505,458,45,54,26,44,19,10
1769286,14,6,1999,9,"female",379,194,93,245,285,72,50,173,235
1769298,19,22,1994,11,"female",638,1277,633,935,1079,226,212,709,867
1769311,48,11,1965,10,"male",252,92,57,163,73,0,17,163,56
1769342,57,1,1956,11,"female",1311,76,17,54,16,54,10,0,6
1769355,27,20,1986,4,"male",413,5,3,0,0,0,0,0,0
1769363,23,15,1990,12,"male",391,21,8,13,1,13,0,0,1
1769364,26,2,1987,1,"male",454,38,34,1,0,1,0,0,0
1769374,22,7,1991,1,"male",394,21,15,0,0,0,0,0,0
1769376,17,21,1996,3,"male",33,96,83,3,43,3,39,0,4
1769396,19,13,1994,2,"female",289,469,255,408,1698,371,852,37,846
1769398,23,9,1990,4,"male",288,44,40,7,5,7,4,0,1
1769412,54,12,1959,5,"male",476,30,18,3,2,0,0,3,2
1769414,21,27,1992,4,"male",555,99,48,862,370,551,312,311,58
1769421,26,11,1987,12,"male",45,36,29,6,4,6,3,0,1
1769451,31,24,1982,12,"male",598,80,30,111,32,111,17,0,15
1769467,59,3,1954,12,"female",1106,31,22,141,149,135,63,6,86
1769516,34,16,1979,2,"male",386,108,41,22,67,16,50,6,17
1769558,54,18,1959,4,"male",1654,113,63,14,25,11,18,3,7
1769572,63,1,1950,12,"male",448,79,41,3,13,0,8,3,5
1769573,19,2,1994,4,"male",12,85,66,63,155,30,122,33,33
1769614,38,28,1975,7,"female",907,171,106,714,383,539,200,175,183
1769635,75,30,1938,1,"male",1250,42,17,2,6,0,4,2,2
1769639,57,27,1956,11,"male",188,15,8,4,3,4,3,0,0
1769644,48,20,1965,1,"female",368,45,37,0,0,0,0,0,0
1769649,28,4,1985,4,"female",207,3,1,2,0,2,0,0,0
1769699,26,4,1987,6,"male",627,0,0,0,0,0,0,0,0
1769702,19,15,1994,3,"male",796,1464,1183,0,0,0,0,0,0
1769716,20,1,1993,5,"male",414,67,64,0,0,0,0,0,0
1769766,69,29,1944,9,"female",1528,181,139,1,1,1,1,0,0
1769802,25,28,1988,1,"female",154,17,8,32,6,32,6,0,0
1769809,27,26,1986,6,"female",390,36,30,6,4,6,4,0,0
1769813,14,10,1999,8,"male",377,171,109,0,49,0,38,0,11
1769821,17,22,1996,7,"male",638,91,64,7,0,6,0,1,0
1769827,47,21,1966,4,"male",565,140,103,63,20,54,18,9,2
1769839,38,2,1975,4,"male",26,36,28,16,19,16,14,0,5
1769840,18,15,1995,6,"male",323,401,271,32,4,0,1,32,3
1769854,23,2,1990,1,"female",716,272,130,985,362,886,196,99,166
1769882,101,28,1912,7,"female",1533,442,319,56,5,19,3,37,2
1769886,21,1,1992,1,"male",478,33,23,71,41,64,3,7,38
1769893,30,15,1983,6,"male",121,105,90,1,0,1,0,0,0
1769904,21,1,1992,12,"female",540,262,202,63,44,62,34,1,10
1769909,39,9,1974,12,"female",206,107,75,9,0,9,0,0,0
1769927,106,18,1907,12,"male",2058,502,129,235,208,4,56,231,152
1769930,34,18,1979,3,"male",52,0,0,0,0,0,0,0,0
1769944,19,18,1994,12,"female",421,1674,356,1981,2515,460,864,1521,1651
1769962,61,4,1952,1,"female",1556,244,142,360,904,317,615,43,289
1769969,54,17,1959,6,"female",706,64,42,41,14,16,7,25,7
1770030,31,22,1982,10,"male",181,0,0,0,0,0,0,0,0
1770037,44,11,1969,9,"male",7,2,2,1,0,1,0,0,0
1770066,21,4,1992,1,"male",421,797,711,247,181,238,139,9,42
1770074,42,4,1971,3,"female",280,36,25,75,26,73,11,2,15
1770078,21,9,1992,3,"female",8,210,48,62,169,1,50,61,119
1770079,107,3,1906,5,"female",547,394,219,83,30,83,27,0,3
1770086,30,15,1983,2,"male",549,171,109,50,4,50,3,0,1
1770135,47,30,1966,11,"male",36,10,9,0,0,0,0,0,0
1770158,15,10,1998,1,"female",322,205,132,384,134,96,68,288,66
1770165,75,24,1938,5,"female",34,37,19,113,31,113,22,0,9
1770172,17,15,1996,4,"male",30,3,3,10,0,10,0,0,0
1770181,17,20,1996,6,"female",359,433,345,18,25,18,10,0,15
1770185,14,8,1999,10,"male",269,28,14,0,0,0,0,0,0
1770193,100,6,1913,6,"male",531,94,83,65,60,65,35,0,25
1770207,41,17,1972,6,"male",413,509,412,111,59,0,7,111,52
1770212,17,1,1996,2,"male",1022,605,406,3,2,3,2,0,0
1770227,67,4,1946,11,"female",1311,188,84,31,0,2,0,29,0
1770228,17,1,1996,5,"male",126,167,149,0,0,0,0,0,0
1770246,25,1,1988,1,"male",1,0,0,30,1,30,0,0,1
1770247,17,8,1996,7,"male",603,28,17,33,4,26,1,7,3
1770260,19,30,1994,7,"female",237,15,12,0,0,0,0,0,0
1770263,28,9,1985,9,"female",309,47,38,17,116,17,45,0,71
1770282,39,9,1974,1,"female",749,10,7,22,18,20,14,2,4
1770337,26,1,1987,1,"male",450,89,68,1,11,1,8,0,3
1770355,53,24,1960,9,"male",492,292,261,208,45,172,9,36,36
1770364,23,28,1990,5,"male",198,7,6,0,0,0,0,0,0
1770387,17,3,1996,3,"male",565,928,650,137,515,101,462,36,53
1770417,25,19,1988,7,"male",678,170,105,41,26,11,14,30,12
1770472,64,6,1949,8,"female",2045,69,39,73,16,0,12,73,4
1770473,45,28,1968,8,"male",867,109,49,6,99,6,50,0,49
1770474,14,16,1999,7,"male",303,199,161,108,1,70,0,38,1
1770488,69,27,1944,7,"female",319,29,22,2,25,0,16,2,9
1770497,54,20,1959,12,"male",446,58,43,46,21,46,13,0,8
1770505,14,20,1999,3,"male",167,70,25,11,1,11,1,0,0
1770533,16,4,1997,3,"female",209,45,37,2,0,2,0,0,0
1770577,38,24,1975,6,"male",521,24,20,1,1,1,1,0,0
1770579,52,13,1961,5,"female",144,11,6,1,0,1,0,0,0
1770693,18,23,1995,12,"male",110,144,115,0,0,0,0,0,0
1770701,72,16,1941,3,"female",1545,76,26,39,8,3,5,36,3
1770705,59,31,1954,10,"male",989,138,77,0,0,0,0,0,0
1770729,34,26,1979,2,"male",280,1,1,0,0,0,0,0,0
1770731,23,30,1990,11,"male",705,77,2,4,0,4,0,0,0
1770740,23,15,1990,6,"male",288,171,128,4,0,4,0,0,0
1770753,62,3,1951,3,"female",350,9,7,2,1,0,0,2,1
1770756,20,24,1993,3,"male",606,47,19,4,4,4,2,0,2
1770767,23,10,1990,12,"female",799,401,144,431,531,310,278,121,253
1770773,34,22,1979,2,"male",1110,83,54,2,6,0,3,2,3
1770774,26,17,1987,10,"female",1110,766,498,255,808,195,439,60,369
1770778,28,23,1985,12,"male",426,27,20,2,0,2,0,0,0
1770792,104,29,1909,10,"female",1326,842,18,92,192,78,102,14,90
1770819,49,30,1964,3,"male",304,78,57,3,3,1,3,2,0
1770846,64,30,1949,7,"male",518,28,17,0,0,0,0,0,0
1770857,52,25,1961,12,"male",625,81,71,754,17,0,14,754,3
1770858,35,21,1978,8,"male",27,0,0,1,1,0,0,1,1
1770860,47,16,1966,9,"female",503,75,34,79,169,78,54,1,115
1770870,35,12,1978,3,"female",353,81,33,183,212,183,177,0,35
1770872,33,3,1980,11,"female",444,11,7,0,8,0,2,0,6
1770903,57,23,1956,9,"male",221,174,68,13,0,0,0,13,0
1770937,67,23,1946,9,"female",1677,27,20,0,0,0,0,0,0
1771023,18,3,1995,6,"male",309,275,235,1,0,0,0,1,0
1771046,14,13,1999,12,"female",246,29,22,62,80,16,15,46,65
1771050,26,23,1987,3,"female",1490,992,366,309,872,291,524,18,348
1771088,108,18,1905,4,"male",2355,135,76,14,18,14,16,0,2
1771102,59,2,1954,11,"male",144,45,34,1,0,1,0,0,0
1771109,108,22,1905,3,"female",1403,500,302,6,3,6,3,0,0
1771113,20,15,1993,11,"female",556,282,82,38,26,38,16,0,10
1771163,15,7,1998,6,"female",98,571,293,428,793,389,193,39,600
1771174,67,5,1946,8,"male",1655,138,91,1,9,0,9,1,0
1771179,63,9,1950,4,"female",585,44,29,0,0,0,0,0,0
1771186,34,25,1979,7,"female",200,135,95,16,14,16,12,0,2
1771191,31,30,1982,5,"female",291,166,138,50,22,35,14,15,8
1771213,31,1,1982,3,"male",1218,208,105,0,5,0,4,0,1
1771230,35,17,1978,10,"male",2046,11,4,36,24,36,19,0,5
1771240,37,26,1976,4,"male",147,38,35,0,0,0,0,0,0
1771244,30,4,1983,2,"male",771,32,20,0,19,0,11,0,8
1771262,26,1,1987,1,"male",447,128,109,0,0,0,0,0,0
1771268,20,20,1993,4,"female",395,322,197,1,1,1,0,0,1
1771283,25,6,1988,4,"female",633,2,1,14,0,7,0,7,0
1771294,19,4,1994,4,"male",198,147,93,273,57,273,50,0,7
1771316,21,20,1992,3,"male",502,46,29,0,0,0,0,0,0
1771324,75,14,1938,2,"female",1117,108,55,99,38,99,26,0,12
1771325,47,2,1966,1,"male",567,7,2,10,0,0,0,10,0
1771340,113,31,1900,12,"male",1200,41,18,0,0,0,0,0,0
1771366,25,5,1988,10,"male",49,15,15,0,2,0,2,0,0
1771388,14,19,1999,6,"male",47,48,46,1,0,0,0,1,0
1771406,22,25,1991,12,"male",34,54,28,286,550,194,131,92,419
1771408,29,13,1984,11,"male",58,32,28,4,0,4,0,0,0
1771442,28,10,1985,8,"male",48,31,24,529,314,529,298,0,16
1771453,54,30,1959,8,"female",333,334,129,920,356,0,49,920,307
1771454,90,20,1923,11,"female",40,117,82,500,59,464,34,36,25
1771459,100,7,1913,2,"male",1046,145,78,94,260,0,90,94,170
1771468,79,9,1934,9,"male",2239,35,12,0,0,0,0,0,0
1771499,17,24,1996,7,"male",552,1029,832,462,573,236,361,226,212
1771508,61,24,1952,4,"male",153,28,17,3,18,3,10,0,8
1771528,54,10,1959,2,"female",18,28,24,27,12,27,4,0,8
1771534,21,3,1992,6,"male",195,6,5,350,248,285,129,65,119
1771552,101,18,1912,1,NA,2097,72,34,5,6,5,4,0,2
1771561,16,23,1997,6,"male",218,98,84,2,0,2,0,0,0
1771569,65,14,1948,2,"male",782,110,67,13,8,13,6,0,2
1771638,23,28,1990,8,"female",246,18,15,1,0,1,0,0,0
1771655,62,17,1951,8,"male",383,9,5,48,0,48,0,0,0
1771656,14,30,1999,8,"female",116,167,98,139,12,137,2,2,10
1771678,53,2,1960,4,"female",780,104,59,116,21,0,6,116,15
1771691,26,22,1987,5,"male",211,53,48,1,0,1,0,0,0
1771694,25,12,1988,4,"female",479,70,30,7,0,7,0,0,0
1771698,17,25,1996,10,"female",646,1271,539,4,32,1,25,3,7
1771716,56,26,1957,8,"female",1482,116,26,406,291,358,204,48,87
1771717,22,3,1991,5,"female",139,122,109,116,222,96,109,20,113
1771732,26,1,1987,7,"male",354,114,29,6,5,6,5,0,0
1771745,20,22,1993,2,"male",426,43,17,7,3,7,1,0,2
1771751,33,10,1980,2,"male",987,19,15,0,0,0,0,0,0
1771753,58,6,1955,10,"male",593,7,2,1,0,0,0,1,0
1771758,59,24,1954,2,"male",948,68,35,87,19,87,9,0,10
1771772,16,1,1997,1,"male",943,13,11,6,0,0,0,6,0
1771786,23,10,1990,1,"male",178,115,68,73,23,73,21,0,2
1771787,108,15,1905,10,"female",25,22,19,349,53,10,6,339,47
1771813,15,22,1998,6,"male",675,1678,992,0,5,0,5,0,0
1771828,14,22,1999,4,"female",303,19,12,22,6,2,0,20,6
1771833,18,22,1995,10,"male",210,44,12,12,2,12,1,0,1
1771856,108,1,1905,1,NA,2205,96,24,0,0,0,0,0,0
1771889,18,5,1995,2,"female",482,502,282,72,58,72,36,0,22
1771909,51,24,1962,3,"female",391,51,36,11,2,11,2,0,0
1771921,18,2,1995,4,"male",466,154,38,208,94,208,55,0,39
1771928,18,27,1995,6,"male",484,444,262,58,30,53,14,5,16
1771937,44,5,1969,7,"male",103,146,143,129,523,84,378,45,145
1771979,19,1,1994,1,"female",271,3,3,35,0,35,0,0,0
1771996,113,1,1900,1,"female",1529,251,81,89,7,89,7,0,0
1772001,19,25,1994,2,"female",124,29,6,164,329,0,48,164,281
1772002,36,19,1977,6,"male",28,24,18,11,7,11,5,0,2
1772040,38,22,1975,8,"male",442,4,1,0,0,0,0,0,0
1772044,28,19,1985,11,"male",409,80,58,1,0,0,0,1,0
1772098,18,30,1995,3,"male",177,59,31,32,1,24,0,8,1
1772121,31,10,1982,4,"male",1077,99,91,2,33,1,23,1,10
1772129,26,1,1987,1,"male",98,1,1,0,0,0,0,0,0
1772132,46,2,1967,7,"female",413,4,4,1,0,1,0,0,0
1772149,23,1,1990,2,"female",291,12,9,1,0,0,0,1,0
1772159,61,23,1952,10,"male",1641,165,69,60,106,3,41,57,65
1772160,26,17,1987,12,"female",252,35,22,336,271,336,191,0,80
1772167,40,11,1973,5,"female",1328,43,19,1858,206,1588,122,270,84
1772173,40,10,1973,7,"male",319,14,12,50,12,3,3,47,9
1772186,43,18,1970,6,"female",604,129,104,1,0,1,0,0,0
1772205,21,18,1992,9,"female",92,243,184,61,400,61,299,0,101
1772209,31,5,1982,1,"male",198,6,6,0,1,0,1,0,0
1772230,32,14,1981,6,"male",419,23,0,0,0,0,0,0,0
1772254,77,1,1936,5,"male",1293,60,40,72,33,0,13,72,20
1772298,16,27,1997,10,"male",420,219,87,5,29,5,15,0,14
1772369,99,2,1914,8,"male",1194,521,305,22,19,0,1,22,18
1772412,14,14,1999,2,"male",555,1319,1083,1333,2260,780,833,553,1427
1772442,18,17,1995,4,"male",329,218,115,45,14,45,6,0,8
1772447,67,1,1946,4,"male",546,24,18,6,0,0,0,6,0
1772449,89,31,1924,5,"male",1379,669,367,178,978,178,563,0,415
1772468,17,10,1996,9,"male",563,132,89,3,8,3,3,0,5
1772474,27,1,1986,7,"male",44,1,1,0,0,0,0,0,0
1772480,57,10,1956,10,"female",267,54,9,57,144,0,7,57,137
1772492,19,23,1994,4,"male",422,52,43,0,0,0,0,0,0
1772498,37,2,1976,3,"male",1521,1531,367,7,28,7,25,0,3
1772518,53,9,1960,3,"male",647,4,3,0,0,0,0,0,0
1772521,100,1,1913,1,"male",313,50,38,46,3,7,0,39,3
1772526,27,1,1986,1,"male",476,123,112,34,26,34,13,0,13
1772544,58,5,1955,8,"male",1519,34,11,69,2,0,0,69,2
1772598,92,4,1921,1,"female",1043,267,94,3,30,3,27,0,3
1772599,16,30,1997,6,"female",287,354,117,56,43,56,42,0,1
1772647,29,19,1984,9,"female",146,98,84,88,106,84,63,4,43
1772671,21,2,1992,7,"male",410,423,266,9,0,9,0,0,0
1772672,20,24,1993,11,"male",830,1209,988,263,297,74,220,189,77
1772714,18,6,1995,10,"male",425,349,324,54,27,54,20,0,7
1772718,50,29,1963,8,"male",204,273,151,24,71,6,37,18,34
1772723,59,10,1954,12,"male",1208,431,192,4,4,0,3,4,1
1772728,72,4,1941,12,"female",320,33,11,8,7,0,0,8,7
1772730,67,9,1946,11,"male",1123,9,7,41,5,41,3,0,2
1772734,41,27,1972,7,"female",203,25,18,111,70,0,16,111,54
1772738,25,10,1988,10,"male",664,39,23,0,0,0,0,0,0
1772770,69,1,1944,5,"female",553,29,23,2,0,2,0,0,0
1772777,21,3,1992,9,"male",1113,169,128,11,3,11,3,0,0
1772805,112,1,1901,1,"female",1183,6,3,8,5,8,4,0,1
1772812,33,8,1980,8,"male",293,28,13,0,0,0,0,0,0
1772844,57,22,1956,11,"male",12,19,18,30,2,30,2,0,0
1772855,25,12,1988,5,"male",15,0,0,3,4,3,4,0,0
1772890,14,26,1999,3,"male",49,108,90,21,5,19,4,2,1
1772898,60,25,1953,12,"male",536,67,22,2,0,2,0,0,0
1772899,18,7,1995,11,"female",8,154,119,248,330,113,168,135,162
1772916,22,30,1991,6,"male",286,143,120,1,0,1,0,0,0
1772926,40,2,1973,8,"female",724,32,14,190,31,190,13,0,18
1772928,68,6,1945,6,"female",1051,27,13,0,0,0,0,0,0
1772962,61,20,1952,3,"female",2012,118,73,116,40,107,18,9,22
1772963,21,31,1992,12,"female",101,161,81,50,143,50,83,0,60
1773035,16,4,1997,6,"male",284,60,30,5,0,4,0,1,0
1773046,16,18,1997,11,"male",624,46,22,0,26,0,11,0,15
1773084,23,8,1990,1,"male",707,15,10,1,0,0,0,1,0
1773094,64,16,1949,1,"male",540,11,3,0,0,0,0,0,0
1773113,38,3,1975,7,"male",421,5,3,28,4,28,1,0,3
1773118,52,29,1961,5,"female",314,171,83,111,218,105,191,6,27
1773136,16,11,1997,9,"male",486,188,112,49,3,49,1,0,2
1773201,47,28,1966,2,"male",567,9,4,2,1,2,1,0,0
1773238,24,13,1989,10,"male",287,214,147,89,80,58,25,31,55
1773263,23,2,1990,9,"male",225,88,70,0,12,0,1,0,11
1773266,21,12,1992,10,"female",206,227,58,289,181,277,69,12,112
1773291,20,18,1993,9,"female",296,299,292,289,25,144,6,145,19
1773315,19,21,1994,12,"female",700,51,41,2,4,2,4,0,0
1773320,46,30,1967,7,"female",94,11,10,0,0,0,0,0,0
1773325,24,10,1989,10,"male",417,159,71,0,1,0,0,0,1
1773342,63,18,1950,3,"female",825,81,48,0,0,0,0,0,0
1773376,31,30,1982,7,"female",248,27,7,0,0,0,0,0,0
1773393,33,9,1980,9,"female",384,464,282,303,385,188,157,115,228
1773398,25,10,1988,3,"male",938,637,413,5,90,5,31,0,59
1773429,33,22,1980,8,"female",933,77,54,43,34,43,21,0,13
1773432,50,16,1963,6,"female",1318,274,120,1419,465,1340,177,79,288
1773450,108,27,1905,5,"male",2177,200,74,29,13,0,1,29,12
1773495,37,9,1976,11,"male",150,62,27,55,57,54,51,1,6
1773496,17,13,1996,10,"male",147,125,98,100,38,5,30,95,8
1773497,26,10,1987,10,"male",236,249,228,1,32,1,21,0,11
1773499,25,1,1988,1,"male",290,118,97,0,0,0,0,0,0
1773512,24,4,1989,3,"male",428,51,37,28,11,28,6,0,5
1773516,59,8,1954,4,"female",1057,224,122,858,299,855,174,3,125
1773530,47,24,1966,2,"female",125,41,40,44,28,44,15,0,13
1773534,28,13,1985,4,"male",155,16,11,10,1,10,1,0,0
1773549,26,7,1987,9,"male",316,88,57,62,57,59,6,3,51
1773597,70,10,1943,4,"female",1283,114,70,0,0,0,0,0,0
1773615,18,6,1995,8,"male",284,346,299,3,43,3,30,0,13
1773617,63,3,1950,7,"male",1322,0,0,15,0,0,0,15,0
1773622,58,28,1955,8,"female",1712,84,33,13,30,13,6,0,24
1773634,25,1,1988,7,"female",300,141,84,218,87,218,67,0,20
1773673,102,1,1911,7,"female",1310,1701,938,149,225,148,172,1,53
1773688,26,29,1987,9,"male",586,189,113,12,0,12,0,0,0
1773711,71,11,1942,5,"male",13,1,1,2,4,0,4,2,0
1773723,19,29,1994,12,"male",464,144,126,9,44,9,27,0,17
1773727,22,23,1991,10,"male",364,356,333,94,28,94,22,0,6
1773740,16,17,1997,7,"female",546,294,137,14,1,14,0,0,1
1773750,36,21,1977,8,"male",65,6,3,2,39,2,30,0,9
1773753,25,16,1988,12,"male",94,17,15,0,0,0,0,0,0
1773788,23,1,1990,1,"male",133,46,30,6,11,6,9,0,2
1773812,33,7,1980,1,"male",490,121,81,30,34,24,25,6,9
1773838,31,4,1982,2,"male",27,5,4,3,0,3,0,0,0
1773881,16,23,1997,3,"male",248,338,151,93,71,93,53,0,18
1773887,33,30,1980,9,"male",193,287,79,6,3,6,2,0,1
1773910,47,3,1966,12,"male",578,63,24,2,8,2,8,0,0
1773930,33,28,1980,11,"female",24,64,62,121,61,119,47,2,14
1773995,37,7,1976,5,"female",244,29,19,72,1,0,0,72,1
1774019,18,6,1995,6,"male",299,381,298,71,72,71,67,0,5
1774024,24,16,1989,6,"male",395,0,0,0,0,0,0,0,0
1774025,74,20,1939,10,"female",557,266,102,942,254,0,18,942,236
1774048,57,18,1956,12,"female",1678,497,261,446,1121,85,710,361,411
1774054,63,11,1950,1,"female",1887,1297,701,343,447,3,51,340,396
1774066,18,20,1995,11,"female",783,487,325,12,10,3,7,9,3
1774069,108,7,1905,3,"male",947,576,304,36,140,20,58,16,82
1774077,39,18,1974,1,"male",722,61,33,82,25,58,15,24,10
1774085,21,10,1992,4,"female",328,27,19,67,5,0,1,67,4
1774104,48,20,1965,6,"male",528,43,21,5,0,5,0,0,0
1774131,19,7,1994,1,"female",148,11,7,67,72,5,71,62,1
1774141,47,17,1966,9,"female",171,26,23,8,5,8,0,0,5
1774155,108,18,1905,6,"male",1515,119,83,6,0,6,0,0,0
1774167,28,14,1985,5,"male",1012,109,61,69,37,69,34,0,3
1774214,69,31,1944,7,"male",55,49,45,13,0,13,0,0,0
1774220,52,21,1961,3,"female",474,58,35,21,10,21,9,0,1
1774224,14,15,1999,2,"male",3,36,36,20,38,0,7,20,31
1774229,31,15,1982,3,"male",618,251,184,0,9,0,7,0,2
1774247,74,27,1939,10,"male",329,12,11,0,0,0,0,0,0
1774248,19,17,1994,2,"male",414,126,86,0,1,0,0,0,1
1774251,18,19,1995,11,"female",288,69,58,330,18,330,18,0,0
1774315,43,18,1970,5,"female",584,154,116,4,3,4,3,0,0
1774336,18,2,1995,6,"male",497,67,48,13,7,13,7,0,0
1774350,107,1,1906,1,"male",2310,93,46,30,37,12,12,18,25
1774385,19,16,1994,2,"male",312,125,79,40,22,16,11,24,11
1774419,15,19,1998,8,"male",710,276,182,7,0,7,0,0,0
1774432,24,1,1989,2,"female",531,226,184,359,418,2,173,357,245
1774436,22,19,1991,5,"female",596,36,32,2,12,2,10,0,2
1774458,29,26,1984,6,"male",250,11,11,2,3,2,0,0,3
1774494,45,4,1968,12,"male",1074,100,26,0,6,0,0,0,6
1774506,17,16,1996,4,"female",362,817,499,783,425,783,258,0,167
1774523,83,30,1930,11,"female",710,280,121,131,180,131,126,0,54
1774525,20,18,1993,2,"female",306,57,19,36,22,12,12,24,10
1774538,18,21,1995,11,"female",429,52,17,4,7,0,3,4,4
1774550,35,4,1978,9,"female",458,42,32,50,65,50,60,0,5
1774557,42,22,1971,9,"male",421,120,20,1,0,0,0,1,0
1774597,16,8,1997,1,"female",39,153,67,28,67,26,25,2,42
1774606,28,19,1985,12,"male",1655,626,287,418,472,181,384,237,88
1774615,22,15,1991,5,"female",296,88,38,2,45,2,31,0,14
1774635,22,28,1991,2,"male",888,66,47,9,5,8,3,1,2
1774647,22,14,1991,8,"female",534,161,82,152,39,121,17,31,22
1774678,43,2,1970,4,"male",513,0,0,0,3,0,3,0,0
1774684,60,18,1953,8,"female",320,32,25,13,2,13,2,0,0
1774710,23,6,1990,7,"female",302,91,75,1,44,0,4,1,40
1774721,51,1,1962,1,"male",109,36,34,1,6,1,6,0,0
1774741,41,24,1972,7,"male",85,0,0,0,0,0,0,0,0
1774768,34,26,1979,5,"male",312,48,8,24,48,22,32,2,16
1774775,63,10,1950,1,"male",977,658,320,1,7,0,3,1,4
1774781,59,28,1954,4,"male",187,91,47,45,27,0,12,45,15
1774790,28,23,1985,4,"male",524,404,223,0,2,0,2,0,0
1774794,38,12,1975,4,"female",631,36,28,100,60,17,4,83,56
1774812,35,23,1978,3,"female",477,112,56,466,89,443,27,23,62
1774849,21,9,1992,9,"male",194,85,77,1,0,1,0,0,0
1774901,68,29,1945,5,"male",892,210,114,20,4,14,2,6,2
1774903,33,12,1980,4,"male",1084,73,58,0,2,0,2,0,0
1774930,33,25,1980,1,"male",712,19,5,2,6,0,3,2,3
1774951,49,1,1964,7,"male",13,1,1,1,0,0,0,1,0
1774973,15,25,1998,4,"male",218,165,117,27,15,16,10,11,5
1774994,25,5,1988,12,"male",138,60,35,1,2,1,1,0,1
1775013,14,1,1999,1,"male",45,44,26,5,1,5,1,0,0
1775063,25,24,1988,10,"female",39,20,18,1,0,1,0,0,0
1775065,30,15,1983,6,"male",171,43,28,23,1,23,1,0,0
1775069,63,19,1950,6,"female",1648,200,69,6,2,6,1,0,1
1775074,18,9,1995,9,"male",518,60,41,2,0,2,0,0,0
1775080,54,24,1959,6,"male",1708,328,286,37,24,25,12,12,12
1775103,27,17,1986,8,"male",667,47,17,0,0,0,0,0,0
1775109,25,8,1988,6,"male",467,133,107,1,0,1,0,0,0
1775123,18,10,1995,11,"male",26,8,7,0,0,0,0,0,0
1775158,31,26,1982,9,"female",76,34,24,1410,115,1410,58,0,57
1775193,33,15,1980,8,"male",348,1577,82,32,59,25,14,7,45
1775202,15,3,1998,5,"male",82,139,93,161,94,161,64,0,30
1775251,57,25,1956,2,"male",1131,78,17,4,1,4,1,0,0
1775271,34,5,1979,5,"male",199,99,43,2,14,2,2,0,12
1775291,27,8,1986,1,"male",436,158,83,154,92,154,50,0,42
1775293,17,11,1996,8,"male",25,38,37,4,3,4,2,0,1
1775298,16,17,1997,11,"female",784,1091,606,8627,5884,6966,4748,1661,1136
1775303,30,10,1983,12,"male",1598,192,104,0,0,0,0,0,0
1775324,25,3,1988,6,"male",1028,200,83,0,0,0,0,0,0
1775352,26,25,1987,6,"male",594,18,12,17,2,17,2,0,0
1775360,53,3,1960,6,"male",261,51,35,26,6,26,4,0,2
1775382,19,28,1994,4,"female",268,227,166,2958,1311,2259,818,699,493
1775407,35,30,1978,9,"female",433,33,13,48,144,48,120,0,24
1775425,73,30,1940,7,"female",1465,30,13,29,0,0,0,29,0
1775441,73,25,1940,2,"female",2205,302,122,72,77,72,68,0,9
1775534,27,28,1986,11,"male",397,92,61,8,3,8,1,0,2
1775540,29,26,1984,1,"male",1154,68,43,0,0,0,0,0,0
1775578,23,27,1990,10,"male",5,3,3,0,0,0,0,0,0
1775592,43,29,1970,4,"female",332,74,39,363,46,285,24,78,22
1775608,23,28,1990,7,"female",17,14,2,7,9,7,8,0,1
1775671,14,7,1999,11,"female",296,167,79,5,1,4,1,1,0
1775694,23,19,1990,1,"female",547,93,40,4,14,1,7,3,7
1775719,29,14,1984,1,"female",505,98,36,6,46,5,33,1,13
1775734,39,4,1974,8,"male",85,4,4,13,8,13,6,0,2
1775748,14,8,1999,3,"male",0,0,0,0,0,0,0,0,0
1775768,22,4,1991,12,"male",953,213,163,0,7,0,6,0,1
1775774,53,6,1960,6,"female",745,62,32,6,3,6,2,0,1
1775816,17,14,1996,8,"male",299,10,10,0,1,0,1,0,0
1775858,21,31,1992,7,"male",380,483,204,81,31,81,14,0,17
1775867,19,26,1994,4,"female",221,138,73,37,9,37,9,0,0
1775890,66,7,1947,3,"male",1561,9,4,14,4,9,2,5,2
1775937,64,12,1949,6,"female",777,19,11,3,3,0,0,3,3
1775955,56,28,1957,7,"female",652,171,145,36,1,22,1,14,0
1775965,22,25,1991,1,"female",110,10,8,1,0,1,0,0,0
1775978,45,7,1968,1,"male",780,159,34,23,2,23,2,0,0
1775979,14,4,1999,7,"female",234,37,20,26,2,23,1,3,1
1776016,19,31,1994,3,"male",193,15,12,0,0,0,0,0,0
1776026,34,16,1979,5,"female",252,222,174,51,94,7,58,44,36
1776041,13,13,2000,7,"female",394,341,145,384,596,292,321,92,275
1776051,20,13,1993,10,"male",474,15,14,0,0,0,0,0,0
1776062,40,30,1973,6,"male",24,3,3,2,1,1,0,1,1
1776072,36,17,1977,1,"female",456,217,165,2147,2171,192,1330,1955,841
1776117,49,20,1964,2,"female",565,185,124,1678,26,185,11,1493,15
1776127,17,26,1996,8,"male",453,4,2,0,0,0,0,0,0
1776144,24,12,1989,12,"male",145,1,1,0,0,0,0,0,0
1776156,19,23,1994,12,"male",446,342,270,145,74,41,27,104,47
1776180,65,9,1948,3,"female",557,12,9,1,0,0,0,1,0
1776188,43,26,1970,7,"male",808,12,3,0,0,0,0,0,0
1776197,17,18,1996,11,"male",381,405,367,190,63,184,38,6,25
1776198,21,15,1992,8,"female",223,151,137,156,414,73,242,83,172
1776246,18,11,1995,6,"female",32,890,557,3051,1714,250,802,2801,912
1776263,19,22,1994,11,"female",511,110,71,16,1,3,0,13,1
1776319,27,10,1986,10,"male",229,107,58,1,21,1,19,0,2
1776331,47,15,1966,1,"male",145,36,16,1,2,0,0,1,2
1776390,28,26,1985,2,"male",741,150,115,2,0,2,0,0,0
1776415,20,5,1993,8,"male",581,314,195,60,3,60,3,0,0
1776428,47,4,1966,1,"male",328,35,29,0,9,0,5,0,4
1776442,23,17,1990,8,"male",1075,35,18,2,6,2,6,0,0
1776460,62,25,1951,10,"male",804,119,37,0,1,0,1,0,0
1776471,15,6,1998,4,"male",31,43,33,37,10,10,4,27,6
1776494,35,22,1978,6,"female",230,162,61,3,5,1,4,2,1
1776496,25,12,1988,2,"female",272,84,50,6,13,6,9,0,4
1776522,60,1,1953,8,"female",1027,42,18,16,5,16,3,0,2
1776553,24,23,1989,9,"female",343,137,62,7,54,1,12,6,42
1776567,27,14,1986,9,"female",221,100,54,85,21,85,10,0,11
1776627,17,21,1996,3,"female",467,51,27,152,48,150,6,2,42
1776639,69,30,1944,6,"male",1755,56,46,3,0,0,0,3,0
1776642,93,1,1920,11,"male",905,721,525,50,40,0,5,50,35
1776661,60,9,1953,3,"female",1422,99,46,215,102,215,61,0,41
1776694,34,24,1979,4,"male",445,178,74,88,155,85,68,3,87
1776750,21,27,1992,12,"male",112,13,8,4,2,3,2,1,0
1776790,25,23,1988,2,"male",1043,172,103,310,523,207,283,103,240
1776792,17,18,1996,2,"male",349,170,79,7,3,0,1,7,2
1776803,13,13,2000,6,"male",81,10,6,0,0,0,0,0,0
1776812,34,12,1979,10,"female",1637,390,206,520,475,395,186,125,289
1776868,46,1,1967,2,"male",920,173,82,62,25,62,17,0,8
1776876,78,7,1935,10,"female",1118,24,14,6,6,0,4,6,2
1776909,57,21,1956,3,"male",73,10,3,1,0,1,0,0,0
1777017,32,2,1981,2,"male",793,62,45,0,0,0,0,0,0
1777022,62,25,1951,5,"female",1922,209,132,976,632,398,222,578,410
1777047,23,2,1990,3,"male",17,1,0,0,0,0,0,0,0
1777095,52,26,1961,4,"female",702,129,93,1895,124,395,32,1500,92
1777104,36,7,1977,4,"male",235,1,1,14,1,14,1,0,0
1777122,78,10,1935,2,"male",1200,105,58,7,15,0,2,7,13
1777131,34,23,1979,8,"male",855,77,44,1,4,1,4,0,0
1777132,28,1,1985,1,"female",419,8,4,0,5,0,0,0,5
1777136,25,1,1988,1,"male",261,190,169,105,1,105,1,0,0
1777158,26,5,1987,5,"male",855,442,326,453,595,453,449,0,146
1777163,15,10,1998,10,"female",477,147,120,62,108,62,88,0,20
1777179,48,2,1965,1,"female",6,37,17,20,88,20,69,0,19
1777185,24,27,1989,12,"male",676,582,414,44,7,17,2,27,5
1777242,103,29,1910,4,"male",807,226,166,11,2,11,2,0,0
1777245,67,14,1946,3,"female",358,137,118,0,5,0,0,0,5
1777250,20,20,1993,10,"male",32,16,15,11,1,11,1,0,0
1777310,103,5,1910,12,"female",925,24,10,14,16,0,9,14,7
1777332,17,26,1996,10,"female",19,313,304,29,86,29,78,0,8
1777335,33,12,1980,12,"male",1297,89,81,9,35,9,34,0,1
1777380,60,3,1953,3,"female",1214,45,10,0,1,0,1,0,0
1777398,20,31,1993,10,"female",242,185,90,24,84,14,45,10,39
1777435,52,16,1961,8,"female",493,40,29,19,2,19,2,0,0
1777451,38,15,1975,4,"male",343,51,24,36,26,12,7,24,19
1777531,26,2,1987,4,"male",640,888,577,2402,1472,699,497,1703,975
1777535,30,15,1983,9,"male",78,6,6,0,0,0,0,0,0
1777572,15,3,1998,6,"female",36,26,10,0,2,0,1,0,1
1777633,33,29,1980,5,"male",310,145,77,2,0,0,0,2,0
1777691,45,17,1968,3,"female",557,97,29,31,1,29,1,2,0
1777703,18,10,1995,9,"male",91,400,376,5,17,5,10,0,7
1777709,23,30,1990,7,"female",585,554,218,646,541,447,211,199,330
1777712,24,11,1989,8,"male",1353,403,160,0,6,0,6,0,0
1777770,34,16,1979,5,"male",62,8,4,4,13,4,11,0,2
1777781,58,23,1955,4,"female",1191,129,45,1,1,1,0,0,1
1777799,25,22,1988,6,"male",1106,261,139,4,1,4,0,0,1
1777804,20,19,1993,9,"female",639,4,4,0,0,0,0,0,0
1777815,65,24,1948,10,"male",268,93,49,17,18,0,6,17,12
1777821,94,21,1919,5,"male",1142,2517,1977,1,8,1,6,0,2
1777881,54,27,1959,4,"male",458,57,30,148,26,2,13,146,13
1777885,27,21,1986,8,"female",272,182,151,7,2,0,1,7,1
1777921,21,9,1992,6,"male",80,67,55,3,0,3,0,0,0
1777941,39,19,1974,9,"male",16,0,0,0,0,0,0,0,0
1777964,19,20,1994,7,"female",220,14,8,27,36,27,28,0,8
1778001,107,2,1906,8,"male",1601,361,206,220,113,67,68,153,45
1778029,70,1,1943,1,"female",1977,1320,711,97,315,97,193,0,122
1778053,64,21,1949,2,"female",1212,92,58,689,108,656,50,33,58
1778055,25,29,1988,12,"female",521,2628,517,12,1380,12,1059,0,321
1778093,21,30,1992,8,"male",114,72,62,1,0,1,0,0,0
1778095,18,22,1995,4,"female",120,365,277,2624,2572,1822,980,802,1592
1778097,31,21,1982,10,"male",1107,1464,1034,155,746,134,577,21,169
1778123,22,4,1991,9,"male",468,80,41,0,0,0,0,0,0
1778162,52,18,1961,6,"male",1001,197,117,60,171,53,80,7,91
1778163,17,19,1996,11,"female",796,11,8,2,0,2,0,0,0
1778165,15,25,1998,9,"male",404,108,62,1,0,1,0,0,0
1778168,29,5,1984,12,"male",304,120,45,1,0,0,0,1,0
1778175,24,11,1989,4,"male",750,52,43,0,4,0,4,0,0
1778201,21,18,1992,11,"male",627,122,47,0,0,0,0,0,0
1778221,22,11,1991,3,"male",278,185,95,180,104,180,51,0,53
1778235,24,1,1989,1,"male",75,4,3,0,0,0,0,0,0
1778252,108,13,1905,8,"male",1628,494,209,7,2,0,2,7,0
1778262,24,15,1989,4,"male",22,40,25,112,130,112,58,0,72
1778263,28,11,1985,6,"male",1521,66,45,0,0,0,0,0,0
1778281,18,22,1995,6,"male",32,46,35,2,4,2,1,0,3
1778297,21,20,1992,6,"male",296,11,6,3,1,3,0,0,1
1778302,86,11,1927,1,"female",1435,87,46,264,364,264,208,0,156
1778343,51,29,1962,4,"female",163,139,116,17,42,17,16,0,26
1778353,20,14,1993,8,"female",795,566,336,525,892,301,409,224,483
1778356,13,1,2000,1,"male",893,42,22,0,2,0,1,0,1
1778359,58,3,1955,12,"female",2251,373,210,1129,684,886,245,243,439
1778379,66,13,1947,7,"female",1125,85,23,5,2,5,0,0,2
1778380,33,22,1980,4,"male",304,23,17,0,0,0,0,0,0
1778395,28,12,1985,1,"male",428,18,4,0,1,0,1,0,0
1778439,17,18,1996,10,"female",467,683,270,1051,930,96,293,955,637
1778462,59,17,1954,1,"male",285,26,12,1771,54,1771,52,0,2
1778467,25,28,1988,9,"male",479,36,9,1,7,1,2,0,5
1778481,54,13,1959,9,"female",1830,243,138,1064,1045,162,593,902,452
1778510,32,29,1981,9,"female",443,50,2,0,4,0,2,0,2
1778515,48,22,1965,3,"female",417,31,15,5,9,5,7,0,2
1778516,15,1,1998,10,"female",323,1314,977,887,982,276,314,611,668
1778567,20,17,1993,10,"male",33,49,11,0,1,0,0,0,1
1778588,23,23,1990,11,"female",281,84,34,31,314,0,92,31,222
1778597,18,23,1995,11,"male",174,273,147,151,97,151,87,0,10
1778609,113,19,1900,11,"male",1476,127,40,21,15,0,2,21,13
1778613,22,1,1991,1,"male",119,3,3,0,0,0,0,0,0
1778619,58,25,1955,9,"female",1589,51,28,8,7,0,0,8,7
1778642,20,15,1993,8,"male",106,36,26,0,0,0,0,0,0
1778673,17,18,1996,12,"female",556,791,404,9,34,5,9,4,25
1778681,68,3,1945,12,"female",1550,45,15,10,32,10,29,0,3
1778702,34,24,1979,8,"female",145,29,25,62,0,62,0,0,0
1778728,34,27,1979,1,"male",163,18,14,2,7,2,5,0,2
1778828,59,16,1954,5,"male",1373,18,2,0,0,0,0,0,0
1778855,105,25,1908,4,"male",187,387,211,227,89,195,73,32,16
1778862,28,30,1985,11,"female",403,94,78,240,244,41,115,199,129
1778874,93,7,1920,12,"male",1479,381,152,13,1,13,1,0,0
1778886,57,30,1956,9,"male",738,31,14,1,6,1,6,0,0
1778891,64,2,1949,4,"female",1408,16,6,1,0,0,0,1,0
1778905,62,24,1951,9,"male",868,172,104,338,531,14,167,324,364
1778942,55,1,1958,2,"female",13,8,5,0,0,0,0,0,0
1778954,28,28,1985,2,"male",98,14,11,1,2,1,1,0,1
1778956,27,5,1986,2,"female",496,22,20,101,25,101,14,0,11
1778967,63,20,1950,3,"female",329,10,5,84,103,1,60,83,43
1778988,21,17,1992,4,"male",1290,261,78,14,10,14,8,0,2
1778999,39,12,1974,8,"male",88,106,44,0,0,0,0,0,0
1779005,22,19,1991,6,"male",13,23,20,23,17,23,9,0,8
1779032,54,9,1959,5,"female",514,50,29,13,4,0,0,13,4
1779042,42,8,1971,2,"male",603,79,42,1293,154,1293,118,0,36
1779067,21,29,1992,9,"male",471,2504,1987,1,7,1,5,0,2
1779072,38,24,1975,5,"male",451,37,22,11,37,3,28,8,9
1779078,21,7,1992,7,"male",205,54,44,0,0,0,0,0,0
1779120,29,25,1984,10,"female",240,30,17,50,43,44,38,6,5
1779132,20,22,1993,3,"male",327,185,154,0,0,0,0,0,0
1779136,108,2,1905,3,"female",1703,447,227,67,59,67,36,0,23
1779169,19,24,1994,6,"female",267,16,9,2,0,2,0,0,0
1779175,29,14,1984,9,"female",1546,609,505,121,240,117,156,4,84
1779214,15,10,1998,7,"female",454,888,575,258,271,158,40,100,231
1779220,29,5,1984,1,"male",1345,141,47,5,2,1,1,4,1
1779223,17,28,1996,7,"male",425,120,36,0,22,0,17,0,5
1779230,48,16,1965,6,"female",1219,113,42,346,560,346,458,0,102
1779243,30,20,1983,7,"male",333,138,89,0,17,0,1,0,16
1779255,44,18,1969,11,"female",333,67,50,21,2,21,2,0,0
1779261,18,3,1995,6,"male",380,0,0,0,3,0,3,0,0
1779272,15,20,1998,5,"female",218,228,192,8,13,0,4,8,9
1779276,25,1,1988,11,"male",372,139,115,0,17,0,12,0,5
1779344,43,8,1970,11,"male",376,1,1,0,0,0,0,0,0
1779371,14,13,1999,9,"male",196,35,20,0,2,0,2,0,0
1779388,61,23,1952,9,"male",818,29,19,18,1,5,1,13,0
1779414,44,24,1969,2,"male",162,58,26,40,12,40,6,0,6
1779472,13,10,2000,5,"male",104,26,19,0,0,0,0,0,0
1779476,52,17,1961,12,"male",264,74,25,31,32,15,14,16,18
1779530,104,1,1909,4,"male",933,303,273,0,0,0,0,0,0
1779533,38,16,1975,1,"female",669,26,16,2,10,1,3,1,7
1779546,38,11,1975,3,"female",396,43,24,2,0,2,0,0,0
1779565,19,26,1994,4,"female",363,558,409,59,50,59,47,0,3
1779567,63,17,1950,12,"male",983,5,1,5,2,5,2,0,0
1779575,34,3,1979,4,"female",243,41,26,1,2,0,2,1,0
1779596,15,4,1998,1,"male",824,178,85,39,37,35,19,4,18
1779608,25,20,1988,11,"female",19,170,119,2741,407,2718,73,23,334
1779609,28,11,1985,3,"male",527,21,8,2,9,2,3,0,6
1779626,24,15,1989,2,"female",115,14,11,10,22,9,17,1,5
1779647,20,14,1993,8,"male",76,143,135,0,30,0,12,0,18
1779671,19,30,1994,8,"male",347,54,36,5,2,5,2,0,0
1779683,16,10,1997,10,"female",340,77,38,1,1,1,1,0,0
1779699,25,16,1988,12,"male",1329,3276,1050,2269,3060,2051,1221,218,1839
1779713,107,14,1906,11,"female",160,219,189,0,7,0,5,0,2
1779716,48,3,1965,7,"female",897,174,99,873,1157,838,510,35,647
1779763,27,10,1986,12,"male",521,33,23,3,0,3,0,0,0
1779781,36,24,1977,5,"female",253,0,0,0,0,0,0,0,0
1779835,20,12,1993,9,"male",208,6,2,5,0,0,0,5,0
1779872,16,18,1997,3,"male",385,114,83,0,18,0,17,0,1
1779873,17,21,1996,9,"male",353,545,363,61,149,38,37,23,112
1779884,40,17,1973,1,"female",420,22,10,2,24,2,21,0,3
1779888,103,2,1910,3,"female",785,75,32,2,1,2,1,0,0
1779903,19,9,1994,2,"female",250,735,329,1005,1056,878,781,127,275
1779908,15,4,1998,12,"female",252,55,22,0,0,0,0,0,0
1779931,95,1,1918,11,"female",1975,4354,748,53,135,19,74,34,61
1779935,58,26,1955,1,"male",720,44,31,4,5,0,3,4,2
1779949,23,1,1990,1,"male",351,331,301,2,5,2,5,0,0
1779970,17,14,1996,10,"male",269,248,80,9,7,3,5,6,2
1779976,24,21,1989,6,"male",255,29,20,1,0,1,0,0,0
1779977,28,17,1985,1,"female",1252,267,14,0,4,0,1,0,3
1779979,19,26,1994,6,"male",624,823,643,113,122,105,104,8,18
1779988,16,11,1997,10,"male",218,333,195,76,51,76,39,0,12
1779995,31,13,1982,10,"female",140,77,53,48,60,46,43,2,17
1780009,41,23,1972,4,"female",94,0,0,0,0,0,0,0,0
1780018,51,22,1962,7,"male",854,490,32,82,29,82,10,0,19
1780049,26,18,1987,7,"male",332,60,38,25,43,25,43,0,0
1780058,41,10,1972,5,"male",480,508,464,279,16,279,14,0,2
1780089,22,2,1991,4,"female",1473,62,41,436,478,5,181,431,297
1780104,56,7,1957,10,"male",1349,6,5,4,9,0,4,4,5
1780117,22,28,1991,1,"female",145,7,3,1,1,1,1,0,0
1780122,24,17,1989,1,"female",533,104,4,2,0,2,0,0,0
1780127,18,4,1995,3,"female",224,62,57,11,11,0,0,11,11
1780141,17,1,1996,1,"male",103,98,66,256,142,233,109,23,33
1780177,23,16,1990,7,"male",510,14,7,0,0,0,0,0,0
1780190,49,17,1964,6,"male",327,62,21,53,47,38,35,15,12
1780201,53,25,1960,3,"male",1738,113,69,5,5,5,5,0,0
1780205,46,22,1967,5,"male",549,104,83,2879,214,2784,120,95,94
1780218,19,1,1994,8,"female",112,140,91,8,71,8,11,0,60
1780231,27,18,1986,12,"male",42,11,9,24,9,24,7,0,2
1780232,24,12,1989,12,"male",564,852,770,9,84,9,83,0,1
1780277,14,16,1999,11,"male",79,58,41,3,4,3,4,0,0
1780286,32,29,1981,3,"male",807,93,32,5,3,5,3,0,0
1780314,18,28,1995,12,"male",1112,354,184,8,1,8,0,0,1
1780332,14,1,1999,3,"male",9,6,6,2,0,2,0,0,0
1780358,42,30,1971,10,"male",414,15,8,1,3,0,1,1,2
1780363,23,4,1990,6,"male",568,349,244,27,17,27,17,0,0
1780364,23,9,1990,12,"male",500,1,0,1,0,1,0,0,0
1780403,20,22,1993,3,"male",94,157,136,1,0,1,0,0,0
1780440,103,11,1910,3,"female",549,214,71,3,3,3,2,0,1
1780447,14,19,1999,11,"female",276,108,70,3,0,1,0,2,0
1780480,17,21,1996,7,"female",152,12,6,706,129,156,51,550,78
1780494,57,4,1956,4,"female",264,93,76,404,93,246,76,158,17
1780497,14,3,1999,6,"female",74,85,44,3,5,3,4,0,1
1780506,21,2,1992,2,"female",540,539,190,35,60,31,15,4,45
1780507,52,28,1961,12,"male",464,35,27,0,0,0,0,0,0
1780511,74,6,1939,6,"female",844,27,16,3,1,0,0,3,1
1780513,18,11,1995,1,"male",35,67,37,1,10,1,8,0,2
1780514,20,13,1993,10,"male",302,2373,437,2399,1652,324,1083,2075,569
1780518,61,17,1952,5,"male",477,218,119,8,113,7,47,1,66
1780526,20,6,1993,3,"male",34,76,69,8,28,8,19,0,9
1780545,50,12,1963,2,"male",289,37,29,107,60,0,16,107,44
1780559,28,9,1985,4,"male",256,318,248,283,284,283,243,0,41
1780563,51,25,1962,2,"male",958,67,43,1,0,0,0,1,0
1780565,34,26,1979,4,"female",381,9,2,0,0,0,0,0,0
1780569,28,10,1985,2,"male",819,182,101,11,76,11,21,0,55
1780577,36,17,1977,12,"female",813,152,101,11,17,11,16,0,1
1780584,19,5,1994,11,"male",600,200,141,1,3,1,2,0,1
1780611,61,23,1952,9,"male",1591,207,115,19,23,0,1,19,22
1780643,58,7,1955,1,"male",1148,67,10,0,6,0,6,0,0
1780658,14,29,1999,4,"female",441,1186,628,1717,2136,1717,1758,0,378
1780661,41,2,1972,10,"female",532,63,35,13,5,7,1,6,4
1780734,30,4,1983,2,"male",173,92,69,1,2,1,2,0,0
1780763,21,5,1992,9,"male",1098,1,1,0,0,0,0,0,0
1780764,15,14,1998,11,"female",218,55,14,157,51,157,46,0,5
1780783,34,31,1979,1,"female",315,24,18,9,4,0,1,9,3
1780789,62,28,1951,4,"female",705,178,82,104,50,104,36,0,14
1780818,24,22,1989,5,"female",124,174,116,5,10,5,6,0,4
1780832,35,14,1978,6,"male",644,1,1,0,0,0,0,0,0
1780840,28,11,1985,8,"female",460,88,72,0,0,0,0,0,0
1780846,18,7,1995,11,"male",542,32,17,0,5,0,0,0,5
1780856,65,28,1948,7,"male",1053,52,30,23,9,0,5,23,4
1780857,62,24,1951,7,"female",333,71,53,668,232,44,6,624,226
1780876,18,13,1995,3,"female",655,241,180,11,23,10,13,1,10
1780890,59,1,1954,12,"female",1335,0,0,0,0,0,0,0,0
1780900,21,11,1992,2,"male",54,40,26,80,8,80,8,0,0
1780904,28,15,1985,8,"female",474,94,55,964,347,961,204,3,143
1780921,30,19,1983,8,"female",360,0,0,0,0,0,0,0,0
1780926,24,12,1989,1,"female",212,23,9,1,7,1,7,0,0
1780950,39,26,1974,8,"female",278,54,31,6,0,6,0,0,0
1780952,20,3,1993,3,"male",125,18,16,47,3,0,1,47,2
1780962,26,12,1987,6,"female",153,42,40,1,0,1,0,0,0
1780966,16,30,1997,1,"male",420,95,79,0,0,0,0,0,0
1780967,69,28,1944,3,"female",1565,65,34,22,5,22,3,0,2
1780990,49,27,1964,5,"female",324,59,35,27,14,0,2,27,12
1781024,21,4,1992,6,"female",322,70,42,3,0,0,0,3,0
1781061,30,21,1983,12,"female",4,0,0,0,0,0,0,0,0
1781064,78,20,1935,8,"female",1827,118,61,0,0,0,0,0,0
1781082,23,22,1990,4,"male",529,1132,664,2752,2388,2116,1468,636,920
1781091,74,14,1939,10,"female",440,37,25,2,4,0,2,2,2
1781135,30,10,1983,4,"female",189,24,21,6,10,6,10,0,0
1781155,73,1,1940,4,"female",1281,237,124,32,166,32,75,0,91
1781167,25,15,1988,10,"male",1011,310,168,134,72,134,70,0,2
1781172,19,12,1994,12,"male",726,362,225,2540,342,941,225,1599,117
1781176,19,28,1994,3,"female",481,310,80,53,32,50,17,3,15
1781198,53,10,1960,8,"female",1556,456,349,60,133,48,118,12,15
1781209,57,6,1956,1,"male",183,28,14,2,2,0,2,2,0
1781266,19,15,1994,6,"male",329,405,246,7,19,7,9,0,10
1781302,31,9,1982,11,"male",302,4,3,0,0,0,0,0,0
1781307,19,4,1994,7,"female",503,93,60,40,37,2,18,38,19
1781308,27,21,1986,2,"male",1349,251,87,37,61,37,44,0,17
1781321,14,23,1999,4,"female",97,453,211,1,24,1,12,0,12
1781327,18,18,1995,3,"male",79,31,24,0,1,0,1,0,0
1781388,50,26,1963,9,"male",465,30,21,3,0,3,0,0,0
1781405,26,19,1987,5,"male",1026,59,26,10,0,0,0,10,0
1781436,24,4,1989,11,"female",358,39,27,4,21,4,18,0,3
1781455,27,9,1986,10,"male",1040,126,53,0,0,0,0,0,0
1781471,18,3,1995,11,"female",188,341,156,52,164,52,151,0,13
1781485,26,9,1987,8,"female",452,49,21,7,2,7,2,0,0
1781494,28,2,1985,9,"female",289,130,69,175,232,175,211,0,21
1781497,70,23,1943,8,"male",24,42,39,2,2,0,1,2,1
1781505,21,13,1992,10,"male",927,198,56,2,14,0,2,2,12
1781506,27,17,1986,4,"male",166,33,20,2,0,0,0,2,0
1781562,21,17,1992,6,"female",391,284,237,0,10,0,3,0,7
1781576,25,1,1988,1,"male",165,1,1,0,2,0,0,0,2
1781577,18,13,1995,7,"male",167,85,71,10,7,10,5,0,2
1781608,17,18,1996,3,"male",142,119,80,296,15,22,8,274,7
1781618,20,2,1993,8,"male",91,40,33,8,11,8,10,0,1
1781641,15,22,1998,12,"female",563,1767,838,4185,5807,437,1971,3748,3836
1781643,32,14,1981,2,"male",767,23,5,1,1,0,0,1,1
1781674,36,12,1977,5,"female",1347,66,29,19,25,7,12,12,13
1781675,15,5,1998,2,"male",122,6,4,11,0,0,0,11,0
1781702,40,13,1973,1,"female",686,1,1,0,0,0,0,0,0
1781710,64,18,1949,3,"female",122,53,30,0,2,0,2,0,0
1781716,28,18,1985,11,"male",199,135,107,4,29,4,11,0,18
1781740,24,20,1989,1,"male",456,22,10,10,2,10,0,0,2
1781760,27,1,1986,1,"male",110,10,6,34,1,0,1,34,0
1781781,48,21,1965,10,"female",683,57,32,403,160,0,74,403,86
1781806,50,17,1963,5,"female",1124,434,293,33,94,21,59,12,35
1781813,108,25,1905,9,"male",560,258,235,82,48,80,38,2,10
1781821,55,21,1958,7,"female",337,7,3,0,0,0,0,0,0
1781834,43,1,1970,1,"male",660,10,8,0,0,0,0,0,0
1781835,53,18,1960,4,"male",1136,80,74,2,1,2,1,0,0
1781840,19,2,1994,2,"female",628,257,106,2,2,2,2,0,0
1781843,17,27,1996,7,"male",40,115,94,12,45,12,25,0,20
1781845,42,9,1971,6,"male",470,171,83,22,6,0,0,22,6
1781875,18,9,1995,5,"male",663,446,180,6,52,6,7,0,45
1781878,46,1,1967,1,"male",478,1,0,58,9,56,5,2,4
1781883,103,27,1910,4,"male",1288,221,146,159,84,13,51,146,33
1781958,32,17,1981,5,"female",555,193,70,61,112,61,102,0,10
1781971,64,20,1949,10,"male",433,34,24,141,56,141,50,0,6
1782015,83,26,1930,9,"male",1766,29,4,43,12,0,3,43,9
1782035,75,22,1938,11,"female",1440,134,34,6,4,0,2,6,2
1782036,18,11,1995,5,"male",33,63,33,479,81,389,55,90,26
1782047,72,19,1941,5,"male",249,23,17,7,13,0,6,7,7
1782049,23,6,1990,5,"male",44,91,78,11,10,11,9,0,1
1782050,55,12,1958,4,"female",1211,80,30,570,275,570,122,0,153
1782052,70,14,1943,3,"female",1120,25,12,45,29,45,24,0,5
1782094,28,26,1985,11,"male",610,57,27,39,0,37,0,2,0
1782104,100,29,1913,10,"male",2042,269,170,339,221,339,203,0,18
1782112,22,11,1991,11,"male",188,257,194,918,597,805,538,113,59
1782118,25,1,1988,1,"female",24,2,2,7,0,7,0,0,0
1782129,23,27,1990,1,"female",188,83,36,1,0,1,0,0,0
1782131,99,14,1914,3,"male",1482,688,294,6,12,6,10,0,2
1782137,23,20,1990,4,"female",490,467,323,65,66,38,24,27,42
1782144,21,22,1992,7,"male",330,10,2,0,0,0,0,0,0
1782167,62,19,1951,10,"male",1354,29,12,31,18,31,12,0,6
1782177,21,1,1992,10,"male",1602,326,52,158,44,158,14,0,30
1782188,27,10,1986,3,"female",114,25,14,93,8,93,5,0,3
1782194,31,24,1982,11,"male",329,58,45,4,0,4,0,0,0
1782195,20,1,1993,9,"female",446,0,0,0,0,0,0,0,0
1782198,39,14,1974,12,"male",151,80,54,19,18,19,9,0,9
1782228,24,17,1989,1,"male",654,0,0,0,0,0,0,0,0
1782250,108,27,1905,5,"male",2366,263,127,71,100,71,81,0,19
1782252,24,20,1989,6,"male",1006,172,98,9,0,9,0,0,0
1782283,20,29,1993,9,"female",469,153,72,38,0,38,0,0,0
1782353,14,15,1999,10,"female",280,411,200,506,565,462,290,44,275
1782367,28,10,1985,9,"male",167,77,39,154,18,154,16,0,2
1782428,33,10,1980,12,"female",395,71,49,1764,551,1753,394,11,157
1782454,20,9,1993,2,"male",1365,142,59,44,21,22,15,22,6
1782513,21,13,1992,9,"male",1164,491,250,2,4,0,0,2,4
1782520,17,7,1996,3,"male",666,252,85,44,30,44,13,0,17
1782546,67,18,1946,4,"female",1772,97,36,268,71,268,48,0,23
1782575,26,17,1987,9,"male",196,225,182,0,0,0,0,0,0
1782581,68,23,1945,1,"male",289,221,196,27,0,0,0,27,0
1782583,23,9,1990,11,"male",136,35,24,0,0,0,0,0,0
1782586,35,19,1978,10,"female",436,72,38,7,11,5,7,2,4
1782612,29,22,1984,1,"male",87,18,12,9,1,9,1,0,0
1782615,23,12,1990,11,"female",281,482,90,0,1,0,0,0,1
1782632,20,2,1993,5,"female",468,46,28,0,0,0,0,0,0
1782646,15,9,1998,3,"female",39,414,85,94,400,29,177,65,223
1782657,15,26,1998,10,"female",391,94,27,13,5,13,4,0,1
1782674,94,1,1919,10,"female",552,33,28,0,0,0,0,0,0
1782685,41,5,1972,10,"male",543,123,83,0,0,0,0,0,0
1782688,24,25,1989,12,"female",758,951,204,65,318,16,210,49,108
1782690,28,23,1985,5,"male",123,46,26,0,4,0,1,0,3
1782714,26,9,1987,12,"male",46,23,20,0,1,0,0,0,1
1782730,49,11,1964,3,"female",349,239,114,212,156,212,95,0,61
1782769,17,18,1996,9,"male",1575,1932,848,470,4199,116,1619,354,2580
1782771,56,12,1957,4,"male",509,4,3,0,0,0,0,0,0
1782783,36,3,1977,8,"male",589,172,109,248,66,244,54,4,12
1782800,18,6,1995,4,"male",295,100,23,4,0,4,0,0,0
1782807,113,3,1900,6,"female",1640,77,18,11,4,0,0,11,4
1782832,100,18,1913,11,"male",1545,495,174,21,58,1,21,20,37
1782874,36,15,1977,10,"male",600,56,51,52,15,22,15,30,0
1782876,57,13,1956,6,"male",226,6,5,15,0,8,0,7,0
1782915,18,30,1995,9,"male",164,307,174,31,19,0,0,31,19
1782921,103,4,1910,4,"male",532,111,87,7,0,7,0,0,0
1782953,34,6,1979,3,"male",264,75,54,27,62,27,46,0,16
1782968,18,12,1995,5,"male",25,32,25,22,6,22,4,0,2
1782977,22,26,1991,10,"female",687,178,62,4,4,4,1,0,3
1783003,68,10,1945,12,"male",885,336,183,168,61,168,60,0,1
1783013,53,22,1960,7,"female",619,30,22,0,1,0,0,0,1
1783020,33,22,1980,4,"female",406,152,117,418,385,416,358,2,27
1783022,30,25,1983,11,"male",278,63,34,10,16,9,10,1,6
1783024,23,27,1990,5,"male",250,29,26,0,1,0,1,0,0
1783051,108,14,1905,9,"male",8,18,18,22,5,22,5,0,0
1783065,36,14,1977,12,"male",136,18,1,17,11,17,11,0,0
1783072,18,24,1995,7,"male",337,126,94,28,9,28,6,0,3
1783082,35,5,1978,2,"male",880,96,16,0,0,0,0,0,0
1783096,17,13,1996,1,"male",432,307,148,74,57,10,5,64,52
1783113,20,1,1993,1,"female",476,126,101,1,0,1,0,0,0
1783126,67,11,1946,7,"female",842,66,35,1,4,1,4,0,0
1783156,31,5,1982,1,"male",146,20,15,14,0,14,0,0,0
1783187,28,27,1985,10,"female",303,5,5,0,0,0,0,0,0
1783191,15,14,1998,3,"male",287,197,179,2,3,2,3,0,0
1783196,25,2,1988,8,"female",91,44,34,0,1,0,1,0,0
1783208,16,9,1997,5,"male",99,23,4,145,309,145,264,0,45
1783209,26,23,1987,11,"male",523,49,36,9,0,0,0,9,0
1783226,77,11,1936,8,"female",644,32,23,0,2,0,2,0,0
1783231,91,31,1922,10,"female",1080,304,135,27,160,3,36,24,124
1783248,22,2,1991,1,"male",85,11,6,21,2,15,2,6,0
1783261,108,3,1905,10,"female",1965,231,111,351,300,186,71,165,229
1783282,22,1,1991,5,"male",260,8,7,1324,16,647,0,677,16
1783287,18,9,1995,12,"female",107,2614,75,70,907,70,789,0,118
1783294,20,24,1993,10,"male",624,450,410,4,1,0,0,4,1
1783302,52,10,1961,12,"female",1513,40,24,26,43,0,24,26,19
1783327,35,17,1978,8,"female",74,113,102,757,213,757,86,0,127
1783336,25,7,1988,4,"male",695,102,86,0,0,0,0,0,0
1783357,43,13,1970,2,"male",1884,7,3,0,0,0,0,0,0
1783370,27,10,1986,4,"female",512,57,45,34,6,34,0,0,6
1783375,18,7,1995,8,"male",772,159,131,27,24,27,24,0,0
1783376,19,20,1994,6,"male",367,81,53,1,4,1,4,0,0
1783386,23,13,1990,10,"male",326,435,358,2,6,0,1,2,5
1783406,29,9,1984,11,"female",227,66,44,129,33,129,9,0,24
1783421,21,5,1992,5,"male",521,74,34,0,15,0,14,0,1
1783470,25,10,1988,8,"female",520,320,255,74,18,69,12,5,6
1783471,73,17,1940,7,"male",1652,39,13,96,60,91,33,5,27
1783519,28,28,1985,1,"female",255,332,295,181,46,178,24,3,22
1783551,35,25,1978,7,"female",587,191,157,30,0,28,0,2,0
1783555,41,21,1972,1,"female",177,156,86,5,14,0,5,5,9
1783573,53,22,1960,6,"female",616,5,4,4,3,4,3,0,0
1783577,23,1,1990,1,"male",5,0,0,0,0,0,0,0,0
1783584,42,28,1971,10,"female",530,125,79,21,31,20,22,1,9
1783592,68,16,1945,4,"male",615,272,203,1,6,1,5,0,1
1783632,23,22,1990,5,"female",173,77,63,35,33,35,19,0,14
1783646,27,19,1986,1,"female",436,9,8,0,0,0,0,0,0
1783661,21,27,1992,7,"male",177,117,106,2,0,0,0,2,0
1783684,53,14,1960,8,"female",114,66,44,53,46,0,9,53,37
1783717,28,17,1985,10,"female",163,39,20,2,0,2,0,0,0
1783743,16,12,1997,5,"male",785,170,54,14,2,11,0,3,2
1783772,28,19,1985,7,"male",520,20,8,0,0,0,0,0,0
1783780,31,6,1982,8,"male",1031,46,22,14,0,13,0,1,0
1783785,74,3,1939,10,"male",2371,28,11,0,4,0,3,0,1
1783881,45,9,1968,12,"male",822,35,26,1,39,0,24,1,15
1783886,22,20,1991,7,"male",354,165,131,0,2,0,0,0,2
1783904,24,27,1989,11,"male",445,146,53,0,0,0,0,0,0
1783916,14,17,1999,6,"male",183,107,76,0,0,0,0,0,0
1783937,28,29,1985,8,"female",340,118,106,65,60,65,54,0,6
1783940,15,27,1998,7,"female",468,288,173,11,14,0,6,11,8
1783949,73,7,1940,9,"male",1263,522,223,111,269,110,162,1,107
1783985,19,19,1994,11,"male",1,0,0,0,0,0,0,0,0
1783995,83,4,1930,2,"female",1785,1144,437,190,293,1,87,189,206
1784014,26,10,1987,7,"male",233,53,43,11,5,11,4,0,1
1784022,34,13,1979,2,"female",259,13,9,8,1,8,0,0,1
1784031,53,22,1960,3,"male",491,227,157,36,0,7,0,29,0
1784043,25,1,1988,1,"male",326,23,12,2,3,1,3,1,0
1784047,47,10,1966,5,"female",789,186,129,338,637,266,554,72,83
1784072,32,23,1981,12,"female",396,89,67,33,28,33,24,0,4
1784082,25,25,1988,3,"male",251,75,43,5,0,5,0,0,0
1784101,46,30,1967,6,"male",99,73,41,23,17,21,14,2,3
1784117,17,29,1996,5,"male",922,256,132,15,17,15,11,0,6
1784134,27,21,1986,11,"female",300,463,65,1147,1297,1007,1089,140,208
1784149,17,31,1996,5,"female",461,125,47,117,89,116,83,1,6
1784174,108,15,1905,5,"male",1305,132,85,20,6,17,2,3,4
1784199,34,5,1979,5,"male",90,0,0,0,0,0,0,0,0
1784212,26,12,1987,10,"female",419,28,15,1,1,1,1,0,0
1784213,48,21,1965,5,"female",948,131,70,41,156,39,38,2,118
1784241,55,22,1958,2,"female",954,240,173,103,41,0,16,103,25
1784264,21,11,1992,6,"male",492,31,21,0,0,0,0,0,0
1784273,92,6,1921,10,"male",455,969,745,110,67,10,23,100,44
1784290,102,10,1911,1,"female",1637,378,187,134,22,134,18,0,4
1784410,68,17,1945,8,"male",98,34,29,7,0,7,0,0,0
1784414,53,8,1960,1,"female",1141,186,74,525,52,515,23,10,29
1784417,103,1,1910,1,"female",814,104,56,21,5,0,0,21,5
1784430,38,8,1975,9,"male",524,324,175,128,9,46,0,82,9
1784450,52,28,1961,1,"female",1662,133,76,81,13,0,7,81,6
1784455,14,4,1999,2,"male",338,5,2,1,0,1,0,0,0
1784464,28,27,1985,8,"male",880,58,48,2,41,2,38,0,3
1784465,19,5,1994,11,"male",487,246,64,0,0,0,0,0,0
1784466,30,13,1983,6,"male",398,162,67,6,3,6,2,0,1
1784479,17,4,1996,5,"male",146,49,39,0,5,0,1,0,4
1784503,31,15,1982,7,"female",298,658,554,1550,425,1550,387,0,38
1784519,103,16,1910,5,"female",861,580,151,32,6,32,4,0,2
1784543,33,15,1980,1,"female",398,74,37,8,7,8,4,0,3
1784576,79,26,1934,11,"female",1641,49,27,3109,44,3109,38,0,6
1784577,17,27,1996,12,"male",512,143,113,11,2,11,1,0,1
1784605,53,1,1960,1,"male",429,28,17,2,2,0,0,2,2
1784644,51,25,1962,2,"male",331,9,9,4,4,0,0,4,4
1784677,17,18,1996,1,"male",277,18,17,12,33,0,10,12,23
1784688,17,26,1996,12,"male",188,235,104,67,24,3,8,64,16
1784696,26,18,1987,2,"female",562,70,17,194,187,194,80,0,107
1784721,24,14,1989,2,"male",634,21,18,30,2,0,2,30,0
1784733,26,3,1987,12,"female",12,266,38,13,64,0,34,13,30
1784735,67,13,1946,2,"male",609,53,38,5,181,5,59,0,122
1784740,23,12,1990,9,"male",757,205,102,5,24,5,14,0,10
1784794,26,14,1987,11,"male",223,343,335,3,0,3,0,0,0
1784817,87,13,1926,8,"female",84,58,47,8,11,0,0,8,11
1784840,100,7,1913,6,"female",2145,1016,984,108,31,100,18,8,13
1784846,57,20,1956,4,"male",1924,106,35,4,2,0,0,4,2
1784863,27,23,1986,6,"male",170,64,62,2,12,2,8,0,4
1784909,18,18,1995,4,"male",1115,402,340,4,40,4,35,0,5
1784952,23,25,1990,12,"male",68,14,14,19,7,19,7,0,0
1784955,52,24,1961,7,"female",171,763,639,252,295,20,156,232,139
1784959,28,1,1985,5,"female",582,150,17,7,20,7,16,0,4
1784983,32,12,1981,10,"male",539,17,15,0,7,0,7,0,0
1784995,17,28,1996,4,"female",484,139,25,49,42,49,25,0,17
1785017,20,6,1993,5,"male",168,223,201,126,54,126,54,0,0
1785041,51,6,1962,1,"female",1052,81,40,54,49,43,40,11,9
1785073,24,30,1989,11,"male",11,14,7,0,0,0,0,0,0
1785074,26,28,1987,11,"female",438,153,80,0,0,0,0,0,0
1785123,17,15,1996,9,"male",343,162,126,5,16,0,4,5,12
1785138,18,20,1995,3,"male",210,177,145,20,5,20,3,0,2
1785170,30,17,1983,7,"female",265,72,33,0,0,0,0,0,0
1785176,15,16,1998,8,"male",667,438,391,0,0,0,0,0,0
1785185,24,15,1989,5,"male",738,172,149,0,0,0,0,0,0
1785189,16,1,1997,1,"female",416,364,159,24,134,12,104,12,30
1785194,29,28,1984,8,"male",505,85,59,1,0,1,0,0,0
1785253,76,17,1937,4,"male",98,6,6,20,1,20,0,0,1
1785257,32,14,1981,5,"male",282,77,69,20,58,4,18,16,40
1785276,19,30,1994,5,"male",556,48,43,0,22,0,20,0,2
1785287,51,19,1962,4,"female",1289,93,62,12,26,9,13,3,13
1785310,38,23,1975,3,"male",1198,312,162,26,25,26,18,0,7
1785335,61,16,1952,6,"male",531,31,25,11,1,0,0,11,1
1785375,28,23,1985,5,"male",10,27,26,1,6,1,4,0,2
1785377,18,28,1995,1,"male",199,29,15,1,1,0,1,1,0
1785380,61,8,1952,5,"female",292,23,18,28,8,19,4,9,4
1785405,31,9,1982,2,"male",152,1,1,0,0,0,0,0,0
1785411,43,26,1970,12,"female",309,60,46,518,59,518,49,0,10
1785442,55,12,1958,10,"female",21,24,15,27,14,0,0,27,14
1785446,103,9,1910,10,"female",1790,2295,197,7,113,0,41,7,72
1785454,67,19,1946,7,"male",183,35,32,0,4,0,4,0,0
1785484,24,18,1989,10,"male",552,157,125,3,3,0,1,3,2
1785493,39,12,1974,7,"male",1280,218,114,3,2,3,2,0,0
1785494,43,21,1970,5,"male",362,66,38,2,0,0,0,2,0
1785533,59,6,1954,7,"female",1811,19,10,96,4,46,3,50,1
1785539,69,17,1944,3,"male",1877,650,79,4,2,0,0,4,2
1785555,25,4,1988,11,"female",273,31,11,0,3,0,0,0,3
1785570,15,18,1998,11,"female",62,7,5,1,0,1,0,0,0
1785586,87,17,1926,2,"male",364,245,146,1154,616,322,165,832,451
1785588,46,29,1967,11,"male",478,75,39,629,23,625,6,4,17
1785638,15,13,1998,1,"male",607,599,500,73,1,41,0,32,1
1785652,28,3,1985,1,"male",426,13,9,1,0,1,0,0,0
1785677,18,10,1995,7,"male",91,8,3,17,23,17,23,0,0
1785686,53,9,1960,8,"female",1510,198,117,3731,1128,418,541,3313,587
1785718,26,19,1987,7,"female",831,195,77,109,82,38,35,71,47
1785721,58,29,1955,11,"male",271,195,147,4,18,0,3,4,15
1785760,23,8,1990,1,"male",362,201,164,0,0,0,0,0,0
1785776,15,18,1998,10,"female",298,29,21,129,101,92,37,37,64
1785784,23,26,1990,7,"female",98,27,18,188,85,188,67,0,18
1785811,17,2,1996,7,"female",301,1656,331,2549,2188,1345,1416,1204,772
1785817,21,26,1992,11,"female",475,164,139,4,24,4,18,0,6
1785829,21,28,1992,12,"male",598,17,4,0,0,0,0,0,0
1785860,26,1,1987,1,"female",667,4,3,238,101,55,57,183,44
1785869,43,15,1970,1,"male",1215,139,38,105,35,105,26,0,9
1785876,70,10,1943,4,"female",1555,63,28,36,0,36,0,0,0
1785894,18,1,1995,1,"male",281,167,90,11,4,0,0,11,4
1785901,21,17,1992,12,"male",206,6,5,0,0,0,0,0,0
1785906,108,16,1905,12,"male",1764,188,68,21,2,19,1,2,1
1785981,50,8,1963,8,"male",683,87,50,1050,461,1050,262,0,199
1786001,20,19,1993,5,"male",575,47,39,2,1,0,1,2,0
1786039,24,16,1989,3,"male",252,150,100,16,25,16,17,0,8
1786091,22,15,1991,4,"female",25,16,12,46,11,42,11,4,0
1786096,64,25,1949,5,"female",1163,64,37,325,121,172,9,153,112
1786118,17,16,1996,12,"male",132,30,21,0,2,0,0,0,2
1786135,57,11,1956,3,"female",1555,25,6,0,2,0,1,0,1
1786141,50,6,1963,12,"female",574,9,5,11,9,11,8,0,1
1786158,113,21,1900,8,"female",1561,232,95,3544,514,2465,286,1079,228
1786179,31,19,1982,7,"female",215,42,31,3,1,3,0,0,1
1786181,30,19,1983,4,"male",1112,76,66,22,3,22,2,0,1
1786219,58,27,1955,3,"female",1806,256,100,4,2,4,2,0,0
1786223,108,13,1905,9,"female",2042,1706,645,234,107,57,81,177,26
1786231,52,12,1961,3,"female",212,37,22,1153,77,1153,60,0,17
1786236,17,13,1996,12,"female",389,330,113,13,170,5,94,8,76
1786293,54,16,1959,7,"male",1007,44,18,180,318,180,181,0,137
1786297,19,27,1994,8,"male",287,130,86,3,2,3,2,0,0
1786302,38,6,1975,5,"female",393,23,11,5,14,5,13,0,1
1786307,18,12,1995,3,"female",328,439,323,419,214,200,92,219,122
1786314,15,6,1998,12,"male",41,20,18,2,2,2,2,0,0
1786329,17,3,1996,1,"female",421,149,102,127,107,127,71,0,36
1786370,39,4,1974,1,"male",381,371,197,187,484,187,255,0,229
1786375,80,12,1933,2,"male",1705,31,21,4,2,0,0,4,2
1786383,19,5,1994,11,"male",499,792,349,0,4,0,3,0,1
1786432,23,1,1990,4,"male",370,47,39,1,1,1,1,0,0
1786433,36,25,1977,5,"female",100,10,10,28,5,0,0,28,5
1786461,16,28,1997,6,"female",800,210,98,4,86,4,62,0,24
1786470,31,4,1982,3,"female",226,79,75,736,63,736,41,0,22
1786493,20,20,1993,1,"male",464,142,13,21,20,15,2,6,18
1786497,68,18,1945,12,"male",46,18,11,66,16,0,1,66,15
1786503,68,7,1945,6,"male",1477,787,398,52,6,52,1,0,5
1786507,34,8,1979,10,"female",324,6,5,0,0,0,0,0,0
1786510,68,29,1945,4,"female",1511,75,25,225,34,15,23,210,11
1786546,21,6,1992,12,"female",160,5,5,1,1,1,1,0,0
1786558,108,12,1905,2,"male",1261,589,348,172,296,47,90,125,206
1786570,29,23,1984,4,"male",63,113,103,10,27,10,22,0,5
1786572,63,25,1950,1,"female",1713,140,85,744,264,744,137,0,127
1786579,14,6,1999,7,"male",0,41,40,8,0,8,0,0,0
1786597,35,14,1978,4,"female",0,0,0,0,0,0,0,0,0
1786605,56,7,1957,5,"female",620,36,17,11,9,11,9,0,0
1786636,26,1,1987,1,"male",481,49,28,2,0,0,0,2,0
1786647,108,13,1905,12,"male",1732,269,16,0,0,0,0,0,0
1786682,14,22,1999,3,"female",201,0,0,0,0,0,0,0,0
1786737,31,28,1982,2,"female",517,1,0,0,0,0,0,0,0
1786738,108,21,1905,4,"male",241,32,20,7,0,0,0,7,0
1786741,70,1,1943,1,"male",1027,96,73,8,8,0,4,8,4
1786756,54,2,1959,5,"male",548,23,18,57,20,50,12,7,8
1786805,61,21,1952,10,"male",497,81,64,5,1,0,1,5,0
1786811,50,5,1963,12,"female",299,51,14,25,23,25,22,0,1
1786833,32,21,1981,12,"female",570,209,44,101,111,4,31,97,80
1786911,53,28,1960,1,"female",54,8,5,14,12,14,11,0,1
1786915,14,10,1999,9,"male",196,5,4,0,0,0,0,0,0
1786934,28,1,1985,10,"male",333,11,6,1,1,1,0,0,1
1786939,59,15,1954,12,"male",1029,2,1,3,0,2,0,1,0
1786946,65,28,1948,2,"female",1216,22,20,3,2,3,0,0,2
1786969,66,17,1947,3,"male",426,42,15,1,2,0,1,1,1
1786973,20,26,1993,3,"male",69,59,56,0,2,0,1,0,1
1786983,93,1,1920,1,"male",1740,245,108,20,3,11,0,9,3
1786995,26,1,1987,1,"male",354,593,341,281,465,251,350,30,115
1787001,33,15,1980,7,"male",50,33,21,14,5,14,5,0,0
1787013,21,31,1992,12,"male",119,15,12,1,0,1,0,0,0
1787054,58,27,1955,11,"female",1365,80,21,26,7,26,5,0,2
1787060,25,1,1988,1,"male",120,29,19,1,0,1,0,0,0
1787062,39,9,1974,12,"male",49,86,76,742,289,493,133,249,156
1787123,18,6,1995,5,"male",1148,244,148,50,35,43,0,7,35
1787190,54,29,1959,11,"female",165,1,0,5,0,0,0,5,0
1787193,58,5,1955,5,"female",522,75,53,310,55,310,12,0,43
1787197,24,28,1989,1,"male",346,303,178,14,7,14,5,0,2
1787223,24,25,1989,4,"female",568,77,25,1,2,1,1,0,1
1787235,19,30,1994,4,"male",203,46,13,0,1,0,0,0,1
1787268,19,18,1994,10,"female",377,77,29,0,6,0,0,0,6
1787272,25,11,1988,11,"male",185,32,12,146,230,146,105,0,125
1787302,18,6,1995,2,"male",788,119,59,7,0,7,0,0,0
1787321,18,1,1995,7,"male",25,24,9,1,0,1,0,0,0
1787342,102,11,1911,11,"male",82,26,22,132,15,0,3,132,12
1787353,31,13,1982,7,"female",1090,253,110,1052,296,183,133,869,163
1787369,20,26,1993,10,"male",413,79,55,63,8,63,8,0,0
1787388,17,4,1996,10,"female",222,260,107,26,0,26,0,0,0
1787398,20,16,1993,1,"male",256,1,1,0,0,0,0,0,0
1787404,35,10,1978,11,"female",132,54,40,54,186,52,23,2,163
1787464,41,27,1972,2,"male",350,56,41,6,18,6,18,0,0
1787491,15,17,1998,11,"female",485,302,160,0,6,0,2,0,4
1787496,17,12,1996,4,"male",116,70,35,24,3,24,2,0,1
1787507,23,10,1990,3,"male",252,88,50,0,0,0,0,0,0
1787526,34,19,1979,1,"female",543,163,134,4,4,4,3,0,1
1787564,18,19,1995,12,"male",225,33,24,17,23,17,14,0,9
1787582,36,13,1977,1,"male",569,227,58,59,57,59,57,0,0
1787589,67,29,1946,4,"female",1068,216,160,1567,337,1567,193,0,144
1787613,21,27,1992,5,"female",231,1682,470,2295,4190,904,1352,1391,2838
1787639,24,9,1989,10,"male",666,5,4,0,0,0,0,0,0
1787657,35,15,1978,3,"male",476,33,20,32,2,14,1,18,1
1787675,18,25,1995,7,"male",297,488,383,5,4,5,3,0,1
1787678,19,16,1994,1,"female",185,1516,415,1744,2908,1636,2589,108,319
1787682,46,11,1967,12,"male",158,24,19,0,0,0,0,0,0
1787723,26,26,1987,4,"female",1012,75,45,211,375,193,304,18,71
1787725,108,15,1905,3,"male",528,67,41,20,74,20,35,0,39
1787734,68,2,1945,4,"male",681,773,469,1129,172,1129,156,0,16
1787739,63,17,1950,1,"female",86,29,25,10,9,1,6,9,3
1787740,30,13,1983,1,"male",699,249,161,1,12,1,12,0,0
1787749,29,16,1984,4,"male",522,39,29,1,2,1,2,0,0
1787759,21,27,1992,12,"male",334,115,45,1,0,0,0,1,0
1787769,42,25,1971,12,"female",446,459,307,1344,687,876,287,468,400
1787774,25,1,1988,1,"female",102,4,3,4,0,3,0,1,0
1787776,45,23,1968,5,"female",134,48,28,106,32,1,17,105,15
1787802,18,7,1995,7,"male",320,95,24,6,1,6,1,0,0
1787804,17,19,1996,9,"male",257,7,4,0,0,0,0,0,0
1787806,25,1,1988,1,"male",39,2,2,0,0,0,0,0,0
1787820,20,1,1993,12,"female",207,78,52,9,4,9,3,0,1
1787847,38,28,1975,7,"male",639,64,41,12,15,12,12,0,3
1787854,71,9,1942,5,"female",399,61,45,74,1,74,1,0,0
1787859,24,12,1989,1,"male",33,64,54,1,2,1,2,0,0
1787937,16,13,1997,7,"female",655,138,53,1151,187,1151,173,0,14
1787947,19,17,1994,12,"female",247,295,83,2,6,2,5,0,1
1787959,61,12,1952,3,"female",1434,45,15,34,16,32,13,2,3
1787998,70,7,1943,3,"female",533,104,93,2214,433,2174,265,40,168
1788013,15,22,1998,5,"male",412,274,217,4,2,0,0,4,2
1788036,42,17,1971,6,"female",76,148,126,1862,303,1728,141,134,162
1788038,47,11,1966,5,"female",203,28,15,84,10,80,8,4,2
1788081,26,20,1987,7,"male",153,49,36,0,3,0,3,0,0
1788133,51,12,1962,11,"male",1606,42,11,1,0,1,0,0,0
1788158,18,28,1995,11,"female",198,79,24,50,186,50,138,0,48
1788159,19,12,1994,1,"male",601,310,232,0,1,0,0,0,1
1788177,54,28,1959,5,"female",56,29,22,13,2,0,1,13,1
1788221,21,24,1992,10,"male",675,491,434,1,78,1,34,0,44
1788222,14,3,1999,8,"male",318,114,49,10,5,10,5,0,0
1788225,30,8,1983,5,"male",478,120,98,0,0,0,0,0,0
1788232,13,1,2000,1,"male",298,72,18,1,74,1,11,0,63
1788249,24,22,1989,5,"male",647,709,395,482,572,482,527,0,45
1788253,96,18,1917,10,"female",2353,245,67,332,622,232,464,100,158
1788291,18,2,1995,8,"female",224,233,142,19,18,19,14,0,4
1788304,22,28,1991,5,"male",288,50,37,74,7,69,4,5,3
1788315,26,20,1987,12,"female",273,103,17,158,221,158,192,0,29
1788342,13,17,2000,4,"female",85,202,34,8,6,8,5,0,1
1788359,36,11,1977,3,"male",175,45,11,0,3,0,2,0,1
1788388,75,7,1938,7,"female",1576,20,12,9,4,0,0,9,4
1788389,24,26,1989,3,"male",268,147,100,3,31,3,9,0,22
1788402,65,23,1948,7,"female",305,11,9,8,1,8,1,0,0
1788415,51,17,1962,7,"female",953,84,48,161,105,161,89,0,16
1788441,108,16,1905,3,NA,1908,202,122,61,57,3,9,58,48
1788443,36,30,1977,7,"female",411,118,48,22,35,22,28,0,7
1788503,68,18,1945,9,"male",925,291,184,52,28,52,23,0,5
1788511,59,7,1954,3,"male",907,226,91,24,86,24,48,0,38
1788568,24,23,1989,3,"male",231,14,10,13,25,13,24,0,1
1788574,24,16,1989,9,"female",388,136,103,37,37,37,37,0,0
1788575,53,11,1960,11,"female",106,79,72,2,0,2,0,0,0
1788596,52,29,1961,6,"female",696,128,79,687,396,560,217,127,179
1788611,66,13,1947,10,"female",40,23,11,2,3,0,1,2,2
1788624,17,14,1996,8,"male",83,21,18,0,0,0,0,0,0
1788668,62,16,1951,7,"female",325,24,16,22,21,0,1,22,20
1788673,27,13,1986,8,"female",542,215,100,44,281,22,106,22,175
1788676,51,6,1962,10,"male",1042,5,3,0,1,0,0,0,1
1788677,47,11,1966,10,"female",655,66,41,0,0,0,0,0,0
1788679,21,2,1992,2,"female",365,5,2,0,0,0,0,0,0
1788685,20,15,1993,1,"male",165,271,246,3,3,3,3,0,0
1788693,17,4,1996,4,"male",423,308,245,334,995,73,323,261,672
1788696,47,2,1966,8,"male",607,24,14,26,2,0,2,26,0
1788723,23,11,1990,1,"female",405,29,15,6,13,6,12,0,1
1788765,34,20,1979,8,"female",275,186,106,551,864,550,430,1,434
1788772,55,9,1958,1,"female",195,36,20,432,93,432,69,0,24
1788777,27,15,1986,9,"male",260,246,199,119,26,119,15,0,11
1788794,39,26,1974,7,"female",400,41,27,71,11,68,7,3,4
1788816,15,23,1998,10,"male",320,61,39,0,12,0,6,0,6
1788822,20,17,1993,10,"male",463,725,377,219,208,219,135,0,73
1788834,22,18,1991,11,"female",740,1,0,0,0,0,0,0,0
1788849,70,8,1943,10,"male",662,54,44,79,17,49,6,30,11
1788856,14,5,1999,12,"female",152,453,275,1043,639,773,279,270,360
1788877,31,27,1982,1,"male",301,24,18,55,1,55,1,0,0
1788886,17,3,1996,7,"female",439,298,93,863,1497,2,190,861,1307
1788895,15,1,1998,1,"male",630,476,360,0,1,0,0,0,1
1788904,19,13,1994,4,"male",817,99,80,0,0,0,0,0,0
1788927,14,5,1999,6,"female",133,16,12,0,0,0,0,0,0
1788930,25,8,1988,8,"male",263,414,406,869,138,850,126,19,12
1788949,16,24,1997,5,"female",338,379,189,203,1141,71,235,132,906
1789016,32,2,1981,2,"male",446,14,13,3,0,3,0,0,0
1789053,21,10,1992,4,"female",458,585,434,30,92,11,50,19,42
1789060,17,6,1996,6,"male",129,147,85,108,28,0,15,108,13
1789081,18,4,1995,8,"male",1294,77,71,37,1,0,0,37,1
1789082,32,6,1981,10,"male",445,24,6,1,1,1,1,0,0
1789087,35,8,1978,10,"male",76,8,7,0,0,0,0,0,0
1789090,17,7,1996,9,"female",369,424,226,405,321,405,243,0,78
1789092,60,15,1953,10,"female",1592,486,258,2792,892,828,428,1964,464
1789111,20,19,1993,2,"female",165,37,31,50,17,0,10,50,7
1789150,56,8,1957,2,"female",814,57,33,2881,697,10,424,2871,273
1789174,19,22,1994,9,"female",453,18,14,1,1,1,1,0,0
1789179,29,1,1984,6,"male",713,43,25,8,5,8,5,0,0
1789193,16,19,1997,8,"male",306,49,17,84,1,83,1,1,0
1789198,43,13,1970,7,"female",239,7,5,6,0,6,0,0,0
1789201,17,12,1996,12,"male",185,328,290,0,0,0,0,0,0
1789213,47,13,1966,8,"male",196,1,1,46,0,0,0,46,0
1789227,24,1,1989,1,"male",233,33,23,1,0,1,0,0,0
1789239,44,1,1969,5,"female",1390,64,20,381,367,275,191,106,176
1789269,16,22,1997,5,"male",248,75,27,324,49,2,17,322,32
1789296,42,31,1971,10,"male",47,1,1,3,0,3,0,0,0
1789300,18,29,1995,12,"male",54,25,24,0,0,0,0,0,0
1789346,53,8,1960,5,"male",40,2,1,0,0,0,0,0,0
1789385,22,17,1991,11,"female",574,119,73,34,9,34,9,0,0
1789411,45,28,1968,5,"male",294,41,34,61,46,16,0,45,46
1789457,33,12,1980,9,"male",550,15,15,6,3,0,1,6,2
1789468,62,8,1951,6,"female",1300,83,60,9,77,0,44,9,33
1789480,27,3,1986,6,"male",371,157,83,148,56,98,50,50,6
1789485,23,6,1990,9,"male",391,516,91,22,185,22,127,0,58
1789511,24,18,1989,3,"male",577,20,11,1,1,0,1,1,0
1789532,18,24,1995,2,"female",226,118,87,152,148,113,113,39,35
1789541,25,5,1988,5,"male",216,211,142,11,11,0,6,11,5
1789544,43,13,1970,7,"female",324,102,68,1759,283,1373,211,386,72
1789614,27,19,1986,10,"male",292,69,46,4,5,4,5,0,0
1789620,108,1,1905,1,"male",849,135,66,22,58,21,13,1,45
1789647,23,22,1990,1,"male",119,41,23,43,6,43,6,0,0
1789685,52,19,1961,3,"female",397,1,0,0,0,0,0,0,0
1789688,108,26,1905,3,"female",621,357,126,8,28,8,28,0,0
1789707,24,15,1989,9,"male",393,128,97,25,13,25,10,0,3
1789715,17,26,1996,12,"male",6,40,38,1,1,1,0,0,1
1789743,18,30,1995,5,"male",147,154,137,0,0,0,0,0,0
1789748,31,21,1982,7,"female",47,30,14,37,23,37,22,0,1
1789770,14,21,1999,4,"male",561,169,142,21,1,3,0,18,1
1789771,14,26,1999,7,"female",357,4641,755,1403,2786,1282,756,121,2030
1789776,18,1,1995,2,"male",37,122,120,37,6,37,4,0,2
1789782,41,5,1972,2,"female",2166,198,98,1013,825,257,297,756,528
1789857,43,27,1970,2,"male",956,263,190,251,183,1,34,250,149
1789877,17,1,1996,8,"male",195,173,132,64,70,47,28,17,42
1789889,14,15,1999,5,"female",72,243,42,10,23,10,22,0,1
1789893,35,28,1978,5,"male",478,293,272,0,1,0,1,0,0
1789935,58,27,1955,12,"male",862,8,6,14,21,0,2,14,19
1789951,20,8,1993,7,"female",263,149,64,182,76,182,53,0,23
1789956,76,2,1937,1,"male",1362,92,48,5,32,0,19,5,13
1789977,26,6,1987,5,"male",463,28,19,44,27,40,26,4,1
1789980,38,4,1975,1,"male",558,65,40,23,12,1,8,22,4
1789987,31,1,1982,1,"male",253,110,69,16,7,16,3,0,4
1790008,44,17,1969,3,"female",282,95,72,24,253,11,201,13,52
1790013,19,24,1994,2,"male",382,135,69,19,33,0,6,19,27
1790014,108,18,1905,9,"female",1327,197,84,161,236,144,92,17,144
1790027,103,25,1910,7,"male",303,280,212,174,229,170,187,4,42
1790112,32,2,1981,2,"male",243,37,27,0,0,0,0,0,0
1790119,16,1,1997,1,"female",168,4,3,0,0,0,0,0,0
1790126,53,6,1960,3,"male",166,124,106,2,23,2,17,0,6
1790143,19,24,1994,8,"male",453,2,1,0,0,0,0,0,0
1790146,59,4,1954,12,"male",30,18,5,2,6,0,0,2,6
1790181,26,13,1987,10,"female",785,39,8,0,0,0,0,0,0
1790204,33,6,1980,8,"female",607,34,18,379,110,8,19,371,91
1790254,43,25,1970,8,"male",477,27,15,0,1,0,1,0,0
1790286,54,26,1959,3,"female",586,51,41,236,115,236,18,0,97
1790317,16,5,1997,9,"female",88,74,64,5,6,1,1,4,5
1790331,36,23,1977,11,"female",30,34,20,6,61,6,57,0,4
1790359,66,6,1947,8,"female",133,25,21,66,35,1,7,65,28
1790382,78,2,1935,10,"male",952,78,45,54,4,0,2,54,2
1790432,16,18,1997,6,"male",575,646,239,2,0,0,0,2,0
1790438,19,10,1994,9,"female",584,537,374,166,184,74,26,92,158
1790446,14,20,1999,8,"male",375,168,100,85,130,37,19,48,111
1790503,29,13,1984,5,"male",382,67,48,4,7,4,6,0,1
1790514,16,6,1997,1,"male",302,115,23,73,26,73,23,0,3
1790561,32,21,1981,5,"male",146,3,0,11,0,11,0,0,0
1790573,25,1,1988,1,"female",203,20,15,0,15,0,9,0,6
1790575,113,12,1900,7,"female",1250,167,50,13,28,13,9,0,19
1790577,51,21,1962,3,"female",390,36,32,15,25,15,6,0,19
1790585,27,28,1986,3,"female",619,11,7,0,0,0,0,0,0
1790586,107,6,1906,5,"male",1578,570,435,2,20,2,8,0,12
1790590,29,24,1984,8,"female",602,51,29,33,20,33,14,0,6
1790645,18,30,1995,11,"male",154,83,63,1,0,1,0,0,0
1790651,63,14,1950,8,"male",489,14,7,0,0,0,0,0,0
1790663,43,31,1970,3,"male",600,34,34,0,0,0,0,0,0
1790669,14,12,1999,4,"female",168,414,120,96,44,0,11,96,33
1790676,18,7,1995,1,"male",408,255,134,0,27,0,3,0,24
1790677,42,18,1971,7,"female",225,136,74,322,276,144,31,178,245
1790680,18,18,1995,12,"female",172,310,117,100,191,100,136,0,55
1790689,27,2,1986,9,"male",358,75,69,0,4,0,3,0,1
1790696,50,13,1963,5,"female",365,116,13,1,16,0,8,1,8
1790717,108,16,1905,5,"male",818,259,145,161,11,97,9,64,2
1790744,21,6,1992,6,"female",515,427,248,486,424,10,116,476,308
1790767,52,2,1961,3,"female",483,274,205,54,22,19,6,35,16
1790777,28,3,1985,2,"male",307,39,27,0,0,0,0,0,0
1790800,97,4,1916,5,"male",1575,663,285,15,8,15,8,0,0
1790812,26,1,1987,5,"male",601,1,0,0,0,0,0,0,0
1790894,18,9,1995,7,"male",343,156,126,0,20,0,16,0,4
1790900,31,1,1982,1,"male",264,71,41,61,68,61,51,0,17
1790941,62,31,1951,1,"female",1343,51,32,60,17,0,8,60,9
1790946,51,19,1962,3,"male",279,26,15,1,9,1,9,0,0
1790977,43,16,1970,5,"female",642,8,6,10,2,4,1,6,1
1790978,15,28,1998,10,"female",86,113,103,14,5,14,5,0,0
1791000,27,7,1986,2,"male",327,178,105,29,9,29,7,0,2
1791016,93,1,1920,1,"female",1978,285,204,75,15,13,4,62,11
1791020,21,13,1992,6,"male",418,50,39,0,0,0,0,0,0
1791038,21,8,1992,1,"male",389,186,160,70,409,70,242,0,167
1791039,25,1,1988,11,"male",26,1,1,33,4,33,0,0,4
1791052,29,8,1984,11,"male",436,702,550,0,0,0,0,0,0
1791060,23,14,1990,1,"male",623,84,76,13,9,13,9,0,0
1791073,59,22,1954,7,"male",158,54,26,9,13,0,5,9,8
1791129,20,2,1993,8,"male",428,64,44,23,2,23,1,0,1
1791144,13,30,2000,8,"female",58,100,87,6,4,6,2,0,2
1791149,37,22,1976,8,"female",1111,318,132,560,1164,560,685,0,479
1791188,20,27,1993,5,"female",207,407,56,35,23,35,16,0,7
1791203,25,5,1988,10,"female",712,273,81,0,29,0,6,0,23
1791208,20,23,1993,5,"female",355,38,31,0,0,0,0,0,0
1791282,26,6,1987,6,"male",749,106,73,1,0,1,0,0,0
1791289,40,15,1973,7,"female",340,57,43,2,11,2,7,0,4
1791319,20,7,1993,7,"female",226,81,52,132,111,33,41,99,70
1791328,66,13,1947,3,"female",535,124,50,1134,146,0,104,1134,42
1791433,19,17,1994,7,"male",211,131,21,0,0,0,0,0,0
1791496,28,9,1985,6,"male",212,92,67,6,6,6,3,0,3
1791521,21,12,1992,6,"male",91,9,9,0,1,0,1,0,0
1791523,14,1,1999,8,"female",85,20,11,0,1,0,0,0,1
1791530,22,21,1991,3,"male",232,169,103,64,32,64,23,0,9
1791531,17,31,1996,12,"male",22,0,0,0,0,0,0,0,0
1791536,25,12,1988,4,"male",302,29,24,1,0,1,0,0,0
1791543,32,5,1981,5,"male",241,13,11,1,0,0,0,1,0
1791548,23,15,1990,6,"female",685,421,255,209,0,209,0,0,0
1791553,31,10,1982,2,"male",652,54,23,290,13,150,6,140,7
1791568,32,8,1981,9,"male",328,27,24,101,22,101,19,0,3
1791584,19,28,1994,8,"male",557,986,545,494,821,494,748,0,73
1791626,20,19,1993,11,"male",502,116,98,0,0,0,0,0,0
1791636,15,13,1998,8,"male",167,631,617,11,42,11,40,0,2
1791679,17,2,1996,2,"male",700,73,55,0,0,0,0,0,0
1791681,68,31,1945,10,"male",52,282,117,35,25,2,15,33,10
1791724,18,29,1995,11,"female",817,164,47,0,1,0,1,0,0
1791783,17,23,1996,8,"male",686,21,4,1,0,1,0,0,0
1791785,44,1,1969,4,"male",567,21,15,0,9,0,6,0,3
1791786,68,17,1945,8,"male",643,658,504,137,100,137,82,0,18
1791819,18,1,1995,1,"female",65,98,53,0,0,0,0,0,0
1791838,103,18,1910,10,"male",1286,375,258,7,85,7,79,0,6
1791849,25,23,1988,2,"female",88,95,81,63,233,63,147,0,86
1791853,36,24,1977,1,"female",586,5,4,0,0,0,0,0,0
1791880,19,4,1994,10,"female",221,113,54,41,163,5,97,36,66
1791884,69,11,1944,5,"female",856,232,179,1992,475,1992,372,0,103
1791889,33,15,1980,11,"male",202,60,53,3,2,0,0,3,2
1791892,35,3,1978,3,"female",120,2,2,7,3,7,3,0,0
1791894,27,18,1986,9,"female",187,24,11,1,2,1,1,0,1
1791907,21,21,1992,8,"male",1521,85,34,20,2,20,0,0,2
1791931,33,21,1980,1,"female",262,145,135,19,6,19,6,0,0
1791946,19,10,1994,4,"male",171,131,101,1,6,1,4,0,2
1791969,33,8,1980,12,"male",333,22,1,0,1,0,0,0,1
1791972,15,21,1998,1,"male",269,87,59,5,4,5,1,0,3
1792051,18,9,1995,4,"female",360,216,154,2,0,0,0,2,0
1792060,25,3,1988,1,"male",573,12,12,0,0,0,0,0,0
1792077,34,29,1979,11,"female",222,213,173,1,9,1,5,0,4
1792084,27,8,1986,8,"male",594,21,12,128,34,128,28,0,6
1792088,31,25,1982,12,"male",697,192,130,3,0,3,0,0,0
1792115,53,29,1960,6,"male",842,91,59,0,0,0,0,0,0
1792142,36,13,1977,5,"female",241,185,96,591,270,591,239,0,31
1792150,51,21,1962,12,"male",662,14,9,0,0,0,0,0,0
1792158,47,18,1966,3,"female",471,135,78,558,220,558,153,0,67
1792186,20,9,1993,10,"male",687,151,107,1,72,1,20,0,52
1792195,25,5,1988,8,"female",1909,904,376,1511,900,1450,719,61,181
1792204,28,11,1985,3,"male",66,0,0,0,0,0,0,0,0
1792207,41,4,1972,1,"male",441,3,3,0,0,0,0,0,0
1792218,30,5,1983,12,"male",669,21,21,161,5,161,5,0,0
1792248,22,6,1991,2,"female",25,750,401,2997,1874,2868,1251,129,623
1792260,59,11,1954,3,"female",1344,163,72,5,3,5,3,0,0
1792320,17,29,1996,8,"female",414,383,134,2,14,2,2,0,12
1792380,38,13,1975,6,"female",159,34,21,368,111,368,102,0,9
1792392,32,22,1981,4,"male",171,207,190,65,47,65,41,0,6
1792401,51,5,1962,10,"female",436,35,22,6,3,4,3,2,0
1792422,39,1,1974,6,"male",452,2,0,264,226,125,116,139,110
1792443,24,2,1989,11,"male",212,51,48,9,24,9,19,0,5
1792463,18,28,1995,7,"male",270,368,280,0,0,0,0,0,0
1792498,17,8,1996,5,"male",527,21,5,0,0,0,0,0,0
1792499,24,21,1989,9,"female",372,57,25,0,1,0,1,0,0
1792530,18,20,1995,7,"male",409,55,49,11,1,11,1,0,0
1792539,58,23,1955,9,"male",91,83,76,6,2,0,0,6,2
1792563,56,22,1957,2,"female",235,102,64,0,0,0,0,0,0
1792567,47,9,1966,10,"male",1620,4,3,3,9,3,3,0,6
1792569,108,15,1905,3,"male",942,177,130,6,4,6,3,0,1
1792573,21,4,1992,9,"male",718,196,155,28,62,28,56,0,6
1792597,28,9,1985,8,"male",435,159,76,34,70,34,69,0,1
1792604,25,11,1988,9,"male",203,242,217,2,3,2,3,0,0
1792710,69,20,1944,4,"male",1698,13,12,0,0,0,0,0,0
1792712,64,21,1949,8,"male",1751,31,9,2,2,2,0,0,2
1792715,27,27,1986,2,"male",317,8,5,0,0,0,0,0,0
1792730,53,30,1960,1,"female",495,0,0,35,0,0,0,35,0
1792753,52,1,1961,7,"male",116,19,15,11,3,0,1,11,2
1792777,46,21,1967,9,"male",714,30,8,8,101,8,70,0,31
1792782,25,10,1988,12,"female",303,312,256,176,67,176,58,0,9
1792794,22,5,1991,7,"female",1254,195,94,43,8,10,4,33,4
1792804,24,9,1989,11,"male",319,63,44,0,2,0,1,0,1
1792866,18,20,1995,4,"male",182,17,11,0,0,0,0,0,0
1792910,54,13,1959,10,"male",1130,210,100,11,23,11,11,0,12
1792914,72,5,1941,7,"female",129,37,32,0,0,0,0,0,0
1792923,15,17,1998,2,"female",443,1279,784,2,2,1,1,1,1
1792962,108,26,1905,3,"male",801,838,668,112,48,112,46,0,2
1792981,67,5,1946,5,"female",658,63,59,1109,115,0,13,1109,102
1792990,54,6,1959,10,"female",230,291,225,43,26,0,2,43,24
1793010,16,17,1997,3,"male",433,53,39,0,0,0,0,0,0
1793013,20,29,1993,6,"female",967,318,61,23,31,21,24,2,7
1793024,14,22,1999,9,"male",276,21,10,0,0,0,0,0,0
1793042,21,15,1992,4,"male",409,126,80,2,7,2,7,0,0
1793046,46,14,1967,11,"female",466,51,39,402,146,401,90,1,56
1793059,25,13,1988,5,"male",411,172,100,18,16,0,6,18,10
1793102,33,1,1980,1,"male",10,14,12,6,19,6,15,0,4
1793121,22,24,1991,8,"male",437,33,31,10,0,10,0,0,0
1793123,71,17,1942,3,"female",978,69,52,8,7,0,5,8,2
1793128,16,26,1997,1,"female",377,360,270,212,299,208,207,4,92
1793131,18,27,1995,11,"male",19,10,7,8,5,8,4,0,1
1793172,63,29,1950,7,"female",249,23,11,122,18,0,3,122,15
1793191,44,24,1969,3,"female",626,47,27,275,176,275,135,0,41
1793216,25,19,1988,10,"male",361,121,117,1,0,0,0,1,0
1793248,60,14,1953,2,"male",41,107,82,19,34,17,20,2,14
1793264,21,20,1992,5,"male",194,204,109,43,45,43,38,0,7
1793279,14,20,1999,7,"male",262,93,60,110,35,110,34,0,1
1793284,24,1,1989,11,"female",1381,549,359,1000,551,709,394,291,157
1793288,29,4,1984,5,"female",1247,25,6,0,1,0,1,0,0
1793301,55,6,1958,2,"male",221,42,36,3,15,3,14,0,1
1793304,26,8,1987,10,"male",241,40,39,3,1,3,0,0,1
1793306,16,19,1997,12,"male",160,3,0,0,0,0,0,0,0
1793353,37,6,1976,10,"female",289,111,68,55,76,0,19,55,57
1793365,30,7,1983,9,"male",1011,13,8,0,2,0,2,0,0
1793373,34,29,1979,3,"female",460,23,13,1,0,1,0,0,0
1793388,22,1,1991,1,"female",238,11,3,2,1,0,0,2,1
1793428,20,10,1993,9,"male",522,262,86,2,2,0,0,2,2
1793446,58,15,1955,12,"female",78,88,69,1,7,1,7,0,0
1793500,68,5,1945,9,"male",1477,34,8,51,18,51,17,0,1
1793502,44,3,1969,10,"female",330,67,58,18,9,1,1,17,8
1793508,76,18,1937,4,"male",1660,39,19,0,0,0,0,0,0
1793512,29,24,1984,7,"male",969,29,22,1,0,1,0,0,0
1793520,28,12,1985,3,"male",511,136,98,51,56,51,55,0,1
1793542,24,12,1989,4,"male",350,126,96,7,37,7,17,0,20
1793562,21,20,1992,11,"female",478,148,13,5,81,5,75,0,6
1793569,35,24,1978,6,"male",750,72,45,2,1,0,0,2,1
1793588,103,25,1910,11,"female",1252,147,38,174,42,0,23,174,19
1793589,26,22,1987,8,"female",475,63,25,3,0,3,0,0,0
1793602,47,7,1966,8,"male",443,52,20,18,7,0,1,18,6
1793666,54,13,1959,1,"male",129,47,14,2,11,2,6,0,5
1793675,17,1,1996,1,"male",595,104,59,3,0,3,0,0,0
1793709,65,22,1948,8,"female",1577,59,34,41,66,29,27,12,39
1793718,32,15,1981,10,"male",345,123,89,6,67,6,54,0,13
1793733,108,5,1905,1,"male",1246,361,285,47,26,47,18,0,8
1793751,16,24,1997,7,"male",571,222,133,2,0,1,0,1,0
1793807,18,18,1995,8,"male",220,389,289,703,411,46,203,657,208
1793836,33,1,1980,1,"male",652,7,7,0,0,0,0,0,0
1793841,22,7,1991,1,"female",565,4622,1846,33,1849,33,1511,0,338
1793842,28,11,1985,5,"male",305,0,0,0,0,0,0,0,0
1793844,18,28,1995,11,"male",181,259,193,8,0,8,0,0,0
1793868,20,10,1993,4,"male",239,23,13,0,3,0,3,0,0
1793875,63,27,1950,10,"female",433,5,3,21,14,21,8,0,6
1793885,22,17,1991,2,"female",440,47,27,4,15,1,7,3,8
1793897,34,21,1979,9,"female",873,62,31,69,17,69,17,0,0
1793915,55,16,1958,9,"female",615,52,27,56,42,50,29,6,13
1793954,37,28,1976,11,"male",885,43,15,10,0,10,0,0,0
1793964,108,14,1905,2,"male",24,115,104,3,37,3,17,0,20
1793967,18,29,1995,5,"male",217,78,65,89,24,89,23,0,1
1793985,18,12,1995,8,"male",61,200,185,706,230,706,205,0,25
1793999,21,11,1992,7,"male",363,352,331,39,4,6,1,33,3
1794002,17,15,1996,6,"female",189,279,238,27,3,17,3,10,0
1794028,60,13,1953,10,"female",587,46,29,66,25,0,16,66,9
1794064,28,10,1985,11,"male",306,1,1,0,0,0,0,0,0
1794082,40,5,1973,12,"male",72,31,26,4,0,4,0,0,0
1794093,73,20,1940,12,"male",642,18,9,0,2,0,2,0,0
1794098,57,28,1956,3,"female",961,117,43,573,97,533,78,40,19
1794099,34,23,1979,9,"male",330,2,2,0,0,0,0,0,0
1794106,65,22,1948,12,"female",747,94,52,90,11,90,6,0,5
1794110,25,26,1988,5,"male",735,63,26,33,5,33,3,0,2
1794117,19,27,1994,2,"male",611,295,277,16,10,8,8,8,2
1794146,25,24,1988,2,"male",251,113,98,4,0,3,0,1,0
1794152,14,2,1999,7,"male",75,60,51,62,2,62,2,0,0
1794169,21,24,1992,4,"male",221,60,20,2,14,0,5,2,9
1794170,70,15,1943,2,"female",325,91,55,3,3,0,2,3,1
1794203,73,22,1940,12,"male",140,0,0,0,0,0,0,0,0
1794209,103,18,1910,6,"male",671,257,188,0,3,0,3,0,0
1794218,43,7,1970,5,"female",496,39,36,681,64,679,46,2,18
1794232,38,23,1975,9,"male",798,37,27,47,23,0,15,47,8
1794248,14,12,1999,12,"male",210,126,90,20,3,20,3,0,0
1794260,48,14,1965,1,"male",581,293,216,1,17,0,16,1,1
1794276,56,16,1957,8,"male",784,128,69,1228,452,611,160,617,292
1794310,14,20,1999,5,"male",0,0,0,0,0,0,0,0,0
1794326,38,20,1975,9,"female",535,123,36,39,2,39,0,0,2
1794380,24,9,1989,3,"male",665,30,22,0,1,0,0,0,1
1794386,38,7,1975,3,"male",868,37,21,2,0,2,0,0,0
1794399,32,3,1981,6,"female",318,84,56,668,85,661,59,7,26
1794401,41,13,1972,7,"female",91,63,11,201,75,104,66,97,9
1794414,60,17,1953,4,"male",23,76,73,5,10,0,0,5,10
1794452,25,28,1988,12,"male",137,267,260,9,3,9,3,0,0
1794472,45,17,1968,10,"male",822,10,9,0,0,0,0,0,0
1794479,28,24,1985,1,"female",499,22,12,51,22,51,5,0,17
1794481,19,27,1994,11,"male",592,142,87,0,1,0,1,0,0
1794490,103,3,1910,2,"male",1895,768,433,42,222,2,92,40,130
1794492,28,19,1985,11,"male",201,52,36,16,1,16,0,0,1
1794517,35,23,1978,11,"female",2231,208,97,109,447,75,290,34,157
1794522,56,29,1957,12,"male",752,37,21,0,7,0,6,0,1
1794574,17,5,1996,4,"male",702,257,121,3888,923,1161,304,2727,619
1794575,26,2,1987,12,"male",605,205,116,0,0,0,0,0,0
1794606,26,1,1987,1,"male",150,69,49,0,0,0,0,0,0
1794610,38,17,1975,6,"female",444,103,70,763,443,4,93,759,350
1794619,29,18,1984,8,"male",209,99,82,1,0,0,0,1,0
1794622,69,30,1944,3,"female",2313,288,197,617,560,501,338,116,222
1794629,98,18,1915,4,"male",1895,352,163,37,23,37,6,0,17
1794689,20,10,1993,10,"male",502,11,9,0,14,0,5,0,9
1794690,35,5,1978,2,"male",1095,202,120,2074,1,2074,1,0,0
1794720,31,10,1982,9,"female",1333,64,48,72,53,62,37,10,16
1794731,18,13,1995,7,"male",509,80,41,1,15,0,10,1,5
1794739,40,20,1973,4,"male",241,116,28,367,202,338,145,29,57
1794745,13,20,2000,1,"female",98,34,28,27,39,27,21,0,18
1794749,66,3,1947,4,"female",2126,65,35,313,108,287,35,26,73
1794781,59,8,1954,5,"female",171,15,12,0,0,0,0,0,0
1794811,36,13,1977,11,"male",72,55,37,853,45,853,44,0,1
1794829,17,23,1996,11,"male",269,71,44,1,0,1,0,0,0
1794895,22,3,1991,2,"female",35,2,2,1,0,1,0,0,0
1794906,63,7,1950,5,"female",1171,82,36,2,19,0,6,2,13
1794907,62,14,1951,2,"female",1581,251,169,829,219,805,127,24,92
1794917,108,10,1905,2,"female",1067,344,79,0,1,0,0,0,1
1794920,24,1,1989,1,"male",61,6,5,5,0,5,0,0,0
1794930,101,17,1912,4,"female",520,599,335,450,49,450,47,0,2
1794998,39,31,1974,8,"female",455,102,84,5,1,5,1,0,0
1795013,30,23,1983,3,"female",994,207,102,10,31,10,31,0,0
1795041,18,2,1995,7,"male",503,156,104,0,0,0,0,0,0
1795044,22,29,1991,9,"female",742,4199,944,3070,4431,799,1154,2271,3277
1795101,19,13,1994,5,"male",196,208,154,185,110,2,70,183,40
1795145,28,25,1985,5,"female",1437,98,30,7,1,7,1,0,0
1795204,24,20,1989,8,"male",278,97,54,0,4,0,2,0,2
1795213,17,26,1996,6,"female",35,22,8,7,28,7,7,0,21
1795218,88,19,1925,10,"female",2145,603,66,992,384,0,247,992,137
1795225,108,21,1905,2,"female",857,194,88,634,409,57,134,577,275
1795227,26,1,1987,8,"male",578,18,11,5,1,5,1,0,0
1795236,23,4,1990,10,"male",446,325,192,908,1185,839,732,69,453
1795247,24,2,1989,8,"female",618,154,79,454,313,454,290,0,23
1795283,18,5,1995,10,"female",198,2,1,45,0,0,0,45,0
1795293,14,7,1999,12,"male",311,51,44,7,0,0,0,7,0
1795295,63,29,1950,6,"male",533,31,13,3,0,3,0,0,0
1795301,26,25,1987,5,"male",72,38,36,0,0,0,0,0,0
1795309,27,2,1986,11,"female",609,108,73,2,20,2,17,0,3
1795317,42,5,1971,3,"male",179,110,74,62,445,62,332,0,113
1795321,16,15,1997,3,"male",12,34,32,1,1,1,1,0,0
1795324,63,1,1950,12,"female",920,57,37,17,49,17,38,0,11
1795325,16,8,1997,3,"female",452,143,108,4,4,4,4,0,0
1795343,51,9,1962,3,"female",1269,132,81,10,43,7,25,3,18
1795390,27,8,1986,9,"male",746,90,40,3,7,0,3,3,4
1795408,53,24,1960,5,"female",557,117,65,29,88,29,79,0,9
1795442,67,29,1946,11,"female",510,20,8,35,77,3,42,32,35
1795448,51,26,1962,7,"female",74,6,2,36,10,36,4,0,6
1795479,26,17,1987,11,"male",754,71,19,0,1,0,1,0,0
1795480,14,22,1999,11,"male",64,153,58,15,10,12,5,3,5
1795483,24,8,1989,6,"female",441,9,7,12,8,6,5,6,3
1795484,32,29,1981,4,"female",219,63,56,158,190,158,118,0,72
1795485,26,1,1987,1,"male",317,17,12,4,4,4,4,0,0
1795486,18,7,1995,5,"female",554,115,51,86,26,86,26,0,0
1795525,26,21,1987,7,"male",263,8,6,0,0,0,0,0,0
1795554,60,9,1953,2,"male",307,79,65,40,31,0,8,40,23
1795585,34,19,1979,9,"male",137,42,24,7,2,7,1,0,1
1795605,18,11,1995,11,"male",888,701,346,1050,903,994,384,56,519
1795623,58,31,1955,12,"male",407,103,18,33,38,0,13,33,25
1795625,45,10,1968,3,"male",254,29,26,30,6,4,6,26,0
1795643,37,26,1976,9,"male",143,12,8,53,5,53,3,0,2
1795648,64,8,1949,3,"female",1291,455,66,19,16,13,4,6,12
1795728,45,17,1968,10,"female",1105,3,3,0,0,0,0,0,0
1795742,69,10,1944,12,"male",230,43,31,50,4,0,1,50,3
1795757,22,21,1991,9,"female",152,83,63,749,667,0,33,749,634
1795764,42,22,1971,2,"female",540,65,38,38,17,38,13,0,4
1795776,17,23,1996,8,"male",698,77,24,49,3,49,3,0,0
1795862,21,16,1992,6,"female",556,451,65,296,173,296,150,0,23
1795867,26,25,1987,12,"female",431,140,104,0,3,0,3,0,0
1795912,20,26,1993,1,"male",737,121,84,3,2,3,2,0,0
1795923,47,19,1966,8,"male",27,4,4,34,9,34,8,0,1
1795947,47,2,1966,4,"female",1322,108,59,187,222,89,140,98,82
1795987,25,22,1988,8,"female",519,369,221,104,78,41,25,63,53
1795996,27,3,1986,11,"male",159,21,11,1,2,0,2,1,0
1796177,18,22,1995,12,"male",1003,1328,1022,1595,397,1489,351,106,46
1796178,16,27,1997,4,"female",369,181,75,14,16,14,16,0,0
1796179,25,18,1988,8,"male",172,0,0,0,0,0,0,0,0
1796208,57,23,1956,12,"male",1699,322,231,23,207,0,54,23,153
1796222,80,20,1933,5,"male",1140,50,25,27,11,27,10,0,1
1796269,68,8,1945,7,"male",1000,788,554,47,1,47,1,0,0
1796307,50,21,1963,5,"male",1048,31,24,568,1,567,1,1,0
1796310,38,3,1975,6,"male",212,30,25,19,0,0,0,19,0
1796318,25,1,1988,3,"male",723,171,145,115,22,115,21,0,1
1796350,31,1,1982,10,"male",869,59,36,28,6,28,4,0,2
1796360,15,30,1998,1,"male",342,271,113,89,64,43,9,46,55
1796379,58,2,1955,7,"female",626,23,13,0,0,0,0,0,0
1796380,94,6,1919,7,"female",999,1187,150,153,86,153,70,0,16
1796383,26,16,1987,11,"male",154,63,52,6,1,6,1,0,0
1796425,34,13,1979,1,"male",1221,595,205,5,0,5,0,0,0
1796427,19,27,1994,10,"male",87,31,22,0,5,0,2,0,3
1796437,19,1,1994,10,"male",284,80,68,11,2,11,2,0,0
1796470,26,7,1987,6,"male",484,3,1,0,0,0,0,0,0
1796509,28,21,1985,11,"female",306,50,32,98,122,98,79,0,43
1796557,23,18,1990,9,"female",269,352,251,584,610,468,331,116,279
1796573,22,22,1991,11,"female",544,77,44,65,73,65,61,0,12
1796576,56,4,1957,9,"male",622,40,29,40,5,33,5,7,0
1796605,104,9,1909,5,"male",1851,702,305,16,3,16,0,0,3
1796669,17,7,1996,2,"male",332,219,206,12,7,11,7,1,0
1796682,22,7,1991,9,"female",347,80,50,66,34,66,19,0,15
1796734,53,15,1960,4,"female",615,52,27,241,109,203,89,38,20
1796741,30,19,1983,11,"male",631,25,4,0,5,0,0,0,5
1796756,34,6,1979,5,"male",283,26,20,0,3,0,3,0,0
1796757,32,3,1981,10,"female",418,191,142,12,43,0,13,12,30
1796774,21,28,1992,12,"male",41,275,35,1219,2134,773,536,446,1598
1796778,67,2,1946,4,"male",3,21,20,12,9,12,9,0,0
1796793,17,21,1996,9,"female",235,82,71,16,0,16,0,0,0
1796829,31,26,1982,5,"male",326,33,22,2,0,2,0,0,0
1796840,17,12,1996,5,"male",175,0,0,0,0,0,0,0,0
1796852,18,9,1995,6,"male",332,45,39,0,28,0,20,0,8
1796877,27,24,1986,9,"male",1320,206,156,25,29,17,10,8,19
1796886,31,4,1982,4,"male",340,186,130,240,220,240,181,0,39
1796897,33,12,1980,11,"male",520,46,36,24,7,24,4,0,3
1796901,26,13,1987,10,"female",666,593,333,2,11,2,8,0,3
1796903,18,2,1995,6,"male",573,263,122,165,157,165,128,0,29
1796941,24,18,1989,7,"male",572,133,83,56,17,56,11,0,6
1796947,16,13,1997,4,"male",454,360,205,15,105,10,20,5,85
1796950,20,6,1993,9,"female",79,0,0,0,0,0,0,0,0
1796955,26,18,1987,7,"male",47,28,20,0,1,0,0,0,1
1796987,16,26,1997,8,"male",6,52,44,2,0,2,0,0,0
1797016,52,28,1961,6,"female",778,30,14,113,5,113,4,0,1
1797044,54,2,1959,1,"female",627,94,63,1158,392,0,75,1158,317
1797056,22,26,1991,5,"male",561,625,580,41,29,41,21,0,8
1797067,15,24,1998,3,"male",105,13,12,0,0,0,0,0,0
1797072,50,28,1963,9,"female",196,29,14,10,6,10,5,0,1
1797087,31,27,1982,3,"male",209,75,69,45,8,45,7,0,1
1797123,28,13,1985,8,"female",472,334,244,291,254,188,132,103,122
1797124,108,17,1905,7,"male",897,242,159,187,15,187,12,0,3
1797133,25,1,1988,1,"male",216,40,27,5,0,5,0,0,0
1797165,18,14,1995,11,"male",747,239,206,172,34,53,7,119,27
1797184,16,28,1997,10,"male",116,433,404,12,4,12,3,0,1
1797193,32,11,1981,10,"male",619,69,42,0,0,0,0,0,0
1797231,62,25,1951,2,"female",1388,57,22,0,0,0,0,0,0
1797232,28,30,1985,6,"male",329,78,50,57,34,57,31,0,3
1797271,48,3,1965,5,"female",330,431,20,265,89,253,41,12,48
1797340,18,12,1995,9,"female",401,562,505,15,13,15,10,0,3
1797370,23,12,1990,6,"female",309,5,3,46,48,0,11,46,37
1797378,46,13,1967,6,"female",743,150,113,131,92,131,69,0,23
1797380,29,4,1984,5,"male",50,45,41,23,79,20,35,3,44
1797404,14,7,1999,7,"female",425,292,186,1160,1420,1160,1260,0,160
1797408,28,21,1985,2,"male",417,36,32,5,0,5,0,0,0
1797412,66,3,1947,7,"male",319,12,9,4,0,1,0,3,0
1797419,25,17,1988,1,"male",599,299,183,89,52,89,46,0,6
1797424,66,5,1947,11,"female",289,44,13,24,11,0,8,24,3
1797431,18,22,1995,3,"male",364,380,229,10,5,10,5,0,0
1797444,20,21,1993,3,"female",470,111,94,0,1,0,1,0,0
1797477,18,3,1995,4,"male",290,385,262,101,48,101,23,0,25
1797493,22,2,1991,8,"male",354,612,551,1,5,1,5,0,0
1797504,28,1,1985,1,"female",236,12,7,104,62,102,19,2,43
1797510,24,29,1989,8,"male",86,38,33,6,1,6,0,0,1
1797538,36,25,1977,2,"female",185,3,1,0,0,0,0,0,0
1797545,56,10,1957,10,"male",875,39,23,1,3,0,2,1,1
1797607,78,29,1935,8,"female",23,24,21,18,12,3,0,15,12
1797627,84,20,1929,2,"male",340,58,51,13,4,0,1,13,3
1797630,49,8,1964,6,"female",757,318,89,185,5,185,3,0,2
1797670,45,30,1968,10,"male",28,6,4,23,5,23,5,0,0
1797708,48,16,1965,3,"male",618,1,1,0,1,0,0,0,1
1797754,30,16,1983,2,"male",106,8,5,1,0,1,0,0,0
1797765,31,12,1982,12,"male",220,6,6,1,0,1,0,0,0
1797780,60,24,1953,11,"female",1493,159,100,0,0,0,0,0,0
1797791,32,15,1981,5,"male",225,1,0,1,0,1,0,0,0
1797795,15,15,1998,4,"female",255,301,96,0,4,0,3,0,1
1797830,66,14,1947,8,"male",539,264,152,1,0,0,0,1,0
1797849,33,30,1980,8,"male",591,140,139,0,0,0,0,0,0
1797897,35,30,1978,8,"female",334,443,260,277,69,0,11,277,58
1797921,14,14,1999,5,"female",272,528,255,583,128,583,117,0,11
1797934,29,18,1984,5,"male",252,114,87,1,7,1,2,0,5
1797947,23,8,1990,9,"male",317,119,102,11,6,11,5,0,1
1797950,27,31,1986,7,"female",352,89,60,12,20,12,14,0,6
1797973,20,25,1993,5,"male",597,220,130,0,0,0,0,0,0
1797980,19,5,1994,11,"female",112,81,43,129,89,112,52,17,37
1798014,21,30,1992,7,"female",403,861,587,43,114,43,79,0,35
1798021,16,5,1997,1,"female",372,203,150,1660,323,1288,86,372,237
1798049,17,26,1996,6,"male",96,3,2,388,14,388,8,0,6
1798055,18,25,1995,9,"female",91,91,41,3,3,3,3,0,0
1798066,108,13,1905,4,"male",1760,560,52,71,0,0,0,71,0
1798081,14,13,1999,8,"male",259,318,151,0,0,0,0,0,0
1798139,15,1,1998,4,"male",117,35,23,0,3,0,2,0,1
1798152,32,26,1981,9,"male",39,2,2,2,0,0,0,2,0
1798192,32,24,1981,5,"male",139,107,80,0,0,0,0,0,0
1798210,18,2,1995,11,"male",261,23,15,0,0,0,0,0,0
1798260,48,20,1965,1,"male",359,73,38,25,8,21,4,4,4
1798275,100,18,1913,12,"female",529,8,4,913,7,913,6,0,1
1798282,113,12,1900,5,"female",1282,32,15,9,16,0,8,9,8
1798294,35,15,1978,5,"male",789,65,45,0,0,0,0,0,0
1798321,67,21,1946,9,"male",1811,647,275,14,26,10,2,4,24
1798376,24,22,1989,9,"female",258,77,56,0,5,0,1,0,4
1798377,35,8,1978,9,"male",384,123,87,30,19,26,14,4,5
1798380,20,19,1993,8,"male",246,99,52,0,3,0,3,0,0
1798402,25,20,1988,12,"male",370,101,94,332,212,309,86,23,126
1798406,26,11,1987,10,"male",609,11,9,3,1,3,1,0,0
1798422,73,22,1940,7,"male",1406,236,99,1,3,1,3,0,0
1798425,15,7,1998,7,"female",448,246,204,2205,5916,233,1887,1972,4029
1798434,26,22,1987,9,"male",534,41,22,20,51,3,27,17,24
1798475,14,1,1999,6,"female",84,44,27,1,3,1,3,0,0
1798504,27,1,1986,3,"male",219,13,12,15,23,15,22,0,1
1798537,22,10,1991,10,"female",415,235,87,62,67,62,54,0,13
1798539,19,8,1994,4,"male",419,34,29,13,0,0,0,13,0
1798547,13,3,2000,1,"male",2,4,3,1,8,1,8,0,0
1798560,20,9,1993,5,"male",243,293,172,18,259,8,50,10,209
1798567,26,21,1987,5,"male",462,240,162,0,1,0,1,0,0
1798573,31,30,1982,4,"female",474,70,50,51,3,51,3,0,0
1798578,65,23,1948,2,"female",347,59,51,29,34,29,30,0,4
1798587,16,4,1997,2,"male",14,28,27,1,1,1,1,0,0
1798616,21,13,1992,3,"male",1192,148,105,4,3,4,0,0,3
1798621,52,28,1961,6,"female",1613,107,69,81,199,29,159,52,40
1798648,21,2,1992,5,"male",333,87,70,16,2,12,1,4,1
1798649,27,1,1986,1,"female",300,102,55,0,0,0,0,0,0
1798683,22,7,1991,8,"male",54,47,40,19,19,3,13,16,6
1798713,113,1,1900,1,NA,1822,39,17,11,12,0,3,11,9
1798730,17,11,1996,7,"female",264,343,109,28,130,7,80,21,50
1798731,29,15,1984,2,"female",544,88,45,217,119,104,55,113,64
1798751,49,15,1964,12,"female",448,26,11,11,0,11,0,0,0
1798761,43,17,1970,3,"male",473,51,32,0,0,0,0,0,0
1798781,22,17,1991,3,"male",407,197,99,12,17,12,11,0,6
1798801,56,1,1957,12,"male",383,48,42,14,2,14,2,0,0
1798818,35,1,1978,9,"male",800,289,256,0,0,0,0,0,0
1798826,36,23,1977,11,"male",484,27,18,1,6,1,5,0,1
1798827,19,30,1994,3,"male",306,176,170,5,0,0,0,5,0
1798839,31,24,1982,3,"female",78,155,143,43,22,43,11,0,11
1798876,18,19,1995,2,"female",164,241,78,48,202,48,177,0,25
1798899,20,24,1993,6,"female",237,58,28,0,0,0,0,0,0
1798922,91,21,1922,8,"male",16,15,12,2,2,2,2,0,0
1799021,21,2,1992,4,"male",234,47,38,62,34,62,9,0,25
1799030,35,21,1978,12,"female",112,53,17,0,0,0,0,0,0
1799059,36,18,1977,2,"male",517,50,24,0,0,0,0,0,0
1799065,55,31,1958,8,"female",543,66,36,458,264,322,182,136,82
1799076,18,7,1995,2,"female",607,268,136,32,35,26,14,6,21
1799081,103,1,1910,1,"male",1376,378,322,78,36,21,4,57,32
1799083,31,17,1982,3,"male",735,106,50,5,7,0,4,5,3
1799103,103,5,1910,1,"male",963,210,126,61,65,17,43,44,22
1799113,43,5,1970,7,"male",45,13,12,15,4,15,4,0,0
1799128,54,5,1959,2,"male",1672,83,28,18,11,0,6,18,5
1799163,15,18,1998,7,"female",242,321,283,115,141,101,116,14,25
1799182,61,23,1952,8,"female",968,184,156,30,119,0,60,30,59
1799257,25,11,1988,1,"female",518,60,41,1,3,1,3,0,0
1799259,17,19,1996,5,"female",25,87,61,20,58,20,55,0,3
1799260,58,11,1955,2,"male",438,96,52,0,0,0,0,0,0
1799265,18,4,1995,10,"male",503,87,67,6,0,0,0,6,0
1799311,45,19,1968,9,"male",84,8,6,1,1,1,1,0,0
1799334,23,27,1990,4,"male",237,159,132,305,23,213,20,92,3
1799337,50,1,1963,1,"male",378,71,40,36,4,6,1,30,3
1799343,30,14,1983,2,"male",243,175,147,12,157,12,95,0,62
1799355,31,17,1982,4,"male",610,59,54,7,1,0,0,7,1
1799416,113,29,1900,9,"male",1154,382,250,80,39,78,32,2,7
1799432,38,4,1975,5,"female",489,1158,334,1389,1431,1383,1203,6,228
1799434,48,11,1965,6,"male",159,3,1,0,0,0,0,0,0
1799460,47,19,1966,7,"male",1161,30,6,5,10,5,6,0,4
1799473,16,25,1997,10,"female",278,474,388,639,780,2,63,637,717
1799486,108,1,1905,1,"female",12,40,17,2,15,2,12,0,3
1799502,41,31,1972,12,"male",361,73,11,0,0,0,0,0,0
1799517,17,7,1996,8,"male",10,6,6,0,0,0,0,0,0
1799543,28,9,1985,8,"male",690,131,64,0,2,0,1,0,1
1799553,53,30,1960,4,"male",987,38,19,26,18,24,8,2,10
1799554,32,3,1981,4,"male",373,18,12,0,0,0,0,0,0
1799564,34,23,1979,2,"male",456,73,62,10,4,10,4,0,0
1799568,20,2,1993,1,"male",651,221,71,1,2,0,2,1,0
1799576,21,6,1992,10,"female",574,58,30,529,62,529,39,0,23
1799582,101,6,1912,12,"male",1368,376,224,47,27,13,22,34,5
1799588,87,3,1926,10,"male",1011,21,18,50,76,6,71,44,5
1799594,51,13,1962,1,"male",191,22,15,22,0,22,0,0,0
1799622,51,2,1962,9,"male",1010,47,28,1,0,0,0,1,0
1799625,22,7,1991,9,"female",302,146,99,71,69,71,59,0,10
1799644,16,1,1997,6,"male",221,142,115,15,16,15,14,0,2
1799680,49,21,1964,5,"female",467,116,74,171,67,129,52,42,15
1799729,15,16,1998,5,"male",378,109,82,0,0,0,0,0,0
1799734,40,26,1973,7,"male",469,66,42,15,59,15,53,0,6
1799744,18,14,1995,9,"male",136,216,192,446,1,60,1,386,0
1799750,17,4,1996,2,"female",294,690,392,38,288,38,256,0,32
1799755,18,7,1995,1,"female",27,108,83,73,76,39,68,34,8
1799794,28,11,1985,7,"male",433,118,65,1,2,0,0,1,2
1799801,43,10,1970,1,"female",675,1,1,0,0,0,0,0,0
1799804,34,6,1979,10,"female",1102,144,51,283,298,175,163,108,135
1799818,103,20,1910,5,"male",306,230,137,38,7,0,5,38,2
1799828,20,29,1993,6,"male",549,2633,213,137,4959,101,2791,36,2168
1799832,23,12,1990,4,"female",599,36,13,40,207,40,207,0,0
1799873,34,23,1979,12,"male",1233,96,20,3,51,3,31,0,20
1799874,28,5,1985,9,"female",1057,283,186,117,307,117,93,0,214
1799877,21,26,1992,7,"female",267,399,120,1471,2263,339,962,1132,1301
1799894,31,28,1982,11,"male",560,206,64,202,16,202,8,0,8
1799897,16,24,1997,8,"female",790,680,429,324,395,11,148,313,247
1799906,38,23,1975,4,"female",574,2,1,0,0,0,0,0,0
1799921,14,25,1999,12,"female",158,62,38,0,0,0,0,0,0
1799968,58,26,1955,10,"female",1895,8,5,0,0,0,0,0,0
1799971,33,18,1980,11,"male",606,173,74,1,0,1,0,0,0
1799990,21,17,1992,8,"female",689,491,273,160,364,160,258,0,106
1799995,58,14,1955,3,"female",2133,409,228,187,379,141,280,46,99
1799996,18,6,1995,2,"male",252,493,424,84,28,1,11,83,17
1800010,19,8,1994,7,"male",349,198,115,17,7,17,7,0,0
1800027,27,4,1986,10,"male",303,21,14,4,1,4,0,0,1
1800033,30,20,1983,2,"male",424,56,48,38,42,38,20,0,22
1800067,13,4,2000,4,"male",273,268,99,165,134,60,63,105,71
1800069,26,25,1987,4,"female",1672,100,51,614,344,289,208,325,136
1800075,16,9,1997,6,"female",217,1681,105,387,1118,387,698,0,420
1800086,108,22,1905,2,"female",1126,365,241,452,835,3,115,449,720
1800126,21,6,1992,10,"male",203,310,211,24,0,24,0,0,0
1800143,16,14,1997,4,"male",596,1347,814,2106,1457,1699,1024,407,433
1800144,33,19,1980,8,"male",1348,246,5,39,44,39,40,0,4
1800158,29,5,1984,3,"female",348,138,71,8,6,0,0,8,6
1800163,38,29,1975,8,"male",137,27,24,0,3,0,0,0,3
1800178,17,24,1996,12,"female",0,0,0,5,4,5,0,0,4
1800179,19,27,1994,3,"male",30,37,20,67,24,3,6,64,18
1800195,52,1,1961,1,"male",209,105,71,40,58,40,33,0,25
1800210,14,30,1999,4,"male",473,161,109,1,13,1,9,0,4
1800221,58,10,1955,1,"male",1729,59,25,1,0,1,0,0,0
1800239,39,18,1974,10,"male",765,14,10,41,3,0,3,41,0
1800242,29,8,1984,1,"female",394,76,59,2,0,2,0,0,0
1800252,19,3,1994,2,"male",305,52,41,1,0,1,0,0,0
1800266,108,1,1905,1,"male",175,78,65,800,60,0,18,800,42
1800297,60,23,1953,7,"male",615,155,89,74,94,68,37,6,57
1800310,63,3,1950,2,"female",200,72,54,232,19,232,19,0,0
1800318,63,25,1950,2,"female",2103,100,36,9,65,6,24,3,41
1800326,28,9,1985,5,"female",170,38,27,2,0,2,0,0,0
1800360,17,24,1996,9,"female",307,199,171,520,1130,446,958,74,172
1800369,18,24,1995,5,"female",342,54,17,69,179,68,51,1,128
1800370,20,18,1993,10,"male",615,188,130,74,9,74,4,0,5
1800375,17,27,1996,12,"male",14,113,100,137,1,137,0,0,1
1800399,24,29,1989,10,"male",556,346,228,7,20,6,13,1,7
1800447,29,12,1984,1,"male",114,59,55,3,0,3,0,0,0
1800493,27,9,1986,9,"male",373,65,25,0,4,0,3,0,1
1800515,51,7,1962,7,"male",782,198,155,20,2,6,2,14,0
1800525,29,21,1984,2,"female",1786,155,50,290,336,222,231,68,105
1800562,23,4,1990,7,"male",563,69,47,162,20,117,7,45,13
1800573,23,26,1990,1,"male",729,303,206,44,9,44,6,0,3
1800592,29,20,1984,8,"male",244,315,210,48,33,32,16,16,17
1800621,66,27,1947,9,"male",1353,71,18,0,1,0,0,0,1
1800629,65,5,1948,6,"female",1693,113,32,782,387,680,127,102,260
1800634,32,25,1981,10,"male",268,169,55,50,170,50,137,0,33
1800642,20,6,1993,3,"female",807,21,14,4,1,0,1,4,0
1800673,53,27,1960,9,"female",376,56,26,20,133,2,70,18,63
1800697,22,7,1991,1,"male",271,144,40,33,5,31,3,2,2
1800732,27,28,1986,11,"male",517,135,44,37,61,37,50,0,11
1800756,23,9,1990,8,"female",71,42,38,61,43,41,29,20,14
1800768,69,28,1944,11,"female",460,82,49,877,56,877,19,0,37
1800773,14,26,1999,5,"female",357,411,359,301,141,10,41,291,100
1800788,43,26,1970,2,"female",384,103,44,51,27,51,25,0,2
1800812,86,6,1927,9,"male",610,4759,994,0,8,0,7,0,1
1800831,47,11,1966,9,"female",237,181,159,46,111,44,57,2,54
1800841,16,22,1997,3,"female",565,1831,266,124,163,124,95,0,68
1800845,21,12,1992,10,"male",439,251,150,3,2,3,2,0,0
1800867,31,15,1982,4,"male",296,12,5,9,0,9,0,0,0
1800873,24,12,1989,12,"female",148,17,4,65,2,65,2,0,0
1800885,35,2,1978,2,"male",694,987,905,15,20,15,17,0,3
1800902,15,19,1998,11,"female",47,283,42,19,34,19,26,0,8
1800909,20,1,1993,1,"male",189,6,6,0,0,0,0,0,0
1800934,108,2,1905,3,"male",341,23,3,0,0,0,0,0,0
1800950,33,19,1980,10,"male",12,6,4,0,0,0,0,0,0
1800951,22,13,1991,6,"male",362,276,208,306,235,173,143,133,92
1800987,61,28,1952,10,"female",769,89,46,273,248,0,63,273,185
1800995,71,14,1942,8,"male",1444,22,6,1,0,0,0,1,0
1800998,19,12,1994,8,"male",813,95,83,63,4,56,1,7,3
1801000,65,7,1948,7,"male",1051,18,4,0,7,0,7,0,0
1801002,58,16,1955,6,"female",1190,31,21,28,3,3,3,25,0
1801006,45,10,1968,12,"male",254,0,0,0,0,0,0,0,0
1801023,101,18,1912,10,"female",668,71,53,6,6,6,5,0,1
1801035,102,18,1911,9,"female",2051,129,18,40,9,0,3,40,6
1801042,77,6,1936,7,"female",573,57,13,430,28,0,23,430,5
1801057,33,16,1980,8,"male",1099,280,251,129,17,129,17,0,0
1801066,21,18,1992,9,"male",169,288,237,48,33,48,20,0,13
1801079,49,9,1964,12,"female",253,44,30,0,14,0,2,0,12
1801091,25,12,1988,6,"male",653,249,89,0,0,0,0,0,0
1801148,59,25,1954,9,"female",2174,83,51,67,154,67,117,0,37
1801154,18,19,1995,4,"female",528,58,22,0,0,0,0,0,0
1801181,72,10,1941,6,"female",109,35,25,0,0,0,0,0,0
1801249,32,16,1981,2,"female",496,283,190,105,76,28,26,77,50
1801253,66,6,1947,6,"male",159,256,128,3171,589,1,285,3170,304
1801264,51,22,1962,4,"female",244,40,16,36,1,36,1,0,0
1801266,16,6,1997,6,"male",187,22,14,37,4,37,2,0,2
1801290,24,5,1989,7,"male",399,234,171,78,62,55,17,23,45
1801356,32,1,1981,2,"female",328,152,100,224,79,224,69,0,10
1801374,16,30,1997,1,"female",1100,139,81,178,14,160,3,18,11
1801392,26,1,1987,1,"male",474,54,26,0,0,0,0,0,0
1801403,26,8,1987,2,"female",114,92,88,4,14,2,13,2,1
1801457,18,4,1995,3,"female",506,444,213,202,101,63,58,139,43
1801463,19,9,1994,3,"male",138,49,40,1,0,0,0,1,0
1801481,32,1,1981,1,"male",57,25,12,0,1,0,1,0,0
1801508,48,9,1965,9,"female",767,618,466,98,296,98,260,0,36
1801514,21,29,1992,6,"male",306,119,99,0,0,0,0,0,0
1801516,41,9,1972,7,"female",1137,2020,123,655,276,576,170,79,106
1801522,48,30,1965,5,"female",1176,52,33,0,0,0,0,0,0
1801528,62,15,1951,4,"male",527,305,180,0,2,0,2,0,0
1801536,25,5,1988,1,"male",111,3,1,0,0,0,0,0,0
1801548,76,17,1937,7,"male",2289,34,16,2,2,0,0,2,2
1801569,17,1,1996,3,"male",562,68,45,0,0,0,0,0,0
1801577,15,15,1998,3,"female",403,2645,290,303,559,53,480,250,79
1801579,19,24,1994,8,"female",1561,1204,672,533,313,459,168,74,145
1801629,13,19,2000,2,"male",64,60,44,4,0,4,0,0,0
1801635,22,30,1991,9,"female",113,21,4,0,0,0,0,0,0
1801650,48,19,1965,10,"female",592,31,14,10,33,10,19,0,14
1801686,26,3,1987,7,"male",454,61,43,4,26,0,13,4,13
1801694,63,19,1950,1,"female",517,32,27,25,4,25,2,0,2
1801718,18,1,1995,12,"male",286,171,80,5,18,2,4,3,14
1801728,21,21,1992,10,"female",25,1,1,0,0,0,0,0,0
1801751,14,15,1999,2,"male",285,136,86,0,0,0,0,0,0
1801763,32,14,1981,2,"female",273,1,1,0,1,0,0,0,1
1801777,17,18,1996,7,"male",671,58,50,3,0,2,0,1,0
1801792,34,22,1979,5,"female",329,147,43,88,69,88,56,0,13
1801841,30,13,1983,4,"female",198,30,16,0,0,0,0,0,0
1801872,52,7,1961,7,"female",449,103,69,334,221,284,145,50,76
1801874,21,12,1992,3,"male",363,2,1,0,0,0,0,0,0
1801899,108,29,1905,7,"female",2030,246,188,208,254,119,123,89,131
1801932,28,29,1985,7,"male",2198,207,143,14,47,14,31,0,16
1801945,22,23,1991,5,"male",478,102,49,1,0,1,0,0,0
1801981,55,2,1958,5,"female",328,391,305,9,4,0,0,9,4
1801985,68,10,1945,6,"female",18,60,44,2,10,2,9,0,1
1802026,15,22,1998,3,"female",209,496,304,6,34,6,32,0,2
1802031,108,29,1905,10,"male",988,189,100,28,16,28,10,0,6
1802044,22,30,1991,1,"female",295,369,135,176,49,130,37,46,12
1802067,20,14,1993,4,"male",168,39,33,0,0,0,0,0,0
1802084,20,5,1993,5,"male",19,5,5,17,20,17,20,0,0
1802117,13,8,2000,7,"male",60,28,25,4,0,4,0,0,0
1802159,108,9,1905,3,"female",998,392,194,2,5,2,2,0,3
1802163,45,21,1968,6,"female",714,131,85,85,76,85,45,0,31
1802179,62,13,1951,1,"female",407,66,38,18,0,18,0,0,0
1802191,33,1,1980,1,"female",259,96,72,67,22,67,20,0,2
1802208,31,2,1982,11,"female",292,404,134,1063,380,1063,351,0,29
1802216,39,31,1974,10,"female",119,75,53,34,39,22,17,12,22
1802271,65,13,1948,9,"female",521,78,32,934,268,231,133,703,135
1802278,59,25,1954,4,"female",543,50,19,36,32,35,15,1,17
1802306,14,18,1999,1,"male",393,193,136,44,3,43,3,1,0
1802319,25,20,1988,3,"male",491,0,0,0,0,0,0,0,0
1802333,54,16,1959,9,"female",959,287,207,99,12,99,12,0,0
1802415,28,26,1985,1,"female",1208,348,186,176,173,176,91,0,82
1802417,36,13,1977,12,"male",368,19,12,0,0,0,0,0,0
1802458,94,11,1919,5,"female",2321,388,214,108,171,108,131,0,40
1802470,23,1,1990,1,"female",102,2,2,0,0,0,0,0,0
1802472,20,16,1993,6,"male",565,239,188,0,0,0,0,0,0
1802482,54,5,1959,7,"male",479,84,68,938,753,930,314,8,439
1802485,103,23,1910,10,"female",99,20,8,9,9,9,9,0,0
1802496,41,23,1972,7,"female",267,605,377,172,181,68,45,104,136
1802501,15,28,1998,5,"male",237,63,35,0,0,0,0,0,0
1802527,29,8,1984,11,"female",1334,21,11,65,27,40,8,25,19
1802541,36,21,1977,4,"male",425,25,8,34,2,0,0,34,2
1802550,73,5,1940,12,"male",934,133,73,19,26,0,3,19,23
1802576,65,15,1948,11,"female",2020,95,33,21,17,1,12,20,5
1802616,28,1,1985,6,"male",242,134,110,1,15,1,11,0,4
1802632,19,1,1994,5,"male",672,49,30,4,0,0,0,4,0
1802650,20,5,1993,7,"male",468,20,13,1,0,0,0,1,0
1802710,24,5,1989,1,"male",247,1,1,1,0,1,0,0,0
1802714,21,10,1992,3,"female",459,114,89,2632,839,2400,430,232,409
1802722,23,22,1990,12,"male",361,770,722,14,41,5,23,9,18
1802780,26,1,1987,1,"female",413,24,10,0,0,0,0,0,0
1802784,16,16,1997,8,"female",323,1476,997,964,654,224,205,740,449
1802796,18,2,1995,10,"male",142,712,592,69,116,69,102,0,14
1802819,62,17,1951,1,"female",728,196,96,73,456,0,141,73,315
1802861,103,13,1910,8,"male",488,881,552,318,36,318,23,0,13
1802887,28,25,1985,9,"female",654,61,28,4,2,4,1,0,1
1802894,54,5,1959,7,"female",413,66,24,85,64,13,23,72,41
1802923,47,28,1966,1,"male",41,0,0,0,0,0,0,0,0
1802925,78,24,1935,10,"male",968,12,6,0,0,0,0,0,0
1802928,37,3,1976,1,"female",829,55,26,9,9,0,2,9,7
1802943,15,7,1998,3,"male",282,0,0,0,0,0,0,0,0
1802954,15,24,1998,5,"female",84,624,523,125,183,124,102,1,81
1802964,31,11,1982,9,"male",582,142,129,0,0,0,0,0,0
1802968,56,21,1957,12,"female",1495,105,60,1026,344,1013,184,13,160
1802979,29,5,1984,2,"female",337,3,3,2,0,2,0,0,0
1802986,36,19,1977,11,"male",617,1,0,0,0,0,0,0,0
1803007,30,28,1983,11,"male",333,243,76,2,22,0,2,2,20
1803008,26,1,1987,1,"male",607,66,34,5,36,5,13,0,23
1803019,51,12,1962,2,"male",134,28,24,57,241,57,102,0,139
1803024,28,20,1985,10,"male",543,0,0,0,0,0,0,0,0
1803030,23,20,1990,12,"female",387,96,60,55,15,13,8,42,7
1803033,65,11,1948,4,"female",1547,125,39,9,5,1,2,8,3
1803044,25,30,1988,5,"male",338,40,40,3,0,3,0,0,0
1803050,66,8,1947,9,"male",602,29,26,0,2,0,1,0,1
1803072,31,27,1982,5,"male",75,17,17,0,1,0,1,0,0
1803092,53,4,1960,4,"male",1388,49,32,65,81,61,32,4,49
1803102,25,11,1988,3,"male",472,127,110,151,56,151,50,0,6
1803106,27,10,1986,6,"male",589,432,290,72,13,66,9,6,4
1803132,46,5,1967,8,"male",350,39,33,0,0,0,0,0,0
1803136,15,26,1998,8,"male",588,1012,521,471,609,82,406,389,203
1803144,19,7,1994,12,"female",428,386,22,11,271,10,186,1,85
1803146,17,20,1996,12,"male",764,0,0,0,0,0,0,0,0
1803147,23,17,1990,7,"female",731,9,3,3,0,3,0,0,0
1803152,60,23,1953,10,"male",1233,111,40,0,3,0,2,0,1
1803156,23,1,1990,1,"male",786,175,97,0,0,0,0,0,0
1803162,51,12,1962,4,"male",188,15,12,5,3,5,3,0,0
1803188,35,14,1978,9,"female",213,4,2,0,0,0,0,0,0
1803200,14,18,1999,3,"female",665,47,30,19,6,19,3,0,3
1803220,18,22,1995,8,"male",496,138,22,8,0,6,0,2,0
1803263,100,27,1913,2,"male",256,340,283,153,16,153,14,0,2
1803271,68,1,1945,1,"male",1474,82,37,0,0,0,0,0,0
1803278,17,10,1996,3,"female",28,109,43,1,0,1,0,0,0
1803302,21,8,1992,1,"male",1262,1954,1050,0,0,0,0,0,0
1803325,53,4,1960,4,"male",584,260,169,171,535,33,359,138,176
1803326,18,9,1995,4,"male",351,192,135,0,5,0,1,0,4
1803351,53,20,1960,4,"male",619,86,49,2,0,0,0,2,0
1803360,14,28,1999,1,"female",447,260,205,1,3,0,2,1,1
1803369,25,15,1988,5,"male",45,26,18,12,15,7,11,5,4
1803378,48,28,1965,1,"female",23,25,23,4,10,0,9,4,1
1803394,38,10,1975,11,"female",274,72,64,144,7,144,2,0,5
1803419,21,29,1992,5,"male",998,1494,669,11,19,11,19,0,0
1803432,45,1,1968,11,"female",1703,251,126,805,507,427,268,378,239
1803477,50,16,1963,9,"female",742,52,22,168,49,168,46,0,3
1803506,39,18,1974,6,"female",269,2,0,1,0,1,0,0,0
1803519,48,18,1965,8,"female",1065,143,61,95,10,95,6,0,4
1803586,25,1,1988,10,"male",1260,466,198,217,172,205,138,12,34
1803593,69,1,1944,4,"male",303,30,19,3,2,0,2,3,0
1803607,57,26,1956,6,"female",150,50,20,693,211,285,23,408,188
1803634,18,6,1995,2,"male",647,176,111,1,8,0,7,1,1
1803642,21,18,1992,12,"male",637,114,78,0,0,0,0,0,0
1803682,23,20,1990,10,"male",516,21,18,0,0,0,0,0,0
1803685,19,9,1994,9,"male",287,334,310,0,0,0,0,0,0
1803711,16,1,1997,2,"female",1200,135,73,1586,951,427,220,1159,731
1803719,23,10,1990,9,"male",76,6,6,9,0,9,0,0,0
1803724,77,12,1936,9,"male",672,16,6,10,5,0,4,10,1
1803741,32,1,1981,1,"male",147,0,0,0,0,0,0,0,0
1803744,108,1,1905,10,"male",1208,479,330,45,21,45,15,0,6
1803781,31,30,1982,4,"female",426,27,14,107,9,75,3,32,6
1803794,31,6,1982,2,"male",335,77,36,30,33,30,28,0,5
1803813,18,12,1995,6,"female",212,212,104,666,878,535,475,131,403
1803835,61,17,1952,9,"male",1019,174,89,27,1,27,1,0,0
1803872,17,30,1996,6,"male",270,49,37,0,0,0,0,0,0
1803874,20,17,1993,6,"female",215,184,155,120,42,120,11,0,31
1803878,48,21,1965,10,"female",775,219,124,203,74,203,64,0,10
1803898,47,29,1966,12,"male",1539,158,62,0,1,0,0,0,1
1803906,49,24,1964,12,"male",209,26,20,1,5,1,1,0,4
1803944,30,20,1983,4,"female",709,151,90,65,107,65,97,0,10
1803948,20,25,1993,5,"male",687,628,357,15,59,15,46,0,13
1803970,34,10,1979,9,"male",15,1,0,12,2,0,0,12,2
1803974,65,10,1948,3,"male",1330,114,51,0,0,0,0,0,0
1804007,15,23,1998,4,"female",834,1473,342,1414,2829,384,1289,1030,1540
1804016,18,1,1995,12,"male",298,163,49,6,2,0,1,6,1
1804058,39,11,1974,11,"male",333,3,3,0,0,0,0,0,0
1804083,51,30,1962,1,"male",419,24,10,0,2,0,0,0,2
1804095,39,28,1974,2,"female",303,97,78,80,50,70,34,10,16
1804116,29,10,1984,10,"male",618,105,85,20,0,20,0,0,0
1804128,21,7,1992,7,"male",235,3,3,1,0,0,0,1,0
1804155,18,6,1995,7,"female",195,1446,1355,563,312,561,243,2,69
1804184,98,1,1915,1,"male",36,1,1,2,1,0,1,2,0
1804193,30,14,1983,5,"female",486,17,13,0,0,0,0,0,0
1804204,55,6,1958,6,"male",279,38,24,0,0,0,0,0,0
1804234,45,4,1968,4,"female",663,49,13,1,17,0,3,1,14
1804248,44,3,1969,12,"male",246,147,95,304,11,131,5,173,6
1804255,44,18,1969,8,"female",442,64,56,56,63,30,33,26,30
1804304,34,28,1979,10,"male",106,7,7,3,3,3,3,0,0
1804323,19,27,1994,9,"male",659,217,196,0,0,0,0,0,0
1804329,23,17,1990,2,"male",702,154,118,0,0,0,0,0,0
1804336,21,30,1992,4,"female",218,161,119,721,711,393,549,328,162
1804338,49,30,1964,7,"male",958,78,41,1,3,0,2,1,1
1804344,25,5,1988,9,"male",194,132,66,0,0,0,0,0,0
1804367,23,9,1990,9,"male",464,838,570,1554,730,1528,638,26,92
1804417,62,28,1951,4,"female",1251,134,123,250,97,0,25,250,72
1804453,20,17,1993,11,"female",1142,407,186,26,24,18,9,8,15
1804456,26,8,1987,12,"male",105,7,6,0,0,0,0,0,0
1804463,65,22,1948,4,"female",401,105,80,150,70,1,51,149,19
1804513,65,7,1948,12,"female",1292,41,32,0,0,0,0,0,0
1804530,35,18,1978,12,"male",1050,139,16,1,17,1,10,0,7
1804545,43,6,1970,10,"male",1327,21,8,1,1,1,1,0,0
1804562,38,18,1975,4,"male",457,6,3,0,3,0,3,0,0
1804576,20,22,1993,1,"male",327,87,65,54,110,54,35,0,75
1804583,20,17,1993,12,"female",2,0,0,26,3,0,1,26,2
1804585,22,29,1991,7,"male",640,91,65,4,2,4,2,0,0
1804604,22,11,1991,3,"male",96,1,0,1,0,0,0,1,0
1804607,26,30,1987,7,"male",500,528,385,44,71,44,51,0,20
1804619,22,12,1991,11,"female",258,190,110,0,0,0,0,0,0
1804628,17,7,1996,1,"female",189,3521,704,2583,4389,2583,3840,0,549
1804646,108,28,1905,9,"female",1156,304,41,448,214,448,101,0,113
1804650,21,10,1992,5,"female",325,312,200,0,3,0,1,0,2
1804654,19,7,1994,12,"male",586,3,2,1,0,0,0,1,0
1804677,23,3,1990,7,"male",608,543,406,50,10,20,6,30,4
1804680,33,23,1980,4,"female",436,300,216,608,613,608,476,0,137
1804748,35,17,1978,9,"female",475,167,139,298,246,24,80,274,166
1804751,34,9,1979,4,"male",1004,18,16,0,1,0,1,0,0
1804772,103,13,1910,8,"female",1031,1005,133,7,41,7,28,0,13
1804791,20,3,1993,4,"male",215,306,275,413,99,363,69,50,30
1804799,103,18,1910,1,"female",89,317,289,127,33,127,28,0,5
1804800,36,12,1977,3,"female",368,284,54,847,17,847,15,0,2
1804804,18,12,1995,4,"male",571,55,31,0,0,0,0,0,0
1804841,33,3,1980,9,"female",221,18,14,0,0,0,0,0,0
1804863,100,1,1913,1,"male",29,18,16,21,6,12,2,9,4
1804866,19,5,1994,1,"female",140,494,394,1875,2280,405,447,1470,1833
1804894,27,21,1986,4,"female",1764,629,414,178,685,178,618,0,67
1804896,23,30,1990,11,"male",16,21,12,4,23,4,23,0,0
1804922,37,29,1976,7,"male",148,18,8,0,1,0,0,0,1
1804925,19,27,1994,12,"male",614,298,188,4,9,3,7,1,2
1804935,40,16,1973,7,"male",226,7,6,0,0,0,0,0,0
1804965,35,28,1978,9,"male",534,8,1,1,0,1,0,0,0
1804969,50,1,1963,6,"male",420,30,22,0,0,0,0,0,0
1804977,55,3,1958,7,"male",18,16,12,37,62,37,58,0,4
1804978,74,4,1939,10,"male",207,11,7,1,0,0,0,1,0
1805020,16,2,1997,3,"female",667,223,173,113,49,98,35,15,14
1805059,28,20,1985,11,"male",1057,688,402,21,21,21,16,0,5
1805071,48,2,1965,2,"male",124,79,57,397,13,397,11,0,2
1805075,22,16,1991,10,"male",229,373,317,695,186,695,133,0,53
1805083,67,11,1946,7,"male",1161,21,11,12,1,12,1,0,0
1805086,37,11,1976,5,"male",63,0,0,0,0,0,0,0,0
1805128,18,2,1995,2,"male",144,236,229,30,4,30,4,0,0
1805135,18,7,1995,8,"male",423,420,327,45,13,30,4,15,9
1805141,16,6,1997,1,"female",266,119,72,0,0,0,0,0,0
1805144,24,21,1989,10,"male",74,24,16,0,1,0,1,0,0
1805160,48,6,1965,3,"male",526,38,22,8,4,0,0,8,4
1805177,25,16,1988,3,"male",210,122,97,0,0,0,0,0,0
1805184,25,19,1988,5,"male",244,16,11,16,0,16,0,0,0
1805193,47,26,1966,4,"male",136,29,8,0,0,0,0,0,0
1805208,43,14,1970,9,"male",373,21,3,6,16,4,4,2,12
1805244,18,18,1995,12,"female",553,43,1,0,6,0,1,0,5
1805259,50,8,1963,6,"male",27,4,4,24,12,24,8,0,4
1805271,23,5,1990,12,"male",427,1519,1339,3874,5216,3874,4329,0,887
1805277,21,2,1992,6,"female",319,142,71,0,3,0,3,0,0
1805320,42,26,1971,2,"female",483,291,248,212,39,212,24,0,15
1805323,113,2,1900,8,"male",1257,421,223,5,119,5,54,0,65
1805334,17,11,1996,1,"female",123,233,146,17,81,16,53,1,28
1805340,92,15,1921,1,"male",2036,682,172,31,77,0,29,31,48
1805343,23,6,1990,4,"male",150,64,26,70,9,70,7,0,2
1805371,17,17,1996,5,"male",353,96,73,2,2,2,0,0,2
1805418,25,25,1988,8,"male",10,30,27,69,27,69,16,0,11
1805425,33,1,1980,11,"female",391,11,5,0,0,0,0,0,0
1805445,29,25,1984,3,"female",729,27,12,1,3,1,2,0,1
1805451,59,25,1954,2,"female",399,171,117,2333,747,0,16,2333,731
1805456,18,3,1995,5,"male",381,366,286,1125,1536,948,1196,177,340
1805457,102,25,1911,12,"male",1085,2560,1525,5,2,5,2,0,0
1805464,71,16,1942,10,"female",1179,29,12,32,56,0,39,32,17
1805487,29,1,1984,4,"female",1078,200,91,750,969,687,461,63,508
1805489,14,21,1999,2,"male",379,261,109,494,2,145,2,349,0
1805495,26,14,1987,4,"female",527,524,362,7083,3698,5913,1830,1170,1868
1805497,18,26,1995,1,"male",23,0,0,0,0,0,0,0,0
1805527,21,29,1992,11,"female",674,673,452,50,178,50,136,0,42
1805559,24,17,1989,8,"male",483,72,58,114,137,114,115,0,22
1805570,44,8,1969,1,"male",710,116,84,61,17,0,12,61,5
1805579,20,18,1993,12,"male",358,268,169,18,3,0,1,18,2
1805592,70,11,1943,4,"male",341,531,431,4,9,1,1,3,8
1805611,52,22,1961,2,"male",606,54,22,100,26,0,11,100,15
1805620,15,18,1998,8,"male",253,116,101,20,0,0,0,20,0
1805639,70,30,1943,5,"male",1453,54,30,69,41,69,20,0,21
1805645,14,25,1999,12,"female",154,135,62,13,8,13,1,0,7
1805646,24,12,1989,12,"female",346,91,49,168,227,7,36,161,191
1805654,39,23,1974,3,"male",305,47,17,61,42,61,32,0,10
1805728,32,28,1981,1,"male",162,44,39,0,0,0,0,0,0
1805750,83,19,1930,6,"male",1587,70,26,16,18,16,14,0,4
1805791,28,5,1985,4,"male",1247,582,480,0,0,0,0,0,0
1805792,34,3,1979,7,"male",459,18,8,5,0,5,0,0,0
1805796,67,21,1946,1,"female",1115,40,15,0,0,0,0,0,0
1805830,30,15,1983,10,"male",300,117,64,1,1,1,1,0,0
1805838,20,19,1993,12,"male",201,81,59,2,0,2,0,0,0
1805850,33,6,1980,5,"male",587,110,48,207,117,207,88,0,29
1805856,103,13,1910,2,"female",1483,52,25,11,1,0,1,11,0
1805859,33,25,1980,3,"male",46,39,23,0,1,0,1,0,0
1805879,42,6,1971,9,"female",313,2,1,0,0,0,0,0,0
1805912,33,19,1980,12,"female",53,9,8,8,9,0,0,8,9
1805935,40,14,1973,10,"male",141,5,0,1,0,0,0,1,0
1805938,66,17,1947,3,"female",198,50,42,7,4,0,0,7,4
1805949,63,2,1950,12,"male",961,23,7,1,3,0,2,1,1
1805959,15,4,1998,2,"female",218,184,137,295,196,95,75,200,121
1805967,52,15,1961,2,"male",866,130,102,178,129,161,80,17,49
1805982,50,8,1963,2,"male",292,70,66,7,6,7,6,0,0
1806010,50,30,1963,10,"female",311,140,108,18,13,18,13,0,0
1806013,21,24,1992,6,"male",252,199,77,15,5,15,4,0,1
1806016,33,10,1980,9,"male",459,2,2,0,0,0,0,0,0
1806020,42,21,1971,7,"male",528,107,65,0,0,0,0,0,0
1806033,58,4,1955,4,"male",119,35,32,1,2,0,1,1,1
1806045,18,29,1995,11,"female",328,166,110,0,0,0,0,0,0
1806051,47,27,1966,9,"male",88,55,44,5,1,0,0,5,1
1806113,33,2,1980,2,NA,2016,493,291,357,886,85,601,272,285
1806132,25,2,1988,8,"female",195,52,22,121,136,118,76,3,60
1806141,36,21,1977,7,"male",562,5,0,0,0,0,0,0,0
1806184,18,11,1995,5,"female",149,79,45,0,48,0,43,0,5
1806198,37,14,1976,4,"male",398,36,26,6,0,6,0,0,0
1806206,24,25,1989,4,"female",23,0,0,0,0,0,0,0,0
1806208,42,2,1971,10,"male",355,183,152,2,0,2,0,0,0
1806211,23,7,1990,7,"male",566,123,66,12,0,12,0,0,0
1806226,51,26,1962,2,"male",23,14,13,0,0,0,0,0,0
1806232,103,25,1910,4,"male",451,101,46,0,2,0,0,0,2
1806244,23,17,1990,10,"male",688,0,0,0,0,0,0,0,0
1806287,41,28,1972,10,"female",508,95,56,379,382,365,302,14,80
1806288,27,1,1986,1,"male",580,0,0,0,0,0,0,0,0
1806290,18,1,1995,1,"male",557,1237,1105,255,140,255,133,0,7
1806371,27,2,1986,9,"male",322,29,27,2,15,2,13,0,2
1806401,37,18,1976,3,"female",198,44,31,983,329,0,101,983,228
1806404,27,10,1986,12,"female",376,318,265,1,6,1,5,0,1
1806414,34,8,1979,7,"female",295,94,19,18,1,18,1,0,0
1806426,68,29,1945,8,"female",1268,1320,537,3,8,3,7,0,1
1806430,97,18,1916,12,"female",784,820,504,8,0,8,0,0,0
1806471,26,8,1987,3,"female",509,390,289,204,347,151,274,53,73
1806478,108,30,1905,3,"female",269,16,8,3,0,3,0,0,0
1806485,22,20,1991,9,"female",357,63,31,72,49,53,32,19,17
1806520,98,29,1915,12,"female",1293,3483,386,0,8,0,5,0,3
1806527,30,19,1983,8,"male",37,81,75,41,59,14,28,27,31
1806530,24,17,1989,2,"male",430,150,57,1,0,1,0,0,0
1806532,47,17,1966,1,"male",291,4,4,8,6,0,0,8,6
1806538,54,17,1959,10,"female",1818,405,267,206,106,110,75,96,31
1806588,53,14,1960,8,"male",729,812,251,1,10,1,7,0,3
1806599,19,29,1994,8,"male",505,88,43,0,1,0,1,0,0
1806634,26,12,1987,6,"female",496,27,10,0,0,0,0,0,0
1806642,31,4,1982,11,"male",303,54,14,30,28,30,19,0,9
1806650,19,29,1994,7,"female",482,4043,2248,292,1489,74,276,218,1213
1806652,66,11,1947,7,"female",222,79,52,42,43,12,16,30,27
1806670,27,1,1986,2,"female",532,73,28,128,131,128,120,0,11
1806671,22,31,1991,12,"female",309,17,8,8,5,2,3,6,2
1806696,45,2,1968,4,"male",451,70,42,68,41,68,39,0,2
1806705,23,1,1990,1,"male",137,5,3,0,0,0,0,0,0
1806756,28,31,1985,3,"female",2033,353,240,244,513,236,456,8,57
1806758,30,1,1983,11,"male",307,74,41,94,154,55,50,39,104
1806774,26,1,1987,1,"female",61,28,23,1,0,1,0,0,0
1806789,28,14,1985,8,"female",348,35,28,9,1,9,0,0,1
1806791,23,10,1990,4,"female",306,16,7,47,9,47,5,0,4
1806794,25,1,1988,1,"male",233,45,31,20,1,20,1,0,0
1806856,61,2,1952,1,"male",733,37,28,68,23,68,12,0,11
1806862,56,9,1957,6,"female",536,44,13,0,0,0,0,0,0
1806872,18,23,1995,2,"male",408,432,405,196,144,196,110,0,34
1806873,45,5,1968,6,"male",967,85,59,4,0,4,0,0,0
1806880,40,1,1973,2,"female",224,188,97,92,29,92,28,0,1
1806902,42,9,1971,5,"female",315,278,212,4,47,4,14,0,33
1806913,35,18,1978,12,"male",369,49,35,1,0,1,0,0,0
1806924,100,13,1913,5,"female",1474,573,263,213,384,145,237,68,147
1806957,25,1,1988,1,"male",140,17,16,3,17,3,9,0,8
1806961,99,27,1914,12,"male",994,68,26,2,13,2,11,0,2
1806967,25,4,1988,8,"male",284,38,36,0,0,0,0,0,0
1806979,19,1,1994,2,"male",45,35,28,7,1,2,1,5,0
1806987,59,13,1954,11,"male",1200,74,27,19,2,0,0,19,2
1806997,31,21,1982,2,"female",1616,161,45,511,515,377,295,134,220
1807025,35,1,1978,5,"male",214,14,13,0,0,0,0,0,0
1807026,101,21,1912,12,"male",1669,97,63,195,123,80,63,115,60
1807036,40,1,1973,1,"male",191,3,2,29,3,27,3,2,0
1807078,15,15,1998,5,"male",173,4,3,5,1,5,1,0,0
1807079,62,25,1951,12,"male",206,1195,281,8,91,0,26,8,65
1807115,37,17,1976,1,"female",252,45,35,605,162,605,107,0,55
1807116,22,15,1991,1,"female",174,21,10,7,9,7,8,0,1
1807128,65,22,1948,5,"female",1747,82,41,18,13,17,7,1,6
1807135,43,12,1970,3,"female",230,28,23,43,52,43,45,0,7
1807143,54,5,1959,6,"male",155,4,4,11,0,11,0,0,0
1807156,25,25,1988,6,"male",1829,212,55,15,3,15,2,0,1
1807161,25,1,1988,1,"male",8,8,8,0,0,0,0,0,0
1807180,19,28,1994,11,"female",653,285,187,110,243,34,168,76,75
1807268,22,1,1991,1,"female",255,217,105,18,45,18,24,0,21
1807279,40,23,1973,6,"male",269,3,2,27,16,0,3,27,13
1807281,24,6,1989,2,"male",380,0,0,0,0,0,0,0,0
1807367,33,16,1980,1,"female",184,26,17,4,7,3,2,1,5
1807382,46,19,1967,5,"female",416,81,55,5,1,0,0,5,1
1807384,100,15,1913,12,"female",936,393,245,794,378,515,298,279,80
1807388,19,18,1994,2,"female",466,3070,1365,348,2011,344,1449,4,562
1807400,21,22,1992,4,"female",397,559,39,0,1,0,1,0,0
1807429,18,28,1995,11,"male",171,60,50,130,33,130,23,0,10
1807448,20,17,1993,7,"male",175,74,45,0,0,0,0,0,0
1807465,21,5,1992,5,"male",465,225,157,3,18,3,13,0,5
1807472,23,2,1990,7,"female",563,529,295,45,103,39,45,6,58
1807478,22,14,1991,10,"female",380,101,40,10,30,10,20,0,10
1807498,52,27,1961,4,"male",249,5,4,2636,706,2636,381,0,325
1807537,46,4,1967,11,"male",354,60,37,10,3,9,3,1,0
1807544,54,24,1959,8,"male",1262,213,124,977,1817,925,781,52,1036
1807547,28,2,1985,1,"female",600,9,8,0,0,0,0,0,0
1807558,42,27,1971,3,"male",327,2,1,0,0,0,0,0,0
1807563,19,21,1994,9,"female",196,38,3,25,13,25,13,0,0
1807567,31,23,1982,6,"female",212,75,37,238,185,238,86,0,99
1807586,30,5,1983,7,"male",108,273,221,39,33,39,32,0,1
1807593,64,2,1949,9,"male",646,38,24,36,28,0,23,36,5
1807629,72,24,1941,4,"female",1661,163,105,83,7,81,5,2,2
1807694,38,16,1975,10,"male",334,197,123,115,88,115,38,0,50
1807697,14,25,1999,8,"male",226,221,120,10,8,9,4,1,4
1807716,18,1,1995,10,"male",546,151,99,40,21,40,11,0,10
1807735,25,1,1988,1,"female",211,21,17,0,0,0,0,0,0
1807737,30,15,1983,8,"male",404,15,13,26,3,0,2,26,1
1807752,26,8,1987,4,"male",323,326,128,15,0,15,0,0,0
1807813,23,10,1990,3,"female",0,0,0,0,0,0,0,0,0
1807819,33,18,1980,10,"male",427,37,21,2,1,2,1,0,0
1807848,31,22,1982,9,"female",156,32,24,80,0,80,0,0,0
1807873,64,1,1949,7,"male",2290,78,40,1,11,0,7,1,4
1807905,66,11,1947,4,"female",740,40,21,53,15,53,10,0,5
1807908,24,1,1989,6,"female",133,240,94,306,933,210,404,96,529
1807923,64,6,1949,5,"male",20,15,9,5,4,4,4,1,0
1807947,16,16,1997,11,"male",14,20,20,2,0,2,0,0,0
1807972,18,30,1995,7,"male",175,36,25,50,25,24,17,26,8
1807979,19,27,1994,1,"female",602,616,354,142,75,106,40,36,35
1807987,18,10,1995,3,"male",215,40,24,6,23,6,7,0,16
1807988,43,20,1970,8,"male",267,26,18,0,1,0,1,0,0
1807989,23,13,1990,11,"female",218,4,2,9,5,0,5,9,0
1807991,25,21,1988,11,"male",211,6,3,0,0,0,0,0,0
1808001,36,6,1977,10,"female",155,3,1,1,2,1,2,0,0
1808010,18,1,1995,3,"male",286,117,94,63,115,63,101,0,14
1808020,57,1,1956,1,"male",538,14,6,0,0,0,0,0,0
1808071,20,27,1993,2,"male",174,0,0,0,0,0,0,0,0
1808079,53,5,1960,7,"female",401,48,41,14,24,3,5,11,19
1808104,63,12,1950,12,"male",1333,110,79,1,3,0,3,1,0
1808110,15,13,1998,2,"female",580,1542,1072,570,390,475,96,95,294
1808127,14,18,1999,10,"male",209,169,115,0,0,0,0,0,0
1808135,19,9,1994,9,"male",1169,1019,492,385,599,218,302,167,297
1808177,64,8,1949,6,"female",634,23,9,1,1,0,1,1,0
1808186,69,1,1944,4,"male",605,24,16,2,6,0,5,2,1
1808197,32,14,1981,6,"female",574,251,159,109,20,109,16,0,4
1808210,68,5,1945,11,"male",1464,69,36,0,0,0,0,0,0
1808237,37,8,1976,7,"male",272,24,12,3,46,3,44,0,2
1808253,43,25,1970,11,"female",104,147,62,36,43,20,21,16,22
1808300,18,2,1995,6,"female",442,35,21,163,50,163,34,0,16
1808305,14,10,1999,2,"male",456,114,61,3,29,3,13,0,16
1808308,63,25,1950,4,"female",56,54,35,40,6,40,4,0,2
1808328,31,5,1982,11,"male",383,102,86,2,2,2,1,0,1
1808392,33,12,1980,5,"male",195,13,12,0,0,0,0,0,0
1808445,21,2,1992,2,"male",184,125,112,5,32,5,26,0,6
1808529,15,28,1998,9,"female",378,288,121,5,0,5,0,0,0
1808581,25,2,1988,9,"male",329,0,0,0,0,0,0,0,0
1808610,18,27,1995,3,"male",629,510,453,8,11,8,11,0,0
1808616,21,13,1992,10,"female",414,92,55,1282,1013,713,585,569,428
1808620,21,30,1992,12,"male",241,74,48,0,0,0,0,0,0
1808644,67,12,1946,12,"male",154,27,23,8,15,8,14,0,1
1808722,18,11,1995,11,"male",540,34,23,4,0,3,0,1,0
1808723,64,20,1949,12,"female",1793,58,9,1,6,0,3,1,3
1808748,48,23,1965,10,"male",700,28,22,18,25,12,19,6,6
1808767,18,14,1995,10,"male",215,176,129,108,79,108,78,0,1
1808782,67,28,1946,5,"male",554,31,24,2,1,0,0,2,1
1808785,67,10,1946,10,"male",715,25,20,2,0,1,0,1,0
1808791,15,17,1998,9,"male",400,81,60,6,0,0,0,6,0
1808816,29,19,1984,5,"female",105,72,53,45,50,45,42,0,8
1808820,36,5,1977,5,"female",345,248,41,17,37,17,17,0,20
1808889,52,27,1961,7,"female",161,18,14,12,0,12,0,0,0
1808891,17,5,1996,2,"male",227,48,45,0,2,0,2,0,0
1808919,58,7,1955,8,"male",301,142,77,8,9,0,0,8,9
1808939,65,21,1948,6,"male",980,41,24,51,6,2,1,49,5
1808943,17,29,1996,12,"male",746,224,171,52,2,52,2,0,0
1808945,18,7,1995,5,"female",196,75,29,182,85,182,72,0,13
1808949,61,9,1952,10,"male",776,44,14,0,0,0,0,0,0
1808992,23,19,1990,5,"male",268,194,61,84,76,84,52,0,24
1809014,29,3,1984,5,"female",112,22,15,3,10,3,4,0,6
1809026,51,24,1962,4,"female",503,80,66,10,10,0,7,10,3
1809041,19,20,1994,1,"male",327,3,2,0,0,0,0,0,0
1809061,23,15,1990,3,"female",312,15,12,203,7,203,3,0,4
1809067,26,14,1987,4,"male",441,35,20,11,22,11,16,0,6
1809079,49,16,1964,11,"male",559,247,206,148,120,148,72,0,48
1809096,14,5,1999,9,"female",273,194,56,468,71,431,31,37,40
1809098,25,1,1988,1,"male",185,11,11,0,0,0,0,0,0
1809135,18,22,1995,2,"male",105,224,197,42,59,42,42,0,17
1809167,49,2,1964,9,"female",614,281,189,84,10,0,7,84,3
1809181,26,18,1987,2,"male",664,317,192,8,2,8,2,0,0
1809198,41,19,1972,12,"female",2235,197,90,84,472,84,393,0,79
1809211,34,24,1979,7,"male",242,110,39,2,1,2,1,0,0
1809222,35,3,1978,6,"male",55,44,31,3,1,3,0,0,1
1809248,24,7,1989,3,"male",541,60,46,0,0,0,0,0,0
1809260,18,5,1995,6,"male",275,131,124,1,15,1,14,0,1
1809261,26,1,1987,11,"male",752,55,11,21,8,21,5,0,3
1809273,57,25,1956,7,"female",158,11,10,12,11,0,1,12,10
1809282,66,18,1947,8,"male",261,7,6,33,4,33,4,0,0
1809294,25,27,1988,8,"female",232,28,12,2,4,2,2,0,2
1809295,19,18,1994,2,"male",557,265,111,2,0,2,0,0,0
1809312,26,18,1987,12,"male",1878,803,320,1,0,0,0,1,0
1809319,30,13,1983,3,"female",370,3,3,0,0,0,0,0,0
1809378,42,7,1971,8,"female",241,8,3,2,0,0,0,2,0
1809382,59,4,1954,8,"male",335,23,13,76,24,76,16,0,8
1809400,39,20,1974,2,"male",518,41,23,0,1,0,0,0,1
1809414,48,19,1965,5,"female",92,24,19,4,3,4,2,0,1
1809415,24,29,1989,12,"male",206,25,15,118,2,111,1,7,1
1809436,45,9,1968,2,"male",94,50,19,28,27,7,11,21,16
1809463,22,7,1991,5,"male",62,17,15,2,0,0,0,2,0
1809479,32,6,1981,5,"male",246,21,19,127,3,127,2,0,1
1809489,28,1,1985,5,"male",867,2,2,0,0,0,0,0,0
1809498,107,10,1906,3,"female",533,331,292,13,31,13,29,0,2
1809503,13,23,2000,1,"male",194,3,2,0,0,0,0,0,0
1809537,21,1,1992,1,"male",895,333,268,28,10,28,9,0,1
1809539,59,2,1954,2,"female",1507,289,211,25,57,0,29,25,28
1809564,16,9,1997,3,"female",359,265,213,733,72,733,50,0,22
1809567,47,24,1966,10,"male",335,75,49,88,49,61,32,27,17
1809571,18,10,1995,6,"male",202,103,63,9,16,9,10,0,6
1809576,21,4,1992,5,"female",244,90,66,5,8,5,3,0,5
1809592,24,15,1989,2,"male",610,5,5,0,0,0,0,0,0
1809603,32,5,1981,10,"female",1122,204,132,1216,1195,280,440,936,755
1809605,61,7,1952,12,"female",1800,127,48,153,19,4,14,149,5
1809629,35,14,1978,3,"male",710,74,33,1,2,1,2,0,0
1809640,108,25,1905,2,"male",1047,57,41,124,18,0,7,124,11
1809644,16,8,1997,7,"male",96,83,65,13,8,13,8,0,0
1809656,83,27,1930,1,"female",2194,300,114,85,191,10,96,75,95
1809659,28,1,1985,1,"male",336,46,28,281,265,281,87,0,178
1809685,28,31,1985,8,"male",225,83,47,0,0,0,0,0,0
1809688,53,4,1960,2,"female",1639,97,69,161,30,157,23,4,7
1809734,64,23,1949,5,"male",696,32,12,0,10,0,5,0,5
1809755,43,17,1970,11,"male",412,7,3,1,0,1,0,0,0
1809759,66,6,1947,6,"female",786,79,23,0,0,0,0,0,0
1809765,63,18,1950,6,"male",2210,51,37,33,42,24,33,9,9
1809789,18,3,1995,12,"female",295,296,81,60,56,44,19,16,37
1809854,30,26,1983,7,"male",157,49,32,25,38,25,14,0,24
1809861,21,15,1992,4,"female",322,35,13,15,32,0,4,15,28
1809863,19,8,1994,5,"male",401,65,40,63,70,20,43,43,27
1809869,21,26,1992,4,"female",12,64,60,498,323,317,76,181,247
1809877,48,25,1965,4,"female",452,24,17,5,11,5,5,0,6
1809893,56,18,1957,9,"female",305,153,110,11,44,0,6,11,38
1809899,60,20,1953,12,"male",8,5,5,0,0,0,0,0,0
1809948,28,1,1985,1,"male",471,121,56,1,1,1,0,0,1
1809961,18,1,1995,2,"female",604,505,401,95,130,95,97,0,33
1809967,42,6,1971,11,"female",643,66,33,0,0,0,0,0,0
1810011,27,17,1986,11,"female",346,2,2,2,2,0,0,2,2
1810017,27,3,1986,5,"female",1097,771,447,1396,1174,220,735,1176,439
1810020,30,5,1983,10,"female",428,307,137,157,269,155,96,2,173
1810023,48,10,1965,4,"female",1460,53,36,12,14,12,9,0,5
1810034,39,2,1974,4,"female",518,21,14,140,16,140,13,0,3
1810050,75,8,1938,3,"female",1466,98,31,290,57,212,20,78,37
1810059,56,11,1957,6,"female",1601,46,28,52,25,8,11,44,14
1810062,100,12,1913,12,"male",1528,604,291,68,46,36,16,32,30
1810090,18,5,1995,5,"male",750,540,310,1,14,1,13,0,1
1810111,38,17,1975,8,"female",329,768,250,444,414,444,370,0,44
1810153,25,11,1988,2,"female",621,200,114,713,444,574,270,139,174
1810173,65,12,1948,2,"female",1268,49,10,4,3,4,3,0,0
1810181,61,27,1952,7,"female",688,34,22,96,32,96,20,0,12
1810224,102,8,1911,10,"female",1503,110,35,69,37,9,24,60,13
1810229,17,30,1996,3,"female",374,414,80,235,468,163,232,72,236
1810263,24,1,1989,12,"male",294,633,510,57,61,57,36,0,25
1810280,53,10,1960,8,"male",822,6,4,0,0,0,0,0,0
1810297,93,19,1920,5,"female",552,347,117,1,0,1,0,0,0
1810320,108,1,1905,1,"male",2208,24,10,6,8,0,6,6,2
1810322,17,14,1996,8,"female",401,818,395,1016,261197,659,131244,357,129953
1810325,30,8,1983,10,"male",932,222,127,239,178,239,167,0,11
1810344,23,19,1990,5,"male",337,199,164,2,2,2,2,0,0
1810371,14,14,1999,11,"female",263,453,399,705,574,653,395,52,179
1810386,28,6,1985,5,"male",39,205,192,34,2,34,2,0,0
1810395,18,1,1995,1,"male",278,178,115,7,0,7,0,0,0
1810420,98,20,1915,12,"female",1379,172,116,907,395,449,99,458,296
1810435,21,20,1992,9,"female",1,0,0,2,3,2,1,0,2
1810437,30,25,1983,10,"female",1247,178,42,85,65,85,61,0,4
1810457,49,2,1964,3,"female",1572,235,90,178,201,1,40,177,161
1810475,22,8,1991,6,"male",7,3,3,0,0,0,0,0,0
1810490,22,10,1991,8,"female",148,68,44,8,10,8,3,0,7
1810492,22,15,1991,10,"male",508,433,414,2,18,0,6,2,12
1810537,79,17,1934,1,"female",972,36,13,15,4,0,2,15,2
1810545,50,5,1963,4,"female",2221,231,165,1603,1361,1542,1175,61,186
1810567,17,7,1996,6,"male",399,165,115,13,12,13,12,0,0
1810594,52,1,1961,6,"female",415,41,25,4,4,0,1,4,3
1810595,24,20,1989,2,"male",56,77,60,0,0,0,0,0,0
1810603,26,5,1987,3,"male",440,60,28,1,1,1,0,0,1
1810632,22,23,1991,1,"male",384,9,4,2,0,2,0,0,0
1810654,17,12,1996,11,"male",337,172,148,0,0,0,0,0,0
1810660,39,4,1974,7,"male",293,2,1,0,3,0,0,0,3
1810753,18,31,1995,1,"male",648,465,351,4,17,4,14,0,3
1810754,17,2,1996,2,"male",400,27,19,0,0,0,0,0,0
1810755,26,4,1987,6,"male",606,108,76,14,32,14,32,0,0
1810756,38,18,1975,11,"male",284,4,2,0,0,0,0,0,0
1810758,20,23,1993,8,"male",212,362,263,21,33,21,30,0,3
1810761,49,25,1964,6,"male",1164,6,1,0,0,0,0,0,0
1810812,58,31,1955,5,"female",725,15,9,2,1,0,0,2,1
1810837,53,7,1960,10,"male",112,0,0,0,0,0,0,0,0
1810839,34,20,1979,12,"female",299,82,66,2,0,0,0,2,0
1810841,32,5,1981,5,"male",242,87,75,0,15,0,9,0,6
1810864,22,7,1991,8,"female",236,1,0,0,0,0,0,0,0
1810900,32,23,1981,9,"male",619,148,93,1,1,1,1,0,0
1810902,25,5,1988,1,"female",327,240,69,0,0,0,0,0,0
1810916,58,17,1955,11,"female",322,64,45,163,86,163,34,0,52
1810958,26,29,1987,12,"male",717,121,100,1,0,1,0,0,0
1810970,15,18,1998,6,"female",718,188,111,1,1,1,1,0,0
1810996,18,14,1995,10,"female",265,8,6,0,2,0,0,0,2
1811026,23,16,1990,7,"male",625,201,15,20,79,20,65,0,14
1811033,38,15,1975,2,"female",479,99,68,328,234,309,187,19,47
1811037,29,18,1984,11,"male",357,39,24,5,5,3,3,2,2
1811049,50,18,1963,1,"male",157,142,62,69,20,10,8,59,12
1811102,29,26,1984,3,"male",374,44,37,44,2,44,2,0,0
1811106,24,1,1989,1,"male",563,605,537,0,1,0,1,0,0
1811123,44,22,1969,9,"female",522,12,7,225,79,214,60,11,19
1811171,37,9,1976,8,"male",441,24,15,1,0,0,0,1,0
1811174,104,24,1909,2,"female",1815,200,23,40,13,40,3,0,10
1811188,23,11,1990,11,"male",572,341,329,248,32,2,19,246,13
1811217,103,16,1910,4,"female",983,223,78,8,4,8,4,0,0
1811272,46,16,1967,9,"male",801,22,9,0,0,0,0,0,0
1811279,21,28,1992,11,"male",1208,114,56,0,0,0,0,0,0
1811286,41,2,1972,2,"male",647,45,20,38,37,10,23,28,14
1811295,89,19,1924,6,"male",70,128,90,52,47,0,25,52,22
1811298,20,7,1993,7,"male",810,673,505,0,0,0,0,0,0
1811314,21,12,1992,12,"female",128,260,24,123,109,123,21,0,88
1811382,19,24,1994,8,"male",361,349,296,2,1,2,1,0,0
1811383,69,18,1944,9,"male",2020,72,30,295,75,280,25,15,50
1811390,23,7,1990,12,"male",381,215,76,42,99,42,66,0,33
1811410,14,22,1999,10,"female",614,64,38,2,0,2,0,0,0
1811416,15,20,1998,6,"female",246,362,198,36,55,36,53,0,2
1811427,66,22,1947,8,"female",1524,41,24,4,21,4,17,0,4
1811454,53,15,1960,10,"female",473,22,15,0,0,0,0,0,0
1811474,18,16,1995,9,"female",788,744,459,2576,947,66,212,2510,735
1811493,28,4,1985,9,"female",304,0,0,0,0,0,0,0,0
1811506,18,9,1995,3,"male",299,9,6,0,1,0,1,0,0
1811518,61,26,1952,2,"female",1327,81,46,3,4,0,3,3,1
1811520,19,5,1994,10,"female",323,457,396,17,10,11,7,6,3
1811527,19,16,1994,5,"female",524,96,21,0,1,0,1,0,0
1811570,18,18,1995,1,"female",401,91,28,15,3,0,0,15,3
1811575,14,22,1999,2,"female",51,13,6,0,0,0,0,0,0
1811594,49,27,1964,7,"male",2049,104,56,6,5,0,1,6,4
1811600,39,12,1974,7,"female",337,137,94,92,24,92,12,0,12
1811626,38,24,1975,1,"male",26,19,12,1,2,1,2,0,0
1811650,58,19,1955,5,"female",1382,86,57,268,7,199,3,69,4
1811698,14,1,1999,1,"male",495,563,404,21,1,21,0,0,1
1811699,22,14,1991,9,"male",291,46,35,0,0,0,0,0,0
1811701,18,24,1995,11,"female",467,480,214,251,133,31,56,220,77
1811705,50,1,1963,8,"female",1147,254,164,411,249,322,107,89,142
1811719,63,23,1950,2,"female",228,47,32,1,0,1,0,0,0
1811740,40,22,1973,10,"female",19,20,16,16,25,16,22,0,3
1811745,71,3,1942,5,"female",2039,39,31,52,100,0,52,52,48
1811773,60,27,1953,5,"female",381,11,2,0,0,0,0,0,0
1811774,26,1,1987,1,"male",27,42,40,0,0,0,0,0,0
1811798,46,21,1967,10,"male",824,164,95,23,59,18,23,5,36
1811809,57,26,1956,4,"female",829,72,22,6,27,1,10,5,17
1811812,28,4,1985,3,"female",825,219,169,283,559,170,418,113,141
1811856,28,29,1985,4,"female",496,191,77,19,28,19,26,0,2
1811901,28,7,1985,12,"female",18,102,85,138,120,69,41,69,79
1811903,22,29,1991,9,"male",288,187,66,81,277,50,108,31,169
1811927,68,28,1945,1,"male",46,275,254,0,5,0,5,0,0
1811948,51,8,1962,2,"male",652,538,270,184,21,163,20,21,1
1811955,100,20,1913,3,"male",1433,955,576,146,838,146,590,0,248
1811960,33,13,1980,4,"female",1825,18,12,31,24,31,20,0,4
1811973,28,11,1985,12,"male",705,157,47,50,6,16,3,34,3
1811989,22,20,1991,11,"female",191,213,171,0,0,0,0,0,0
1812008,19,7,1994,3,"male",529,65,47,1,2,1,1,0,1
1812024,54,5,1959,6,"female",850,308,125,8347,5191,2574,2506,5773,2685
1812044,56,14,1957,10,"male",536,212,145,32,25,32,25,0,0
1812046,35,10,1978,4,"male",1283,286,251,639,861,249,378,390,483
1812088,33,31,1980,10,"male",357,96,40,100,19,100,19,0,0
1812094,56,3,1957,8,"male",155,62,43,32,10,0,0,32,10
1812098,63,30,1950,12,"female",287,215,123,357,555,0,213,357,342
1812101,25,1,1988,1,"male",303,39,38,22,3,22,2,0,1
1812106,35,12,1978,10,"male",193,30,13,0,0,0,0,0,0
1812147,19,1,1994,1,"male",368,214,72,1,0,1,0,0,0
1812194,16,5,1997,8,"male",5,0,0,0,0,0,0,0,0
1812205,18,28,1995,1,"male",678,84,44,0,0,0,0,0,0
1812206,44,3,1969,12,"female",51,7,0,76,7,32,7,44,0
1812235,19,22,1994,11,"male",29,103,97,17,7,17,3,0,4
1812241,14,11,1999,5,"male",389,66,49,0,31,0,19,0,12
1812253,43,13,1970,7,"male",183,106,44,3,0,0,0,3,0
1812257,38,24,1975,10,"male",174,14,2,122,26,122,10,0,16
1812271,20,22,1993,8,"female",1486,1182,553,7156,5026,1403,3481,5753,1545
1812287,58,3,1955,6,"female",422,66,43,0,0,0,0,0,0
1812335,53,27,1960,6,"male",184,215,113,4,7,4,6,0,1
1812348,43,27,1970,7,"female",1904,675,198,154,296,153,166,1,130
1812356,61,22,1952,1,"male",174,28,22,2,0,2,0,0,0
1812365,16,3,1997,2,"female",650,371,34,0,0,0,0,0,0
1812367,36,5,1977,4,"male",544,5,1,1,1,0,1,1,0
1812371,14,15,1999,1,"male",329,87,73,172,0,0,0,172,0
1812405,37,2,1976,6,"male",750,44,30,7,19,0,6,7,13
1812436,19,18,1994,7,"female",424,299,89,25,59,25,55,0,4
1812443,17,1,1996,3,"female",478,245,139,35,23,25,16,10,7
1812475,24,4,1989,5,"male",887,135,129,0,0,0,0,0,0
1812477,54,4,1959,1,"male",607,35,26,20,46,0,14,20,32
1812482,51,26,1962,4,"male",1802,60,10,4,2,2,1,2,1
1812523,31,13,1982,9,"female",398,1113,926,599,681,571,444,28,237
1812529,54,15,1959,8,"male",1528,94,43,14,0,14,0,0,0
1812544,56,27,1957,10,"female",194,40,15,1,2,0,0,1,2
1812566,25,22,1988,1,"male",97,54,51,0,1,0,0,0,1
1812585,43,23,1970,2,"female",222,12,7,1,2,1,1,0,1
1812589,21,20,1992,9,"male",442,113,57,3,1,1,1,2,0
1812600,24,9,1989,10,"male",264,11,5,63,0,0,0,63,0
1812604,68,25,1945,4,"female",155,271,190,4,47,0,22,4,25
1812605,54,28,1959,11,"female",1692,52,28,325,320,274,210,51,110
1812607,33,3,1980,12,"male",286,8,8,9,2,9,2,0,0
1812617,14,10,1999,2,"male",355,202,103,176,12,176,11,0,1
1812634,61,20,1952,6,"male",1002,47,38,3,54,3,39,0,15
1812643,17,10,1996,9,"male",848,296,198,86,128,85,95,1,33
1812645,17,11,1996,1,"male",110,8,8,49,39,0,0,49,39
1812649,19,1,1994,1,"male",452,45,21,17,12,16,9,1,3
1812671,65,4,1948,3,"male",204,8,6,0,16,0,4,0,12
1812682,18,30,1995,8,"female",1937,1199,300,454,1386,431,725,23,661
1812683,43,17,1970,12,"male",52,27,26,6,5,6,3,0,2
1812706,38,21,1975,6,"male",148,19,13,0,0,0,0,0,0
1812707,74,14,1939,11,"male",1626,96,12,0,4,0,1,0,3
1812723,65,8,1948,6,"female",1382,54,29,30,9,30,9,0,0
1812758,52,10,1961,1,"female",118,28,21,20,17,20,13,0,4
1812768,64,12,1949,1,"male",447,41,18,2,2,2,2,0,0
1812784,108,20,1905,5,"male",880,318,211,627,47,627,39,0,8
1812792,58,15,1955,5,"male",1460,49,24,65,8,65,2,0,6
1812793,32,21,1981,2,"male",126,16,8,6,0,6,0,0,0
1812817,39,10,1974,7,"female",1751,373,169,8,174,8,167,0,7
1812827,64,25,1949,10,"female",918,66,34,135,35,0,1,135,34
1812858,24,15,1989,8,"male",78,33,25,1,1,1,1,0,0
1812862,17,6,1996,4,"male",204,124,106,1,1,1,1,0,0
1812884,16,2,1997,8,"male",442,304,267,3,0,3,0,0,0
1812933,63,3,1950,7,"female",1781,27,8,0,0,0,0,0,0
1812934,21,3,1992,1,"female",768,134,47,1,0,1,0,0,0
1812949,16,17,1997,7,"male",5,0,0,0,0,0,0,0,0
1813002,43,1,1970,6,"female",995,2564,1408,1963,2345,1920,1180,43,1165
1813010,63,25,1950,6,"female",1338,74,28,24,3,0,3,24,0
1813019,26,16,1987,9,"male",582,61,28,5,0,0,0,5,0
1813024,33,12,1980,2,"male",564,3,1,0,0,0,0,0,0
1813029,34,10,1979,8,"female",412,60,49,16,8,16,4,0,4
1813035,18,12,1995,8,"female",574,3179,1382,29,68,29,56,0,12
1813039,39,18,1974,11,"female",1597,315,42,74,39,74,24,0,15
1813058,14,30,1999,6,"female",147,244,155,54,105,10,71,44,34
1813067,51,31,1962,12,"male",612,33,20,4,3,4,3,0,0
1813077,18,2,1995,5,"male",804,3,2,0,0,0,0,0,0
1813088,80,28,1933,11,"male",101,22,20,1,1,1,1,0,0
1813091,58,14,1955,2,"female",598,82,50,58,41,58,29,0,12
1813096,24,25,1989,3,"male",39,49,44,267,144,267,142,0,2
1813100,19,15,1994,2,"female",322,326,266,23,28,2,5,21,23
1813101,23,9,1990,5,"female",371,114,48,26,47,26,28,0,19
1813111,23,10,1990,10,"male",486,284,151,51,110,3,18,48,92
1813124,29,5,1984,5,"male",430,250,107,6,11,6,11,0,0
1813133,18,4,1995,6,"male",229,302,211,10,29,9,12,1,17
1813135,22,3,1991,2,"male",398,239,213,0,7,0,3,0,4
1813144,41,29,1972,7,"female",502,0,0,0,0,0,0,0,0
1813174,30,13,1983,3,"female",497,15,2,2,0,1,0,1,0
1813182,31,22,1982,7,"male",182,16,11,0,0,0,0,0,0
1813194,14,10,1999,2,"female",952,2858,305,514,2133,451,1589,63,544
1813202,20,1,1993,8,"male",211,64,61,1,0,1,0,0,0
1813213,83,19,1930,10,"male",1653,100,39,0,0,0,0,0,0
1813217,20,5,1993,1,"male",326,49,43,0,0,0,0,0,0
1813227,25,10,1988,8,"male",518,134,109,0,44,0,16,0,28
1813254,31,15,1982,4,"female",542,24,10,34,19,34,2,0,17
1813262,42,22,1971,3,"female",467,15,9,0,3,0,2,0,1
1813330,48,27,1965,3,"male",1657,193,105,17,34,10,25,7,9
1813358,21,20,1992,9,"male",239,141,94,27,59,27,41,0,18
1813368,50,26,1963,2,"male",1094,66,48,0,0,0,0,0,0
1813420,29,26,1984,6,"male",633,65,21,33,122,33,92,0,30
1813473,32,11,1981,10,"male",700,71,63,0,0,0,0,0,0
1813481,20,26,1993,11,"male",159,0,0,0,0,0,0,0,0
1813482,19,25,1994,8,"female",177,56,38,849,1145,849,395,0,750
1813490,19,25,1994,9,"male",25,25,22,23,18,23,11,0,7
1813499,16,15,1997,8,"male",1371,112,77,0,1,0,0,0,1
1813548,36,23,1977,5,"female",316,186,104,19,17,19,16,0,1
1813551,32,27,1981,8,"male",92,21,13,16,32,16,29,0,3
1813571,103,21,1910,8,"male",1498,158,60,17,1,17,1,0,0
1813575,97,1,1916,1,"male",2243,61,42,6,20,6,7,0,13
1813585,25,25,1988,7,"female",977,228,176,43,62,43,43,0,19
1813646,36,22,1977,11,"female",197,46,31,288,1,0,0,288,1
1813664,21,19,1992,3,"male",501,13,6,0,0,0,0,0,0
1813667,19,3,1994,1,"male",678,61,22,3,5,3,3,0,2
1813671,102,31,1911,1,"female",950,105,88,124,2,0,0,124,2
1813673,108,23,1905,10,"female",66,2,2,2,3,1,1,1,2
1813679,103,14,1910,7,"male",2190,625,309,688,514,676,305,12,209
1813691,108,8,1905,7,"male",301,471,314,52,193,52,153,0,40
1813698,24,3,1989,2,"female",34,407,11,2,18,2,15,0,3
1813711,17,10,1996,8,"male",3,2,2,4,2,0,1,4,1
1813746,16,19,1997,6,"male",227,14,5,93,5,1,4,92,1
1813756,14,24,1999,4,"female",265,262,136,24,61,6,41,18,20
1813764,21,13,1992,8,"female",1514,2190,734,38,275,38,218,0,57
1813783,56,30,1957,6,"male",161,17,13,0,0,0,0,0,0
1813795,35,1,1978,3,"male",656,143,88,29,49,28,19,1,30
1813812,73,1,1940,1,"male",592,11,8,4,0,0,0,4,0
1813815,51,7,1962,10,"male",971,19,3,2,2,2,2,0,0
1813831,16,23,1997,2,"female",392,118,61,4,0,4,0,0,0
1813910,18,12,1995,7,"male",120,30,16,54,30,1,4,53,26
1813918,64,12,1949,7,"female",1705,85,46,23,14,0,11,23,3
1813941,17,21,1996,9,"male",160,78,67,131,316,33,47,98,269
1813973,63,21,1950,11,"female",234,10,9,0,0,0,0,0,0
1813978,17,26,1996,6,"male",237,274,180,124,18,124,14,0,4
1814033,33,25,1980,12,"male",104,124,89,2505,691,2505,625,0,66
1814034,19,6,1994,12,"female",422,125,72,164,13,164,13,0,0
1814044,71,16,1942,1,"male",1953,411,192,271,114,203,58,68,56
1814062,40,19,1973,1,"male",552,13,1,0,0,0,0,0,0
1814093,62,30,1951,3,"male",1081,64,19,40,30,1,16,39,14
1814106,16,4,1997,12,"male",886,1185,886,0,18,0,11,0,7
1814176,100,16,1913,4,"male",733,645,471,426,311,426,218,0,93
1814181,25,4,1988,1,"male",18,27,26,59,18,26,13,33,5
1814207,16,1,1997,1,"male",412,6,6,0,0,0,0,0,0
1814260,19,6,1994,2,"male",364,167,127,0,0,0,0,0,0
1814310,108,31,1905,8,"male",2248,701,300,40,211,35,123,5,88
1814335,22,24,1991,1,"female",190,55,33,23,8,23,7,0,1
1814364,55,10,1958,2,"male",658,22,15,64,1,64,1,0,0
1814374,68,2,1945,7,"female",1920,13,6,35,47,0,20,35,27
1814383,23,6,1990,11,"male",433,79,44,6,14,6,8,0,6
1814389,23,15,1990,9,"female",237,151,88,103,18,3,13,100,5
1814417,19,22,1994,12,"male",811,234,152,12,9,12,7,0,2
1814427,24,8,1989,1,"male",797,194,177,0,23,0,12,0,11
1814458,36,14,1977,7,"female",615,317,204,25,5,25,5,0,0
1814476,67,18,1946,4,"male",597,33,18,0,0,0,0,0,0
1814493,58,6,1955,10,"male",251,79,64,6,8,0,4,6,4
1814494,14,8,1999,1,"female",238,147,16,13,7,13,7,0,0
1814507,18,1,1995,9,"female",572,207,134,44,62,44,36,0,26
1814513,24,3,1989,4,"male",211,1,0,0,0,0,0,0,0
1814529,57,23,1956,7,"male",617,209,46,140,113,0,46,140,67
1814546,64,13,1949,9,"female",1876,43,21,22,20,5,9,17,11
1814562,23,1,1990,6,"male",444,243,173,0,0,0,0,0,0
1814578,16,23,1997,1,"male",215,191,139,1,1,1,1,0,0
1814579,45,18,1968,5,"female",248,66,53,127,41,127,26,0,15
1814645,40,1,1973,11,"male",394,0,0,0,0,0,0,0,0
1814661,99,30,1914,6,"female",202,212,144,688,393,663,283,25,110
1814672,23,14,1990,6,"male",887,1139,890,14,247,14,219,0,28
1814680,45,22,1968,12,"female",369,86,65,53,19,6,14,47,5
1814697,20,26,1993,11,"female",215,55,23,47,74,7,7,40,67
1814702,29,4,1984,3,"male",597,40,17,0,0,0,0,0,0
1814728,16,8,1997,5,"male",310,183,128,881,17,881,17,0,0
1814765,25,1,1988,2,"female",549,52,41,2,9,2,5,0,4
1814778,65,18,1948,4,"female",1386,161,109,78,164,51,81,27,83
1814786,69,9,1944,4,"female",1376,33,17,142,1,142,0,0,1
1814816,18,25,1995,6,"male",519,342,229,13,88,13,22,0,66
1814854,18,5,1995,6,"male",317,257,178,75,7,75,7,0,0
1814872,40,1,1973,1,"female",369,1068,171,7,3,0,1,7,2
1814873,31,14,1982,2,"female",628,1,1,0,0,0,0,0,0
1814884,103,8,1910,9,"female",964,737,200,57,200,56,186,1,14
1814969,13,26,2000,1,"male",109,97,78,0,0,0,0,0,0
1814981,37,8,1976,1,"male",506,100,80,7,5,7,5,0,0
1815030,22,18,1991,8,"male",164,94,70,68,61,14,24,54,37
1815064,20,9,1993,8,"male",847,538,386,35,65,29,29,6,36
1815097,25,5,1988,9,"female",273,2332,1849,6135,4952,6029,4547,106,405
1815118,33,1,1980,6,"female",422,14,7,0,0,0,0,0,0
1815136,25,6,1988,4,"female",293,113,74,261,267,209,133,52,134
1815148,49,23,1964,12,"male",662,54,28,107,23,105,9,2,14
1815151,42,22,1971,4,"female",205,5,4,0,7,0,7,0,0
1815162,57,5,1956,1,"male",254,17,13,0,0,0,0,0,0
1815174,21,8,1992,4,"female",555,419,137,180,76,167,53,13,23
1815178,63,6,1950,4,"female",545,129,114,110,10,66,2,44,8
1815200,33,3,1980,2,"male",303,508,428,8,5,8,4,0,1
1815226,43,1,1970,1,"male",341,4,2,2,5,2,1,0,4
1815263,108,19,1905,7,"male",2067,111,60,42,11,42,10,0,1
1815271,18,8,1995,6,"female",175,332,285,15,87,15,81,0,6
1815289,24,25,1989,5,"female",719,153,56,7,0,7,0,0,0
1815310,61,4,1952,1,"female",195,45,23,90,81,90,67,0,14
1815322,32,12,1981,5,"male",173,44,41,131,1,131,0,0,1
1815405,53,3,1960,1,"male",57,20,6,282,126,1,86,281,40
1815444,14,1,1999,1,"male",378,142,100,1,1,1,0,0,1
1815453,29,22,1984,5,"female",829,1570,1030,13692,3114,12639,2010,1053,1104
1815463,41,2,1972,11,"male",452,5,4,0,0,0,0,0,0
1815486,16,24,1997,2,"male",855,229,81,3,2,2,0,1,2
1815503,28,19,1985,5,"male",561,284,199,99,42,54,33,45,9
1815509,19,28,1994,5,"male",1085,263,105,48,25,47,12,1,13
1815530,23,12,1990,12,"male",305,33,25,13,0,13,0,0,0
1815535,13,8,2000,8,"male",58,71,59,584,35,0,9,584,26
1815610,16,16,1997,5,"male",530,267,218,0,1,0,1,0,0
1815616,23,10,1990,1,"male",870,43,29,112,12,112,6,0,6
1815619,23,28,1990,6,"male",349,95,64,9,0,9,0,0,0
1815620,29,18,1984,5,"male",385,32,24,0,0,0,0,0,0
1815628,89,29,1924,12,"male",2530,174,47,9,4,0,0,9,4
1815638,33,20,1980,10,"male",144,0,0,1,0,1,0,0,0
1815700,33,11,1980,11,"male",835,121,52,194,35,179,18,15,17
1815701,50,17,1963,5,"female",948,112,45,70,32,70,17,0,15
1815703,52,6,1961,12,"female",557,47,15,4,51,4,26,0,25
1815722,16,13,1997,12,"male",412,69,22,2,4,0,1,2,3
1815731,29,28,1984,2,"male",205,205,138,5,1,5,1,0,0
1815748,52,3,1961,8,"female",208,34,25,42,7,42,7,0,0
1815784,29,2,1984,6,"male",171,27,20,11,0,11,0,0,0
1815803,17,21,1996,12,"female",249,367,234,101,263,63,180,38,83
1815810,58,28,1955,2,"male",81,22,18,0,0,0,0,0,0
1815812,46,21,1967,10,"male",1569,146,69,1,0,0,0,1,0
1815844,23,18,1990,5,"female",463,68,43,25,6,25,3,0,3
1815861,48,22,1965,7,"male",193,192,162,385,384,315,161,70,223
1815865,56,22,1957,12,"male",1256,26,16,0,2,0,2,0,0
1815874,24,28,1989,4,"female",68,69,43,6,19,6,8,0,11
1815882,58,1,1955,8,"female",780,49,41,63,6,63,4,0,2
1815901,16,16,1997,11,"female",270,356,242,113,203,6,94,107,109
1815934,52,12,1961,12,"female",1283,51,19,241,140,239,91,2,49
1815990,29,11,1984,6,"male",353,59,40,88,0,12,0,76,0
1816036,15,29,1998,7,"male",452,2241,1164,30,67,30,64,0,3
1816055,16,13,1997,10,"female",700,853,533,51,163,51,96,0,67
1816075,32,23,1981,1,"male",871,26,19,3,11,0,6,3,5
1816088,31,1,1982,8,"male",519,20,1,1,0,0,0,1,0
1816137,31,10,1982,4,"male",1171,14,14,5,0,0,0,5,0
1816147,67,15,1946,4,"male",851,54,38,0,0,0,0,0,0
1816160,72,7,1941,6,"male",787,43,4,0,0,0,0,0,0
1816191,56,18,1957,3,"female",1829,172,77,71,132,6,64,65,68
1816206,39,14,1974,10,"male",819,44,20,0,0,0,0,0,0
1816211,28,13,1985,3,"male",366,73,52,0,21,0,10,0,11
1816213,58,11,1955,11,"female",486,191,140,35,18,0,3,35,15
1816215,23,30,1990,12,"male",1072,147,42,0,0,0,0,0,0
1816221,24,1,1989,1,"male",88,32,30,0,0,0,0,0,0
1816226,15,3,1998,11,"female",320,61,32,31,15,29,6,2,9
1816249,19,1,1994,7,"male",137,27,14,0,0,0,0,0,0
1816268,21,20,1992,2,"female",153,182,86,14,10,14,8,0,2
1816299,67,17,1946,7,"male",1706,45,13,0,0,0,0,0,0
1816300,17,21,1996,3,"male",360,159,125,6,4,2,1,4,3
1816311,44,26,1969,10,"male",625,43,27,24,9,24,9,0,0
1816337,17,1,1996,5,"male",31,14,11,6,9,6,8,0,1
1816346,23,26,1990,5,"female",134,128,66,136,186,38,96,98,90
1816380,16,4,1997,3,"male",641,469,370,3,474,3,407,0,67
1816404,14,16,1999,10,"male",363,172,113,4,20,0,4,4,16
1816409,61,23,1952,2,"female",194,40,21,0,1,0,1,0,0
1816510,27,5,1986,4,"female",216,42,18,2,0,2,0,0,0
1816512,65,11,1948,10,"male",730,17,8,0,0,0,0,0,0
1816523,18,4,1995,6,"male",15,36,28,179,39,179,19,0,20
1816562,30,14,1983,10,"male",665,42,16,1,1,1,1,0,0
1816575,18,9,1995,10,"male",183,45,36,0,2,0,2,0,0
1816576,19,14,1994,8,"male",756,205,190,0,10,0,3,0,7
1816592,32,1,1981,2,"male",177,13,8,1,0,1,0,0,0
1816594,77,15,1936,1,"male",400,23,19,0,0,0,0,0,0
1816597,14,29,1999,7,"female",819,1293,675,2202,915,1201,314,1001,601
1816600,59,11,1954,5,"female",747,48,33,53,6,0,3,53,3
1816601,108,29,1905,11,"female",1191,268,102,54,64,54,48,0,16
1816616,56,12,1957,2,"female",290,63,8,45,2,45,1,0,1
1816624,100,2,1913,4,"male",1485,253,142,65,59,40,46,25,13
1816626,27,11,1986,6,"male",148,62,47,0,1,0,1,0,0
1816630,19,10,1994,10,"male",421,396,287,117,103,32,12,85,91
1816632,18,11,1995,11,"female",572,1022,766,5,26,5,12,0,14
1816662,82,20,1931,2,"female",353,53,27,69,20,69,8,0,12
1816664,23,10,1990,5,"male",60,77,67,70,54,70,40,0,14
1816707,51,30,1962,3,"female",89,57,40,8,100,6,83,2,17
1816710,31,21,1982,6,"female",605,161,108,6,18,6,15,0,3
1816713,23,23,1990,8,"male",744,151,75,270,70,270,48,0,22
1816765,37,11,1976,2,"male",387,47,35,0,0,0,0,0,0
1816766,22,18,1991,6,"male",394,300,205,11,2,11,1,0,1
1816768,107,1,1906,1,"male",1830,58,18,7,11,7,6,0,5
1816792,56,31,1957,10,"female",236,38,28,2,1,2,1,0,0
1816818,28,22,1985,6,"male",332,191,120,23,62,23,59,0,3
1816824,23,17,1990,12,"male",63,37,17,0,0,0,0,0,0
1816828,27,31,1986,3,"male",770,238,151,11,26,11,23,0,3
1816829,19,14,1994,1,"male",481,193,54,0,6,0,5,0,1
1816858,57,10,1956,9,NA,813,54,38,0,0,0,0,0,0
1816877,98,29,1915,10,"female",98,137,49,1853,1124,1853,880,0,244
1816970,15,17,1998,2,"male",481,169,144,6,1,6,1,0,0
1817042,25,2,1988,4,"male",3,6,6,6,0,6,0,0,0
1817043,21,4,1992,5,"male",633,218,116,1,2,1,2,0,0
1817047,19,7,1994,12,"male",364,510,423,27,21,26,15,1,6
1817064,14,3,1999,6,"female",419,233,173,1516,191,1493,82,23,109
1817078,68,7,1945,2,"female",1891,212,168,1845,362,0,67,1845,295
1817098,41,30,1972,7,"male",111,46,26,12,0,12,0,0,0
1817103,54,1,1959,2,"male",796,40,22,1,3,0,3,1,0
1817117,108,22,1905,10,"male",1020,131,113,0,0,0,0,0,0
1817123,35,5,1978,1,"male",251,35,20,0,0,0,0,0,0
1817124,25,30,1988,5,"male",211,28,25,0,0,0,0,0,0
1817133,21,4,1992,12,"male",107,64,37,3,30,3,18,0,12
1817153,44,29,1969,11,"male",90,5,5,56,0,56,0,0,0
1817175,27,16,1986,3,"female",723,638,565,55,77,55,71,0,6
1817221,15,8,1998,2,"male",105,22,13,3,9,3,9,0,0
1817232,33,3,1980,3,"male",584,16,13,3,2,0,1,3,1
1817260,32,12,1981,11,"male",233,55,38,36,14,24,6,12,8
1817307,28,11,1985,7,"male",307,107,81,9,5,9,4,0,1
1817316,21,11,1992,1,"male",129,26,25,0,0,0,0,0,0
1817336,94,22,1919,1,"male",58,120,109,57,44,0,11,57,33
1817382,33,3,1980,9,"male",1225,125,25,0,7,0,7,0,0
1817391,52,24,1961,2,"female",1758,65,31,15,17,15,13,0,4
1817405,66,23,1947,12,"female",1773,52,7,19,5,0,2,19,3
1817407,19,9,1994,8,"male",397,98,54,7,13,6,7,1,6
1817455,103,29,1910,1,"male",331,191,173,0,1,0,0,0,1
1817457,21,29,1992,12,"male",44,6,5,0,0,0,0,0,0
1817488,16,19,1997,5,"female",712,158,61,14,2,14,2,0,0
1817503,103,9,1910,4,"male",1572,480,346,197,60,175,45,22,15
1817519,20,1,1993,1,"female",391,119,52,32,14,32,11,0,3
1817539,16,22,1997,12,"male",395,13,13,13,0,0,0,13,0
1817577,50,4,1963,1,"male",1568,159,58,169,361,34,114,135,247
1817586,32,14,1981,12,"female",273,37,7,31,21,29,11,2,10
1817592,27,15,1986,9,"male",1099,168,141,0,2,0,2,0,0
1817628,17,2,1996,11,"male",1174,1974,1111,203,739,32,221,171,518
1817636,34,5,1979,7,"male",225,162,132,835,340,835,222,0,118
1817639,23,15,1990,9,"female",404,39,23,44,21,44,17,0,4
1817648,57,11,1956,2,"female",164,31,26,32,1,0,0,32,1
1817652,13,21,2000,6,"female",320,193,140,6,12,5,5,1,7
1817660,18,11,1995,10,"male",550,326,276,1,0,1,0,0,0
1817661,46,18,1967,10,"female",1663,312,62,212,569,86,274,126,295
1817666,17,13,1996,5,"male",244,79,73,1,0,1,0,0,0
1817676,67,25,1946,5,"male",361,56,44,4,6,3,5,1,1
1817683,54,2,1959,12,"female",764,16,7,67,208,44,135,23,73
1817725,36,7,1977,6,"female",354,24,13,122,48,122,15,0,33
1817740,23,14,1990,8,"male",183,66,31,65,33,65,15,0,18
1817771,39,19,1974,11,"female",780,94,53,243,58,13,33,230,25
1817821,47,24,1966,4,"female",574,81,41,19,18,19,13,0,5
1817832,20,29,1993,6,"male",453,312,183,4,10,4,7,0,3
1817902,19,8,1994,4,"male",506,114,58,2,1,2,1,0,0
1817915,25,17,1988,2,"female",450,20,15,3,0,1,0,2,0
1817922,30,5,1983,1,"male",326,137,133,224,34,195,32,29,2
1817937,21,15,1992,1,"male",237,43,40,0,0,0,0,0,0
1817957,25,13,1988,9,"male",251,23,16,33,38,0,2,33,36
1817961,36,28,1977,8,"female",260,98,84,2,8,0,2,2,6
1817965,113,1,1900,1,"male",1121,321,120,192,51,191,19,1,32
1817968,14,29,1999,12,"male",232,138,79,122,158,95,97,27,61
1817981,24,15,1989,11,"male",613,56,11,2,0,2,0,0,0
1818046,28,20,1985,1,"female",778,279,168,541,501,530,188,11,313
1818086,20,8,1993,7,"female",787,98,36,148,59,108,20,40,39
1818095,18,28,1995,4,"male",35,129,123,2,0,2,0,0,0
1818096,26,20,1987,8,"male",754,69,32,4,6,4,5,0,1
1818104,17,5,1996,6,"male",205,153,123,17,5,1,2,16,3
1818114,27,24,1986,12,"female",578,438,191,20,20,20,17,0,3
1818134,67,9,1946,11,"male",2100,269,86,5,13,0,9,5,4
1818149,26,20,1987,9,"male",41,1,1,15,1,15,1,0,0
1818169,22,15,1991,3,"female",233,48,21,29,17,29,11,0,6
1818173,28,18,1985,6,"male",77,14,11,2,8,2,2,0,6
1818181,32,29,1981,7,"female",671,28,17,208,62,208,27,0,35
1818187,52,27,1961,6,"female",1767,165,78,355,181,90,50,265,131
1818193,33,2,1980,1,"male",3,0,0,0,0,0,0,0,0
1818231,56,30,1957,10,"male",293,28,27,0,0,0,0,0,0
1818238,68,5,1945,12,"male",1813,30,6,2,0,1,0,1,0
1818246,13,1,2000,1,"male",607,384,198,218,124,218,94,0,30
1818284,31,21,1982,12,"male",919,252,164,102,5,93,1,9,4
1818301,35,22,1978,12,"male",300,0,0,0,0,0,0,0,0
1818313,18,12,1995,10,"male",52,410,398,145,111,72,41,73,70
1818353,100,12,1913,2,"male",1014,161,100,37,30,37,17,0,13
1818374,44,5,1969,5,"male",587,82,43,16,29,15,10,1,19
1818381,16,13,1997,10,"female",472,308,101,78,163,66,40,12,123
1818395,23,12,1990,5,"male",730,4,4,0,1,0,1,0,0
1818401,22,18,1991,1,"female",769,453,183,126,453,126,363,0,90
1818452,67,1,1946,7,"male",780,95,61,1,1,1,0,0,1
1818468,50,14,1963,11,"male",263,26,21,0,0,0,0,0,0
1818486,18,20,1995,7,"male",149,93,78,386,33,386,26,0,7
1818500,103,21,1910,4,"male",297,138,124,2,2,2,2,0,0
1818533,18,2,1995,1,"male",129,79,69,4,6,4,6,0,0
1818534,42,2,1971,6,"female",740,32,21,33,15,23,10,10,5
1818543,32,9,1981,9,"male",110,34,30,23,1,23,1,0,0
1818553,39,11,1974,11,"male",306,54,27,1,2,1,1,0,1
1818563,23,12,1990,9,"male",269,52,12,6,11,6,11,0,0
1818583,21,16,1992,1,"male",418,508,248,2035,987,1456,431,579,556
1818585,20,13,1993,8,"male",221,416,313,14,6,14,6,0,0
1818587,16,13,1997,10,"male",263,13,1,0,0,0,0,0,0
1818602,23,30,1990,12,"female",355,1252,33,6,226,6,134,0,92
1818634,36,12,1977,3,"male",323,117,95,0,1,0,1,0,0
1818642,24,6,1989,6,"male",1051,36,33,0,0,0,0,0,0
1818647,29,11,1984,8,"male",436,267,147,1,0,1,0,0,0
1818673,21,1,1992,3,"male",124,40,27,5628,230,3467,123,2161,107
1818718,55,5,1958,11,"female",290,4,2,1,0,1,0,0,0
1818731,82,29,1931,6,"male",1273,32,8,0,0,0,0,0,0
1818732,108,4,1905,5,"male",1840,186,89,8,20,0,6,8,14
1818754,108,25,1905,11,"male",1020,215,165,0,0,0,0,0,0
1818784,28,30,1985,12,"female",528,206,42,64,122,64,77,0,45
1818793,28,14,1985,5,"male",298,32,24,8,1,0,0,8,1
1818817,32,7,1981,7,"male",715,16,4,0,0,0,0,0,0
1818823,84,18,1929,5,"female",790,176,68,233,87,219,80,14,7
1818851,94,26,1919,2,"male",1277,248,149,37,36,4,12,33,24
1818853,27,17,1986,10,"female",439,33,18,0,0,0,0,0,0
1818856,54,22,1959,10,"male",144,44,43,4,0,4,0,0,0
1818905,85,17,1928,9,"female",1044,64,47,41,0,40,0,1,0
1818936,18,12,1995,2,"male",579,239,40,1,13,1,13,0,0
1818937,26,13,1987,7,"male",188,114,82,2,1,2,1,0,0
1819014,37,17,1976,7,"male",753,215,157,2,10,2,0,0,10
1819022,23,25,1990,1,"male",663,13,10,2,1,0,0,2,1
1819028,16,1,1997,1,"male",260,798,720,357,190,357,132,0,58
1819036,19,2,1994,4,"male",232,110,92,15,6,10,4,5,2
1819060,30,26,1983,1,"male",507,606,225,40,3,40,1,0,2
1819070,24,22,1989,10,"male",98,160,140,4,30,4,23,0,7
1819102,78,1,1935,8,"male",731,37,18,1,1,0,1,1,0
1819129,19,1,1994,1,"male",133,66,63,0,2,0,2,0,0
1819147,28,9,1985,6,"female",780,247,57,40,98,40,48,0,50
1819150,40,2,1973,8,"female",700,196,140,340,436,293,364,47,72
1819199,20,3,1993,2,"male",215,267,240,4,0,4,0,0,0
1819211,23,21,1990,3,"male",529,827,669,331,845,105,276,226,569
1819229,17,29,1996,7,"female",283,56,40,101,38,101,24,0,14
1819334,22,1,1991,12,"male",388,52,41,3,0,3,0,0,0
1819341,108,16,1905,6,"male",1711,1393,1052,201,165,201,108,0,57
1819354,24,15,1989,8,"male",400,30,14,0,1,0,0,0,1
1819383,25,12,1988,3,"female",319,22,9,13,43,1,19,12,24
1819386,25,1,1988,1,"female",171,0,0,0,0,0,0,0,0
1819395,18,6,1995,8,"female",199,99,80,4,33,4,27,0,6
1819407,25,15,1988,7,"male",886,224,168,3,4,3,1,0,3
1819422,72,28,1941,2,"male",1132,26,21,12,9,0,2,12,7
1819434,20,10,1993,6,"male",351,56,36,0,0,0,0,0,0
1819458,24,19,1989,7,"male",253,48,23,15,16,0,9,15,7
1819497,50,2,1963,11,"female",509,38,24,8,2,4,1,4,1
1819514,16,10,1997,3,"male",182,36,33,2,0,0,0,2,0
1819524,15,17,1998,8,"male",661,0,0,0,0,0,0,0,0
1819529,21,6,1992,2,"female",309,21,8,12,0,1,0,11,0
1819539,32,2,1981,11,"female",427,21,4,16,10,0,8,16,2
1819543,51,24,1962,11,"female",731,263,159,180,512,180,412,0,100
1819563,32,2,1981,9,"male",604,105,60,51,15,28,4,23,11
1819581,35,31,1978,10,"female",791,151,109,309,271,103,110,206,161
1819584,27,21,1986,11,"female",384,98,63,55,54,55,39,0,15
1819586,21,10,1992,2,"male",105,28,24,50,337,50,317,0,20
1819593,17,28,1996,8,"female",485,603,530,37,0,9,0,28,0
1819594,93,9,1920,8,"female",1467,140,78,235,222,235,182,0,40
1819595,31,7,1982,1,"female",606,139,71,14,128,14,61,0,67
1819610,108,4,1905,2,"male",1600,213,133,78,112,13,32,65,80
1819633,27,10,1986,2,"female",607,13,13,3,5,3,5,0,0
1819653,15,24,1998,9,"female",419,1584,1368,6,9,1,8,5,1
1819662,21,13,1992,9,"female",266,25,14,138,6,138,4,0,2
1819740,46,4,1967,9,"female",107,24,16,849,578,849,480,0,98
1819772,22,15,1991,7,"female",1340,468,257,765,904,728,691,37,213
1819812,18,28,1995,1,"female",645,2245,462,765,1069,390,517,375,552
1819819,19,23,1994,11,"male",259,500,433,157,72,157,66,0,6
1819820,27,1,1986,1,"male",394,6,3,1,0,1,0,0,0
1819841,16,1,1997,6,"female",366,289,206,178,170,144,97,34,73
1819844,46,23,1967,6,"female",1406,642,235,825,534,465,322,360,212
1819903,19,30,1994,11,"female",120,47,28,2,1,2,1,0,0
1819949,26,20,1987,9,"male",1229,439,309,12,40,12,32,0,8
1819962,16,26,1997,1,"female",287,175,139,23,12,23,11,0,1
1819973,22,20,1991,11,"female",312,45,35,4,0,4,0,0,0
1820030,103,17,1910,11,"female",2104,230,91,41,84,39,67,2,17
1820033,73,19,1940,6,"male",1086,57,21,0,0,0,0,0,0
1820036,60,14,1953,2,"female",884,302,206,67,320,0,130,67,190
1820119,25,12,1988,5,"male",277,128,37,304,6,304,5,0,1
1820135,25,3,1988,7,"male",623,86,69,24,53,24,50,0,3
1820146,22,11,1991,10,"male",389,97,65,3037,20,3037,8,0,12
1820188,17,8,1996,2,"female",382,182,88,168,60,168,25,0,35
1820205,20,22,1993,4,"male",537,124,77,150,21,150,9,0,12
1820214,25,3,1988,2,"male",439,97,57,16,201,16,153,0,48
1820217,19,14,1994,6,"female",712,253,106,13,53,13,48,0,5
1820236,43,25,1970,1,"male",1235,163,38,6,0,0,0,6,0
1820240,13,1,2000,2,"male",236,367,303,85,10,85,10,0,0
1820245,25,1,1988,1,"male",9,0,0,0,0,0,0,0,0
1820281,68,3,1945,12,"male",4,11,7,4,2,4,2,0,0
1820290,15,2,1998,5,"male",610,111,58,72,1,69,0,3,1
1820304,14,9,1999,9,"male",50,32,22,1,0,0,0,1,0
1820312,40,27,1973,2,"female",41,22,5,34,22,34,12,0,10
1820354,60,2,1953,4,"female",949,122,84,726,506,318,291,408,215
1820356,42,14,1971,12,"female",2203,357,238,435,482,250,299,185,183
1820361,21,17,1992,4,"female",536,16,9,13,10,11,6,2,4
1820372,51,13,1962,5,"female",1204,205,51,1037,1134,689,351,348,783
1820373,66,10,1947,1,"female",1579,192,108,31,12,26,6,5,6
1820374,30,10,1983,8,"female",168,34,25,68,0,68,0,0,0
1820404,50,6,1963,5,"male",101,60,30,174,26,174,19,0,7
1820414,18,31,1995,7,"male",571,115,104,55,0,0,0,55,0
1820422,43,23,1970,8,"male",92,34,31,13,9,0,4,13,5
1820435,32,10,1981,12,"male",759,29,25,0,2,0,2,0,0
1820446,19,13,1994,6,"male",203,77,51,0,1,0,0,0,1
1820447,17,3,1996,6,"male",490,135,132,11,14,11,12,0,2
1820448,16,2,1997,11,"male",420,81,42,84,45,84,36,0,9
1820452,33,30,1980,8,"female",76,38,29,1,3,1,1,0,2
1820463,21,3,1992,5,"female",93,45,41,53,25,10,4,43,21
1820465,23,25,1990,1,"male",223,16,15,0,0,0,0,0,0
1820477,23,10,1990,10,"male",680,42,25,1,0,1,0,0,0
1820503,20,23,1993,1,"female",257,0,0,848,1,848,0,0,1
1820520,30,24,1983,9,"male",118,136,106,7,1,7,1,0,0
1820536,27,22,1986,8,"female",559,129,64,4,4,4,4,0,0
1820545,30,20,1983,6,"male",282,167,154,0,0,0,0,0,0
1820568,23,5,1990,12,"male",168,7,5,4,2,3,2,1,0
1820571,43,10,1970,11,"male",141,1,0,4,0,4,0,0,0
1820578,56,3,1957,3,"male",989,89,21,216,819,166,489,50,330
1820599,21,29,1992,6,"male",248,608,489,790,305,790,244,0,61
1820601,32,22,1981,7,"male",51,2,0,0,0,0,0,0,0
1820605,20,10,1993,4,"female",453,0,0,0,0,0,0,0,0
1820610,103,5,1910,2,"male",1511,417,261,160,101,160,77,0,24
1820630,38,12,1975,8,"female",601,70,45,178,174,178,88,0,86
1820631,41,5,1972,1,"female",372,101,80,179,162,179,117,0,45
1820658,57,5,1956,2,"female",83,9,2,15,0,13,0,2,0
1820676,40,12,1973,9,"female",287,2,2,125,42,125,42,0,0
1820713,32,31,1981,10,"female",427,246,196,43,93,43,59,0,34
1820727,27,28,1986,11,"male",206,133,130,0,0,0,0,0,0
1820730,57,30,1956,9,"male",140,64,51,6,7,0,5,6,2
1820758,23,30,1990,11,"male",197,152,130,168,18,77,12,91,6
1820770,93,23,1920,11,"male",1789,60,24,16,3,0,1,16,2
1820850,14,1,1999,3,"male",289,154,103,8,1,5,0,3,1
1820872,20,1,1993,3,"male",477,131,67,0,6,0,4,0,2
1820894,14,11,1999,10,"female",478,146,74,433,259,357,127,76,132
1820901,33,26,1980,9,"male",564,81,70,0,2,0,1,0,1
1820905,34,12,1979,12,"female",798,19,8,0,0,0,0,0,0
1820912,90,3,1923,6,"female",1879,199,83,45,42,45,16,0,26
1821008,16,4,1997,4,"female",659,386,167,196,145,186,59,10,86
1821036,17,15,1996,3,"male",529,626,579,1,0,0,0,1,0
1821056,73,26,1940,6,"female",1740,442,291,35,14,23,9,12,5
1821084,21,18,1992,10,"female",387,1467,615,1771,1599,1771,1303,0,296
1821098,27,1,1986,11,"male",660,27,13,17,1,15,1,2,0
1821129,19,18,1994,8,"female",422,73,44,1009,441,268,317,741,124
1821144,16,8,1997,7,"male",15,39,31,7,7,6,7,1,0
1821145,65,9,1948,7,"male",590,1,1,0,0,0,0,0,0
1821174,18,14,1995,9,"male",45,40,38,86,5,86,5,0,0
1821237,16,1,1997,1,"male",263,90,53,0,0,0,0,0,0
1821255,79,1,1934,12,"female",1377,233,78,13,101,13,73,0,28
1821301,17,12,1996,9,"male",113,49,45,5,3,5,2,0,1
1821311,20,2,1993,6,"male",45,13,6,2,0,0,0,2,0
1821314,14,23,1999,6,"female",264,2,0,0,0,0,0,0,0
1821315,100,6,1913,4,"female",788,15,9,9,14,9,10,0,4
1821328,25,7,1988,8,"female",132,65,50,81,31,81,14,0,17
1821338,27,2,1986,9,"male",426,6,5,26,3,26,3,0,0
1821354,106,17,1907,9,"male",1062,133,67,79,61,0,26,79,35
1821402,41,7,1972,9,"male",1256,160,79,0,0,0,0,0,0
1821415,35,8,1978,11,"male",63,34,30,1,2,0,2,1,0
1821421,23,2,1990,12,"female",186,0,0,0,0,0,0,0,0
1821455,20,15,1993,5,"male",101,101,62,1,2,1,1,0,1
1821458,16,18,1997,11,"female",55,260,58,483,332,469,215,14,117
1821498,59,14,1954,3,"female",285,62,44,507,74,0,39,507,35
1821503,54,21,1959,1,"male",354,20,9,0,1,0,1,0,0
1821504,32,26,1981,4,"male",379,101,38,111,52,111,51,0,1
1821535,19,19,1994,6,"female",1689,1304,174,212,731,171,514,41,217
1821539,23,15,1990,8,"female",1068,525,206,1,6,0,2,1,4
1821546,24,23,1989,8,"female",288,432,185,81,191,4,102,77,89
1821567,43,2,1970,5,"male",382,40,32,0,28,0,12,0,16
1821599,41,24,1972,12,"female",177,1,0,0,0,0,0,0,0
1821608,24,10,1989,2,"male",242,212,118,38,15,0,5,38,10
1821613,63,1,1950,1,"male",82,350,208,31,134,28,86,3,48
1821662,27,16,1986,6,"female",106,7,3,0,0,0,0,0,0
1821680,100,6,1913,8,"female",1441,439,165,80,214,73,195,7,19
1821710,17,7,1996,9,"male",382,1,1,9,1,7,1,2,0
1821734,37,4,1976,4,"female",546,375,266,798,636,798,535,0,101
1821777,33,17,1980,3,"male",356,174,143,299,73,299,42,0,31
1821806,16,17,1997,1,"male",65,96,92,0,0,0,0,0,0
1821811,14,19,1999,11,"female",332,359,70,95,21,81,12,14,9
1821814,96,18,1917,6,"female",1154,21,10,1,25,0,24,1,1
1821895,55,2,1958,1,"male",700,287,106,10,0,10,0,0,0
1821917,45,9,1968,5,"male",259,34,30,0,4,0,4,0,0
1821948,60,12,1953,6,"female",873,27,11,315,39,315,20,0,19
1821965,26,1,1987,1,"female",313,29,13,95,26,95,22,0,4
1821970,33,3,1980,11,"female",508,13,7,162,18,0,2,162,16
1821989,61,20,1952,8,"male",271,21,17,187,97,14,32,173,65
1822004,21,18,1992,8,"male",87,14,10,0,2,0,0,0,2
1822029,24,18,1989,3,"female",536,78,29,89,163,89,132,0,31
1822030,45,15,1968,10,"male",49,43,39,37,22,37,20,0,2
1822081,44,25,1969,12,"female",227,48,31,1,9,1,7,0,2
1822105,25,1,1988,1,"female",289,48,19,26,15,26,13,0,2
1822110,51,14,1962,10,"female",344,173,49,2231,2233,2231,1939,0,294
1822117,49,11,1964,3,"female",1660,362,117,54,195,45,133,9,62
1822139,24,22,1989,11,"male",450,36,18,0,0,0,0,0,0
1822166,16,15,1997,2,"female",498,108,63,45,7,43,5,2,2
1822179,64,10,1949,6,"female",1833,109,42,0,0,0,0,0,0
1822186,26,2,1987,1,"male",223,32,28,0,0,0,0,0,0
1822237,32,26,1981,8,"male",531,93,63,43,42,43,41,0,1
1822240,50,19,1963,11,"female",595,4,3,4,0,4,0,0,0
1822246,18,21,1995,10,"female",474,35,24,3,33,0,10,3,23
1822247,59,22,1954,2,"male",51,46,43,75,9,75,8,0,1
1822297,26,1,1987,1,"male",230,76,66,442,39,442,27,0,12
1822334,66,23,1947,12,"male",581,5,5,0,0,0,0,0,0
1822393,37,8,1976,9,"male",38,10,10,13,0,3,0,10,0
1822445,21,25,1992,6,"male",334,306,189,1,0,1,0,0,0
1822447,108,25,1905,5,"male",1278,520,409,29,26,0,5,29,21
1822451,28,5,1985,5,"male",196,60,50,1,0,1,0,0,0
1822463,21,22,1992,5,"male",20,17,15,1,0,1,0,0,0
1822470,108,10,1905,2,"female",1010,92,40,465,865,465,742,0,123
1822493,14,28,1999,10,"male",786,7,3,0,0,0,0,0,0
1822495,89,19,1924,2,"male",470,338,253,108,100,108,90,0,10
1822520,47,2,1966,2,"male",178,11,6,0,0,0,0,0,0
1822531,40,12,1973,2,"male",307,60,48,6,1,4,1,2,0
1822533,23,2,1990,4,"male",26,76,51,1,3,1,3,0,0
1822542,44,22,1969,10,"male",235,150,99,54,23,54,21,0,2
1822599,47,27,1966,7,"male",812,60,42,0,5,0,2,0,3
1822611,38,12,1975,12,"male",1104,19,15,0,0,0,0,0,0
1822631,22,10,1991,4,"female",561,15,10,2,6,2,5,0,1
1822647,19,6,1994,12,"male",575,315,224,0,1,0,1,0,0
1822670,58,22,1955,12,"female",1468,323,201,1120,3003,155,2103,965,900
1822696,17,8,1996,1,"male",291,11,8,0,1,0,1,0,0
1822701,48,13,1965,8,"male",391,53,45,194,20,194,18,0,2
1822709,16,5,1997,6,"female",678,787,191,72,0,42,0,30,0
1822711,21,26,1992,12,"female",549,1098,368,856,173,499,43,357,130
1822738,71,13,1942,9,"male",1862,45,7,3,0,1,0,2,0
1822794,54,12,1959,5,"male",435,41,28,41,15,0,0,41,15
1822848,22,28,1991,6,"male",158,17,7,0,0,0,0,0,0
1822871,55,18,1958,5,"female",257,11,10,0,0,0,0,0,0
1822881,58,16,1955,11,"female",190,21,17,28,2,0,0,28,2
1822889,61,1,1952,1,"male",1064,43,21,5,3,0,1,5,2
1822897,18,5,1995,5,"female",702,370,105,62,52,22,41,40,11
1822917,19,1,1994,1,"female",234,3,3,0,0,0,0,0,0
1822928,17,1,1996,1,"male",639,27,6,3,5,3,0,0,5
1822930,74,19,1939,11,"female",1047,34,28,26,8,0,2,26,6
1822937,29,20,1984,1,"male",645,151,105,20,7,4,5,16,2
1822956,15,12,1998,11,"male",511,1036,901,289,406,289,335,0,71
1822960,27,9,1986,7,"male",779,899,807,7,0,7,0,0,0
1822971,22,5,1991,8,"male",7,27,20,5,4,4,2,1,2
1822982,22,22,1991,7,"male",371,57,47,16,0,16,0,0,0
1823009,17,19,1996,5,"female",98,402,273,2336,2447,1943,2046,393,401
1823013,31,3,1982,2,"male",180,250,175,16,193,16,113,0,80
1823015,34,29,1979,1,"male",323,37,24,0,1,0,1,0,0
1823016,22,30,1991,8,"male",507,263,211,3,17,3,15,0,2
1823020,33,19,1980,5,"female",1777,660,306,967,632,958,417,9,215
1823050,40,12,1973,3,"male",240,100,43,27,22,0,10,27,12
1823055,23,25,1990,10,"male",81,18,14,111,15,111,13,0,2
1823059,28,2,1985,12,"female",489,148,61,165,265,15,118,150,147
1823061,58,12,1955,7,"female",1404,178,121,791,309,688,223,103,86
1823075,23,1,1990,1,"male",450,137,123,0,1,0,1,0,0
1823090,51,14,1962,10,"male",1079,36,16,25,45,23,27,2,18
1823099,19,6,1994,6,"male",240,23,16,12,1,12,1,0,0
1823100,19,17,1994,1,"female",369,1143,239,12,31,12,22,0,9
1823117,33,5,1980,3,"male",397,133,69,1,1,1,1,0,0
1823166,63,17,1950,6,"female",222,96,80,37,39,0,11,37,28
1823173,54,19,1959,6,"female",1218,986,303,1595,1644,23,214,1572,1430
1823218,34,1,1979,1,"female",142,9,6,16,10,0,4,16,6
1823253,30,24,1983,6,"female",255,10,10,0,0,0,0,0,0
1823289,29,5,1984,3,"male",357,229,168,9,15,9,8,0,7
1823292,23,18,1990,1,"male",1355,70,29,10,1,10,1,0,0
1823295,17,17,1996,10,"female",260,663,385,438,326,232,78,206,248
1823303,61,27,1952,12,"female",1446,2,1,0,0,0,0,0,0
1823305,24,16,1989,4,"female",198,207,87,423,952,418,515,5,437
1823342,48,18,1965,9,"female",70,40,32,16,3,14,2,2,1
1823378,52,4,1961,1,"male",412,168,154,1,13,1,8,0,5
1823401,43,25,1970,12,"male",324,1,1,0,0,0,0,0,0
1823403,26,12,1987,5,"male",724,153,88,60,4,49,3,11,1
1823415,18,7,1995,4,"male",192,1351,1316,336,117,334,76,2,41
1823439,23,30,1990,3,"male",1352,476,151,30,3,27,2,3,1
1823471,25,1,1988,1,"male",15,7,5,0,0,0,0,0,0
1823472,69,19,1944,1,"male",204,11,8,5,0,0,0,5,0
1823499,27,14,1986,4,"female",102,30,28,0,0,0,0,0,0
1823500,20,14,1993,4,"female",625,291,153,67,53,67,47,0,6
1823506,18,18,1995,8,"male",492,108,55,1,22,1,15,0,7
1823509,80,23,1933,12,"male",536,10,8,0,0,0,0,0,0
1823535,32,1,1981,5,"female",536,164,111,6,29,1,17,5,12
1823539,25,30,1988,5,"male",194,27,8,0,0,0,0,0,0
1823544,45,30,1968,5,"male",222,11,8,0,0,0,0,0,0
1823571,108,22,1905,10,"male",1086,416,73,200,164,157,67,43,97
1823587,57,27,1956,3,"female",593,103,45,111,139,111,91,0,48
1823598,76,3,1937,7,"female",478,51,27,385,82,0,37,385,45
1823632,52,10,1961,9,"male",602,9,9,3,1,1,0,2,1
1823638,39,8,1974,9,"female",187,24,17,0,0,0,0,0,0
1823654,43,26,1970,9,"male",302,78,77,191,1,180,1,11,0
1823665,23,21,1990,3,"female",618,39,28,432,48,432,34,0,14
1823669,38,12,1975,2,"female",1123,72,45,3,3,0,0,3,3
1823684,32,14,1981,7,"female",1159,114,69,3228,590,3210,454,18,136
1823694,27,22,1986,1,"male",792,112,89,95,50,52,27,43,23
1823766,103,21,1910,8,"male",133,944,216,355,448,131,225,224,223
1823775,23,9,1990,9,"female",45,103,67,71,43,71,42,0,1
1823806,20,9,1993,12,"male",679,182,101,1,6,1,4,0,2
1823841,28,19,1985,2,"male",402,55,44,8,0,8,0,0,0
1823867,62,7,1951,4,"female",1895,69,25,6,31,0,4,6,27
1823872,25,9,1988,3,"male",461,16,2,0,0,0,0,0,0
1823878,73,29,1940,6,"female",1526,100,78,104,12,104,11,0,1
1823887,21,19,1992,1,"female",1376,740,466,236,92,206,57,30,35
1823910,19,2,1994,10,"male",652,62,35,8,0,7,0,1,0
1823923,18,1,1995,1,"male",261,48,34,59,51,59,46,0,5
1823944,53,10,1960,12,"male",224,72,48,19,6,0,4,19,2
1823945,108,1,1905,1,"male",1656,461,245,224,217,196,66,28,151
1823948,44,17,1969,7,"male",486,11,9,0,0,0,0,0,0
1823954,27,15,1986,11,"female",492,48,39,0,2,0,2,0,0
1823982,45,4,1968,9,"male",989,64,36,6,8,2,8,4,0
1824005,76,25,1937,12,"female",278,13,5,17,12,0,5,17,7
1824008,29,10,1984,4,"male",20,1,1,0,0,0,0,0,0
1824009,21,8,1992,9,"male",660,5,3,0,0,0,0,0,0
1824065,108,29,1905,12,"male",1970,374,258,8,38,7,32,1,6
1824067,16,24,1997,2,"male",447,187,85,379,223,316,99,63,124
1824076,70,10,1943,4,"male",760,383,298,111,56,0,38,111,18
1824079,15,20,1998,5,"female",366,473,241,71,58,22,14,49,44
1824080,20,4,1993,4,"male",342,507,433,31,101,31,90,0,11
1824104,24,22,1989,12,"male",401,155,108,0,0,0,0,0,0
1824115,25,20,1988,11,"male",13,5,5,2,0,2,0,0,0
1824133,33,5,1980,9,"female",227,98,59,22,2,22,1,0,1
1824177,19,14,1994,11,"female",243,310,48,12,23,12,22,0,1
1824180,28,19,1985,9,"female",413,81,56,64,188,64,188,0,0
1824183,55,4,1958,5,"male",548,148,74,260,108,0,58,260,50
1824192,34,14,1979,11,"male",14,1,1,0,0,0,0,0,0
1824276,43,22,1970,12,"male",232,31,12,17,163,0,37,17,126
1824287,71,9,1942,9,"female",1696,19,7,9,2,4,1,5,1
1824398,14,15,1999,4,"male",471,3,3,0,0,0,0,0,0
1824406,48,30,1965,3,"female",181,75,41,56,18,56,4,0,14
1824450,18,19,1995,4,"male",524,166,91,22,7,22,7,0,0
1824451,57,9,1956,9,"female",349,78,42,86,49,0,19,86,30
1824458,108,1,1905,4,"male",1535,528,321,50,142,26,57,24,85
1824461,29,22,1984,11,"female",493,29,20,0,1,0,0,0,1
1824465,66,3,1947,4,"male",722,53,16,2,0,0,0,2,0
1824490,86,6,1927,7,"female",403,120,104,23,4,0,3,23,1
1824514,46,5,1967,11,"female",67,26,16,4,3,1,2,3,1
1824525,63,4,1950,10,"female",1018,401,239,1501,375,332,90,1169,285
1824530,75,1,1938,6,"female",802,50,34,1174,2,1165,2,9,0
1824566,45,4,1968,5,"male",376,89,27,15,3,0,2,15,1
1824577,66,28,1947,6,"female",217,27,25,119,35,0,24,119,11
1824596,21,19,1992,1,"male",466,108,93,1,0,1,0,0,0
1824606,25,19,1988,9,"male",234,19,13,3,5,3,1,0,4
1824612,18,26,1995,1,"female",985,93,56,342,302,142,93,200,209
1824629,27,26,1986,12,"female",711,1208,363,1944,3130,1944,2870,0,260
1824641,25,22,1988,11,"male",540,33,27,0,8,0,3,0,5
1824660,51,3,1962,3,"male",37,0,0,0,0,0,0,0,0
1824679,16,31,1997,7,"female",584,371,104,424,642,418,374,6,268
1824700,48,24,1965,10,"female",955,17,7,10,13,4,2,6,11
1824709,28,4,1985,4,"male",1686,452,226,451,232,106,90,345,142
1824737,58,9,1955,2,"female",117,1,1,0,0,0,0,0,0
1824759,19,14,1994,12,"female",202,149,67,3,7,3,2,0,5
1824790,59,6,1954,7,"male",716,360,172,442,486,81,248,361,238
1824792,20,22,1993,3,"female",218,1,1,0,0,0,0,0,0
1824814,22,25,1991,3,"male",633,24,20,2,1,2,1,0,0
1824818,16,20,1997,2,"male",609,20,14,0,0,0,0,0,0
1824877,34,21,1979,11,"male",1789,114,67,0,0,0,0,0,0
1824878,22,25,1991,6,"female",369,14,7,17,9,9,3,8,6
1824880,21,10,1992,6,"male",266,27,22,43,58,43,55,0,3
1824912,17,1,1996,8,"female",263,92,77,0,0,0,0,0,0
1824916,18,22,1995,3,"male",537,175,75,23,27,23,24,0,3
1824931,36,16,1977,6,"female",271,83,44,23,118,16,86,7,32
1824940,30,10,1983,10,"male",91,4,2,2,1,2,1,0,0
1824951,35,7,1978,6,"male",410,57,17,0,1,0,0,0,1
1824962,57,8,1956,9,"female",733,19,15,3,0,3,0,0,0
1824964,23,31,1990,8,"male",835,183,68,0,1,0,0,0,1
1825027,18,8,1995,7,"male",544,133,54,43,21,15,8,28,13
1825029,21,16,1992,7,"female",455,145,70,469,225,455,166,14,59
1825033,28,26,1985,7,"male",300,123,57,0,1,0,0,0,1
1825043,17,11,1996,8,"female",285,23,11,5,0,0,0,5,0
1825044,27,21,1986,4,"female",245,122,67,34,22,34,22,0,0
1825052,17,15,1996,6,"male",321,29,24,1,1,1,1,0,0
1825055,30,7,1983,2,"female",79,10,10,1,1,1,1,0,0
1825066,16,5,1997,5,"female",215,134,28,3,2,1,0,2,2
1825089,103,28,1910,10,"male",1253,411,131,167,352,29,163,138,189
1825101,28,9,1985,11,"male",60,16,16,568,11,313,0,255,11
1825138,46,30,1967,3,"male",587,28,14,19,0,3,0,16,0
1825140,24,31,1989,1,"female",76,26,15,0,6,0,4,0,2
1825177,37,19,1976,4,"male",315,50,40,9,3,9,3,0,0
1825192,18,13,1995,1,"male",215,277,234,151,43,89,31,62,12
1825214,23,28,1990,9,"female",467,139,98,78,29,53,14,25,15
1825240,29,1,1984,1,"male",42,49,29,8,24,8,7,0,17
1825245,54,29,1959,11,"male",429,29,19,121,44,120,23,1,21
1825300,69,22,1944,7,"female",462,112,72,380,378,0,93,380,285
1825310,41,2,1972,5,"male",929,85,48,0,0,0,0,0,0
1825338,28,5,1985,5,"female",145,59,15,299,127,299,124,0,3
1825356,34,17,1979,10,"male",113,40,33,4,1,4,1,0,0
1825388,20,6,1993,4,"female",318,1276,841,1483,1037,284,217,1199,820
1825389,47,10,1966,8,"male",184,74,48,2006,187,2006,170,0,17
1825393,59,1,1954,7,"male",433,7,3,2,8,0,4,2,4
1825396,61,23,1952,10,"female",1336,200,139,39,126,0,56,39,70
1825400,17,26,1996,1,"female",290,29,17,443,838,346,489,97,349
1825416,20,8,1993,12,"male",116,9,6,0,0,0,0,0,0
1825422,34,11,1979,11,"male",1059,65,11,0,2,0,0,0,2
1825464,32,29,1981,1,"female",301,206,143,14,54,14,21,0,33
1825469,21,9,1992,1,"male",435,264,178,49,2,13,0,36,2
1825490,20,28,1993,7,"male",274,184,78,13,21,13,17,0,4
1825514,26,1,1987,4,"male",504,72,39,0,0,0,0,0,0
1825521,34,10,1979,10,"male",575,59,21,1,0,1,0,0,0
1825556,70,16,1943,10,"female",676,24,16,199,32,29,30,170,2
1825613,21,10,1992,11,"male",605,187,152,17,0,17,0,0,0
1825618,13,10,2000,5,"female",55,65,52,7,18,7,13,0,5
1825619,83,12,1930,4,"male",1094,95,61,183,151,0,43,183,108
1825635,23,10,1990,12,"male",17,49,46,413,195,413,189,0,6
1825680,32,1,1981,10,"female",22,87,27,9,7,9,4,0,3
1825687,22,24,1991,1,"male",830,615,436,44,36,44,29,0,7
1825692,76,27,1937,7,"male",1393,42,23,2,10,1,6,1,4
1825740,37,4,1976,4,"male",926,51,28,0,3,0,1,0,2
1825795,18,30,1995,7,"female",438,154,78,27,0,27,0,0,0
1825800,21,23,1992,10,"female",415,389,245,83,201,83,191,0,10
1825821,84,17,1929,6,"female",1251,1138,612,3,77,3,25,0,52
1825882,23,1,1990,1,"female",184,86,27,26,28,26,27,0,1
1825886,34,14,1979,2,"male",388,201,82,3,2,3,2,0,0
1825908,13,27,2000,6,"female",7,18,12,1,1,0,0,1,1
1825935,103,24,1910,11,"male",920,460,131,30,45,30,29,0,16
1825938,36,11,1977,9,"male",312,24,21,4,7,4,6,0,1
1825944,20,13,1993,4,"female",720,380,200,120,5,120,4,0,1
1825953,50,20,1963,7,"male",416,47,38,11,40,1,14,10,26
1826003,17,25,1996,6,"male",262,148,131,22,2,0,1,22,1
1826007,15,24,1998,3,"female",1071,2111,860,3025,5183,533,2480,2492,2703
1826088,72,28,1941,10,"male",401,75,53,1037,519,0,56,1037,463
1826104,42,27,1971,10,"female",174,18,14,137,37,137,37,0,0
1826112,14,10,1999,12,"female",277,673,178,2190,2334,1588,1062,602,1272
1826165,26,3,1987,7,"female",126,126,39,198,220,198,208,0,12
1826176,26,3,1987,4,"female",396,74,48,1693,132,1693,72,0,60
1826222,52,17,1961,4,"male",529,97,55,4,1,4,1,0,0
1826225,23,3,1990,1,"female",196,151,50,38,28,38,17,0,11
1826231,62,21,1951,4,"female",1435,155,104,111,250,1,174,110,76
1826232,23,5,1990,5,"male",472,94,62,0,3,0,1,0,2
1826249,22,27,1991,6,"female",1957,133,50,748,581,205,305,543,276
1826265,36,27,1977,2,"female",210,21,16,1,0,0,0,1,0
1826280,108,28,1905,7,"male",2075,253,142,183,52,183,45,0,7
1826374,48,9,1965,2,"female",432,120,82,386,498,383,217,3,281
1826379,28,1,1985,1,"male",12,0,0,0,0,0,0,0,0
1826421,19,1,1994,10,"male",490,64,49,0,0,0,0,0,0
1826434,49,26,1964,3,"male",774,89,60,3,2,3,2,0,0
1826441,45,4,1968,10,"male",587,1,0,0,0,0,0,0,0
1826456,18,9,1995,3,"male",119,0,0,0,0,0,0,0,0
1826472,18,12,1995,4,"male",144,262,227,19,37,19,29,0,8
1826481,23,14,1990,6,"female",264,873,155,5,37,5,29,0,8
1826486,52,27,1961,10,"male",902,175,143,47,23,0,4,47,19
1826527,15,9,1998,7,"male",306,263,199,66,34,66,28,0,6
1826530,19,3,1994,4,"female",365,1,1,1,0,0,0,1,0
1826540,21,1,1992,2,"female",192,46,32,3,10,0,2,3,8
1826575,20,27,1993,9,"male",371,867,793,163,160,63,66,100,94
1826582,113,2,1900,9,NA,2278,240,136,21,5,3,3,18,2
1826588,33,11,1980,5,"male",157,61,46,6,11,6,9,0,2
1826603,32,1,1981,1,"female",452,183,169,0,2,0,2,0,0
1826625,22,21,1991,1,"male",176,132,111,1,0,0,0,1,0
1826656,54,14,1959,8,"female",730,200,146,24,38,15,26,9,12
1826660,19,17,1994,5,"female",583,532,357,237,173,223,150,14,23
1826670,23,4,1990,3,"female",268,0,0,0,0,0,0,0,0
1826677,28,31,1985,8,"female",1410,179,111,39,15,39,14,0,1
1826725,18,14,1995,7,"female",622,768,153,476,509,443,350,33,159
1826729,52,14,1961,1,"female",652,150,103,477,699,177,561,300,138
1826755,18,1,1995,1,"female",364,139,128,0,0,0,0,0,0
1826781,19,14,1994,6,"female",57,1,1,1,2,1,2,0,0
1826784,15,21,1998,1,"male",248,136,69,14,7,14,7,0,0
1826785,68,18,1945,3,"female",1190,260,86,312,139,312,124,0,15
1826791,32,22,1981,6,"male",248,61,47,16,61,16,10,0,51
1826794,53,5,1960,5,"female",381,125,40,21,11,2,5,19,6
1826853,23,5,1990,2,"male",176,76,30,3,5,3,5,0,0
1826874,23,16,1990,2,"male",465,77,64,3,0,3,0,0,0
1826887,73,15,1940,8,"female",216,22,13,1,11,0,7,1,4
1826888,23,23,1990,12,"male",375,164,112,5,1,5,0,0,1
1826909,103,30,1910,6,"male",1049,739,458,898,383,894,353,4,30
1826911,55,2,1958,5,"male",577,1,1,0,0,0,0,0,0
1826914,19,2,1994,5,"male",273,13,11,1,0,0,0,1,0
1826916,23,7,1990,6,"male",719,158,97,3,2,0,2,3,0
1826921,36,13,1977,7,"male",685,101,93,0,0,0,0,0,0
1826956,24,28,1989,7,"female",330,38,19,0,0,0,0,0,0
1826988,47,26,1966,3,"male",1503,17,11,27,4,23,4,4,0
1826991,61,19,1952,9,"female",481,866,394,223,639,66,221,157,418
1826992,50,8,1963,8,"female",520,125,75,1,4,1,3,0,1
1827006,18,6,1995,10,"male",97,54,44,2,4,2,2,0,2
1827009,58,13,1955,5,"female",1215,41,22,10,11,0,2,10,9
1827039,25,1,1988,1,"female",591,35,26,3,5,2,2,1,3
1827047,19,8,1994,6,"female",472,132,89,93,19,88,10,5,9
1827051,20,30,1993,7,"male",343,148,92,408,408,309,326,99,82
1827069,37,12,1976,4,"male",446,59,26,44,0,44,0,0,0
1827077,26,23,1987,3,"male",314,22,11,0,0,0,0,0,0
1827086,42,17,1971,9,"male",558,74,57,75,41,21,8,54,33
1827097,57,8,1956,11,"female",851,16,4,3,2,0,2,3,0
1827101,20,4,1993,11,"male",619,156,131,49,81,15,26,34,55
1827134,23,18,1990,12,"male",672,200,57,78,27,77,19,1,8
1827142,73,28,1940,1,"female",1173,20,8,22,0,0,0,22,0
1827148,15,7,1998,10,"female",49,15,10,42,1,42,1,0,0
1827288,22,24,1991,11,"female",305,75,34,629,202,629,89,0,113
1827295,19,13,1994,5,"female",263,307,150,6,0,2,0,4,0
1827357,49,30,1964,6,"male",369,108,89,88,7,88,4,0,3
1827358,14,10,1999,7,"female",378,182,56,31,8,6,1,25,7
1827392,70,19,1943,12,"female",443,24,16,0,0,0,0,0,0
1827465,107,22,1906,4,"male",1705,58,37,24,2,0,1,24,1
1827488,15,12,1998,7,"male",39,35,21,5,4,4,1,1,3
1827489,22,30,1991,11,"male",297,36,25,1,2,1,2,0,0
1827503,47,7,1966,3,"female",1526,436,211,1746,727,160,362,1586,365
1827504,84,30,1929,5,"male",851,33,25,3,1,3,1,0,0
1827518,57,9,1956,12,"male",1030,306,70,1,1,1,0,0,1
1827532,21,9,1992,1,"male",253,30,25,14,6,14,5,0,1
1827553,25,10,1988,11,"male",1379,34,18,0,0,0,0,0,0
1827562,36,4,1977,9,"male",379,15,8,1,0,1,0,0,0
1827564,77,27,1936,9,"male",1582,45,25,45,1,44,1,1,0
1827569,41,3,1972,3,"male",1907,171,43,0,5,0,3,0,2
1827573,20,5,1993,6,"male",802,43,36,0,0,0,0,0,0
1827596,28,21,1985,6,"male",328,1,1,36,8,36,5,0,3
1827602,21,1,1992,11,"male",479,436,336,34,87,15,47,19,40
1827647,31,14,1982,3,"female",280,39,26,329,28,86,1,243,27
1827648,24,18,1989,1,"male",287,25,14,3,3,3,1,0,2
1827654,25,6,1988,12,"male",357,5,3,3,0,3,0,0,0
1827655,60,30,1953,6,"female",1347,36,20,2,5,0,1,2,4
1827660,44,4,1969,6,"male",645,52,34,46,1,46,1,0,0
1827703,14,6,1999,4,"female",543,245,76,43,90,18,19,25,71
1827744,24,1,1989,1,"male",107,118,116,0,0,0,0,0,0
1827806,57,2,1956,9,"female",884,33,17,24,17,24,9,0,8
1827822,34,2,1979,12,"male",855,162,89,76,25,61,10,15,15
1827849,30,24,1983,3,"male",1005,49,27,0,4,0,0,0,4
1827860,18,15,1995,6,"female",595,626,480,37,34,37,29,0,5
1827870,48,13,1965,2,"male",427,61,50,0,0,0,0,0,0
1827876,25,1,1988,1,"female",167,2,2,0,0,0,0,0,0
1827911,67,6,1946,6,"female",376,46,43,9,18,1,2,8,16
1828006,36,18,1977,2,"female",32,14,7,2,6,2,2,0,4
1828020,23,10,1990,5,"female",460,109,53,0,1,0,1,0,0
1828025,30,11,1983,4,"male",264,3,0,46,2,38,1,8,1
1828031,65,28,1948,11,"male",861,175,30,0,0,0,0,0,0
1828039,18,26,1995,12,"male",420,224,125,1,4,1,4,0,0
1828064,55,18,1958,10,"male",575,768,661,159,61,34,42,125,19
1828088,18,4,1995,12,"male",345,820,728,43,2173,43,1325,0,848
1828092,32,11,1981,5,"male",521,371,114,47,15,0,6,47,9
1828109,23,18,1990,12,"male",322,138,83,6,48,0,27,6,21
1828111,58,27,1955,4,"male",948,182,29,114,80,113,58,1,22
1828113,77,1,1936,8,"male",125,23,11,1,0,0,0,1,0
1828148,15,20,1998,7,"male",315,354,153,343,957,111,392,232,565
1828181,47,30,1966,6,"male",617,21,9,34,25,23,9,11,16
1828228,95,28,1918,2,"male",1557,189,73,414,238,254,101,160,137
1828251,18,25,1995,4,"female",358,50,43,0,0,0,0,0,0
1828292,18,29,1995,12,"male",129,67,64,0,0,0,0,0,0
1828296,17,31,1996,1,"male",378,305,153,4,3,0,0,4,3
1828304,30,17,1983,12,"male",491,6,1,0,0,0,0,0,0
1828331,21,10,1992,5,"male",725,175,82,2,1,2,0,0,1
1828343,42,6,1971,10,"male",445,332,305,30,10,30,9,0,1
1828357,43,12,1970,12,"male",321,88,40,130,9,130,8,0,1
1828366,58,2,1955,10,"female",725,194,132,287,165,0,42,287,123
1828368,54,6,1959,10,"female",197,5,5,0,0,0,0,0,0
1828392,32,25,1981,9,"male",449,158,121,4,4,4,3,0,1
1828394,43,4,1970,3,"male",413,76,49,745,366,745,237,0,129
1828411,21,11,1992,9,"male",0,0,0,0,1,0,1,0,0
1828421,50,11,1963,2,"female",624,159,45,134,26,133,17,1,9
1828434,25,3,1988,4,"female",126,107,104,183,130,183,128,0,2
1828435,38,5,1975,12,"male",586,26,10,96,14,96,14,0,0
1828443,85,2,1928,12,"male",695,79,60,21,64,0,42,21,22
1828451,40,25,1973,11,"male",135,13,9,81,41,81,32,0,9
1828508,78,10,1935,4,"female",1691,4735,268,475,2677,423,1857,52,820
1828510,33,6,1980,1,"female",597,15,13,1,0,1,0,0,0
1828545,22,16,1991,9,"female",213,112,70,7,4,7,3,0,1
1828552,27,14,1986,9,"female",588,7,4,40,2,0,0,40,2
1828566,24,11,1989,10,"male",243,44,22,10,16,10,13,0,3
1828576,35,5,1978,12,"male",371,94,89,124,6,124,4,0,2
1828587,23,4,1990,11,"female",335,98,32,10,40,10,35,0,5
1828590,27,3,1986,5,"male",245,110,107,0,0,0,0,0,0
1828611,36,10,1977,5,"male",503,0,0,0,0,0,0,0,0
1828624,62,29,1951,8,"male",171,43,29,217,281,0,61,217,220
1828632,31,31,1982,1,"male",698,87,23,36,53,36,46,0,7
1828633,33,20,1980,2,"male",359,29,21,0,0,0,0,0,0
1828635,55,14,1958,10,"male",137,20,4,6,17,6,11,0,6
1828648,16,16,1997,5,"male",543,575,342,222,29,41,19,181,10
1828665,21,1,1992,1,"male",150,5,5,0,0,0,0,0,0
1828666,26,26,1987,4,"male",285,43,31,0,0,0,0,0,0
1828695,23,30,1990,11,"male",348,180,160,2,11,2,10,0,1
1828711,21,12,1992,7,"female",168,607,400,17,84,11,47,6,37
1828745,65,10,1948,11,"female",635,44,28,145,36,0,18,145,18
1828752,32,30,1981,9,"female",504,732,527,803,3328,611,1698,192,1630
1828754,26,14,1987,9,"female",554,15,9,0,0,0,0,0,0
1828758,22,15,1991,6,"male",181,36,26,74,28,74,22,0,6
1828778,81,16,1932,3,"female",485,58,38,65,22,0,5,65,17
1828808,83,10,1930,7,"male",887,521,226,369,237,253,160,116,77
1828845,20,11,1993,3,"female",120,62,52,24,38,24,33,0,5
1828907,65,26,1948,6,"female",1384,77,33,0,0,0,0,0,0
1828908,47,3,1966,6,"male",257,3,2,4,5,4,5,0,0
1828924,25,2,1988,7,"female",604,31,19,23,26,23,21,0,5
1828951,53,17,1960,9,"female",66,28,6,14,15,12,10,2,5
1828986,25,7,1988,1,"male",295,102,79,0,5,0,0,0,5
1828989,31,17,1982,10,"female",276,22,11,92,125,33,75,59,50
1829032,20,9,1993,1,"male",260,12,10,8,1,8,0,0,1
1829041,17,17,1996,1,"male",324,126,113,0,1,0,1,0,0
1829097,23,10,1990,8,"female",534,41,18,70,35,44,23,26,12
1829102,19,9,1994,7,"male",710,502,425,0,4,0,4,0,0
1829111,23,31,1990,3,"female",362,36,22,12,7,12,6,0,1
1829135,19,5,1994,3,"female",439,201,49,1,10,1,6,0,4
1829191,19,27,1994,11,"male",452,193,121,1,2,1,2,0,0
1829209,21,1,1992,1,"female",257,25,4,0,0,0,0,0,0
1829214,33,26,1980,3,"male",162,8,7,4,3,4,3,0,0
1829273,28,26,1985,11,"male",214,40,25,2,3,2,3,0,0
1829275,60,9,1953,7,"female",1525,143,87,151,63,141,23,10,40
1829300,18,25,1995,12,"female",539,53,29,1,0,1,0,0,0
1829311,33,28,1980,10,"male",390,23,15,4,1,4,1,0,0
1829348,57,8,1956,1,"male",352,100,81,10,5,0,3,10,2
1829349,37,26,1976,5,"female",264,2,1,0,0,0,0,0,0
1829360,31,11,1982,9,"female",199,2,2,4,0,4,0,0,0
1829367,25,2,1988,2,"male",18,12,11,1,12,1,11,0,1
1829383,58,28,1955,11,"female",556,58,49,153,23,137,17,16,6
1829386,20,20,1993,10,"male",330,281,144,5,0,5,0,0,0
1829387,18,24,1995,2,"male",207,75,46,2,12,2,11,0,1
1829404,49,13,1964,2,"female",1695,179,111,188,123,38,24,150,99
1829424,33,24,1980,6,"female",77,9,7,14,3,14,3,0,0
1829425,15,30,1998,7,"female",436,499,378,1,5,0,1,1,4
1829429,24,4,1989,3,"female",932,229,108,143,160,105,61,38,99
1829430,17,25,1996,7,"male",484,111,77,125,47,44,8,81,39
1829433,24,15,1989,11,"male",936,103,22,0,2,0,2,0,0
1829450,78,15,1935,9,"male",1479,139,51,170,179,170,165,0,14
1829550,94,10,1919,2,"female",2591,243,71,34,147,27,80,7,67
1829554,18,17,1995,1,"male",341,126,67,29,5,29,2,0,3
1829555,31,1,1982,1,"male",381,74,40,1,0,0,0,1,0
1829558,90,15,1923,4,"female",104,42,35,20,0,0,0,20,0
1829573,35,8,1978,7,"male",768,2,2,0,0,0,0,0,0
1829575,17,2,1996,2,"male",280,40,33,2,0,0,0,2,0
1829585,57,30,1956,9,"male",273,653,368,552,430,536,211,16,219
1829601,72,13,1941,9,"female",1287,191,81,2096,942,686,293,1410,649
1829631,55,9,1958,9,"female",1033,199,147,799,304,799,125,0,179
1829650,29,21,1984,4,"male",444,340,238,12,1,12,1,0,0
1829665,48,6,1965,10,"female",289,222,97,7,2,0,0,7,2
1829677,32,30,1981,7,"female",566,115,91,45,37,45,13,0,24
1829695,60,21,1953,8,"female",96,103,79,140,132,0,16,140,116
1829717,43,8,1970,2,"male",609,29,11,24,19,24,11,0,8
1829735,20,13,1993,1,"male",264,69,26,3,8,3,2,0,6
1829794,53,1,1960,1,"male",673,101,75,1,0,1,0,0,0
1829818,18,11,1995,7,"male",833,692,597,53,27,9,15,44,12
1829874,29,19,1984,2,"male",371,862,789,37,4,37,1,0,3
1829876,40,26,1973,3,"female",295,245,112,1016,657,982,120,34,537
1829884,21,1,1992,12,"female",1541,1497,852,1,1,1,0,0,1
1829893,50,1,1963,10,"male",314,55,29,11,3,0,2,11,1
1829897,15,20,1998,6,"female",343,263,140,23,4,23,0,0,4
1829939,65,8,1948,3,"female",95,18,11,10,1,9,1,1,0
1829977,38,21,1975,11,"female",432,93,55,0,0,0,0,0,0
1829981,32,16,1981,3,"male",102,50,22,11,4,11,4,0,0
1829982,31,14,1982,1,"male",487,184,87,5,0,0,0,5,0
1829983,113,30,1900,9,"female",1605,57,42,21,5,0,1,21,4
1830030,31,1,1982,6,"male",511,102,88,0,3,0,3,0,0
1830044,35,9,1978,9,"male",212,55,40,431,250,431,193,0,57
1830051,46,7,1967,8,"female",613,110,84,145,148,8,32,137,116
1830053,62,23,1951,12,"female",797,536,267,1274,596,46,264,1228,332
1830089,25,10,1988,2,"male",261,136,115,12,5,12,4,0,1
1830092,14,30,1999,3,"male",265,66,37,1,1,1,0,0,1
1830099,19,12,1994,12,"male",641,245,161,3,0,3,0,0,0
1830109,22,31,1991,12,"male",232,415,57,169,373,75,113,94,260
1830110,31,3,1982,3,"male",419,12,12,0,0,0,0,0,0
1830112,18,30,1995,7,"female",717,2123,713,1767,2623,1743,2197,24,426
1830188,65,7,1948,7,"female",671,53,32,159,224,0,65,159,159
1830212,64,23,1949,3,"female",830,107,14,1,18,0,4,1,14
1830226,14,14,1999,2,"female",419,470,157,32,4,10,2,22,2
1830228,19,1,1994,1,"male",747,589,430,98,174,98,157,0,17
1830243,57,28,1956,2,"male",1720,13,2,0,0,0,0,0,0
1830293,35,2,1978,7,"male",675,48,31,0,5,0,4,0,1
1830300,15,26,1998,8,"female",430,139,35,23,0,23,0,0,0
1830333,25,15,1988,9,"female",702,1323,120,4,659,4,534,0,125
1830334,21,14,1992,8,"male",169,170,143,4,11,4,9,0,2
1830342,14,18,1999,6,"male",251,365,222,38,32,38,31,0,1
1830426,43,24,1970,5,"male",393,24,19,0,0,0,0,0,0
1830479,16,29,1997,10,"male",133,30,19,20,13,9,6,11,7
1830555,53,16,1960,4,"male",1826,146,53,0,12,0,10,0,2
1830562,63,10,1950,6,"female",556,79,50,1693,163,1693,117,0,46
1830567,24,17,1989,11,"male",350,112,85,0,1,0,0,0,1
1830600,108,25,1905,1,"female",2040,579,291,39,0,39,0,0,0
1830612,20,25,1993,7,"female",465,240,65,90,59,90,46,0,13
1830620,68,7,1945,7,"male",1465,28,13,10,0,0,0,10,0
1830627,24,28,1989,7,"male",250,218,123,11,51,11,39,0,12
1830637,16,28,1997,8,"male",178,158,115,0,1,0,1,0,0
1830640,63,6,1950,10,"male",338,8,6,0,0,0,0,0,0
1830663,16,14,1997,8,"female",257,1227,850,1800,1223,1800,1100,0,123
1830695,18,14,1995,5,"male",100,31,19,0,0,0,0,0,0
1830706,16,23,1997,7,"female",104,161,124,1,1,0,1,1,0
1830776,51,24,1962,12,"male",219,24,18,61,28,61,25,0,3
1830798,20,28,1993,4,"male",1300,1570,928,11,30,5,19,6,11
1830800,30,3,1983,2,"female",462,114,61,0,4,0,4,0,0
1830832,30,21,1983,10,"female",1105,19,13,46,91,29,74,17,17
1830851,59,28,1954,12,"female",267,45,23,0,7,0,3,0,4
1830882,66,5,1947,9,"female",825,43,22,2,4,2,4,0,0
1830907,18,22,1995,12,"male",26,7,6,4,2,4,2,0,0
1830910,28,25,1985,4,"male",589,85,53,9,0,0,0,9,0
1830923,52,3,1961,6,"male",1526,41,9,0,4,0,0,0,4
1830935,32,14,1981,3,"male",26,13,9,4,4,2,0,2,4
1830957,39,15,1974,9,"male",347,61,25,12,13,12,11,0,2
1830961,34,19,1979,8,"male",340,320,307,1,2,1,1,0,1
1830970,32,7,1981,8,"male",157,15,12,2,5,2,0,0,5
1830971,18,15,1995,7,"male",114,21,17,6,5,6,2,0,3
1830976,26,3,1987,3,"male",286,131,122,10,6,10,0,0,6
1830978,33,29,1980,10,"female",2373,2870,2265,2097,4442,1989,2208,108,2234
1830984,51,13,1962,8,"female",1728,211,55,183,496,109,245,74,251
1831001,29,19,1984,4,"female",508,54,27,7,35,7,18,0,17
1831016,51,26,1962,4,"female",183,23,12,3,0,3,0,0,0
1831021,27,1,1986,1,"male",32,32,26,2,21,2,6,0,15
1831031,14,21,1999,10,"male",28,1,1,0,0,0,0,0,0
1831096,42,5,1971,11,"female",109,13,13,56,76,56,28,0,48
1831119,73,7,1940,11,"female",2197,299,193,4,4,4,4,0,0
1831122,55,6,1958,6,"male",74,61,61,2,0,2,0,0,0
1831130,20,29,1993,5,"male",229,16,14,413,246,210,91,203,155
1831143,26,3,1987,5,"female",250,53,41,3,3,3,1,0,2
1831144,21,1,1992,8,"male",13,3,2,0,0,0,0,0,0
1831147,16,16,1997,12,"male",685,1553,627,58,249,58,186,0,63
1831148,20,11,1993,2,"male",473,159,69,0,0,0,0,0,0
1831177,51,20,1962,8,"female",629,39,18,415,44,415,32,0,12
1831192,20,20,1993,2,"male",68,46,39,0,1,0,0,0,1
1831194,28,8,1985,3,"female",413,109,56,143,211,0,4,143,207
1831204,61,11,1952,11,"female",654,90,47,100,270,0,13,100,257
1831223,28,4,1985,8,"male",283,598,372,2179,235,2179,172,0,63
1831233,27,24,1986,3,"male",511,103,39,33,45,33,42,0,3
1831236,25,5,1988,2,"female",624,1626,441,1309,1130,1309,982,0,148
1831253,68,26,1945,10,"female",1911,143,65,5,19,0,3,5,16
1831273,29,28,1984,4,"male",100,28,20,24,8,24,5,0,3
1831286,35,2,1978,1,"male",416,30,20,5,0,5,0,0,0
1831296,103,2,1910,12,"male",1534,98,78,3,43,2,13,1,30
1831305,18,26,1995,1,"male",563,46,28,5,0,0,0,5,0
1831315,76,20,1937,3,"female",40,22,19,9,21,0,9,9,12
1831341,15,28,1998,2,"female",243,306,58,87,146,87,138,0,8
1831369,26,2,1987,10,"female",1521,749,410,285,281,247,187,38,94
1831413,23,5,1990,10,"male",640,247,221,656,21,654,10,2,11
1831418,23,11,1990,9,"male",408,100,66,0,1,0,1,0,0
1831423,20,20,1993,9,"female",788,4540,2145,1169,482,1169,375,0,107
1831424,65,23,1948,7,"male",327,63,21,0,0,0,0,0,0
1831481,73,15,1940,8,"female",1468,100,41,1,5,0,3,1,2
1831487,25,10,1988,1,"male",131,74,22,7,40,7,21,0,19
1831509,24,20,1989,5,"male",646,136,121,0,0,0,0,0,0
1831548,38,25,1975,1,"male",494,99,70,18,8,18,8,0,0
1831549,17,1,1996,1,"male",110,23,23,15,7,15,7,0,0
1831557,86,19,1927,5,"female",816,122,57,6,11,0,2,6,9
1831558,13,6,2000,6,"female",79,179,146,117,43,46,21,71,22
1831573,21,22,1992,8,"male",415,193,111,134,74,134,67,0,7
1831594,20,10,1993,3,"male",317,18,9,102,9,0,1,102,8
1831620,18,20,1995,4,"female",442,479,204,805,490,630,324,175,166
1831641,23,29,1990,4,"male",67,10,10,37,1,0,0,37,1
1831649,34,4,1979,4,"male",1044,176,113,15,7,10,2,5,5
1831657,16,20,1997,8,"male",335,190,89,38,0,38,0,0,0
1831669,32,16,1981,1,"male",1634,255,122,2,1,1,0,1,1
1831674,19,21,1994,2,"male",497,812,624,2581,2674,1142,1026,1439,1648
1831689,55,24,1958,3,"male",999,413,358,1,16,1,14,0,2
1831723,31,15,1982,4,"male",34,63,50,79,28,56,15,23,13
1831762,96,11,1917,10,"female",2063,311,201,278,61,213,38,65,23
1831783,28,19,1985,1,"female",408,201,174,9,6,0,2,9,4
1831791,17,11,1996,4,"male",199,28,15,3,0,0,0,3,0
1831794,13,24,2000,3,"male",212,365,321,94,75,75,37,19,38
1831820,22,27,1991,3,"female",628,127,82,1566,1194,690,169,876,1025
1831885,19,3,1994,3,"male",450,93,49,21,0,0,0,21,0
1831904,25,27,1988,5,"male",436,159,75,133,160,133,109,0,51
1831930,71,6,1942,10,"female",1143,54,23,2,4,2,0,0,4
1831946,91,15,1922,2,"male",165,44,32,1,0,0,0,1,0
1831950,17,11,1996,8,"female",64,192,165,29,79,2,4,27,75
1831973,64,25,1949,4,"female",1807,75,16,92,28,92,21,0,7
1831985,25,2,1988,2,"female",382,84,51,45,15,45,10,0,5
1831989,23,19,1990,5,"male",183,3,1,0,0,0,0,0,0
1832000,21,19,1992,9,"male",174,21,10,0,10,0,4,0,6
1832034,35,21,1978,5,"female",796,23,11,4,0,4,0,0,0
1832098,27,21,1986,10,"female",393,129,74,0,3,0,1,0,2
1832103,108,1,1905,1,"male",583,1,0,0,0,0,0,0,0
1832109,23,2,1990,1,"female",352,10,10,0,0,0,0,0,0
1832115,39,9,1974,6,"male",216,8,3,6,3,0,2,6,1
1832118,20,6,1993,3,"male",769,182,137,0,0,0,0,0,0
1832123,19,7,1994,12,"male",399,40,22,0,0,0,0,0,0
1832152,56,25,1957,7,"male",307,100,62,13,29,13,15,0,14
1832186,19,19,1994,7,"female",306,169,84,38,15,38,6,0,9
1832187,21,8,1992,6,"male",425,99,51,7,28,7,27,0,1
1832192,20,19,1993,3,"male",265,54,37,34,5,34,5,0,0
1832218,23,1,1990,1,"male",456,13,7,1,0,1,0,0,0
1832235,34,11,1979,9,"female",522,78,28,24,0,24,0,0,0
1832280,42,27,1971,9,"male",319,341,327,33,7,14,2,19,5
1832283,74,24,1939,9,"female",292,26,5,3,6,3,4,0,2
1832374,70,20,1943,2,"male",1152,51,24,1,1,0,1,1,0
1832378,35,7,1978,9,"male",78,26,14,0,1,0,0,0,1
1832381,49,10,1964,10,"female",331,120,100,426,24,0,11,426,13
1832407,14,20,1999,4,"male",136,17,11,7,81,7,15,0,66
1832456,65,16,1948,3,"female",1382,38,20,73,28,30,17,43,11
1832474,19,19,1994,4,"female",1332,2258,1245,450,1437,142,1063,308,374
1832483,26,7,1987,7,"male",18,46,41,0,0,0,0,0,0
1832495,49,23,1964,7,"male",252,22,18,1,0,1,0,0,0
1832526,71,5,1942,11,"female",1028,63,45,59,1,0,0,59,1
1832537,48,13,1965,1,"male",722,46,17,23,8,23,6,0,2
1832543,24,29,1989,4,"male",324,81,65,0,2,0,2,0,0
1832548,23,9,1990,6,"male",253,1278,945,959,1033,632,524,327,509
1832597,46,19,1967,10,"male",79,126,83,0,0,0,0,0,0
1832632,39,18,1974,8,"male",14,0,0,0,0,0,0,0,0
1832633,25,4,1988,2,"male",357,179,146,0,0,0,0,0,0
1832664,22,1,1991,1,"male",482,156,82,19,15,19,15,0,0
1832674,48,1,1965,3,"male",92,29,4,6,2,6,2,0,0
1832706,39,11,1974,12,"female",377,1,1,0,0,0,0,0,0
1832712,60,27,1953,1,"male",1502,127,47,12,2,0,0,12,2
1832715,30,9,1983,3,"male",337,1,1,0,1,0,1,0,0
1832718,28,28,1985,9,"female",433,28,4,3,0,3,0,0,0
1832723,27,16,1986,4,"female",209,38,31,129,37,128,31,1,6
1832727,21,17,1992,8,"male",225,325,217,95,90,78,51,17,39
1832783,48,25,1965,3,"male",287,157,141,1,21,1,20,0,1
1832799,26,21,1987,6,"female",394,191,162,615,925,589,661,26,264
1832828,25,25,1988,2,"female",838,252,37,5,30,4,10,1,20
1832830,60,25,1953,7,"female",558,108,61,87,71,0,11,87,60
1832921,19,5,1994,4,"male",916,418,338,24,5,11,3,13,2
1832937,19,18,1994,12,"male",37,153,135,996,479,996,428,0,51
1832946,31,31,1982,1,"male",307,154,67,1,0,1,0,0,0
1832961,54,13,1959,5,"female",1697,58,17,4,19,0,8,4,11
1832962,57,4,1956,5,"male",976,17,4,2,2,0,1,2,1
1832973,30,27,1983,11,"male",518,157,122,346,219,346,214,0,5
1832978,93,14,1920,10,"male",724,230,163,650,317,569,225,81,92
1832981,13,4,2000,1,"male",39,233,215,18,15,2,6,16,9
1832986,26,17,1987,1,"male",232,220,187,60,151,60,126,0,25
1833030,23,1,1990,11,"female",386,75,44,3,4,3,1,0,3
1833046,62,11,1951,8,"female",1586,204,108,82,23,82,13,0,10
1833050,20,16,1993,11,"male",206,95,50,0,0,0,0,0,0
1833082,20,11,1993,1,"male",648,133,77,14,5,14,3,0,2
1833094,18,12,1995,12,"male",721,1905,1810,7,2,0,1,7,1
1833102,59,12,1954,1,"male",1796,31,19,4,0,4,0,0,0
1833121,63,5,1950,1,"male",1440,77,17,0,0,0,0,0,0
1833133,20,30,1993,5,"female",258,555,268,309,449,82,204,227,245
1833142,94,19,1919,1,"female",1613,83,47,21,36,9,22,12,14
1833155,16,26,1997,8,"male",523,513,302,409,569,366,276,43,293
1833158,21,18,1992,5,"male",635,625,488,2,12,2,6,0,6
1833175,39,10,1974,1,"male",510,182,134,55,405,55,327,0,78
1833205,17,27,1996,11,"female",1005,4351,2210,5045,4498,4742,3909,303,588
1833243,23,5,1990,3,"male",822,1560,912,677,384,595,238,82,146
1833248,27,28,1986,3,"female",111,240,179,80,113,44,54,36,59
1833297,17,13,1996,6,"female",610,1705,1179,132,214,131,91,1,123
1833312,24,24,1989,7,"male",355,286,95,1,8,1,7,0,1
1833313,25,12,1988,12,"male",206,85,66,14,13,14,13,0,0
1833332,47,6,1966,4,"male",295,27,13,0,1,0,1,0,0
1833337,18,23,1995,3,"female",154,45,22,9,10,9,10,0,0
1833362,64,17,1949,8,"female",1589,114,53,64,17,52,8,12,9
1833374,18,7,1995,7,"male",71,1,1,0,0,0,0,0,0
1833450,60,19,1953,6,"female",80,108,88,128,76,128,38,0,38
1833455,17,25,1996,12,"male",140,118,59,0,0,0,0,0,0
1833462,18,1,1995,4,"female",909,539,278,14,19,14,10,0,9
1833497,23,13,1990,10,"female",672,175,134,257,190,55,81,202,109
1833514,48,2,1965,7,"female",1922,58,14,21,15,21,11,0,4
1833544,57,17,1956,3,"male",355,42,24,3,1,2,1,1,0
1833560,14,1,1999,2,"male",145,63,49,47,16,0,1,47,15
1833566,17,27,1996,11,"female",667,4277,1477,27,1447,27,1236,0,211
1833575,19,12,1994,1,"female",487,215,104,17,24,17,18,0,6
1833612,40,17,1973,8,"male",297,85,50,5,13,5,7,0,6
1833613,35,11,1978,11,"male",1007,8,7,4,2,1,0,3,2
1833614,17,25,1996,1,"male",159,5,3,0,0,0,0,0,0
1833622,32,19,1981,3,"female",285,140,79,245,41,245,29,0,12
1833623,17,26,1996,8,"male",484,79,49,2,1,0,1,2,0
1833633,16,5,1997,1,"male",431,100,76,3,0,3,0,0,0
1833651,22,31,1991,8,"male",280,38,38,8,0,8,0,0,0
1833683,26,4,1987,2,"male",222,131,91,1,0,0,0,1,0
1833720,45,19,1968,3,"female",326,21,15,1,0,1,0,0,0
1833727,35,10,1978,4,"female",1001,27,9,3,0,3,0,0,0
1833735,19,1,1994,3,"male",187,4,2,0,0,0,0,0,0
1833739,19,17,1994,3,"male",240,111,84,271,158,176,126,95,32
1833772,27,12,1986,5,"female",514,108,87,0,0,0,0,0,0
1833811,26,31,1987,7,"male",553,42,27,8,0,8,0,0,0
1833822,49,2,1964,10,"male",296,92,35,275,2,275,1,0,1
1833829,47,15,1966,12,"female",796,53,35,573,1328,144,844,429,484
1833831,35,23,1978,7,"female",600,22,14,29,0,29,0,0,0
1833835,24,14,1989,6,"male",462,22,14,1,1,1,1,0,0
1833844,19,2,1994,2,"male",186,63,48,1,0,1,0,0,0
1833885,20,25,1993,5,"female",172,541,50,342,127,54,23,288,104
1833887,82,15,1931,9,"female",1239,107,29,6,15,0,6,6,9
1833894,43,8,1970,5,"female",628,164,89,250,55,243,15,7,40
1833898,85,7,1928,9,"male",1827,691,441,47,25,0,16,47,9
1833909,64,27,1949,10,"male",1342,509,237,29,29,29,27,0,2
1833953,38,25,1975,5,"male",189,32,21,2,1,0,0,2,1
1833955,31,21,1982,2,"male",447,36,25,0,5,0,5,0,0
1833974,14,4,1999,1,"female",656,98,32,1,0,1,0,0,0
1833991,67,19,1946,12,"female",677,49,38,74,16,74,13,0,3
1834005,26,26,1987,1,"male",349,94,43,262,272,262,171,0,101
1834037,31,20,1982,5,"female",921,5,3,0,0,0,0,0,0
1834048,15,10,1998,10,"female",549,724,469,59,99,31,69,28,30
1834063,64,23,1949,3,"male",219,63,51,5,21,0,9,5,12
1834082,103,5,1910,5,"female",989,386,90,5,3,5,3,0,0
1834085,65,17,1948,3,"male",1717,139,67,79,16,23,3,56,13
1834097,32,25,1981,7,"male",199,102,83,28,90,27,52,1,38
1834108,16,11,1997,10,"female",296,27,14,1,8,1,0,0,8
1834109,31,20,1982,7,"female",380,10,0,0,0,0,0,0,0
1834117,26,12,1987,10,"male",577,197,97,113,122,43,86,70,36
1834127,59,6,1954,11,"male",1428,14,3,0,0,0,0,0,0
1834133,17,15,1996,6,"female",139,3,0,115,4,52,2,63,2
1834134,22,3,1991,6,"female",455,259,83,0,0,0,0,0,0
1834151,72,21,1941,11,"male",950,195,97,488,171,2,38,486,133
1834159,52,20,1961,7,"male",945,366,259,258,478,11,194,247,284
1834162,16,18,1997,10,"female",156,931,251,621,813,123,156,498,657
1834166,31,24,1982,9,"male",274,19,7,5,1,5,1,0,0
1834230,34,1,1979,1,"male",311,3,3,1,0,1,0,0,0
1834272,52,21,1961,3,"male",1603,56,31,2,22,1,20,1,2
1834286,14,12,1999,4,"female",308,404,333,136,73,79,57,57,16
1834326,56,18,1957,2,"male",909,27,17,5,21,2,17,3,4
1834353,17,13,1996,6,"male",651,1222,591,4059,1487,1404,572,2655,915
1834364,17,20,1996,11,"male",622,597,283,0,39,0,9,0,30
1834385,15,29,1998,8,"female",893,3893,715,4236,10510,718,2926,3518,7584
1834388,16,29,1997,6,"male",426,98,50,0,0,0,0,0,0
1834413,62,15,1951,3,"female",551,72,35,69,53,13,34,56,19
1834439,26,4,1987,4,"male",62,3,3,10,5,0,0,10,5
1834457,21,7,1992,10,"male",329,72,51,2,24,0,2,2,22
1834521,107,10,1906,10,"male",97,636,336,204,469,204,172,0,297
1834533,60,17,1953,10,"female",1133,128,69,257,189,173,138,84,51
1834574,18,7,1995,6,"male",401,352,126,1,1,0,1,1,0
1834607,26,24,1987,8,"female",528,46,6,1,0,1,0,0,0
1834612,43,27,1970,9,"male",502,162,40,13,17,4,6,9,11
1834614,67,15,1946,4,"female",669,264,137,12,22,12,22,0,0
1834621,62,29,1951,9,"male",380,0,0,0,0,0,0,0,0
1834633,17,27,1996,7,"male",587,30,20,1,1,1,1,0,0
1834641,34,1,1979,9,"male",92,1,0,32,12,32,12,0,0
1834674,55,27,1958,3,"female",583,52,43,0,0,0,0,0,0
1834680,103,1,1910,3,"male",735,152,77,115,81,115,58,0,23
1834685,53,12,1960,10,"male",2121,164,59,1,3,1,1,0,2
1834694,19,5,1994,8,"male",461,64,24,0,0,0,0,0,0
1834702,19,27,1994,1,"male",751,8,8,0,0,0,0,0,0
1834729,25,19,1988,7,"male",483,217,191,0,9,0,7,0,2
1834753,30,15,1983,2,"male",132,94,50,20,59,20,42,0,17
1834754,17,16,1996,4,"female",412,53,29,0,0,0,0,0,0
1834804,56,29,1957,4,"female",500,56,22,5,3,0,2,5,1
1834815,26,1,1987,1,"male",593,57,43,1,4,1,1,0,3
1834845,23,1,1990,8,"female",200,3,3,5,0,5,0,0,0
1834854,103,4,1910,8,"male",1109,303,71,43,27,43,24,0,3
1834860,27,12,1986,12,"male",168,66,53,3,4,3,4,0,0
1834868,59,16,1954,4,"male",10,23,21,11,3,11,1,0,2
1834921,19,18,1994,6,"female",579,164,95,5,1,5,1,0,0
1834922,24,5,1989,12,"female",764,547,234,105,195,105,156,0,39
1834926,38,28,1975,11,"female",23,10,7,8,17,8,13,0,4
1834968,29,15,1984,9,"male",367,161,147,22,9,22,8,0,1
1834969,27,16,1986,10,"female",660,91,50,95,91,80,49,15,42
1834971,18,18,1995,7,"female",48,466,20,387,133,387,123,0,10
1834976,13,20,2000,1,"male",177,4,1,0,2,0,0,0,2
1835008,19,3,1994,8,"male",781,1271,1066,16,16,16,15,0,1
1835037,21,17,1992,1,"male",475,553,370,32,27,31,17,1,10
1835048,23,21,1990,4,"male",574,142,100,2,0,0,0,2,0
1835051,29,11,1984,12,"female",657,539,441,25,91,0,66,25,25
1835071,88,26,1925,8,"female",1829,634,424,521,661,347,300,174,361
1835091,29,22,1984,10,"male",72,26,24,1,0,0,0,1,0
1835106,29,4,1984,6,"female",1424,87,61,0,1,0,1,0,0
1835112,26,25,1987,12,"male",421,167,58,2,5,2,5,0,0
1835116,59,15,1954,5,"male",1497,106,37,23,24,22,15,1,9
1835118,51,12,1962,6,"male",102,51,35,24,16,14,8,10,8
1835123,53,10,1960,4,"male",152,23,20,8,8,0,4,8,4
1835124,25,1,1988,10,"male",965,11,6,0,0,0,0,0,0
1835191,42,3,1971,3,"male",373,47,24,97,61,97,56,0,5
1835193,104,13,1909,11,"male",55,257,223,220,145,52,55,168,90
1835212,31,22,1982,5,"female",557,68,27,39,25,0,2,39,23
1835219,44,1,1969,11,"male",419,96,65,12,2,11,2,1,0
1835233,24,20,1989,12,"male",681,76,43,2,48,1,31,1,17
1835240,29,23,1984,3,"male",415,68,42,0,0,0,0,0,0
1835282,19,4,1994,6,"male",361,174,139,1403,643,1403,598,0,45
1835287,51,6,1962,6,"male",127,128,117,489,3,489,1,0,2
1835300,22,12,1991,11,"female",566,105,24,46,5,0,3,46,2
1835302,67,2,1946,9,"female",151,20,9,2,5,0,1,2,4
1835303,18,20,1995,3,"male",301,321,201,11,3,0,0,11,3
1835320,22,16,1991,9,"male",510,18,11,1,4,1,4,0,0
1835325,24,17,1989,5,"male",577,71,29,0,0,0,0,0,0
1835339,66,12,1947,8,"male",546,192,71,3,65,3,11,0,54
1835341,21,11,1992,9,"male",567,208,96,51,43,50,9,1,34
1835347,100,7,1913,9,"male",2208,178,109,52,17,2,4,50,13
1835366,24,9,1989,9,"female",268,1563,882,237,477,237,270,0,207
1835382,21,28,1992,5,"male",751,983,659,845,969,647,829,198,140
1835395,15,28,1998,7,"male",13,6,6,0,0,0,0,0,0
1835416,20,19,1993,2,"male",301,63,43,0,0,0,0,0,0
1835422,59,13,1954,2,"female",754,26,12,1,5,0,2,1,3
1835458,45,16,1968,8,"male",300,9,5,31,2,0,1,31,1
1835470,41,11,1972,1,"male",252,18,9,3,9,3,5,0,4
1835471,14,27,1999,12,"male",50,90,88,104,4,104,4,0,0
1835490,18,17,1995,4,"female",393,547,268,60,108,60,79,0,29
1835503,68,17,1945,12,"female",1193,42,18,0,0,0,0,0,0
1835529,24,25,1989,6,"male",147,19,8,6,0,6,0,0,0
1835534,21,20,1992,4,"female",432,77,67,2,4,2,4,0,0
1835568,16,1,1997,5,"male",286,105,94,1,1,1,1,0,0
1835571,15,6,1998,4,"female",3,205,44,450,318,87,216,363,102
1835575,19,1,1994,8,"male",177,145,102,5,7,5,6,0,1
1835592,16,7,1997,2,"female",205,139,101,0,0,0,0,0,0
1835603,19,5,1994,7,"male",324,42,22,0,0,0,0,0,0
1835621,21,20,1992,7,"female",426,3,1,1,3,1,3,0,0
1835686,53,16,1960,3,"male",649,42,13,3,18,3,15,0,3
1835688,26,19,1987,1,"male",573,221,151,0,20,0,15,0,5
1835700,35,19,1978,12,"male",273,0,0,0,0,0,0,0,0
1835705,18,27,1995,4,"male",806,657,456,30,503,19,246,11,257
1835725,34,9,1979,6,"male",436,364,228,29,38,29,32,0,6
1835733,34,10,1979,10,"female",481,14,3,0,0,0,0,0,0
1835755,25,5,1988,9,"male",294,162,67,8,18,8,15,0,3
1835787,26,26,1987,3,"male",426,209,90,56,34,24,10,32,24
1835792,14,27,1999,1,"female",153,28,20,0,0,0,0,0,0
1835799,61,7,1952,2,"female",143,11,6,123,32,123,23,0,9
1835804,14,15,1999,4,"male",368,14,8,0,0,0,0,0,0
1835827,23,26,1990,9,"male",1115,118,61,7,6,7,5,0,1
1835828,29,18,1984,10,"female",681,97,70,1,1,1,1,0,0
1835834,18,13,1995,9,"male",144,18,16,0,0,0,0,0,0
1835914,46,19,1967,8,"male",404,87,69,29,2,25,1,4,1
1835934,19,4,1994,5,"male",212,998,610,1651,4491,451,2018,1200,2473
1835959,25,3,1988,7,"male",230,89,46,0,0,0,0,0,0
1835979,17,1,1996,2,"male",440,29,20,27,3,0,0,27,3
1836006,29,5,1984,3,"female",238,437,257,1476,1813,1024,839,452,974
1836021,72,10,1941,12,"male",992,33,24,1,42,0,19,1,23
1836077,65,14,1948,1,"female",1112,60,38,37,78,37,53,0,25
1836085,21,18,1992,8,"female",639,545,416,37,3,37,3,0,0
1836093,51,16,1962,11,"female",426,27,11,89,15,89,12,0,3
1836096,27,20,1986,12,"male",216,132,98,2,2,2,0,0,2
1836115,35,12,1978,10,"female",37,18,11,7,6,4,3,3,3
1836121,18,27,1995,8,"female",784,427,199,19,16,15,1,4,15
1836144,65,26,1948,1,"male",1349,19,3,0,1,0,0,0,1
1836147,30,3,1983,3,"male",224,235,217,34,11,34,11,0,0
1836149,103,12,1910,1,"female",1093,481,227,7,78,7,68,0,10
1836167,52,8,1961,7,"male",374,79,36,101,136,101,135,0,1
1836193,54,29,1959,7,"male",459,20,9,0,0,0,0,0,0
1836206,31,21,1982,1,"male",304,77,60,83,20,42,17,41,3
1836209,35,28,1978,4,"male",21,10,10,0,0,0,0,0,0
1836212,21,25,1992,5,"male",194,12,9,20,0,20,0,0,0
1836215,21,8,1992,7,"female",641,230,48,92,97,91,62,1,35
1836231,71,31,1942,8,"female",955,105,57,24,3,10,2,14,1
1836251,25,23,1988,3,"male",110,20,19,2,1,0,1,2,0
1836260,25,12,1988,3,"male",334,111,34,406,37,406,26,0,11
1836279,34,23,1979,8,"male",159,205,89,14,29,14,25,0,4
1836293,19,29,1994,5,"male",868,407,246,33,29,31,14,2,15
1836304,20,28,1993,2,"male",70,90,85,19,3,18,1,1,2
1836308,15,29,1998,5,"male",255,150,93,21,5,16,5,5,0
1836319,69,29,1944,10,"male",577,18,15,0,0,0,0,0,0
1836366,100,16,1913,10,"male",1495,872,528,181,500,77,229,104,271
1836392,22,4,1991,12,"male",259,6,5,0,0,0,0,0,0
1836399,18,16,1995,9,"male",170,65,57,82,35,82,32,0,3
1836427,68,1,1945,1,"female",1005,483,258,593,764,6,405,587,359
1836434,33,16,1980,8,"male",182,12,12,0,0,0,0,0,0
1836467,29,11,1984,1,"male",196,52,20,0,0,0,0,0,0
1836498,33,6,1980,6,"male",622,70,43,301,186,301,158,0,28
1836501,44,16,1969,7,"female",396,17,9,202,136,0,27,202,109
1836506,21,10,1992,3,"male",247,173,132,814,343,708,107,106,236
1836513,44,9,1969,2,"female",283,45,24,5,34,5,33,0,1
1836544,23,12,1990,1,"female",119,41,16,42,57,0,12,42,45
1836545,56,2,1957,9,"female",398,476,307,82,67,82,50,0,17
1836559,52,13,1961,9,"male",504,28,13,82,22,82,17,0,5
1836562,20,4,1993,4,"male",209,30,26,34,36,0,2,34,34
1836571,55,1,1958,6,"female",174,4,4,0,0,0,0,0,0
1836593,55,26,1958,7,"male",466,206,153,399,612,230,423,169,189
1836622,33,29,1980,2,"male",624,80,69,4,0,0,0,4,0
1836628,48,2,1965,3,"female",119,13,4,1,0,1,0,0,0
1836645,23,24,1990,8,"male",118,120,108,149,19,149,11,0,8
1836668,17,8,1996,3,"female",326,203,121,0,0,0,0,0,0
1836690,24,5,1989,9,"male",694,404,356,247,43,247,41,0,2
1836707,62,12,1951,7,"male",257,41,21,3,11,3,10,0,1
1836742,28,15,1985,3,"male",726,62,42,129,7,129,5,0,2
1836749,18,17,1995,5,"female",583,69,27,1,11,1,11,0,0
1836767,42,18,1971,3,"male",253,14,13,1392,107,1392,43,0,64
1836814,15,21,1998,8,"female",11,16,14,13,1,0,1,13,0
1836826,33,4,1980,11,"female",454,94,67,39,16,39,11,0,5
1836830,28,18,1985,2,"male",102,2,2,1,0,1,0,0,0
1836837,28,22,1985,10,"male",865,77,62,179,57,179,56,0,1
1836885,33,1,1980,1,"male",305,109,58,18,4,18,2,0,2
1836891,37,18,1976,7,"male",3,0,0,2,0,2,0,0,0
1836932,15,11,1998,1,"male",184,557,406,2288,2071,1887,1883,401,188
1836945,75,18,1938,12,"female",685,72,45,26,2,26,2,0,0
1836952,16,8,1997,5,"male",166,73,56,9,0,9,0,0,0
1836955,40,1,1973,7,"male",533,13,13,27,2,27,1,0,1
1836962,38,8,1975,8,"male",207,20,15,0,0,0,0,0,0
1836980,18,14,1995,9,"female",556,601,417,6,4,6,0,0,4
1836988,25,24,1988,11,"male",443,105,56,0,0,0,0,0,0
1836993,35,3,1978,2,"female",271,280,169,1159,446,1159,439,0,7
1837015,19,21,1994,4,"female",273,325,190,209,578,128,296,81,282
1837030,16,5,1997,9,"male",115,266,124,36,288,25,184,11,104
1837031,19,2,1994,2,"male",286,173,117,52,1,51,1,1,0
1837057,23,21,1990,6,"male",348,239,131,639,264,639,218,0,46
1837060,15,12,1998,2,"male",257,112,32,13,7,13,7,0,0
1837088,32,22,1981,10,"male",147,75,45,100,74,100,69,0,5
1837101,27,15,1986,4,"male",673,98,57,17,2,9,2,8,0
1837109,21,2,1992,2,"male",66,12,2,1,0,1,0,0,0
1837118,24,10,1989,1,"male",810,69,32,14,7,13,5,1,2
1837146,35,11,1978,2,"male",264,5,5,1,0,1,0,0,0
1837151,17,16,1996,9,"male",43,22,10,3,1,3,0,0,1
1837174,26,30,1987,3,"male",1077,116,47,0,127,0,45,0,82
1837210,24,7,1989,11,"male",696,755,672,13,134,10,110,3,24
1837211,20,11,1993,2,"female",528,2016,803,5407,15036,1094,9022,4313,6014
1837218,17,19,1996,4,"male",499,628,526,45,2,45,1,0,1
1837229,16,17,1997,5,"female",407,654,528,241,285,241,243,0,42
1837240,18,25,1995,5,"male",486,250,193,0,9,0,9,0,0
1837249,28,1,1985,12,"male",704,150,128,1,6,1,6,0,0
1837259,103,26,1910,12,"male",2156,113,39,399,341,139,209,260,132
1837272,19,23,1994,4,"male",386,42,23,0,4,0,3,0,1
1837278,24,30,1989,6,"female",391,260,201,179,81,149,39,30,42
1837306,23,10,1990,2,"male",138,118,84,75,48,75,34,0,14
1837328,24,24,1989,3,"female",300,44,14,69,21,69,21,0,0
1837331,23,11,1990,11,"male",309,3,3,0,0,0,0,0,0
1837340,16,15,1997,4,"male",617,15,13,1,9,0,8,1,1
1837341,56,26,1957,7,"male",1822,188,75,30,13,17,9,13,4
1837356,39,24,1974,5,"female",164,174,89,2,72,2,46,0,26
1837358,40,10,1973,7,"female",283,528,352,569,569,15,206,554,363
1837371,61,4,1952,6,"female",681,30,26,7,3,6,1,1,2
1837378,23,10,1990,10,"female",440,49,26,75,24,1,9,74,15
1837382,71,6,1942,1,"male",971,42,25,1,1,0,1,1,0
1837408,64,17,1949,10,"female",539,32,22,382,6,0,3,382,3
1837414,14,1,1999,1,"male",77,2,2,0,0,0,0,0,0
1837420,23,5,1990,9,"male",101,0,0,0,0,0,0,0,0
1837447,26,7,1987,4,"female",641,82,3,130,49,130,29,0,20
1837465,32,18,1981,10,"female",93,38,28,216,92,216,71,0,21
1837488,21,18,1992,9,"male",296,118,44,0,1,0,1,0,0
1837490,21,5,1992,11,"male",306,83,70,0,2,0,2,0,0
1837492,27,19,1986,11,"male",138,47,37,145,13,145,13,0,0
1837499,19,5,1994,6,"female",358,240,94,1109,725,1107,695,2,30
1837501,14,5,1999,12,"male",67,505,492,25,1,0,0,25,1
1837504,57,26,1956,9,"female",608,86,42,110,111,0,45,110,66
1837522,17,2,1996,1,"male",246,66,41,0,1,0,1,0,0
1837527,19,19,1994,7,"male",245,36,30,11,7,11,3,0,4
1837528,23,3,1990,9,"female",334,1464,590,290,422,220,83,70,339
1837544,23,19,1990,10,"female",419,343,273,19,77,9,60,10,17
1837550,18,1,1995,3,"male",25,44,13,118,1,106,1,12,0
1837601,26,2,1987,12,"female",1364,708,473,0,11,0,10,0,1
1837610,33,16,1980,8,"male",649,134,72,44,4,34,4,10,0
1837612,18,28,1995,8,"male",68,85,74,147,31,147,27,0,4
1837622,46,5,1967,6,"male",207,1,1,0,0,0,0,0,0
1837633,45,15,1968,8,"male",168,0,0,4,0,0,0,4,0
1837678,48,6,1965,3,"male",514,11,11,4,0,4,0,0,0
1837680,30,16,1983,1,"female",234,43,30,280,194,280,124,0,70
1837681,70,19,1943,3,"female",942,6,5,0,0,0,0,0,0
1837688,14,26,1999,3,"female",658,353,223,119,137,1,55,118,82
1837693,23,19,1990,4,"male",60,59,38,69,15,69,13,0,2
1837712,21,21,1992,6,"male",193,458,201,5631,3462,1081,633,4550,2829
1837740,67,2,1946,7,NA,2056,5,2,0,0,0,0,0,0
1837744,14,17,1999,3,"male",363,10,5,0,0,0,0,0,0
1837753,41,3,1972,11,"male",329,79,77,0,0,0,0,0,0
1837764,23,9,1990,6,"female",660,72,45,29,26,22,24,7,2
1837767,19,20,1994,11,"female",93,66,19,29,198,29,158,0,40
1837773,67,10,1946,3,"male",647,42,15,11,0,11,0,0,0
1837784,30,15,1983,9,"female",389,308,183,38,81,38,77,0,4
1837827,63,21,1950,9,"male",1395,42,30,0,0,0,0,0,0
1837843,34,4,1979,4,"male",276,61,23,34,38,34,24,0,14
1837846,52,22,1961,9,"female",170,63,16,840,628,0,64,840,564
1837868,19,25,1994,11,"female",505,317,85,0,1,0,1,0,0
1837870,25,30,1988,7,"male",369,10,2,0,0,0,0,0,0
1837876,22,8,1991,5,"female",14,1,1,0,0,0,0,0,0
1837891,51,30,1962,3,"male",39,1,0,2,0,0,0,2,0
1837894,32,14,1981,4,"male",520,135,89,68,9,68,4,0,5
1837916,57,10,1956,2,"male",731,29,13,0,0,0,0,0,0
1837957,24,1,1989,1,"male",630,0,0,0,0,0,0,0,0
1837958,15,23,1998,9,"female",442,1859,1187,2906,2356,1170,1860,1736,496
1838008,22,17,1991,3,"male",696,65,56,63,43,63,35,0,8
1838011,18,23,1995,5,"male",277,135,108,18,42,7,5,11,37
1838013,21,4,1992,3,"male",170,743,560,2453,881,2453,795,0,86
1838037,21,14,1992,9,"female",832,673,144,56,168,50,67,6,101
1838056,24,17,1989,5,"female",31,74,64,117,14,116,9,1,5
1838101,22,3,1991,6,"male",24,1,0,0,0,0,0,0,0
1838104,19,16,1994,2,"female",668,3675,764,1337,4036,564,2812,773,1224
1838113,45,7,1968,3,"female",536,113,63,146,31,146,30,0,1
1838120,22,26,1991,11,"male",503,258,187,30,60,15,28,15,32
1838128,19,26,1994,8,"female",540,1145,820,44,87,44,65,0,22
1838133,15,3,1998,4,"male",338,345,291,1,8,1,6,0,2
1838142,44,13,1969,7,"female",401,156,87,266,106,43,50,223,56
1838153,42,9,1971,12,"male",398,110,98,0,0,0,0,0,0
1838159,19,28,1994,12,"male",128,84,76,1,0,1,0,0,0
1838171,16,20,1997,6,"female",553,2644,430,57,318,19,218,38,100
1838203,103,29,1910,6,NA,1554,95,38,4,11,1,6,3,5
1838212,21,19,1992,12,"female",295,12,7,11,1,0,0,11,1
1838218,62,29,1951,12,"male",1683,42,14,59,54,59,51,0,3
1838219,92,25,1921,9,"male",1149,483,204,6,58,6,42,0,16
1838231,56,13,1957,3,"female",832,100,28,220,134,5,36,215,98
1838240,59,6,1954,6,"female",473,54,34,103,39,103,26,0,13
1838250,105,29,1908,2,"male",1733,47,25,0,0,0,0,0,0
1838288,19,12,1994,4,"male",1440,2564,1394,248,314,88,184,160,130
1838338,45,6,1968,10,"female",284,317,107,15,145,15,116,0,29
1838356,48,26,1965,10,"male",294,120,75,10,23,10,16,0,7
1838358,59,10,1954,1,"male",342,45,30,4,1,4,1,0,0
1838362,50,27,1963,1,"male",921,41,23,382,134,0,16,382,118
1838370,56,24,1957,9,"female",502,212,82,185,303,13,92,172,211
1838381,30,11,1983,3,"male",527,74,9,11,31,11,25,0,6
1838384,23,7,1990,5,"male",287,376,243,57,67,57,56,0,11
1838417,33,7,1980,10,"female",132,40,25,97,84,92,64,5,20
1838445,46,29,1967,3,"female",647,58,39,3,13,0,8,3,5
1838460,47,1,1966,7,"male",144,16,10,5,5,0,4,5,1
1838521,42,31,1971,8,"male",591,58,41,21,3,21,1,0,2
1838531,47,30,1966,4,"female",169,29,23,1054,263,0,69,1054,194
1838551,14,1,1999,9,"female",284,206,165,88,9,88,8,0,1
1838562,63,10,1950,3,"female",144,63,41,1,49,1,49,0,0
1838590,66,23,1947,10,"male",534,2,0,0,0,0,0,0,0
1838593,41,17,1972,2,"male",508,216,152,0,0,0,0,0,0
1838612,30,7,1983,11,"female",1707,55,36,359,599,170,363,189,236
1838614,38,1,1975,12,"male",356,683,499,640,455,469,298,171,157
1838627,17,17,1996,2,"male",233,23,20,0,0,0,0,0,0
1838635,23,23,1990,8,"male",242,322,135,0,1,0,1,0,0
1838645,28,26,1985,8,"female",1025,16,3,4,1,4,0,0,1
1838648,37,8,1976,10,"female",395,18,10,4,1,4,1,0,0
1838660,15,16,1998,2,"male",188,124,95,201,324,41,154,160,170
1838662,25,18,1988,7,"male",227,48,9,21,0,21,0,0,0
1838700,41,15,1972,10,"male",663,6,4,55,7,0,0,55,7
1838725,57,4,1956,3,"female",2045,190,103,137,346,135,194,2,152
1838730,14,18,1999,2,"male",412,7,4,0,0,0,0,0,0
1838741,25,10,1988,8,"male",151,26,26,25,0,19,0,6,0
1838769,30,16,1983,5,"male",256,41,24,2,21,2,13,0,8
1838796,23,24,1990,5,"female",495,46,6,0,0,0,0,0,0
1838823,16,22,1997,3,"female",88,21,17,350,279,83,172,267,107
1838843,53,4,1960,3,"male",118,13,12,323,24,323,16,0,8
1838872,24,1,1989,11,"female",405,83,78,53,12,49,5,4,7
1838887,103,24,1910,9,"female",559,166,45,7,25,7,24,0,1
1838905,23,17,1990,1,"female",667,9,5,0,0,0,0,0,0
1838915,57,12,1956,1,"male",1724,181,129,144,360,33,164,111,196
1838917,19,1,1994,10,"male",575,408,184,45,51,23,16,22,35
1838921,21,5,1992,5,"female",190,975,141,3357,3744,2503,2485,854,1259
1838941,43,26,1970,5,"female",283,62,42,7,1,7,1,0,0
1838962,27,17,1986,9,"female",101,29,23,0,0,0,0,0,0
1838983,48,24,1965,9,"female",4,26,26,38,176,38,163,0,13
1839000,65,7,1948,2,"female",510,59,39,242,56,13,18,229,38
1839020,17,23,1996,9,"male",483,27,1,0,0,0,0,0,0
1839092,20,19,1993,2,"male",276,292,136,3,4,3,3,0,1
1839098,93,20,1920,6,"male",1231,40,15,4,0,4,0,0,0
1839100,26,5,1987,7,"male",94,94,80,6,8,6,6,0,2
1839110,34,30,1979,10,"female",511,21,11,39,1,39,1,0,0
1839135,57,21,1956,4,"male",485,12,5,0,0,0,0,0,0
1839146,28,13,1985,7,"male",668,10,8,22,24,22,23,0,1
1839193,22,2,1991,6,"male",427,87,64,24,16,24,14,0,2
1839247,22,11,1991,8,"male",1061,309,205,39,4,39,3,0,1
1839303,18,22,1995,5,"male",451,729,681,0,2,0,0,0,2
1839306,21,30,1992,8,"male",263,8,7,0,0,0,0,0,0
1839319,15,21,1998,7,"female",572,119,83,14,38,14,22,0,16
1839331,30,6,1983,5,"male",918,133,62,0,7,0,4,0,3
1839349,21,7,1992,8,"female",23,37,32,0,1,0,1,0,0
1839398,31,20,1982,1,"male",274,81,55,74,29,74,29,0,0
1839404,79,30,1934,10,"male",1029,74,14,0,2,0,2,0,0
1839421,19,5,1994,5,"male",27,0,0,0,0,0,0,0,0
1839426,23,23,1990,10,"male",286,47,21,1,0,1,0,0,0
1839455,54,11,1959,12,"male",261,1,1,6,6,6,6,0,0
1839456,22,22,1991,7,"female",290,149,89,279,218,213,123,66,95
1839472,21,20,1992,1,"male",226,24,18,7,6,7,2,0,4
1839501,20,1,1993,1,"male",191,44,23,4,4,4,4,0,0
1839522,21,17,1992,7,"male",675,145,124,0,0,0,0,0,0
1839536,99,13,1914,7,"male",953,1567,733,83,99,83,87,0,12
1839555,43,14,1970,2,"male",756,51,41,0,0,0,0,0,0
1839606,18,16,1995,5,"female",216,405,239,374,764,303,277,71,487
1839631,22,25,1991,6,"female",238,1,1,0,0,0,0,0,0
1839656,26,1,1987,1,"male",348,10,10,0,0,0,0,0,0
1839669,56,5,1957,3,"male",936,40,26,76,53,76,46,0,7
1839673,103,12,1910,4,"female",718,343,201,91,32,0,3,91,29
1839680,64,24,1949,12,"male",1657,25,13,0,0,0,0,0,0
1839690,28,11,1985,11,"male",392,89,55,6,2,6,2,0,0
1839707,68,10,1945,8,"male",320,10,2,0,0,0,0,0,0
1839755,40,5,1973,7,"male",488,90,41,5,19,5,19,0,0
1839761,64,28,1949,7,"female",774,39,22,0,0,0,0,0,0
1839779,47,8,1966,9,"male",421,6,5,0,0,0,0,0,0
1839783,38,31,1975,12,"female",502,140,64,701,343,684,262,17,81
1839818,14,2,1999,9,"male",246,599,367,1139,1857,107,1367,1032,490
1839828,23,27,1990,10,"male",310,127,114,0,0,0,0,0,0
1839833,21,2,1992,4,"female",783,194,30,19,60,19,53,0,7
1839846,19,20,1994,8,"male",851,252,171,0,31,0,19,0,12
1839847,31,8,1982,9,"male",10,4,4,0,0,0,0,0,0
1839859,28,28,1985,5,"female",254,32,13,142,65,142,26,0,39
1839867,72,3,1941,8,"female",1803,92,56,14,38,14,29,0,9
1839871,30,26,1983,5,"male",653,73,56,0,0,0,0,0,0
1839875,26,27,1987,7,"male",328,45,36,19,12,19,10,0,2
1839907,18,19,1995,7,"male",512,198,60,4,13,1,5,3,8
1839908,22,12,1991,10,"female",497,61,32,545,188,545,133,0,55
1839915,21,6,1992,3,"female",72,214,148,989,472,950,322,39,150
1839936,35,19,1978,3,"female",176,121,54,7,8,7,7,0,1
1839954,33,31,1980,8,"male",187,74,54,0,0,0,0,0,0
1839971,57,20,1956,5,"female",231,44,38,0,0,0,0,0,0
1839975,18,5,1995,5,"female",235,1,1,31,2,19,1,12,1
1839989,63,15,1950,5,"male",449,87,33,90,20,90,15,0,5
1840008,18,4,1995,4,"male",143,98,78,1,1,1,1,0,0
1840066,35,28,1978,2,"male",442,20,6,2,8,2,1,0,7
1840073,113,31,1900,12,"male",2072,103,8,6,9,0,3,6,6
1840085,24,25,1989,4,"male",542,171,97,52,42,50,24,2,18
1840113,56,17,1957,6,"male",504,210,33,1347,247,1347,209,0,38
1840122,15,3,1998,3,"male",502,724,608,0,0,0,0,0,0
1840126,98,30,1915,11,"female",1989,878,166,23,2,18,1,5,1
1840229,45,13,1968,4,"female",861,210,193,117,459,94,205,23,254
1840232,21,27,1992,1,"female",222,380,123,2,13,2,3,0,10
1840260,14,30,1999,11,"female",460,2611,656,1551,1781,1355,1131,196,650
1840324,26,17,1987,9,"male",424,794,602,554,1055,523,893,31,162
1840341,25,21,1988,5,"female",244,94,86,0,5,0,5,0,0
1840354,32,12,1981,11,"male",484,260,89,3,13,3,13,0,0
1840384,26,7,1987,9,"male",355,169,102,37,59,37,45,0,14
1840392,26,21,1987,1,"female",558,184,9,0,46,0,1,0,45
1840397,59,23,1954,4,"male",209,30,18,3,2,0,2,3,0
1840439,15,11,1998,11,"female",139,354,247,162,103,162,102,0,1
1840460,26,9,1987,5,"female",144,284,136,49,250,47,119,2,131
1840485,28,14,1985,4,"male",752,374,255,12,0,12,0,0,0
1840497,27,28,1986,2,"male",470,197,197,17,2,12,1,5,1
1840505,20,21,1993,3,"male",235,30,16,2,10,2,9,0,1
1840594,40,15,1973,7,"male",251,69,21,23,63,23,37,0,26
1840616,18,2,1995,1,"male",673,3,0,0,0,0,0,0,0
1840640,24,15,1989,9,"male",681,122,38,0,0,0,0,0,0
1840695,19,1,1994,6,"female",261,15,4,14,75,14,29,0,46
1840729,108,28,1905,3,"female",1573,216,82,143,166,0,70,143,96
1840742,17,20,1996,9,"female",515,265,94,35,1,25,0,10,1
1840759,32,25,1981,5,"male",7,0,0,0,0,0,0,0,0
1840761,37,9,1976,11,"male",440,36,26,21,15,21,12,0,3
1840765,18,23,1995,12,"male",637,264,154,0,0,0,0,0,0
1840809,108,18,1905,12,"male",2,89,79,231,47,0,3,231,44
1840829,73,7,1940,10,"male",285,445,414,44,27,44,23,0,4
1840833,19,8,1994,8,"male",727,439,258,5,33,2,25,3,8
1840841,113,25,1900,9,"female",1396,297,104,0,0,0,0,0,0
1840916,17,2,1996,7,"female",190,410,117,196,252,196,223,0,29
1840928,73,11,1940,10,"female",1664,1888,293,63,65,63,40,0,25
1840935,55,29,1958,10,"male",594,399,199,19,1,0,0,19,1
1840956,51,22,1962,7,"male",543,19,15,1,2,0,0,1,2
1840999,19,19,1994,7,"male",503,45,21,11,1,0,0,11,1
1841006,17,21,1996,2,"female",612,653,264,220,647,220,424,0,223
1841016,15,22,1998,5,"female",169,91,71,59,20,47,11,12,9
1841019,35,5,1978,6,"male",323,54,41,0,2,0,0,0,2
1841039,35,3,1978,8,"male",177,40,28,1,0,1,0,0,0
1841051,56,27,1957,7,"female",391,30,19,13,34,13,20,0,14
1841060,20,23,1993,6,"male",229,79,57,26,2,26,2,0,0
1841063,18,16,1995,2,"male",252,266,186,1801,406,15,117,1786,289
1841078,49,24,1964,11,"male",387,33,23,1,2,0,0,1,2
1841094,24,15,1989,4,"male",355,222,177,1158,553,31,124,1127,429
1841168,28,7,1985,12,"male",107,84,64,46,93,5,71,41,22
1841177,14,19,1999,3,"female",258,103,62,20,4,20,3,0,1
1841180,21,14,1992,7,"male",507,478,397,24,13,19,3,5,10
1841195,30,24,1983,1,"male",306,98,55,3,14,3,14,0,0
1841206,103,1,1910,3,"male",1169,68,48,462,364,5,152,457,212
1841215,13,6,2000,2,"female",96,493,179,186,151,139,93,47,58
1841219,31,3,1982,5,"male",148,23,20,0,0,0,0,0,0
1841233,43,22,1970,6,"female",1719,115,55,124,229,2,72,122,157
1841247,75,3,1938,12,"female",1342,118,18,9,3,0,0,9,3
1841248,15,19,1998,7,"female",34,25,19,28,1,28,1,0,0
1841252,21,6,1992,9,"male",266,77,48,0,4,0,2,0,2
1841273,50,4,1963,8,"female",1263,98,66,43,25,13,11,30,14
1841280,27,1,1986,1,"male",91,0,0,0,0,0,0,0,0
1841287,66,24,1947,5,"female",1298,575,364,422,578,0,119,422,459
1841296,14,14,1999,2,"male",420,127,95,0,3,0,0,0,3
1841316,23,10,1990,4,"female",136,55,47,182,134,143,68,39,66
1841330,18,10,1995,10,"female",272,498,95,509,358,509,244,0,114
1841335,43,30,1970,3,"female",83,121,79,343,84,0,6,343,78
1841349,43,12,1970,8,"female",145,22,14,54,18,11,2,43,16
1841355,38,9,1975,2,"male",233,241,51,3,5,3,5,0,0
1841361,17,15,1996,12,"female",473,61,42,0,0,0,0,0,0
1841368,31,29,1982,7,"female",600,393,290,715,549,715,403,0,146
1841388,16,12,1997,5,"female",341,52,31,3,2,3,2,0,0
1841389,22,14,1991,12,"female",111,87,66,18,27,15,14,3,13
1841433,27,12,1986,8,"male",406,9,5,9,8,9,5,0,3
1841448,56,30,1957,8,"male",301,103,101,0,1,0,1,0,0
1841470,19,27,1994,9,"female",593,56,15,436,816,252,103,184,713
1841478,19,6,1994,4,"male",416,64,30,1,0,0,0,1,0
1841480,29,6,1984,5,"male",516,237,148,21,0,21,0,0,0
1841491,44,3,1969,8,"male",134,12,3,0,0,0,0,0,0
1841497,22,11,1991,7,"female",134,126,98,38,21,0,5,38,16
1841498,28,1,1985,1,"male",317,79,72,0,0,0,0,0,0
1841508,14,8,1999,3,"female",291,413,315,4,9,4,9,0,0
1841554,32,14,1981,3,"male",438,170,103,6,83,6,79,0,4
1841559,19,5,1994,3,"male",300,25,12,0,0,0,0,0,0
1841564,16,10,1997,3,"male",326,311,136,88,13,88,12,0,1
1841595,19,13,1994,10,"female",113,190,111,370,1021,313,623,57,398
1841597,23,27,1990,11,"male",333,12,6,35,12,23,10,12,2
1841599,23,25,1990,8,"female",209,553,272,1,138,1,86,0,52
1841604,49,13,1964,1,"female",727,98,42,155,143,155,87,0,56
1841605,18,13,1995,1,"male",607,159,77,34,6,22,1,12,5
1841618,13,4,2000,1,"female",126,40,30,17,1,17,1,0,0
1841626,93,4,1920,6,"male",1254,789,190,23,1,23,1,0,0
1841627,22,14,1991,9,"male",361,19,7,2,0,2,0,0,0
1841670,14,16,1999,7,"male",108,199,94,1,3,1,2,0,1
1841680,16,23,1997,3,"male",451,46,33,0,0,0,0,0,0
1841708,49,21,1964,11,"female",1365,355,113,32,46,32,33,0,13
1841729,60,31,1953,3,"female",81,16,8,0,0,0,0,0,0
1841734,17,13,1996,2,"female",143,163,83,279,322,279,274,0,48
1841745,47,9,1966,2,"male",881,2,2,2,1,0,0,2,1
1841751,52,18,1961,10,"male",335,0,0,0,0,0,0,0,0
1841766,31,25,1982,12,"male",369,165,159,55,0,55,0,0,0
1841792,14,1,1999,9,"male",112,5,5,0,0,0,0,0,0
1841806,62,27,1951,10,"female",49,38,22,91,189,15,126,76,63
1841819,17,18,1996,8,"male",272,92,45,2,26,0,11,2,15
1841822,19,8,1994,5,"male",514,266,181,690,58,666,22,24,36
1841844,60,6,1953,5,"female",727,95,57,0,31,0,4,0,27
1841852,68,1,1945,1,"male",723,83,46,13,24,13,17,0,7
1841867,41,9,1972,6,"male",679,57,52,3,3,3,3,0,0
1841892,44,14,1969,11,"female",265,111,54,4,0,4,0,0,0
1841904,18,3,1995,5,"female",392,266,61,19,68,19,38,0,30
1841916,59,16,1954,2,"female",1306,121,67,898,35,95,28,803,7
1841932,21,22,1992,8,"male",227,43,30,1,9,1,6,0,3
1841945,53,15,1960,11,"male",393,13,6,1,0,1,0,0,0
1841950,32,19,1981,11,"male",251,90,14,6,28,6,20,0,8
1841989,43,14,1970,2,"male",856,74,67,2,0,2,0,0,0
1842007,36,7,1977,6,"male",555,6,2,40,25,4,20,36,5
1842054,31,4,1982,6,"male",212,148,139,17,2,17,2,0,0
1842065,67,30,1946,12,"male",1983,217,140,315,73,51,41,264,32
1842101,47,7,1966,7,"female",1356,42,24,13,37,8,32,5,5
1842108,55,17,1958,11,"male",1468,169,43,5,9,5,3,0,6
1842118,22,12,1991,3,"male",284,130,99,148,114,69,38,79,76
1842152,24,21,1989,8,"male",417,91,51,5,1,0,0,5,1
1842227,41,31,1972,1,"male",354,123,92,14,9,14,5,0,4
1842232,43,10,1970,1,"female",409,58,29,584,247,55,32,529,215
1842250,36,1,1977,11,"male",54,5,4,0,0,0,0,0,0
1842253,58,19,1955,10,"male",452,29,14,9,1,0,1,9,0
1842258,16,13,1997,9,"female",134,112,93,43,56,43,40,0,16
1842301,29,8,1984,11,"male",747,21,6,1,5,0,4,1,1
1842304,108,10,1905,11,"female",1372,440,311,15,7,1,6,14,1
1842308,16,15,1997,4,"female",407,370,152,18,10,18,9,0,1
1842309,45,15,1968,10,"female",403,58,11,81,149,81,132,0,17
1842310,42,21,1971,6,"female",215,19,12,36,2,36,2,0,0
1842312,18,29,1995,10,"female",259,219,120,57,63,57,44,0,19
1842317,33,19,1980,12,"male",281,39,29,2,0,2,0,0,0
1842323,100,18,1913,11,"male",2208,107,76,0,0,0,0,0,0
1842334,108,13,1905,7,"female",249,17,13,9,2,9,2,0,0
1842343,26,30,1987,7,"female",368,78,37,0,9,0,7,0,2
1842351,26,3,1987,2,"female",199,23,18,9,10,9,8,0,2
1842379,26,2,1987,2,"male",334,20,15,11,8,11,8,0,0
1842381,34,1,1979,2,"male",647,150,67,0,1,0,1,0,0
1842384,85,25,1928,12,"male",1286,1057,474,6,81,6,63,0,18
1842395,24,24,1989,4,"male",361,166,139,4,6,4,2,0,4
1842436,25,27,1988,1,"female",68,206,44,3467,2005,3467,1718,0,287
1842447,48,21,1965,2,"female",105,148,106,36,23,0,0,36,23
1842451,41,17,1972,6,"female",85,50,37,101,62,0,13,101,49
1842454,17,1,1996,8,"male",1207,1717,1290,3,158,1,118,2,40
1842468,21,1,1992,8,"male",550,661,457,3160,1404,935,617,2225,787
1842541,66,27,1947,6,"female",1251,204,109,41,14,2,6,39,8
1842545,25,31,1988,8,"male",300,161,138,4,0,4,0,0,0
1842555,27,25,1986,6,"female",468,103,44,6,15,6,14,0,1
1842593,54,17,1959,2,"male",478,40,34,15,3,0,0,15,3
1842612,19,1,1994,3,"male",183,111,82,1425,327,1424,226,1,101
1842634,47,26,1966,6,"female",1753,455,189,712,707,457,429,255,278
1842647,68,24,1945,1,"male",1518,2,1,90,20,0,4,90,16
1842658,20,7,1993,4,"female",91,31,27,0,0,0,0,0,0
1842668,20,4,1993,7,"female",203,99,44,31,5,31,4,0,1
1842692,33,15,1980,2,"male",360,6,4,0,1,0,0,0,1
1842711,37,10,1976,8,"female",130,215,29,18,50,18,38,0,12
1842728,58,11,1955,1,"male",638,125,72,3,6,3,6,0,0
1842733,56,21,1957,6,"female",1233,367,277,538,478,538,367,0,111
1842738,23,30,1990,8,"female",590,1697,656,1530,3780,420,1007,1110,2773
1842750,27,1,1986,2,"male",423,15,14,2,2,0,0,2,2
1842779,22,22,1991,8,"male",583,1470,1030,851,531,851,501,0,30
1842815,17,18,1996,2,"male",377,397,295,52,91,34,54,18,37
1842844,20,14,1993,3,"male",585,170,136,0,1,0,1,0,0
1842851,51,1,1962,4,"male",1701,359,256,16,85,5,65,11,20
1842852,69,11,1944,3,"male",1401,26,13,20,31,11,24,9,7
1842863,33,4,1980,11,"male",285,2,2,0,0,0,0,0,0
1842891,17,8,1996,3,"male",919,512,279,21,20,2,10,19,10
1842898,15,4,1998,2,"female",2,2,2,0,0,0,0,0,0
1842901,32,20,1981,2,"male",736,355,295,13,54,13,54,0,0
1842905,52,9,1961,8,"male",182,0,0,0,0,0,0,0,0
1842911,22,7,1991,7,"male",54,2,0,0,0,0,0,0,0
1842946,29,14,1984,9,"male",269,79,54,0,0,0,0,0,0
1842950,59,28,1954,4,"male",1163,143,76,630,183,529,119,101,64
1842952,29,9,1984,5,"female",541,68,44,0,1,0,1,0,0
1842960,20,4,1993,12,"male",357,1,1,0,0,0,0,0,0
1843006,21,5,1992,5,"female",495,1048,613,20,359,9,178,11,181
1843024,40,11,1973,9,"male",24,47,47,33,9,33,5,0,4
1843026,49,20,1964,1,"female",1667,131,56,711,808,708,425,3,383
1843044,57,5,1956,6,"male",825,78,68,126,28,126,25,0,3
1843058,15,19,1998,10,"male",80,45,34,40,6,0,2,40,4
1843074,28,30,1985,4,"female",1232,788,267,51,80,51,79,0,1
1843092,22,11,1991,1,"female",549,200,133,118,35,22,10,96,25
1843108,35,15,1978,6,"female",1443,635,427,180,136,178,85,2,51
1843208,72,22,1941,8,"female",1228,337,299,1307,424,182,191,1125,233
1843213,27,5,1986,9,"male",57,23,20,0,60,0,14,0,46
1843218,26,18,1987,1,"male",593,27,17,2,0,2,0,0,0
1843234,20,3,1993,10,"male",349,65,41,161,52,161,37,0,15
1843247,16,24,1997,9,"female",452,192,162,36,3,36,3,0,0
1843281,25,7,1988,12,"female",442,486,405,27,13,0,0,27,13
1843285,19,14,1994,2,"female",417,424,90,9,112,9,90,0,22
1843287,41,21,1972,10,"female",303,12,4,26,15,26,13,0,2
1843292,52,10,1961,2,"female",1731,129,87,1756,1851,421,572,1335,1279
1843323,18,28,1995,4,"female",282,63,40,0,1,0,0,0,1
1843344,27,10,1986,6,"female",419,304,161,467,121,352,41,115,80
1843354,18,4,1995,10,"male",530,991,330,181,685,80,358,101,327
1843360,21,1,1992,6,"male",234,59,58,0,0,0,0,0,0
1843402,17,16,1996,11,"male",461,312,270,1,0,0,0,1,0
1843491,21,31,1992,5,"male",312,189,103,31,50,31,46,0,4
1843519,47,6,1966,12,"female",737,123,70,123,79,60,34,63,45
1843548,68,14,1945,2,"male",711,24,18,0,1,0,0,0,1
1843558,21,23,1992,11,"female",351,58,19,27,0,27,0,0,0
1843567,33,31,1980,5,"male",63,45,37,2,0,2,0,0,0
1843587,38,25,1975,9,"male",2027,993,587,256,240,191,142,65,98
1843590,32,1,1981,8,"male",282,242,128,1,66,1,47,0,19
1843594,38,22,1975,1,"female",320,17,12,194,101,193,67,1,34
1843616,22,27,1991,8,"male",201,24,8,1,8,1,3,0,5
1843626,65,15,1948,8,"female",1717,77,46,150,177,150,91,0,86
1843655,24,22,1989,5,"male",419,251,172,26,65,26,56,0,9
1843722,46,12,1967,11,"female",286,23,10,12,12,2,11,10,1
1843723,43,16,1970,2,"male",557,39,20,2,2,2,0,0,2
1843778,100,4,1913,1,"male",487,128,111,11,13,8,12,3,1
1843785,24,20,1989,10,"male",216,15,9,3,3,3,2,0,1
1843798,20,17,1993,10,"male",431,185,155,29,0,27,0,2,0
1843802,14,20,1999,3,"male",412,231,97,145,4,63,1,82,3
1843805,21,7,1992,4,"male",128,8,6,0,0,0,0,0,0
1843810,49,24,1964,5,"male",1254,108,44,0,0,0,0,0,0
1843824,15,16,1998,4,"female",225,61,41,49,66,0,46,49,20
1843833,56,24,1957,10,"female",296,13,13,0,14,0,0,0,14
1843865,19,21,1994,3,"male",366,44,37,0,2,0,0,0,2
1843867,17,27,1996,11,"female",114,349,327,823,475,462,270,361,205
1843908,30,9,1983,1,"male",189,5,0,0,0,0,0,0,0
1843928,18,11,1995,1,"female",157,42,22,3,42,3,10,0,32
1843967,19,3,1994,1,"male",638,604,415,55,58,55,23,0,35
1843975,29,6,1984,6,"male",615,1,1,0,0,0,0,0,0
1843978,108,25,1905,12,"male",1475,600,319,11,16,0,8,11,8
1844012,20,3,1993,3,"male",586,175,121,0,2,0,0,0,2
1844024,76,16,1937,5,"male",687,218,174,40,9,0,1,40,8
1844046,32,8,1981,9,"male",766,8,4,0,0,0,0,0,0
1844061,17,6,1996,8,"female",217,290,30,7,14,6,10,1,4
1844072,22,14,1991,11,"female",472,291,140,119,96,117,33,2,63
1844073,17,22,1996,4,"male",89,949,609,1942,1727,1034,1335,908,392
1844078,14,13,1999,12,"male",92,49,37,0,0,0,0,0,0
1844100,37,30,1976,9,"male",59,20,12,1,23,1,21,0,2
1844123,15,1,1998,8,"female",316,324,136,19,19,19,16,0,3
1844134,28,15,1985,3,"male",15,36,7,0,2,0,1,0,1
1844168,21,4,1992,12,"male",216,20,1,0,1,0,0,0,1
1844169,25,16,1988,5,"female",283,5,5,20,0,19,0,1,0
1844174,15,28,1998,8,"female",591,629,453,1793,473,1479,152,314,321
1844205,70,29,1943,10,"male",1331,22,19,7,32,0,10,7,22
1844218,15,2,1998,1,"female",275,9,8,2,0,2,0,0,0
1844231,17,26,1996,4,"male",1441,325,237,7,0,0,0,7,0
1844237,32,4,1981,10,"female",105,11,7,16,21,0,0,16,21
1844239,44,29,1969,1,"male",221,29,11,0,12,0,8,0,4
1844258,19,26,1994,9,"male",311,201,125,0,0,0,0,0,0
1844284,15,2,1998,1,"male",254,147,72,0,7,0,2,0,5
1844288,18,13,1995,9,"female",298,28,3,77,96,77,85,0,11
1844318,24,13,1989,3,"female",215,50,23,17,29,17,24,0,5
1844322,24,26,1989,2,"male",188,32,19,0,0,0,0,0,0
1844364,66,23,1947,4,"female",1062,34,8,21,24,0,3,21,21
1844365,64,6,1949,1,"male",1544,61,35,109,46,80,24,29,22
1844380,106,11,1907,7,"male",2174,202,117,14,47,4,34,10,13
1844381,31,11,1982,8,"male",421,33,16,521,26,521,24,0,2
1844398,68,25,1945,12,"female",314,135,111,2,1,0,0,2,1
1844401,14,12,1999,3,"female",258,40,28,13,0,13,0,0,0
1844412,26,18,1987,7,"female",144,122,105,149,75,149,59,0,16
1844425,18,10,1995,5,"female",397,517,353,0,0,0,0,0,0
1844430,22,18,1991,2,"male",354,3,3,0,0,0,0,0,0
1844433,58,3,1955,6,"female",1493,45,31,57,4,57,2,0,2
1844441,23,8,1990,1,"female",132,242,107,1539,3032,1539,2719,0,313
1844445,31,23,1982,10,"female",80,70,16,157,151,0,48,157,103
1844478,14,24,1999,3,"female",551,1104,800,1,70,1,47,0,23
1844509,28,1,1985,6,"female",261,230,68,783,665,783,589,0,76
1844522,32,4,1981,6,"male",346,16,11,2,1,2,1,0,0
1844558,21,15,1992,5,"female",556,27,14,3,0,3,0,0,0
1844580,34,12,1979,1,"male",184,61,41,10,27,10,22,0,5
1844604,61,18,1952,7,"female",885,161,77,56,81,56,55,0,26
1844606,15,8,1998,9,"female",146,76,64,2,4,2,4,0,0
1844614,32,19,1981,11,"female",609,162,54,830,1177,830,649,0,528
1844624,73,27,1940,8,"male",1733,106,41,83,74,79,34,4,40
1844638,38,3,1975,6,"female",249,25,18,0,0,0,0,0,0
1844653,23,14,1990,8,"female",503,1802,1668,1,36,1,15,0,21
1844698,100,19,1913,3,"male",2473,4765,2668,5,1,0,1,5,0
1844762,21,1,1992,8,"female",707,207,87,9,17,4,4,5,13
1844782,50,26,1963,4,"female",86,20,17,2,0,2,0,0,0
1844785,16,22,1997,6,"male",400,96,79,0,0,0,0,0,0
1844812,16,9,1997,10,"male",24,5,5,0,0,0,0,0,0
1844830,14,10,1999,7,"male",79,66,60,0,0,0,0,0,0
1844835,18,17,1995,1,"female",1397,673,287,162,370,145,121,17,249
1844870,48,15,1965,12,"female",691,84,35,18,85,18,62,0,23
1844878,26,12,1987,4,"male",423,9,9,0,0,0,0,0,0
1844903,15,28,1998,2,"male",951,474,302,0,2,0,2,0,0
1844912,19,9,1994,4,"female",559,263,129,44,9,44,9,0,0
1844940,59,25,1954,11,"female",215,42,27,3,1,3,1,0,0
1844972,68,5,1945,2,"male",1363,54,10,403,90,29,83,374,7
1844975,22,4,1991,6,"male",37,0,0,81,0,81,0,0,0
1844988,52,29,1961,10,"male",481,3,3,0,0,0,0,0,0
1844991,50,6,1963,5,"male",39,14,11,0,1,0,0,0,1
1844996,108,29,1905,5,"male",1041,1736,947,616,1642,616,1364,0,278
1845004,70,27,1943,4,"female",4,2,2,0,0,0,0,0,0
1845006,103,7,1910,4,"female",1443,931,159,68,181,56,124,12,57
1845016,82,21,1931,5,"male",142,15,10,38,0,0,0,38,0
1845064,50,4,1963,4,"male",220,1,0,0,0,0,0,0,0
1845074,15,24,1998,4,"male",165,85,50,488,225,483,145,5,80
1845105,31,5,1982,11,"female",451,214,193,95,4,95,3,0,1
1845135,40,15,1973,4,"male",596,0,0,0,0,0,0,0,0
1845141,108,20,1905,12,"female",902,194,103,62,4,62,4,0,0
1845173,14,2,1999,8,"female",445,1970,1397,1128,8581,331,1989,797,6592
1845191,100,19,1913,6,"male",1590,129,51,41,26,41,9,0,17
1845211,42,1,1971,1,"female",220,2,2,0,0,0,0,0,0
1845215,21,24,1992,4,"male",351,86,64,0,3,0,3,0,0
1845244,26,23,1987,7,"female",288,19,16,6,5,6,4,0,1
1845264,16,30,1997,10,"male",0,0,0,4,4,4,4,0,0
1845266,33,8,1980,10,"female",628,133,112,0,5,0,2,0,3
1845269,50,27,1963,7,"female",952,448,158,1127,313,1028,274,99,39
1845282,24,4,1989,1,"male",195,52,14,4,9,4,0,0,9
1845305,21,5,1992,1,"male",579,437,394,91,96,90,90,1,6
1845350,18,16,1995,4,"female",109,9,5,163,13,163,13,0,0
1845353,21,5,1992,12,"male",296,90,73,2,0,2,0,0,0
1845358,113,21,1900,8,"male",1570,138,13,0,14,0,10,0,4
1845374,19,24,1994,3,"female",64,266,243,0,7,0,5,0,2
1845377,22,1,1991,5,"male",569,322,173,2,4,2,3,0,1
1845383,71,22,1942,4,"male",1823,53,16,115,16,10,9,105,7
1845386,52,24,1961,6,"female",449,112,66,380,149,380,124,0,25
1845394,18,19,1995,11,"female",639,411,236,90,305,90,210,0,95
1845402,15,3,1998,10,"male",303,44,43,0,0,0,0,0,0
1845404,39,9,1974,2,"female",934,299,153,2238,773,1092,550,1146,223
1845410,23,27,1990,5,"male",208,241,97,9,2,9,1,0,1
1845434,67,14,1946,7,"female",14,6,6,3,7,3,7,0,0
1845478,90,23,1923,3,"male",1490,172,128,1469,284,1385,203,84,81
1845488,27,23,1986,7,"female",276,60,43,7,25,7,21,0,4
1845536,44,24,1969,10,"male",628,61,39,213,108,188,63,25,45
1845568,62,8,1951,2,"female",1213,114,58,27,20,27,9,0,11
1845581,66,1,1947,8,"male",415,8,1,2,0,2,0,0,0
1845583,23,19,1990,10,"male",272,4274,100,170,3488,169,2861,1,627
1845590,53,23,1960,4,"male",523,366,241,28,2,0,0,28,2
1845621,108,26,1905,10,"male",1102,75,33,20,12,0,1,20,11
1845625,33,20,1980,10,"male",251,619,529,5,4,2,2,3,2
1845631,18,30,1995,4,"female",107,46,27,80,30,79,20,1,10
1845633,21,16,1992,9,"male",276,93,56,0,1,0,1,0,0
1845638,51,19,1962,8,"male",403,18,10,0,0,0,0,0,0
1845647,28,15,1985,8,"male",1106,80,64,1,0,1,0,0,0
1845662,16,21,1997,8,"male",295,262,147,18,4,16,2,2,2
1845666,27,10,1986,7,"male",525,73,36,0,2,0,2,0,0
1845678,19,6,1994,7,"male",329,251,119,1,12,1,9,0,3
1845679,31,14,1982,6,"male",149,22,18,0,0,0,0,0,0
1845729,92,28,1921,10,NA,2290,145,90,0,0,0,0,0,0
1845749,40,19,1973,2,"male",504,37,12,95,0,95,0,0,0
1845774,36,15,1977,10,"female",182,164,145,649,1117,1,228,648,889
1845809,18,25,1995,11,"female",344,278,51,81,174,81,116,0,58
1845813,19,1,1994,1,"female",376,691,302,4,250,4,100,0,150
1845855,30,21,1983,2,"male",392,66,30,1,4,1,3,0,1
1845902,74,22,1939,9,"female",304,0,0,0,0,0,0,0,0
1845906,17,12,1996,12,"male",502,54,52,0,0,0,0,0,0
1845935,19,4,1994,8,"male",507,13,7,0,0,0,0,0,0
1845959,18,5,1995,12,"male",286,65,55,0,1,0,1,0,0
1845981,50,21,1963,9,"female",619,53,42,22,1,22,1,0,0
1846018,17,10,1996,5,"male",476,33,25,234,43,234,29,0,14
1846021,17,27,1996,11,"male",1129,748,541,0,6,0,4,0,2
1846037,63,5,1950,12,"male",492,15,11,8,3,0,1,8,2
1846043,15,24,1998,12,"female",96,930,230,1148,2062,54,1575,1094,487
1846049,27,17,1986,1,"male",60,39,38,29,5,29,5,0,0
1846051,32,23,1981,10,"female",457,37,15,35,2,35,1,0,1
1846052,54,22,1959,6,"female",1294,138,62,220,200,92,97,128,103
1846058,26,1,1987,1,"female",612,3,1,0,0,0,0,0,0
1846065,59,14,1954,7,"male",1565,204,114,54,62,54,37,0,25
1846081,52,10,1961,3,"male",570,24,13,37,15,0,3,37,12
1846106,46,30,1967,3,"male",103,132,99,1,32,0,11,1,21
1846122,54,1,1959,11,"female",254,31,18,0,3,0,2,0,1
1846132,22,17,1991,4,"male",348,101,77,0,0,0,0,0,0
1846158,24,8,1989,9,"female",308,136,61,328,678,282,437,46,241
1846173,28,27,1985,4,"male",188,80,52,2,81,2,37,0,44
1846182,23,19,1990,4,"female",728,1,1,0,0,0,0,0,0
1846197,22,21,1991,6,"male",552,432,349,1,30,0,20,1,10
1846199,52,22,1961,4,"female",353,100,85,1097,104,1097,88,0,16
1846211,34,10,1979,7,"male",557,127,68,21,23,21,15,0,8
1846225,50,19,1963,9,"male",418,29,13,1,0,1,0,0,0
1846237,33,24,1980,1,"male",154,242,83,87,65,62,3,25,62
1846245,20,1,1993,1,"male",355,51,32,2,12,0,5,2,7
1846275,17,18,1996,5,"male",276,3,1,8,2,8,2,0,0
1846286,54,27,1959,6,"male",52,21,20,60,40,0,0,60,40
1846393,14,7,1999,8,"female",268,389,90,4,4,4,4,0,0
1846398,17,6,1996,6,"male",340,36,21,3,14,2,2,1,12
1846404,17,29,1996,11,"male",686,326,261,6,3,0,0,6,3
1846424,34,22,1979,10,"male",617,68,56,0,0,0,0,0,0
1846430,19,20,1994,10,"male",257,163,65,9,11,9,11,0,0
1846463,19,6,1994,4,"female",357,399,189,34,101,34,99,0,2
1846472,15,10,1998,8,"male",24,3,3,0,0,0,0,0,0
1846535,18,13,1995,1,"male",117,23,15,0,0,0,0,0,0
1846540,16,16,1997,5,"male",252,74,52,51,1,0,0,51,1
1846548,59,14,1954,5,"male",1739,30,12,1,2,1,2,0,0
1846575,23,3,1990,8,"female",401,98,26,0,20,0,19,0,1
1846583,25,23,1988,4,"male",523,385,35,72,28,72,10,0,18
1846584,13,1,2000,1,"female",24,6,6,0,0,0,0,0,0
1846606,63,25,1950,6,"female",205,134,113,4,32,0,0,4,32
1846624,20,19,1993,9,"male",435,2939,984,1856,2704,1523,2397,333,307
1846636,18,13,1995,9,"male",273,159,106,134,26,98,9,36,17
1846639,24,23,1989,7,"female",837,579,431,944,764,873,372,71,392
1846661,108,10,1905,4,"female",2296,405,197,21,41,17,24,4,17
1846664,26,11,1987,1,"male",431,33,22,0,1,0,0,0,1
1846714,20,17,1993,11,"female",279,529,66,2,9,2,6,0,3
1846736,28,3,1985,2,"female",81,1,1,0,0,0,0,0,0
1846816,26,13,1987,2,"male",651,29,13,2,2,2,1,0,1
1846828,23,13,1990,12,"male",198,85,79,12,17,0,3,12,14
1846829,54,2,1959,2,"female",475,27,9,4,0,0,0,4,0
1846844,33,13,1980,1,"male",558,1,0,0,0,0,0,0,0
1846846,35,26,1978,4,"male",431,112,64,22,13,19,9,3,4
1846872,23,29,1990,8,"male",61,116,34,25,43,25,32,0,11
1846890,69,26,1944,12,"female",1174,80,31,52,26,0,21,52,5
1846921,64,4,1949,5,"female",2241,23,2,0,0,0,0,0,0
1846926,18,19,1995,9,"male",641,389,135,48,7,15,5,33,2
1847011,25,2,1988,8,"female",550,30,19,36,4,12,0,24,4
1847026,39,1,1974,9,"male",519,98,67,1,5,0,1,1,4
1847030,51,26,1962,9,"female",132,64,47,717,300,717,176,0,124
1847039,57,11,1956,3,"male",726,192,137,17,6,0,1,17,5
1847059,57,12,1956,5,"male",468,270,245,155,51,12,14,143,37
1847060,42,17,1971,9,"female",456,333,55,5,12,5,7,0,5
1847061,54,27,1959,4,"female",38,18,11,33,18,33,16,0,2
1847100,31,17,1982,6,"male",431,53,49,0,8,0,7,0,1
1847130,21,11,1992,4,"male",359,451,375,581,751,581,483,0,268
1847177,30,8,1983,6,"female",242,118,84,119,71,101,45,18,26
1847203,20,1,1993,1,"male",160,83,35,101,133,101,108,0,25
1847204,19,25,1994,6,"female",162,26,19,12,3,3,1,9,2
1847255,64,9,1949,11,"male",1635,51,12,0,1,0,0,0,1
1847257,98,1,1915,1,"male",1288,407,344,356,213,327,103,29,110
1847277,34,26,1979,8,"male",406,68,46,9,6,0,1,9,5
1847281,18,6,1995,3,"male",504,234,139,103,25,100,14,3,11
1847342,21,25,1992,2,"male",22,70,66,9,52,9,25,0,27
1847346,79,29,1934,8,"female",1832,47,17,6,1,0,0,6,1
1847367,37,14,1976,7,"female",267,41,28,2,10,2,5,0,5
1847381,109,1,1904,1,"female",2330,360,61,64,68,64,57,0,11
1847393,25,1,1988,1,"female",108,24,0,0,2,0,0,0,2
1847402,33,17,1980,3,"male",1130,16,15,0,0,0,0,0,0
1847421,60,5,1953,9,"female",1272,199,52,52,67,51,40,1,27
1847435,16,21,1997,4,"female",452,47,23,5,5,5,1,0,4
1847450,18,20,1995,9,"male",25,132,123,90,27,25,16,65,11
1847460,20,12,1993,2,"male",197,22,21,0,0,0,0,0,0
1847488,38,10,1975,10,"male",194,134,97,0,0,0,0,0,0
1847523,46,30,1967,3,"male",810,58,19,24,37,8,22,16,15
1847534,58,24,1955,12,"male",1038,49,5,0,1,0,1,0,0
1847540,57,19,1956,4,"male",1383,74,33,20,8,0,7,20,1
1847547,20,29,1993,9,"female",148,32,12,296,155,296,123,0,32
1847582,19,6,1994,11,"male",511,287,186,94,112,86,96,8,16
1847640,23,25,1990,2,"female",522,133,61,169,85,169,75,0,10
1847641,18,23,1995,1,"female",401,172,122,137,48,137,26,0,22
1847655,36,23,1977,4,"female",261,46,24,0,1,0,1,0,0
1847656,30,22,1983,6,"female",139,167,123,276,127,158,62,118,65
1847671,67,8,1946,12,"male",477,23,16,9,3,9,1,0,2
1847682,28,7,1985,12,"male",647,192,165,19,3,19,3,0,0
1847691,30,12,1983,2,"female",409,250,140,13,14,1,4,12,10
1847698,63,23,1950,9,"male",801,64,37,13,15,11,13,2,2
1847699,49,28,1964,2,"female",628,34,17,0,0,0,0,0,0
1847727,23,4,1990,3,"female",188,16,10,344,200,222,45,122,155
1847751,25,25,1988,12,"female",49,15,11,0,19,0,5,0,14
1847753,57,15,1956,11,"male",507,38,13,47,23,13,15,34,8
1847757,62,15,1951,8,"female",456,73,46,1,0,0,0,1,0
1847791,14,23,1999,8,"female",555,59,39,27,13,27,8,0,5
1847808,25,19,1988,8,"female",247,460,233,24,126,24,100,0,26
1847835,103,13,1910,1,"female",718,234,43,5,6,5,4,0,2
1847838,54,19,1959,11,"female",293,59,38,55,1,55,1,0,0
1847864,68,3,1945,3,"male",1142,271,175,16,10,0,5,16,5
1847942,18,28,1995,10,"female",311,262,111,317,507,317,244,0,263
1847982,76,19,1937,3,"female",251,99,60,243,208,243,158,0,50
1847995,21,13,1992,6,"female",796,1081,715,323,497,314,342,9,155
1848001,19,9,1994,1,"male",1234,529,418,3,4,3,3,0,1
1848014,21,28,1992,3,"female",332,328,78,530,462,513,201,17,261
1848017,24,30,1989,10,"female",698,77,37,2,12,2,2,0,10
1848022,31,9,1982,8,"female",282,49,31,219,54,219,32,0,22
1848032,22,28,1991,4,"male",260,2,1,19,9,0,2,19,7
1848039,23,1,1990,1,"female",611,64,18,4,4,4,2,0,2
1848042,22,28,1991,11,"male",492,202,133,2,2,0,0,2,2
1848044,18,9,1995,2,"male",488,55,47,0,0,0,0,0,0
1848069,108,27,1905,12,"female",1777,280,73,45,62,1,42,44,20
1848094,27,6,1986,8,"male",488,81,35,18,0,18,0,0,0
1848132,33,4,1980,1,"female",30,3,3,0,0,0,0,0,0
1848168,103,3,1910,7,"male",1539,317,227,44,34,44,18,0,16
1848172,22,8,1991,12,"female",84,15,10,42,29,28,11,14,18
1848208,19,29,1994,5,"female",522,211,115,1,5,1,3,0,2
1848210,108,1,1905,1,"male",885,111,90,3,1,3,0,0,1
1848259,40,18,1973,12,"female",315,20,8,53,36,53,36,0,0
1848260,28,6,1985,11,"male",1475,11,8,0,1,0,0,0,1
1848272,61,27,1952,5,"female",112,76,56,42,16,5,7,37,9
1848288,32,7,1981,8,"female",141,212,202,3,65,3,24,0,41
1848299,21,3,1992,11,"female",369,352,248,11,32,11,10,0,22
1848337,19,13,1994,11,"male",711,121,69,0,1,0,0,0,1
1848354,26,26,1987,10,"female",299,57,37,38,30,20,10,18,20
1848363,19,4,1994,12,"male",467,513,426,12,25,12,23,0,2
1848366,19,23,1994,8,"female",343,186,113,2952,2062,444,650,2508,1412
1848399,57,17,1956,3,"male",798,59,27,6,154,0,62,6,92
1848420,23,11,1990,3,"female",235,124,99,4,10,4,10,0,0
1848431,49,26,1964,5,"female",796,74,38,22,17,16,7,6,10
1848437,19,10,1994,2,"male",746,122,78,0,0,0,0,0,0
1848447,62,24,1951,6,"female",1054,62,28,15,23,15,15,0,8
1848453,19,1,1994,3,"male",346,332,239,471,120,315,113,156,7
1848459,19,23,1994,10,"male",361,1394,1242,276,226,260,185,16,41
1848469,103,19,1910,1,"male",1327,513,154,0,45,0,35,0,10
1848471,55,30,1958,8,"male",282,33,25,32,5,32,2,0,3
1848474,56,4,1957,8,"male",1761,82,60,0,16,0,11,0,5
1848502,108,10,1905,7,"male",220,366,322,133,220,95,124,38,96
1848510,16,3,1997,4,"male",15,101,98,61,30,37,4,24,26
1848547,25,11,1988,3,"male",232,3,3,0,0,0,0,0,0
1848569,29,2,1984,7,"female",15,0,0,0,0,0,0,0,0
1848583,24,1,1989,12,"female",349,261,82,562,723,562,653,0,70
1848610,31,5,1982,4,"male",409,15,8,0,1,0,1,0,0
1848744,21,12,1992,12,"male",128,15,14,0,0,0,0,0,0
1848756,19,6,1994,6,"female",151,855,669,1529,680,1054,595,475,85
1848767,25,1,1988,1,"male",224,13,8,0,3,0,3,0,0
1848799,52,2,1961,11,"male",113,38,29,3,1,0,0,3,1
1848813,63,23,1950,10,"male",343,50,20,20,1,6,1,14,0
1848817,17,12,1996,12,"male",222,112,88,0,10,0,4,0,6
1848828,41,9,1972,5,"male",653,2,0,0,0,0,0,0,0
1848839,62,29,1951,9,"female",161,20,18,442,143,440,116,2,27
1848843,17,10,1996,5,"male",595,97,71,0,0,0,0,0,0
1848864,37,7,1976,6,"male",624,62,19,39,17,39,7,0,10
1848868,29,18,1984,7,"male",460,82,40,9,64,6,64,3,0
1848904,26,1,1987,1,"male",490,78,57,0,0,0,0,0,0
1848958,24,28,1989,7,"female",162,90,61,29,49,29,24,0,25
1848966,21,23,1992,5,"male",271,69,26,0,11,0,11,0,0
1848973,50,15,1963,8,"female",665,38,22,58,28,2,13,56,15
1848974,22,10,1991,3,"female",242,16,12,1,0,1,0,0,0
1849008,23,5,1990,7,"female",179,738,499,273,75,273,60,0,15
1849011,103,2,1910,11,"male",1999,328,109,645,646,184,313,461,333
1849033,15,5,1998,4,"male",233,39,30,0,0,0,0,0,0
1849094,41,1,1972,6,"female",652,56,34,2,1,0,1,2,0
1849118,57,16,1956,3,"female",1647,80,57,71,13,38,8,33,5
1849121,41,25,1972,11,"male",687,19,5,0,0,0,0,0,0
1849134,94,1,1919,9,"male",160,57,53,20,6,20,5,0,1
1849137,57,28,1956,10,"male",1638,609,319,1,5,0,0,1,5
1849149,62,17,1951,12,"female",574,27,11,9,0,6,0,3,0
1849154,60,27,1953,4,"female",442,85,59,11,16,10,13,1,3
1849180,22,1,1991,2,"female",471,70,25,4,11,4,11,0,0
1849196,34,12,1979,12,"male",238,30,12,0,2,0,0,0,2
1849208,23,11,1990,12,"male",91,26,24,3,0,3,0,0,0
1849219,49,12,1964,7,"female",343,14,6,1,6,1,5,0,1
1849225,31,15,1982,12,"male",675,319,237,7,0,7,0,0,0
1849256,42,21,1971,2,"male",152,26,19,92,72,86,20,6,52
1849294,57,15,1956,6,"female",808,58,40,82,30,0,0,82,30
1849372,23,6,1990,6,"male",167,54,40,12,7,12,5,0,2
1849408,52,3,1961,6,"female",823,51,40,604,314,604,87,0,227
1849425,103,6,1910,11,"male",620,88,56,5,0,1,0,4,0
1849432,42,28,1971,8,"male",541,13,8,0,0,0,0,0,0
1849434,26,12,1987,12,"male",849,169,64,17,44,8,34,9,10
1849490,17,5,1996,11,"female",373,539,412,174,33,5,19,169,14
1849562,29,22,1984,6,"male",519,42,20,10,35,10,14,0,21
1849575,15,14,1998,10,"female",22,88,73,1,6,1,3,0,3
1849583,17,15,1996,12,"male",228,122,102,133,2,133,2,0,0
1849584,30,28,1983,1,"male",591,149,84,1,1,1,0,0,1
1849586,21,20,1992,2,"male",296,166,124,6,114,6,56,0,58
1849615,23,29,1990,4,"female",495,348,208,82,43,82,34,0,9
1849616,103,23,1910,8,"female",926,242,142,78,35,0,10,78,25
1849657,20,17,1993,8,"male",214,0,0,0,0,0,0,0,0
1849659,27,9,1986,9,"male",221,122,105,0,0,0,0,0,0
1849669,77,8,1936,5,"male",322,33,22,3,0,0,0,3,0
1849683,39,1,1974,5,"male",313,56,52,0,0,0,0,0,0
1849691,44,24,1969,2,"female",1824,184,115,35,93,0,57,35,36
1849699,54,7,1959,3,"male",109,1,0,1,1,1,1,0,0
1849701,61,18,1952,7,"female",105,34,27,101,16,101,16,0,0
1849712,20,1,1993,4,"female",181,293,46,13,8,13,6,0,2
1849751,39,6,1974,7,"male",826,65,22,7,33,7,21,0,12
1849808,21,8,1992,7,"male",36,65,59,0,0,0,0,0,0
1849851,32,28,1981,1,"male",23,2,0,0,0,0,0,0,0
1849872,37,4,1976,3,"male",316,78,69,8,0,8,0,0,0
1849919,71,13,1942,2,"male",1781,38,4,11,0,11,0,0,0
1849931,45,1,1968,1,"male",1462,1,1,25,3,25,1,0,2
1849936,28,3,1985,10,"female",499,198,55,101,21,101,20,0,1
1849937,18,18,1995,10,"female",413,200,94,198,218,83,136,115,82
1849942,32,24,1981,7,"female",237,196,148,702,472,702,339,0,133
1849951,42,20,1971,6,"female",868,32,15,612,337,603,222,9,115
1849971,27,14,1986,9,"male",61,58,26,0,0,0,0,0,0
1849972,22,6,1991,9,"male",620,1529,683,370,413,93,135,277,278
1849987,28,22,1985,11,"female",748,37,25,0,0,0,0,0,0
1849996,94,4,1919,12,"female",2313,154,62,72,110,63,76,9,34
1850023,32,8,1981,9,"female",559,338,219,0,5,0,5,0,0
1850026,25,11,1988,11,"male",117,6,4,2,2,2,2,0,0
1850035,77,26,1936,8,"male",403,51,36,11,10,0,3,11,7
1850036,27,11,1986,7,"male",85,43,39,12,1,12,0,0,1
1850045,54,5,1959,12,"female",425,19,11,11,20,0,9,11,11
1850048,66,3,1947,2,"female",369,3,2,16,2,16,0,0,2
1850051,68,28,1945,12,"female",627,79,56,120,53,2,22,118,31
1850072,19,16,1994,5,"male",521,119,103,0,0,0,0,0,0
1850075,31,30,1982,1,"female",468,56,37,32,32,32,32,0,0
1850078,75,7,1938,5,"male",432,29,14,38,20,0,7,38,13
1850088,20,21,1993,8,"female",503,304,129,162,218,162,89,0,129
1850093,23,20,1990,11,"male",79,3,2,1,0,1,0,0,0
1850094,21,30,1992,6,"female",626,256,79,3,1,3,1,0,0
1850147,16,7,1997,8,"female",59,19,12,0,3,0,0,0,3
1850174,17,3,1996,9,"male",575,267,223,37,15,5,8,32,7
1850179,90,2,1923,3,"male",1640,238,112,0,4,0,4,0,0
1850188,29,21,1984,9,"female",718,121,69,0,1,0,0,0,1
1850190,50,31,1963,5,"male",434,265,178,0,0,0,0,0,0
1850214,33,8,1980,3,"male",164,31,20,0,0,0,0,0,0
1850266,18,9,1995,8,"male",394,29,27,0,0,0,0,0,0
1850287,21,19,1992,9,"male",499,247,207,0,0,0,0,0,0
1850299,49,26,1964,1,"female",869,126,68,1,2,1,0,0,2
1850410,49,21,1964,1,"female",348,197,127,189,60,12,48,177,12
1850424,21,2,1992,12,"female",491,230,110,6,43,6,38,0,5
1850470,18,7,1995,3,"male",651,330,265,366,290,192,233,174,57
1850476,55,26,1958,2,"female",62,17,12,62,6,32,3,30,3
1850490,19,10,1994,5,"female",136,67,45,1223,235,1155,203,68,32
1850500,27,6,1986,5,"female",190,101,91,46,14,19,6,27,8
1850510,22,29,1991,9,"female",281,61,29,6,8,0,5,6,3
1850527,28,28,1985,11,"female",346,228,93,6,0,6,0,0,0
1850557,23,28,1990,4,"male",154,358,271,28,41,23,20,5,21
1850603,24,3,1989,7,"male",530,147,119,53,9,53,9,0,0
1850607,21,18,1992,3,"female",605,1628,483,1163,942,907,699,256,243
1850616,41,6,1972,5,"female",26,28,19,20,29,20,20,0,9
1850620,42,21,1971,11,"male",94,22,13,24,10,24,5,0,5
1850659,38,15,1975,7,"male",1028,17,8,7,2,6,1,1,1
1850662,17,9,1996,1,"male",257,106,75,53,23,0,9,53,14
1850663,18,30,1995,3,"male",554,113,99,3,12,3,12,0,0
1850675,54,13,1959,2,"female",296,165,66,1010,100,0,13,1010,87
1850690,44,20,1969,8,"male",79,104,101,217,148,217,28,0,120
1850712,33,23,1980,3,"male",31,15,9,0,0,0,0,0,0
1850720,42,30,1971,11,"male",304,112,94,4,9,1,7,3,2
1850771,31,22,1982,4,"female",746,309,183,536,574,536,453,0,121
1850781,18,3,1995,4,"male",309,1,1,0,0,0,0,0,0
1850797,30,23,1983,2,"male",229,6,3,0,1,0,1,0,0
1850855,14,1,1999,1,"female",235,480,240,114,109,68,52,46,57
1850860,14,1,1999,1,"female",224,154,66,0,1,0,1,0,0
1850867,32,4,1981,6,"male",555,1,1,1,0,0,0,1,0
1850876,16,24,1997,3,"female",298,111,61,16,10,8,5,8,5
1850927,64,11,1949,1,"male",186,51,43,17,3,0,1,17,2
1850988,22,16,1991,12,"male",937,566,331,37,69,37,46,0,23
1850989,94,9,1919,3,"male",661,246,109,29,53,29,31,0,22
1850992,55,20,1958,9,"male",847,28,23,2,1,0,0,2,1
1850997,23,19,1990,6,"female",324,130,61,27,0,0,0,27,0
1851032,39,9,1974,12,"female",490,46,26,237,22,237,22,0,0
1851043,24,13,1989,7,"female",1092,485,297,23,54,20,38,3,16
1851054,65,4,1948,10,"male",261,44,35,0,0,0,0,0,0
1851062,19,15,1994,12,"male",609,349,298,29,6,19,1,10,5
1851093,25,15,1988,10,"male",745,84,45,11,7,11,7,0,0
1851094,16,4,1997,8,"male",297,16,14,27,4,0,3,27,1
1851097,19,1,1994,6,"female",516,1018,491,122,279,0,154,122,125
1851135,24,24,1989,3,"male",73,158,103,39,73,39,23,0,50
1851136,21,15,1992,4,"male",354,161,101,18,23,18,23,0,0
1851169,18,18,1995,3,"male",680,71,29,17,14,17,2,0,12
1851191,26,29,1987,7,"female",1063,1656,536,848,4223,250,3209,598,1014
1851210,26,3,1987,11,"male",795,79,44,8,3,4,2,4,1
1851219,25,24,1988,12,"female",695,323,190,2,0,2,0,0,0
1851227,108,9,1905,10,"female",184,27,23,0,1,0,0,0,1
1851236,50,27,1963,12,"female",530,45,26,20,63,1,34,19,29
1851278,18,12,1995,1,"female",590,1,1,0,0,0,0,0,0
1851282,105,29,1908,2,"female",2107,384,143,139,43,19,17,120,26
1851284,72,8,1941,11,"female",2018,177,86,4492,467,4492,251,0,216
1851285,49,28,1964,6,"male",510,53,23,128,3,95,1,33,2
1851289,51,7,1962,9,"female",129,5,2,1,4,1,4,0,0
1851321,46,12,1967,4,"female",411,31,18,16,16,16,14,0,2
1851334,23,11,1990,11,"male",682,94,48,0,1,0,0,0,1
1851362,64,21,1949,9,"female",377,24,12,0,0,0,0,0,0
1851368,29,5,1984,2,"male",403,2,2,0,0,0,0,0,0
1851414,23,13,1990,6,"male",232,151,115,4,27,4,9,0,18
1851417,56,5,1957,9,"female",1032,59,34,333,100,333,95,0,5
1851444,73,19,1940,3,"male",775,24,9,2,10,0,1,2,9
1851471,42,3,1971,2,"male",86,16,16,0,0,0,0,0,0
1851484,17,26,1996,9,"male",51,32,24,4,49,0,2,4,47
1851513,61,24,1952,2,"male",661,90,44,37,2,0,0,37,2
1851519,27,31,1986,7,"male",217,202,132,430,54,430,39,0,15
1851524,20,15,1993,10,"male",679,92,84,6,12,0,0,6,12
1851544,104,19,1909,9,"female",466,230,61,191,84,186,60,5,24
1851564,24,1,1989,7,"male",370,1,1,0,0,0,0,0,0
1851570,18,15,1995,9,"female",204,42,19,0,0,0,0,0,0
1851575,20,27,1993,5,"male",495,70,46,20,23,3,11,17,12
1851621,17,25,1996,9,"female",273,3,2,0,0,0,0,0,0
1851634,66,8,1947,8,"male",633,229,208,7,106,0,73,7,33
1851645,29,16,1984,7,"male",554,102,60,82,67,6,22,76,45
1851665,107,8,1906,2,"female",1084,446,198,97,139,78,53,19,86
1851675,28,10,1985,4,"female",230,30,24,644,21,644,20,0,1
1851680,25,1,1988,1,"female",117,6,3,2,0,2,0,0,0
1851712,30,3,1983,8,"female",466,158,73,180,49,175,31,5,18
1851724,40,12,1973,3,"male",321,234,224,564,150,290,98,274,52
1851769,15,24,1998,8,"male",65,928,910,3,40,3,34,0,6
1851774,22,6,1991,8,"male",158,0,0,0,0,0,0,0,0
1851788,25,4,1988,12,"male",413,19,3,2,3,2,2,0,1
1851830,22,2,1991,2,"female",196,19,19,0,0,0,0,0,0
1851832,18,1,1995,8,"female",627,233,195,22,15,2,9,20,6
1851837,14,24,1999,11,"female",341,330,220,2,43,2,33,0,10
1851859,24,29,1989,9,"male",50,102,96,46,100,46,82,0,18
1851875,14,14,1999,3,"female",188,89,20,1,0,1,0,0,0
1851895,60,3,1953,6,"female",1301,98,49,1228,396,1228,170,0,226
1851933,57,4,1956,5,"male",628,19,10,33,75,33,61,0,14
1851952,108,24,1905,1,"male",813,659,395,359,158,12,45,347,113
1852052,18,5,1995,3,"male",1,10,0,1,1,1,1,0,0
1852066,26,14,1987,11,"male",121,86,53,54,148,54,56,0,92
1852076,33,27,1980,9,"male",538,331,251,45,13,31,7,14,6
1852099,37,16,1976,1,"male",1013,71,53,2,0,2,0,0,0
1852112,19,20,1994,11,"male",275,74,47,0,0,0,0,0,0
1852139,48,16,1965,8,"male",126,153,98,35,124,35,69,0,55
1852140,15,10,1998,9,"female",246,47,31,1,0,1,0,0,0
1852144,18,15,1995,8,"male",270,70,61,0,0,0,0,0,0
1852147,20,6,1993,5,"female",364,627,468,763,178,763,153,0,25
1852155,59,11,1954,6,"female",499,2834,1375,2134,2763,984,1819,1150,944
1852158,19,9,1994,8,"male",489,1807,1373,1059,1388,1059,1310,0,78
1852162,61,18,1952,10,"male",1138,23,16,11,7,0,5,11,2
1852182,39,6,1974,5,"female",881,22,4,0,0,0,0,0,0
1852198,92,30,1921,3,"female",825,211,33,39,120,19,61,20,59
1852204,108,16,1905,4,"female",142,160,128,996,400,386,71,610,329
1852232,14,22,1999,11,"male",344,60,27,0,4,0,3,0,1
1852239,25,1,1988,2,"female",455,97,69,671,210,671,174,0,36
1852282,18,28,1995,8,"female",639,421,344,0,0,0,0,0,0
1852286,68,29,1945,1,"male",36,151,150,24,0,24,0,0,0
1852291,20,3,1993,12,"male",259,99,58,5,35,5,29,0,6
1852317,46,5,1967,10,"male",491,95,55,325,108,0,51,325,57
1852318,42,18,1971,12,"male",350,466,295,1055,864,896,489,159,375
1852333,28,13,1985,8,"male",436,45,24,1049,385,124,158,925,227
1852335,34,8,1979,1,"male",1506,169,164,8,3,8,3,0,0
1852337,51,26,1962,12,"male",179,71,37,105,66,105,56,0,10
1852382,26,7,1987,11,"female",337,47,24,431,85,431,81,0,4
1852402,24,18,1989,2,"male",229,4,1,0,0,0,0,0,0
1852423,60,14,1953,3,"female",363,36,23,226,81,0,57,226,24
1852443,22,5,1991,8,"male",142,308,269,0,2,0,0,0,2
1852472,13,14,2000,7,"female",970,1183,491,3414,3428,109,1360,3305,2068
1852539,19,25,1994,6,"male",585,137,82,8,1,4,0,4,1
1852555,30,9,1983,2,"male",704,60,54,0,16,0,15,0,1
1852567,33,12,1980,8,"male",1470,582,301,3,8,3,8,0,0
1852573,21,27,1992,7,"female",1448,120,26,9690,1679,8323,376,1367,1303
1852576,30,4,1983,5,"male",235,53,41,5,7,4,3,1,4
1852584,57,15,1956,8,"female",403,72,58,288,18,288,11,0,7
1852591,21,4,1992,7,"male",339,101,88,2,0,2,0,0,0
1852609,33,14,1980,8,"male",366,100,23,6,0,6,0,0,0
1852620,58,9,1955,7,"male",275,38,29,2,0,0,0,2,0
1852636,25,8,1988,5,"male",1234,1162,958,2327,1440,2327,471,0,969
1852661,43,11,1970,9,"male",142,44,28,174,55,174,49,0,6
1852678,47,25,1966,9,"female",1502,954,353,825,1227,825,733,0,494
1852680,52,20,1961,3,"male",37,13,2,8,77,8,34,0,43
1852682,35,18,1978,10,"male",525,54,15,17,28,17,22,0,6
1852683,25,18,1988,4,"female",426,38,16,0,0,0,0,0,0
1852709,32,22,1981,9,"male",544,113,75,24,1,24,1,0,0
1852716,24,7,1989,11,"male",94,14,13,4,1,2,0,2,1
1852723,66,2,1947,1,"female",1675,25,13,1,0,0,0,1,0
1852752,58,5,1955,11,"male",1034,28,21,0,0,0,0,0,0
1852764,37,15,1976,10,"male",31,16,12,2,14,2,10,0,4
1852777,19,28,1994,11,"male",397,74,33,40,18,40,11,0,7
1852786,20,12,1993,10,"male",87,8,6,0,0,0,0,0,0
1852811,82,15,1931,3,"male",1566,54,37,0,0,0,0,0,0
1852816,13,7,2000,8,"male",26,2,2,1,0,1,0,0,0
1852820,24,30,1989,3,"male",380,261,219,31,0,27,0,4,0
1852824,15,8,1998,2,"male",579,28,25,0,2,0,1,0,1
1852828,60,4,1953,5,"female",825,4,3,1,0,0,0,1,0
1852869,98,25,1915,7,"male",1563,323,140,20,131,10,69,10,62
1852878,22,6,1991,7,"male",70,89,63,180,15,178,15,2,0
1852887,18,15,1995,4,"female",201,4,2,6,2,0,0,6,2
1852889,15,14,1998,7,"female",346,271,62,44,164,38,100,6,64
1852906,51,3,1962,4,"male",574,105,62,198,128,20,98,178,30
1852920,94,25,1919,8,"female",2283,1825,333,31,6,2,3,29,3
1852922,33,29,1980,6,"female",483,282,166,448,379,443,210,5,169
1852932,17,16,1996,9,"male",1005,7,3,3,0,3,0,0,0
1852941,18,26,1995,2,"female",309,2,2,30,31,30,10,0,21
1852944,15,30,1998,11,"male",420,231,162,1,6,1,6,0,0
1852946,40,3,1973,12,"male",188,0,0,0,0,0,0,0,0
1852948,14,25,1999,7,"female",408,532,424,442,53,440,24,2,29
1852952,100,3,1913,9,"male",540,385,191,325,74,325,72,0,2
1852953,38,21,1975,1,"female",372,22,8,380,57,0,14,380,43
1852974,19,18,1994,3,"male",104,238,168,236,193,236,174,0,19
1852997,50,27,1963,9,"female",737,70,45,6,12,6,10,0,2
1853015,21,26,1992,7,"female",250,142,133,462,263,462,166,0,97
1853029,51,30,1962,5,"male",595,22,5,1,0,1,0,0,0
1853038,57,30,1956,1,"female",512,87,73,2,1,0,1,2,0
1853045,17,28,1996,9,"male",391,473,175,1414,452,1378,262,36,190
1853046,32,22,1981,9,"female",504,46,30,57,106,57,46,0,60
1853053,22,26,1991,5,"female",194,1,1,0,0,0,0,0,0
1853057,71,3,1942,6,"female",924,59,40,7,0,1,0,6,0
1853078,21,7,1992,11,"female",81,23,17,95,5,95,5,0,0
1853092,83,8,1930,4,"male",1063,204,138,5,4,5,4,0,0
1853094,84,16,1929,4,"male",839,377,248,20,2,0,0,20,2
1853150,33,18,1980,4,"male",619,84,62,197,104,196,43,1,61
1853170,62,16,1951,10,"female",418,63,49,79,44,77,38,2,6
1853187,16,10,1997,4,"male",605,94,79,0,127,0,38,0,89
1853196,16,28,1997,5,"female",366,189,114,81,25,81,14,0,11
1853200,57,6,1956,6,"male",1641,41,17,1,33,0,3,1,30
1853202,94,20,1919,7,"male",119,337,308,8,23,8,5,0,18
1853211,38,5,1975,11,"male",337,63,40,1,1,1,1,0,0
1853227,22,19,1991,12,"male",364,15,9,0,0,0,0,0,0
1853249,49,10,1964,12,"female",866,195,109,9,46,9,34,0,12
1853274,25,5,1988,4,"male",131,36,28,1,0,1,0,0,0
1853315,40,16,1973,8,"male",584,14,9,0,0,0,0,0,0
1853318,26,5,1987,2,"female",77,40,27,0,0,0,0,0,0
1853324,25,26,1988,3,"male",253,151,103,5,81,0,13,5,68
1853325,18,21,1995,5,"male",460,1077,570,1784,1814,1651,1308,133,506
1853338,23,10,1990,3,"male",405,52,24,2,0,2,0,0,0
1853342,52,23,1961,10,"female",224,35,26,94,85,94,75,0,10
1853343,28,14,1985,11,"female",370,52,28,2,24,2,4,0,20
1853347,23,14,1990,7,"male",289,40,17,0,1,0,1,0,0
1853352,17,5,1996,5,"female",180,59,55,8,1,8,1,0,0
1853363,30,29,1983,12,"male",223,79,55,40,51,40,30,0,21
1853399,58,25,1955,5,"male",243,11,3,0,0,0,0,0,0
1853404,71,18,1942,12,"female",532,39,16,33,27,3,7,30,20
1853406,16,13,1997,12,"female",1019,715,530,425,152,0,73,425,79
1853423,108,2,1905,11,"female",876,131,38,19,9,19,8,0,1
1853439,23,7,1990,10,"female",792,179,143,651,112,353,65,298,47
1853486,37,27,1976,6,"male",212,222,145,0,0,0,0,0,0
1853489,28,4,1985,4,"male",346,341,262,3519,1535,3175,1003,344,532
1853518,29,26,1984,3,"male",594,8,5,2,0,2,0,0,0
1853525,25,1,1988,1,"female",139,153,64,23,26,8,24,15,2
1853567,28,17,1985,10,"male",500,16,7,1,0,1,0,0,0
1853586,17,28,1996,9,"male",352,358,204,111,53,0,17,111,36
1853602,19,25,1994,10,"male",828,37,23,162,61,2,17,160,44
1853637,25,20,1988,10,"male",96,319,313,0,0,0,0,0,0
1853662,20,6,1993,7,"male",250,14,12,0,0,0,0,0,0
1853696,27,9,1986,5,"male",997,67,31,2,4,2,2,0,2
1853698,25,1,1988,1,"female",172,10,5,0,0,0,0,0,0
1853704,21,25,1992,12,"female",403,249,42,5,9,5,6,0,3
1853718,23,1,1990,1,"male",924,26,4,0,0,0,0,0,0
1853737,33,23,1980,5,"male",1223,38,12,2,2,0,0,2,2
1853756,108,1,1905,1,"male",1000,10,10,35,22,35,13,0,9
1853771,22,3,1991,8,"male",0,0,0,24,23,0,4,24,19
1853775,26,13,1987,6,"male",87,97,80,134,34,134,16,0,18
1853784,45,29,1968,7,"male",357,76,45,2,0,2,0,0,0
1853797,20,28,1993,1,"female",229,45,36,19,74,17,27,2,47
1853813,20,20,1993,11,"male",2,7,6,1,0,1,0,0,0
1853817,16,28,1997,9,"male",370,110,79,3,47,3,43,0,4
1853819,84,9,1929,2,"female",1797,74,22,226,10,226,5,0,5
1853835,108,14,1905,3,"female",218,146,119,25,18,0,3,25,15
1853836,18,25,1995,6,"female",467,1184,750,200,356,176,145,24,211
1853845,64,19,1949,9,"male",1067,42,11,7,1,0,1,7,0
1853859,15,18,1998,2,"female",384,357,167,0,5,0,2,0,3
1853861,53,5,1960,1,"male",1418,16,5,2,5,2,0,0,5
1853882,23,22,1990,3,"male",244,30,17,0,5,0,2,0,3
1853909,105,29,1908,2,"female",1426,549,113,210,101,95,83,115,18
1853913,23,11,1990,9,"male",498,19,16,4,2,0,0,4,2
1853918,106,1,1907,12,"female",174,50,22,20,5,20,2,0,3
1853976,15,4,1998,4,"male",255,9,7,0,0,0,0,0,0
1853979,63,5,1950,5,"female",20,25,15,41,20,0,7,41,13
1854003,26,1,1987,1,"male",411,92,47,2,0,2,0,0,0
1854004,56,15,1957,5,"male",293,175,49,532,143,0,10,532,133
1854019,15,2,1998,2,"male",11,17,10,6,3,0,0,6,3
1854020,26,1,1987,1,"male",375,27,26,0,0,0,0,0,0
1854025,16,13,1997,10,"male",190,73,63,1,1,1,1,0,0
1854048,68,28,1945,5,"male",279,34,14,50,8,50,7,0,1
1854076,55,9,1958,12,"male",604,22,12,2,0,2,0,0,0
1854105,21,13,1992,7,"female",340,80,27,0,0,0,0,0,0
1854114,17,11,1996,3,"male",81,0,0,0,0,0,0,0,0
1854122,50,25,1963,5,"male",1839,58,18,22,15,15,5,7,10
1854134,15,21,1998,3,"female",522,351,244,0,4,0,3,0,1
1854144,16,20,1997,8,"female",306,130,81,46,47,46,37,0,10
1854145,22,9,1991,2,"male",768,220,137,41,26,4,8,37,18
1854187,113,29,1900,9,"female",1137,77,25,238,128,0,30,238,98
1854206,21,14,1992,3,"male",270,46,32,1,0,0,0,1,0
1854209,26,10,1987,2,"male",137,111,104,7,4,7,3,0,1
1854215,21,1,1992,1,"male",220,17,14,0,0,0,0,0,0
1854254,68,5,1945,5,"male",951,128,38,3,7,3,5,0,2
1854278,81,29,1932,3,"female",35,8,7,102,1,102,0,0,1
1854306,22,1,1991,1,"male",563,328,240,91,23,63,19,28,4
1854331,36,19,1977,7,"male",172,57,39,0,0,0,0,0,0
1854335,31,6,1982,2,"female",353,61,52,3,21,1,9,2,12
1854340,35,16,1978,3,"female",61,5,2,11,17,11,12,0,5
1854377,108,1,1905,1,"male",1938,135,60,104,371,104,144,0,227
1854397,24,20,1989,8,"male",161,824,632,727,722,390,438,337,284
1854446,23,10,1990,11,"female",646,271,115,84,113,84,82,0,31
1854487,20,12,1993,8,"female",470,268,34,0,4,0,4,0,0
1854489,98,15,1915,5,"male",473,59,49,8,24,8,18,0,6
1854549,20,26,1993,6,"female",299,33,24,7,0,5,0,2,0
1854550,47,1,1966,4,"female",465,49,18,15,7,15,5,0,2
1854565,47,31,1966,10,"male",110,0,0,0,0,0,0,0,0
1854575,101,18,1912,7,"female",583,245,62,27,31,27,28,0,3
1854587,15,7,1998,9,"female",471,332,183,72,231,30,168,42,63
1854606,56,11,1957,3,"female",458,233,85,4,6,0,0,4,6
1854623,23,20,1990,10,"male",383,217,185,265,48,265,47,0,1
1854631,53,27,1960,1,"female",455,149,107,11,1,0,0,11,1
1854653,32,26,1981,7,"male",1427,171,116,1,29,1,11,0,18
1854656,25,23,1988,8,"male",636,96,72,7,9,7,7,0,2
1854664,59,6,1954,4,"male",616,43,31,3,32,3,25,0,7
1854683,28,2,1985,9,"male",300,96,57,0,0,0,0,0,0
1854701,25,2,1988,1,"male",189,10,6,0,0,0,0,0,0
1854712,19,28,1994,10,"male",354,84,30,78,19,0,9,78,10
1854713,19,23,1994,7,"male",616,223,102,8,0,8,0,0,0
1854722,47,30,1966,7,"male",927,37,17,16,3,16,3,0,0
1854792,28,28,1985,2,"male",542,286,195,67,117,67,104,0,13
1854855,49,30,1964,4,"male",790,134,81,94,11,94,7,0,4
1854882,25,29,1988,12,"female",391,251,57,155,197,155,187,0,10
1854894,58,26,1955,9,"male",1376,105,65,341,174,341,98,0,76
1854915,22,25,1991,1,"female",504,416,256,0,0,0,0,0,0
1854922,54,20,1959,12,"female",188,270,13,6,5,0,0,6,5
1854930,18,4,1995,8,"male",448,900,868,3991,1307,3990,753,1,554
1854942,20,15,1993,10,"female",719,58,47,14,6,12,4,2,2
1854944,25,3,1988,2,"male",11,8,5,42,11,41,2,1,9
1854946,37,17,1976,10,"female",412,153,27,3,9,0,8,3,1
1854983,40,15,1973,4,"female",1677,133,61,211,244,205,206,6,38
1854984,19,28,1994,5,"female",749,595,326,759,943,407,161,352,782
1855036,19,25,1994,8,"male",235,138,137,0,0,0,0,0,0
1855084,73,1,1940,11,"female",2283,717,170,645,301,85,103,560,198
1855139,26,11,1987,1,"female",295,45,10,2,1,2,1,0,0
1855179,30,26,1983,1,"male",36,5,4,1,0,1,0,0,0
1855185,102,3,1911,10,"male",4,4,2,14,2,1,1,13,1
1855200,58,12,1955,7,"male",18,4,3,67,53,67,34,0,19
1855227,18,2,1995,9,"male",588,210,156,3,1,3,1,0,0
1855245,52,1,1961,2,"male",997,105,28,22,57,22,30,0,27
1855247,15,20,1998,5,"male",329,115,90,0,0,0,0,0,0
1855273,38,18,1975,1,"male",650,101,62,481,857,329,705,152,152
1855290,49,20,1964,8,"female",781,132,77,510,178,0,75,510,103
1855306,25,27,1988,1,"male",290,95,79,5,0,5,0,0,0
1855309,41,19,1972,11,"male",426,18,17,1,0,1,0,0,0
1855318,37,5,1976,6,"male",371,63,40,0,9,0,1,0,8
1855331,40,26,1973,1,"male",382,0,0,0,0,0,0,0,0
1855332,34,27,1979,1,"female",896,1,1,1,0,1,0,0,0
1855334,23,9,1990,5,"male",162,5,5,0,0,0,0,0,0
1855335,27,3,1986,5,"male",383,72,48,25,16,0,5,25,11
1855360,62,14,1951,7,"male",802,0,0,0,0,0,0,0,0
1855389,17,3,1996,6,"female",460,1655,487,175,1154,175,1067,0,87
1855430,28,14,1985,6,"male",363,48,28,4,6,2,0,2,6
1855445,67,29,1946,10,"female",235,2,2,3,1,3,1,0,0
1855458,50,14,1963,2,"male",782,38,19,2,2,2,1,0,1
1855483,24,21,1989,3,"male",453,79,13,0,5,0,5,0,0
1855487,38,7,1975,2,"male",176,0,0,0,0,0,0,0,0
1855493,22,2,1991,7,"male",177,79,20,17,1,0,0,17,1
1855496,21,11,1992,12,"male",999,639,354,3,50,2,36,1,14
1855498,49,20,1964,4,"female",59,28,20,3,1,3,0,0,1
1855501,28,21,1985,5,"female",412,82,72,211,127,211,117,0,10
1855540,45,3,1968,9,"male",213,111,78,3,11,3,9,0,2
1855559,16,7,1997,7,"female",25,54,14,0,2,0,2,0,0
1855593,35,22,1978,10,"male",124,22,20,7,0,7,0,0,0
1855594,20,29,1993,6,"male",199,39,26,239,352,77,107,162,245
1855617,33,8,1980,5,"male",356,198,170,91,4,48,4,43,0
1855635,49,25,1964,2,"female",1378,136,74,183,413,179,265,4,148
1855644,28,25,1985,4,"female",1527,636,195,67,161,66,87,1,74
1855682,23,2,1990,4,"female",759,132,74,821,177,10,42,811,135
1855710,51,26,1962,4,"female",731,117,63,2,1,0,0,2,1
1855722,66,19,1947,5,"male",233,20,18,12,25,12,15,0,10
1855734,30,21,1983,3,"female",289,125,92,0,0,0,0,0,0
1855753,48,20,1965,1,"female",219,20,15,60,13,60,12,0,1
1855755,19,18,1994,5,"female",298,343,156,144,46,144,46,0,0
1855756,31,13,1982,10,"male",149,2,0,0,0,0,0,0,0
1855771,26,20,1987,7,"male",304,139,116,106,6,106,6,0,0
1855783,69,10,1944,9,"male",1541,30,11,0,0,0,0,0,0
1855810,57,1,1956,3,"female",1536,77,28,149,126,63,64,86,62
1855825,71,17,1942,5,"male",400,64,41,1,4,0,0,1,4
1855881,16,17,1997,9,"male",792,53,17,29,5,29,3,0,2
1855895,64,16,1949,1,"male",1592,47,35,11,0,4,0,7,0
1855904,20,13,1993,9,"female",272,83,67,209,90,197,23,12,67
1855913,63,14,1950,3,"male",676,61,48,0,8,0,5,0,3
1855916,31,19,1982,11,"female",138,13,10,0,2,0,2,0,0
1855917,22,18,1991,8,"male",425,53,17,5,6,5,3,0,3
1855929,20,8,1993,10,"male",211,21,14,2,2,2,2,0,0
1855942,47,17,1966,1,"male",57,36,23,0,0,0,0,0,0
1855959,33,11,1980,4,"female",1198,363,260,57,123,34,51,23,72
1855962,18,10,1995,7,"female",221,151,69,96,38,96,28,0,10
1856017,23,25,1990,9,"male",448,180,54,55,34,55,33,0,1
1856020,60,22,1953,2,"male",371,46,33,2,0,2,0,0,0
1856027,57,15,1956,3,"male",488,78,35,93,63,8,22,85,41
1856030,108,19,1905,9,"female",236,74,37,34,18,21,9,13,9
1856173,29,25,1984,12,"male",56,66,49,76,29,76,26,0,3
1856204,21,20,1992,10,"male",7,5,5,0,8,0,3,0,5
1856218,113,11,1900,8,"female",1241,154,55,28,84,8,43,20,41
1856221,22,13,1991,7,"male",488,319,207,337,173,337,112,0,61
1856272,16,1,1997,5,"female",634,226,148,1,4,1,4,0,0
1856283,55,21,1958,4,"male",546,272,234,0,1,0,0,0,1
1856304,27,18,1986,6,"male",1570,187,79,4,3,1,0,3,3
1856344,47,6,1966,9,"male",118,162,135,17,38,17,23,0,15
1856352,73,23,1940,7,"female",284,73,43,10,2,0,0,10,2
1856363,19,23,1994,7,"male",407,1047,583,992,1248,992,1070,0,178
1856368,51,20,1962,6,"female",515,163,125,2084,87,0,14,2084,73
1856371,38,19,1975,9,"male",719,49,32,0,0,0,0,0,0
1856399,26,17,1987,1,"male",602,173,113,37,23,33,13,4,10
1856414,57,14,1956,10,"female",948,424,165,2100,1564,406,419,1694,1145
1856440,14,22,1999,6,"female",466,102,85,198,35,148,28,50,7
1856477,100,17,1913,8,"male",2077,303,122,1,4,1,4,0,0
1856481,59,25,1954,8,"male",866,59,24,61,93,61,90,0,3
1856496,23,11,1990,10,"male",692,979,684,321,378,250,212,71,166
1856511,30,17,1983,9,"male",11,7,7,23,10,23,9,0,1
1856588,15,9,1998,8,"female",93,110,75,618,445,583,299,35,146
1856613,25,26,1988,2,"male",665,2396,714,163,198,163,176,0,22
1856624,35,6,1978,5,"female",1264,268,84,107,284,107,190,0,94
1856637,18,7,1995,10,"male",322,28,20,4,4,4,4,0,0
1856661,29,22,1984,8,"female",433,29,14,0,2,0,0,0,2
1856665,23,20,1990,8,"female",378,43,1,30,3,30,1,0,2
1856672,23,25,1990,7,"male",500,3,2,8,0,0,0,8,0
1856679,32,24,1981,11,"female",194,180,48,188,99,188,99,0,0
1856687,61,28,1952,9,"female",53,22,17,0,1,0,1,0,0
1856698,113,7,1900,10,"female",1491,325,80,5,6,5,6,0,0
1856704,48,6,1965,12,"female",570,41,19,1,0,1,0,0,0
1856743,20,14,1993,1,"male",511,9,8,2,5,2,4,0,1
1856757,25,1,1988,1,"male",242,1022,61,563,1245,560,685,3,560
1856761,17,1,1996,1,"male",64,4,4,0,0,0,0,0,0
1856825,69,13,1944,6,"male",1358,67,37,30,53,24,24,6,29
1856849,20,15,1993,9,"female",39,13,13,2,0,2,0,0,0
1856868,73,31,1940,7,"male",1021,53,27,0,0,0,0,0,0
1856874,31,24,1982,10,"female",180,2,2,0,0,0,0,0,0
1856938,25,22,1988,12,"male",756,664,463,24,55,21,38,3,17
1856939,20,22,1993,7,"female",393,84,39,31,65,31,52,0,13
1857000,18,24,1995,2,"male",281,343,237,1326,803,1326,692,0,111
1857017,19,2,1994,1,"female",387,580,136,148,380,128,170,20,210
1857036,22,13,1991,4,"male",521,189,72,4,3,4,3,0,0
1857046,25,30,1988,12,"male",266,208,192,1,8,1,8,0,0
1857062,30,23,1983,4,"male",767,127,87,0,0,0,0,0,0
1857073,108,17,1905,1,"female",464,482,369,28,54,28,20,0,34
1857131,21,1,1992,1,"male",538,1097,951,14,41,14,36,0,5
1857221,31,27,1982,2,"female",266,54,17,152,225,152,114,0,111
1857232,67,21,1946,4,"male",359,86,39,0,21,0,8,0,13
1857233,19,3,1994,8,"female",841,879,576,324,200,324,129,0,71
1857245,16,5,1997,1,"female",541,94,48,14,1,14,1,0,0
1857256,60,29,1953,6,"male",1415,126,64,40,129,14,77,26,52
1857258,27,27,1986,11,"male",276,0,0,0,0,0,0,0,0
1857259,65,1,1948,12,"female",1782,44,25,86,16,57,16,29,0
1857261,21,5,1992,4,"male",294,26,19,2,7,0,5,2,2
1857274,16,30,1997,4,"male",194,19,10,0,1,0,0,0,1
1857319,59,14,1954,7,"female",869,36,23,293,67,293,30,0,37
1857328,65,23,1948,6,"female",456,42,23,77,86,62,64,15,22
1857347,92,13,1921,12,"male",1429,214,122,111,41,33,28,78,13
1857349,25,16,1988,4,"male",695,26,18,0,0,0,0,0,0
1857359,108,7,1905,12,"male",1897,73,12,9,14,9,8,0,6
1857363,63,2,1950,12,"female",2271,89,44,3,12,3,10,0,2
1857368,103,19,1910,8,"female",622,192,105,0,2,0,0,0,2
1857369,72,1,1941,2,"female",1654,22,19,0,0,0,0,0,0
1857377,59,23,1954,12,"male",96,174,162,2,5,2,3,0,2
1857387,26,1,1987,1,"male",419,19,18,0,0,0,0,0,0
1857412,58,9,1955,3,"female",210,84,25,7,9,0,1,7,8
1857417,23,24,1990,10,"male",507,149,77,45,751,45,380,0,371
1857440,57,21,1956,6,"male",389,3,1,0,0,0,0,0,0
1857450,23,17,1990,3,"male",413,71,27,5,0,3,0,2,0
1857455,23,9,1990,8,"male",371,164,133,4,4,4,4,0,0
1857472,35,5,1978,10,"male",460,102,68,5,5,5,4,0,1
1857518,18,1,1995,1,"male",443,168,96,35,3,5,3,30,0
1857521,29,22,1984,7,"male",99,57,20,1,1,1,1,0,0
1857527,108,21,1905,2,"male",1046,95,62,84,122,84,65,0,57
1857574,61,8,1952,11,"female",749,74,56,627,195,0,19,627,176
1857578,47,3,1966,10,"male",1583,105,57,32,33,31,24,1,9
1857601,18,10,1995,8,"male",562,430,350,2,14,2,6,0,8
1857615,105,26,1908,11,"male",1788,278,146,44,45,13,24,31,21
1857616,20,29,1993,4,"female",395,371,188,6,14,0,0,6,14
1857641,29,27,1984,4,"male",918,261,103,9,37,9,36,0,1
1857658,18,11,1995,7,"female",560,375,277,239,564,21,262,218,302
1857661,30,16,1983,8,"female",1212,235,100,808,694,680,451,128,243
1857679,18,16,1995,9,"male",714,179,123,0,1,0,1,0,0
1857693,14,15,1999,10,"female",14,214,172,145,159,143,106,2,53
1857714,43,1,1970,1,"male",188,121,114,0,1,0,0,0,1
1857757,54,22,1959,7,"female",505,37,19,7,1,7,1,0,0
1857758,28,29,1985,7,"male",534,247,172,0,0,0,0,0,0
1857781,18,4,1995,10,"male",468,22,8,17,11,12,1,5,10
1857783,31,3,1982,3,"male",564,124,70,14,7,14,4,0,3
1857803,14,17,1999,6,"male",488,1029,850,13,61,13,27,0,34
1857849,28,24,1985,2,"male",560,88,76,0,1,0,0,0,1
1857850,60,13,1953,4,"male",525,100,45,0,0,0,0,0,0
1857874,24,3,1989,4,"male",110,12,12,0,5,0,5,0,0
1857884,15,4,1998,4,"male",351,48,24,0,0,0,0,0,0
1857891,33,17,1980,10,"male",572,21,16,3,29,3,11,0,18
1857944,23,23,1990,10,"male",408,878,570,299,192,299,187,0,5
1857966,64,8,1949,11,"male",552,2,0,1,0,0,0,1,0
1857987,40,10,1973,10,"female",195,113,62,7,150,7,119,0,31
1858002,81,4,1932,4,"female",1819,426,338,1130,569,1130,448,0,121
1858005,13,5,2000,6,"female",41,33,22,3,1,3,0,0,1
1858036,23,3,1990,9,"male",662,95,79,3,1,2,0,1,1
1858048,56,7,1957,7,"male",351,54,50,58,35,58,32,0,3
1858060,15,25,1998,12,"male",339,44,31,0,0,0,0,0,0
1858070,33,13,1980,10,"male",495,91,83,3,1,3,1,0,0
1858073,26,5,1987,6,"male",476,138,104,4,1,4,1,0,0
1858077,24,11,1989,2,"male",678,183,60,9,21,3,9,6,12
1858092,18,22,1995,11,"male",499,382,292,6,19,6,18,0,1
1858093,58,15,1955,10,"female",174,12,8,87,7,87,6,0,1
1858101,63,21,1950,12,"male",448,52,41,131,63,24,11,107,52
1858143,75,18,1938,2,"female",954,38,18,2,7,0,3,2,4
1858146,40,30,1973,8,"male",166,19,18,3,0,3,0,0,0
1858162,57,3,1956,10,"male",236,32,14,35,9,23,8,12,1
1858164,63,8,1950,5,"male",1699,31,12,6,1,6,1,0,0
1858179,24,24,1989,1,"male",292,411,287,177,183,117,118,60,65
1858189,27,21,1986,6,"female",645,134,114,0,0,0,0,0,0
1858209,25,3,1988,1,"male",402,33,20,0,1,0,1,0,0
1858229,42,14,1971,1,"male",1037,154,102,75,47,75,46,0,1
1858240,27,5,1986,8,"male",524,330,296,3,0,3,0,0,0
1858243,21,22,1992,7,"male",208,108,71,9,0,9,0,0,0
1858248,23,23,1990,8,"male",1382,1231,1005,276,4,276,3,0,1
1858263,15,18,1998,10,"male",177,47,29,0,0,0,0,0,0
1858317,44,6,1969,3,"female",559,36,21,33,17,0,0,33,17
1858333,27,12,1986,12,"male",389,27,11,0,0,0,0,0,0
1858361,63,21,1950,4,"male",1229,4,1,0,0,0,0,0,0
1858370,31,4,1982,2,"female",260,1,1,0,0,0,0,0,0
1858374,16,18,1997,2,"female",1027,1625,987,3330,1509,1843,624,1487,885
1858375,75,30,1938,6,"female",399,13,11,1,2,0,2,1,0
1858396,33,17,1980,7,"male",565,52,27,0,0,0,0,0,0
1858405,24,14,1989,8,"male",430,214,121,6,2,6,2,0,0
1858406,41,2,1972,3,"male",252,255,107,1,7,1,7,0,0
1858429,20,22,1993,7,"female",456,481,215,164,97,158,49,6,48
1858440,21,1,1992,1,"female",464,312,96,1186,1983,569,1399,617,584
1858446,19,23,1994,2,"female",1348,1661,538,182,604,182,543,0,61
1858461,15,14,1998,4,"male",438,103,87,0,1,0,1,0,0
1858469,80,6,1933,12,"female",1050,15,8,0,1,0,1,0,0
1858501,19,10,1994,10,"male",383,74,52,13,10,13,4,0,6
1858533,19,28,1994,4,"female",316,97,49,4,17,0,7,4,10
1858552,103,20,1910,3,"male",1173,726,241,339,468,309,169,30,299
1858575,78,21,1935,9,"male",372,34,14,2,3,0,0,2,3
1858582,70,14,1943,12,"female",312,13,13,30,4,30,4,0,0
1858600,17,24,1996,7,"female",476,400,168,2180,2645,1985,2228,195,417
1858603,21,24,1992,10,"female",222,291,136,386,923,131,376,255,547
1858611,27,5,1986,5,"male",274,131,92,0,0,0,0,0,0
1858622,68,12,1945,11,"male",218,189,119,0,0,0,0,0,0
1858637,103,6,1910,1,"male",1535,215,113,180,177,3,27,177,150
1858652,26,15,1987,9,"male",422,388,231,54,85,54,58,0,27
1858654,20,25,1993,4,"male",803,454,402,1,19,1,9,0,10
1858670,23,18,1990,10,"male",573,127,72,13,8,3,3,10,5
1858676,26,30,1987,1,"male",513,73,28,5,0,5,0,0,0
1858696,38,1,1975,3,"female",56,14,10,15,13,15,6,0,7
1858697,17,6,1996,12,"female",343,129,80,308,164,308,107,0,57
1858698,14,10,1999,6,"female",545,1767,1069,68,89,4,68,64,21
1858702,48,6,1965,5,"male",301,38,24,12,9,11,7,1,2
1858714,27,23,1986,4,"female",156,10,8,165,24,140,20,25,4
1858723,68,24,1945,8,"male",1197,121,81,2,7,1,2,1,5
1858746,26,15,1987,5,"female",751,218,141,30,11,30,11,0,0
1858755,18,13,1995,1,"male",267,1,1,0,0,0,0,0,0
1858756,39,26,1974,8,"female",84,7,6,2,6,2,6,0,0
1858778,35,28,1978,12,"male",700,38,24,22,0,22,0,0,0
1858799,27,29,1986,9,"male",455,4,2,0,0,0,0,0,0
1858834,15,10,1998,6,"female",516,642,258,922,1015,914,553,8,462
1858871,57,16,1956,5,"female",42,41,7,253,47,13,0,240,47
1858881,15,30,1998,11,"female",553,188,109,0,1,0,0,0,1
1858882,23,2,1990,10,"male",399,2,1,110,5,110,2,0,3
1858903,34,12,1979,10,"male",192,37,28,0,0,0,0,0,0
1858951,18,14,1995,10,"female",374,457,402,17,17,16,10,1,7
1858955,32,15,1981,8,"female",429,117,29,12,80,12,41,0,39
1858966,57,18,1956,2,"male",122,0,0,0,0,0,0,0,0
1858970,18,16,1995,2,"female",503,32,23,70,156,70,106,0,50
1858975,24,28,1989,6,"male",715,37,28,0,1,0,1,0,0
1859000,60,29,1953,6,"female",1749,121,73,71,123,41,70,30,53
1859013,34,16,1979,8,"male",522,157,124,23,17,23,9,0,8
1859017,18,4,1995,5,"female",293,663,443,0,6,0,6,0,0
1859034,108,1,1905,7,"male",954,59,13,232,30,0,13,232,17
1859036,17,5,1996,12,"male",219,428,368,149,42,34,28,115,14
1859042,34,22,1979,5,"female",446,238,127,398,102,398,50,0,52
1859054,56,13,1957,6,"female",1343,35,13,20,57,0,4,20,53
1859091,15,28,1998,2,"female",610,846,361,1957,856,1140,545,817,311
1859144,35,15,1978,6,"male",687,71,38,8,0,8,0,0,0
1859150,17,19,1996,3,"female",797,3973,883,87,335,19,207,68,128
1859165,17,28,1996,5,"male",548,386,285,84,4,0,1,84,3
1859170,31,19,1982,6,"female",56,113,104,458,367,458,289,0,78
1859179,36,17,1977,9,"male",244,27,16,0,0,0,0,0,0
1859183,19,11,1994,9,"female",37,56,36,2,10,2,8,0,2
1859220,16,26,1997,5,"male",1054,1258,573,1644,2242,1528,938,116,1304
1859236,100,13,1913,6,"male",81,297,77,57,11,57,8,0,3
1859237,28,8,1985,4,"female",603,299,253,573,576,570,354,3,222
1859260,18,4,1995,5,"female",224,226,199,74,29,74,28,0,1
1859281,23,7,1990,9,"female",59,354,256,223,723,206,453,17,270
1859351,40,3,1973,6,"female",635,238,170,77,138,77,101,0,37
1859366,26,15,1987,6,"female",568,88,70,5,19,3,11,2,8
1859367,19,15,1994,7,"male",249,135,103,7,0,7,0,0,0
1859378,18,6,1995,10,"male",56,527,464,273,476,272,342,1,134
1859410,15,20,1998,12,"male",135,49,41,21,3,13,2,8,1
1859415,44,10,1969,6,"male",550,11,10,1,0,0,0,1,0
1859416,29,26,1984,1,"male",143,82,80,6,2,6,2,0,0
1859420,67,13,1946,5,"male",185,26,19,0,0,0,0,0,0
1859444,16,23,1997,5,"female",268,31,5,1,0,1,0,0,0
1859445,29,23,1984,7,"female",552,89,29,4,1,4,0,0,1
1859467,18,4,1995,7,"female",187,259,119,18,29,9,15,9,14
1859469,17,31,1996,10,"male",27,20,14,3,7,3,5,0,2
1859478,48,6,1965,3,"female",520,172,139,6,34,6,8,0,26
1859497,25,3,1988,5,"male",368,68,63,0,0,0,0,0,0
1859550,31,15,1982,12,"male",610,148,83,16,9,16,8,0,1
1859556,94,20,1919,10,"female",209,402,82,18,52,18,27,0,25
1859564,39,21,1974,9,"female",545,231,119,69,55,69,30,0,25
1859579,28,1,1985,1,"male",327,83,81,0,3,0,3,0,0
1859584,75,14,1938,5,"male",1051,531,194,673,176,673,87,0,89
1859606,32,21,1981,9,"female",134,0,0,0,0,0,0,0,0
1859626,16,27,1997,10,"female",168,210,113,4,6,4,6,0,0
1859629,16,25,1997,6,"female",400,71,44,0,0,0,0,0,0
1859645,43,8,1970,10,"female",92,7,4,33,17,33,13,0,4
1859684,93,11,1920,12,"female",292,363,254,589,282,589,245,0,37
1859724,21,1,1992,2,"male",255,106,88,4,13,4,11,0,2
1859725,31,1,1982,7,"female",351,0,0,0,0,0,0,0,0
1859773,19,7,1994,2,"female",118,8,7,0,0,0,0,0,0
1859779,38,15,1975,3,"female",273,81,74,570,214,570,61,0,153
1859806,25,11,1988,3,"female",575,26,10,16,43,16,43,0,0
1859815,52,25,1961,9,"female",788,38,22,36,17,3,11,33,6
1859821,20,12,1993,12,"male",133,38,33,3,8,3,8,0,0
1859838,33,26,1980,5,"male",327,0,0,0,0,0,0,0,0
1859849,84,13,1929,10,"female",2315,94,64,24,57,1,18,23,39
1859863,25,5,1988,4,"male",121,12,11,0,0,0,0,0,0
1859871,67,4,1946,10,"female",55,43,25,2,0,2,0,0,0
1859923,15,1,1998,10,"male",176,33,22,0,0,0,0,0,0
1859940,20,3,1993,3,"male",143,0,0,0,0,0,0,0,0
1859995,18,13,1995,6,"male",130,44,35,0,0,0,0,0,0
1859999,27,22,1986,5,"male",107,46,25,0,19,0,19,0,0
1860063,16,20,1997,4,"male",147,26,20,0,0,0,0,0,0
1860083,39,4,1974,5,"male",240,1,1,3,2,3,2,0,0
1860089,25,28,1988,4,"male",185,44,40,12,3,0,1,12,2
1860094,21,5,1992,5,"male",699,66,37,0,10,0,8,0,2
1860119,24,18,1989,11,"male",249,131,128,0,2,0,2,0,0
1860120,37,4,1976,9,"female",534,48,34,1,0,1,0,0,0
1860124,14,29,1999,4,"male",243,196,139,0,1,0,0,0,1
1860140,58,12,1955,4,"female",457,14,6,0,0,0,0,0,0
1860157,66,5,1947,1,"male",1113,276,86,0,1,0,1,0,0
1860175,81,21,1932,10,"male",1673,17,10,2,4,0,4,2,0
1860176,44,6,1969,10,"female",100,23,12,0,5,0,2,0,3
1860186,29,13,1984,6,"male",484,17,14,0,0,0,0,0,0
1860210,25,1,1988,4,"male",955,153,26,264,73,264,73,0,0
1860249,31,14,1982,2,"female",229,86,12,9,129,0,77,9,52
1860305,69,8,1944,7,"female",450,31,30,5,10,0,0,5,10
1860341,65,28,1948,4,"male",125,0,0,0,0,0,0,0,0
1860353,22,6,1991,1,"male",667,230,158,0,0,0,0,0,0
1860355,21,10,1992,1,"male",538,215,131,500,50,500,46,0,4
1860368,57,18,1956,4,"male",1050,97,68,7,11,7,11,0,0
1860404,110,2,1903,3,NA,2219,503,167,26,4,25,2,1,2
1860411,62,26,1951,5,"female",914,137,86,103,139,103,75,0,64
1860425,23,12,1990,9,"female",36,12,12,453,22,453,13,0,9
1860442,108,1,1905,1,"female",1313,46,22,0,0,0,0,0,0
1860467,25,9,1988,1,"female",206,0,0,0,0,0,0,0,0
1860468,26,19,1987,5,"male",307,75,62,75,14,75,12,0,2
1860488,20,24,1993,12,"female",302,59,46,9,46,4,29,5,17
1860501,40,29,1973,6,"female",424,30,23,20,40,11,20,9,20
1860502,27,6,1986,9,"female",304,32,17,3,7,3,6,0,1
1860536,103,26,1910,9,"female",746,79,31,0,5,0,2,0,3
1860542,53,21,1960,9,"female",914,47,27,90,173,49,92,41,81
1860544,22,2,1991,8,"male",504,107,66,12,1,9,0,3,1
1860548,62,19,1951,10,"female",1750,157,121,155,92,0,31,155,61
1860565,75,13,1938,1,"female",421,38,32,49,8,0,4,49,4
1860573,18,3,1995,4,"female",637,716,351,394,493,266,145,128,348
1860599,53,4,1960,10,"male",328,74,22,33,7,33,7,0,0
1860624,37,26,1976,3,"male",288,0,0,0,0,0,0,0,0
1860625,14,16,1999,5,"female",341,67,35,261,73,0,34,261,39
1860630,16,10,1997,1,"female",211,21,14,1,0,1,0,0,0
1860631,19,21,1994,3,"male",720,665,491,1036,451,762,409,274,42
1860632,20,9,1993,1,"male",636,13,9,8,2,8,2,0,0
1860640,70,15,1943,6,"male",1850,43,31,6,0,0,0,6,0
1860643,61,3,1952,5,"female",469,69,36,36,10,36,6,0,4
1860661,23,27,1990,6,"female",265,16,12,12,0,12,0,0,0
1860664,20,14,1993,7,"male",48,31,28,34,13,32,5,2,8
1860696,19,16,1994,10,"male",581,150,107,112,76,112,51,0,25
1860735,43,28,1970,7,"male",185,60,58,4,4,4,1,0,3
1860748,48,2,1965,5,"female",247,12,10,116,39,0,19,116,20
1860772,33,6,1980,7,"male",86,34,28,1,4,0,0,1,4
1860774,28,4,1985,8,"male",717,61,54,0,0,0,0,0,0
1860786,40,22,1973,2,"female",474,17,15,134,21,134,16,0,5
1860794,44,5,1969,1,"female",169,2,2,0,0,0,0,0,0
1860798,18,1,1995,7,"female",342,234,191,14,8,14,8,0,0
1860807,49,20,1964,12,"male",32,24,15,10,0,0,0,10,0
1860809,37,17,1976,9,"female",593,153,95,128,450,127,143,1,307
1860820,65,13,1948,8,"female",57,31,21,1,5,1,1,0,4
1860848,46,1,1967,8,"female",97,19,16,272,461,272,381,0,80
1860850,14,18,1999,4,"male",428,37,31,8,0,6,0,2,0
1860855,18,8,1995,8,"male",72,5,4,6,3,0,0,6,3
1860868,17,14,1996,12,"female",42,65,54,762,65,762,41,0,24
1860882,19,17,1994,4,"female",280,0,0,0,0,0,0,0,0
1860914,49,2,1964,12,"male",286,51,31,1,4,0,4,1,0
1860922,42,27,1971,9,"male",428,13,7,34,0,0,0,34,0
1860970,103,6,1910,3,"male",661,627,534,1338,260,1338,242,0,18
1860974,76,10,1937,11,"male",273,50,33,0,3,0,1,0,2
1860993,23,11,1990,12,"male",441,84,66,1,6,1,4,0,2
1860999,58,21,1955,10,"female",802,86,54,356,381,355,230,1,151
1861003,34,2,1979,3,"female",338,13,11,2,4,0,3,2,1
1861011,55,14,1958,10,"male",370,5,4,0,0,0,0,0,0
1861074,14,14,1999,6,"female",345,669,553,15,21,6,12,9,9
1861123,16,9,1997,5,"female",128,621,251,157,207,109,120,48,87
1861141,18,3,1995,2,"female",135,1181,71,2,72,2,35,0,37
1861154,22,1,1991,1,"male",115,9,4,0,2,0,0,0,2
1861177,21,11,1992,2,"female",381,136,107,0,1,0,0,0,1
1861181,40,13,1973,5,"female",1176,150,103,244,605,212,447,32,158
1861188,35,1,1978,1,"male",211,23,23,9,1,0,0,9,1
1861203,63,4,1950,1,"male",1595,81,41,9,11,9,5,0,6
1861209,14,9,1999,9,"male",342,21,18,0,0,0,0,0,0
1861217,20,11,1993,4,"male",644,55,15,29,24,15,14,14,10
1861226,77,30,1936,4,"female",1759,88,25,6,43,6,32,0,11
1861236,43,11,1970,4,"male",538,1,1,0,0,0,0,0,0
1861237,66,19,1947,2,"male",927,26,14,0,0,0,0,0,0
1861243,32,9,1981,7,"male",204,28,12,1,1,1,1,0,0
1861255,37,23,1976,12,"male",1025,28,23,0,26,0,22,0,4
1861256,25,12,1988,5,"male",49,1,1,7,0,0,0,7,0
1861287,26,26,1987,6,"female",274,57,22,317,102,316,77,1,25
1861303,17,4,1996,12,"male",59,46,36,2,0,2,0,0,0
1861310,35,1,1978,5,"female",849,54,27,1892,404,1784,217,108,187
1861337,18,9,1995,9,"male",132,181,172,82,13,82,11,0,2
1861353,29,18,1984,11,"female",190,39,30,67,11,67,3,0,8
1861359,67,15,1946,9,"male",1503,35,17,5,2,0,1,5,1
1861371,17,8,1996,10,"male",81,79,60,13,4,7,1,6,3
1861377,23,7,1990,5,"male",162,1029,1008,2,0,2,0,0,0
1861380,22,2,1991,8,"male",82,66,66,1,3,1,3,0,0
1861387,45,1,1968,10,"male",242,16,15,0,0,0,0,0,0
1861402,31,28,1982,10,"male",629,94,66,0,0,0,0,0,0
1861403,43,10,1970,3,"male",159,80,70,8,27,8,10,0,17
1861448,103,12,1910,11,"male",978,223,86,319,241,53,70,266,171
1861466,15,26,1998,1,"female",365,318,151,350,144,341,88,9,56
1861471,18,27,1995,8,"male",799,140,57,1,0,1,0,0,0
1861483,15,11,1998,11,"male",408,131,49,5,16,0,1,5,15
1861487,63,9,1950,3,"male",552,260,119,130,132,40,26,90,106
1861497,19,30,1994,9,"male",206,77,63,9,5,2,2,7,3
1861510,61,10,1952,12,"male",415,34,27,34,15,4,11,30,4
1861530,21,23,1992,12,"female",627,238,171,33,40,33,39,0,1
1861540,35,7,1978,7,"male",281,6,4,0,0,0,0,0,0
1861572,22,5,1991,1,"male",573,545,436,3,21,3,17,0,4
1861580,58,13,1955,7,"female",500,56,47,24,7,0,1,24,6
1861590,30,4,1983,2,"female",633,79,39,200,2,200,2,0,0
1861595,16,3,1997,8,"male",535,1265,383,269,411,269,268,0,143
1861640,61,21,1952,3,"female",370,128,73,297,69,0,39,297,30
1861664,22,11,1991,9,"male",1333,79,28,6,5,6,1,0,4
1861667,31,1,1982,1,"male",288,107,51,10,2,10,2,0,0
1861684,16,13,1997,12,"male",1,53,50,20,4,0,3,20,1
1861701,51,13,1962,12,"male",365,59,20,1,5,0,2,1,3
1861739,73,1,1940,1,"male",1222,277,144,36,73,34,57,2,16
1861743,51,1,1962,3,"male",1187,143,47,15,6,15,5,0,1
1861747,61,29,1952,6,"female",831,163,120,1,10,0,6,1,4
1861781,14,17,1999,5,"male",88,23,20,28,6,1,1,27,5
1861808,27,20,1986,6,"male",112,85,45,441,168,441,146,0,22
1861820,35,24,1978,4,"male",214,16,13,308,101,308,95,0,6
1861841,19,25,1994,11,"male",181,614,556,2,8,2,7,0,1
1861860,45,8,1968,8,"female",454,27,13,31,21,27,11,4,10
1861873,33,22,1980,10,"male",183,146,53,4,39,4,37,0,2
1861934,31,10,1982,8,"female",775,1177,1009,507,634,498,557,9,77
1861943,25,11,1988,7,"male",194,122,51,9,14,9,8,0,6
1861956,68,20,1945,3,"female",849,158,112,158,11,0,7,158,4
1861963,54,17,1959,2,"male",1506,292,73,796,116,387,45,409,71
1861966,29,1,1984,1,"male",803,24,10,0,0,0,0,0,0
1861974,37,28,1976,8,"female",625,26,7,13,9,13,7,0,2
1861986,16,22,1997,9,"female",151,311,118,35,9,35,8,0,1
1861999,28,12,1985,10,"male",266,71,51,12,141,12,108,0,33
1862007,19,21,1994,2,"male",643,116,84,18,17,18,15,0,2
1862023,66,12,1947,6,"male",354,92,62,2,17,2,17,0,0
1862042,20,17,1993,8,"male",550,74,65,0,3,0,2,0,1
1862076,18,28,1995,6,"male",115,219,207,52,16,52,16,0,0
1862079,43,15,1970,8,"female",181,8,6,0,0,0,0,0,0
1862108,20,28,1993,6,"female",492,413,218,81,428,63,244,18,184
1862135,14,22,1999,5,"female",523,212,112,176,101,144,67,32,34
1862137,15,12,1998,3,"male",762,291,127,2,4,0,2,2,2
1862143,66,10,1947,1,"female",2180,222,19,410,202,257,110,153,92
1862162,23,25,1990,5,"male",378,182,166,12,6,12,6,0,0
1862164,31,26,1982,4,"male",266,106,86,0,0,0,0,0,0
1862167,23,11,1990,2,"male",642,194,119,0,0,0,0,0,0
1862170,31,22,1982,7,"male",1459,169,114,6,54,6,32,0,22
1862175,26,12,1987,1,"female",330,8,5,0,0,0,0,0,0
1862241,27,1,1986,1,"female",752,296,37,5,27,5,18,0,9
1862254,54,17,1959,2,"male",522,217,118,897,300,897,263,0,37
1862266,26,9,1987,5,"male",391,10,1,0,0,0,0,0,0
1862270,18,11,1995,6,"male",219,273,180,0,0,0,0,0,0
1862300,18,4,1995,11,"male",887,476,355,26,2,26,2,0,0
1862318,64,5,1949,6,"female",1881,109,50,36,11,33,6,3,5
1862331,93,15,1920,5,"male",104,17,10,0,0,0,0,0,0
1862332,48,8,1965,8,"male",121,0,0,0,0,0,0,0,0
1862339,42,29,1971,8,"female",199,32,19,73,96,73,88,0,8
1862353,18,5,1995,3,"female",161,65,40,49,29,49,10,0,19
1862429,103,6,1910,5,"male",171,105,89,7,1,7,0,0,1
1862434,38,28,1975,5,"male",495,122,9,5,0,5,0,0,0
1862504,33,19,1980,5,"female",395,72,44,27,39,27,19,0,20
1862511,68,28,1945,1,"male",365,532,145,7,8,3,6,4,2
1862520,48,6,1965,3,"male",614,0,0,0,0,0,0,0,0
1862523,37,15,1976,2,"female",118,242,52,473,270,473,241,0,29
1862543,61,22,1952,12,"female",264,140,115,12,47,12,32,0,15
1862547,18,11,1995,11,"female",22,47,6,0,4,0,3,0,1
1862572,30,26,1983,1,"female",255,59,33,51,42,11,31,40,11
1862621,24,11,1989,1,"male",319,93,54,0,8,0,4,0,4
1862644,16,10,1997,9,"male",482,63,51,65,3,0,0,65,3
1862649,17,23,1996,9,"male",405,400,321,5,45,5,20,0,25
1862661,38,5,1975,5,"male",689,8,7,0,0,0,0,0,0
1862674,22,26,1991,10,"male",618,38,18,1,1,1,1,0,0
1862676,66,5,1947,1,"male",1242,48,35,0,0,0,0,0,0
1862682,36,7,1977,12,"male",413,251,184,210,11,210,9,0,2
1862697,21,21,1992,3,"male",14,19,11,7,21,7,17,0,4
1862725,57,1,1956,4,"female",267,29,15,10,15,10,11,0,4
1862728,42,26,1971,12,"female",246,20,13,0,0,0,0,0,0
1862759,46,15,1967,10,"male",706,331,186,6,1,6,1,0,0
1862763,70,27,1943,2,"female",451,39,16,6,0,0,0,6,0
1862774,74,3,1939,12,"male",138,70,32,4,2,4,2,0,0
1862781,16,23,1997,1,"male",447,46,37,2,7,0,5,2,2
1862782,26,8,1987,7,"male",210,10,3,2,0,0,0,2,0
1862793,52,19,1961,10,"female",1304,167,108,1387,1927,516,884,871,1043
1862794,103,1,1910,1,"male",1028,629,510,10,33,7,23,3,10
1862800,32,19,1981,6,"male",1608,84,29,9,7,5,0,4,7
1862808,55,21,1958,1,"female",1403,82,41,21,8,16,6,5,2
1862824,44,5,1969,9,"male",759,170,95,544,243,543,216,1,27
1862832,16,21,1997,8,"male",525,72,34,1,1,0,0,1,1
1862853,22,16,1991,1,"male",106,76,56,4,7,4,5,0,2
1862870,27,6,1986,6,"female",55,7,4,242,33,232,27,10,6
1862871,18,17,1995,4,"male",490,116,72,10,28,10,24,0,4
1862898,62,14,1951,5,"male",731,29,13,0,1,0,0,0,1
1862905,18,31,1995,5,"female",358,1865,1359,78,485,78,338,0,147
1862917,101,13,1912,10,"female",615,53,29,186,124,184,82,2,42
1862951,34,9,1979,8,"male",108,11,10,1,1,0,0,1,1
1862954,35,20,1978,5,"male",311,27,24,16,8,0,8,16,0
1862965,25,1,1988,1,"male",296,1,1,0,0,0,0,0,0
1862978,26,17,1987,2,"male",696,10,8,27,1,0,1,27,0
1862990,31,21,1982,4,"female",1078,138,57,3137,3154,0,407,3137,2747
1863000,53,10,1960,7,"male",80,21,15,2,3,0,2,2,1
1863027,16,4,1997,4,"male",121,176,99,0,0,0,0,0,0
1863035,36,7,1977,1,"male",620,26,17,0,0,0,0,0,0
1863052,29,19,1984,10,"male",202,1,0,0,0,0,0,0,0
1863062,45,12,1968,2,"female",195,17,14,0,0,0,0,0,0
1863112,33,28,1980,9,"male",1766,29,20,191,40,90,31,101,9
1863134,32,20,1981,8,"male",612,184,129,3,12,3,11,0,1
1863156,23,14,1990,6,"female",279,67,33,22,26,22,19,0,7
1863173,23,15,1990,7,"male",725,96,62,250,17,239,5,11,12
1863178,53,31,1960,12,"female",315,14,14,1,0,1,0,0,0
1863217,54,28,1959,8,"female",355,1,1,0,0,0,0,0,0
1863221,17,2,1996,2,"male",39,51,39,4,8,4,0,0,8
1863233,22,25,1991,12,"male",42,17,15,0,0,0,0,0,0
1863243,22,11,1991,1,"male",128,78,38,56,5,42,4,14,1
1863253,22,3,1991,3,"female",240,77,39,0,6,0,0,0,6
1863267,21,11,1992,2,"female",683,338,127,1292,109,1292,102,0,7
1863328,31,16,1982,6,"female",67,253,100,350,254,243,246,107,8
1863344,42,29,1971,9,"female",377,13,9,46,5,46,5,0,0
1863348,15,1,1998,1,"male",244,1,0,0,0,0,0,0,0
1863370,70,16,1943,7,"male",1185,39,28,15,16,15,12,0,4
1863375,59,5,1954,9,"male",1439,90,20,89,77,88,15,1,62
1863423,52,17,1961,9,"female",464,50,44,9,10,9,9,0,1
1863435,47,21,1966,5,"female",271,24,5,7,3,7,2,0,1
1863469,29,4,1984,4,"female",566,1,0,0,0,0,0,0,0
1863520,19,1,1994,5,"male",22,4,3,0,0,0,0,0,0
1863527,18,3,1995,1,"male",854,14,13,3,0,3,0,0,0
1863531,29,28,1984,9,"male",225,0,0,0,0,0,0,0,0
1863581,41,2,1972,2,"male",506,12,3,0,0,0,0,0,0
1863587,20,16,1993,10,"female",525,140,56,1,0,1,0,0,0
1863594,103,17,1910,4,"male",465,109,74,105,6,105,4,0,2
1863596,72,21,1941,4,"male",426,1312,1118,6,3,5,1,1,2
1863604,17,28,1996,5,"male",146,93,85,109,0,109,0,0,0
1863627,50,3,1963,1,"male",334,23,10,118,4,0,2,118,2
1863629,19,3,1994,9,"female",389,397,299,99,294,75,102,24,192
1863633,64,18,1949,7,"male",163,5,4,0,0,0,0,0,0
1863654,21,23,1992,5,"male",27,15,15,0,0,0,0,0,0
1863676,93,10,1920,9,"female",129,47,33,7,5,7,3,0,2
1863677,69,17,1944,8,"male",446,50,32,118,5,46,4,72,1
1863680,14,30,1999,3,"male",211,42,36,0,0,0,0,0,0
1863696,24,13,1989,11,"female",279,44,27,212,18,212,16,0,2
1863699,75,1,1938,1,"female",1399,318,43,192,125,14,67,178,58
1863711,26,16,1987,7,"female",484,241,177,313,195,313,162,0,33
1863717,106,12,1907,8,"female",1445,57,21,2,2,0,1,2,1
1863725,50,16,1963,9,"female",508,27,19,3,0,3,0,0,0
1863747,40,23,1973,7,"female",628,9,3,1,0,1,0,0,0
1863754,73,3,1940,3,"female",91,8,6,1,1,0,1,1,0
1863786,23,25,1990,2,"female",474,156,113,222,257,84,139,138,118
1863835,37,8,1976,10,"male",195,49,34,0,0,0,0,0,0
1863873,30,23,1983,2,"female",732,591,257,440,459,316,264,124,195
1863881,32,16,1981,11,"male",567,111,49,0,0,0,0,0,0
1863890,24,10,1989,10,"male",166,0,0,0,0,0,0,0,0
1863894,21,16,1992,10,"male",795,154,134,0,1,0,1,0,0
1863901,29,2,1984,4,"male",64,95,74,0,0,0,0,0,0
1863926,17,1,1996,10,"female",135,52,24,2,14,2,12,0,2
1863977,16,12,1997,2,"female",183,808,255,694,744,677,623,17,121
1863986,20,16,1993,11,"male",516,63,34,0,7,0,7,0,0
1863991,17,22,1996,1,"female",160,190,143,79,143,79,129,0,14
1863995,20,13,1993,5,"male",336,404,297,91,141,81,54,10,87
1863999,29,16,1984,3,"female",155,46,19,4,1,4,1,0,0
1864001,66,19,1947,4,"female",2184,61,25,4,0,1,0,3,0
1864034,25,1,1988,1,"male",118,44,11,469,248,459,142,10,106
1864037,14,8,1999,4,"female",157,380,202,485,234,148,76,337,158
1864045,16,14,1997,1,"male",282,127,71,11,6,11,6,0,0
1864061,37,1,1976,1,"female",126,35,28,14,4,14,1,0,3
1864067,73,4,1940,7,"female",1907,108,25,71,78,70,57,1,21
1864070,31,10,1982,10,"male",265,158,138,1,0,1,0,0,0
1864097,18,1,1995,1,"male",14,15,12,1,1,1,1,0,0
1864101,34,26,1979,8,"male",237,11,6,1,0,1,0,0,0
1864112,29,9,1984,7,"female",338,113,92,0,0,0,0,0,0
1864125,27,5,1986,2,"male",995,1,1,0,0,0,0,0,0
1864183,20,19,1993,3,"female",673,165,46,109,3,109,2,0,1
1864214,27,24,1986,10,"male",103,1,0,0,0,0,0,0,0
1864238,23,28,1990,2,"female",500,86,76,0,2,0,0,0,2
1864259,33,8,1980,7,"female",175,46,22,23,1,23,1,0,0
1864303,65,11,1948,3,"male",420,148,93,771,247,110,85,661,162
1864361,18,14,1995,12,"female",1167,229,101,266,458,2,64,264,394
1864380,108,29,1905,6,"female",1193,880,292,2,68,2,46,0,22
1864383,30,28,1983,5,"male",1544,41,25,11,1,11,1,0,0
1864390,19,1,1994,1,"male",249,99,86,137,29,136,23,1,6
1864396,67,8,1946,4,"male",946,24,17,2,10,2,10,0,0
1864419,54,1,1959,4,"male",845,93,17,4,31,4,30,0,1
1864431,37,9,1976,3,"female",334,22,10,281,22,281,10,0,12
1864450,89,17,1924,5,"male",2076,572,249,79,27,66,5,13,22
1864521,49,31,1964,3,"male",217,7,6,0,0,0,0,0,0
1864533,59,10,1954,4,"female",323,37,17,9,15,9,13,0,2
1864584,50,27,1963,11,"male",987,28,19,0,0,0,0,0,0
1864646,78,25,1935,9,"female",357,10,7,0,12,0,1,0,11
1864678,26,1,1987,1,"male",636,82,44,44,18,40,8,4,10
1864705,15,30,1998,6,"female",374,326,67,47,0,47,0,0,0
1864721,33,19,1980,3,"male",279,209,121,166,158,165,155,1,3
1864722,59,7,1954,10,"female",677,70,40,5,0,0,0,5,0
1864761,59,29,1954,6,"female",425,644,226,4981,9233,1442,4072,3539,5161
1864763,15,27,1998,12,"male",186,8,3,0,0,0,0,0,0
1864775,18,1,1995,7,"female",243,132,98,434,74,434,67,0,7
1864777,29,14,1984,3,"female",598,74,30,1,5,1,5,0,0
1864783,64,3,1949,9,"female",1497,301,134,615,352,115,142,500,210
1864813,25,1,1988,1,"male",146,29,18,4,38,4,38,0,0
1864831,17,15,1996,3,"male",281,258,223,2,0,2,0,0,0
1864838,61,12,1952,8,"female",147,25,20,1,1,1,1,0,0
1864923,13,23,2000,1,"male",228,61,53,5,0,5,0,0,0
1864924,52,18,1961,1,"female",88,101,89,15,42,0,9,15,33
1864950,50,11,1963,3,"male",427,1,1,0,0,0,0,0,0
1864952,55,2,1958,7,"male",173,7,7,2,0,2,0,0,0
1864962,16,21,1997,12,"male",505,60,21,0,13,0,13,0,0
1864978,18,23,1995,3,"male",58,22,22,0,1,0,1,0,0
1865027,25,10,1988,3,"male",495,44,33,1,5,1,5,0,0
1865038,16,6,1997,7,"male",280,20,3,0,2,0,2,0,0
1865044,36,25,1977,5,"male",152,39,22,0,0,0,0,0,0
1865059,54,10,1959,1,"male",757,124,44,14,0,2,0,12,0
1865060,15,18,1998,10,"female",396,86,73,227,350,75,157,152,193
1865069,24,6,1989,8,"male",477,29,20,3,0,3,0,0,0
1865077,18,8,1995,5,"female",206,13,8,0,1,0,0,0,1
1865089,29,9,1984,5,"male",748,261,119,83,155,72,121,11,34
1865124,59,20,1954,3,"female",1260,194,106,56,173,39,114,17,59
1865128,70,11,1943,4,"female",2135,52,27,1,5,0,5,1,0
1865137,19,1,1994,10,"female",437,104,19,1,0,1,0,0,0
1865141,26,1,1987,1,"male",405,137,130,0,13,0,1,0,12
1865156,42,28,1971,6,"male",116,55,39,22,7,0,3,22,4
1865167,64,2,1949,5,"female",693,62,37,51,68,0,24,51,44
1865170,29,14,1984,2,"male",597,106,81,3,1,3,1,0,0
1865175,30,23,1983,12,"male",14,8,6,0,0,0,0,0,0
1865177,24,2,1989,5,"female",644,0,0,0,0,0,0,0,0
1865206,26,29,1987,7,"male",48,104,88,0,1,0,1,0,0
1865211,27,24,1986,1,"female",260,119,95,704,194,704,153,0,41
1865217,18,16,1995,7,"male",403,1,1,0,0,0,0,0,0
1865261,22,11,1991,7,"female",1502,423,201,5,21,5,6,0,15
1865269,85,5,1928,8,"female",1405,264,232,54,138,0,52,54,86
1865289,16,24,1997,3,"male",266,35,29,0,0,0,0,0,0
1865311,100,3,1913,1,"female",1710,170,45,72,74,72,34,0,40
1865313,46,20,1967,4,"male",604,172,77,0,1,0,1,0,0
1865329,55,6,1958,9,"male",449,18,16,0,0,0,0,0,0
1865351,16,28,1997,10,"female",695,940,461,1274,1107,1123,972,151,135
1865375,34,11,1979,7,"female",208,58,49,109,21,109,11,0,10
1865393,15,16,1998,11,"female",94,67,48,34,0,34,0,0,0
1865407,50,4,1963,6,"female",714,72,53,22,1,0,1,22,0
1865413,25,28,1988,8,"male",7,7,4,0,1,0,0,0,1
1865431,24,11,1989,8,"male",748,331,212,0,0,0,0,0,0
1865439,17,17,1996,2,"female",304,165,111,11,0,11,0,0,0
1865484,45,27,1968,2,"male",17,49,33,2,17,2,13,0,4
1865492,27,29,1986,8,"female",27,10,10,209,12,207,11,2,1
1865498,48,24,1965,10,"male",328,0,0,0,0,0,0,0,0
1865501,17,29,1996,6,"female",25,406,175,122,286,59,154,63,132
1865505,37,11,1976,3,"female",267,180,100,56,32,18,1,38,31
1865521,21,25,1992,10,"male",288,124,91,27,26,25,17,2,9
1865529,15,20,1998,9,"female",636,2769,453,6135,5444,5515,4021,620,1423
1865532,28,19,1985,6,"female",108,85,47,16,16,16,16,0,0
1865553,49,7,1964,7,"female",206,22,9,35,6,35,3,0,3
1865564,40,26,1973,10,"female",290,127,108,10,90,10,28,0,62
1865569,23,6,1990,1,"female",810,330,143,5,29,5,19,0,10
1865580,54,12,1959,6,"male",49,110,84,522,8,522,6,0,2
1865593,30,2,1983,11,"male",197,228,197,0,7,0,7,0,0
1865595,18,2,1995,4,"male",309,201,176,36,7,36,1,0,6
1865599,28,6,1985,8,"female",412,177,62,919,421,886,339,33,82
1865617,16,17,1997,7,"female",883,455,179,0,2,0,1,0,1
1865655,20,17,1993,7,"female",316,141,43,258,156,187,75,71,81
1865656,31,3,1982,5,"male",383,80,43,2,0,0,0,2,0
1865675,43,1,1970,10,"female",553,15,11,154,24,3,16,151,8
1865688,16,16,1997,7,"male",290,152,125,4,2,4,2,0,0
1865692,21,22,1992,6,"female",34,21,11,2,26,2,22,0,4
1865703,51,30,1962,8,"female",505,133,99,561,209,561,185,0,24
1865704,67,24,1946,6,"male",1880,29,9,42,54,42,29,0,25
1865705,53,25,1960,1,"female",968,79,42,58,35,58,29,0,6
1865724,27,5,1986,8,"male",243,172,84,1,38,1,37,0,1
1865731,66,6,1947,3,"female",605,138,126,1322,132,0,26,1322,106
1865751,58,26,1955,6,"male",97,10,5,15,24,9,16,6,8
1865787,28,24,1985,9,"female",542,485,448,113,307,104,271,9,36
1865794,66,9,1947,7,"male",1154,87,45,17,11,16,4,1,7
1865796,103,23,1910,5,"male",400,669,548,107,66,107,36,0,30
1865797,44,17,1969,2,"male",1608,481,164,10,19,10,18,0,1
1865799,22,3,1991,5,"male",55,14,4,5,7,5,1,0,6
1865803,19,5,1994,9,"female",653,850,566,444,474,420,420,24,54
1865804,71,29,1942,11,"male",516,28,22,21,0,2,0,19,0
1865814,34,29,1979,8,"female",295,34,12,0,0,0,0,0,0
1865829,36,2,1977,1,"male",114,73,53,298,77,298,49,0,28
1865843,60,12,1953,2,"female",732,82,41,1041,347,1041,205,0,142
1865849,19,23,1994,11,"male",654,299,244,0,2,0,2,0,0
1865850,36,1,1977,8,"female",342,20,5,309,34,234,27,75,7
1865856,108,18,1905,9,"male",1178,678,192,4,52,4,45,0,7
1865868,41,6,1972,4,"male",116,59,12,0,19,0,12,0,7
1865877,16,14,1997,8,"male",755,300,216,4,4,4,4,0,0
1865879,24,11,1989,11,"male",313,109,87,2,0,2,0,0,0
1865922,103,8,1910,3,"male",438,86,62,72,12,72,9,0,3
1865949,100,18,1913,1,"female",2483,581,183,4,42,4,28,0,14
1865950,108,14,1905,10,"female",2339,158,53,46,4,1,3,45,1
1865951,60,29,1953,3,"female",403,17,12,60,56,60,41,0,15
1865971,113,19,1900,2,"female",1613,204,74,88,346,85,275,3,71
1865982,26,1,1987,1,"male",584,12,12,0,0,0,0,0,0
1865992,20,19,1993,3,"female",670,247,126,1,1,1,0,0,1
1866002,16,25,1997,4,"male",238,131,90,31,2,31,2,0,0
1866048,50,3,1963,4,"female",733,83,46,464,367,446,283,18,84
1866091,23,20,1990,3,"female",284,648,202,102,719,13,292,89,427
1866108,46,1,1967,9,"male",32,3,3,2,0,2,0,0,0
1866145,65,6,1948,3,"female",1380,66,30,331,212,0,39,331,173
1866165,16,6,1997,1,"male",206,644,368,540,1269,45,1014,495,255
1866178,54,21,1959,3,"male",107,10,7,0,0,0,0,0,0
1866199,23,16,1990,9,"male",342,51,44,8,14,8,10,0,4
1866216,24,17,1989,11,"male",1550,804,293,8,5,8,5,0,0
1866250,49,11,1964,6,"female",312,286,127,922,583,899,543,23,40
1866270,43,1,1970,12,"female",422,53,37,80,70,80,20,0,50
1866281,13,14,2000,2,"male",250,305,254,6,5,0,1,6,4
1866306,29,12,1984,9,"female",592,16,9,31,0,0,0,31,0
1866326,54,12,1959,4,"female",1836,190,81,83,23,56,18,27,5
1866332,32,17,1981,9,"female",464,0,0,0,0,0,0,0,0
1866362,23,23,1990,6,"male",262,189,112,0,0,0,0,0,0
1866376,50,11,1963,2,"female",1738,489,383,179,156,176,113,3,43
1866378,19,25,1994,7,"male",480,130,13,20,9,20,8,0,1
1866382,33,1,1980,1,"male",619,294,118,21,14,21,14,0,0
1866403,22,6,1991,1,"male",565,486,362,58,149,58,131,0,18
1866427,64,26,1949,10,"female",1426,179,89,1,27,0,12,1,15
1866440,58,28,1955,7,"male",1462,100,70,8,30,0,1,8,29
1866442,64,13,1949,1,"female",528,24,7,54,85,0,1,54,84
1866498,62,13,1951,7,"male",828,81,49,2607,387,351,23,2256,364
1866506,66,15,1947,1,"female",318,25,10,0,0,0,0,0,0
1866513,18,3,1995,3,"female",316,548,342,379,284,379,248,0,36
1866527,33,16,1980,12,"female",770,372,186,1151,640,921,265,230,375
1866540,66,22,1947,1,"female",540,79,68,10,2,10,2,0,0
1866575,104,30,1909,5,"male",1827,1159,235,1,23,0,13,1,10
1866611,54,16,1959,4,"female",642,103,39,0,0,0,0,0,0
1866665,25,18,1988,5,"male",762,351,197,30,94,17,39,13,55
1866677,36,22,1977,12,"male",412,25,4,1,0,1,0,0,0
1866678,23,10,1990,3,"male",37,22,19,0,0,0,0,0,0
1866679,21,25,1992,8,"male",349,637,419,33,4,33,4,0,0
1866684,22,15,1991,4,"male",349,48,42,74,51,74,42,0,9
1866689,49,8,1964,8,"male",741,13,8,12,7,12,4,0,3
1866690,23,13,1990,6,"female",783,547,387,123,466,89,244,34,222
1866691,30,15,1983,12,"female",276,10,10,60,0,59,0,1,0
1866697,18,10,1995,10,"female",245,102,77,0,0,0,0,0,0
1866729,35,1,1978,11,"male",325,50,24,30,34,30,24,0,10
1866753,63,8,1950,7,"female",1539,220,150,494,255,156,173,338,82
1866754,76,3,1937,6,"male",1996,80,27,1,40,0,11,1,29
1866774,35,1,1978,1,"male",440,101,51,122,64,122,57,0,7
1866780,31,26,1982,10,"female",183,72,35,49,21,49,14,0,7
1866781,106,21,1907,9,"male",1884,310,203,225,78,112,38,113,40
1866789,15,11,1998,5,"female",121,266,249,0,1,0,1,0,0
1866801,20,23,1993,10,"female",657,125,86,44,29,44,26,0,3
1866809,65,1,1948,11,"female",1021,128,51,222,71,222,67,0,4
1866843,18,4,1995,11,"male",444,253,193,165,2,5,2,160,0
1866860,21,13,1992,7,"female",363,548,476,394,204,26,27,368,177
1866867,27,7,1986,8,"male",499,101,71,0,7,0,2,0,5
1866869,20,17,1993,7,"male",366,57,48,0,0,0,0,0,0
1866889,18,10,1995,4,"male",604,82,22,2,0,2,0,0,0
1866896,41,5,1972,5,"male",444,207,33,11,6,11,6,0,0
1866919,63,22,1950,10,"female",473,16,12,50,2,0,0,50,2
1866926,45,8,1968,8,"female",55,120,103,29,29,29,28,0,1
1866936,43,16,1970,7,"female",724,163,59,176,80,172,71,4,9
1866942,63,8,1950,8,"female",54,38,17,9,7,2,5,7,2
1866952,18,22,1995,1,"male",469,18,11,0,1,0,1,0,0
1866992,25,31,1988,3,"female",431,13,8,11,8,11,5,0,3
1866999,19,23,1994,7,"female",432,283,106,40,46,40,38,0,8
1867014,23,4,1990,11,"female",432,175,111,2,6,2,3,0,3
1867020,53,12,1960,12,"male",828,0,0,0,0,0,0,0,0
1867027,33,18,1980,11,"male",494,35,35,0,0,0,0,0,0
1867045,45,17,1968,11,"female",292,32,20,12,1,12,1,0,0
1867054,26,23,1987,9,"male",296,243,124,363,1347,363,1110,0,237
1867062,18,1,1995,1,"male",40,23,22,0,1,0,0,0,1
1867071,38,1,1975,2,"female",48,25,22,34,12,34,11,0,1
1867075,16,28,1997,8,"female",352,320,169,26,29,7,8,19,21
1867103,29,7,1984,3,"female",532,77,54,0,2,0,0,0,2
1867108,30,12,1983,12,"male",534,277,207,161,235,53,95,108,140
1867109,18,1,1995,7,"male",123,70,62,0,0,0,0,0,0
1867147,31,7,1982,5,"female",278,45,32,143,37,85,24,58,13
1867157,22,15,1991,5,"male",242,103,83,23,14,5,4,18,10
1867202,36,4,1977,10,"female",553,82,51,126,101,16,71,110,30
1867212,17,15,1996,2,"male",472,131,61,503,20,503,17,0,3
1867214,34,3,1979,1,"male",551,13,6,5,1,5,1,0,0
1867219,18,10,1995,5,"female",629,728,306,8,41,8,34,0,7
1867258,25,17,1988,10,"male",179,62,57,187,123,141,44,46,79
1867273,59,8,1954,10,"male",711,16,8,0,0,0,0,0,0
1867291,23,19,1990,3,"male",168,60,48,3,36,3,9,0,27
1867294,22,13,1991,6,"male",253,109,87,1,6,1,6,0,0
1867308,60,14,1953,9,"male",1064,64,41,0,0,0,0,0,0
1867324,65,7,1948,3,"female",474,127,81,75,149,0,52,75,97
1867334,43,29,1970,8,"female",141,6,4,17,30,17,30,0,0
1867347,27,31,1986,10,"male",187,58,38,2,17,1,14,1,3
1867413,22,22,1991,3,"female",253,2,2,0,2,0,2,0,0
1867415,26,23,1987,4,"female",597,10,4,0,0,0,0,0,0
1867506,47,10,1966,3,"female",912,43,28,10,5,4,4,6,1
1867521,19,29,1994,11,"female",303,121,75,242,81,242,78,0,3
1867523,31,30,1982,12,"female",317,110,56,0,1,0,1,0,0
1867530,22,25,1991,3,"female",471,205,68,25,37,25,30,0,7
1867532,19,8,1994,5,"male",458,948,780,925,676,789,536,136,140
1867553,23,20,1990,7,"female",411,56,34,4,1,0,0,4,1
1867556,33,22,1980,5,"male",1246,64,32,0,1,0,0,0,1
1867559,28,25,1985,12,"female",340,414,196,22,35,0,25,22,10
1867567,81,4,1932,5,"male",1361,61,27,0,0,0,0,0,0
1867583,33,1,1980,1,"female",100,39,28,1,2,1,2,0,0
1867596,32,12,1981,7,"male",514,227,128,371,178,371,147,0,31
1867610,17,14,1996,8,"male",371,74,62,9,4,9,4,0,0
1867623,27,27,1986,4,"male",533,103,76,2,0,2,0,0,0
1867646,45,18,1968,9,"male",306,20,15,0,3,0,3,0,0
1867677,19,2,1994,12,"male",296,379,200,106,449,106,421,0,28
1867678,46,16,1967,9,"female",147,33,21,16,23,16,17,0,6
1867687,41,24,1972,2,"male",838,57,31,0,0,0,0,0,0
1867705,21,4,1992,5,"male",383,68,44,28,13,18,1,10,12
1867713,52,3,1961,2,"male",794,62,42,4,0,4,0,0,0
1867721,35,25,1978,9,"male",597,126,106,78,37,46,4,32,33
1867743,37,23,1976,2,"male",426,71,49,10,4,10,0,0,4
1867769,18,27,1995,12,"male",394,196,161,0,1,0,1,0,0
1867775,20,1,1993,6,"female",555,81,43,4,4,3,2,1,2
1867810,26,11,1987,2,"male",311,93,53,6,7,0,2,6,5
1867833,18,27,1995,4,"female",583,223,42,9,20,0,15,9,5
1867838,42,21,1971,12,"male",507,1107,1010,55,39,55,23,0,16
1867847,53,2,1960,11,"female",706,13,8,7,7,3,5,4,2
1867864,68,9,1945,12,"male",761,2440,1735,666,500,648,380,18,120
1867871,23,1,1990,7,"male",430,64,31,6,4,4,3,2,1
1867897,27,4,1986,1,"female",72,1413,458,163,215,163,166,0,49
1867908,58,29,1955,9,"female",1245,93,48,941,383,941,207,0,176
1867918,30,18,1983,8,"male",165,36,36,24,11,24,10,0,1
1867934,18,14,1995,11,"female",133,25,18,0,1,0,1,0,0
1867938,46,11,1967,11,"male",642,20,12,11,0,11,0,0,0
1867945,62,31,1951,12,"female",673,134,82,625,121,0,50,625,71
1867948,25,18,1988,9,"male",665,34,26,0,14,0,9,0,5
1867969,25,12,1988,8,"male",603,119,108,3,7,3,4,0,3
1867998,16,11,1997,2,"female",826,2825,1002,514,502,462,429,52,73
1868082,20,3,1993,3,"male",909,261,186,4,23,3,18,1,5
1868108,37,20,1976,4,"male",383,21,18,0,2,0,0,0,2
1868118,66,19,1947,9,"female",1719,174,85,23,7,0,6,23,1
1868139,29,8,1984,8,"male",413,173,73,35,53,10,21,25,32
1868143,40,2,1973,1,"female",365,46,9,9,30,3,7,6,23
1868155,108,23,1905,10,"male",167,480,267,821,323,664,207,157,116
1868238,21,1,1992,1,"male",266,51,14,0,0,0,0,0,0
1868242,44,19,1969,6,"male",573,35,25,0,4,0,3,0,1
1868249,20,23,1993,1,"male",669,784,705,16,0,0,0,16,0
1868251,108,31,1905,1,"male",1263,108,39,0,1,0,1,0,0
1868253,47,8,1966,7,"female",289,65,23,50,77,50,26,0,51
1868298,57,15,1956,1,"female",579,9,3,0,0,0,0,0,0
1868326,22,15,1991,1,"male",211,21,10,22,12,0,2,22,10
1868348,108,17,1905,10,"male",532,172,81,870,491,0,64,870,427
1868390,49,12,1964,6,"female",437,106,62,793,235,784,103,9,132
1868426,21,23,1992,6,"female",25,1,0,3,1,1,0,2,1
1868454,68,27,1945,11,"female",56,33,18,237,122,237,74,0,48
1868477,22,25,1991,1,"female",304,112,50,168,111,168,95,0,16
1868478,32,9,1981,9,"female",638,54,41,162,61,162,27,0,34
1868493,33,15,1980,11,"male",1181,350,170,3,0,0,0,3,0
1868494,25,1,1988,7,"male",196,27,9,0,0,0,0,0,0
1868505,14,22,1999,8,"male",140,21,19,14,0,14,0,0,0
1868514,24,2,1989,5,"male",35,58,41,13,5,13,2,0,3
1868555,19,12,1994,1,"male",256,59,29,13,10,13,4,0,6
1868572,67,2,1946,12,"male",515,5,0,1,0,0,0,1,0
1868583,22,7,1991,10,"male",274,4078,773,3228,1956,1957,1436,1271,520
1868610,58,25,1955,8,"female",332,26,9,5,22,5,22,0,0
1868613,60,6,1953,1,"female",400,73,36,12,17,12,0,0,17
1868631,21,19,1992,2,"male",1185,277,132,230,102,37,63,193,39
1868685,62,27,1951,12,"female",1567,72,52,210,179,3,44,207,135
1868687,18,4,1995,6,"male",891,330,177,2,1,0,1,2,0
1868689,18,13,1995,2,"female",91,154,125,440,270,311,171,129,99
1868691,58,10,1955,3,"female",185,111,69,52,141,48,81,4,60
1868753,26,18,1987,4,"female",336,45,26,0,0,0,0,0,0
1868761,18,14,1995,2,"male",427,225,117,317,56,278,34,39,22
1868785,27,26,1986,2,"male",352,2,2,1,1,0,0,1,1
1868817,20,10,1993,4,"male",57,24,19,0,0,0,0,0,0
1868828,23,15,1990,1,"male",231,45,43,0,2,0,1,0,1
1868839,113,1,1900,5,"female",1463,115,37,23,3,23,2,0,1
1868847,34,8,1979,1,"female",526,232,144,425,594,425,518,0,76
1868853,23,1,1990,1,"male",220,56,32,82,74,82,56,0,18
1868859,19,12,1994,5,"male",667,167,94,4,4,4,2,0,2
1868869,66,27,1947,6,"male",64,11,9,0,0,0,0,0,0
1868891,31,8,1982,12,"male",200,13,8,52,2,0,2,52,0
1868901,29,1,1984,12,"female",53,1,1,2,0,0,0,2,0
1868931,20,3,1993,7,"male",509,98,51,94,31,94,26,0,5
1868935,43,23,1970,3,"male",547,57,5,3,19,0,9,3,10
1868944,66,20,1947,4,"female",1566,41,11,0,1,0,1,0,0
1869053,62,18,1951,9,"female",870,99,56,453,135,2,39,451,96
1869064,50,31,1963,3,"male",30,91,73,307,497,307,312,0,185
1869089,20,14,1993,7,"female",788,838,462,1021,501,675,440,346,61
1869097,18,1,1995,4,"male",106,35,10,7,0,1,0,6,0
1869115,30,1,1983,1,"male",809,11,9,6,0,6,0,0,0
1869130,26,1,1987,1,"female",304,1072,605,1179,5879,1179,5092,0,787
1869149,68,3,1945,6,"female",1352,30,20,546,13,535,3,11,10
1869160,80,12,1933,3,"male",1063,115,36,0,0,0,0,0,0
1869167,108,13,1905,12,"male",1121,406,223,266,14,141,6,125,8
1869174,26,1,1987,1,"female",4,12,11,35,3,11,1,24,2
1869216,18,24,1995,7,"male",229,50,22,9,1,9,1,0,0
1869228,40,30,1973,9,"female",464,43,42,0,0,0,0,0,0
1869235,25,11,1988,12,"male",211,144,133,3,3,3,3,0,0
1869244,24,1,1989,1,"female",324,62,44,1,9,0,1,1,8
1869248,27,1,1986,8,"female",292,38,27,3,17,3,14,0,3
1869314,32,18,1981,5,"male",531,0,0,0,0,0,0,0,0
1869325,28,11,1985,1,"male",262,73,48,1,0,1,0,0,0
1869368,21,30,1992,10,"female",711,913,118,2962,4623,1366,2459,1596,2164
1869377,24,16,1989,7,"male",2,0,0,0,0,0,0,0,0
1869427,22,28,1991,12,"female",737,14,4,0,1,0,0,0,1
1869445,67,15,1946,2,"female",1456,214,39,310,278,207,201,103,77
1869455,15,19,1998,8,"female",151,291,106,44,16,30,5,14,11
1869459,52,23,1961,3,"female",214,118,81,50,15,49,12,1,3
1869482,30,3,1983,3,"female",369,1,1,0,0,0,0,0,0
1869492,30,8,1983,8,"female",1256,110,51,55,13,55,7,0,6
1869528,23,8,1990,11,"male",421,296,270,24,11,24,10,0,1
1869555,66,15,1947,10,"male",439,37,18,0,3,0,2,0,1
1869577,16,5,1997,10,"male",461,16,8,0,3,0,1,0,2
1869579,32,18,1981,8,"male",97,22,21,8,1,8,1,0,0
1869601,20,11,1993,5,"male",295,500,393,0,6,0,5,0,1
1869612,20,25,1993,1,"female",677,988,565,213,327,0,154,213,173
1869620,78,20,1935,10,"male",1530,220,80,0,0,0,0,0,0
1869646,100,21,1913,4,"male",1258,523,280,82,26,49,13,33,13
1869656,59,6,1954,3,"male",639,10,8,0,1,0,0,0,1
1869659,24,1,1989,2,"male",136,196,159,5,3,5,3,0,0
1869703,27,15,1986,7,"male",217,208,131,25,185,24,88,1,97
1869706,59,15,1954,8,"male",1003,9,6,0,0,0,0,0,0
1869716,89,19,1924,6,"male",636,123,33,47,73,35,50,12,23
1869740,29,7,1984,7,"female",34,63,29,105,127,105,90,0,37
1869752,19,5,1994,3,"male",473,285,158,3,4,3,4,0,0
1869811,42,20,1971,5,"male",392,5,2,0,0,0,0,0,0
1869829,25,14,1988,3,"female",268,3,1,0,0,0,0,0,0
1869833,43,6,1970,5,"male",265,43,26,138,77,135,46,3,31
1869842,16,11,1997,5,"male",300,37,22,4,12,3,6,1,6
1869843,22,3,1991,1,"male",587,133,74,4,3,4,3,0,0
1869851,54,28,1959,12,"male",347,14,5,0,0,0,0,0,0
1869854,35,7,1978,8,"male",22,1,1,1,0,1,0,0,0
1869857,16,25,1997,12,"female",688,817,568,151,202,73,136,78,66
1869862,53,3,1960,3,"male",126,25,21,17,7,17,4,0,3
1869864,25,1,1988,1,"male",21,21,6,4,2,4,2,0,0
1869865,27,1,1986,1,"female",577,68,40,118,63,118,54,0,9
1869875,15,25,1998,7,"male",576,63,55,4,0,0,0,4,0
1869906,103,1,1910,1,"male",1644,110,47,9,20,1,8,8,12
1869942,20,8,1993,11,"male",196,320,191,1,7,0,1,1,6
1869974,28,17,1985,5,"male",354,28,26,0,2,0,1,0,1
1869977,21,23,1992,5,"male",539,82,70,14,1,14,1,0,0
1870003,55,30,1958,3,"female",727,390,86,63,156,1,53,62,103
1870006,14,23,1999,7,"male",237,108,66,3,25,2,11,1,14
1870011,19,13,1994,1,"male",340,111,47,1,0,1,0,0,0
1870013,71,26,1942,7,"female",1678,40,2,73,7,68,5,5,2
1870024,70,18,1943,11,NA,2009,9,4,2,1,0,0,2,1
1870025,17,31,1996,1,"male",513,553,461,0,0,0,0,0,0
1870034,40,17,1973,4,"female",275,77,34,66,37,66,23,0,14
1870054,19,3,1994,9,"female",447,254,161,33,1,29,0,4,1
1870056,18,8,1995,8,"male",75,53,46,17,18,17,18,0,0
1870058,50,8,1963,10,"female",1383,28,12,19,12,5,4,14,8
1870090,37,10,1976,6,"male",867,20,15,1,1,1,1,0,0
1870133,20,10,1993,10,"male",735,384,207,25,24,1,2,24,22
1870183,84,18,1929,3,"male",1092,85,51,0,0,0,0,0,0
1870186,47,8,1966,5,"female",95,40,31,89,3,89,3,0,0
1870204,59,4,1954,12,"male",768,62,23,1,1,1,1,0,0
1870213,23,20,1990,1,"female",520,18,7,0,0,0,0,0,0
1870226,15,3,1998,8,"male",465,312,210,14,17,0,4,14,13
1870227,18,15,1995,3,"male",159,161,135,9,1,0,0,9,1
1870307,20,20,1993,2,"female",424,458,206,1,11,1,11,0,0
1870309,27,3,1986,8,"male",315,13,6,1,0,1,0,0,0
1870316,52,24,1961,6,"female",282,28,15,1,5,0,2,1,3
1870329,25,26,1988,6,"female",488,92,35,22,2,22,2,0,0
1870345,21,10,1992,12,"male",612,27,15,11,10,0,3,11,7
1870383,18,27,1995,7,"male",589,143,100,5,32,4,9,1,23
1870384,34,22,1979,9,"male",23,0,0,0,0,0,0,0,0
1870442,54,22,1959,7,"female",501,19,11,0,0,0,0,0,0
1870554,25,17,1988,11,"female",253,157,33,107,65,105,33,2,32
1870564,44,24,1969,9,"male",350,84,66,40,0,0,0,40,0
1870601,16,5,1997,7,"male",269,9,7,54,2,0,0,54,2
1870605,23,7,1990,6,"female",537,53,42,1,0,0,0,1,0
1870607,44,7,1969,8,"female",141,68,30,97,63,97,58,0,5
1870652,18,23,1995,2,"male",250,94,77,10,4,8,3,2,1
1870655,52,8,1961,10,"female",302,34,17,1,16,0,3,1,13
1870686,74,8,1939,12,"male",651,9,8,1,0,0,0,1,0
1870696,26,9,1987,4,"female",19,0,0,0,0,0,0,0,0
1870706,34,5,1979,12,"male",1723,143,50,2,0,2,0,0,0
1870741,43,16,1970,12,"female",1828,93,58,112,155,80,116,32,39
1870760,40,15,1973,5,"male",320,76,36,5,24,0,15,5,9
1870815,31,8,1982,4,"male",400,143,99,0,0,0,0,0,0
1870848,17,11,1996,10,"female",1316,4357,1810,10433,3066,7427,2119,3006,947
1870867,27,20,1986,4,"female",230,116,82,42,20,32,17,10,3
1870890,25,18,1988,5,"male",142,96,88,6,67,0,15,6,52
1870910,21,11,1992,12,"male",817,55,28,0,0,0,0,0,0
1870932,18,17,1995,10,"male",596,463,406,495,399,415,321,80,78
1870939,23,12,1990,5,"male",337,58,37,0,0,0,0,0,0
1870949,18,31,1995,1,"female",2,0,0,2,6,2,5,0,1
1870952,62,16,1951,6,"female",374,49,33,45,24,45,15,0,9
1870957,15,19,1998,5,"female",535,179,158,0,0,0,0,0,0
1870958,107,6,1906,8,"female",1829,720,264,139,73,104,34,35,39
1870964,28,4,1985,1,"male",742,191,41,1,2,1,2,0,0
1870966,23,2,1990,2,"female",291,19,1,9,0,0,0,9,0
1870992,24,3,1989,1,"male",308,42,29,0,1,0,1,0,0
1870996,26,1,1987,11,"female",348,89,62,142,26,142,20,0,6
1871037,26,3,1987,9,"female",1528,512,174,2094,944,2006,454,88,490
1871044,23,7,1990,1,"female",439,75,19,2,43,2,41,0,2
1871068,22,14,1991,6,"male",440,99,51,416,182,416,178,0,4
1871070,20,18,1993,5,"female",308,592,273,115,30,90,18,25,12
1871075,21,4,1992,8,"female",603,120,57,9,70,9,60,0,10
1871081,68,17,1945,8,"male",472,754,401,1634,1371,1634,1069,0,302
1871114,48,3,1965,7,"female",115,22,12,41,13,41,9,0,4
1871119,19,25,1994,5,"male",17,171,133,62,125,62,92,0,33
1871156,23,19,1990,2,"male",534,21,17,1,1,1,1,0,0
1871162,21,15,1992,3,"male",507,293,100,2,5,2,5,0,0
1871174,14,20,1999,6,"female",397,30,15,39,3,9,2,30,1
1871178,17,11,1996,12,"female",289,92,64,24,27,24,10,0,17
1871218,25,7,1988,6,"female",137,65,39,3,5,3,3,0,2
1871219,16,22,1997,3,"male",129,86,61,444,45,444,37,0,8
1871223,23,25,1990,8,"male",276,48,47,0,0,0,0,0,0
1871228,46,28,1967,4,"male",681,138,85,37,70,0,1,37,69
1871230,26,22,1987,8,"male",135,127,91,4,12,4,11,0,1
1871233,71,3,1942,8,"female",1005,54,34,488,81,0,24,488,57
1871242,50,18,1963,4,"female",558,1166,805,14,28,0,12,14,16
1871256,18,15,1995,10,"male",87,702,586,64,116,64,94,0,22
1871264,23,1,1990,12,"male",184,92,71,2,2,0,0,2,2
1871287,30,16,1983,3,"male",541,1,1,0,0,0,0,0,0
1871308,18,6,1995,2,"male",630,260,236,0,0,0,0,0,0
1871309,14,15,1999,4,"female",246,424,243,28,6,28,4,0,2
1871315,27,1,1986,1,"male",286,2,0,0,1,0,1,0,0
1871322,51,5,1962,3,"female",540,248,208,36,158,36,96,0,62
1871371,53,29,1960,6,"male",644,421,274,0,0,0,0,0,0
1871373,18,4,1995,1,"male",259,107,93,2,33,2,15,0,18
1871380,53,18,1960,1,"female",495,63,30,71,34,14,26,57,8
1871390,15,13,1998,9,"female",76,23,8,5616,4604,0,655,5616,3949
1871392,23,13,1990,10,"male",266,25,17,0,0,0,0,0,0
1871396,90,24,1923,8,"male",673,27,14,24,13,15,7,9,6
1871425,27,3,1986,11,"female",524,16,6,0,0,0,0,0,0
1871429,21,24,1992,3,"male",463,236,183,0,0,0,0,0,0
1871430,18,19,1995,10,"male",627,103,48,1,0,1,0,0,0
1871441,36,18,1977,2,"male",915,144,118,209,81,209,63,0,18
1871492,42,29,1971,12,"male",101,8,6,5,4,4,1,1,3
1871494,22,5,1991,3,"female",43,147,120,5,20,5,14,0,6
1871516,18,22,1995,8,"female",423,759,213,512,773,509,449,3,324
1871532,54,23,1959,10,"female",258,91,58,32,34,32,16,0,18
1871557,31,8,1982,7,"male",323,50,35,1,8,1,2,0,6
1871573,108,1,1905,1,"female",1625,139,70,957,186,0,44,957,142
1871594,57,9,1956,6,"male",704,80,48,0,4,0,1,0,3
1871599,18,19,1995,10,"male",523,117,112,71,22,69,16,2,6
1871672,35,24,1978,6,"male",573,55,34,15,2,10,2,5,0
1871699,22,21,1991,2,"male",450,221,142,10,0,10,0,0,0
1871729,51,1,1962,1,"female",1744,52,23,10,23,10,22,0,1
1871735,23,30,1990,8,"male",204,26,14,13,0,13,0,0,0
1871737,30,23,1983,1,"female",691,340,186,45,11,3,8,42,3
1871740,20,30,1993,11,"male",299,899,668,0,40,0,38,0,2
1871744,29,24,1984,3,"male",71,31,15,0,0,0,0,0,0
1871764,16,16,1997,8,"female",548,43,38,0,0,0,0,0,0
1871801,67,2,1946,12,"male",33,1,1,3,2,0,0,3,2
1871818,28,8,1985,8,"male",168,463,445,243,131,243,128,0,3
1871820,63,30,1950,8,"male",1157,20,12,1,2,0,2,1,0
1871826,18,11,1995,4,"female",417,407,232,117,71,117,68,0,3
1871844,28,28,1985,2,"male",414,84,47,1,16,1,6,0,10
1871847,33,12,1980,10,"male",278,59,35,92,38,92,29,0,9
1871877,59,25,1954,2,"female",411,1,1,0,0,0,0,0,0
1871879,31,12,1982,4,"female",212,169,122,280,182,280,124,0,58
1871921,62,28,1951,6,"female",1530,91,30,49,28,45,17,4,11
1871930,24,6,1989,6,"male",192,97,82,0,0,0,0,0,0
1871938,16,12,1997,2,"male",180,83,66,10,29,5,17,5,12
1871973,65,28,1948,1,"male",1595,14,6,3,0,3,0,0,0
1871977,23,24,1990,6,"male",731,222,146,80,44,75,12,5,32
1871994,17,15,1996,12,"male",702,66,55,0,0,0,0,0,0
1871995,28,17,1985,6,"male",562,486,389,4,99,4,87,0,12
1871998,60,30,1953,11,"female",536,299,188,1541,754,0,141,1541,613
1872014,43,15,1970,10,"male",241,89,73,2,8,2,8,0,0
1872068,65,26,1948,3,"female",641,37,35,430,181,4,38,426,143
1872108,29,24,1984,11,"male",81,37,28,7,6,5,3,2,3
1872113,49,26,1964,6,"male",124,24,22,7,1,7,1,0,0
1872117,20,23,1993,5,"female",360,1160,668,7447,5547,7447,3756,0,1791
1872125,46,16,1967,9,"male",337,36,12,0,1,0,1,0,0
1872150,19,6,1994,8,"female",435,62,43,131,5,131,4,0,1
1872154,44,30,1969,10,"male",560,190,167,67,58,67,54,0,4
1872177,18,14,1995,5,"female",236,1422,191,2890,5272,320,2043,2570,3229
1872192,22,6,1991,8,"female",359,430,235,1,39,0,17,1,22
1872203,38,28,1975,6,"male",135,152,50,47,204,47,114,0,90
1872230,42,17,1971,3,"male",394,18,15,0,0,0,0,0,0
1872236,19,9,1994,2,"male",455,107,83,0,1,0,1,0,0
1872252,23,6,1990,2,"male",1057,601,518,0,0,0,0,0,0
1872254,60,15,1953,9,"female",1265,225,134,206,148,206,73,0,75
1872261,108,31,1905,12,"female",104,28,2,1,1,0,1,1,0
1872280,27,23,1986,2,"male",231,75,61,18,15,18,9,0,6
1872284,64,6,1949,1,"female",258,31,22,0,7,0,2,0,5
1872287,39,11,1974,2,"female",353,0,0,2,0,2,0,0,0
1872298,33,3,1980,3,"male",585,0,0,0,0,0,0,0,0
1872300,72,4,1941,7,"female",112,46,24,0,6,0,3,0,3
1872302,27,29,1986,7,"female",523,446,406,354,197,349,162,5,35
1872315,57,4,1956,7,"female",101,16,10,14,41,0,6,14,35
1872330,38,16,1975,7,"male",344,30,15,15,60,15,48,0,12
1872377,97,3,1916,4,"female",2226,1204,306,22,5,0,1,22,4
1872395,22,21,1991,4,"male",551,75,60,0,0,0,0,0,0
1872397,51,14,1962,9,"female",148,12,11,2,0,2,0,0,0
1872414,53,1,1960,4,"male",307,1,1,5,3,0,1,5,2
1872459,25,1,1988,1,"male",27,6,6,0,1,0,1,0,0
1872461,16,26,1997,12,"male",558,156,139,126,35,36,12,90,23
1872484,65,30,1948,5,"female",74,27,22,47,42,47,36,0,6
1872497,18,23,1995,4,"male",1166,1198,829,229,58,229,47,0,11
1872520,26,12,1987,6,"female",282,135,112,1,12,1,9,0,3
1872535,103,21,1910,10,"male",154,46,35,8,7,6,6,2,1
1872547,48,25,1965,5,"male",372,5,4,0,0,0,0,0,0
1872559,16,13,1997,1,"female",308,55,37,3,43,2,21,1,22
1872569,18,1,1995,5,"male",562,540,470,22,7,22,6,0,1
1872570,57,19,1956,3,"female",108,669,501,154,262,0,49,154,213
1872572,32,15,1981,6,"male",223,163,62,7,0,3,0,4,0
1872582,18,14,1995,9,"female",272,262,113,61,14,9,4,52,10
1872586,25,4,1988,5,"male",284,79,27,7,10,7,9,0,1
1872590,71,10,1942,6,"male",1169,47,12,0,4,0,3,0,1
1872597,23,3,1990,1,"female",346,75,55,102,34,78,16,24,18
1872605,18,25,1995,7,"female",148,298,218,267,195,164,156,103,39
1872608,40,6,1973,6,"female",483,2,0,0,0,0,0,0,0
1872652,18,24,1995,9,"female",278,742,423,29,79,29,72,0,7
1872675,25,1,1988,1,"male",190,22,11,2,0,2,0,0,0
1872685,52,20,1961,7,"female",210,59,40,485,115,485,80,0,35
1872693,19,16,1994,9,"female",415,75,49,0,0,0,0,0,0
1872717,21,8,1992,11,"female",412,326,146,287,298,277,121,10,177
1872726,14,25,1999,1,"female",793,1224,409,235,380,28,179,207,201
1872738,63,30,1950,5,"female",149,60,38,1736,386,1736,268,0,118
1872743,50,18,1963,2,"female",1794,325,228,411,382,54,27,357,355
1872749,45,3,1968,5,"female",614,16,12,11,22,11,22,0,0
1872750,23,19,1990,6,"male",196,119,97,0,2,0,1,0,1
1872807,20,27,1993,3,"male",482,110,61,671,162,671,105,0,57
1872821,16,3,1997,7,"female",56,1,1,4,0,0,0,4,0
1872847,24,14,1989,4,"female",217,2376,1442,487,1681,170,970,317,711
1872854,22,10,1991,10,"male",26,7,6,3,3,3,3,0,0
1872862,25,23,1988,7,"female",215,1,1,85,1,83,1,2,0
1872892,33,2,1980,2,"male",597,60,52,0,27,0,1,0,26
1873018,108,5,1905,5,"male",2229,398,161,8,14,8,12,0,2
1873034,16,19,1997,8,"female",459,2080,611,888,2166,752,959,136,1207
1873077,28,12,1985,12,"female",441,326,265,69,94,0,12,69,82
1873128,20,1,1993,9,"male",666,251,200,11,3,11,3,0,0
1873140,26,10,1987,7,"female",323,226,12,49,7,49,7,0,0
1873146,23,10,1990,6,"female",24,3,3,2,1,2,1,0,0
1873157,41,20,1972,3,"female",503,34,12,689,506,588,166,101,340
1873161,19,9,1994,9,"male",486,815,600,6,3,2,2,4,1
1873167,24,5,1989,2,"male",306,27,8,1,0,1,0,0,0
1873170,43,26,1970,7,"male",501,69,30,15,37,15,24,0,13
1873178,36,4,1977,9,"male",602,98,74,0,7,0,3,0,4
1873257,14,4,1999,10,"male",155,62,53,6,0,0,0,6,0
1873299,28,20,1985,9,"male",215,208,176,2,14,2,10,0,4
1873314,90,12,1923,4,"female",659,70,37,8,4,8,2,0,2
1873315,20,1,1993,3,"male",265,187,139,110,126,110,51,0,75
1873321,23,9,1990,7,"female",251,327,196,202,66,31,26,171,40
1873333,19,24,1994,8,"female",321,135,71,362,140,338,48,24,92
1873407,36,7,1977,8,"female",645,215,141,1,11,0,0,1,11
1873414,59,18,1954,5,"male",457,26,21,4,1,4,1,0,0
1873422,33,4,1980,12,"female",151,47,38,2,2,2,2,0,0
1873440,14,16,1999,10,"male",133,268,176,0,39,0,8,0,31
1873492,22,8,1991,7,"female",222,115,98,319,344,319,174,0,170
1873507,34,20,1979,3,"male",136,31,14,5,13,5,8,0,5
1873518,23,16,1990,5,"female",500,3,2,4,0,3,0,1,0
1873620,47,7,1966,3,"male",27,1,1,0,0,0,0,0,0
1873636,19,17,1994,7,"female",272,205,81,1,19,1,18,0,1
1873637,21,16,1992,5,"male",196,121,37,1,11,0,11,1,0
1873646,19,23,1994,11,"male",488,140,60,0,0,0,0,0,0
1873685,13,27,2000,4,"male",31,243,210,4,4,4,1,0,3
1873702,48,17,1965,2,"male",306,22,3,85,4,85,4,0,0
1873708,18,18,1995,10,"female",457,878,435,1856,1157,1313,508,543,649
1873710,23,3,1990,3,"male",592,391,292,30,16,17,10,13,6
1873768,18,16,1995,3,"male",327,18,7,6,4,0,2,6,2
1873775,57,8,1956,4,"male",59,23,20,323,6,323,5,0,1
1873782,31,15,1982,10,"female",312,64,43,42,100,0,67,42,33
1873786,30,19,1983,8,"male",58,54,31,4,2,0,1,4,1
1873807,23,28,1990,2,"male",195,100,60,20,9,20,8,0,1
1873808,23,9,1990,10,"male",664,237,222,17,16,16,13,1,3
1873839,103,5,1910,10,"female",650,331,55,26,3,26,3,0,0
1873877,62,28,1951,4,"female",614,158,128,587,61,0,11,587,50
1873897,30,4,1983,1,"female",202,102,61,10,85,10,83,0,2
1873916,66,3,1947,2,"female",1173,218,131,75,261,23,184,52,77
1873930,25,10,1988,6,"female",686,548,391,1111,757,852,373,259,384
1873967,15,17,1998,12,"male",91,102,99,0,0,0,0,0,0
1874003,42,25,1971,7,"male",29,3,2,1,3,0,2,1,1
1874008,20,1,1993,1,"male",520,22,15,0,0,0,0,0,0
1874017,21,20,1992,3,"male",306,451,306,46,26,6,14,40,12
1874019,14,18,1999,2,"female",525,544,367,21,22,19,10,2,12
1874020,21,13,1992,1,"male",172,102,73,10,6,10,5,0,1
1874064,43,11,1970,2,"female",670,140,82,113,262,113,192,0,70
1874107,19,21,1994,6,"male",228,156,131,11,4,11,4,0,0
1874128,40,9,1973,7,"male",336,6,4,0,0,0,0,0,0
1874158,22,22,1991,7,"male",527,0,0,0,0,0,0,0,0
1874165,39,9,1974,8,"male",774,27,14,3,0,3,0,0,0
1874199,48,28,1965,5,"male",407,23,11,13,1,12,0,1,1
1874211,42,12,1971,8,"male",184,10,9,2,0,2,0,0,0
1874214,47,18,1966,9,"female",123,41,22,0,0,0,0,0,0
1874249,22,17,1991,9,"male",86,69,67,0,0,0,0,0,0
1874259,21,23,1992,7,"male",19,453,421,874,650,859,432,15,218
1874264,30,19,1983,6,"male",709,170,140,19,0,19,0,0,0
1874269,34,16,1979,1,"male",216,182,139,34,10,34,3,0,7
1874271,18,20,1995,3,"male",69,8,5,5,1,0,0,5,1
1874276,25,2,1988,1,"female",558,156,28,215,139,214,63,1,76
1874293,16,1,1997,2,"male",330,141,85,10,0,10,0,0,0
1874294,16,25,1997,1,"female",205,359,194,813,1022,813,868,0,154
1874301,62,23,1951,7,"male",1040,128,107,41,23,41,4,0,19
1874347,73,4,1940,5,"female",164,10,10,2,9,2,0,0,9
1874371,23,17,1990,2,"male",465,35,27,0,3,0,3,0,0
1874424,17,13,1996,3,"female",297,62,33,1585,0,1585,0,0,0
1874438,28,3,1985,9,"male",1108,150,110,148,37,119,30,29,7
1874454,21,8,1992,6,"female",447,44,23,0,0,0,0,0,0
1874490,33,18,1980,1,"female",198,14,10,38,20,22,7,16,13
1874492,38,5,1975,9,"female",524,370,252,22,13,22,4,0,9
1874500,18,24,1995,5,"male",498,68,57,0,1,0,1,0,0
1874538,50,6,1963,3,"female",177,12,4,0,1,0,1,0,0
1874545,23,16,1990,10,"female",339,258,82,330,288,154,115,176,173
1874550,61,17,1952,10,"male",550,158,42,2,3,0,1,2,2
1874552,26,1,1987,8,"female",302,42,11,0,0,0,0,0,0
1874604,70,9,1943,11,"female",104,19,11,50,25,0,16,50,9
1874613,49,19,1964,11,"male",220,15,13,7,2,7,2,0,0
1874630,16,7,1997,10,"female",329,277,129,44,43,44,10,0,33
1874682,16,1,1997,1,"male",364,162,105,165,46,165,21,0,25
1874722,57,13,1956,5,"male",422,53,29,4,0,0,0,4,0
1874738,61,4,1952,3,"male",256,15,14,0,0,0,0,0,0
1874765,13,11,2000,5,"male",163,135,130,0,0,0,0,0,0
1874779,20,7,1993,2,"female",369,203,152,14,22,0,5,14,17
1874785,68,12,1945,1,"male",1129,57,38,0,3,0,0,0,3
1874797,19,14,1994,3,"male",413,888,226,30,172,2,60,28,112
1874805,38,25,1975,3,"female",281,108,73,144,67,141,37,3,30
1874807,108,24,1905,4,"male",2011,256,205,18,40,5,29,13,11
1874840,25,20,1988,6,"male",129,32,20,171,1,171,1,0,0
1874883,103,26,1910,12,"female",743,365,95,6,6,6,5,0,1
1874904,54,27,1959,5,"female",162,22,10,1,2,1,1,0,1
1874908,33,2,1980,7,"male",435,15,8,0,4,0,1,0,3
1874923,29,11,1984,4,"male",354,152,102,0,0,0,0,0,0
1874930,74,31,1939,7,"female",672,52,26,212,37,212,12,0,25
1874941,19,28,1994,6,"male",255,172,63,48,18,48,17,0,1
1874942,20,7,1993,7,"male",988,1362,1098,507,159,504,124,3,35
1874960,60,26,1953,12,"female",363,23,23,0,1,0,0,0,1
1874961,17,5,1996,3,"male",176,7,6,0,0,0,0,0,0
1874963,16,30,1997,12,"female",527,3163,1345,50,71,50,56,0,15
1874966,60,15,1953,10,"male",1360,129,90,3,15,0,7,3,8
1874970,18,12,1995,8,"female",210,320,275,1593,2797,1469,1245,124,1552
1874980,25,15,1988,6,"female",358,232,211,124,59,124,37,0,22
1875009,33,20,1980,2,"male",451,190,164,2,0,2,0,0,0
1875026,21,10,1992,5,"male",91,250,187,6,16,6,15,0,1
1875052,22,11,1991,2,"male",260,9,8,0,0,0,0,0,0
1875053,57,6,1956,9,"male",1335,24,11,5,29,5,21,0,8
1875059,32,13,1981,3,"female",556,77,54,141,175,131,141,10,34
1875079,15,1,1998,8,"male",10,20,16,2,2,2,1,0,1
1875081,24,19,1989,5,"female",1448,1444,859,373,354,247,194,126,160
1875103,23,16,1990,2,"male",145,26,17,0,0,0,0,0,0
1875104,30,1,1983,1,"male",165,88,64,0,0,0,0,0,0
1875108,25,2,1988,6,"female",63,1073,806,3629,2131,3617,1724,12,407
1875113,52,26,1961,12,"male",199,68,44,439,3,11,1,428,2
1875137,21,24,1992,12,"female",765,270,191,255,198,249,184,6,14
1875167,43,15,1970,5,"male",1073,48,27,11,19,11,9,0,10
1875200,67,4,1946,2,"female",251,41,28,328,372,0,21,328,351
1875237,77,24,1936,10,"female",2115,48,13,128,29,0,21,128,8
1875238,25,7,1988,10,"male",1646,394,193,4,8,4,8,0,0
1875244,29,16,1984,11,"female",623,83,26,177,21,177,19,0,2
1875257,17,15,1996,6,"female",259,337,167,102,351,102,336,0,15
1875270,44,27,1969,8,"female",1379,350,225,171,211,171,167,0,44
1875280,46,14,1967,11,"female",64,32,24,41,5,0,4,41,1
1875283,24,23,1989,12,"female",314,19,7,1,0,1,0,0,0
1875289,22,23,1991,6,"male",493,75,21,0,0,0,0,0,0
1875291,33,5,1980,6,"male",51,5,4,2,0,2,0,0,0
1875295,14,24,1999,8,"female",107,235,114,2278,1094,71,290,2207,804
1875332,26,1,1987,1,"female",257,111,78,63,61,63,29,0,32
1875337,50,24,1963,3,"female",879,11,5,1,1,0,1,1,0
1875344,23,1,1990,1,"female",112,2,1,14,9,0,0,14,9
1875359,14,22,1999,11,"male",473,110,57,9,13,3,9,6,4
1875372,39,15,1974,5,"female",575,110,73,1083,502,1066,151,17,351
1875377,69,5,1944,8,"male",629,25,15,0,0,0,0,0,0
1875402,17,18,1996,4,"male",386,55,39,1,1,1,1,0,0
1875407,37,7,1976,6,"female",406,29,19,1,0,1,0,0,0
1875423,41,24,1972,12,"female",371,102,79,0,1,0,1,0,0
1875426,48,1,1965,1,"male",245,18,12,12,6,12,6,0,0
1875455,61,24,1952,1,"female",902,52,23,17,5,0,3,17,2
1875457,22,16,1991,10,"female",398,58,36,3,7,3,5,0,2
1875485,20,8,1993,9,"male",526,166,87,22,111,22,78,0,33
1875509,22,22,1991,11,"male",262,45,34,0,0,0,0,0,0
1875527,22,1,1991,12,"male",487,412,341,1,0,1,0,0,0
1875539,23,20,1990,5,"male",412,125,70,11,16,11,9,0,7
1875551,19,5,1994,12,"female",423,352,195,130,68,30,41,100,27
1875562,13,24,2000,5,"female",161,61,46,61,12,61,12,0,0
1875567,20,3,1993,12,"female",624,62,31,120,149,120,138,0,11
1875570,50,9,1963,4,"male",394,51,25,4,12,1,8,3,4
1875575,35,12,1978,6,"male",160,34,26,0,0,0,0,0,0
1875642,14,23,1999,5,"female",39,76,57,2,9,0,2,2,7
1875649,22,13,1991,10,"male",90,18,1,0,0,0,0,0,0
1875681,30,1,1983,1,"male",19,41,31,12,15,12,15,0,0
1875703,23,26,1990,6,"female",536,204,137,31,63,30,27,1,36
1875708,67,18,1946,4,"male",1130,23,5,0,0,0,0,0,0
1875714,26,16,1987,12,"male",136,14,11,0,0,0,0,0,0
1875719,59,3,1954,9,"female",219,33,17,160,12,0,10,160,2
1875736,19,17,1994,5,"male",41,30,18,0,0,0,0,0,0
1875755,56,23,1957,10,"female",725,109,69,1,35,0,17,1,18
1875765,28,10,1985,8,"female",418,274,173,2,5,2,2,0,3
1875780,27,14,1986,8,"female",636,461,362,164,165,164,73,0,92
1875790,30,6,1983,5,"male",397,58,38,18,0,17,0,1,0
1875795,48,19,1965,3,"female",159,72,54,67,115,0,17,67,98
1875814,16,1,1997,9,"female",284,1672,1230,1800,38,1400,29,400,9
1875859,20,10,1993,10,"female",179,637,275,28,130,28,125,0,5
1875874,18,20,1995,1,"male",242,134,67,3,2,3,1,0,1
1875895,23,1,1990,1,"male",445,12,5,4,1,1,1,3,0
1875922,63,14,1950,6,"female",1202,21,9,168,11,110,1,58,10
1875944,49,21,1964,3,"female",1713,285,119,1804,916,1776,594,28,322
1875947,57,27,1956,12,"male",1188,38,16,19,4,2,2,17,2
1875954,16,29,1997,8,"male",269,138,118,62,0,29,0,33,0
1875961,53,14,1960,1,"female",1821,52,18,35,21,0,17,35,4
1875969,23,24,1990,10,"male",388,3,2,0,0,0,0,0,0
1875973,19,9,1994,7,"male",507,652,403,186,133,143,74,43,59
1876110,17,3,1996,12,"female",399,429,323,2859,719,15,220,2844,499
1876142,20,25,1993,12,"male",289,24,22,0,0,0,0,0,0
1876163,55,15,1958,9,"female",41,43,32,60,41,60,25,0,16
1876164,62,20,1951,2,"female",1198,18,7,0,0,0,0,0,0
1876166,19,3,1994,7,"female",216,164,138,115,29,115,29,0,0
1876196,17,10,1996,12,"male",710,105,70,4,35,4,26,0,9
1876200,27,26,1986,10,"male",445,3,2,0,0,0,0,0,0
1876209,20,1,1993,10,"female",372,56,13,76,0,17,0,59,0
1876211,20,8,1993,5,"female",645,430,341,145,136,121,74,24,62
1876228,15,10,1998,5,"female",427,362,200,83,170,81,79,2,91
1876243,31,18,1982,8,"female",203,135,93,55,30,55,28,0,2
1876255,31,7,1982,3,"male",725,652,446,583,859,583,801,0,58
1876273,65,13,1948,4,"female",172,96,80,3,96,3,73,0,23
1876285,17,8,1996,2,"male",272,143,86,2,3,0,1,2,2
1876329,57,25,1956,10,"male",1091,22,13,12,2,2,2,10,0
1876330,57,22,1956,11,"male",302,15,11,2,0,2,0,0,0
1876379,21,23,1992,2,"male",577,476,321,17,10,17,6,0,4
1876399,16,6,1997,1,"female",373,134,111,2,1,0,1,2,0
1876432,57,10,1956,3,"female",555,74,44,27,74,20,20,7,54
1876438,17,9,1996,1,"male",46,40,21,2,0,2,0,0,0
1876473,108,8,1905,12,"male",850,173,50,82,26,51,14,31,12
1876494,92,4,1921,6,"male",969,285,225,313,58,0,23,313,35
1876515,70,31,1943,3,"female",1732,96,25,1,8,0,4,1,4
1876526,23,15,1990,5,"female",1018,175,61,58,13,45,9,13,4
1876566,81,26,1932,11,"female",343,32,29,0,4,0,4,0,0
1876574,21,15,1992,11,"male",217,245,182,4,4,0,3,4,1
1876577,103,5,1910,10,"male",858,868,633,221,477,31,158,190,319
1876578,68,4,1945,1,"female",1672,385,136,2,64,1,39,1,25
1876579,28,17,1985,6,"male",322,210,188,68,7,56,5,12,2
1876592,47,28,1966,6,"male",273,6,6,0,0,0,0,0,0
1876597,14,23,1999,9,"female",138,231,92,1,14,1,14,0,0
1876619,21,26,1992,12,"female",350,277,101,28,186,28,172,0,14
1876670,26,9,1987,11,"male",743,257,171,39,27,1,17,38,10
1876684,26,29,1987,3,"male",283,51,44,0,0,0,0,0,0
1876719,22,10,1991,4,"male",426,420,266,47,15,45,12,2,3
1876725,36,15,1977,12,"male",494,92,56,29,10,29,9,0,1
1876766,27,26,1986,6,"male",239,121,107,3,2,3,1,0,1
1876781,64,21,1949,4,"male",1008,0,0,10,0,0,0,10,0
1876826,14,13,1999,6,"female",165,183,160,687,141,622,74,65,67
1876876,14,4,1999,7,"female",78,1,1,0,0,0,0,0,0
1876877,20,3,1993,6,"female",622,81,46,0,0,0,0,0,0
1876896,37,26,1976,3,"male",422,2,2,0,0,0,0,0,0
1876898,23,1,1990,2,"female",397,74,50,1,1,1,1,0,0
1876935,31,7,1982,9,"female",360,153,115,692,386,637,200,55,186
1876938,28,30,1985,10,"male",379,16,4,0,0,0,0,0,0
1876943,21,8,1992,4,"male",996,2473,1999,60,3409,60,2738,0,671
1876952,108,18,1905,2,"male",1085,345,196,118,160,10,77,108,83
1876980,30,20,1983,10,"female",718,161,139,142,230,142,168,0,62
1877007,24,12,1989,12,"female",163,97,53,11,35,11,27,0,8
1877014,23,8,1990,8,"female",2,5,5,20,5,16,3,4,2
1877019,21,18,1992,7,"male",692,276,136,5,8,4,3,1,5
1877091,19,3,1994,9,"female",453,1252,420,8,20,8,18,0,2
1877098,100,6,1913,3,"female",2273,249,85,107,35,0,1,107,34
1877102,67,5,1946,8,"male",203,121,108,44,95,0,49,44,46
1877124,21,11,1992,3,"male",488,197,141,1,0,1,0,0,0
1877143,56,6,1957,10,"male",107,18,16,20,79,20,28,0,51
1877150,46,18,1967,8,"male",253,0,0,0,0,0,0,0,0
1877160,60,27,1953,8,"male",706,51,12,14,6,0,0,14,6
1877164,16,10,1997,2,"female",809,433,160,3,13,3,7,0,6
1877182,16,18,1997,2,"male",521,389,166,9,11,9,3,0,8
1877232,18,28,1995,8,"female",22,0,0,0,0,0,0,0,0
1877237,19,1,1994,1,"male",686,299,232,7,20,7,19,0,1
1877239,108,17,1905,3,"male",1373,115,36,157,31,0,12,157,19
1877266,64,14,1949,4,"female",215,37,27,12,0,12,0,0,0
1877278,45,28,1968,4,"female",335,9,7,2,2,0,0,2,2
1877283,67,30,1946,11,"female",1739,143,62,191,172,17,85,174,87
1877350,51,23,1962,10,"female",365,196,148,299,165,0,28,299,137
1877357,60,7,1953,3,"female",404,62,41,35,21,35,13,0,8
1877390,24,1,1989,1,"male",67,12,8,4,0,4,0,0,0
1877438,32,10,1981,2,"female",375,27,19,49,13,1,13,48,0
1877459,69,18,1944,5,"male",191,47,26,0,0,0,0,0,0
1877461,26,8,1987,4,"female",245,26,10,0,2,0,2,0,0
1877473,60,18,1953,3,"female",370,69,43,581,214,581,99,0,115
1877477,48,30,1965,3,"female",303,209,81,77,126,5,34,72,92
1877495,16,2,1997,4,"male",175,266,170,253,137,253,88,0,49
1877500,30,20,1983,9,"male",484,10,5,37,11,31,9,6,2
1877511,36,8,1977,11,"male",609,225,186,145,166,37,58,108,108
1877555,73,1,1940,1,"female",445,48,30,140,31,48,14,92,17
1877564,26,28,1987,7,"male",88,43,37,27,2,27,0,0,2
1877577,25,30,1988,9,"female",302,27,18,59,44,27,14,32,30
1877582,59,19,1954,2,"female",338,52,37,206,29,206,28,0,1
1877595,18,1,1995,4,"female",363,49,38,92,32,5,15,87,17
1877614,74,10,1939,5,"female",1094,32,16,14,3,0,1,14,2
1877617,67,1,1946,6,"male",28,12,9,8,7,8,4,0,3
1877658,82,7,1931,5,"female",1115,40,20,91,87,90,84,1,3
1877707,59,21,1954,10,"male",714,1,0,0,0,0,0,0,0
1877745,43,10,1970,7,"female",57,23,16,100,28,100,11,0,17
1877750,61,7,1952,9,"female",744,90,42,0,0,0,0,0,0
1877778,83,15,1930,9,"female",1144,133,83,14,12,14,5,0,7
1877782,23,1,1990,1,"male",322,128,74,58,30,58,19,0,11
1877787,103,19,1910,7,"male",941,107,52,3,8,3,5,0,3
1877802,26,10,1987,10,"female",950,2832,145,1954,4671,1954,4162,0,509
1877803,23,12,1990,3,"female",456,30,18,0,0,0,0,0,0
1877808,61,22,1952,8,"male",621,1,0,0,0,0,0,0,0
1877819,24,14,1989,9,"female",484,1171,695,14799,22513,12934,17955,1865,4558
1877875,35,6,1978,5,"male",63,98,65,32,72,32,24,0,48
1877884,56,12,1957,8,"female",594,106,69,706,280,565,259,141,21
1877908,23,24,1990,5,"male",161,31,1,0,0,0,0,0,0
1877937,27,1,1986,1,"male",458,464,298,38,12,0,5,38,7
1877938,36,20,1977,12,"male",595,61,51,0,0,0,0,0,0
1877944,25,7,1988,12,"male",28,0,0,0,0,0,0,0,0
1877968,63,11,1950,11,"female",48,13,12,2,4,2,2,0,2
1877970,34,7,1979,9,"male",901,90,28,0,2,0,2,0,0
1877998,55,26,1958,8,"female",1946,197,96,418,238,42,119,376,119
1878006,65,5,1948,4,"female",442,162,57,3567,813,0,173,3567,640
1878031,16,9,1997,12,"male",17,0,0,0,0,0,0,0,0
1878065,66,9,1947,1,"female",1018,1410,771,2352,4931,1237,3083,1115,1848
1878070,25,17,1988,1,"female",1523,450,143,187,107,172,56,15,51
1878081,20,14,1993,12,"female",659,96,45,112,86,112,83,0,3
1878083,34,6,1979,2,"male",436,53,49,3,2,3,0,0,2
1878115,31,17,1982,9,"male",1240,213,135,11,16,11,15,0,1
1878145,20,13,1993,9,"female",1451,585,291,64,77,64,61,0,16
1878163,15,13,1998,4,"male",485,247,124,114,2,114,2,0,0
1878174,29,4,1984,7,"female",169,101,74,443,4038,443,1451,0,2587
1878179,40,26,1973,7,"male",1026,53,17,0,0,0,0,0,0
1878190,21,10,1992,8,"male",108,72,49,20,5,20,5,0,0
1878196,21,24,1992,5,"male",196,187,136,1,0,1,0,0,0
1878227,26,1,1987,2,"male",346,161,119,23,43,23,28,0,15
1878258,18,20,1995,6,"male",291,148,96,18,15,18,8,0,7
1878295,47,23,1966,6,"male",404,47,22,3,0,0,0,3,0
1878304,19,28,1994,6,"male",84,68,62,8,0,8,0,0,0
1878319,108,6,1905,10,"male",1656,930,578,59,51,2,21,57,30
1878342,29,14,1984,7,"male",191,6,6,27,0,3,0,24,0
1878358,22,14,1991,10,"female",254,329,20,0,0,0,0,0,0
1878364,101,13,1912,11,"female",248,339,43,1,21,1,15,0,6
1878386,23,10,1990,9,"male",417,32,28,7,42,7,39,0,3
1878402,33,17,1980,5,"female",522,604,509,1467,226,1442,127,25,99
1878423,25,15,1988,5,"male",676,77,48,0,0,0,0,0,0
1878426,79,9,1934,11,"female",1767,30,6,1,3,1,2,0,1
1878439,15,12,1998,7,"male",167,6,6,1,0,0,0,1,0
1878481,18,11,1995,12,"male",222,28,12,2,0,0,0,2,0
1878510,19,28,1994,11,"male",33,0,0,0,0,0,0,0,0
1878511,21,25,1992,2,"female",267,10,7,3,3,0,0,3,3
1878528,22,5,1991,10,"male",610,41,20,16,12,14,7,2,5
1878538,53,27,1960,9,"female",502,76,27,21,2,10,0,11,2
1878544,24,26,1989,10,"male",794,142,101,0,17,0,17,0,0
1878550,29,14,1984,4,"female",517,18,7,4,0,4,0,0,0
1878576,24,2,1989,10,"male",325,40,26,47,36,40,20,7,16
1878595,26,17,1987,11,"male",480,101,69,0,1,0,1,0,0
1878617,19,9,1994,5,"female",1008,121,76,153,152,112,56,41,96
1878627,56,27,1957,7,"female",1261,204,83,13,106,12,46,1,60
1878630,48,7,1965,8,"male",716,34,10,10,6,10,6,0,0
1878649,17,29,1996,8,"male",258,503,304,138,121,138,114,0,7
1878678,27,13,1986,3,"female",76,9,5,1,2,1,2,0,0
1878691,58,29,1955,8,"male",524,36,33,14,12,14,2,0,10
1878693,32,30,1981,1,"female",18,0,0,0,0,0,0,0,0
1878696,22,9,1991,4,"male",128,89,81,0,0,0,0,0,0
1878703,55,5,1958,10,"female",274,563,393,2844,1777,10,440,2834,1337
1878738,20,1,1993,2,"male",449,123,60,95,44,94,23,1,21
1878769,108,10,1905,10,"female",2234,383,186,62,82,41,58,21,24
1878817,29,24,1984,4,"male",728,18,10,2,3,2,3,0,0
1878829,79,21,1934,9,"male",1524,59,7,0,0,0,0,0,0
1878844,21,23,1992,3,"female",127,232,24,1,2,1,0,0,2
1878850,38,15,1975,6,"female",76,44,37,15,59,15,49,0,10
1878867,16,22,1997,5,"female",979,224,94,0,0,0,0,0,0
1878898,17,20,1996,10,"male",338,2393,499,687,583,459,418,228,165
1878947,36,15,1977,9,"male",519,35,34,7,23,0,8,7,15
1878964,21,31,1992,8,"male",438,196,98,2,1,0,1,2,0
1878972,26,30,1987,5,"female",295,905,404,1624,3174,1624,2630,0,544
1878994,18,25,1995,8,"male",566,373,316,238,84,43,17,195,67
1878995,50,19,1963,11,"female",333,32,20,2,9,1,9,1,0
1879006,18,7,1995,8,"female",114,336,100,33,214,29,137,4,77
1879019,18,14,1995,6,"male",208,110,38,20,9,20,9,0,0
1879020,53,17,1960,10,"male",206,140,78,450,109,0,66,450,43
1879025,28,14,1985,4,"male",452,105,79,0,0,0,0,0,0
1879030,17,28,1996,2,"male",332,256,212,45,17,21,0,24,17
1879034,36,12,1977,8,"male",335,0,0,0,0,0,0,0,0
1879039,39,27,1974,11,"male",409,1,0,0,0,0,0,0,0
1879062,60,18,1953,3,"female",1239,71,58,675,131,0,18,675,113
1879100,73,29,1940,12,"male",1485,1099,842,10,3,0,1,10,2
1879126,19,25,1994,8,"male",604,202,126,1,5,1,5,0,0
1879128,26,20,1987,1,"male",284,214,175,0,0,0,0,0,0
1879133,25,1,1988,1,"male",116,53,41,9,6,9,6,0,0
1879135,108,6,1905,8,"male",1900,3889,1977,356,835,0,338,356,497
1879140,44,25,1969,2,"male",286,358,178,69,1,69,1,0,0
1879145,58,25,1955,3,"male",157,0,0,0,0,0,0,0,0
1879154,49,21,1964,11,"male",382,18,4,1,0,1,0,0,0
1879192,23,2,1990,8,"male",347,65,52,0,13,0,1,0,12
1879198,15,21,1998,4,"male",493,148,50,3,9,3,9,0,0
1879201,55,6,1958,6,"male",331,136,91,3,44,2,32,1,12
1879215,18,3,1995,12,"male",543,206,143,0,1,0,1,0,0
1879219,27,9,1986,8,"male",440,34,26,7,0,0,0,7,0
1879238,45,1,1968,9,"female",171,0,0,0,0,0,0,0,0
1879243,35,30,1978,3,"male",87,1,1,0,3,0,0,0,3
1879264,24,26,1989,8,"female",201,84,72,151,93,143,68,8,25
1879279,108,7,1905,3,"female",1289,222,92,102,428,100,293,2,135
1879322,31,14,1982,3,"male",130,89,34,1,4,1,1,0,3
1879356,18,5,1995,4,"male",282,19,13,0,0,0,0,0,0
1879373,108,31,1905,12,"male",1203,303,97,14,54,14,50,0,4
1879392,58,9,1955,10,"female",445,50,43,5,18,4,10,1,8
1879407,19,18,1994,9,"male",641,96,58,316,188,316,178,0,10
1879429,21,24,1992,1,"male",401,173,101,3,0,0,0,3,0
1879447,27,12,1986,1,"male",361,27,14,0,1,0,0,0,1
1879490,14,10,1999,9,"female",134,191,119,129,35,52,17,77,18
1879507,16,7,1997,3,"male",165,181,152,1,5,0,4,1,1
1879517,24,4,1989,4,"male",625,47,30,0,0,0,0,0,0
1879557,21,28,1992,12,"male",485,76,51,2,1,0,0,2,1
1879599,25,31,1988,10,"male",987,168,100,6,0,6,0,0,0
1879601,23,23,1990,4,"male",1142,2964,2396,706,2074,703,1650,3,424
1879627,80,9,1933,11,"female",1369,163,110,3996,168,3969,101,27,67
1879651,19,10,1994,4,"male",347,1594,757,587,542,587,509,0,33
1879663,97,4,1916,2,"female",949,95,14,14,9,14,9,0,0
1879667,45,18,1968,5,"male",700,34,0,73,4,73,3,0,1
1879677,59,1,1954,1,"female",776,49,14,110,14,110,13,0,1
1879689,97,22,1916,7,"female",521,193,75,7,26,7,14,0,12
1879692,29,10,1984,5,"male",892,779,686,2,8,2,8,0,0
1879696,15,2,1998,2,"male",198,3,3,0,0,0,0,0,0
1879710,27,1,1986,1,"male",107,23,14,506,48,506,41,0,7
1879718,30,9,1983,12,"female",950,1394,815,2081,1288,1532,963,549,325
1879721,16,8,1997,7,"male",239,284,175,8,4,6,0,2,4
1879772,15,29,1998,5,"male",573,73,50,92,25,92,19,0,6
1879816,33,27,1980,3,"male",634,321,274,7,2,0,2,7,0
1879839,30,13,1983,12,"female",436,37,21,40,4,40,3,0,1
1879858,32,9,1981,2,"male",138,62,53,15,0,15,0,0,0
1879861,23,5,1990,11,"male",34,41,27,125,120,125,116,0,4
1879896,47,7,1966,8,"male",494,27,17,13,0,12,0,1,0
1879901,22,5,1991,10,"male",460,172,67,5,58,5,23,0,35
1879912,33,29,1980,10,"female",241,25,16,1,0,1,0,0,0
1879934,18,18,1995,5,"male",45,29,17,47,34,47,33,0,1
1879935,54,11,1959,9,"male",300,0,0,0,0,0,0,0,0
1879954,19,11,1994,6,"male",55,4,2,2,0,2,0,0,0
1879962,18,10,1995,9,"male",94,263,253,0,1,0,1,0,0
1879965,58,23,1955,1,"male",279,84,21,5,3,5,3,0,0
1880025,21,10,1992,5,"female",491,612,549,148,363,44,173,104,190
1880035,68,7,1945,12,"male",329,30,22,0,2,0,1,0,1
1880066,28,29,1985,11,"female",668,170,85,2153,356,2122,259,31,97
1880076,24,24,1989,12,"male",96,3,1,1,0,1,0,0,0
1880117,56,14,1957,9,"female",403,16,7,120,5,0,1,120,4
1880130,30,16,1983,2,"female",385,198,97,108,115,75,58,33,57
1880144,17,25,1996,9,"male",770,394,187,0,0,0,0,0,0
1880148,26,3,1987,6,"female",292,123,99,372,86,293,44,79,42
1880151,17,5,1996,3,"male",609,1,1,0,0,0,0,0,0
1880153,68,1,1945,4,"male",510,33,15,0,0,0,0,0,0
1880156,33,7,1980,3,"female",555,2,2,0,0,0,0,0,0
1880188,100,28,1913,8,"male",165,179,99,1134,104,1009,97,125,7
1880286,18,19,1995,12,"male",23,10,1,0,0,0,0,0,0
1880292,57,8,1956,5,"female",100,48,36,74,45,74,32,0,13
1880307,18,19,1995,7,"male",191,154,119,62,36,62,26,0,10
1880363,32,1,1981,1,"female",115,5,4,0,0,0,0,0,0
1880365,23,3,1990,7,"male",522,56,34,468,360,186,118,282,242
1880367,21,19,1992,2,"male",245,67,48,0,3,0,3,0,0
1880375,49,11,1964,9,"male",1489,95,44,8,26,8,19,0,7
1880408,38,13,1975,6,"male",639,121,38,27,65,16,25,11,40
1880426,21,27,1992,2,"male",463,102,59,28,27,26,13,2,14
1880436,31,31,1982,5,"male",341,189,173,1,2,1,2,0,0
1880458,34,30,1979,8,"male",461,23,15,0,0,0,0,0,0
1880462,47,1,1966,7,"male",346,22,6,4,0,2,0,2,0
1880466,15,7,1998,9,"female",555,1926,613,161,570,57,176,104,394
1880474,51,14,1962,9,"female",263,166,130,34,16,26,7,8,9
1880477,108,25,1905,6,"male",1244,140,85,135,197,11,65,124,132
1880489,22,5,1991,4,"male",317,82,63,6,0,4,0,2,0
1880512,40,1,1973,3,"female",280,64,51,273,87,273,34,0,53
1880527,29,22,1984,8,"female",490,78,41,157,8,157,4,0,4
1880553,48,28,1965,2,"male",110,3,3,1,0,1,0,0,0
1880556,28,1,1985,1,"female",71,61,14,2,3,2,2,0,1
1880567,28,15,1985,1,"female",89,26,23,1,1,1,1,0,0
1880580,51,17,1962,10,"male",227,16,5,0,0,0,0,0,0
1880596,58,1,1955,4,"female",668,33,28,1,1,0,0,1,1
1880609,15,25,1998,8,"male",74,19,14,8,1,0,0,8,1
1880610,19,1,1994,7,"male",462,72,67,0,0,0,0,0,0
1880627,46,17,1967,3,"male",574,21,12,3,0,3,0,0,0
1880630,52,1,1961,1,"male",51,313,272,324,256,324,245,0,11
1880664,21,27,1992,4,"male",384,33,21,10,0,10,0,0,0
1880665,49,9,1964,7,"male",541,36,13,9,8,9,7,0,1
1880682,103,12,1910,3,"male",612,1016,740,5,6,5,4,0,2
1880749,26,10,1987,1,"male",462,681,223,149,84,149,79,0,5
1880750,33,1,1980,1,"female",210,11,8,382,53,382,34,0,19
1880771,18,15,1995,7,"male",419,166,60,39,63,16,28,23,35
1880791,47,17,1966,6,"male",543,170,74,611,1488,91,521,520,967
1880793,25,18,1988,10,"female",251,78,53,0,0,0,0,0,0
1880810,41,20,1972,10,"male",391,105,85,0,2,0,0,0,2
1880835,22,15,1991,9,"male",229,1,0,8,9,6,6,2,3
1880863,19,22,1994,5,"male",358,88,77,1,0,0,0,1,0
1880926,112,5,1901,8,"female",1347,203,94,163,345,6,236,157,109
1880946,28,13,1985,11,"male",222,37,31,0,3,0,0,0,3
1880949,48,22,1965,5,"male",19,12,11,8,1,6,1,2,0
1880951,23,15,1990,12,"female",292,328,261,26,27,21,25,5,2
1880954,37,9,1976,11,"female",410,87,40,33,9,33,8,0,1
1880980,36,11,1977,1,"male",571,135,105,0,0,0,0,0,0
1880990,23,25,1990,11,"male",87,113,96,10,7,10,7,0,0
1881007,42,9,1971,7,"male",192,2,2,0,0,0,0,0,0
1881025,59,5,1954,1,"male",2132,33,26,5,0,2,0,3,0
1881028,25,16,1988,5,"female",721,140,112,53,38,2,7,51,31
1881032,35,24,1978,5,"male",641,169,92,214,197,186,62,28,135
1881033,35,26,1978,4,"male",858,23,8,0,0,0,0,0,0
1881035,19,24,1994,12,"male",338,90,34,15,35,15,33,0,2
1881045,17,25,1996,1,"female",201,11,2,14,7,14,5,0,2
1881069,108,8,1905,11,"female",484,208,87,30,31,30,29,0,2
1881094,17,15,1996,11,"female",373,127,57,0,2,0,2,0,0
1881095,70,8,1943,12,"female",1807,5,3,0,0,0,0,0,0
1881113,40,13,1973,5,"male",276,42,12,8,2,8,2,0,0
1881116,81,17,1932,11,"male",835,31,18,11,5,9,4,2,1
1881146,20,2,1993,4,"male",106,4,3,3,0,0,0,3,0
1881220,100,20,1913,5,"male",863,284,135,0,0,0,0,0,0
1881236,23,1,1990,9,"male",131,41,34,0,11,0,4,0,7
1881248,17,17,1996,9,"male",298,61,43,17,2,0,1,17,1
1881280,44,30,1969,6,"female",490,46,27,4,0,4,0,0,0
1881286,61,28,1952,11,"female",410,84,52,2,0,2,0,0,0
1881288,28,23,1985,12,"female",719,257,137,307,268,241,128,66,140
1881289,20,5,1993,3,"male",554,140,62,5,2,1,2,4,0
1881321,19,7,1994,3,"male",123,308,272,50,64,28,53,22,11
1881352,102,1,1911,4,"male",1655,167,57,20,14,1,10,19,4
1881356,56,4,1957,2,"male",694,59,37,22,8,22,6,0,2
1881366,68,20,1945,4,"female",334,147,47,10,290,10,159,0,131
1881387,101,1,1912,4,"male",1865,1836,1379,37,16,0,10,37,6
1881388,25,1,1988,1,"female",747,239,116,6,30,6,28,0,2
1881390,100,31,1913,1,"male",842,391,336,5,45,5,35,0,10
1881393,36,10,1977,1,"male",336,197,172,3,11,2,5,1,6
1881401,30,30,1983,11,"male",631,53,13,24,59,24,14,0,45
1881423,19,17,1994,12,"male",239,5,4,98,0,0,0,98,0
1881426,53,25,1960,12,"male",421,68,60,19,60,0,31,19,29
1881453,18,4,1995,12,"female",448,872,175,12,30,12,25,0,5
1881458,25,1,1988,10,"male",445,186,118,4,5,4,5,0,0
1881472,52,20,1961,5,"female",163,131,81,48,40,5,23,43,17
1881482,69,3,1944,3,"female",1381,15,4,17,2,0,1,17,1
1881500,27,31,1986,10,"male",449,202,91,125,121,125,102,0,19
1881511,14,18,1999,4,"male",359,24,23,7,3,0,0,7,3
1881517,17,15,1996,7,"male",529,125,75,9,3,9,2,0,1
1881521,59,14,1954,11,"female",602,54,27,101,54,100,44,1,10
1881531,26,26,1987,1,"male",233,15,14,0,2,0,2,0,0
1881587,14,30,1999,5,"male",687,1108,752,0,2,0,2,0,0
1881595,33,25,1980,9,"male",491,111,94,0,15,0,6,0,9
1881596,57,27,1956,11,"female",593,60,23,296,155,194,30,102,125
1881610,17,20,1996,1,"male",175,102,73,5,9,0,0,5,9
1881679,30,22,1983,6,"male",736,62,37,7,2,7,2,0,0
1881687,29,14,1984,1,"male",970,29,28,0,0,0,0,0,0
1881692,51,1,1962,2,"female",372,4,2,18,10,0,8,18,2
1881694,19,18,1994,6,"female",340,89,62,4,2,4,2,0,0
1881738,55,12,1958,4,"male",605,21,15,3,8,3,7,0,1
1881763,37,29,1976,5,"male",152,15,12,3,2,3,2,0,0
1881828,66,22,1947,2,"female",431,412,240,530,646,0,56,530,590
1881838,16,6,1997,1,"female",553,485,214,54,51,46,32,8,19
1881861,15,8,1998,2,"male",672,283,109,20,32,20,28,0,4
1881870,57,1,1956,12,"female",302,21,14,123,64,94,41,29,23
1881896,28,25,1985,12,"male",430,136,67,9,7,9,7,0,0
1881902,34,14,1979,1,"male",305,132,104,30,100,0,76,30,24
1881913,33,13,1980,8,"male",260,15,13,0,0,0,0,0,0
1881935,46,27,1967,3,"female",290,27,12,11,7,10,1,1,6
1881945,18,8,1995,5,"male",500,31,15,5,0,5,0,0,0
1881947,23,26,1990,7,"male",493,213,163,37,11,37,9,0,2
1881951,32,1,1981,10,"male",354,12,9,0,9,0,8,0,1
1881961,20,23,1993,12,"female",599,266,150,596,241,596,227,0,14
1881970,17,26,1996,6,"female",786,2253,1355,670,1743,502,759,168,984
1882033,34,5,1979,5,"male",87,190,174,47,247,18,96,29,151
1882043,19,1,1994,1,"male",41,1,1,0,0,0,0,0,0
1882060,33,6,1980,3,"male",483,97,70,9,2,9,2,0,0
1882069,16,7,1997,9,"female",469,291,193,2,1,0,0,2,1
1882130,19,11,1994,10,"male",105,36,26,0,2,0,1,0,1
1882140,32,8,1981,8,"male",720,230,197,77,10,77,9,0,1
1882160,42,15,1971,1,"female",1746,108,67,54,12,45,10,9,2
1882163,69,12,1944,9,"male",1512,29,18,7,3,7,2,0,1
1882206,20,10,1993,11,"female",168,586,311,850,466,481,411,369,55
1882208,74,19,1939,2,"male",248,87,82,0,0,0,0,0,0
1882214,37,11,1976,5,"female",690,44,17,76,60,76,37,0,23
1882220,40,20,1973,5,"male",217,70,51,58,13,58,12,0,1
1882229,18,5,1995,10,"female",60,2,1,50,0,50,0,0,0
1882253,16,7,1997,2,"female",574,155,67,73,24,73,16,0,8
1882259,41,15,1972,2,"female",572,2,0,10,1,10,1,0,0
1882266,22,5,1991,10,"female",414,207,155,79,162,79,158,0,4
1882267,31,11,1982,10,"male",33,2,2,4,0,4,0,0,0
1882269,26,7,1987,8,"male",618,85,59,0,27,0,9,0,18
1882273,16,20,1997,5,"female",260,207,153,54,21,20,3,34,18
1882284,28,5,1985,3,"male",624,1,0,0,0,0,0,0,0
1882307,19,1,1994,1,"male",7,23,23,8,0,8,0,0,0
1882318,19,4,1994,1,"male",623,428,363,0,0,0,0,0,0
1882319,26,9,1987,10,"female",157,19,15,3,1,3,1,0,0
1882325,20,26,1993,8,"male",832,861,671,42,177,36,145,6,32
1882326,16,15,1997,7,"male",239,158,109,88,32,8,20,80,12
1882335,24,28,1989,11,"male",525,117,67,0,0,0,0,0,0
1882336,19,18,1994,9,"male",331,10,8,0,0,0,0,0,0
1882350,60,18,1953,2,NA,1825,308,214,363,505,186,56,177,449
1882352,30,25,1983,6,"male",741,38,22,157,11,157,10,0,1
1882361,16,6,1997,1,"male",57,151,130,1,3,1,2,0,1
1882374,76,4,1937,7,"male",361,21,13,4,5,0,2,4,3
1882377,108,7,1905,11,"female",1088,552,203,92,43,88,20,4,23
1882385,99,29,1914,8,"male",11,223,202,53,506,53,344,0,162
1882428,19,17,1994,6,"male",135,93,74,1,2,1,2,0,0
1882484,20,1,1993,3,"male",267,2536,610,14355,5151,8591,3461,5764,1690
1882500,50,29,1963,5,"male",371,158,119,293,14,293,4,0,10
1882502,71,18,1942,1,"female",109,7,6,4,2,4,1,0,1
1882519,16,18,1997,1,"male",221,184,148,4,0,4,0,0,0
1882528,13,8,2000,4,"male",464,194,72,59,83,52,58,7,25
1882533,54,30,1959,4,"male",187,18,14,0,0,0,0,0,0
1882545,37,12,1976,12,"male",196,123,52,1316,273,1316,56,0,217
1882550,15,6,1998,8,"male",237,178,148,0,0,0,0,0,0
1882573,24,10,1989,3,"male",313,2190,1226,18,23,5,9,13,14
1882588,40,11,1973,5,"male",587,36,17,0,0,0,0,0,0
1882598,49,24,1964,1,"female",2063,95,66,250,0,231,0,19,0
1882626,27,24,1986,7,"male",596,38,32,6,6,6,6,0,0
1882653,48,8,1965,3,"female",124,22,11,33,0,0,0,33,0
1882671,18,15,1995,1,"male",41,14,12,0,0,0,0,0,0
1882681,22,17,1991,10,"male",445,67,36,0,0,0,0,0,0
1882697,19,27,1994,4,"male",176,223,170,376,228,370,215,6,13
1882708,27,9,1986,11,"female",557,107,67,0,9,0,5,0,4
1882776,44,8,1969,10,"male",306,54,32,31,46,26,41,5,5
1882795,70,11,1943,2,"female",1331,39,24,0,0,0,0,0,0
1882845,25,3,1988,6,"male",304,343,201,1269,301,1269,89,0,212
1882850,20,20,1993,5,"male",258,77,60,1,1,0,1,1,0
1882853,108,9,1905,3,"male",1237,226,135,4,1,4,0,0,1
1882886,20,20,1993,5,"male",796,97,42,27,2,0,1,27,1
1882901,32,21,1981,12,"male",411,185,156,87,59,5,3,82,56
1882921,17,27,1996,12,"male",382,274,207,7,2,7,2,0,0
1882934,31,26,1982,11,"male",272,25,5,0,0,0,0,0,0
1882941,23,14,1990,6,"male",507,137,96,1,3,0,2,1,1
1882947,53,29,1960,2,"male",966,312,106,8,5,2,5,6,0
1882968,23,15,1990,4,"male",8,15,13,3,0,3,0,0,0
1882969,29,13,1984,7,"female",380,68,46,1234,1217,920,661,314,556
1882984,18,15,1995,6,"male",346,21,17,0,5,0,3,0,2
1882990,20,24,1993,8,"female",321,305,60,51,57,49,34,2,23
1882992,30,24,1983,10,"male",300,94,68,65,43,65,43,0,0
1882993,23,9,1990,9,"male",445,125,59,0,0,0,0,0,0
1882999,57,16,1956,2,"male",291,12,8,0,5,0,3,0,2
1883018,17,16,1996,11,"female",453,1536,653,248,4,248,3,0,1
1883021,21,28,1992,1,"female",228,278,131,34,73,34,44,0,29
1883022,83,3,1930,7,"male",942,118,59,0,44,0,35,0,9
1883024,26,1,1987,1,"female",312,56,29,49,33,49,27,0,6
1883062,17,11,1996,6,"male",1390,811,158,29,149,12,73,17,76
1883108,19,21,1994,11,"female",521,428,341,378,56,377,46,1,10
1883116,16,17,1997,10,"male",894,69,48,26,2,14,1,12,1
1883122,17,8,1996,1,"male",778,435,174,77,257,7,160,70,97
1883132,18,19,1995,4,"male",66,89,73,25,5,25,1,0,4
1883138,52,2,1961,4,"female",94,53,38,55,39,54,35,1,4
1883192,18,10,1995,12,"male",461,62,28,0,6,0,2,0,4
1883202,38,6,1975,7,"male",401,24,23,1,29,0,20,1,9
1883215,33,20,1980,5,"female",1304,258,161,110,373,41,242,69,131
1883238,15,19,1998,3,"male",310,114,76,6,6,0,3,6,3
1883287,30,14,1983,11,"male",548,86,64,2,7,0,4,2,3
1883309,49,3,1964,6,"male",554,10,6,8,6,0,4,8,2
1883358,44,26,1969,1,"male",68,0,0,0,0,0,0,0,0
1883366,66,19,1947,12,"male",503,6,5,0,0,0,0,0,0
1883367,45,22,1968,10,"female",888,147,99,4,2,0,1,4,1
1883373,79,21,1934,1,"female",127,19,13,0,0,0,0,0,0
1883381,36,17,1977,1,"male",1000,107,66,2,1,2,1,0,0
1883385,54,10,1959,3,"female",107,107,72,192,64,192,22,0,42
1883411,67,9,1946,10,"female",540,70,22,225,51,0,31,225,20
1883468,25,1,1988,1,"male",9,8,5,0,0,0,0,0,0
1883485,35,1,1978,9,"female",393,154,121,0,0,0,0,0,0
1883487,19,11,1994,9,"female",538,274,132,8,20,8,8,0,12
1883520,31,16,1982,1,"male",1575,274,98,1,9,1,5,0,4
1883521,18,17,1995,5,"male",734,226,123,11,34,0,8,11,26
1883524,23,27,1990,11,"female",608,57,19,0,0,0,0,0,0
1883544,59,11,1954,10,"female",804,38,17,1,9,0,9,1,0
1883564,16,23,1997,8,"male",308,75,33,4,0,4,0,0,0
1883570,15,25,1998,4,"male",444,536,460,2,32,0,1,2,31
1883620,20,7,1993,10,"male",295,76,41,8,120,0,49,8,71
1883626,40,1,1973,5,"female",428,31,19,95,28,95,22,0,6
1883627,24,19,1989,8,"male",1205,79,72,0,1,0,0,0,1
1883647,29,4,1984,4,"male",274,179,92,22,22,7,4,15,18
1883710,55,24,1958,10,"female",63,4,4,9,0,9,0,0,0
1883724,35,14,1978,6,"male",165,9,8,3,0,3,0,0,0
1883768,25,2,1988,9,"male",1432,227,124,17,23,17,15,0,8
1883782,21,10,1992,5,"male",363,136,132,5,0,4,0,1,0
1883792,16,19,1997,9,"male",200,110,93,87,7,8,1,79,6
1883850,58,27,1955,11,"female",549,37,11,18,51,8,22,10,29
1883881,49,7,1964,12,"male",134,10,6,0,0,0,0,0,0
1883935,50,1,1963,9,"male",1441,2,1,1,0,1,0,0,0
1883937,66,28,1947,2,"female",1383,49,26,19,5,19,3,0,2
1883972,55,3,1958,5,"male",1814,107,48,2,11,2,7,0,4
1883982,23,10,1990,4,"male",375,17,11,0,12,0,4,0,8
1883987,15,18,1998,1,"male",392,65,27,18,14,0,7,18,7
1884024,100,13,1913,1,"male",1529,93,43,159,116,0,27,159,89
1884027,88,30,1925,6,"female",158,34,27,50,14,0,10,50,4
1884046,26,29,1987,12,"male",465,204,175,0,1,0,0,0,1
1884051,38,11,1975,4,"male",538,11,8,0,0,0,0,0,0
1884059,33,17,1980,12,"male",184,135,92,0,1,0,1,0,0
1884079,25,29,1988,9,"male",319,65,48,0,0,0,0,0,0
1884094,56,15,1957,11,"male",15,3,3,19,6,1,3,18,3
1884107,28,15,1985,1,"male",454,111,101,294,7,294,3,0,4
1884135,45,25,1968,12,"male",44,85,71,51,29,50,11,1,18
1884150,20,17,1993,1,"male",983,557,186,25,14,0,2,25,12
1884174,24,18,1989,3,"female",285,2,1,7,1,0,0,7,1
1884197,24,21,1989,4,"female",2064,57,47,873,250,519,152,354,98
1884205,22,10,1991,9,"male",297,174,170,3,2,3,0,0,2
1884209,69,6,1944,1,"female",310,41,20,188,99,0,9,188,90
1884224,19,27,1994,2,"male",251,41,26,0,13,0,2,0,11
1884235,102,3,1911,3,"male",2139,401,248,15,20,15,18,0,2
1884241,42,1,1971,4,"male",43,31,9,3,7,0,0,3,7
1884243,60,15,1953,5,"male",1191,39,10,2,1,2,1,0,0
1884269,19,10,1994,10,"male",238,165,79,6,7,6,7,0,0
1884288,108,6,1905,4,"female",1451,279,178,438,205,0,116,438,89
1884331,25,10,1988,1,"male",224,17,13,1,0,1,0,0,0
1884349,31,16,1982,2,"male",300,73,50,18,11,18,5,0,6
1884362,25,14,1988,2,"female",1167,143,54,996,5,996,3,0,2
1884429,61,16,1952,11,"male",406,2,2,0,0,0,0,0,0
1884435,33,16,1980,1,"female",392,109,56,203,3,165,3,38,0
1884461,28,19,1985,7,"male",417,120,109,12,1,12,1,0,0
1884464,58,9,1955,8,"male",354,6,6,0,0,0,0,0,0
1884467,57,12,1956,6,"female",29,51,38,202,218,202,135,0,83
1884482,26,1,1987,1,"male",297,288,250,57,90,57,86,0,4
1884487,17,2,1996,12,"male",744,1163,500,437,1314,437,726,0,588
1884493,39,23,1974,7,"male",314,7,5,5,5,5,5,0,0
1884495,25,1,1988,1,"male",32,62,50,296,42,296,33,0,9
1884527,63,23,1950,5,"male",605,318,234,2481,389,1500,267,981,122
1884544,25,10,1988,10,"male",130,810,490,4847,1816,4847,1699,0,117
1884563,59,3,1954,12,"male",1549,647,424,8,22,8,17,0,5
1884575,73,24,1940,7,"male",1104,106,63,2,8,2,8,0,0
1884582,16,3,1997,7,"male",57,252,238,0,0,0,0,0,0
1884605,41,25,1972,5,"male",1216,232,70,0,2,0,0,0,2
1884618,108,22,1905,10,"male",1157,525,142,1,3,1,3,0,0
1884625,80,6,1933,1,"male",237,31,26,2,0,2,0,0,0
1884729,18,8,1995,4,"male",112,69,52,65,46,30,33,35,13
1884749,17,20,1996,12,"female",690,524,386,256,35,166,26,90,9
1884750,44,13,1969,2,"male",436,193,116,27,28,0,3,27,25
1884769,38,4,1975,12,"male",189,1,1,27,0,1,0,26,0
1884790,23,7,1990,4,"female",1242,525,366,9,32,1,20,8,12
1884805,20,12,1993,1,"male",455,29,9,52,8,24,7,28,1
1884830,28,21,1985,9,"female",315,134,121,155,92,97,82,58,10
1884867,57,28,1956,12,"female",375,39,33,41,10,41,7,0,3
1884887,17,15,1996,10,"male",478,1128,819,12,6,6,5,6,1
1884888,23,18,1990,3,"female",351,111,65,28,33,21,21,7,12
1884890,44,14,1969,3,"male",499,129,103,1,0,0,0,1,0
1884901,18,6,1995,8,"male",370,502,449,0,0,0,0,0,0
1884906,58,24,1955,11,"female",607,39,8,0,0,0,0,0,0
1884912,22,25,1991,1,"male",263,66,44,18,8,14,4,4,4
1884941,77,19,1936,7,"female",767,83,22,9,3,7,3,2,0
1884951,19,10,1994,4,"male",89,28,21,25,31,14,18,11,13
1885057,31,3,1982,2,"male",199,140,137,1,2,1,1,0,1
1885063,22,10,1991,6,"female",231,36,24,65,58,65,33,0,25
1885076,32,25,1981,10,"female",713,1375,652,131,156,129,149,2,7
1885090,103,22,1910,12,"female",808,387,188,53,22,18,8,35,14
1885118,94,1,1919,6,"male",1351,2203,799,301,282,26,148,275,134
1885125,19,3,1994,1,"male",220,36,35,0,5,0,3,0,2
1885129,13,19,2000,1,"male",119,162,77,530,350,466,223,64,127
1885155,58,4,1955,7,"female",155,50,17,456,117,456,43,0,74
1885156,33,10,1980,5,"male",587,27,15,6,0,6,0,0,0
1885168,50,29,1963,1,"male",153,65,36,317,86,0,13,317,73
1885186,71,15,1942,1,"male",442,4,2,0,0,0,0,0,0
1885198,34,3,1979,12,"male",182,3,3,0,0,0,0,0,0
1885204,49,2,1964,2,"male",81,20,8,0,0,0,0,0,0
1885230,18,15,1995,12,"male",325,219,134,20,24,0,10,20,14
1885256,33,23,1980,5,"female",278,0,0,0,0,0,0,0,0
1885264,26,1,1987,8,"male",329,40,20,19,10,15,1,4,9
1885276,25,1,1988,1,"male",243,67,56,3,0,3,0,0,0
1885285,22,7,1991,3,"female",428,1,1,2,0,2,0,0,0
1885306,29,27,1984,1,"male",365,46,28,36,7,0,5,36,2
1885318,37,5,1976,12,"female",249,43,31,113,56,113,34,0,22
1885346,35,15,1978,3,"male",299,45,45,0,0,0,0,0,0
1885349,15,10,1998,6,"male",208,128,117,86,67,24,44,62,23
1885383,46,1,1967,10,"female",1496,2,2,1,0,1,0,0,0
1885401,84,29,1929,3,"female",1911,384,201,8,1,7,1,1,0
1885405,22,21,1991,7,"female",274,267,233,149,215,99,190,50,25
1885407,61,23,1952,7,"female",400,32,7,116,7,82,7,34,0
1885408,29,12,1984,11,"male",386,1027,848,768,1537,768,1475,0,62
1885420,45,10,1968,3,"male",463,70,43,1,0,1,0,0,0
1885427,18,5,1995,10,"female",142,4,3,0,0,0,0,0,0
1885484,34,2,1979,8,"male",304,8,7,0,0,0,0,0,0
1885490,26,22,1987,7,"male",320,208,160,2,0,2,0,0,0
1885513,49,7,1964,6,"male",326,29,20,391,88,48,38,343,50
1885550,18,27,1995,11,"male",391,185,151,5,0,5,0,0,0
1885592,19,24,1994,10,"female",42,82,59,1230,1044,61,616,1169,428
1885612,25,5,1988,4,"male",362,304,283,3,7,3,6,0,1
1885614,22,11,1991,12,"female",114,11,0,0,0,0,0,0,0
1885619,20,11,1993,12,"male",418,60,35,204,1,204,1,0,0
1885651,19,26,1994,1,"female",107,60,45,80,86,75,54,5,32
1885663,51,25,1962,12,"male",422,11,7,0,0,0,0,0,0
1885703,47,4,1966,2,"male",431,15,4,6,2,6,2,0,0
1885707,40,5,1973,5,"female",212,46,38,118,78,118,67,0,11
1885710,41,16,1972,3,"female",780,120,67,29,25,28,7,1,18
1885737,18,8,1995,9,"male",370,228,121,1,1,1,0,0,1
1885748,100,19,1913,8,"female",314,35,11,281,133,281,128,0,5
1885775,53,5,1960,3,"male",785,32,22,598,5,0,0,598,5
1885843,17,28,1996,1,"female",328,201,160,0,0,0,0,0,0
1885846,60,17,1953,1,"male",618,42,27,11,13,11,9,0,4
1885849,24,1,1989,4,"male",224,49,22,28,11,28,8,0,3
1885882,108,15,1905,4,"male",1146,47,31,83,15,70,10,13,5
1885920,21,1,1992,1,"male",328,0,0,1,0,0,0,1,0
1885921,38,2,1975,6,"male",350,9,6,26,13,26,9,0,4
1885929,25,5,1988,4,"male",1132,318,67,1,8,0,1,1,7
1885942,62,13,1951,2,"male",1008,61,37,5,6,2,6,3,0
1885962,103,14,1910,11,"male",706,593,287,90,230,90,212,0,18
1885977,14,9,1999,1,"female",234,216,67,60,289,60,180,0,109
1885978,50,14,1963,9,"female",747,85,40,9,57,9,29,0,28
1885988,27,19,1986,1,"male",458,119,70,0,0,0,0,0,0
1885990,16,23,1997,8,"female",526,358,227,28,28,16,7,12,21
1886003,70,15,1943,8,"male",794,31,17,0,10,0,8,0,2
1886019,28,28,1985,8,"male",206,36,19,0,0,0,0,0,0
1886053,103,17,1910,6,"male",879,195,145,0,2,0,2,0,0
1886061,23,20,1990,7,"male",182,104,87,0,1,0,0,0,1
1886075,25,8,1988,8,"male",447,59,47,1,0,1,0,0,0
1886108,18,31,1995,10,"female",259,16,6,2,0,2,0,0,0
1886144,62,9,1951,5,"male",639,92,69,104,21,104,15,0,6
1886191,16,2,1997,1,"female",435,3600,114,100,206,95,157,5,49
1886193,52,21,1961,11,"male",185,75,58,0,0,0,0,0,0
1886216,21,13,1992,10,"female",29,304,132,19,96,19,74,0,22
1886228,33,11,1980,2,"female",560,88,42,7,4,7,2,0,2
1886248,25,14,1988,6,"male",16,87,81,4,3,4,3,0,0
1886252,66,9,1947,7,"female",1783,288,151,146,94,5,84,141,10
1886269,14,1,1999,1,"male",56,25,14,0,0,0,0,0,0
1886319,13,19,2000,2,"male",107,21,14,6,2,5,0,1,2
1886338,21,1,1992,1,"female",232,23,7,0,0,0,0,0,0
1886342,71,24,1942,4,"female",1563,197,83,342,498,271,247,71,251
1886345,21,15,1992,8,"male",391,202,119,175,157,0,35,175,122
1886369,46,25,1967,1,"female",173,133,56,45,94,45,64,0,30
1886379,19,27,1994,2,"male",478,149,33,89,4,1,2,88,2
1886455,23,10,1990,3,"male",412,429,356,1843,115,1843,95,0,20
1886462,17,25,1996,5,"male",182,60,42,43,0,10,0,33,0
1886479,26,3,1987,12,"male",445,92,61,9,0,9,0,0,0
1886483,47,1,1966,6,"male",213,114,87,610,61,609,41,1,20
1886516,21,14,1992,12,"female",351,35,21,120,85,120,40,0,45
1886518,37,1,1976,1,"male",500,129,54,34,21,34,15,0,6
1886550,17,25,1996,12,"female",29,57,51,104,144,104,119,0,25
1886553,38,24,1975,1,"male",540,31,15,13,3,13,2,0,1
1886599,27,25,1986,10,"male",490,25,17,0,0,0,0,0,0
1886607,26,10,1987,2,"male",654,22,22,6,0,6,0,0,0
1886616,51,17,1962,6,"male",545,70,45,1033,88,944,67,89,21
1886627,25,1,1988,1,"male",291,119,79,0,13,0,7,0,6
1886635,18,12,1995,9,"male",70,70,26,8,6,8,5,0,1
1886660,29,9,1984,11,"female",542,247,119,293,213,293,97,0,116
1886686,68,6,1945,6,"female",377,15,9,79,109,0,5,79,104
1886707,18,11,1995,5,"male",641,188,139,21,7,21,7,0,0
1886732,19,16,1994,4,"female",291,55,38,22,5,4,3,18,2
1886741,58,11,1955,11,"female",176,115,24,95,92,88,78,7,14
1886744,67,18,1946,2,"male",296,199,103,79,1039,11,96,68,943
1886761,23,21,1990,10,"male",10,58,46,1,12,0,1,1,11
1886786,28,31,1985,5,"male",46,28,21,6,4,6,3,0,1
1886790,44,14,1969,9,"female",332,68,47,1,2,1,2,0,0
1886818,24,1,1989,12,"female",71,22,17,4,0,4,0,0,0
1886839,66,14,1947,8,"male",1778,86,7,366,86,0,16,366,70
1886855,17,3,1996,6,"female",64,505,396,212,793,202,215,10,578
1886865,16,5,1997,12,"female",258,95,33,14,19,14,11,0,8
1886901,28,6,1985,7,"male",88,20,13,3,2,0,2,3,0
1886906,22,17,1991,8,"male",268,545,300,90,20,12,13,78,7
1886937,14,19,1999,7,"male",93,0,0,0,0,0,0,0,0
1886940,62,30,1951,1,"male",422,40,21,7,46,6,22,1,24
1886958,54,11,1959,11,"male",417,84,66,11,44,0,3,11,41
1886974,66,4,1947,4,"male",750,516,220,349,135,1,48,348,87
1887002,60,14,1953,12,"female",1490,55,22,5,13,5,8,0,5
1887013,103,26,1910,1,"male",1334,230,122,5,143,5,100,0,43
1887027,35,20,1978,3,"male",829,86,41,55,64,55,26,0,38
1887044,41,22,1972,12,"male",70,1,0,0,0,0,0,0,0
1887095,59,26,1954,10,"female",632,288,240,4,13,4,10,0,3
1887098,65,5,1948,3,"female",1470,21,13,4,3,4,2,0,1
1887124,62,7,1951,12,"male",439,217,122,1,11,1,8,0,3
1887131,27,7,1986,7,"female",588,74,55,1,3,1,2,0,1
1887177,51,10,1962,1,"female",211,10,3,10,1,9,1,1,0
1887208,18,1,1995,11,"female",45,591,490,7419,4354,2208,2419,5211,1935
1887216,14,24,1999,11,"female",106,20,15,6,11,6,1,0,10
1887225,17,17,1996,6,"male",13,63,51,9,16,9,13,0,3
1887257,28,5,1985,5,"male",355,12,10,4,0,0,0,4,0
1887262,108,6,1905,10,"male",1293,871,750,2,167,1,142,1,25
1887264,96,16,1917,9,"male",1196,176,97,266,93,266,61,0,32
1887304,20,9,1993,2,"male",598,1,1,1,0,1,0,0,0
1887312,15,22,1998,9,"male",40,15,12,20,14,20,14,0,0
1887325,33,1,1980,1,"male",275,40,30,0,0,0,0,0,0
1887346,21,26,1992,8,"male",367,52,37,0,1,0,0,0,1
1887348,54,24,1959,5,"male",866,43,29,2,0,1,0,1,0
1887368,14,26,1999,6,"male",307,133,92,199,135,199,72,0,63
1887376,29,28,1984,5,"male",1360,291,211,7,28,7,21,0,7
1887396,20,1,1993,1,"female",355,259,24,67,46,67,37,0,9
1887403,20,11,1993,11,"female",511,444,228,1482,784,1061,611,421,173
1887426,27,14,1986,6,"male",512,332,284,2,0,0,0,2,0
1887489,16,13,1997,8,"female",560,216,76,97,3,82,1,15,2
1887490,21,24,1992,4,"male",168,19,12,3,0,3,0,0,0
1887492,50,16,1963,4,"female",1597,130,56,2,2,2,2,0,0
1887500,58,25,1955,5,"male",572,38,12,1,8,0,5,1,3
1887586,21,15,1992,7,"female",186,156,74,489,69,489,45,0,24
1887602,18,5,1995,4,"female",166,30,18,0,0,0,0,0,0
1887611,40,1,1973,2,"female",312,51,34,0,0,0,0,0,0
1887620,33,17,1980,1,"male",469,1,1,0,0,0,0,0,0
1887634,28,1,1985,1,"female",297,10,6,0,0,0,0,0,0
1887661,33,3,1980,11,"male",190,74,36,18,50,18,20,0,30
1887685,38,21,1975,4,"male",262,31,24,0,9,0,6,0,3
1887737,51,13,1962,10,"male",41,5,5,1,1,1,1,0,0
1887739,13,6,2000,1,"female",301,26,24,16,0,13,0,3,0
1887743,35,13,1978,7,"female",176,1,1,0,0,0,0,0,0
1887764,31,31,1982,12,"male",111,18,17,1,1,0,0,1,1
1887780,37,25,1976,1,"female",480,129,91,72,77,71,57,1,20
1887790,33,8,1980,8,"male",75,37,31,0,0,0,0,0,0
1887821,57,14,1956,5,"female",252,13,7,23,14,23,14,0,0
1887823,22,13,1991,12,"female",137,23,12,129,130,129,108,0,22
1887827,33,14,1980,11,"male",866,529,436,217,94,47,75,170,19
1887846,14,31,1999,1,"female",479,539,309,29,96,23,26,6,70
1887853,30,17,1983,8,"male",18,13,13,1,0,1,0,0,0
1887870,31,19,1982,12,"female",249,71,57,30,2,30,1,0,1
1887875,32,4,1981,6,"male",330,0,0,2,0,2,0,0,0
1887891,22,25,1991,5,"female",638,144,108,49,10,49,6,0,4
1887906,59,19,1954,7,"female",73,474,446,1260,1461,201,757,1059,704
1887907,14,6,1999,9,"female",420,883,631,1052,298,1046,170,6,128
1887917,23,2,1990,3,"male",429,170,120,4,4,4,2,0,2
1887934,47,29,1966,12,"female",908,2,0,66,7,66,3,0,4
1887942,104,30,1909,4,"female",1494,1102,507,94,37,54,15,40,22
1887970,34,11,1979,2,"female",820,35,8,2,0,2,0,0,0
1888028,22,10,1991,8,"female",98,42,33,1,5,1,4,0,1
1888056,19,13,1994,1,"male",318,124,39,92,12,15,6,77,6
1888078,19,15,1994,6,"female",495,117,92,10,0,10,0,0,0
1888105,18,28,1995,6,"female",498,311,150,112,582,112,256,0,326
1888114,19,23,1994,8,"male",32,83,63,58,129,57,61,1,68
1888148,18,7,1995,7,"male",725,801,473,230,575,73,259,157,316
1888164,55,12,1958,11,"female",677,64,39,50,38,50,33,0,5
1888185,18,28,1995,4,"male",368,230,100,91,18,84,8,7,10
1888188,26,14,1987,8,"male",454,1023,876,5,7,5,7,0,0
1888216,18,27,1995,5,"female",184,36,22,70,38,19,29,51,9
1888224,18,25,1995,1,"male",598,161,111,0,3,0,0,0,3
1888226,20,14,1993,11,"male",294,0,0,0,0,0,0,0,0
1888236,18,24,1995,12,"male",392,267,195,180,22,51,7,129,15
1888308,19,13,1994,10,"female",583,77,43,2,16,0,9,2,7
1888318,18,9,1995,12,"male",462,174,139,3,4,0,1,3,3
1888406,33,27,1980,3,"male",316,136,101,0,0,0,0,0,0
1888421,25,1,1988,1,"male",39,19,18,0,0,0,0,0,0
1888428,20,6,1993,6,"male",679,143,114,1,4,1,4,0,0
1888449,24,26,1989,10,"male",320,61,49,199,9,199,4,0,5
1888450,26,2,1987,11,"female",542,36,20,56,133,56,125,0,8
1888452,57,24,1956,6,"female",1369,25,9,1,0,0,0,1,0
1888458,53,29,1960,1,"female",650,50,40,45,4,45,1,0,3
1888478,64,27,1949,6,"female",2106,46,12,30,17,2,10,28,7
1888485,58,8,1955,9,"male",401,170,45,1,16,0,2,1,14
1888496,33,17,1980,10,"male",392,116,59,0,3,0,1,0,2
1888504,59,25,1954,6,"female",306,52,46,3245,295,0,145,3245,150
1888539,68,26,1945,6,"male",893,21,10,19,1,6,1,13,0
1888588,26,23,1987,11,"female",507,82,37,18,6,6,2,12,4
1888594,26,22,1987,7,"male",1188,1661,718,767,873,81,533,686,340
1888596,21,6,1992,6,"male",410,220,13,103,88,0,34,103,54
1888602,28,16,1985,4,"male",204,17,16,0,0,0,0,0,0
1888629,23,2,1990,8,"male",356,32,20,0,2,0,1,0,1
1888635,19,11,1994,9,"female",488,268,195,17,33,17,30,0,3
1888671,30,11,1983,4,"male",164,1,1,1,1,0,0,1,1
1888682,18,18,1995,7,"male",12,15,12,56,0,54,0,2,0
1888684,21,24,1992,12,"female",494,106,65,6,35,6,12,0,23
1888685,23,28,1990,3,"male",702,159,94,7,0,0,0,7,0
1888687,18,18,1995,5,"female",238,580,168,1663,1890,389,1102,1274,788
1888691,26,5,1987,11,"female",41,13,10,2,13,2,13,0,0
1888695,18,5,1995,9,"female",156,518,216,98,341,93,157,5,184
1888729,15,23,1998,2,"female",377,179,41,1027,263,429,151,598,112
1888740,29,27,1984,7,"male",1385,1,1,27,0,1,0,26,0
1888742,20,7,1993,7,"male",538,187,93,0,13,0,13,0,0
1888756,37,9,1976,10,"female",228,68,32,213,83,213,69,0,14
1888762,46,26,1967,10,"female",2283,108,44,11,57,11,55,0,2
1888768,47,28,1966,3,"female",100,70,55,23,7,22,5,1,2
1888795,108,19,1905,3,"male",1741,273,139,40,148,39,134,1,14
1888800,23,5,1990,4,"male",568,202,50,1,10,1,2,0,8
1888812,21,30,1992,3,"male",227,125,95,0,1,0,1,0,0
1888826,32,8,1981,10,"male",259,19,19,9,9,0,6,9,3
1888837,17,15,1996,12,"female",267,1280,215,1784,1423,1784,844,0,579
1888839,18,11,1995,9,"female",1040,584,454,234,104,0,36,234,68
1888841,51,18,1962,5,"female",290,17,6,8,34,8,31,0,3
1888911,33,8,1980,12,"female",430,4,3,1,0,1,0,0,0
1888928,27,5,1986,8,"male",30,20,12,5,8,5,3,0,5
1888959,20,14,1993,5,"male",46,24,23,2,4,2,4,0,0
1888984,113,1,1900,1,"male",1606,178,84,0,39,0,16,0,23
1889011,20,13,1993,4,"male",63,166,162,7,2,7,2,0,0
1889051,15,25,1998,10,"male",426,275,64,24,61,22,13,2,48
1889073,49,18,1964,5,"male",427,12,6,5,0,0,0,5,0
1889093,66,12,1947,11,"female",147,207,56,593,211,0,6,593,205
1889094,25,7,1988,8,"female",118,75,50,102,76,102,47,0,29
1889133,59,9,1954,8,"male",171,267,22,19,55,0,32,19,23
1889150,29,8,1984,4,"male",429,93,63,4,7,4,5,0,2
1889161,26,1,1987,1,"male",16,8,8,3,0,3,0,0,0
1889162,16,7,1997,5,"female",261,296,206,246,401,208,265,38,136
1889179,31,15,1982,7,"female",468,109,83,128,61,128,56,0,5
1889182,36,29,1977,9,"female",260,20,18,1,0,1,0,0,0
1889196,24,25,1989,11,"male",137,134,52,3,23,0,4,3,19
1889213,19,19,1994,7,"male",475,231,150,49,19,49,19,0,0
1889261,21,22,1992,1,"male",68,5,4,0,0,0,0,0,0
1889279,42,17,1971,7,"male",198,64,27,66,12,35,6,31,6
1889335,29,18,1984,4,"male",19,0,0,0,0,0,0,0,0
1889341,29,29,1984,6,"male",428,24,20,43,138,36,78,7,60
1889349,23,19,1990,8,"male",152,27,25,63,43,35,33,28,10
1889379,19,23,1994,5,"male",181,151,65,2,0,2,0,0,0
1889386,33,1,1980,11,"male",481,88,70,80,52,80,44,0,8
1889388,23,5,1990,1,"male",270,521,377,2,133,2,84,0,49
1889392,49,14,1964,7,"female",981,407,93,426,360,426,159,0,201
1889395,64,15,1949,6,"female",440,21,17,4,3,4,2,0,1
1889401,40,9,1973,12,"female",426,150,88,0,19,0,16,0,3
1889409,77,23,1936,4,"female",255,37,32,337,7,3,1,334,6
1889434,27,2,1986,1,"male",98,6,4,0,0,0,0,0,0
1889435,28,8,1985,5,"male",401,118,27,4,44,4,10,0,34
1889496,50,14,1963,10,"male",389,25,21,0,0,0,0,0,0
1889498,36,28,1977,8,"female",335,31,11,0,0,0,0,0,0
1889515,23,30,1990,10,"male",494,226,161,72,37,72,37,0,0
1889532,43,4,1970,4,"male",284,19,9,0,0,0,0,0,0
1889584,54,22,1959,1,"female",422,145,96,190,90,0,23,190,67
1889596,64,11,1949,1,"female",8,6,2,2,2,0,0,2,2
1889600,39,3,1974,9,"female",253,99,36,514,193,442,86,72,107
1889613,21,13,1992,12,"female",474,235,145,7,69,5,56,2,13
1889624,22,1,1991,9,"male",1394,291,126,1,10,1,6,0,4
1889640,21,29,1992,6,"female",87,217,30,30,16,9,3,21,13
1889701,53,13,1960,9,"male",1456,50,20,6,5,6,1,0,4
1889717,25,1,1988,1,"male",133,1,1,0,0,0,0,0,0
1889745,25,28,1988,2,"female",495,468,277,570,1483,474,904,96,579
1889760,17,17,1996,11,"female",433,434,114,58,128,55,118,3,10
1889767,59,13,1954,11,"male",1289,83,65,3,3,0,2,3,1
1889769,34,22,1979,4,"male",864,54,37,0,1,0,1,0,0
1889792,33,10,1980,10,"male",173,19,11,0,0,0,0,0,0
1889806,56,18,1957,12,"male",465,4,2,0,0,0,0,0,0
1889808,19,1,1994,7,"male",291,404,164,4,11,2,6,2,5
1889826,60,12,1953,12,"female",425,103,65,1357,775,16,335,1341,440
1889836,28,10,1985,10,"female",311,11,11,0,0,0,0,0,0
1889925,108,9,1905,9,"female",1613,4138,1212,14,60,14,38,0,22
1889945,31,15,1982,6,"female",668,905,748,179,840,179,633,0,207
1889963,18,7,1995,8,"male",110,1256,702,1005,2092,556,1139,449,953
1889979,18,29,1995,3,"female",6,1,1,1,0,0,0,1,0
1889998,27,18,1986,9,"male",1202,43,14,0,1,0,1,0,0
1890046,108,19,1905,5,"female",241,107,59,17,51,17,29,0,22
1890056,72,4,1941,12,"female",1587,60,10,0,0,0,0,0,0
1890059,17,27,1996,5,"male",17,1,1,3,0,3,0,0,0
1890070,18,27,1995,8,"male",60,42,41,0,1,0,1,0,0
1890090,20,4,1993,4,"female",424,161,133,0,0,0,0,0,0
1890092,24,25,1989,11,"male",414,82,18,0,0,0,0,0,0
1890101,31,19,1982,8,"female",317,92,69,0,0,0,0,0,0
1890118,66,26,1947,1,NA,2162,113,51,7,8,3,6,4,2
1890133,34,18,1979,7,"female",1353,1552,225,478,819,463,522,15,297
1890142,41,1,1972,1,"female",195,22,21,103,22,103,14,0,8
1890161,29,22,1984,5,"male",559,184,126,395,100,395,63,0,37
1890164,32,1,1981,1,"male",729,296,203,11,25,11,22,0,3
1890173,39,3,1974,1,"female",308,421,349,51,60,50,49,1,11
1890192,103,29,1910,9,"male",1257,435,199,0,0,0,0,0,0
1890206,14,4,1999,5,"male",64,142,119,12,7,12,5,0,2
1890217,28,23,1985,3,"male",655,164,141,12,5,12,5,0,0
1890272,51,4,1962,11,"male",433,2,1,1,0,0,0,1,0
1890273,13,17,2000,5,"female",167,491,367,27,60,27,56,0,4
1890274,27,26,1986,8,"female",206,11,7,2,3,2,1,0,2
1890277,61,18,1952,5,"male",766,70,13,0,1,0,1,0,0
1890297,102,20,1911,6,"male",706,190,57,16,54,0,18,16,36
1890301,49,15,1964,12,"male",268,12,8,8,5,0,4,8,1
1890309,108,22,1905,10,"female",1391,241,94,372,893,55,575,317,318
1890351,65,15,1948,9,"female",573,131,80,2,3,0,0,2,3
1890383,103,25,1910,2,"male",217,108,65,2,14,2,8,0,6
1890416,45,11,1968,9,"female",112,387,340,835,341,835,229,0,112
1890420,18,1,1995,4,"female",1263,1983,309,231,711,229,221,2,490
1890421,103,1,1910,9,"male",375,139,108,16,0,16,0,0,0
1890422,16,14,1997,4,"female",757,1938,1306,591,575,76,149,515,426
1890435,17,8,1996,4,"male",550,224,169,23,1,0,1,23,0
1890453,40,4,1973,3,"male",13,24,23,8,1,0,0,8,1
1890493,26,25,1987,9,"male",214,14,5,3,0,3,0,0,0
1890506,62,10,1951,10,"male",1377,53,19,7,23,7,14,0,9
1890515,26,2,1987,5,"male",1885,1,1,1,2,0,1,1,1
1890527,22,8,1991,10,"female",134,263,128,313,129,313,54,0,75
1890531,63,7,1950,3,"male",1456,224,115,3,4,3,4,0,0
1890541,22,9,1991,7,"female",1102,456,278,562,357,0,68,562,289
1890559,30,1,1983,6,"male",381,26,12,0,0,0,0,0,0
1890560,22,16,1991,3,"female",122,58,37,227,113,58,48,169,65
1890574,71,2,1942,9,"male",556,46,41,7,0,7,0,0,0
1890604,70,8,1943,11,"female",1592,63,30,20,13,16,3,4,10
1890609,49,10,1964,4,"male",766,106,90,0,0,0,0,0,0
1890622,27,1,1986,10,"male",363,54,35,6,9,0,0,6,9
1890704,86,6,1927,8,"male",1093,733,485,54,112,3,43,51,69
1890708,36,13,1977,1,"female",424,63,31,18,24,15,4,3,20
1890717,32,25,1981,6,"male",1335,27,21,10,11,0,6,10,5
1890736,17,5,1996,1,"male",261,91,27,233,103,232,58,1,45
1890765,73,28,1940,9,"female",668,348,163,1260,518,0,119,1260,399
1890773,54,2,1959,1,"female",186,54,36,48,11,48,8,0,3
1890788,23,17,1990,11,"male",352,17,9,1,0,1,0,0,0
1890807,39,3,1974,9,"male",224,70,42,34,5,33,2,1,3
1890860,27,10,1986,10,"male",78,5,4,4,0,4,0,0,0
1890890,26,29,1987,8,"male",89,101,94,10,1,8,1,2,0
1890893,20,5,1993,2,"male",330,234,164,8,43,8,32,0,11
1890927,28,15,1985,9,"male",251,2,1,13,0,13,0,0,0
1890995,25,3,1988,2,"male",426,4,3,0,0,0,0,0,0
1891040,65,25,1948,6,"male",889,9,5,6,11,0,2,6,9
1891047,23,29,1990,4,"female",782,87,65,18,3,18,3,0,0
1891050,16,3,1997,3,"male",662,147,86,0,0,0,0,0,0
1891079,26,29,1987,7,"male",146,10,8,7,2,7,0,0,2
1891113,19,27,1994,8,"female",600,3719,1761,1918,3896,77,1499,1841,2397
1891148,19,15,1994,12,"female",62,129,93,515,393,3,176,512,217
1891153,27,26,1986,3,"male",410,44,24,4,4,3,2,1,2
1891155,50,26,1963,4,"male",313,19,18,0,0,0,0,0,0
1891159,25,1,1988,1,"male",138,31,26,9,2,8,2,1,0
1891172,30,7,1983,8,"female",460,98,22,2,4,2,1,0,3
1891178,103,1,1910,6,"female",454,333,283,0,1,0,0,0,1
1891199,19,18,1994,5,"male",416,321,304,0,0,0,0,0,0
1891225,33,15,1980,6,"female",547,22,14,33,27,33,26,0,1
1891232,19,2,1994,3,"male",331,338,255,203,159,203,134,0,25
1891237,34,22,1979,2,"female",531,205,80,50,47,50,15,0,32
1891294,29,22,1984,8,"male",485,75,34,13,7,13,5,0,2
1891311,21,12,1992,2,"female",261,5,5,0,6,0,6,0,0
1891321,16,2,1997,7,"male",601,796,452,83,128,45,24,38,104
1891351,33,26,1980,1,"female",131,13,9,3,116,2,73,1,43
1891356,34,16,1979,3,"male",35,19,10,1,1,1,1,0,0
1891364,102,7,1911,7,"female",1317,532,133,1,46,0,36,1,10
1891371,53,10,1960,7,"male",20,7,6,1,0,1,0,0,0
1891372,35,1,1978,1,"male",170,164,132,458,868,458,621,0,247
1891377,36,7,1977,10,"male",205,131,102,44,34,44,20,0,14
1891399,14,24,1999,7,"male",342,265,115,0,3,0,3,0,0
1891411,28,14,1985,11,"male",48,107,71,3,0,1,0,2,0
1891437,45,28,1968,5,"female",334,38,25,51,31,2,14,49,17
1891452,51,5,1962,7,"female",894,62,33,85,91,84,64,1,27
1891478,20,2,1993,4,"male",372,52,35,0,0,0,0,0,0
1891490,21,27,1992,9,"female",726,49,19,0,0,0,0,0,0
1891522,20,24,1993,10,"female",660,192,88,3,38,3,13,0,25
1891529,74,25,1939,4,"female",1371,23,4,23,0,20,0,3,0
1891538,20,5,1993,3,"male",68,7,7,19,17,19,16,0,1
1891559,39,2,1974,1,"male",772,19,7,1,2,1,2,0,0
1891562,16,22,1997,8,"male",83,104,88,125,8,0,3,125,5
1891572,23,21,1990,7,"male",281,108,26,0,13,0,7,0,6
1891589,65,27,1948,6,"female",1038,130,38,352,70,301,42,51,28
1891592,21,10,1992,10,"female",471,167,34,0,1,0,1,0,0
1891599,25,15,1988,2,NA,239,4,4,0,0,0,0,0,0
1891620,22,16,1991,5,"male",568,57,52,0,0,0,0,0,0
1891634,32,23,1981,1,"male",900,83,47,3,10,2,3,1,7
1891664,62,30,1951,6,"female",158,187,156,0,0,0,0,0,0
1891693,16,24,1997,5,"female",426,125,88,21,2,21,1,0,1
1891722,15,23,1998,6,"male",408,54,26,0,0,0,0,0,0
1891748,29,25,1984,12,"female",753,10,10,0,0,0,0,0,0
1891750,20,10,1993,8,"female",341,248,73,187,68,187,47,0,21
1891762,20,7,1993,4,"male",178,707,536,931,225,931,188,0,37
1891770,33,23,1980,12,"male",583,177,165,46,10,45,9,1,1
1891842,22,7,1991,6,"female",563,225,153,109,81,106,32,3,49
1891911,42,8,1971,2,"male",670,67,38,0,0,0,0,0,0
1891914,20,2,1993,11,"female",428,336,219,179,194,179,151,0,43
1891926,22,12,1991,6,"male",68,8,7,0,1,0,1,0,0
1891944,38,15,1975,1,"male",409,30,11,0,0,0,0,0,0
1891958,31,3,1982,2,"male",321,71,67,12,2,11,1,1,1
1891985,19,24,1994,8,"female",448,61,25,82,96,82,62,0,34
1891995,19,21,1994,3,"male",622,870,242,1039,2014,151,918,888,1096
1892050,66,3,1947,7,NA,2219,36,11,19,1,5,1,14,0
1892074,66,12,1947,10,"female",180,33,15,200,139,0,64,200,75
1892075,19,18,1994,2,"male",439,156,149,0,0,0,0,0,0
1892110,64,26,1949,2,"female",817,105,21,1,19,0,13,1,6
1892135,103,20,1910,5,"male",1709,137,55,2,92,2,49,0,43
1892153,108,3,1905,9,"female",1003,142,77,55,10,25,6,30,4
1892160,19,10,1994,5,"male",824,230,162,37,0,37,0,0,0
1892201,49,16,1964,3,"male",1412,37,12,0,0,0,0,0,0
1892230,26,26,1987,1,"female",348,20,13,44,8,44,8,0,0
1892240,61,29,1952,7,"female",164,164,87,1049,347,0,41,1049,306
1892288,23,19,1990,2,"male",1085,524,211,87,32,87,30,0,2
1892307,42,10,1971,8,"female",359,2,1,0,0,0,0,0,0
1892350,30,28,1983,2,"male",391,264,234,2461,313,2440,229,21,84
1892359,103,24,1910,4,"female",1644,106,39,8,10,2,5,6,5
1892361,93,4,1920,10,"male",392,87,84,67,7,0,1,67,6
1892400,21,28,1992,8,"female",264,416,337,236,738,5,462,231,276
1892405,15,17,1998,1,"female",172,123,91,111,191,104,122,7,69
1892420,28,28,1985,11,"female",714,237,116,195,102,163,58,32,44
1892425,23,12,1990,1,"male",91,21,16,0,3,0,3,0,0
1892450,69,5,1944,5,"female",987,18,13,0,1,0,0,0,1
1892465,44,6,1969,6,"male",454,156,79,1,26,0,11,1,15
1892494,71,16,1942,6,"male",391,14,3,85,26,22,13,63,13
1892499,35,3,1978,7,"female",351,67,43,53,1,53,1,0,0
1892523,19,3,1994,11,"male",553,320,201,59,10,59,2,0,8
1892524,46,17,1967,8,"female",1850,302,241,0,0,0,0,0,0
1892536,66,27,1947,7,"female",234,145,41,89,1,0,0,89,1
1892557,21,6,1992,6,"female",223,127,82,0,5,0,3,0,2
1892644,19,7,1994,11,"male",486,158,107,9,0,9,0,0,0
1892650,34,25,1979,4,"male",316,175,148,79,166,79,82,0,84
1892651,25,26,1988,4,"male",245,207,178,1,7,1,7,0,0
1892653,25,16,1988,1,"male",171,107,91,119,21,37,15,82,6
1892655,18,1,1995,12,"female",421,203,135,0,0,0,0,0,0
1892659,26,1,1987,1,"female",305,47,33,0,0,0,0,0,0
1892699,25,28,1988,3,"male",101,55,50,13,24,9,24,4,0
1892713,19,14,1994,10,"female",314,88,62,189,297,105,53,84,244
1892716,101,30,1912,4,"female",658,39,27,51,21,19,9,32,12
1892720,62,23,1951,12,"male",300,9,4,0,0,0,0,0,0
1892733,14,15,1999,9,"male",51,62,44,3,2,3,2,0,0
1892739,25,18,1988,6,"male",1174,213,198,63,48,50,39,13,9
1892771,100,4,1913,9,"female",1018,102,32,745,42,744,16,1,26
1892776,19,9,1994,4,"female",232,190,142,751,460,728,360,23,100
1892779,32,28,1981,2,"male",548,150,59,33,1,33,1,0,0
1892783,26,20,1987,5,"male",481,258,228,30,34,30,32,0,2
1892804,18,2,1995,4,"male",1681,216,118,14,17,8,8,6,9
1892835,53,9,1960,6,"male",320,49,37,4,11,4,10,0,1
1892858,26,9,1987,7,"male",639,99,78,8,0,8,0,0,0
1892867,21,5,1992,3,"male",545,646,550,176,117,175,100,1,17
1892894,14,1,1999,1,"male",182,0,0,3,0,3,0,0,0
1892918,28,18,1985,2,"male",145,13,12,8,4,6,2,2,2
1892921,18,17,1995,11,"male",738,96,57,2,2,2,1,0,1
1892928,66,29,1947,4,"female",885,46,12,153,26,65,18,88,8
1892931,31,3,1982,2,"male",474,1,1,0,0,0,0,0,0
1892948,26,6,1987,11,"male",1269,92,42,3,5,3,1,0,4
1892964,51,12,1962,9,"female",811,139,77,128,219,107,121,21,98
1892977,18,15,1995,5,"male",434,73,62,0,1,0,0,0,1
1892995,14,1,1999,10,"male",364,239,231,1,12,1,4,0,8
1893024,18,7,1995,7,"female",75,274,158,1466,1541,833,777,633,764
1893026,108,28,1905,5,NA,2254,198,102,41,36,2,10,39,26
1893037,96,24,1917,8,"female",1069,1404,1005,3,0,3,0,0,0
1893046,62,19,1951,11,"male",1570,128,42,106,43,106,42,0,1
1893178,20,22,1993,3,"female",314,311,241,906,315,224,116,682,199
1893231,78,1,1935,1,"male",1413,184,57,0,1,0,1,0,0
1893256,70,22,1943,7,"female",1130,27,12,6,2,0,1,6,1
1893266,71,4,1942,6,"female",384,25,13,0,0,0,0,0,0
1893291,68,27,1945,4,NA,1862,790,435,422,425,410,318,12,107
1893295,67,26,1946,7,"male",527,101,78,48,35,0,3,48,32
1893301,33,11,1980,7,"male",222,196,106,6,30,0,6,6,24
1893342,20,5,1993,9,"male",92,4,4,0,0,0,0,0,0
1893384,16,12,1997,1,"female",193,92,55,2,34,2,21,0,13
1893400,62,23,1951,6,"female",594,40,21,45,13,0,4,45,9
1893449,15,12,1998,1,"male",339,42,8,91,6,91,1,0,5
1893451,70,18,1943,12,"male",1524,48,29,4,2,0,0,4,2
1893517,20,26,1993,8,"female",378,252,59,4,53,1,21,3,32
1893534,54,23,1959,1,"female",74,22,17,78,10,0,8,78,2
1893536,44,27,1969,9,"male",121,32,26,3,0,3,0,0,0
1893545,22,20,1991,9,"male",934,48,26,13,12,7,5,6,7
1893560,19,9,1994,1,"male",676,993,624,23,10,23,4,0,6
1893571,23,18,1990,10,"female",417,160,123,38,7,0,0,38,7
1893576,16,24,1997,8,"male",465,0,0,0,0,0,0,0,0
1893579,15,20,1998,2,"female",380,456,400,0,19,0,4,0,15
1893596,18,24,1995,7,"male",199,785,691,144,22,144,17,0,5
1893644,23,11,1990,2,"male",172,61,50,23,78,0,49,23,29
1893656,102,11,1911,11,"male",1460,29,20,1,0,0,0,1,0
1893657,18,18,1995,6,"male",198,3,2,1,3,1,1,0,2
1893686,19,21,1994,7,"male",246,17,16,0,0,0,0,0,0
1893702,58,29,1955,6,"male",1344,68,17,19,0,0,0,19,0
1893740,53,23,1960,9,"male",177,65,54,3,1,0,0,3,1
1893743,27,22,1986,7,"male",1031,240,176,15,154,4,115,11,39
1893755,65,15,1948,10,"male",38,18,8,5,2,5,1,0,1
1893765,21,20,1992,11,"female",280,78,44,57,103,25,83,32,20
1893774,25,1,1988,1,"male",42,6,6,21,0,21,0,0,0
1893779,22,2,1991,5,"female",671,191,81,4,0,0,0,4,0
1893801,13,27,2000,4,"male",5,29,19,73,64,73,42,0,22
1893812,44,20,1969,5,"female",1329,126,34,26,39,26,24,0,15
1893822,26,7,1987,10,"male",322,83,59,22,25,4,18,18,7
1893826,25,4,1988,1,"female",156,98,74,189,233,189,191,0,42
1893845,45,1,1968,1,"male",164,0,0,0,0,0,0,0,0
1893861,55,10,1958,8,"male",338,67,37,25,11,7,2,18,9
1893894,17,5,1996,7,"male",758,239,149,0,0,0,0,0,0
1893900,31,9,1982,1,"male",524,82,46,0,1,0,1,0,0
1893955,22,26,1991,1,"male",195,32,20,25,8,0,5,25,3
1893966,30,1,1983,8,"female",201,48,23,186,149,186,65,0,84
1893967,38,18,1975,11,"female",345,21,11,17,6,0,0,17,6
1893998,24,6,1989,8,"female",562,377,166,154,143,154,101,0,42
1894012,108,2,1905,5,"female",1054,239,104,7,3,7,3,0,0
1894019,31,13,1982,5,"female",440,97,77,112,20,103,16,9,4
1894020,67,30,1946,10,"male",1679,8,4,0,0,0,0,0,0
1894029,94,5,1919,4,"female",1043,623,254,0,0,0,0,0,0
1894033,77,1,1936,5,"male",1199,217,135,21,22,14,6,7,16
1894041,36,20,1977,5,"female",775,40,19,0,14,0,11,0,3
1894046,19,20,1994,6,"male",137,54,48,1,8,0,2,1,6
1894055,24,30,1989,3,"male",695,281,127,43,20,28,14,15,6
1894065,24,26,1989,10,"female",570,17,12,7,12,7,12,0,0
1894066,24,7,1989,7,"female",991,120,67,183,159,128,101,55,58
1894071,14,20,1999,10,"male",13,36,23,0,1,0,1,0,0
1894118,24,3,1989,2,"female",1463,381,230,599,514,513,214,86,300
1894122,61,22,1952,8,"female",171,21,13,31,44,31,7,0,37
1894128,32,25,1981,3,"male",235,151,68,203,74,84,59,119,15
1894137,38,7,1975,4,"male",201,86,65,15,28,15,26,0,2
1894144,20,7,1993,12,"male",545,98,73,2,3,2,0,0,3
1894151,19,25,1994,11,"male",411,151,105,3,1,3,1,0,0
1894181,24,24,1989,7,"female",253,280,158,27,86,17,41,10,45
1894184,32,2,1981,3,"male",501,971,60,36,70,33,62,3,8
1894211,56,25,1957,2,"female",494,160,104,241,59,0,35,241,24
1894212,23,1,1990,1,"female",249,25,5,22,10,0,1,22,9
1894246,13,24,2000,1,"female",280,167,131,101,34,101,34,0,0
1894249,55,7,1958,6,"male",470,59,24,0,0,0,0,0,0
1894253,19,23,1994,6,"male",178,16,16,0,0,0,0,0,0
1894255,18,19,1995,12,"female",82,61,47,11,7,11,5,0,2
1894299,23,3,1990,1,"male",60,108,89,55,21,55,10,0,11
1894307,45,18,1968,10,"male",293,298,292,564,301,564,281,0,20
1894313,30,15,1983,3,"female",494,204,111,670,820,197,459,473,361
1894327,40,8,1973,10,"female",900,142,63,185,175,177,131,8,44
1894332,16,14,1997,9,"female",744,2427,1436,282,3317,15,2111,267,1206
1894350,27,28,1986,1,"male",370,164,31,0,0,0,0,0,0
1894351,57,17,1956,7,"male",7,37,32,8,8,8,5,0,3
1894395,32,28,1981,5,"male",81,6,4,2,1,2,0,0,1
1894430,27,21,1986,4,"male",315,1,1,0,0,0,0,0,0
1894431,27,3,1986,3,"female",212,33,7,24,11,18,9,6,2
1894439,48,28,1965,4,"female",758,131,21,136,82,0,37,136,45
1894446,13,2,2000,10,"male",27,1,1,0,0,0,0,0,0
1894476,21,26,1992,4,"male",221,69,51,6,3,6,3,0,0
1894495,28,25,1985,12,"male",432,17,7,5,1,3,0,2,1
1894496,20,25,1993,9,"male",344,179,128,3,0,3,0,0,0
1894505,38,31,1975,12,"female",666,36,19,49,76,49,53,0,23
1894518,18,23,1995,12,"female",292,198,151,0,6,0,0,0,6
1894529,100,1,1913,1,"male",887,34,16,12,3,12,3,0,0
1894530,23,28,1990,1,"male",549,211,118,0,4,0,2,0,2
1894540,18,6,1995,5,"male",1418,884,319,861,1036,697,484,164,552
1894600,55,27,1958,3,"female",24,10,6,7,13,7,8,0,5
1894612,55,17,1958,1,"male",75,34,27,34,0,34,0,0,0
1894649,108,31,1905,12,"male",1181,409,76,1,4,0,2,1,2
1894696,34,24,1979,9,"female",284,45,20,194,210,5,25,189,185
1894697,25,1,1988,1,"male",262,19,6,0,0,0,0,0,0
1894701,16,24,1997,5,"male",40,6,4,0,3,0,3,0,0
1894706,35,26,1978,1,"female",626,481,227,0,0,0,0,0,0
1894728,44,6,1969,11,"female",268,158,116,422,197,1,77,421,120
1894742,36,10,1977,8,"male",784,21,18,0,1,0,0,0,1
1894788,32,26,1981,5,"female",289,108,89,24,11,0,3,24,8
1894793,37,8,1976,5,"male",56,112,74,45,50,45,24,0,26
1894806,25,28,1988,7,"male",609,51,23,0,0,0,0,0,0
1894807,26,13,1987,9,"female",100,20,10,14,8,14,8,0,0
1894818,14,4,1999,4,"male",404,168,81,18,60,18,50,0,10
1894838,103,30,1910,12,"female",1431,127,67,5,1,0,0,5,1
1894851,64,30,1949,5,"male",2193,147,44,1,10,0,7,1,3
1894863,27,27,1986,3,"male",489,108,76,54,0,54,0,0,0
1894921,18,3,1995,8,"male",520,271,218,10,1,0,0,10,1
1894934,18,25,1995,8,"male",10,11,8,2,1,0,0,2,1
1894936,48,20,1965,10,"female",19,68,57,43,146,41,120,2,26
1894948,52,30,1961,11,"female",286,22,12,0,9,0,6,0,3
1894972,70,28,1943,1,"male",1418,13,1,0,0,0,0,0,0
1895012,49,6,1964,1,"female",239,6,6,3,0,3,0,0,0
1895030,68,13,1945,12,"male",186,105,102,0,0,0,0,0,0
1895041,22,1,1991,3,"male",149,76,73,0,0,0,0,0,0
1895092,30,15,1983,6,"female",422,104,82,299,232,285,168,14,64
1895131,49,10,1964,4,"male",1877,71,52,12,3,0,0,12,3
1895134,38,28,1975,8,"female",277,35,25,145,35,0,2,145,33
1895138,27,9,1986,1,"female",182,39,25,15,25,15,22,0,3
1895158,17,19,1996,9,"female",313,168,85,1,0,1,0,0,0
1895165,27,13,1986,3,"male",477,26,16,3,1,3,0,0,1
1895191,31,3,1982,11,"female",576,150,98,662,243,628,166,34,77
1895203,103,25,1910,12,"female",718,487,306,51,38,51,36,0,2
1895237,33,28,1980,3,"male",803,30,24,1,0,1,0,0,0
1895257,23,17,1990,6,"female",112,217,208,1036,345,1024,328,12,17
1895262,28,5,1985,3,"male",202,48,33,44,35,41,21,3,14
1895265,56,6,1957,3,"male",19,19,11,16,52,1,29,15,23
1895291,29,28,1984,2,"female",308,19,16,0,0,0,0,0,0
1895292,64,15,1949,4,"male",242,74,57,2,3,0,3,2,0
1895299,24,18,1989,7,"female",469,152,107,15,30,15,16,0,14
1895332,17,3,1996,1,"male",558,33,20,0,0,0,0,0,0
1895337,58,11,1955,3,"male",307,39,27,1,0,1,0,0,0
1895360,17,25,1996,11,"male",33,67,51,27,1,27,1,0,0
1895380,24,5,1989,9,"male",256,108,85,2,22,2,12,0,10
1895441,35,15,1978,6,"female",283,7,6,0,0,0,0,0,0
1895453,19,13,1994,6,"male",565,312,224,9,10,0,1,9,9
1895456,36,1,1977,1,"male",497,58,27,7,8,7,8,0,0
1895502,25,5,1988,5,"male",280,254,165,119,175,107,114,12,61
1895541,29,1,1984,8,"female",289,167,59,46,113,42,43,4,70
1895554,16,9,1997,12,"female",406,563,291,137,187,37,77,100,110
1895559,16,6,1997,11,"female",550,212,84,1,14,1,10,0,4
1895577,53,1,1960,1,"male",1236,35,8,0,0,0,0,0,0
1895583,23,13,1990,1,"male",320,51,31,0,0,0,0,0,0
1895649,28,13,1985,3,"male",599,892,836,1,22,1,18,0,4
1895658,75,19,1938,4,"female",1147,67,31,310,76,252,38,58,38
1895720,49,1,1964,6,"male",71,14,12,0,0,0,0,0,0
1895741,43,2,1970,12,"male",584,21,13,4,0,2,0,2,0
1895747,44,12,1969,12,"male",329,10,5,0,0,0,0,0,0
1895783,63,15,1950,2,"female",154,62,30,102,159,102,158,0,1
1895797,50,2,1963,9,"female",568,541,390,517,85,517,58,0,27
1895809,41,3,1972,11,"male",29,10,9,3,11,3,11,0,0
1895822,60,29,1953,12,"male",1020,136,83,1,30,0,18,1,12
1895823,42,5,1971,8,"female",1281,307,223,605,565,353,475,252,90
1895895,43,25,1970,12,"female",52,120,53,118,241,2,79,116,162
1895897,23,26,1990,12,"male",1024,277,130,67,11,67,2,0,9
1895942,29,17,1984,7,"female",50,17,11,4,8,4,7,0,1
1895992,18,25,1995,5,"male",218,42,22,0,0,0,0,0,0
1895995,38,16,1975,1,"female",462,156,87,159,265,138,118,21,147
1896005,55,3,1958,10,"male",1096,16,7,2,7,1,7,1,0
1896015,67,20,1946,6,"female",278,39,29,191,109,189,80,2,29
1896019,28,11,1985,8,"male",166,28,20,0,0,0,0,0,0
1896069,55,3,1958,6,"female",83,42,19,14,11,1,0,13,11
1896094,74,31,1939,12,"male",1843,188,76,3,2,3,1,0,1
1896099,23,18,1990,9,"male",373,2,2,1,1,1,0,0,1
1896107,23,31,1990,1,"male",842,175,146,104,106,104,81,0,25
1896122,64,4,1949,11,"female",1905,113,43,1208,179,1145,46,63,133
1896141,26,1,1987,1,"female",135,66,59,89,15,89,11,0,4
1896155,74,3,1939,8,"male",1573,32,20,9,3,0,2,9,1
1896201,43,8,1970,5,"female",454,93,50,103,36,96,22,7,14
1896217,75,13,1938,3,"male",356,32,11,6,5,6,5,0,0
1896228,26,15,1987,7,"male",452,1,1,0,0,0,0,0,0
1896243,20,11,1993,11,"female",277,266,79,0,1,0,0,0,1
1896261,33,8,1980,2,"female",393,180,122,765,144,765,110,0,34
1896271,22,6,1991,8,"female",252,150,29,2,17,2,13,0,4
1896283,47,15,1966,4,"female",33,117,37,17,63,4,21,13,42
1896289,40,7,1973,10,"male",469,81,55,182,155,182,102,0,53
1896293,16,21,1997,3,"female",374,111,69,71,7,71,5,0,2
1896333,108,5,1905,6,"female",1896,510,225,85,160,25,79,60,81
1896354,41,5,1972,10,"male",416,0,0,0,0,0,0,0,0
1896359,90,2,1923,2,"male",1437,564,112,122,95,122,91,0,4
1896365,13,1,2000,1,"male",293,13,9,0,0,0,0,0,0
1896388,19,28,1994,12,"female",559,398,144,116,4,116,4,0,0
1896409,19,13,1994,11,"male",739,621,442,1,12,1,7,0,5
1896439,15,19,1998,11,"male",308,95,90,0,0,0,0,0,0
1896455,40,3,1973,1,"male",740,220,174,17,1,0,1,17,0
1896482,41,14,1972,8,"female",817,130,76,239,98,188,46,51,52
1896486,29,8,1984,12,"female",415,41,22,0,1,0,1,0,0
1896490,18,20,1995,6,"female",1127,1869,296,1013,786,533,336,480,450
1896549,29,15,1984,3,"male",415,444,337,6,5,6,0,0,5
1896556,30,10,1983,7,"female",417,211,166,640,113,622,53,18,60
1896559,94,11,1919,5,"female",934,228,98,17,28,17,25,0,3
1896574,68,19,1945,8,"female",1705,73,31,3,6,0,2,3,4
1896598,53,20,1960,6,"male",195,65,42,226,91,0,34,226,57
1896620,61,24,1952,6,"female",1093,165,75,767,132,0,35,767,97
1896634,108,22,1905,8,"female",1032,23,10,66,2,0,2,66,0
1896657,16,13,1997,6,"female",44,8,7,30,8,30,6,0,2
1896660,18,3,1995,11,"male",1251,164,93,35,53,35,43,0,10
1896669,20,27,1993,2,"male",293,252,104,0,0,0,0,0,0
1896672,23,1,1990,1,"male",355,26,15,0,0,0,0,0,0
1896698,46,4,1967,12,"male",622,58,26,0,1,0,1,0,0
1896735,49,8,1964,7,"male",815,21,7,1,0,0,0,1,0
1896749,39,21,1974,12,"male",97,16,10,2,6,2,5,0,1
1896796,53,20,1960,6,"male",278,42,18,20,1,20,1,0,0
1896802,26,30,1987,1,"female",1082,184,100,73,267,72,151,1,116
1896855,18,30,1995,9,"male",839,554,408,11,65,0,37,11,28
1896864,69,4,1944,11,"male",1039,135,54,32,112,3,71,29,41
1896869,47,6,1966,6,"male",82,83,81,172,38,172,35,0,3
1896937,28,5,1985,5,"female",337,175,85,1,381,1,292,0,89
1896939,22,17,1991,12,"male",572,164,150,30,0,30,0,0,0
1896959,55,22,1958,12,"female",411,22,15,19,13,0,8,19,5
1896980,103,11,1910,11,"female",1175,834,399,416,540,392,263,24,277
1896986,109,4,1904,5,"female",1723,55,5,3,0,3,0,0,0
1897012,42,17,1971,3,"male",228,64,34,76,80,75,54,1,26
1897013,27,28,1986,2,"male",339,624,484,5,5,5,5,0,0
1897057,26,30,1987,8,"male",1112,1080,726,357,372,73,212,284,160
1897092,18,5,1995,9,"female",301,504,372,176,174,176,162,0,12
1897099,17,1,1996,10,"male",208,9,3,4,0,0,0,4,0
1897142,22,19,1991,1,"male",434,22,17,0,0,0,0,0,0
1897148,65,20,1948,5,"male",1831,99,8,0,2,0,2,0,0
1897159,56,18,1957,6,"male",566,28,13,2,51,2,30,0,21
1897174,35,26,1978,7,"female",258,52,40,39,26,10,20,29,6
1897181,38,15,1975,1,"male",1380,59,24,0,0,0,0,0,0
1897194,22,6,1991,11,"female",725,116,71,0,0,0,0,0,0
1897214,20,2,1993,2,"male",687,480,405,132,34,132,28,0,6
1897246,18,2,1995,8,"female",1035,4566,646,1726,4258,19,1746,1707,2512
1897262,19,1,1994,9,"male",232,115,47,2,17,2,4,0,13
1897300,25,8,1988,8,"male",2,0,0,0,0,0,0,0,0
1897311,18,1,1995,5,"male",560,717,592,71,34,57,25,14,9
1897334,22,4,1991,6,"male",58,110,95,41,55,41,48,0,7
1897412,108,25,1905,9,"female",1092,194,116,28,44,3,18,25,26
1897414,106,12,1907,4,"female",1750,143,97,969,70,61,19,908,51
1897436,38,13,1975,2,"male",467,92,70,6,5,6,5,0,0
1897446,75,31,1938,8,"male",58,131,120,3,7,0,1,3,6
1897453,22,21,1991,8,"female",475,105,49,51,56,51,33,0,23
1897473,61,24,1952,6,"female",1324,75,22,1,11,1,7,0,4
1897508,17,20,1996,6,"male",478,525,469,0,1,0,0,0,1
1897536,23,9,1990,1,"male",229,39,28,1,24,1,22,0,2
1897542,103,29,1910,7,"male",1015,372,263,124,15,124,11,0,4
1897554,21,19,1992,4,"male",94,94,75,372,313,372,244,0,69
1897601,54,15,1959,6,"female",658,30,15,38,4,6,1,32,3
1897621,58,25,1955,2,"female",1449,151,101,192,153,192,75,0,78
1897623,34,5,1979,8,"male",1703,4,3,19,4,19,0,0,4
1897655,43,13,1970,4,"male",306,15,10,36,8,0,2,36,6
1897709,62,21,1951,7,"female",159,27,15,2,0,2,0,0,0
1897716,19,3,1994,6,"female",6,15,12,100,2,0,1,100,1
1897717,72,13,1941,11,"male",1518,32,5,0,0,0,0,0,0
1897755,62,30,1951,7,"female",416,66,33,47,18,5,5,42,13
1897784,16,27,1997,5,"female",492,1736,975,80,36,67,13,13,23
1897840,19,2,1994,4,"male",650,157,79,0,5,0,0,0,5
1897848,18,24,1995,5,"male",315,123,85,9,2,0,2,9,0
1897885,18,13,1995,3,"male",658,497,371,1,1,0,1,1,0
1897943,18,22,1995,1,"male",244,68,35,0,0,0,0,0,0
1897956,79,1,1934,2,"male",1934,467,238,81,89,32,72,49,17
1897966,17,25,1996,4,"male",915,242,137,19,0,19,0,0,0
1897976,15,24,1998,7,"female",503,670,429,871,218,0,112,871,106
1897980,28,22,1985,7,"female",1493,463,207,12,109,8,95,4,14
1897995,17,18,1996,7,"female",32,66,42,647,39,130,12,517,27
1898021,63,18,1950,10,"female",750,12,5,0,0,0,0,0,0
1898033,103,7,1910,2,"female",921,412,98,2,1,0,0,2,1
1898041,27,1,1986,1,"male",391,210,130,626,337,626,320,0,17
1898066,103,13,1910,11,"female",920,55,38,991,929,0,95,991,834
1898083,25,11,1988,6,"male",16,3,3,0,0,0,0,0,0
1898118,16,13,1997,10,"female",999,155,113,116,241,34,36,82,205
1898128,14,8,1999,3,"female",368,275,114,5,1,5,1,0,0
1898166,15,24,1998,3,"male",60,188,163,0,11,0,11,0,0
1898171,27,2,1986,8,"male",93,77,59,14,9,14,8,0,1
1898199,21,12,1992,4,"male",669,915,820,69,14,0,4,69,10
1898239,24,3,1989,9,"female",179,6,3,1,0,0,0,1,0
1898264,30,15,1983,9,"male",615,175,42,30,13,30,10,0,3
1898274,108,1,1905,6,NA,2265,36,17,75,122,53,42,22,80
1898295,41,6,1972,1,"female",41,0,0,0,0,0,0,0,0
1898305,51,15,1962,3,"female",537,109,39,153,171,5,48,148,123
1898320,21,14,1992,1,"male",1538,320,67,1,4,1,3,0,1
1898342,67,7,1946,4,"female",863,97,36,433,103,430,51,3,52
1898363,37,30,1976,4,"female",726,165,53,3,27,3,7,0,20
1898364,17,7,1996,10,"male",177,252,149,19,12,1,4,18,8
1898371,17,8,1996,3,"male",324,20,18,4,1,0,0,4,1
1898372,67,11,1946,10,"female",337,38,33,626,19,626,16,0,3
1898383,24,1,1989,1,"male",310,26,24,0,0,0,0,0,0
1898397,25,20,1988,7,"male",239,12,4,0,0,0,0,0,0
1898421,19,1,1994,1,"male",116,98,90,0,28,0,26,0,2
1898480,25,30,1988,11,"male",434,62,5,6,0,6,0,0,0
1898539,27,31,1986,12,"male",676,158,83,0,0,0,0,0,0
1898544,32,31,1981,1,"male",196,63,57,48,5,48,5,0,0
1898552,25,17,1988,2,"male",55,16,14,1,1,1,1,0,0
1898571,23,29,1990,6,"male",318,51,19,0,42,0,16,0,26
1898593,22,22,1991,9,"female",240,67,42,18,4,18,4,0,0
1898614,16,15,1997,9,"male",739,109,66,52,14,35,5,17,9
1898617,36,9,1977,6,"female",246,22,6,44,32,44,29,0,3
1898623,19,1,1994,1,"male",603,637,519,35,48,35,31,0,17
1898627,15,20,1998,11,"male",85,17,14,0,0,0,0,0,0
1898671,64,2,1949,4,"male",1295,176,97,159,221,2,104,157,117
1898676,108,1,1905,1,"male",1848,329,118,0,1,0,1,0,0
1898687,74,21,1939,8,NA,2213,18,6,1,5,0,1,1,4
1898707,31,24,1982,7,"male",635,22,17,1,0,1,0,0,0
1898752,30,30,1983,6,"male",461,51,16,12,0,0,0,12,0
1898754,17,6,1996,6,"female",363,307,63,5,18,5,11,0,7
1898783,43,18,1970,11,"male",281,91,46,10,9,10,4,0,5
1898814,68,27,1945,11,"male",663,74,40,6,0,6,0,0,0
1898817,18,28,1995,3,"male",77,57,43,6,2,6,2,0,0
1898819,25,23,1988,11,"male",540,708,623,676,956,615,311,61,645
1898846,17,23,1996,8,"male",375,14,5,0,0,0,0,0,0
1898865,31,16,1982,10,"female",420,1,0,6,0,6,0,0,0
1898867,48,29,1965,5,"male",286,1,1,0,0,0,0,0,0
1898870,53,8,1960,10,"female",1813,268,126,71,93,71,60,0,33
1898875,63,19,1950,7,"female",203,50,28,95,1,0,0,95,1
1898921,54,8,1959,1,"male",1192,25,15,1,12,0,0,1,12
1898933,54,4,1959,5,"male",449,130,109,110,63,11,31,99,32
1898994,39,12,1974,2,"female",605,87,61,46,40,46,10,0,30
1899004,65,7,1948,12,"male",1167,106,61,0,0,0,0,0,0
1899023,48,27,1965,1,"male",88,120,57,30,102,29,67,1,35
1899032,21,20,1992,1,"female",128,149,33,1,6,1,4,0,2
1899099,19,24,1994,8,"female",298,1071,637,24,102,24,97,0,5
1899100,53,12,1960,12,"female",738,53,46,0,1,0,0,0,1
1899128,47,18,1966,11,"female",642,47,32,12,29,12,13,0,16
1899160,21,1,1992,1,"male",12,0,0,0,0,0,0,0,0
1899161,56,10,1957,9,"male",127,9,5,6,7,4,6,2,1
1899162,29,6,1984,10,"male",437,21,16,4,42,4,20,0,22
1899185,19,18,1994,5,"male",561,122,46,0,0,0,0,0,0
1899205,36,31,1977,1,"male",160,32,13,0,0,0,0,0,0
1899211,53,25,1960,1,"female",800,11,5,0,0,0,0,0,0
1899218,44,4,1969,6,"female",1385,2066,41,2951,14625,2951,7869,0,6756
1899222,17,14,1996,9,"male",956,250,99,1,0,0,0,1,0
1899239,31,16,1982,10,"male",553,35,29,44,6,44,6,0,0
1899342,54,29,1959,3,"male",734,83,40,105,36,105,35,0,1
1899345,29,31,1984,8,"female",280,2,0,1,0,1,0,0,0
1899363,42,22,1971,3,"female",800,89,75,2,1,2,1,0,0
1899377,33,1,1980,12,"male",282,13,12,5,0,5,0,0,0
1899379,45,29,1968,5,"male",960,85,36,0,0,0,0,0,0
1899384,21,10,1992,8,"male",856,110,42,10,45,5,4,5,41
1899398,18,10,1995,1,"male",985,87,20,1,4,0,0,1,4
1899400,61,8,1952,7,"female",801,17,7,294,908,0,113,294,795
1899459,14,12,1999,9,"male",351,27,9,4,12,0,4,4,8
1899462,57,11,1956,4,"male",473,37,16,87,22,84,22,3,0
1899472,101,30,1912,1,"male",1034,361,260,2,1,0,0,2,1
1899473,81,14,1932,4,"female",1817,61,24,3,7,0,2,3,5
1899500,30,2,1983,1,"male",159,11,8,0,0,0,0,0,0
1899501,71,3,1942,9,"male",1720,176,71,182,16,68,8,114,8
1899508,24,19,1989,12,"female",685,643,241,5,28,5,14,0,14
1899514,43,2,1970,2,"female",234,7,6,1,3,1,3,0,0
1899516,20,27,1993,2,"male",329,467,350,190,249,190,239,0,10
1899521,55,30,1958,10,"male",542,84,44,442,47,429,41,13,6
1899526,40,13,1973,6,"female",304,7,2,3,0,3,0,0,0
1899534,38,30,1975,9,"female",114,30,5,13,21,13,16,0,5
1899542,16,3,1997,11,"male",311,118,52,5,3,5,3,0,0
1899543,108,13,1905,4,"male",1993,707,335,14,1,14,1,0,0
1899558,88,24,1925,9,"male",287,179,133,333,96,0,21,333,75
1899569,30,28,1983,11,"female",866,206,151,5,0,5,0,0,0
1899596,21,4,1992,4,"female",296,301,102,692,647,691,376,1,271
1899628,19,17,1994,6,"male",570,455,310,29,20,29,12,0,8
1899638,48,16,1965,5,"male",106,44,40,0,1,0,1,0,0
1899640,16,2,1997,2,"female",82,685,563,870,155,870,117,0,38
1899667,44,29,1969,9,"female",84,35,26,0,0,0,0,0,0
1899694,30,29,1983,7,"male",277,21,14,18,2,18,0,0,2
1899699,18,14,1995,9,"male",315,51,37,978,13,978,12,0,1
1899722,63,25,1950,9,"female",212,8,8,0,0,0,0,0,0
1899758,24,10,1989,8,"male",538,90,44,1,6,1,5,0,1
1899777,55,13,1958,10,NA,2145,35,13,52,28,52,9,0,19
1899797,66,12,1947,4,"female",1114,61,27,116,115,0,22,116,93
1899807,21,12,1992,12,"male",615,330,305,31,0,31,0,0,0
1899824,22,10,1991,8,"female",424,483,177,1829,1372,1376,652,453,720
1899833,21,12,1992,1,"female",392,28,25,0,0,0,0,0,0
1899845,23,22,1990,6,"female",623,288,165,58,126,35,94,23,32
1899870,25,3,1988,2,"male",63,112,102,50,27,42,19,8,8
1899879,16,3,1997,11,"female",130,75,22,1202,199,1202,171,0,28
1899882,18,2,1995,1,"male",341,305,195,3,4,3,3,0,1
1899896,15,8,1998,7,"female",20,0,0,0,0,0,0,0,0
1899915,26,1,1987,1,"male",267,33,29,15,3,15,3,0,0
1899919,67,8,1946,6,"female",1463,70,41,65,134,0,30,65,104
1899942,18,2,1995,7,"female",482,159,115,27,5,0,5,27,0
1899962,54,18,1959,8,"male",342,29,23,1,0,1,0,0,0
1899966,33,20,1980,2,"female",402,28,16,58,21,57,20,1,1
1899978,27,26,1986,1,"male",666,190,186,0,0,0,0,0,0
1899992,50,1,1963,8,"female",150,28,28,125,0,125,0,0,0
1900018,19,22,1994,11,"male",227,154,67,4,8,1,4,3,4
1900023,55,12,1958,3,"female",332,93,41,25,11,25,10,0,1
1900025,69,5,1944,9,"female",84,13,9,0,0,0,0,0,0
1900035,29,4,1984,10,"male",526,281,103,14,8,14,1,0,7
1900061,30,26,1983,9,"male",182,7,7,1,1,0,0,1,1
1900084,103,1,1910,1,"male",359,145,121,12,1,12,1,0,0
1900098,18,17,1995,1,"male",222,137,94,3,20,3,12,0,8
1900106,20,2,1993,10,"male",25,6,6,2,0,0,0,2,0
1900113,14,3,1999,5,"male",126,153,87,22,7,11,5,11,2
1900122,55,24,1958,8,"male",119,32,19,149,92,149,64,0,28
1900146,22,18,1991,10,"male",171,57,34,0,0,0,0,0,0
1900164,22,13,1991,4,"male",712,79,23,0,0,0,0,0,0
1900166,59,4,1954,11,"male",1737,18,13,2,2,0,1,2,1
1900199,25,21,1988,2,"female",695,710,587,718,598,416,409,302,189
1900208,28,1,1985,3,"male",387,1,0,13,17,13,10,0,7
1900233,52,9,1961,11,"female",1504,231,160,404,139,170,120,234,19
1900234,25,10,1988,1,"female",47,221,81,2465,1072,2465,916,0,156
1900247,33,17,1980,7,"female",567,173,107,8,9,8,9,0,0
1900265,14,22,1999,5,"male",179,218,97,22,10,22,6,0,4
1900289,16,14,1997,5,"male",44,24,19,0,1,0,1,0,0
1900310,40,17,1973,3,"male",246,2,0,14,0,0,0,14,0
1900318,49,10,1964,1,"male",497,115,21,38,17,0,2,38,15
1900338,26,22,1987,1,"male",360,68,54,21,5,21,5,0,0
1900340,47,2,1966,8,"male",465,103,75,4,22,2,6,2,16
1900350,46,5,1967,10,"male",65,50,46,175,49,174,31,1,18
1900363,56,23,1957,6,"female",2131,299,64,149,103,149,71,0,32
1900364,35,5,1978,3,"male",15,0,0,0,0,0,0,0,0
1900368,45,11,1968,9,"male",574,495,336,358,428,308,271,50,157
1900378,18,16,1995,2,"female",165,5,3,0,1,0,0,0,1
1900393,62,26,1951,9,"male",1282,283,188,4,11,0,7,4,4
1900411,26,19,1987,1,"female",302,125,80,33,34,33,27,0,7
1900471,20,7,1993,1,"male",909,89,56,11,1,11,1,0,0
1900481,108,21,1905,8,"male",923,266,145,5,14,5,3,0,11
1900494,18,9,1995,11,"female",83,2,2,0,0,0,0,0,0
1900500,28,13,1985,5,"female",292,330,119,2144,2122,1360,1793,784,329
1900510,61,30,1952,6,"female",375,333,205,503,279,0,24,503,255
1900519,53,13,1960,3,"female",1725,144,81,838,691,108,95,730,596
1900524,38,23,1975,12,"male",116,61,45,5,9,5,6,0,3
1900551,63,23,1950,12,"male",987,79,53,3,0,3,0,0,0
1900553,84,11,1929,6,"male",1642,600,159,176,123,176,116,0,7
1900582,22,16,1991,10,"male",525,110,55,0,3,0,2,0,1
1900591,20,21,1993,7,"female",586,192,112,15,21,15,20,0,1
1900630,23,10,1990,10,"male",488,342,303,10,8,10,0,0,8
1900632,23,30,1990,10,"male",564,67,61,17,3,17,3,0,0
1900636,22,22,1991,1,"female",131,96,39,19,21,19,16,0,5
1900658,49,12,1964,1,"female",569,93,33,13,20,0,13,13,7
1900680,44,9,1969,7,"male",164,89,45,26,193,26,131,0,62
1900692,18,20,1995,10,"male",151,13,13,1,5,1,3,0,2
1900707,23,21,1990,8,"female",351,66,29,66,72,66,71,0,1
1900770,26,1,1987,1,"female",345,33,21,15,2,15,2,0,0
1900781,54,25,1959,3,"male",1356,81,45,58,11,58,1,0,10
1900786,17,31,1996,5,"male",358,343,281,4,9,4,8,0,1
1900808,19,1,1994,1,"male",342,165,85,62,29,1,15,61,14
1900822,44,12,1969,10,"female",421,72,46,94,132,0,43,94,89
1900823,21,11,1992,10,"female",333,210,138,811,166,675,41,136,125
1900864,38,18,1975,2,"female",1220,278,155,612,435,564,275,48,160
1900865,24,7,1989,9,"female",418,1379,719,4633,2592,455,1420,4178,1172
1900872,28,19,1985,5,"female",482,24,18,0,0,0,0,0,0
1900888,17,24,1996,10,"male",972,438,239,232,221,222,134,10,87
1900895,17,1,1996,1,"male",145,212,165,257,122,255,85,2,37
1900900,34,3,1979,1,"female",244,11,6,197,183,197,140,0,43
1900906,25,1,1988,1,"male",35,3,3,0,0,0,0,0,0
1900929,35,20,1978,7,"female",771,296,147,1632,837,1631,570,1,267
1900961,26,29,1987,9,"male",436,341,230,1,10,1,7,0,3
1900968,21,27,1992,9,"male",265,35,34,3,0,3,0,0,0
1901017,19,15,1994,1,"male",151,18,13,1,0,1,0,0,0
1901027,33,12,1980,5,"male",364,22,14,7,26,7,13,0,13
1901036,108,8,1905,12,"female",1518,204,18,543,109,543,72,0,37
1901069,36,23,1977,4,"male",448,20,12,3,8,1,2,2,6
1901123,55,24,1958,10,"male",362,5,2,59,16,27,8,32,8
1901132,21,12,1992,10,"male",282,42,25,85,153,85,131,0,22
1901149,27,29,1986,7,"female",41,9,8,63,31,60,16,3,15
1901179,22,31,1991,12,"female",182,262,107,5,14,5,11,0,3
1901199,14,12,1999,3,"male",135,61,53,29,6,29,5,0,1
1901275,20,9,1993,8,"female",235,22,7,20,39,20,34,0,5
1901278,30,19,1983,8,"female",63,113,102,96,82,96,67,0,15
1901282,16,16,1997,7,"male",11,9,4,1,0,1,0,0,0
1901290,22,12,1991,7,"female",264,187,139,249,227,249,214,0,13
1901301,50,19,1963,4,"male",341,40,38,57,5,11,0,46,5
1901313,65,23,1948,11,"male",1592,83,57,0,0,0,0,0,0
1901335,49,29,1964,10,"female",77,178,87,293,719,293,203,0,516
1901349,33,30,1980,8,"male",91,122,59,17,13,17,10,0,3
1901364,61,22,1952,5,"male",1401,208,117,1833,1203,1606,736,227,467
1901400,14,11,1999,12,"female",64,22,16,0,0,0,0,0,0
1901437,39,1,1974,1,"male",210,59,49,0,0,0,0,0,0
1901453,26,1,1987,1,"female",244,33,12,23,29,23,11,0,18
1901459,50,4,1963,10,"male",1332,700,246,1147,607,1147,418,0,189
1901468,40,2,1973,7,"female",278,101,71,40,3,40,2,0,1
1901478,19,18,1994,3,"male",149,206,116,1,0,1,0,0,0
1901486,16,9,1997,4,"female",685,1966,390,110,13,110,13,0,0
1901488,23,7,1990,7,"male",448,55,41,2,1,2,1,0,0
1901489,26,9,1987,1,"male",372,39,33,0,2,0,2,0,0
1901520,37,30,1976,8,"female",143,27,17,30,6,30,6,0,0
1901548,20,1,1993,8,"female",363,993,453,203,636,203,610,0,26
1901557,49,9,1964,12,"male",718,22,12,9,3,0,0,9,3
1901559,37,23,1976,2,"female",306,78,64,156,105,150,71,6,34
1901622,18,20,1995,4,"female",448,1324,860,360,306,328,187,32,119
1901628,48,23,1965,3,"female",451,2,2,3,0,2,0,1,0
1901677,23,22,1990,7,"male",285,43,37,7,6,3,6,4,0
1901688,16,7,1997,7,"female",710,119,65,0,0,0,0,0,0
1901693,43,16,1970,9,"female",341,4,3,0,0,0,0,0,0
1901701,22,18,1991,7,"female",1506,1295,434,152,261,139,156,13,105
1901703,30,15,1983,3,"male",73,7,7,0,1,0,0,0,1
1901712,44,22,1969,10,"female",761,64,33,405,373,405,294,0,79
1901718,55,18,1958,6,"female",624,50,36,12,10,12,7,0,3
1901736,91,30,1922,8,"male",5,8,6,0,0,0,0,0,0
1901750,23,1,1990,3,"male",188,142,109,0,29,0,7,0,22
1901752,20,4,1993,4,"male",168,82,61,0,1,0,1,0,0
1901800,63,18,1950,11,"female",667,152,65,8,6,8,5,0,1
1901822,68,9,1945,2,"female",1490,85,45,117,49,14,25,103,24
1901832,43,14,1970,12,"female",1061,145,46,82,74,62,41,20,33
1901844,37,22,1976,10,"male",1758,188,83,9,19,9,13,0,6
1901855,37,7,1976,8,"female",530,25,15,53,20,0,7,53,13
1901871,28,1,1985,1,"female",1509,2,1,0,1,0,1,0,0
1901878,68,1,1945,1,"female",1820,55,12,37,27,37,15,0,12
1901908,105,17,1908,4,"male",2051,185,103,513,322,0,125,513,197
1901913,15,21,1998,12,"female",371,4826,97,815,4801,737,3843,78,958
1901929,36,19,1977,3,"female",966,434,284,7964,1156,4196,988,3768,168
1901930,71,14,1942,9,"female",614,7,2,2,2,0,1,2,1
1901936,42,31,1971,1,"male",343,43,24,6,1,6,1,0,0
1901951,22,2,1991,4,"male",502,760,670,141,68,0,31,141,37
1901959,20,22,1993,3,"male",291,47,34,0,0,0,0,0,0
1901965,24,5,1989,4,"male",212,253,179,120,144,93,96,27,48
1901968,33,1,1980,1,"male",36,6,6,190,43,110,18,80,25
1901976,21,14,1992,3,"male",628,718,404,15,16,15,1,0,15
1902001,19,10,1994,6,"male",413,22,14,0,0,0,0,0,0
1902018,19,24,1994,11,"male",176,59,56,1,0,1,0,0,0
1902054,14,9,1999,7,"male",222,217,154,18,1,18,0,0,1
1902074,24,9,1989,5,"male",417,222,102,40,70,8,15,32,55
1902083,32,1,1981,1,"male",658,63,44,11,76,0,10,11,66
1902086,33,12,1980,2,"male",248,51,24,2,0,2,0,0,0
1902104,17,13,1996,11,"female",405,19,16,0,0,0,0,0,0
1902116,62,6,1951,5,"female",1648,290,172,749,566,53,197,696,369
1902124,16,27,1997,12,"male",356,91,56,1,0,0,0,1,0
1902127,53,6,1960,5,"female",1169,111,80,25,43,25,14,0,29
1902134,35,10,1978,1,"male",461,169,48,52,127,52,113,0,14
1902141,30,18,1983,10,"male",1475,246,133,253,52,253,44,0,8
1902177,59,13,1954,3,"male",508,3,0,725,4,1,0,724,4
1902197,30,1,1983,1,"male",483,244,183,5,0,0,0,5,0
1902219,18,16,1995,1,"male",690,11,11,1,0,0,0,1,0
1902225,16,17,1997,7,"male",580,109,2,6,1,6,1,0,0
1902249,15,4,1998,12,"male",169,48,37,140,12,140,3,0,9
1902250,32,10,1981,3,"male",308,78,65,23,42,23,27,0,15
1902265,93,15,1920,10,"male",917,717,503,3,2,3,0,0,2
1902300,30,25,1983,7,"male",81,44,41,137,12,137,7,0,5
1902381,24,25,1989,1,"male",300,13,7,1,1,0,0,1,1
1902384,67,21,1946,1,"male",1185,20,9,0,0,0,0,0,0
1902387,20,11,1993,11,"male",1117,296,186,6,63,6,56,0,7
1902426,54,26,1959,2,"female",1010,76,18,3,3,2,1,1,2
1902449,21,1,1992,1,"female",134,0,0,0,0,0,0,0,0
1902466,48,11,1965,5,"female",332,28,26,5,3,4,3,1,0
1902471,46,28,1967,7,"male",1048,11,10,5,4,5,3,0,1
1902472,51,14,1962,10,"male",405,47,39,25,55,25,40,0,15
1902496,23,8,1990,4,"male",324,436,365,0,0,0,0,0,0
1902529,45,29,1968,9,"female",205,56,48,64,53,64,43,0,10
1902552,18,17,1995,5,"female",194,165,85,10,25,10,8,0,17
1902565,94,29,1919,4,"female",959,271,131,241,81,241,65,0,16
1902589,65,26,1948,10,"female",511,16,11,0,0,0,0,0,0
1902591,21,25,1992,7,"male",959,245,141,25,38,20,33,5,5
1902600,54,8,1959,1,"female",1846,170,86,252,66,249,63,3,3
1902606,64,2,1949,10,"male",1025,42,26,4,3,4,3,0,0
1902613,19,17,1994,1,"male",350,259,220,0,20,0,17,0,3
1902651,45,25,1968,9,"female",268,21,14,7,3,7,3,0,0
1902652,21,1,1992,1,"female",21,6,4,8,9,7,5,1,4
1902668,18,2,1995,2,"female",247,104,97,0,1,0,1,0,0
1902671,44,30,1969,5,"female",356,109,90,341,54,341,54,0,0
1902694,17,5,1996,7,"female",415,923,102,2138,312,2138,243,0,69
1902697,73,23,1940,5,"male",242,0,0,0,0,0,0,0,0
1902708,57,25,1956,2,"male",848,26,21,4,0,2,0,2,0
1902732,52,4,1961,1,NA,1806,43,29,152,52,127,35,25,17
1902781,56,8,1957,9,"female",357,66,45,680,194,680,155,0,39
1902809,19,1,1994,1,"male",245,70,63,5,3,5,3,0,0
1902810,15,25,1998,3,"female",406,169,166,0,3,0,3,0,0
1902817,20,30,1993,9,"male",22,2,2,0,0,0,0,0,0
1902839,25,1,1988,2,"male",16,0,0,0,0,0,0,0,0
1902864,35,5,1978,10,"male",767,2,0,0,0,0,0,0,0
1902868,22,14,1991,5,"female",173,6,4,0,0,0,0,0,0
1902880,17,9,1996,4,"male",232,146,90,234,124,234,111,0,13
1902895,68,6,1945,5,"female",829,121,13,557,640,524,536,33,104
1902898,41,14,1972,8,"male",49,24,19,16,6,16,5,0,1
1903006,23,23,1990,6,"male",182,7,2,0,0,0,0,0,0
1903017,30,24,1983,11,"male",157,5,0,0,0,0,0,0,0
1903027,59,1,1954,12,"female",220,112,95,18,6,18,6,0,0
1903035,43,16,1970,5,"male",302,89,19,2,1,2,0,0,1
1903053,58,20,1955,5,"male",287,35,29,16,4,0,1,16,3
1903066,23,25,1990,9,"male",517,18,13,0,0,0,0,0,0
1903073,21,31,1992,12,"male",11,0,0,0,0,0,0,0,0
1903104,39,11,1974,7,"male",623,39,15,9,7,1,7,8,0
1903130,90,2,1923,11,"female",1943,281,149,0,2,0,2,0,0
1903137,38,17,1975,4,"male",241,104,53,28,3,20,2,8,1
1903142,20,29,1993,6,"female",687,55,16,139,78,139,76,0,2
1903144,46,17,1967,12,"male",79,5,4,3,0,3,0,0,0
1903145,27,30,1986,3,"male",340,45,33,0,1,0,1,0,0
1903146,23,9,1990,11,"female",1018,1985,251,269,1608,48,1239,221,369
1903151,26,8,1987,4,"female",313,171,70,0,7,0,6,0,1
1903162,22,29,1991,7,"male",419,395,350,55,86,44,36,11,50
1903174,29,4,1984,1,"male",195,39,32,2,3,2,0,0,3
1903180,15,9,1998,12,"male",52,32,27,0,1,0,1,0,0
1903193,63,20,1950,12,"female",915,148,73,8,32,8,10,0,22
1903195,16,1,1997,4,"male",77,150,144,374,105,0,21,374,84
1903208,13,15,2000,1,"female",123,89,48,40,1,0,0,40,1
1903213,42,18,1971,12,"male",96,22,17,92,60,92,24,0,36
1903214,42,13,1971,9,"male",1568,58,17,0,2,0,2,0,0
1903238,21,1,1992,4,"male",126,6,6,9,0,0,0,9,0
1903243,40,19,1973,7,"female",1265,297,143,1713,3167,1369,839,344,2328
1903261,18,13,1995,4,"female",272,508,154,0,4,0,2,0,2
1903274,51,29,1962,12,"male",621,52,27,2,1,0,0,2,1
1903278,17,13,1996,5,"male",1,1,1,15,6,15,0,0,6
1903290,55,7,1958,3,"female",312,13,11,9,2,2,1,7,1
1903302,108,24,1905,2,"male",1671,499,258,47,7,28,3,19,4
1903355,17,9,1996,9,"female",604,360,311,326,350,86,170,240,180
1903378,77,17,1936,9,"male",19,34,27,32,1,20,0,12,1
1903388,65,17,1948,2,"female",1145,152,112,57,15,57,12,0,3
1903410,24,21,1989,12,"female",11,3,1,0,0,0,0,0,0
1903415,50,29,1963,1,"male",1220,150,64,1,0,0,0,1,0
1903416,41,20,1972,2,"male",258,0,0,0,0,0,0,0,0
1903439,28,3,1985,10,"male",238,245,133,46,23,3,22,43,1
1903440,21,3,1992,8,"male",575,255,178,9,4,9,2,0,2
1903465,15,18,1998,11,"female",572,479,291,514,346,163,147,351,199
1903484,34,4,1979,10,"female",211,18,8,31,10,31,5,0,5
1903487,28,27,1985,9,"male",512,57,51,0,0,0,0,0,0
1903493,47,15,1966,11,"male",1280,76,54,0,4,0,4,0,0
1903494,19,22,1994,9,"male",545,56,35,9,7,0,0,9,7
1903503,62,9,1951,2,"male",657,47,15,49,27,0,15,49,12
1903510,33,21,1980,5,"male",142,70,62,198,25,198,10,0,15
1903527,26,14,1987,4,"female",674,50,24,59,81,59,50,0,31
1903528,57,13,1956,5,"male",347,0,0,0,0,0,0,0,0
1903536,54,17,1959,5,"female",167,93,49,55,7,0,1,55,6
1903540,21,16,1992,8,"female",171,563,134,0,0,0,0,0,0
1903547,28,4,1985,3,"male",617,274,78,19,1,19,0,0,1
1903556,23,7,1990,7,"male",1072,51,39,6,2,6,2,0,0
1903566,59,18,1954,1,"female",603,131,21,660,470,660,273,0,197
1903585,35,17,1978,6,"male",273,152,102,2,1,0,0,2,1
1903650,51,28,1962,5,"male",1236,9,5,0,0,0,0,0,0
1903669,113,30,1900,3,"female",2243,425,268,154,84,154,35,0,49
1903687,32,5,1981,12,"female",613,180,116,58,33,56,27,2,6
1903689,28,3,1985,9,"male",497,255,201,42,37,23,25,19,12
1903744,69,23,1944,5,"male",1542,224,97,57,51,55,20,2,31
1903753,23,6,1990,1,"female",363,34,10,43,18,43,14,0,4
1903782,18,10,1995,1,"female",159,77,14,57,17,57,13,0,4
1903784,24,15,1989,12,"female",888,107,82,397,229,196,127,201,102
1903787,50,3,1963,12,"male",631,94,36,129,74,0,2,129,72
1903796,19,18,1994,8,"male",164,178,158,1,0,1,0,0,0
1903822,108,16,1905,5,"male",1892,306,146,398,74,398,40,0,34
1903828,44,24,1969,8,"female",418,108,49,4,3,1,1,3,2
1903856,59,8,1954,6,"female",383,82,25,54,39,0,2,54,37
1903866,21,4,1992,4,"female",112,130,122,3,8,3,4,0,4
1903881,36,20,1977,10,"female",13,0,0,0,0,0,0,0,0
1903905,49,5,1964,3,"female",214,10,6,15,0,15,0,0,0
1903906,21,1,1992,1,"male",529,261,137,50,192,50,159,0,33
1903908,26,8,1987,7,"male",625,77,43,34,5,34,5,0,0
1903938,33,1,1980,1,"female",321,30,11,829,117,0,1,829,116
1903957,19,16,1994,3,"female",633,519,224,31,87,31,78,0,9
1903964,22,8,1991,2,"female",1713,2157,1065,2,19,2,16,0,3
1904036,33,1,1980,4,"female",135,51,37,37,23,37,15,0,8
1904049,21,17,1992,7,"male",156,23,20,0,0,0,0,0,0
1904079,52,28,1961,10,"male",201,111,57,23,62,23,53,0,9
1904098,74,16,1939,6,"male",1794,23,16,0,0,0,0,0,0
1904136,62,6,1951,6,"male",672,99,41,7,33,7,23,0,10
1904155,42,19,1971,3,"female",286,9,8,91,46,0,3,91,43
1904174,37,11,1976,8,"male",813,52,35,0,0,0,0,0,0
1904195,25,5,1988,6,"female",601,129,93,223,135,223,78,0,57
1904196,19,26,1994,2,"male",359,199,183,7,4,7,3,0,1
1904230,18,4,1995,4,"male",83,106,98,98,7,0,0,98,7
1904241,55,15,1958,7,"female",211,14,9,0,0,0,0,0,0
1904243,32,20,1981,3,"female",161,14,3,0,0,0,0,0,0
1904265,98,2,1915,5,"male",1680,177,82,1,2,0,1,1,1
1904279,44,16,1969,9,"male",509,42,8,3,0,1,0,2,0
1904287,35,8,1978,11,"male",1368,21,7,2,0,2,0,0,0
1904290,60,21,1953,1,"female",236,17,10,43,0,43,0,0,0
1904293,24,1,1989,4,"female",533,64,61,0,0,0,0,0,0
1904344,17,4,1996,7,"male",586,12,9,7,0,3,0,4,0
1904348,16,25,1997,6,"female",408,321,188,1,1,1,0,0,1
1904356,53,9,1960,3,"male",1506,32,11,4,2,3,2,1,0
1904371,21,15,1992,3,"female",1149,162,89,11,44,11,24,0,20
1904378,19,7,1994,7,"male",178,318,267,196,116,196,108,0,8
1904380,49,11,1964,3,"female",871,129,46,640,497,639,182,1,315
1904414,18,20,1995,4,"male",271,155,108,59,1,12,1,47,0
1904430,29,17,1984,1,"male",594,159,122,140,52,82,16,58,36
1904469,26,20,1987,4,"female",446,8,4,1,0,1,0,0,0
1904473,21,14,1992,4,"male",23,33,24,12,16,12,16,0,0
1904515,23,15,1990,2,"male",1020,79,60,1,0,1,0,0,0
1904536,27,17,1986,10,"male",292,72,39,385,55,385,39,0,16
1904559,108,15,1905,8,"male",423,762,717,4,0,4,0,0,0
1904578,78,22,1935,1,"male",1922,16,1,0,0,0,0,0,0
1904603,43,10,1970,3,"male",315,1,1,0,0,0,0,0,0
1904613,59,4,1954,12,"female",265,10,3,0,0,0,0,0,0
1904616,16,2,1997,11,"male",144,26,16,0,0,0,0,0,0
1904622,20,29,1993,12,"female",676,1224,703,258,137,256,108,2,29
1904623,60,16,1953,10,"male",745,60,52,3,9,3,7,0,2
1904625,55,28,1958,7,"female",223,56,22,46,34,0,13,46,21
1904660,38,27,1975,2,"male",595,16,12,0,0,0,0,0,0
1904672,103,26,1910,12,"male",1277,258,97,11,5,11,5,0,0
1904682,41,13,1972,3,"male",362,0,0,0,0,0,0,0,0
1904701,65,21,1948,12,"female",800,53,22,0,0,0,0,0,0
1904726,42,20,1971,11,"male",529,24,15,143,6,143,6,0,0
1904763,24,3,1989,12,"male",192,297,216,19,2,0,2,19,0
1904790,26,18,1987,11,"male",589,6,6,239,36,239,25,0,11
1904806,18,25,1995,5,"female",244,1432,382,286,854,281,578,5,276
1904812,24,24,1989,9,"female",175,34,20,18,22,18,12,0,10
1904814,16,5,1997,4,"male",832,14,8,0,0,0,0,0,0
1904817,61,21,1952,12,"male",410,113,79,9,35,9,30,0,5
1904826,31,3,1982,2,"male",743,126,64,31,0,31,0,0,0
1904836,26,16,1987,2,"female",147,19,11,63,60,0,23,63,37
1904846,22,11,1991,8,"female",455,38,20,0,0,0,0,0,0
1904864,71,18,1942,3,"male",657,38,7,3,2,3,2,0,0
1904883,38,20,1975,3,"female",1758,72,40,401,63,152,23,249,40
1904886,29,27,1984,1,"male",20,2,2,4,0,1,0,3,0
1904893,34,20,1979,4,"male",377,55,34,36,142,23,58,13,84
1904901,50,1,1963,3,"male",692,24,24,0,0,0,0,0,0
1904908,24,9,1989,9,"male",65,323,320,0,0,0,0,0,0
1904978,21,2,1992,2,"male",400,98,91,295,4,295,0,0,4
1904988,21,22,1992,1,"female",562,354,141,129,93,129,45,0,48
1904996,50,9,1963,12,"female",592,59,36,16,4,0,1,16,3
1905014,24,7,1989,9,"male",408,64,51,0,1,0,1,0,0
1905026,32,2,1981,5,"male",932,431,223,6,8,0,4,6,4
1905034,55,29,1958,6,"female",190,157,135,786,665,162,117,624,548
1905038,21,20,1992,1,"male",322,93,54,29,15,27,5,2,10
1905063,33,20,1980,4,"male",241,40,21,168,36,166,13,2,23
1905080,18,1,1995,11,"male",3,1,1,0,46,0,8,0,38
1905084,22,17,1991,10,"female",20,0,0,0,0,0,0,0,0
1905098,22,31,1991,1,"male",103,40,36,1,6,1,5,0,1
1905104,30,20,1983,11,"female",503,62,43,46,0,46,0,0,0
1905121,28,25,1985,4,"male",558,1,1,0,0,0,0,0,0
1905129,48,26,1965,12,"female",1241,279,171,965,1513,94,199,871,1314
1905132,51,5,1962,7,"female",593,65,46,5,0,0,0,5,0
1905140,47,8,1966,2,"male",1292,15,6,1,1,0,0,1,1
1905143,31,8,1982,8,"female",1719,262,250,6,54,0,24,6,30
1905149,20,13,1993,10,"male",37,29,23,0,7,0,0,0,7
1905162,15,15,1998,7,"female",438,119,109,130,1,130,0,0,1
1905170,19,14,1994,12,"female",295,14,13,12,19,12,19,0,0
1905172,25,13,1988,6,"female",749,14,11,0,0,0,0,0,0
1905206,54,28,1959,2,"female",52,2,2,0,0,0,0,0,0
1905240,17,2,1996,4,"male",296,22,15,4,3,4,3,0,0
1905258,20,6,1993,1,"male",93,42,29,64,22,47,13,17,9
1905297,21,1,1992,8,"male",715,9,6,0,2,0,2,0,0
1905326,23,20,1990,12,"male",1518,377,143,1,7,1,5,0,2
1905334,24,8,1989,1,"male",277,13,7,1,0,1,0,0,0
1905377,30,6,1983,4,"male",76,53,45,403,344,403,344,0,0
1905394,49,5,1964,6,"male",1031,52,28,24,40,24,6,0,34
1905407,58,17,1955,11,"female",1489,30,3,106,52,106,25,0,27
1905426,22,21,1991,4,"female",302,101,62,39,37,39,21,0,16
1905432,63,7,1950,4,"female",879,85,24,32,4,0,2,32,2
1905434,57,22,1956,12,"male",421,46,36,0,1,0,1,0,0
1905437,17,25,1996,11,"male",475,1673,1458,554,376,554,267,0,109
1905469,19,10,1994,2,"male",612,1169,981,93,176,93,136,0,40
1905510,97,11,1916,8,"male",1617,275,217,0,0,0,0,0,0
1905516,27,11,1986,10,"female",574,196,104,198,115,198,71,0,44
1905523,52,24,1961,6,"male",402,5,3,1,2,0,1,1,1
1905542,54,27,1959,6,"male",1754,58,28,2,1,0,0,2,1
1905569,18,8,1995,8,"female",312,303,94,23,58,23,5,0,53
1905575,15,20,1998,1,"male",302,76,39,7,6,7,4,0,2
1905582,49,3,1964,1,"male",435,50,35,1,1,1,1,0,0
1905622,41,11,1972,2,"female",299,249,65,228,101,224,47,4,54
1905639,17,4,1996,4,"female",331,964,625,1596,2534,642,1440,954,1094
1905647,18,6,1995,1,"female",522,785,299,173,427,173,407,0,20
1905678,61,20,1952,11,"female",1483,77,29,71,14,63,10,8,4
1905701,63,30,1950,5,"female",791,117,69,83,51,37,15,46,36
1905757,17,25,1996,5,"male",610,67,47,0,2,0,0,0,2
1905761,51,10,1962,1,"female",1718,266,218,206,167,0,69,206,98
1905773,54,27,1959,3,"male",48,19,17,0,0,0,0,0,0
1905782,20,4,1993,3,"male",373,337,224,562,612,376,194,186,418
1905785,37,6,1976,8,"male",741,33,15,42,17,37,11,5,6
1905790,26,26,1987,12,"male",229,7,5,0,0,0,0,0,0
1905841,48,9,1965,12,"female",255,36,23,80,186,80,50,0,136
1905843,33,19,1980,10,"male",364,273,194,141,557,141,319,0,238
1905862,14,16,1999,4,"female",494,651,400,1652,361,1566,244,86,117
1905874,23,23,1990,11,"male",223,1,0,0,0,0,0,0,0
1905905,44,12,1969,10,"male",620,44,32,77,1,77,0,0,1
1905908,16,14,1997,4,"male",680,643,414,2,7,2,6,0,1
1905939,22,18,1991,3,"female",902,626,191,210,277,192,67,18,210
1905943,25,27,1988,2,"female",172,0,0,0,0,0,0,0,0
1905946,23,28,1990,12,"male",386,34,17,0,0,0,0,0,0
1905953,45,12,1968,2,"male",789,39,23,0,0,0,0,0,0
1905974,16,4,1997,4,"male",26,29,26,13,0,13,0,0,0
1905980,30,10,1983,10,"female",443,1731,1293,914,5102,216,2301,698,2801
1905989,30,13,1983,12,"male",481,40,17,32,66,20,21,12,45
1906003,61,6,1952,2,"female",1258,71,28,130,9,0,2,130,7
1906006,73,17,1940,12,"male",1555,60,14,74,19,74,5,0,14
1906022,33,2,1980,3,"male",302,11,8,4,1,4,1,0,0
1906085,26,21,1987,6,"male",185,5,5,0,0,0,0,0,0
1906108,29,6,1984,11,"female",87,285,278,58,104,34,91,24,13
1906113,14,31,1999,7,"male",297,74,62,0,0,0,0,0,0
1906122,27,31,1986,12,"male",471,82,72,1,0,1,0,0,0
1906124,23,12,1990,5,"male",401,10,6,9,3,0,3,9,0
1906150,23,7,1990,9,"male",193,310,274,134,129,0,105,134,24
1906153,28,10,1985,5,"male",1011,155,117,1,28,1,14,0,14
1906193,14,18,1999,8,"male",309,332,188,16,5,1,1,15,4
1906214,25,5,1988,3,"male",255,38,33,315,30,312,27,3,3
1906215,57,8,1956,8,"male",718,72,46,5,8,4,5,1,3
1906222,31,14,1982,2,"female",753,65,29,0,0,0,0,0,0
1906232,36,2,1977,2,"male",402,11,8,0,2,0,1,0,1
1906264,18,10,1995,1,"male",184,0,0,0,0,0,0,0,0
1906275,20,3,1993,9,"male",14,2,2,0,0,0,0,0,0
1906282,17,26,1996,2,"male",203,10,6,1,0,1,0,0,0
1906287,33,1,1980,1,"male",511,1,1,0,0,0,0,0,0
1906318,58,1,1955,12,"male",305,51,43,5,0,5,0,0,0
1906319,28,3,1985,6,"female",716,190,99,243,76,187,36,56,40
1906327,16,3,1997,3,"male",152,0,0,0,0,0,0,0,0
1906328,61,27,1952,10,"male",1256,7,3,1,0,0,0,1,0
1906342,25,31,1988,10,"male",407,929,739,4654,1862,3887,1381,767,481
1906354,17,2,1996,6,"female",621,1363,732,51,80,51,41,0,39
1906364,63,19,1950,7,"male",1638,80,46,50,66,49,30,1,36
1906414,24,16,1989,10,"female",209,66,40,49,24,49,22,0,2
1906421,54,19,1959,10,"male",753,112,54,99,59,0,4,99,55
1906431,31,31,1982,3,"male",95,1,1,77,24,49,5,28,19
1906474,50,15,1963,1,"female",21,18,16,434,265,434,253,0,12
1906495,13,16,2000,5,"female",4,0,0,0,0,0,0,0,0
1906501,19,26,1994,5,"male",404,156,87,44,0,44,0,0,0
1906546,20,7,1993,5,"female",259,464,179,1,0,1,0,0,0
1906552,27,26,1986,1,"male",556,196,150,11,22,11,16,0,6
1906556,53,3,1960,10,"female",418,339,324,4,6,4,2,0,4
1906562,20,31,1993,3,"male",374,215,165,20,0,0,0,20,0
1906566,19,3,1994,8,"female",795,488,109,89,145,64,88,25,57
1906581,17,1,1996,1,"female",391,274,29,2,2,2,2,0,0
1906582,41,7,1972,11,"male",244,109,72,3,7,3,7,0,0
1906583,29,11,1984,4,"male",227,46,11,68,1,68,1,0,0
1906594,25,16,1988,6,"male",256,21,19,4,3,4,3,0,0
1906603,33,4,1980,1,"male",390,68,46,97,8,97,7,0,1
1906627,41,14,1972,10,"male",58,36,32,1,0,1,0,0,0
1906638,28,5,1985,1,"male",591,891,771,63,123,52,83,11,40
1906641,19,28,1994,8,"female",268,108,74,166,84,166,75,0,9
1906654,15,22,1998,4,"female",1405,468,332,290,184,288,149,2,35
1906674,82,21,1931,3,"female",176,65,46,297,78,297,47,0,31
1906684,23,12,1990,3,"male",24,26,19,23,7,19,5,4,2
1906695,21,23,1992,10,"male",580,685,322,4,11,4,11,0,0
1906719,25,16,1988,8,"male",150,39,15,8,20,8,15,0,5
1906722,19,20,1994,3,"male",505,144,46,5,17,4,8,1,9
1906723,27,19,1986,1,"female",104,65,49,0,1,0,1,0,0
1906763,57,9,1956,1,"male",1400,7,3,0,1,0,1,0,0
1906766,35,18,1978,11,"female",78,101,96,2,2,2,2,0,0
1906767,18,1,1995,1,"female",408,15,7,0,0,0,0,0,0
1906789,28,13,1985,11,"male",701,6,4,0,0,0,0,0,0
1906830,43,13,1970,9,"female",493,74,25,90,139,83,33,7,106
1906848,23,14,1990,9,"female",770,345,261,208,102,22,66,186,36
1906894,29,16,1984,10,"male",385,97,43,0,1,0,1,0,0
1906897,58,28,1955,10,"female",931,241,202,240,49,240,40,0,9
1906906,29,14,1984,5,"female",202,35,23,67,35,56,12,11,23
1906911,37,23,1976,7,"male",823,70,37,0,0,0,0,0,0
1906932,25,14,1988,2,"male",615,266,48,17,23,17,23,0,0
1906958,61,14,1952,3,"female",855,602,306,10,12,10,11,0,1
1906973,26,25,1987,5,"male",196,401,394,0,10,0,1,0,9
1906998,17,12,1996,6,"female",459,552,407,2,2,2,2,0,0
1907003,18,15,1995,12,"female",472,418,80,292,388,292,359,0,29
1907026,17,26,1996,10,"male",415,194,71,0,1,0,1,0,0
1907070,19,20,1994,4,"male",497,757,506,15,187,0,133,15,54
1907081,29,27,1984,10,"male",611,95,68,2,2,0,0,2,2
1907091,20,13,1993,9,"male",303,88,51,349,16,303,7,46,9
1907105,70,15,1943,3,"male",1306,208,127,774,613,330,132,444,481
1907116,56,9,1957,9,"male",568,821,214,0,2,0,2,0,0
1907132,74,17,1939,12,"female",222,17,10,330,51,0,12,330,39
1907208,62,7,1951,6,"male",673,20,14,1,1,0,0,1,1
1907225,98,10,1915,4,"male",984,718,657,0,17,0,15,0,2
1907229,74,8,1939,8,"male",646,169,113,121,32,26,2,95,30
1907265,14,31,1999,5,"male",183,80,58,0,0,0,0,0,0
1907312,31,10,1982,6,"male",253,3,2,22,0,0,0,22,0
1907335,57,8,1956,3,"female",59,51,38,235,84,234,54,1,30
1907345,63,30,1950,12,"male",852,125,75,147,10,147,8,0,2
1907346,26,17,1987,3,"female",501,125,38,0,2,0,1,0,1
1907348,24,15,1989,8,"male",756,634,500,16,10,16,8,0,2
1907355,32,6,1981,7,"male",347,77,35,1,0,0,0,1,0
1907401,15,8,1998,3,"male",668,711,571,7,0,0,0,7,0
1907411,86,5,1927,5,"male",149,7,5,0,0,0,0,0,0
1907418,63,4,1950,7,"male",203,29,28,0,0,0,0,0,0
1907423,64,12,1949,7,"male",1052,101,42,54,62,21,32,33,30
1907437,19,26,1994,6,"male",386,111,40,2,0,2,0,0,0
1907472,20,27,1993,10,"female",1159,248,132,98,63,98,56,0,7
1907503,24,1,1989,9,"male",174,12,8,19,20,19,12,0,8
1907548,19,2,1994,12,"male",406,77,53,0,0,0,0,0,0
1907580,39,28,1974,8,"male",482,353,241,0,1,0,0,0,1
1907593,83,9,1930,10,"male",636,133,27,0,0,0,0,0,0
1907595,47,14,1966,2,"female",132,8,6,0,2,0,0,0,2
1907597,46,28,1967,5,"female",402,18,10,99,149,4,20,95,129
1907600,15,17,1998,4,"female",157,72,48,164,52,5,15,159,37
1907609,43,18,1970,11,"male",270,77,47,2,36,2,14,0,22
1907624,25,14,1988,3,"male",260,289,117,6,114,6,58,0,56
1907625,24,30,1989,8,"male",262,34,24,25,153,20,92,5,61
1907647,55,21,1958,6,"male",906,24,8,5,14,3,12,2,2
1907648,27,23,1986,4,"female",403,669,596,475,701,234,556,241,145
1907659,20,14,1993,5,"male",598,453,292,54,99,49,49,5,50
1907669,51,20,1962,8,"male",148,14,10,126,0,0,0,126,0
1907671,27,16,1986,3,"male",276,0,0,0,0,0,0,0,0
1907672,21,8,1992,3,"male",561,128,48,0,9,0,1,0,8
1907679,33,25,1980,6,"male",599,316,268,34,47,34,34,0,13
1907721,51,6,1962,6,"male",47,36,26,0,0,0,0,0,0
1907751,21,3,1992,1,"male",178,148,137,0,0,0,0,0,0
1907780,23,17,1990,5,"male",305,262,200,141,310,141,104,0,206
1907784,20,28,1993,4,"male",1247,21,18,1,0,0,0,1,0
1907873,18,10,1995,10,"female",706,295,45,105,347,105,65,0,282
1907879,32,29,1981,4,"male",480,29,16,1,66,0,18,1,48
1907884,43,13,1970,3,"male",66,44,33,14,2,14,0,0,2
1907892,19,9,1994,6,"male",367,1675,1301,1799,296,1799,289,0,7
1907916,58,25,1955,2,"female",1687,74,18,20,172,20,67,0,105
1907932,20,12,1993,9,"male",481,139,119,10,22,9,18,1,4
1907944,21,15,1992,10,"female",427,114,46,110,118,92,81,18,37
1907947,68,14,1945,3,"male",79,10,4,0,1,0,0,0,1
1907976,22,9,1991,2,"female",268,232,85,1410,1369,1395,1260,15,109
1907981,13,7,2000,3,"female",49,30,27,9,4,9,1,0,3
1908004,19,18,1994,3,"male",550,288,241,44,25,3,5,41,20
1908020,25,4,1988,11,"male",421,7,7,0,0,0,0,0,0
1908025,24,28,1989,4,"female",290,189,135,137,99,137,83,0,16
1908036,32,17,1981,5,"male",103,75,59,33,64,33,18,0,46
1908049,19,11,1994,5,"male",139,4,3,3,0,3,0,0,0
1908055,20,1,1993,1,"female",14,10,10,17,4,17,4,0,0
1908082,64,22,1949,1,"female",1585,162,62,871,363,871,315,0,48
1908090,29,18,1984,12,"male",516,128,87,0,0,0,0,0,0
1908091,21,1,1992,7,"male",75,18,16,0,0,0,0,0,0
1908110,39,10,1974,3,"male",1517,91,46,7,33,7,25,0,8
1908142,25,8,1988,8,"male",502,516,455,1831,144,1603,96,228,48
1908165,55,24,1958,11,"male",233,77,22,135,10,0,0,135,10
1908187,24,21,1989,6,"male",226,129,44,2,34,1,28,1,6
1908189,29,12,1984,2,"male",78,0,0,0,0,0,0,0,0
1908192,14,1,1999,1,"male",49,12,12,15,0,15,0,0,0
1908209,22,15,1991,1,"female",330,33,15,2047,686,1304,420,743,266
1908212,26,15,1987,10,"male",368,12,8,15,3,15,2,0,1
1908231,29,18,1984,5,"male",258,15,11,12,9,12,5,0,4
1908248,108,18,1905,5,"female",954,3982,1190,6016,4012,1180,2816,4836,1196
1908264,32,24,1981,3,"male",520,13,11,19,2,13,2,6,0
1908267,23,9,1990,7,"male",691,3,3,0,2,0,0,0,2
1908277,35,1,1978,9,"male",541,193,158,37,0,37,0,0,0
1908293,21,17,1992,2,"male",485,20,14,0,0,0,0,0,0
1908300,15,24,1998,8,"male",313,72,48,0,0,0,0,0,0
1908394,46,3,1967,7,"male",66,39,30,7,15,7,12,0,3
1908401,59,10,1954,10,"male",516,174,150,7,159,0,92,7,67
1908406,74,22,1939,4,"female",482,18,7,0,0,0,0,0,0
1908483,20,25,1993,3,"male",308,103,48,4,9,4,6,0,3
1908484,51,24,1962,2,"female",100,73,57,97,435,97,358,0,77
1908487,50,18,1963,2,"male",358,38,21,9,29,9,21,0,8
1908510,38,23,1975,3,"male",353,9,3,0,0,0,0,0,0
1908552,25,3,1988,12,"female",271,124,28,18,38,18,38,0,0
1908570,20,24,1993,9,"male",182,98,47,33,1,33,1,0,0
1908573,45,29,1968,8,"female",283,10,5,1,0,1,0,0,0
1908574,23,8,1990,12,"male",458,39,12,0,0,0,0,0,0
1908576,63,29,1950,7,"female",1366,41,15,3528,715,3484,286,44,429
1908675,21,12,1992,10,"female",625,67,47,100,649,82,359,18,290
1908714,16,1,1997,1,"male",146,27,24,9,0,0,0,9,0
1908730,23,14,1990,3,"male",397,0,0,0,0,0,0,0,0
1908768,15,14,1998,3,"female",628,347,200,7,24,3,5,4,19
1908779,23,1,1990,5,"female",420,32,21,31,10,31,10,0,0
1908861,35,2,1978,6,"female",193,25,19,114,84,114,45,0,39
1908915,15,22,1998,3,"male",237,34,24,0,1,0,0,0,1
1908919,58,17,1955,3,"female",1181,11,5,9,28,8,16,1,12
1908923,43,29,1970,7,"female",514,56,35,81,46,81,21,0,25
1908948,29,12,1984,3,"female",437,39,35,2,27,2,13,0,14
1908971,20,30,1993,4,"female",384,317,251,153,64,23,10,130,54
1908986,25,4,1988,3,"male",72,5,5,3,11,0,0,3,11
1909005,28,3,1985,7,"female",531,284,54,4642,6943,4642,6618,0,325
1909006,42,26,1971,11,"female",421,24,12,61,68,60,28,1,40
1909018,45,13,1968,6,"male",692,125,78,120,86,120,75,0,11
1909021,21,1,1992,1,"male",579,270,120,15,26,15,26,0,0
1909048,57,20,1956,10,"female",1412,271,194,2051,259,0,112,2051,147
1909074,108,8,1905,7,"male",469,41,14,1,0,1,0,0,0
1909084,37,11,1976,5,"female",367,91,50,39,57,39,20,0,37
1909091,83,11,1930,11,"male",864,490,201,102,887,102,708,0,179
1909133,30,24,1983,5,"female",906,56,15,1,17,1,12,0,5
1909134,57,20,1956,3,"female",1834,181,121,575,245,575,175,0,70
1909144,52,8,1961,12,"female",1724,416,287,310,678,307,469,3,209
1909178,34,2,1979,4,"male",493,1,1,0,1,0,1,0,0
1909193,21,10,1992,1,"male",226,170,121,56,103,52,100,4,3
1909208,93,24,1920,11,"male",456,121,49,4,2,0,1,4,1
1909210,68,11,1945,12,"female",930,705,255,13,101,13,55,0,46
1909252,42,4,1971,4,"female",325,83,57,117,50,97,34,20,16
1909264,16,5,1997,11,"female",368,840,578,0,28,0,25,0,3
1909274,20,19,1993,10,"female",477,266,182,197,244,180,146,17,98
1909283,51,17,1962,6,"male",2216,100,71,64,160,64,125,0,35
1909302,13,1,2000,1,"male",163,80,14,3,0,3,0,0,0
1909338,55,16,1958,11,"female",523,22,16,8,6,8,4,0,2
1909352,32,28,1981,5,"male",409,203,114,4,25,4,25,0,0
1909354,17,10,1996,11,"male",139,55,45,2,6,2,2,0,4
1909362,74,10,1939,1,"male",546,155,140,44,2,23,2,21,0
1909384,103,25,1910,6,"male",459,806,765,7,5,7,5,0,0
1909400,43,18,1970,12,"male",533,9,5,0,0,0,0,0,0
1909407,28,1,1985,1,"male",680,880,802,38,88,25,35,13,53
1909411,28,31,1985,8,"male",467,23,20,2,0,2,0,0,0
1909444,16,23,1997,1,"male",465,703,310,665,888,665,672,0,216
1909474,29,18,1984,5,"male",557,33,23,2,4,0,2,2,2
1909494,28,16,1985,5,"male",228,163,86,65,82,36,6,29,76
1909499,16,19,1997,2,"female",475,33,27,30,2,0,0,30,2
1909531,18,2,1995,1,"male",225,47,41,105,31,101,25,4,6
1909578,47,14,1966,6,"male",276,64,26,7,52,6,10,1,42
1909580,41,7,1972,11,"male",442,18,6,2,2,2,2,0,0
1909593,23,1,1990,1,"male",388,8,7,55,2,0,0,55,2
1909610,24,1,1989,7,"female",817,1,1,0,0,0,0,0,0
1909625,36,22,1977,8,"female",334,73,17,110,32,110,28,0,4
1909640,56,26,1957,4,"female",273,87,18,9,2,0,1,9,1
1909650,64,8,1949,7,"female",1601,42,20,473,146,0,35,473,111
1909661,23,10,1990,10,"female",383,416,150,0,0,0,0,0,0
1909684,18,9,1995,7,"female",483,3330,781,513,4187,513,3958,0,229
1909700,27,25,1986,6,"female",502,159,124,95,27,95,18,0,9
1909710,19,7,1994,7,"female",463,75,47,5242,1785,2527,922,2715,863
1909720,22,3,1991,2,"male",715,28,23,0,0,0,0,0,0
1909723,16,3,1997,8,"male",4,0,0,14,0,0,0,14,0
1909724,29,29,1984,2,"male",1221,78,56,1,0,0,0,1,0
1909730,52,11,1961,5,"male",613,91,51,19,0,19,0,0,0
1909742,41,24,1972,10,"female",1433,169,120,149,274,126,142,23,132
1909744,22,17,1991,9,"male",449,203,168,23,7,23,6,0,1
1909747,47,28,1966,9,"male",1359,175,71,1,3,0,2,1,1
1909749,33,9,1980,8,"female",622,171,131,80,71,41,31,39,40
1909795,48,4,1965,11,"male",263,43,36,6,4,1,0,5,4
1909850,15,1,1998,2,"male",296,41,2,1,1,1,0,0,1
1909853,15,17,1998,2,"male",496,266,173,50,43,47,34,3,9
1909855,56,11,1957,5,NA,1968,16,6,18,3,1,2,17,1
1909860,18,4,1995,5,"male",38,0,0,0,0,0,0,0,0
1909869,23,21,1990,6,"male",343,67,40,0,0,0,0,0,0
1909876,43,1,1970,2,"female",261,110,22,261,95,261,17,0,78
1909883,17,19,1996,8,"female",319,241,160,89,129,75,39,14,90
1909917,74,20,1939,5,"female",997,46,29,0,0,0,0,0,0
1909918,35,1,1978,1,"male",238,208,39,42,34,42,27,0,7
1909931,28,20,1985,1,"male",279,0,0,0,0,0,0,0,0
1909946,21,17,1992,6,"male",266,83,50,30,8,30,7,0,1
1909977,56,7,1957,3,"female",823,539,170,79,144,64,54,15,90
1909989,42,1,1971,1,"male",14,9,5,4,3,4,0,0,3
1909997,18,12,1995,12,"male",58,98,52,5,2,5,2,0,0
1909999,17,9,1996,8,"male",166,0,0,0,0,0,0,0,0
1910002,34,6,1979,3,"male",554,229,40,11,23,0,6,11,17
1910004,23,4,1990,4,"male",499,579,486,10,121,10,98,0,23
1910009,27,1,1986,1,"male",672,107,81,17,17,17,7,0,10
1910011,59,7,1954,7,"female",211,38,32,157,0,143,0,14,0
1910026,18,13,1995,10,"female",353,10,7,1,5,1,5,0,0
1910049,19,31,1994,8,"female",544,54,37,0,0,0,0,0,0
1910052,18,19,1995,5,"male",552,920,818,28,80,28,80,0,0
1910053,61,22,1952,5,"male",530,26,5,10,25,10,24,0,1
1910076,21,16,1992,3,"male",185,68,40,16,2,1,1,15,1
1910077,17,5,1996,12,"female",373,266,188,91,21,7,13,84,8
1910078,17,20,1996,11,"male",325,183,96,84,14,0,2,84,12
1910094,20,28,1993,12,"male",255,176,85,5,5,5,4,0,1
1910098,17,14,1996,8,"female",44,132,21,2,3,2,3,0,0
1910117,40,15,1973,12,"male",355,12,8,2,0,0,0,2,0
1910138,19,26,1994,11,"male",441,71,60,18,1,4,0,14,1
1910153,23,10,1990,9,"male",179,303,194,408,605,337,334,71,271
1910162,19,4,1994,10,"male",366,354,320,32,0,32,0,0,0
1910166,50,17,1963,6,"male",290,31,30,1,0,1,0,0,0
1910182,60,5,1953,3,"male",442,67,44,162,70,86,40,76,30
1910191,56,28,1957,10,"male",507,33,21,0,1,0,1,0,0
1910203,35,5,1978,5,"male",352,21,16,0,1,0,1,0,0
1910224,21,23,1992,3,"male",4,18,17,6,17,5,5,1,12
1910236,63,6,1950,8,"male",1648,93,43,117,38,98,25,19,13
1910249,26,28,1987,6,"male",1276,292,56,0,3,0,2,0,1
1910253,34,29,1979,4,"male",324,114,88,44,7,0,3,44,4
1910264,14,12,1999,6,"male",493,305,215,75,36,73,14,2,22
1910275,23,20,1990,5,"female",158,1074,561,1347,840,1194,491,153,349
1910291,59,19,1954,12,"male",609,42,30,61,8,0,0,61,8
1910301,18,8,1995,5,"male",1028,251,96,9,11,9,0,0,11
1910326,28,12,1985,12,"male",207,32,28,61,4,61,3,0,1
1910333,28,17,1985,2,"male",144,67,65,3,4,3,3,0,1
1910336,20,28,1993,7,"male",923,1008,562,27,192,27,147,0,45
1910337,34,7,1979,1,"male",564,110,75,41,0,0,0,41,0
1910340,26,29,1987,8,"female",209,358,330,49,120,49,108,0,12
1910354,23,9,1990,7,"male",397,627,489,4,22,0,11,4,11
1910398,20,16,1993,4,"male",156,49,11,81,35,81,30,0,5
1910400,103,27,1910,8,"female",1057,423,139,200,813,188,472,12,341
1910403,26,1,1987,1,"male",316,57,31,8,0,8,0,0,0
1910415,22,31,1991,5,"male",556,95,46,16,34,16,27,0,7
1910418,20,12,1993,1,"male",517,137,108,0,0,0,0,0,0
1910469,28,25,1985,5,"male",850,140,40,1,0,1,0,0,0
1910470,50,1,1963,1,"male",69,28,26,140,1,140,1,0,0
1910511,36,15,1977,9,"female",474,99,21,23,40,17,8,6,32
1910513,108,1,1905,1,"male",2218,249,77,30,93,13,39,17,54
1910555,32,1,1981,10,"female",114,6,2,5,1,5,0,0,1
1910575,50,30,1963,11,"male",87,6,6,0,0,0,0,0,0
1910579,49,1,1964,4,"male",574,18,12,40,0,40,0,0,0
1910586,25,15,1988,1,"male",31,5,1,0,1,0,0,0,1
1910599,40,14,1973,8,"male",736,33,18,0,1,0,0,0,1
1910610,24,14,1989,10,"male",194,24,6,1,0,1,0,0,0
1910616,23,3,1990,11,"male",340,129,96,1,1,1,1,0,0
1910619,60,17,1953,11,"male",1707,26,10,1,0,0,0,1,0
1910643,33,8,1980,8,"male",127,78,69,0,0,0,0,0,0
1910652,67,10,1946,3,"male",1400,40,10,2,1,0,1,2,0
1910664,72,8,1941,5,"male",1046,4,1,1,0,0,0,1,0
1910683,106,14,1907,4,"male",1007,19,8,7,6,7,3,0,3
1910702,47,1,1966,1,"female",1877,116,65,86,83,69,69,17,14
1910721,56,5,1957,1,"female",53,1,0,1,1,0,0,1,1
1910731,82,2,1931,2,"male",1579,225,174,2,6,0,0,2,6
1910749,28,8,1985,4,"female",894,279,183,439,146,439,62,0,84
1910806,16,19,1997,10,"male",207,945,619,2195,2249,1143,1003,1052,1246
1910811,59,22,1954,1,"male",665,1,0,0,0,0,0,0,0
1910822,71,29,1942,5,"female",831,36,24,0,0,0,0,0,0
1910862,38,2,1975,2,"male",59,11,11,1,1,1,1,0,0
1910866,34,17,1979,6,"female",312,304,228,988,1076,833,441,155,635
1910877,17,25,1996,8,"male",56,36,20,6,16,6,7,0,9
1910901,26,20,1987,7,"male",479,25,22,0,0,0,0,0,0
1910910,65,15,1948,11,"female",891,384,150,6,5,6,5,0,0
1910925,15,18,1998,7,"male",244,106,65,0,0,0,0,0,0
1910966,42,1,1971,5,"male",276,62,31,85,7,75,6,10,1
1910970,28,10,1985,1,"male",442,21,10,1,4,0,1,1,3
1910994,42,13,1971,10,"male",352,88,59,3,5,0,0,3,5
1910999,50,24,1963,9,"female",625,97,51,290,61,259,44,31,17
1911008,21,28,1992,6,"male",1077,201,153,1,3,1,3,0,0
1911052,15,14,1998,2,"female",458,217,49,238,322,238,262,0,60
1911053,42,29,1971,8,"female",76,33,23,59,22,59,6,0,16
1911093,18,17,1995,8,"female",72,82,44,2,9,2,7,0,2
1911160,17,28,1996,5,"male",91,325,289,27,112,27,93,0,19
1911164,57,26,1956,11,"female",810,110,78,297,161,1,75,296,86
1911167,18,17,1995,11,"male",132,112,89,171,63,116,39,55,24
1911209,56,4,1957,11,"female",377,45,19,17,3,17,2,0,1
1911210,51,27,1962,12,"female",145,24,18,4,0,4,0,0,0
1911218,28,9,1985,6,"male",455,30,21,1,13,1,8,0,5
1911219,108,5,1905,6,"male",1478,147,74,6,25,6,16,0,9
1911235,13,15,2000,5,"male",121,160,72,689,23,689,14,0,9
1911256,18,23,1995,6,"male",640,112,59,0,0,0,0,0,0
1911261,59,15,1954,7,"male",1456,114,48,275,130,164,37,111,93
1911312,32,10,1981,10,"female",283,228,84,10,37,10,22,0,15
1911332,20,28,1993,10,"male",82,10,8,0,1,0,0,0,1
1911350,24,9,1989,9,"male",294,143,99,13,4,13,4,0,0
1911356,53,10,1960,1,"male",203,277,46,5,14,3,8,2,6
1911380,25,31,1988,5,"male",163,59,29,1,4,1,1,0,3
1911389,19,21,1994,12,"female",389,109,42,0,7,0,5,0,2
1911392,54,10,1959,2,"female",1542,26,17,11,21,0,6,11,15
1911401,64,14,1949,10,"male",348,0,0,0,0,0,0,0,0
1911420,15,12,1998,12,"male",544,1101,774,1098,294,1098,245,0,49
1911506,20,6,1993,6,"male",421,100,81,49,6,49,6,0,0
1911507,21,18,1992,1,"male",560,132,92,3,1,0,1,3,0
1911519,23,12,1990,10,"female",73,47,45,47,9,47,2,0,7
1911539,54,1,1959,4,"female",228,36,31,93,36,62,14,31,22
1911542,25,10,1988,7,"male",842,57,28,53,3,53,3,0,0
1911548,21,25,1992,11,"male",1421,478,331,1,0,1,0,0,0
1911553,52,19,1961,7,"male",146,28,24,3,8,3,7,0,1
1911561,15,4,1998,9,"male",329,1,0,7,0,0,0,7,0
1911604,43,14,1970,2,"female",441,164,147,0,29,0,20,0,9
1911612,55,17,1958,4,"male",252,29,26,3,0,0,0,3,0
1911626,14,2,1999,3,"female",180,101,80,14,14,3,8,11,6
1911630,26,3,1987,5,"female",73,198,97,25,65,17,48,8,17
1911634,19,3,1994,2,"female",382,326,208,1,2,1,2,0,0
1911653,22,14,1991,7,"female",546,117,69,1,0,1,0,0,0
1911657,42,25,1971,2,"female",476,6,5,16,1,16,0,0,1
1911661,21,11,1992,5,"female",755,136,80,261,254,240,136,21,118
1911668,74,13,1939,11,"male",1662,1384,833,6086,1059,2274,650,3812,409
1911729,17,4,1996,8,"male",272,145,128,40,2,20,2,20,0
1911739,25,10,1988,8,"female",397,73,37,89,88,89,55,0,33
1911743,65,9,1948,4,"female",1874,32,11,173,33,18,16,155,17
1911744,24,23,1989,6,"male",107,11,10,0,0,0,0,0,0
1911753,21,1,1992,10,"female",527,246,171,349,204,268,89,81,115
1911765,60,10,1953,4,"female",1001,19,14,0,5,0,5,0,0
1911770,18,5,1995,4,"male",269,211,83,0,0,0,0,0,0
1911795,56,2,1957,4,"female",899,16,7,12,5,9,1,3,4
1911800,29,28,1984,8,"male",387,87,67,3,1,3,1,0,0
1911808,25,25,1988,7,"male",467,9,6,0,7,0,6,0,1
1911879,27,13,1986,3,"female",452,168,44,47,168,47,109,0,59
1911928,20,2,1993,6,"female",211,662,212,714,3133,394,1011,320,2122
1911946,14,31,1999,3,"female",133,175,137,74,69,57,49,17,20
1911959,52,9,1961,3,"female",723,69,57,271,172,130,118,141,54
1911960,62,8,1951,10,"female",1161,193,102,638,474,356,42,282,432
1911962,18,9,1995,3,"male",74,40,29,46,6,43,4,3,2
1911975,34,19,1979,7,"male",438,25,10,1,0,0,0,1,0
1911986,57,9,1956,5,"male",1102,50,31,1,1,0,0,1,1
1912002,61,3,1952,4,"male",174,44,42,16,3,0,1,16,2
1912018,43,19,1970,2,"male",139,23,15,3,2,3,2,0,0
1912090,41,1,1972,1,"female",266,18,18,0,0,0,0,0,0
1912117,21,4,1992,8,"female",530,134,116,22,9,2,2,20,7
1912163,30,13,1983,8,"male",273,203,84,0,9,0,7,0,2
1912174,66,5,1947,4,"male",393,120,79,0,0,0,0,0,0
1912206,18,13,1995,4,"male",564,683,459,114,215,64,80,50,135
1912225,18,10,1995,7,"male",248,90,73,3,3,3,0,0,3
1912280,24,26,1989,3,"female",421,617,291,9552,1704,9552,1536,0,168
1912282,19,30,1994,11,"female",386,14,12,18,4,18,3,0,1
1912321,29,17,1984,5,"male",161,267,250,0,0,0,0,0,0
1912323,49,10,1964,5,"male",906,23,11,1,15,0,8,1,7
1912326,79,18,1934,9,"female",1491,65,30,33,25,0,8,33,17
1912350,28,22,1985,9,"female",267,29,18,3,7,3,6,0,1
1912407,19,12,1994,6,"female",381,41,15,25,18,25,3,0,15
1912417,37,1,1976,7,"male",207,37,30,0,8,0,6,0,2
1912438,17,15,1996,5,"female",372,1549,1078,112,736,111,473,1,263
1912445,54,12,1959,4,"male",536,295,237,9,11,0,5,9,6
1912463,50,4,1963,6,"male",414,102,66,955,1126,486,791,469,335
1912478,19,9,1994,8,"male",163,230,64,6,4,3,1,3,3
1912520,19,3,1994,10,"male",1,1,0,0,0,0,0,0,0
1912530,107,2,1906,3,"male",1378,151,107,13,4,12,1,1,3
1912536,53,1,1960,6,"female",1616,88,41,33,98,31,75,2,23
1912539,50,22,1963,2,"male",1080,50,21,0,0,0,0,0,0
1912542,29,22,1984,8,"female",358,112,105,10,154,10,136,0,18
1912550,22,14,1991,7,"male",759,210,109,12,2,0,2,12,0
1912560,34,28,1979,7,"female",520,58,34,5,38,3,24,2,14
1912574,20,21,1993,3,"female",373,589,278,142,188,135,117,7,71
1912582,48,30,1965,10,"female",254,72,36,357,216,357,105,0,111
1912589,15,5,1998,5,"female",391,26,24,23,6,18,3,5,3
1912621,15,11,1998,3,"female",377,2748,369,7,3,7,1,0,2
1912648,69,17,1944,4,"male",391,103,83,16,18,0,12,16,6
1912662,108,13,1905,5,"female",1320,190,149,7,0,0,0,7,0
1912690,43,11,1970,10,"male",290,57,31,13,26,13,17,0,9
1912708,30,2,1983,3,"female",301,6,3,0,0,0,0,0,0
1912710,41,11,1972,1,"male",456,69,43,30,0,30,0,0,0
1912714,72,6,1941,12,"male",32,16,14,0,0,0,0,0,0
1912745,36,3,1977,6,"male",425,134,118,62,102,62,81,0,21
1912750,24,5,1989,3,"male",461,77,63,0,4,0,0,0,4
1912758,21,4,1992,3,"female",303,79,30,1078,1648,1078,907,0,741
1912803,15,17,1998,12,"male",457,127,41,83,35,0,0,83,35
1912813,23,28,1990,7,"female",176,0,0,0,0,0,0,0,0
1912827,53,3,1960,1,"female",1514,273,30,11,0,11,0,0,0
1912832,27,22,1986,10,"male",630,138,80,9,5,8,3,1,2
1912857,73,28,1940,10,"female",707,21,10,1,2,0,1,1,1
1912873,37,18,1976,12,"male",89,2,1,1,0,1,0,0,0
1912881,54,15,1959,5,"male",1179,25,4,0,0,0,0,0,0
1912902,16,21,1997,1,"male",263,108,78,16,6,0,5,16,1
1912911,70,22,1943,7,"female",1395,35,10,9,0,9,0,0,0
1912917,93,1,1920,1,"male",511,62,19,31,26,24,5,7,21
1912947,37,14,1976,5,"female",243,0,0,0,0,0,0,0,0
1912951,30,11,1983,11,"female",266,47,34,267,391,234,284,33,107
1912953,19,7,1994,8,"male",653,31,11,17,45,5,17,12,28
1912990,15,3,1998,7,"female",359,19,2,1,0,1,0,0,0
1912994,23,12,1990,5,"female",477,153,58,246,24,231,16,15,8
1912997,103,21,1910,3,"male",801,44,14,21,0,16,0,5,0
1913007,66,20,1947,12,"male",955,71,42,102,88,102,67,0,21
1913016,39,20,1974,2,"female",291,21,13,2,4,2,0,0,4
1913017,78,27,1935,7,"female",1235,21,12,0,0,0,0,0,0
1913036,108,1,1905,7,"male",1180,147,91,43,19,43,7,0,12
1913067,35,6,1978,5,"male",1386,136,85,2,1,2,1,0,0
1913070,27,1,1986,9,"male",305,169,151,1,0,1,0,0,0
1913087,34,28,1979,6,"male",1020,144,111,195,52,195,44,0,8
1913089,17,11,1996,11,"male",183,86,73,0,2,0,2,0,0
1913103,62,26,1951,10,"male",21,0,0,1,0,1,0,0,0
1913110,27,15,1986,9,"male",525,79,59,3,14,3,13,0,1
1913132,61,22,1952,4,"male",768,126,100,2,9,0,2,2,7
1913138,30,28,1983,7,"female",937,221,128,121,369,14,186,107,183
1913140,93,7,1920,6,"male",569,461,258,201,176,201,168,0,8
1913147,19,9,1994,3,"male",630,170,59,1,1,0,0,1,1
1913157,15,19,1998,1,"female",625,2802,250,88,1633,12,1235,76,398
1913164,15,21,1998,10,"female",300,62,15,0,3,0,1,0,2
1913175,19,7,1994,4,"male",240,491,184,84,139,84,136,0,3
1913192,18,7,1995,7,"male",52,38,26,32,20,32,17,0,3
1913205,30,12,1983,2,"male",26,27,23,4,1,4,1,0,0
1913222,14,1,1999,1,"male",131,173,161,15,3,15,3,0,0
1913226,66,5,1947,2,"female",297,16,8,0,0,0,0,0,0
1913279,49,27,1964,4,"female",416,8,5,0,0,0,0,0,0
1913288,57,22,1956,9,"female",1013,43,17,50,2,0,1,50,1
1913293,26,24,1987,2,"male",493,166,125,2,4,1,0,1,4
1913310,51,1,1962,9,"male",497,112,87,159,21,159,14,0,7
1913340,23,5,1990,11,"female",514,125,53,2,16,2,16,0,0
1913359,57,24,1956,9,"female",1812,32,9,49,119,6,34,43,85
1913396,51,1,1962,1,"male",674,24,16,0,0,0,0,0,0
1913406,24,25,1989,4,"female",182,2938,1272,6018,17765,5843,11708,175,6057
1913432,27,8,1986,8,"male",272,13,6,0,0,0,0,0,0
1913439,23,8,1990,2,"male",575,39,30,18,0,18,0,0,0
1913457,35,20,1978,9,"male",728,2,2,14,0,0,0,14,0
1913470,28,12,1985,3,"male",52,14,13,0,0,0,0,0,0
1913497,49,4,1964,9,"male",256,22,14,1,0,0,0,1,0
1913526,33,2,1980,11,"male",235,13,6,4,18,0,8,4,10
1913541,29,14,1984,9,"female",443,97,60,307,135,307,109,0,26
1913556,58,19,1955,12,"male",1125,91,45,4,9,1,8,3,1
1913579,16,1,1997,9,"male",625,441,356,80,103,37,32,43,71
1913599,57,27,1956,7,"female",742,71,44,37,46,28,33,9,13
1913643,64,25,1949,2,"female",663,164,68,13,23,0,2,13,21
1913649,32,21,1981,10,"male",484,5,3,0,0,0,0,0,0
1913651,28,24,1985,9,"male",138,101,78,28,19,28,15,0,4
1913658,48,23,1965,9,"female",939,200,128,1747,178,1336,96,411,82
1913661,17,23,1996,9,"female",205,394,122,11,53,11,50,0,3
1913682,56,12,1957,5,"female",13,1,1,2,0,2,0,0,0
1913692,34,9,1979,1,"male",610,210,166,29,44,29,22,0,22
1913720,25,22,1988,4,"female",216,43,36,0,3,0,0,0,3
1913776,35,26,1978,5,"female",297,5,1,0,0,0,0,0,0
1913781,75,5,1938,9,"male",1843,26,9,0,3,0,2,0,1
1913790,35,10,1978,5,"male",408,81,43,2,0,2,0,0,0
1913802,26,2,1987,2,"male",173,16,11,19,8,19,8,0,0
1913870,19,30,1994,11,"male",790,216,106,7,65,3,62,4,3
1913879,20,31,1993,12,"male",494,112,79,0,0,0,0,0,0
1913880,23,2,1990,2,"male",374,102,77,0,2,0,1,0,1
1913941,20,10,1993,8,"male",489,17,13,0,0,0,0,0,0
1913948,21,18,1992,11,"male",512,778,644,168,97,168,79,0,18
1913961,63,10,1950,7,"female",1430,174,40,265,215,146,64,119,151
1913968,38,15,1975,6,"male",309,36,29,13,16,13,16,0,0
1913969,16,3,1997,9,"female",231,201,81,37,25,4,2,33,23
1914061,23,16,1990,3,"male",728,83,43,10,0,0,0,10,0
1914085,27,18,1986,4,"male",597,12,7,0,0,0,0,0,0
1914093,65,28,1948,9,"female",445,51,30,0,0,0,0,0,0
1914155,16,25,1997,11,"male",20,98,92,0,0,0,0,0,0
1914157,21,31,1992,8,"male",507,1,1,18,3,18,0,0,3
1914180,28,25,1985,12,"male",290,36,25,1,3,1,2,0,1
1914212,23,10,1990,2,"male",580,0,0,1,0,0,0,1,0
1914230,90,14,1923,10,"female",1848,440,120,182,122,182,110,0,12
1914232,52,27,1961,10,"female",1100,289,58,678,198,678,153,0,45
1914258,26,1,1987,7,"male",259,6,5,1,0,1,0,0,0
1914270,25,11,1988,12,"male",225,90,48,8,17,0,4,8,13
1914292,22,2,1991,9,"male",463,363,209,138,135,29,24,109,111
1914298,74,13,1939,6,"female",1347,143,78,493,314,0,62,493,252
1914350,26,1,1987,1,"male",347,0,0,7,0,7,0,0,0
1914356,65,31,1948,3,"female",1361,174,111,769,112,0,33,769,79
1914364,63,3,1950,1,"male",498,105,72,121,103,121,37,0,66
1914375,33,31,1980,1,"male",403,131,97,175,247,175,220,0,27
1914419,67,19,1946,9,"male",880,108,69,31,1,0,0,31,1
1914452,108,25,1905,11,"male",764,216,133,1,1,1,1,0,0
1914458,21,16,1992,1,"female",325,12,3,0,0,0,0,0,0
1914472,25,1,1988,1,"male",52,20,16,3,3,3,3,0,0
1914485,22,1,1991,1,"male",568,6,1,0,0,0,0,0,0
1914494,26,26,1987,8,"male",148,86,71,0,0,0,0,0,0
1914505,26,1,1987,1,"female",379,57,12,0,0,0,0,0,0
1914516,65,13,1948,5,"male",711,125,37,495,280,427,193,68,87
1914520,59,30,1954,1,"male",606,100,64,250,532,0,77,250,455
1914542,26,7,1987,5,"male",211,191,138,148,34,148,25,0,9
1914555,23,30,1990,12,"female",148,441,109,1,65,1,37,0,28
1914558,20,17,1993,1,"male",149,131,57,136,73,136,48,0,25
1914567,16,5,1997,7,"male",400,25,20,0,0,0,0,0,0
1914569,21,10,1992,11,"female",563,237,212,11,2,11,2,0,0
1914581,100,5,1913,5,"male",293,51,40,317,12,317,6,0,6
1914582,33,31,1980,10,"female",304,123,33,1,2,1,1,0,1
1914634,21,30,1992,1,"female",498,626,197,805,754,495,219,310,535
1914636,32,27,1981,4,"male",572,97,34,12,10,12,2,0,8
1914640,20,25,1993,5,"male",1077,3,2,55,6,0,1,55,5
1914659,14,24,1999,9,"female",39,227,76,8,59,8,23,0,36
1914661,20,24,1993,9,"male",375,425,295,405,343,59,96,346,247
1914684,17,31,1996,5,"female",352,517,214,360,239,360,120,0,119
1914686,19,13,1994,7,"male",83,106,91,1,18,1,12,0,6
1914701,19,11,1994,1,"female",268,109,35,0,0,0,0,0,0
1914715,52,15,1961,12,"male",1405,36,15,18,8,0,5,18,3
1914738,40,9,1973,10,"female",717,1034,85,310,1111,310,605,0,506
1914769,23,1,1990,1,"male",608,0,0,0,0,0,0,0,0
1914770,18,10,1995,9,"male",422,445,291,0,1,0,1,0,0
1914774,16,10,1997,2,"female",16,166,152,21,105,14,19,7,86
1914786,54,4,1959,10,"male",229,28,21,23,7,1,1,22,6
1914806,36,22,1977,5,"female",205,160,140,371,184,367,160,4,24
1914830,24,1,1989,1,"male",336,747,594,4402,1484,4402,830,0,654
1914835,48,15,1965,3,"female",896,16,1,0,0,0,0,0,0
1914843,100,17,1913,2,"male",2088,421,226,152,129,10,15,142,114
1914862,29,14,1984,7,"male",286,7,7,1,2,1,2,0,0
1914872,38,13,1975,9,"female",499,83,52,29,38,22,29,7,9
1914877,24,6,1989,3,"male",395,2,2,0,0,0,0,0,0
1914885,19,6,1994,8,"male",73,51,36,4,3,4,2,0,1
1914912,38,16,1975,4,"male",337,31,15,0,0,0,0,0,0
1914937,25,22,1988,11,"female",333,67,41,80,4,80,2,0,2
1914977,39,21,1974,3,"female",1662,86,39,47,72,30,45,17,27
1914984,14,7,1999,6,"female",323,288,224,375,83,223,55,152,28
1915019,53,17,1960,2,"female",890,50,32,95,49,71,25,24,24
1915027,23,27,1990,12,"male",249,122,89,3,0,3,0,0,0
1915031,17,12,1996,4,"male",47,63,45,124,68,124,26,0,42
1915042,39,1,1974,1,"male",44,5,3,0,0,0,0,0,0
1915046,26,10,1987,1,"male",1176,64,47,12,5,11,5,1,0
1915099,30,29,1983,4,"male",434,167,150,40,2,40,1,0,1
1915101,20,5,1993,5,"female",808,426,50,1,1,1,1,0,0
1915104,54,24,1959,12,"female",484,121,76,400,41,0,4,400,37
1915124,47,3,1966,12,"female",607,78,75,2,9,1,1,1,8
1915200,21,30,1992,11,"male",122,69,37,1,16,1,5,0,11
1915219,25,1,1988,1,"female",72,98,84,332,421,328,249,4,172
1915304,33,1,1980,3,"female",198,101,75,556,60,129,23,427,37
1915340,19,22,1994,3,"female",604,563,375,45,201,45,91,0,110
1915344,100,16,1913,8,"female",1777,112,88,66,34,66,19,0,15
1915346,44,1,1969,1,"male",1554,27,13,1,4,1,1,0,3
1915349,62,13,1951,2,"male",742,47,38,1,0,1,0,0,0
1915354,15,6,1998,1,"female",184,434,140,60,94,22,47,38,47
1915363,17,3,1996,5,"male",57,130,117,189,157,119,88,70,69
1915374,36,15,1977,11,"male",1046,73,39,7,2,2,0,5,2
1915381,72,2,1941,12,"female",466,130,84,45,1,0,1,45,0
1915408,59,5,1954,5,"female",769,144,74,1043,327,0,73,1043,254
1915419,25,15,1988,6,"female",174,12,9,24,7,24,7,0,0
1915432,44,24,1969,10,"male",303,208,77,92,5,16,5,76,0
1915448,15,7,1998,1,"male",103,3,3,0,0,0,0,0,0
1915462,48,21,1965,11,"male",225,27,15,0,0,0,0,0,0
1915466,73,21,1940,7,"male",750,29,17,0,19,0,11,0,8
1915481,73,26,1940,7,"male",1692,28,6,10,1,3,1,7,0
1915533,19,20,1994,4,"male",113,318,276,123,72,70,36,53,36
1915587,34,18,1979,2,"female",226,57,42,124,16,124,8,0,8
1915594,20,3,1993,4,"female",431,137,50,1,8,1,0,0,8
1915646,22,6,1991,6,"female",234,55,20,2,4,2,4,0,0
1915667,25,1,1988,1,"female",138,18,12,1,4,1,4,0,0
1915679,43,20,1970,9,"male",240,3,2,0,0,0,0,0,0
1915720,24,29,1989,8,"male",574,57,35,23,32,4,20,19,12
1915721,29,22,1984,3,"male",423,129,91,0,1,0,1,0,0
1915741,22,28,1991,8,"female",850,807,187,51,102,51,89,0,13
1915787,14,7,1999,10,"female",279,432,366,872,480,0,217,872,263
1915796,19,14,1994,12,"male",644,601,497,261,98,261,67,0,31
1915813,28,21,1985,9,"male",153,44,24,48,21,48,16,0,5
1915828,36,30,1977,1,"female",138,21,6,1261,10,1261,7,0,3
1915832,28,16,1985,12,"female",455,141,87,0,0,0,0,0,0
1915833,16,18,1997,10,"female",783,589,240,608,672,560,440,48,232
1915880,18,3,1995,5,"male",470,83,72,1,1,1,1,0,0
1915886,36,20,1977,7,"male",155,53,42,86,132,6,61,80,71
1915888,52,6,1961,5,"male",858,76,74,455,131,455,67,0,64
1915889,18,3,1995,10,"male",126,23,14,0,0,0,0,0,0
1915893,62,9,1951,7,"female",358,105,74,1221,821,0,180,1221,641
1915967,20,13,1993,8,"male",165,80,61,11,0,10,0,1,0
1915984,27,16,1986,4,"male",300,271,256,0,2,0,2,0,0
1915991,14,11,1999,9,"male",132,13,9,1,20,1,18,0,2
1916004,27,1,1986,1,"female",534,6,4,11,26,2,13,9,13
1916009,92,19,1921,4,"male",59,289,232,221,46,0,25,221,21
1916024,113,1,1900,1,"male",1645,62,42,24,39,17,22,7,17
1916033,22,1,1991,1,"male",71,82,69,1,1,1,1,0,0
1916044,25,21,1988,11,"male",945,544,340,0,0,0,0,0,0
1916074,59,25,1954,9,"female",370,92,72,560,395,0,77,560,318
1916090,28,21,1985,6,"male",279,9,7,0,0,0,0,0,0
1916091,24,7,1989,11,"female",171,17,12,148,118,130,73,18,45
1916101,25,26,1988,8,"female",682,364,216,1,12,1,11,0,1
1916111,24,25,1989,1,"female",291,325,77,75,9,75,7,0,2
1916113,24,13,1989,10,"male",484,311,240,0,0,0,0,0,0
1916132,20,18,1993,5,"male",452,51,44,1,0,0,0,1,0
1916135,53,8,1960,6,"male",153,12,8,5,15,0,3,5,12
1916217,40,3,1973,9,"female",2289,374,96,558,697,476,484,82,213
1916231,57,1,1956,2,"female",319,23,6,84,7,0,1,84,6
1916247,33,7,1980,3,"male",360,96,82,4,0,4,0,0,0
1916251,18,27,1995,1,"male",753,528,108,10,149,10,87,0,62
1916272,22,19,1991,10,"female",383,14,7,0,2,0,2,0,0
1916286,32,19,1981,11,"male",412,21,2,1,0,1,0,0,0
1916310,17,12,1996,12,"male",234,141,77,2,0,2,0,0,0
1916325,29,29,1984,2,"male",225,110,49,2,16,2,13,0,3
1916329,82,27,1931,4,"female",646,261,103,4,8,0,1,4,7
1916346,24,6,1989,8,"female",551,192,155,146,68,85,3,61,65
1916390,43,12,1970,1,"male",825,195,94,418,360,356,202,62,158
1916396,44,9,1969,10,"female",274,99,92,43,124,41,74,2,50
1916441,33,2,1980,1,"male",257,22,15,3,0,3,0,0,0
1916442,20,28,1993,12,"female",362,247,149,301,104,246,53,55,51
1916483,19,15,1994,12,"male",644,48,29,0,0,0,0,0,0
1916522,104,16,1909,9,"female",1439,16,14,55,2,55,2,0,0
1916597,70,12,1943,3,"female",1692,134,70,74,125,0,18,74,107
1916613,20,22,1993,10,"female",400,0,0,0,0,0,0,0,0
1916633,25,1,1988,5,"female",268,10,10,0,18,0,11,0,7
1916651,18,12,1995,2,"male",185,63,56,0,0,0,0,0,0
1916665,49,14,1964,8,"male",341,3,3,0,11,0,11,0,0
1916681,15,7,1998,9,"female",196,386,123,0,11,0,7,0,4
1916688,64,3,1949,6,"female",1499,74,31,48,13,48,13,0,0
1916705,31,30,1982,11,"male",363,26,20,0,2,0,0,0,2
1916716,38,19,1975,4,"female",83,34,33,0,3,0,2,0,1
1916730,13,8,2000,8,"male",68,83,55,6,1,6,1,0,0
1916741,19,3,1994,8,"female",497,1817,1287,339,723,229,376,110,347
1916745,26,2,1987,2,"male",217,22,19,34,4,34,1,0,3
1916772,18,18,1995,10,"male",1223,436,301,0,0,0,0,0,0
1916777,60,2,1953,8,"female",47,6,6,0,0,0,0,0,0
1916804,39,30,1974,5,"male",143,17,11,0,0,0,0,0,0
1916821,18,12,1995,7,"female",442,132,111,124,70,4,28,120,42
1916859,101,9,1912,1,"female",84,111,105,54,8,1,1,53,7
1916863,17,8,1996,5,"male",208,1,1,0,0,0,0,0,0
1916904,16,3,1997,5,"male",186,274,247,2,36,2,33,0,3
1916919,27,22,1986,12,"female",216,39,17,4,6,4,6,0,0
1916920,25,16,1988,6,"male",517,375,214,407,89,384,66,23,23
1916970,19,14,1994,7,"male",525,598,575,0,0,0,0,0,0
1917002,19,14,1994,3,"female",789,22,11,0,0,0,0,0,0
1917003,21,8,1992,7,"male",1127,3450,2837,327,243,56,118,271,125
1917016,18,3,1995,9,"female",494,255,130,2,0,0,0,2,0
1917046,47,9,1966,9,"male",429,37,20,1,0,0,0,1,0
1917075,38,2,1975,2,"male",537,5,3,0,1,0,1,0,0
1917095,72,11,1941,3,"female",1766,125,88,168,12,0,7,168,5
1917106,18,22,1995,11,"male",450,199,75,37,17,37,15,0,2
1917110,18,16,1995,6,"male",238,221,203,2,3,2,1,0,2
1917113,43,19,1970,3,"male",317,101,34,332,118,306,54,26,64
1917114,23,27,1990,1,"male",50,0,0,0,0,0,0,0,0
1917118,20,11,1993,6,"male",488,592,494,34,13,28,13,6,0
1917123,49,28,1964,4,"female",1494,19,13,150,86,105,56,45,30
1917124,25,14,1988,1,"male",228,8,8,12,5,12,4,0,1
1917133,15,1,1998,9,"female",152,89,51,11,0,11,0,0,0
1917165,25,25,1988,7,"male",269,156,108,47,6,47,5,0,1
1917166,60,23,1953,11,"male",696,9,5,1,1,0,1,1,0
1917200,23,23,1990,5,"female",207,102,61,27,13,27,11,0,2
1917222,18,26,1995,5,"female",576,1449,934,46,134,46,95,0,39
1917250,27,2,1986,11,"male",617,142,84,79,42,67,26,12,16
1917256,30,21,1983,4,"male",899,145,37,71,95,71,91,0,4
1917267,18,26,1995,11,"male",331,818,436,2383,1894,2353,1349,30,545
1917273,48,11,1965,10,"male",320,79,49,3,0,3,0,0,0
1917275,15,6,1998,9,"male",13,3,3,0,0,0,0,0,0
1917279,45,1,1968,12,"male",329,1,1,0,0,0,0,0,0
1917334,34,7,1979,9,"male",378,32,14,0,4,0,1,0,3
1917363,47,19,1966,3,"male",507,75,57,240,14,234,13,6,1
1917364,24,1,1989,1,"male",626,355,257,207,131,207,83,0,48
1917375,103,4,1910,12,"female",1109,615,262,198,13,198,12,0,1
1917419,18,15,1995,3,"male",412,518,262,4952,2907,73,2013,4879,894
1917421,108,7,1905,2,"male",929,117,99,28,0,28,0,0,0
1917438,108,6,1905,9,"female",852,76,35,11,5,0,4,11,1
1917476,26,2,1987,12,"male",56,22,17,0,0,0,0,0,0
1917496,27,20,1986,12,"male",515,474,297,45,97,45,51,0,46
1917540,29,4,1984,3,"female",301,59,43,387,33,387,26,0,7
1917548,27,27,1986,5,"female",420,32,18,4,0,1,0,3,0
1917554,23,22,1990,6,"male",425,96,90,3,0,3,0,0,0
1917584,31,15,1982,4,"male",443,56,32,6,2,6,0,0,2
1917607,21,19,1992,4,"female",68,7,2,6,7,6,6,0,1
1917643,27,27,1986,9,"male",229,82,63,1,10,1,9,0,1
1917652,93,1,1920,1,"male",232,223,191,9,51,9,34,0,17
1917679,33,25,1980,10,"female",977,60,37,177,502,177,313,0,189
1917686,33,1,1980,1,"male",218,0,0,0,0,0,0,0,0
1917708,23,4,1990,10,"male",150,318,293,91,60,91,41,0,19
1917723,41,17,1972,4,"female",318,128,100,1883,1026,1883,181,0,845
1917727,21,15,1992,4,"female",220,77,11,1,0,1,0,0,0
1917741,24,16,1989,9,"male",302,96,45,1,4,1,4,0,0
1917760,20,15,1993,12,"female",176,1144,202,785,1312,785,651,0,661
1917798,38,9,1975,6,"male",415,4,2,0,0,0,0,0,0
1917838,29,15,1984,1,"male",251,521,406,6612,369,6612,334,0,35
1917839,39,27,1974,3,"female",327,3,1,1,1,1,1,0,0
1917845,52,26,1961,5,"male",410,61,37,5,75,5,68,0,7
1917907,67,15,1946,12,"female",974,52,39,0,2,0,2,0,0
1917917,16,28,1997,11,"male",634,91,18,0,0,0,0,0,0
1917920,64,20,1949,6,"female",606,24,23,5,3,0,0,5,3
1917938,22,10,1991,2,"male",372,121,54,2,19,2,15,0,4
1917943,108,12,1905,9,"male",1507,693,355,155,75,3,20,152,55
1917952,58,4,1955,5,"female",631,81,53,17,0,0,0,17,0
1917953,30,18,1983,7,"male",115,4,3,0,0,0,0,0,0
1917991,21,16,1992,2,"female",375,643,391,1122,2046,493,967,629,1079
1917992,51,9,1962,4,"female",643,46,28,2,2,0,0,2,2
1917999,18,1,1995,12,"female",340,153,115,33,18,0,2,33,16
1918007,71,27,1942,12,"male",1061,32,19,0,2,0,0,0,2
1918010,18,28,1995,2,"male",48,7,7,6,3,6,3,0,0
1918047,35,10,1978,1,"male",236,11,10,1480,4,1463,1,17,3
1918062,21,24,1992,3,"female",1669,171,99,1,12,1,7,0,5
1918100,47,17,1966,10,"male",152,25,16,58,9,0,3,58,6
1918115,29,1,1984,9,"male",137,70,42,32,21,32,9,0,12
1918137,45,7,1968,6,"male",89,46,29,97,5,0,1,97,4
1918145,58,18,1955,12,"male",1492,81,27,16,26,14,14,2,12
1918146,53,14,1960,12,"female",235,54,31,69,19,69,16,0,3
1918216,79,20,1934,4,"male",849,32,14,6,54,0,17,6,37
1918225,19,6,1994,11,"male",244,181,77,215,29,18,8,197,21
1918236,26,1,1987,1,"male",669,93,58,34,22,34,20,0,2
1918238,23,8,1990,9,"male",544,61,41,75,0,75,0,0,0
1918241,20,16,1993,10,"male",398,450,284,385,1032,91,406,294,626
1918260,48,4,1965,5,"male",647,226,171,0,0,0,0,0,0
1918290,23,13,1990,3,"female",237,17,16,59,52,9,25,50,27
1918315,68,20,1945,11,"female",562,57,28,3,5,0,0,3,5
1918325,19,9,1994,1,"female",161,160,125,690,578,690,406,0,172
1918340,24,2,1989,4,"male",257,92,27,0,0,0,0,0,0
1918355,50,23,1963,7,"male",516,150,82,0,0,0,0,0,0
1918371,24,5,1989,4,"female",1856,651,438,79,47,79,25,0,22
1918389,28,14,1985,2,"female",356,77,35,26,19,2,14,24,5
1918394,26,14,1987,12,"male",341,232,157,167,116,167,113,0,3
1918395,25,11,1988,9,"female",310,84,47,2,26,2,8,0,18
1918406,22,3,1991,7,"male",262,79,47,87,15,86,10,1,5
1918410,24,23,1989,2,"male",30,12,5,4,1,4,1,0,0
1918427,21,12,1992,10,"female",297,205,136,80,33,80,20,0,13
1918429,43,25,1970,3,"male",863,384,243,13,27,13,16,0,11
1918446,30,11,1983,4,"male",156,40,16,8,80,8,41,0,39
1918474,17,26,1996,8,"male",450,1052,899,1,11,1,6,0,5
1918481,18,7,1995,8,"female",249,298,95,34,11,33,10,1,1
1918525,46,3,1967,10,"male",551,23,19,37,18,37,15,0,3
1918529,26,19,1987,6,"female",41,70,65,0,2,0,2,0,0
1918534,23,6,1990,12,"male",744,928,641,35,0,35,0,0,0
1918540,14,4,1999,8,"male",372,139,125,1,9,1,9,0,0
1918548,16,3,1997,2,"female",416,426,325,246,264,246,164,0,100
1918560,16,6,1997,12,"male",344,80,45,4,1,3,0,1,1
1918565,46,12,1967,10,"female",768,278,138,292,305,292,289,0,16
1918584,52,4,1961,5,"male",1415,175,67,5,37,5,15,0,22
1918585,51,7,1962,11,"male",1114,38,17,0,0,0,0,0,0
1918600,46,27,1967,8,"female",44,177,108,97,248,89,121,8,127
1918618,18,20,1995,12,"female",39,33,25,25,19,25,8,0,11
1918646,17,2,1996,12,"male",7,2,0,0,0,0,0,0,0
1918692,25,2,1988,2,"male",95,12,9,0,0,0,0,0,0
1918727,64,30,1949,6,"male",1345,25,8,7,1,4,0,3,1
1918731,43,18,1970,11,"male",60,69,61,5,17,5,12,0,5
1918748,36,11,1977,5,"female",435,51,25,1,0,1,0,0,0
1918804,15,7,1998,10,"female",468,1041,452,620,1114,521,480,99,634
1918830,108,24,1905,8,NA,2594,72,38,23,8,0,1,23,7
1918857,44,10,1969,6,"male",557,4,3,0,0,0,0,0,0
1918858,21,14,1992,3,"female",1054,2805,802,281,451,281,395,0,56
1918883,20,25,1993,4,"female",342,368,216,79,79,79,78,0,1
1918947,23,26,1990,6,"male",423,16,6,0,9,0,9,0,0
1918971,43,1,1970,7,"male",885,109,45,0,0,0,0,0,0
1918979,71,12,1942,2,"female",1235,27,15,0,0,0,0,0,0
1919005,32,8,1981,9,"female",595,111,54,9,6,9,2,0,4
1919022,53,30,1960,9,"male",301,110,68,26,19,26,10,0,9
1919048,17,1,1996,3,"male",193,352,152,357,46,357,31,0,15
1919058,19,13,1994,3,"male",190,339,319,70,83,70,50,0,33
1919081,30,10,1983,8,"female",251,10,8,2,9,2,6,0,3
1919085,35,9,1978,1,"male",327,157,105,99,14,99,3,0,11
1919088,16,28,1997,8,"female",351,658,512,1185,509,279,218,906,291
1919103,17,1,1996,9,"male",850,188,68,11,5,11,4,0,1
1919104,100,9,1913,2,"male",1059,778,547,986,355,986,341,0,14
1919150,33,24,1980,1,"male",456,42,27,0,0,0,0,0,0
1919159,17,27,1996,4,"female",249,225,58,0,0,0,0,0,0
1919182,42,4,1971,5,"male",337,81,70,98,12,98,12,0,0
1919185,25,6,1988,6,"male",418,21,12,0,1,0,1,0,0
1919187,22,13,1991,4,"male",933,651,162,170,205,170,151,0,54
1919204,65,14,1948,5,"female",1856,88,25,114,66,114,50,0,16
1919207,15,13,1998,2,"male",324,71,54,2,2,2,1,0,1
1919251,29,17,1984,8,"female",447,18,8,0,0,0,0,0,0
1919257,23,27,1990,10,"male",758,13,10,0,0,0,0,0,0
1919265,24,31,1989,1,"male",511,2,1,0,0,0,0,0,0
1919287,29,4,1984,12,"male",215,55,30,0,0,0,0,0,0
1919317,15,5,1998,8,"male",374,81,32,3,0,3,0,0,0
1919334,20,15,1993,8,"female",135,59,49,3,7,0,2,3,5
1919388,33,19,1980,12,"female",183,54,30,613,135,613,68,0,67
1919393,17,14,1996,1,"female",60,1,1,61,30,61,26,0,4
1919402,61,21,1952,8,"male",1448,86,24,0,0,0,0,0,0
1919469,50,8,1963,2,"male",559,54,39,194,84,0,15,194,69
1919482,19,9,1994,6,"male",466,337,224,0,0,0,0,0,0
1919484,53,24,1960,11,"male",685,171,72,6,0,0,0,6,0
1919491,16,4,1997,7,"male",153,43,35,27,0,27,0,0,0
1919520,27,7,1986,1,"female",332,0,0,51,51,0,0,51,51
1919522,25,22,1988,10,"male",129,119,103,0,1,0,1,0,0
1919553,18,8,1995,8,"male",209,63,29,49,6,2,1,47,5
1919585,59,5,1954,2,"female",1299,90,48,22,2,22,1,0,1
1919607,63,10,1950,1,"male",1570,399,160,5,7,0,1,5,6
1919611,51,28,1962,5,"male",259,0,0,0,0,0,0,0,0
1919614,19,22,1994,6,"female",295,21,12,0,2,0,2,0,0
1919639,52,4,1961,5,"male",796,45,31,1,20,1,8,0,12
1919640,15,1,1998,12,"male",106,75,61,11,40,11,37,0,3
1919651,15,22,1998,1,"female",500,1862,366,411,501,130,306,281,195
1919662,21,8,1992,12,"female",425,317,86,10,194,10,146,0,48
1919694,30,27,1983,8,"female",144,32,15,0,0,0,0,0,0
1919724,66,3,1947,4,"female",704,23,13,1,2,1,2,0,0
1919744,67,12,1946,9,"male",500,26,14,0,0,0,0,0,0
1919752,108,24,1905,11,"male",1570,41,13,3,0,0,0,3,0
1919763,20,7,1993,4,"male",597,812,661,458,223,213,127,245,96
1919780,56,9,1957,5,"female",254,295,73,602,133,0,11,602,122
1919781,18,18,1995,5,"female",41,24,10,11,36,11,29,0,7
1919783,18,16,1995,8,"male",894,3440,1138,3835,3833,3269,2221,566,1612
1919786,41,15,1972,5,"male",1297,30,13,1,0,1,0,0,0
1919795,54,8,1959,6,"male",845,74,49,0,2,0,0,0,2
1919817,21,2,1992,8,"female",29,170,154,568,291,0,103,568,188
1919829,18,20,1995,11,"male",195,424,361,25,7,25,4,0,3
1919832,74,4,1939,9,"female",422,14,7,2,1,0,1,2,0
1919838,47,16,1966,5,"female",1177,276,102,407,174,407,132,0,42
1919841,14,20,1999,5,"female",227,40,29,1,0,0,0,1,0
1919858,64,27,1949,11,"male",1673,53,28,0,3,0,0,0,3
1919870,39,25,1974,1,"female",566,73,48,63,34,48,13,15,21
1919887,15,22,1998,6,"female",294,1789,606,4000,6212,2821,4392,1179,1820
1919892,53,8,1960,11,"male",426,0,0,0,0,0,0,0,0
1919893,16,17,1997,6,"male",67,15,12,106,42,6,14,100,28
1919902,54,2,1959,9,"male",1362,66,34,0,0,0,0,0,0
1919904,62,20,1951,7,"male",66,51,37,2,12,0,0,2,12
1919917,58,11,1955,2,"female",335,174,107,11,10,0,3,11,7
1919918,26,4,1987,8,"male",652,30,16,0,0,0,0,0,0
1919931,50,23,1963,10,"male",972,76,29,158,34,0,17,158,17
1919950,36,8,1977,7,"female",872,11,9,1,0,1,0,0,0
1919952,56,24,1957,1,"female",529,218,165,133,9,133,6,0,3
1919977,19,27,1994,10,"female",414,673,479,321,196,58,53,263,143
1919986,33,11,1980,4,"female",190,10,10,2,4,2,3,0,1
1919988,69,5,1944,3,"female",753,37,36,27,3,0,0,27,3
1920006,42,1,1971,12,"male",903,45,20,2,0,2,0,0,0
1920017,30,30,1983,11,"male",266,61,14,157,178,157,178,0,0
1920018,25,9,1988,4,"male",241,144,103,53,122,53,90,0,32
1920034,62,14,1951,10,"female",1352,218,172,183,339,1,78,182,261
1920040,21,26,1992,12,"female",796,611,152,10,20,10,19,0,1
1920057,19,8,1994,2,"female",274,840,589,1229,3941,1226,2773,3,1168
1920071,19,25,1994,3,"male",172,252,132,87,143,35,54,52,89
1920101,36,28,1977,3,"female",311,297,170,3515,1461,3515,1201,0,260
1920127,66,25,1947,2,"male",1377,57,43,3,6,0,3,3,3
1920137,67,14,1946,10,"female",385,14,10,0,2,0,2,0,0
1920142,19,29,1994,9,"male",730,229,104,1,0,1,0,0,0
1920174,14,3,1999,3,"male",317,236,76,34,53,6,5,28,48
1920225,17,19,1996,11,"female",693,943,248,539,659,539,543,0,116
1920275,14,2,1999,5,"male",488,369,277,13,28,10,8,3,20
1920304,52,5,1961,2,"female",1690,171,79,315,368,111,263,204,105
1920321,18,15,1995,8,"male",340,80,21,4,23,4,14,0,9
1920324,14,18,1999,6,"female",17,50,49,0,2,0,1,0,1
1920343,20,19,1993,2,"male",403,75,61,0,4,0,4,0,0
1920350,33,13,1980,1,"male",445,77,52,39,189,36,113,3,76
1920356,40,1,1973,9,"male",870,23,8,2,0,0,0,2,0
1920366,93,24,1920,7,"male",1381,245,97,40,70,0,12,40,58
1920402,73,1,1940,12,"male",11,11,9,45,17,45,14,0,3
1920409,52,20,1961,8,"female",35,25,21,61,30,61,30,0,0
1920418,20,5,1993,9,"female",216,222,126,96,28,93,26,3,2
1920429,32,7,1981,1,"male",191,128,114,20,18,17,16,3,2
1920467,38,17,1975,8,"male",1469,215,132,20,30,13,22,7,8
1920481,24,4,1989,1,"female",131,103,81,267,55,267,52,0,3
1920501,59,23,1954,10,"female",1010,98,72,84,27,53,8,31,19
1920508,20,20,1993,9,"female",634,281,161,101,17,101,6,0,11
1920533,73,18,1940,11,"male",238,6,1,0,0,0,0,0,0
1920564,35,22,1978,6,"female",370,65,25,48,55,48,50,0,5
1920591,23,31,1990,1,"male",563,271,219,5,12,2,4,3,8
1920598,23,2,1990,11,"female",119,387,338,1364,1402,1364,1254,0,148
1920600,78,29,1935,9,"male",1197,40,24,0,2,0,1,0,1
1920611,51,5,1962,7,"female",111,53,34,16,62,6,45,10,17
1920615,22,17,1991,12,"male",60,5,5,1,0,1,0,0,0
1920631,21,19,1992,10,"male",317,607,538,196,747,196,691,0,56
1920662,108,9,1905,4,"male",878,286,158,6,5,6,4,0,1
1920684,25,1,1988,1,"female",19,0,0,0,0,0,0,0,0
1920689,63,5,1950,9,"male",750,224,95,121,76,1,30,120,46
1920705,59,30,1954,9,"male",1682,10,3,0,0,0,0,0,0
1920708,23,12,1990,4,"female",337,2,2,0,0,0,0,0,0
1920709,25,5,1988,9,"female",371,298,274,45,302,38,202,7,100
1920729,19,26,1994,11,"male",536,74,60,2,7,0,4,2,3
1920730,30,28,1983,1,"male",303,87,32,1,0,1,0,0,0
1920750,68,17,1945,10,"female",537,36,27,1,4,1,4,0,0
1920753,16,12,1997,3,"female",562,231,91,100,2,0,0,100,2
1920789,52,23,1961,7,"female",697,201,167,11,1,9,0,2,1
1920811,22,4,1991,7,"male",508,325,207,128,33,2,20,126,13
1920820,28,25,1985,6,"male",25,24,5,1,8,0,4,1,4
1920845,23,14,1990,9,"male",291,42,19,1,1,1,1,0,0
1920846,23,31,1990,8,"female",1656,237,160,336,263,320,231,16,32
1920862,67,23,1946,10,"female",978,61,39,151,125,93,59,58,66
1920878,32,18,1981,2,"female",260,120,62,177,304,88,130,89,174
1920969,23,8,1990,1,"male",196,55,13,86,16,86,11,0,5
1920974,18,11,1995,1,"male",191,93,84,4,2,4,2,0,0
1920991,25,27,1988,9,"female",174,259,116,395,77,394,43,1,34
1921007,22,15,1991,9,"male",272,45,42,7,0,7,0,0,0
1921010,17,1,1996,1,"female",732,18,12,32,0,32,0,0,0
1921060,45,24,1968,5,"male",561,48,40,11,45,1,33,10,12
1921061,108,1,1905,1,"male",1191,238,95,57,45,3,19,54,26
1921076,57,17,1956,4,"female",496,12,7,54,11,10,2,44,9
1921091,17,17,1996,3,"male",656,121,104,1,0,0,0,1,0
1921102,20,7,1993,12,"female",484,741,353,314,37,1,6,313,31
1921124,48,18,1965,7,"female",899,119,65,123,226,123,132,0,94
1921144,15,26,1998,9,"female",131,311,98,264,446,254,186,10,260
1921147,74,22,1939,12,"female",1625,71,32,76,18,8,10,68,8
1921174,23,6,1990,3,"male",583,790,745,35,34,35,31,0,3
1921179,16,22,1997,3,"female",1420,930,466,753,708,681,452,72,256
1921184,21,25,1992,12,"male",482,18,9,0,0,0,0,0,0
1921204,27,9,1986,6,"female",260,46,34,0,0,0,0,0,0
1921230,68,20,1945,11,"male",287,93,24,3,3,3,0,0,3
1921245,17,24,1996,3,"female",265,530,428,386,189,115,89,271,100
1921246,73,8,1940,5,"male",946,12,2,62,15,0,11,62,4
1921262,39,22,1974,8,"female",118,22,18,814,312,814,285,0,27
1921299,46,6,1967,2,"male",220,51,40,4,2,4,0,0,2
1921305,56,21,1957,6,"female",415,70,62,48,16,13,8,35,8
1921320,58,18,1955,6,"male",387,81,44,0,0,0,0,0,0
1921331,22,6,1991,4,"male",288,8,4,4,3,4,3,0,0
1921332,55,7,1958,8,"female",579,56,38,5,1,0,0,5,1
1921336,55,20,1958,7,"male",465,6,6,9,9,0,7,9,2
1921338,14,5,1999,5,"male",497,137,80,0,3,0,0,0,3
1921344,20,10,1993,1,"male",570,87,66,5,4,5,4,0,0
1921350,14,6,1999,10,"female",300,124,103,32,28,32,17,0,11
1921368,35,5,1978,5,"male",109,6,3,0,0,0,0,0,0
1921377,60,7,1953,11,"female",1776,185,126,267,244,267,202,0,42
1921388,58,27,1955,8,"female",1286,431,256,1653,749,1497,299,156,450
1921402,30,10,1983,12,"female",49,39,18,63,15,63,14,0,1
1921404,67,14,1946,6,"female",256,40,36,0,0,0,0,0,0
1921419,49,15,1964,11,"male",693,30,9,132,30,90,13,42,17
1921433,37,24,1976,2,"female",264,327,266,27,25,27,23,0,2
1921441,21,9,1992,12,"male",467,16,15,101,1,101,1,0,0
1921483,27,7,1986,3,"female",356,64,31,0,0,0,0,0,0
1921503,24,23,1989,12,"male",415,31,14,0,0,0,0,0,0
1921518,26,1,1987,1,"female",372,26,21,0,0,0,0,0,0
1921543,14,2,1999,3,"male",25,29,29,9,1,9,1,0,0
1921557,103,4,1910,8,"male",1430,136,72,36,16,36,10,0,6
1921586,61,19,1952,1,"female",283,230,31,463,520,461,171,2,349
1921593,14,18,1999,1,"female",267,237,94,128,57,128,46,0,11
1921615,17,1,1996,11,"male",86,50,32,56,26,32,15,24,11
1921621,32,3,1981,9,"female",364,172,155,414,232,136,146,278,86
1921649,108,13,1905,3,"male",1262,1601,1247,349,90,125,54,224,36
1921662,23,12,1990,11,"female",379,84,69,39,30,39,23,0,7
1921676,70,20,1943,11,"male",726,50,17,17,24,17,11,0,13
1921677,37,10,1976,4,"male",542,16,11,0,0,0,0,0,0
1921693,35,28,1978,6,"female",483,16,6,2,3,2,1,0,2
1921707,25,7,1988,4,"female",356,334,296,10,13,10,9,0,4
1921721,20,28,1993,11,"female",365,53,43,5,33,5,13,0,20
1921737,40,19,1973,5,"male",305,36,27,79,27,1,19,78,8
1921750,23,10,1990,10,"female",165,132,61,61,123,54,74,7,49
1921770,23,6,1990,10,"male",21,3,3,0,0,0,0,0,0
1921772,30,14,1983,10,"male",540,65,19,0,3,0,1,0,2
1921777,60,23,1953,11,"female",1583,2849,1191,750,1467,649,547,101,920
1921792,14,27,1999,5,"male",82,47,18,0,9,0,0,0,9
1921793,33,17,1980,10,"male",487,42,12,1,5,1,0,0,5
1921818,30,2,1983,7,"male",205,75,56,30,31,30,14,0,17
1921837,66,10,1947,9,"female",1956,14,3,1,3,1,3,0,0
1921854,18,14,1995,2,"female",190,3,3,472,209,9,128,463,81
1921871,23,1,1990,1,"male",174,1,1,0,0,0,0,0,0
1921889,16,17,1997,11,"male",164,108,101,0,0,0,0,0,0
1921908,35,23,1978,6,"male",116,25,18,0,4,0,0,0,4
1921909,54,5,1959,3,"female",592,180,139,474,106,471,57,3,49
1921913,53,13,1960,11,"male",686,120,46,0,3,0,1,0,2
1921920,28,31,1985,12,"male",169,9,8,0,0,0,0,0,0
1921924,18,2,1995,9,"male",281,2,2,0,0,0,0,0,0
1921931,49,31,1964,7,"female",410,90,44,1504,231,1495,80,9,151
1921932,23,18,1990,7,"male",813,246,141,0,9,0,8,0,1
1921972,13,2,2000,1,"male",24,6,6,0,0,0,0,0,0
1922006,34,31,1979,12,"female",478,76,68,91,72,29,58,62,14
1922019,66,9,1947,5,"male",1407,76,50,455,339,0,72,455,267
1922025,20,17,1993,3,"male",308,145,121,4,19,4,17,0,2
1922033,54,11,1959,2,"female",1464,38,26,1465,326,724,138,741,188
1922071,25,29,1988,10,"male",681,140,101,0,0,0,0,0,0
1922086,14,15,1999,2,"male",625,50,16,0,0,0,0,0,0
1922106,31,1,1982,1,"male",175,4,1,65,4,65,4,0,0
1922134,20,7,1993,2,"male",1089,73,22,0,2,0,2,0,0
1922154,60,1,1953,1,"female",263,36,26,5,3,5,2,0,1
1922188,26,1,1987,1,"male",390,60,21,2,0,2,0,0,0
1922193,26,25,1987,7,"female",124,138,81,2931,474,2820,235,111,239
1922226,27,4,1986,6,"male",63,139,125,126,228,126,218,0,10
1922231,43,31,1970,10,"male",70,160,152,9,28,9,27,0,1
1922265,50,13,1963,12,"female",695,161,46,334,501,56,303,278,198
1922275,13,24,2000,3,"male",428,248,64,4,4,4,4,0,0
1922280,49,10,1964,9,"male",484,72,45,42,69,6,20,36,49
1922283,60,12,1953,5,"male",285,130,89,3,0,3,0,0,0
1922305,62,17,1951,4,"female",75,33,17,360,158,360,42,0,116
1922371,30,14,1983,5,"male",65,48,9,2,1,2,0,0,1
1922408,17,13,1996,8,"male",510,85,63,4,1,4,1,0,0
1922411,106,6,1907,8,"male",1313,339,182,140,173,31,104,109,69
1922413,50,1,1963,1,"female",305,241,153,443,78,371,66,72,12
1922423,15,10,1998,12,"female",110,317,187,164,28,164,23,0,5
1922435,21,2,1992,4,"male",490,326,218,36,25,9,19,27,6
1922438,64,19,1949,7,"male",1409,26,17,0,0,0,0,0,0
1922471,31,27,1982,9,"female",495,240,220,9,9,9,8,0,1
1922492,47,10,1966,1,"male",1162,23,8,645,22,330,9,315,13
1922507,19,14,1994,7,"male",496,126,69,0,5,0,5,0,0
1922550,47,28,1966,7,"male",580,122,82,868,561,868,290,0,271
1922578,38,22,1975,4,"female",146,63,38,0,4,0,1,0,3
1922581,103,14,1910,4,"female",1492,586,317,253,251,239,188,14,63
1922607,58,25,1955,1,"female",297,34,26,12,3,3,1,9,2
1922616,73,25,1940,1,"male",53,25,20,104,16,104,12,0,4
1922624,18,16,1995,5,"male",87,378,362,8,4,7,2,1,2
1922661,74,5,1939,5,"male",684,16,13,1,4,1,4,0,0
1922662,52,11,1961,3,"female",227,24,10,31,8,31,7,0,1
1922664,108,3,1905,12,"male",844,473,230,121,140,29,51,92,89
1922690,18,9,1995,6,"female",1722,990,555,385,347,63,154,322,193
1922709,75,5,1938,3,"female",771,53,14,78,13,0,9,78,4
1922738,66,14,1947,4,"male",60,66,42,63,16,63,13,0,3
1922766,43,5,1970,12,"male",370,116,85,37,4,37,2,0,2
1922773,21,29,1992,7,"male",452,143,30,8,7,8,7,0,0
1922776,54,12,1959,5,"female",506,22,7,89,53,89,41,0,12
1922797,28,25,1985,4,"female",411,102,62,543,124,0,84,543,40
1922828,23,17,1990,10,"male",491,366,359,7,9,7,9,0,0
1922848,20,10,1993,5,"male",84,34,0,1,1,1,1,0,0
1922878,63,27,1950,9,"male",55,61,53,35,31,0,7,35,24
1922894,25,1,1988,4,"female",1317,600,345,1344,1291,604,586,740,705
1922973,29,18,1984,2,"female",526,172,31,0,5,0,4,0,1
1922977,16,8,1997,11,"male",433,171,148,5,0,0,0,5,0
1922984,31,8,1982,4,"female",311,13,4,0,0,0,0,0,0
1922995,51,25,1962,10,"male",446,108,85,169,30,169,22,0,8
1923063,108,16,1905,7,"female",1464,693,311,1556,1738,449,987,1107,751
1923072,43,16,1970,1,"female",303,39,33,2,1,2,1,0,0
1923100,32,20,1981,7,"male",907,11,9,1,0,0,0,1,0
1923110,17,3,1996,9,"female",1304,1275,1004,19,119,18,85,1,34
1923120,40,19,1973,2,"female",529,13,6,0,0,0,0,0,0
1923146,34,10,1979,7,"male",933,72,40,7,1,7,1,0,0
1923163,50,28,1963,11,"male",820,26,10,19,29,16,14,3,15
1923167,59,10,1954,11,"female",1666,424,96,688,1284,550,850,138,434
1923170,59,5,1954,6,"male",755,70,49,7,1,7,1,0,0
1923181,53,12,1960,4,"female",169,15,15,6,4,0,0,6,4
1923190,21,8,1992,8,"male",131,15,15,2,1,2,1,0,0
1923203,23,19,1990,4,"female",537,160,67,12,1,12,1,0,0
1923230,19,13,1994,3,"male",620,20,6,0,1,0,1,0,0
1923231,31,12,1982,10,"male",168,293,257,486,358,299,80,187,278
1923241,22,27,1991,8,"female",258,75,25,20,89,20,69,0,20
1923251,24,4,1989,2,"female",503,178,91,19,12,19,10,0,2
1923268,22,10,1991,5,"female",18,2,2,0,0,0,0,0,0
1923284,17,26,1996,2,"male",368,46,1,14,0,14,0,0,0
1923290,21,19,1992,9,"female",117,36,3,20,92,20,63,0,29
1923293,21,18,1992,2,"male",389,27,15,3,13,3,0,0,13
1923303,29,4,1984,4,"male",318,96,91,2,3,2,1,0,2
1923323,87,7,1926,8,"male",230,5,5,0,0,0,0,0,0
1923333,34,24,1979,6,"female",424,43,39,37,11,37,10,0,1
1923340,103,3,1910,12,"female",901,172,111,449,280,449,184,0,96
1923389,43,24,1970,8,"male",555,66,48,10,25,10,11,0,14
1923413,21,14,1992,10,"male",687,220,173,13,1,13,1,0,0
1923416,103,19,1910,3,"male",999,148,82,36,107,17,60,19,47
1923454,21,4,1992,4,"male",669,158,52,4,11,4,2,0,9
1923459,24,3,1989,3,"male",21,0,0,0,0,0,0,0,0
1923460,33,19,1980,1,"male",338,179,147,194,36,194,27,0,9
1923515,58,8,1955,2,"female",315,1,1,1,1,1,1,0,0
1923518,18,26,1995,11,"female",156,44,38,0,2,0,1,0,1
1923574,30,2,1983,5,"male",361,107,50,0,0,0,0,0,0
1923605,16,22,1997,1,"female",866,647,449,1000,640,495,374,505,266
1923631,21,1,1992,5,"male",382,102,56,193,49,193,14,0,35
1923643,36,2,1977,7,"male",536,34,29,0,0,0,0,0,0
1923651,17,7,1996,9,"male",382,51,43,23,0,23,0,0,0
1923658,56,25,1957,4,"female",915,48,38,75,25,75,6,0,19
1923666,17,10,1996,10,"female",384,49,15,177,180,173,142,4,38
1923683,15,11,1998,1,"male",44,4,3,0,1,0,1,0,0
1923690,26,7,1987,9,"female",454,31,15,4,2,4,2,0,0
1923692,18,22,1995,6,"female",220,476,152,138,237,105,177,33,60
1923710,28,13,1985,11,"male",1,9,9,4,9,4,5,0,4
1923733,20,19,1993,9,"female",490,220,126,28,26,28,8,0,18
1923734,57,18,1956,8,"male",759,52,17,91,45,56,25,35,20
1923753,18,9,1995,5,"female",539,116,38,7,1,0,0,7,1
1923766,40,25,1973,5,"female",501,42,25,7,1,0,0,7,1
1923771,18,27,1995,1,"male",634,8,3,0,0,0,0,0,0
1923792,20,22,1993,11,"female",636,135,98,916,1802,878,1045,38,757
1923798,15,28,1998,3,"male",60,344,246,895,300,60,98,835,202
1923821,65,25,1948,8,"male",1129,147,40,5,13,4,9,1,4
1923839,54,29,1959,6,"male",551,95,41,28,55,0,13,28,42
1923871,65,7,1948,8,"male",593,275,180,83,51,20,27,63,24
1923886,65,1,1948,5,"female",444,98,77,110,11,0,2,110,9
1923896,57,11,1956,5,"male",1113,381,283,66,16,63,6,3,10
1923943,25,23,1988,8,"male",700,281,143,0,3,0,0,0,3
1923957,50,16,1963,11,"male",324,29,20,17,24,5,2,12,22
1923976,64,26,1949,7,"male",1532,222,62,37,14,37,6,0,8
1923982,26,19,1987,4,"male",392,32,6,0,0,0,0,0,0
1923985,37,12,1976,8,"male",50,24,12,16,21,10,17,6,4
1923995,72,20,1941,1,"female",606,30,25,75,9,0,1,75,8
1924016,57,3,1956,10,"female",624,138,43,51,101,0,26,51,75
1924038,52,25,1961,4,"male",278,35,18,0,0,0,0,0,0
1924042,20,24,1993,7,"female",131,52,42,278,414,5,212,273,202
1924060,36,19,1977,2,"female",240,334,207,222,646,126,235,96,411
1924101,17,4,1996,5,"male",533,489,426,0,9,0,8,0,1
1924105,46,10,1967,5,"female",699,255,112,183,17,183,4,0,13
1924110,22,20,1991,6,"female",1466,542,83,69,97,69,54,0,43
1924120,49,12,1964,3,"female",528,50,39,4,1,4,1,0,0
1924138,24,3,1989,4,"male",206,76,59,0,5,0,5,0,0
1924187,87,7,1926,8,"male",163,13,11,9,0,9,0,0,0
1924219,48,17,1965,7,"male",692,53,17,47,0,47,0,0,0
1924231,33,2,1980,6,"male",357,4,4,0,0,0,0,0,0
1924233,18,28,1995,7,"male",224,33,16,1,2,0,1,1,1
1924254,38,10,1975,11,"female",237,13,10,89,2,0,1,89,1
1924263,67,6,1946,6,"male",1688,38,16,94,81,94,39,0,42
1924287,47,25,1966,12,"female",509,43,27,149,1,0,0,149,1
1924299,28,29,1985,9,"male",763,279,171,9,1,9,1,0,0
1924367,72,29,1941,6,"female",1742,32,18,9,0,0,0,9,0
1924400,19,2,1994,7,"male",415,278,179,13,9,13,9,0,0
1924438,28,5,1985,3,"male",506,107,89,8,9,8,5,0,4
1924442,73,23,1940,4,"female",17,4,4,0,0,0,0,0,0
1924459,31,3,1982,6,"male",13,54,42,421,125,249,70,172,55
1924510,27,18,1986,2,"male",125,307,290,82,49,61,38,21,11
1924525,15,18,1998,10,"male",378,59,23,10,2,0,1,10,1
1924535,65,15,1948,11,"male",43,33,15,6,2,6,1,0,1
1924595,21,23,1992,4,"female",1027,94,55,1,2,1,2,0,0
1924598,69,18,1944,1,"male",602,26,20,1,1,0,0,1,1
1924603,108,22,1905,2,"female",1073,912,51,46,59,46,47,0,12
1924616,32,6,1981,4,"male",636,32,16,3,0,3,0,0,0
1924631,22,18,1991,9,"male",78,7,6,2,17,0,3,2,14
1924651,27,26,1986,7,"male",441,120,112,1,3,1,0,0,3
1924654,24,2,1989,4,"male",394,52,41,0,1,0,0,0,1
1924665,48,5,1965,8,"female",144,54,25,5,3,2,2,3,1
1924683,23,5,1990,1,"male",175,27,16,10,2,0,0,10,2
1924720,19,5,1994,5,"male",664,977,879,529,53,529,43,0,10
1924722,41,9,1972,5,"female",549,4,0,5,5,5,5,0,0
1924732,22,8,1991,1,"male",579,129,61,9,22,9,6,0,16
1924741,19,20,1994,11,"male",781,168,114,6,1,0,0,6,1
1924742,33,1,1980,1,"male",54,1,1,5,0,5,0,0,0
1924757,31,23,1982,10,"female",284,26,23,23,17,23,6,0,11
1924786,48,4,1965,9,"female",415,35,22,110,95,110,43,0,52
1924791,24,25,1989,11,"male",391,34,27,31,8,0,2,31,6
1924816,15,31,1998,12,"female",575,4173,294,336,1845,336,1205,0,640
1924845,26,25,1987,5,"male",303,226,115,45,24,45,24,0,0
1924855,49,26,1964,4,"female",425,22,10,209,112,0,7,209,105
1924879,61,10,1952,12,"male",2169,44,17,114,130,52,103,62,27
1924925,31,19,1982,10,"female",297,44,34,36,53,36,50,0,3
1924951,53,30,1960,9,"female",1464,212,164,3122,741,3122,349,0,392
1924962,46,6,1967,1,"male",288,182,130,170,16,170,13,0,3
1924964,49,2,1964,12,"male",302,19,15,5,16,5,16,0,0
1924966,38,22,1975,8,"male",481,355,112,9,45,9,14,0,31
1924983,16,21,1997,4,"female",467,127,50,405,398,0,110,405,288
1925076,18,16,1995,1,"female",269,188,30,0,3,0,3,0,0
1925115,21,29,1992,6,"female",204,299,262,126,110,94,96,32,14
1925145,33,25,1980,6,"male",409,9,5,0,0,0,0,0,0
1925160,17,18,1996,6,"male",436,145,86,39,18,5,14,34,4
1925161,20,12,1993,11,"female",215,247,125,0,0,0,0,0,0
1925203,34,24,1979,8,"female",330,6,3,5,9,5,9,0,0
1925217,34,23,1979,9,"male",388,2,1,1,0,1,0,0,0
1925223,93,16,1920,7,"male",878,66,43,5,3,0,2,5,1
1925228,20,1,1993,1,"female",422,50,36,0,1,0,1,0,0
1925245,39,16,1974,8,"male",228,34,28,2,0,2,0,0,0
1925250,18,10,1995,10,"male",74,273,199,9,16,9,14,0,2
1925261,53,25,1960,3,"male",2410,216,128,5,16,4,3,1,13
1925284,31,14,1982,10,"female",587,2,0,0,0,0,0,0,0
1925285,21,14,1992,8,"male",322,7,3,73,3,0,0,73,3
1925288,25,30,1988,3,"male",65,37,26,0,1,0,1,0,0
1925296,36,27,1977,3,"male",366,441,390,594,79,587,43,7,36
1925298,25,12,1988,6,"male",672,379,333,0,0,0,0,0,0
1925335,38,12,1975,12,"male",501,22,16,0,0,0,0,0,0
1925371,24,25,1989,7,"male",7,7,6,0,0,0,0,0,0
1925396,51,29,1962,11,"female",143,56,48,57,10,57,9,0,1
1925436,71,3,1942,12,"female",1638,51,26,87,19,87,11,0,8
1925446,14,27,1999,2,"female",420,850,413,1201,944,1201,796,0,148
1925464,27,1,1986,1,"male",812,154,96,0,18,0,9,0,9
1925495,28,6,1985,10,"male",757,376,302,1,41,1,29,0,12
1925501,100,1,1913,1,"male",1490,329,184,70,311,69,231,1,80
1925554,20,1,1993,6,"female",329,99,49,59,47,59,37,0,10
1925558,24,28,1989,6,"male",300,182,132,876,573,876,477,0,96
1925561,59,1,1954,1,"female",392,57,32,128,19,0,17,128,2
1925562,56,25,1957,1,"female",1729,212,129,69,222,2,53,67,169
1925571,58,3,1955,5,"female",152,40,5,55,38,9,28,46,10
1925574,29,21,1984,12,"female",333,502,333,0,0,0,0,0,0
1925582,50,24,1963,2,"female",1514,87,22,159,209,141,108,18,101
1925670,24,1,1989,11,"male",450,263,240,950,646,950,547,0,99
1925696,21,1,1992,9,"male",98,14,12,0,0,0,0,0,0
1925709,18,18,1995,8,"female",137,665,315,1054,2494,794,713,260,1781
1925742,19,2,1994,10,"male",105,21,13,3,0,1,0,2,0
1925743,64,9,1949,8,"female",72,49,22,17,15,0,5,17,10
1925776,73,1,1940,3,"female",1515,35,16,0,0,0,0,0,0
1925792,26,19,1987,7,"female",84,85,77,43,17,23,8,20,9
1925809,15,29,1998,9,"male",171,120,98,3,3,1,3,2,0
1925857,20,9,1993,10,"male",287,85,41,0,0,0,0,0,0
1925875,68,2,1945,3,"female",256,265,147,0,0,0,0,0,0
1925882,17,22,1996,6,"female",333,258,117,1936,134,1936,67,0,67
1925973,26,10,1987,7,"male",522,347,243,19,24,19,24,0,0
1926010,19,4,1994,5,"male",938,2941,1579,29,3916,27,2461,2,1455
1926020,69,6,1944,8,"male",129,372,355,35,3,12,2,23,1
1926072,23,21,1990,2,"male",511,320,263,27,130,3,120,24,10
1926079,23,13,1990,3,"male",313,668,625,2691,647,2120,401,571,246
1926109,28,5,1985,10,"male",493,163,79,2593,558,2526,485,67,73
1926110,15,16,1998,4,"male",16,5,4,0,0,0,0,0,0
1926112,18,2,1995,8,"male",356,21,15,30,16,30,4,0,12
1926114,30,18,1983,5,"female",323,241,184,2664,2748,2653,756,11,1992
1926136,68,17,1945,8,"male",1034,162,125,2,26,2,22,0,4
1926154,73,23,1940,7,"male",784,266,148,53,35,0,30,53,5
1926163,62,22,1951,8,"male",1475,139,36,21,17,21,11,0,6
1926164,38,13,1975,2,"male",883,43,16,13,33,13,22,0,11
1926205,25,29,1988,3,"male",699,97,42,28,28,7,14,21,14
1926221,26,8,1987,1,"male",356,101,82,480,28,480,11,0,17
1926236,24,14,1989,8,"male",336,223,136,13,0,13,0,0,0
1926242,48,16,1965,4,"male",1993,446,219,717,325,714,283,3,42
1926302,24,20,1989,11,"male",303,1,1,4,0,0,0,4,0
1926313,24,26,1989,6,"male",364,353,285,51,37,51,36,0,1
1926323,20,17,1993,1,"female",204,62,28,426,281,408,71,18,210
1926338,35,1,1978,10,"male",880,76,50,31,41,22,31,9,10
1926345,35,7,1978,10,"female",160,1,1,5,1,5,0,0,1
1926355,17,7,1996,9,"male",125,263,189,362,912,159,598,203,314
1926356,16,31,1997,7,"female",419,4663,542,2119,4404,1678,3027,441,1377
1926359,19,10,1994,8,"female",621,151,101,189,173,184,159,5,14
1926389,26,9,1987,5,"male",292,71,68,4,1,4,1,0,0
1926406,55,5,1958,9,"male",1470,91,58,128,22,120,11,8,11
1926424,108,26,1905,1,"male",2085,223,98,8,1,6,0,2,1
1926430,38,17,1975,3,"male",565,18,5,1,0,1,0,0,0
1926434,59,16,1954,10,"male",406,44,39,81,39,81,33,0,6
1926438,16,8,1997,11,"female",23,677,38,82,188,80,152,2,36
1926464,47,10,1966,1,"male",59,296,218,86,43,86,36,0,7
1926537,18,26,1995,7,"male",786,978,387,101,136,101,92,0,44
1926548,26,26,1987,5,"male",293,111,61,1,23,0,5,1,18
1926569,53,11,1960,8,"female",312,48,23,0,0,0,0,0,0
1926592,22,16,1991,9,"male",370,50,47,1,4,0,1,1,3
1926611,17,12,1996,3,"male",438,2193,1754,16,66,16,52,0,14
1926616,40,24,1973,6,"female",568,33,14,4,0,4,0,0,0
1926623,25,20,1988,6,"female",392,74,61,227,10,225,1,2,9
1926628,26,1,1987,12,"male",687,151,76,26,1,7,1,19,0
1926636,50,28,1963,3,"female",602,325,184,1772,1196,313,262,1459,934
1926642,19,19,1994,9,"male",30,2,0,70,2,70,2,0,0
1926655,37,15,1976,7,"female",750,27,10,15,8,15,8,0,0
1926675,14,1,1999,10,"male",339,1073,599,0,0,0,0,0,0
1926681,25,19,1988,2,"female",348,63,28,10,28,10,6,0,22
1926687,17,10,1996,10,"male",9,10,7,1,0,1,0,0,0
1926711,20,21,1993,3,"female",1250,196,52,657,960,474,184,183,776
1926721,63,1,1950,10,"male",904,42,21,0,1,0,0,0,1
1926744,21,2,1992,5,"male",280,219,179,30,38,13,30,17,8
1926777,47,1,1966,1,"male",240,18,9,20,26,20,13,0,13
1926782,23,1,1990,1,"female",348,67,17,31,5,31,5,0,0
1926785,62,4,1951,1,"male",442,37,31,2,2,0,0,2,2
1926827,36,4,1977,8,"female",1301,214,103,84,65,84,38,0,27
1926849,73,12,1940,6,"female",1340,53,33,0,0,0,0,0,0
1926861,56,7,1957,6,"male",179,26,22,0,0,0,0,0,0
1926900,60,17,1953,12,"female",2148,291,142,66,196,59,163,7,33
1926902,28,10,1985,12,"male",227,57,55,43,4,43,4,0,0
1926904,41,1,1972,7,"female",408,164,138,103,161,93,96,10,65
1926910,39,14,1974,11,"male",416,217,138,330,373,306,275,24,98
1926919,33,14,1980,3,"female",128,2,0,0,0,0,0,0,0
1926951,37,9,1976,12,"male",132,1,0,2,0,2,0,0,0
1926952,66,11,1947,1,"male",306,14,6,1,0,1,0,0,0
1926956,19,19,1994,10,"female",709,1414,1054,48,57,13,44,35,13
1926961,105,13,1908,3,"male",1264,124,53,6,0,6,0,0,0
1926962,66,20,1947,5,"male",850,64,27,1,0,0,0,1,0
1926968,56,10,1957,10,"female",932,124,86,14,25,14,4,0,21
1926971,22,12,1991,1,"male",271,405,373,30,151,30,46,0,105
1926975,32,17,1981,9,"male",510,1064,885,689,168,689,158,0,10
1926986,33,29,1980,9,"female",879,226,128,36,31,36,19,0,12
1926989,34,7,1979,12,"female",812,33,13,77,25,77,16,0,9
1926997,15,18,1998,4,"male",5,38,37,0,14,0,12,0,2
1927000,22,21,1991,3,"female",247,118,75,0,0,0,0,0,0
1927003,19,14,1994,7,"male",318,208,23,2,1,0,0,2,1
1927029,29,18,1984,8,"female",457,772,209,6,101,6,97,0,4
1927042,16,12,1997,12,"female",116,303,182,3283,4024,1292,1983,1991,2041
1927088,47,23,1966,9,"female",470,39,22,20,12,0,0,20,12
1927096,63,6,1950,12,"female",1568,514,184,160,41,160,31,0,10
1927105,26,2,1987,2,"male",87,131,115,11,7,0,3,11,4
1927132,88,29,1925,8,"male",1582,27,15,1,54,0,35,1,19
1927154,37,3,1976,6,"female",464,31,25,91,111,64,64,27,47
1927158,19,30,1994,7,"male",192,20,18,3,1,3,1,0,0
1927190,18,1,1995,5,"female",20,57,22,0,1,0,1,0,0
1927221,69,19,1944,12,"female",436,10,7,17,7,0,4,17,3
1927222,26,21,1987,9,"male",1287,370,108,63,54,63,46,0,8
1927234,103,1,1910,9,"female",1040,243,92,88,234,0,59,88,175
1927256,40,10,1973,10,"male",304,35,13,2094,125,2094,76,0,49
1927275,27,18,1986,2,"male",412,161,131,34,4,34,3,0,1
1927278,28,11,1985,7,"female",458,98,86,174,74,50,46,124,28
1927282,28,22,1985,9,"male",591,170,120,8,0,4,0,4,0
1927304,24,1,1989,1,"female",60,8,8,1,0,1,0,0,0
1927312,33,19,1980,4,"female",1291,169,18,0,2,0,0,0,2
1927313,27,2,1986,2,"male",14,0,0,0,0,0,0,0,0
1927316,101,17,1912,8,"female",492,52,26,0,0,0,0,0,0
1927330,23,24,1990,8,"female",466,285,112,213,115,118,20,95,95
1927334,23,30,1990,11,"male",154,167,126,2,11,2,2,0,9
1927412,58,27,1955,4,"female",2223,510,243,54,126,1,43,53,83
1927450,23,28,1990,12,"female",397,87,12,3,0,1,0,2,0
1927455,66,10,1947,8,"female",1744,209,78,270,44,47,29,223,15
1927501,15,29,1998,8,"male",92,33,25,0,0,0,0,0,0
1927516,105,17,1908,7,"female",1492,104,37,149,8,149,6,0,2
1927549,54,25,1959,3,"male",507,2,1,0,0,0,0,0,0
1927556,59,27,1954,7,"female",463,67,26,68,17,0,0,68,17
1927565,32,22,1981,9,"male",136,27,26,0,0,0,0,0,0
1927582,15,8,1998,9,"male",484,341,264,4,7,0,1,4,6
1927588,26,15,1987,7,"female",799,42,9,1,2,1,2,0,0
1927590,55,16,1958,10,"female",614,18,1,0,0,0,0,0,0
1927595,26,23,1987,10,"male",624,356,238,0,0,0,0,0,0
1927599,21,1,1992,6,"female",56,1,1,0,0,0,0,0,0
1927601,43,24,1970,12,"male",448,5,4,0,5,0,3,0,2
1927607,38,9,1975,12,"female",172,24,16,127,46,127,30,0,16
1927609,93,21,1920,8,"female",1592,346,147,361,561,360,414,1,147
1927626,44,28,1969,10,"female",110,20,15,0,0,0,0,0,0
1927632,17,10,1996,6,"female",672,43,8,152,85,152,82,0,3
1927639,37,29,1976,4,"female",229,181,175,0,0,0,0,0,0
1927678,19,27,1994,2,"female",240,335,189,56,33,56,32,0,1
1927725,13,8,2000,7,"female",94,316,249,158,105,23,75,135,30
1927730,14,4,1999,1,"female",149,487,366,3382,4282,335,1873,3047,2409
1927754,28,1,1985,2,"male",337,96,85,0,0,0,0,0,0
1927805,62,17,1951,12,"male",1381,351,162,1549,361,0,93,1549,268
1927838,22,2,1991,1,"male",489,233,173,3,4,3,3,0,1
1927839,27,30,1986,3,"male",488,229,191,193,421,81,99,112,322
1927854,35,16,1978,3,"male",1105,24,15,2,4,2,2,0,2
1927892,43,10,1970,7,"female",285,180,143,19,5,19,5,0,0
1927894,19,16,1994,11,"male",1304,332,208,7,24,7,15,0,9
1927896,59,30,1954,9,"female",603,143,57,527,411,0,7,527,404
1927917,21,8,1992,2,"male",879,171,132,35,12,35,8,0,4
1927928,25,1,1988,1,"male",109,0,0,0,0,0,0,0,0
1927955,26,1,1987,6,"male",517,38,22,15,17,15,17,0,0
1927963,22,12,1991,10,"female",430,182,150,458,543,255,359,203,184
1927982,18,5,1995,7,"female",283,142,103,7,30,7,23,0,7
1927999,68,17,1945,8,"female",309,27,24,0,0,0,0,0,0
1928008,44,10,1969,5,"male",1784,201,51,3,1,3,1,0,0
1928035,21,26,1992,1,"male",92,26,18,229,187,159,113,70,74
1928067,19,12,1994,8,"male",34,76,65,4,17,0,5,4,12
1928095,61,21,1952,9,"female",906,44,30,13,15,0,10,13,5
1928098,108,16,1905,1,"female",843,18,8,0,0,0,0,0,0
1928117,113,13,1900,5,"male",1524,223,53,7,3,6,1,1,2
1928123,37,22,1976,12,"male",250,114,42,57,18,32,6,25,12
1928139,108,8,1905,3,"male",1019,604,571,0,5,0,4,0,1
1928149,34,25,1979,6,"female",401,190,148,1844,916,1710,631,134,285
1928161,19,10,1994,4,"female",373,278,59,44,24,44,14,0,10
1928167,29,19,1984,7,"male",295,248,179,69,129,63,107,6,22
1928226,28,5,1985,9,"male",354,120,96,186,66,186,28,0,38
1928231,20,28,1993,11,"male",448,484,442,198,25,198,20,0,5
1928247,46,13,1967,9,"male",935,123,50,1900,639,1855,516,45,123
1928263,19,21,1994,9,"female",334,453,250,359,1046,332,470,27,576
1928274,24,15,1989,2,"male",943,37,18,0,0,0,0,0,0
1928314,79,26,1934,1,"female",672,53,35,205,34,0,15,205,19
1928316,23,22,1990,3,"male",283,63,49,3,0,3,0,0,0
1928322,51,20,1962,3,"male",2297,110,18,5,1,5,0,0,1
1928330,66,24,1947,12,"male",1369,41,8,102,32,102,21,0,11
1928379,17,10,1996,10,"male",533,73,61,6,1,6,1,0,0
1928412,47,2,1966,2,"male",487,73,58,356,59,356,45,0,14
1928425,24,20,1989,7,"male",374,210,139,21,10,21,9,0,1
1928447,17,1,1996,3,"female",274,12,8,100,1,100,0,0,1
1928457,68,18,1945,3,"female",2134,121,37,0,1,0,1,0,0
1928463,19,11,1994,4,"male",589,317,141,0,0,0,0,0,0
1928498,39,27,1974,7,"male",681,161,123,0,0,0,0,0,0
1928530,19,10,1994,7,"female",721,1751,1180,115,206,72,160,43,46
1928537,23,2,1990,12,"male",801,414,201,3,0,3,0,0,0
1928549,69,3,1944,9,"male",1285,94,12,1,1,0,1,1,0
1928551,15,23,1998,12,"male",174,68,36,31,31,31,15,0,16
1928555,79,4,1934,11,"female",1317,82,41,5,2,5,2,0,0
1928559,95,27,1918,11,"male",85,157,95,5,13,0,1,5,12
1928568,57,15,1956,4,"male",1268,37,26,3,0,0,0,3,0
1928578,19,18,1994,11,"female",871,237,109,7,2,7,1,0,1
1928579,17,4,1996,11,"male",374,441,280,227,366,128,110,99,256
1928620,74,5,1939,7,"female",456,13,9,1,10,0,1,1,9
1928630,103,12,1910,11,"female",1554,649,74,0,2,0,1,0,1
1928632,33,15,1980,7,"female",78,135,126,2,4,2,3,0,1
1928646,20,10,1993,5,"female",198,4,3,0,0,0,0,0,0
1928648,100,22,1913,3,"female",1870,220,58,115,40,100,19,15,21
1928686,13,14,2000,4,"female",567,458,274,842,204,842,52,0,152
1928694,65,24,1948,9,"female",465,34,24,1,1,0,1,1,0
1928698,29,7,1984,5,"female",220,88,45,0,0,0,0,0,0
1928701,23,17,1990,5,"female",667,47,23,0,5,0,5,0,0
1928708,19,23,1994,10,"male",46,71,52,67,58,64,23,3,35
1928736,68,3,1945,2,"male",638,163,141,33,51,33,47,0,4
1928769,23,6,1990,4,"male",830,113,98,7,10,7,9,0,1
1928790,18,13,1995,5,"female",548,867,532,32,4,0,0,32,4
1928807,29,11,1984,1,"female",221,2,1,0,0,0,0,0,0
1928818,25,1,1988,1,"male",209,151,53,141,179,141,126,0,53
1928848,16,1,1997,1,"male",133,172,149,0,2,0,1,0,1
1928884,36,29,1977,9,"female",198,62,51,0,0,0,0,0,0
1928887,65,20,1948,7,"female",170,50,45,22,1,0,0,22,1
1928916,15,25,1998,5,"male",566,335,252,34,8,34,6,0,2
1928922,19,7,1994,2,"male",379,169,102,5,0,5,0,0,0
1928943,28,2,1985,5,"female",404,59,31,28,46,26,11,2,35
1928949,22,19,1991,11,"female",1278,639,316,1674,2192,0,585,1674,1607
1928957,25,1,1988,1,"male",106,31,29,0,0,0,0,0,0
1928959,31,22,1982,8,"male",980,101,27,45,59,17,32,28,27
1928969,33,1,1980,1,"male",322,2,2,1,0,1,0,0,0
1928975,54,6,1959,2,"male",1274,431,181,27,44,24,12,3,32
1928998,67,28,1946,11,"male",1959,61,24,9,34,0,18,9,16
1929023,100,11,1913,8,"female",261,249,171,1897,336,1897,302,0,34
1929025,26,27,1987,4,"female",326,10,7,146,45,120,25,26,20
1929052,65,8,1948,12,"female",694,41,16,7,4,7,4,0,0
1929068,50,7,1963,2,"male",971,39,3,33,44,26,9,7,35
1929091,16,14,1997,10,"female",54,223,7,9,22,0,0,9,22
1929096,60,16,1953,10,"male",510,148,65,1,7,0,3,1,4
1929099,54,23,1959,11,"female",430,37,4,4,19,4,15,0,4
1929177,52,2,1961,1,"female",672,216,131,93,176,0,66,93,110
1929245,48,26,1965,12,"female",213,9,3,3,1,3,1,0,0
1929253,43,23,1970,2,"female",148,86,50,138,87,12,9,126,78
1929269,27,11,1986,11,"male",18,34,26,6,4,6,1,0,3
1929301,39,25,1974,1,"male",473,13,10,0,0,0,0,0,0
1929317,51,16,1962,2,"female",380,59,36,193,83,193,47,0,36
1929370,23,19,1990,9,"male",675,39,17,0,1,0,1,0,0
1929395,57,31,1956,1,"male",266,78,74,0,20,0,13,0,7
1929423,17,3,1996,5,"male",35,21,9,0,0,0,0,0,0
1929430,21,27,1992,5,"male",203,2,1,0,0,0,0,0,0
1929450,27,21,1986,2,"female",325,311,255,1545,1267,1534,1206,11,61
1929479,23,1,1990,1,"male",61,67,38,60,5,60,3,0,2
1929484,18,3,1995,9,"male",913,150,78,1,7,1,4,0,3
1929518,23,24,1990,11,"male",52,14,12,0,0,0,0,0,0
1929544,42,11,1971,2,"female",376,1,1,2,0,0,0,2,0
1929573,68,16,1945,6,"female",803,290,110,9,5,9,3,0,2
1929594,36,16,1977,3,"male",339,5,2,8,12,8,5,0,7
1929611,22,25,1991,12,"male",400,211,149,105,90,58,28,47,62
1929612,25,1,1988,2,"female",657,61,51,10,12,10,8,0,4
1929643,20,30,1993,7,"female",362,183,132,3,87,3,65,0,22
1929681,16,8,1997,2,"male",495,414,160,396,124,396,112,0,12
1929695,17,8,1996,1,"male",524,218,79,44,54,7,13,37,41
1929700,33,19,1980,9,"female",482,53,31,7,0,0,0,7,0
1929749,16,18,1997,3,"male",33,129,124,1,2,1,2,0,0
1929751,34,11,1979,1,"female",208,154,61,2447,1602,2447,402,0,1200
1929752,19,27,1994,8,"male",967,73,43,7,1,1,1,6,0
1929754,45,9,1968,6,"male",294,21,16,0,0,0,0,0,0
1929787,19,15,1994,8,"male",496,283,248,107,55,107,51,0,4
1929802,29,28,1984,7,"male",151,69,16,1,0,1,0,0,0
1929816,16,6,1997,6,"female",337,379,254,722,112,722,107,0,5
1929819,16,17,1997,11,"male",392,113,91,0,0,0,0,0,0
1929882,26,14,1987,7,"male",663,51,48,75,8,25,2,50,6
1929885,20,4,1993,3,"female",392,49,20,24,20,24,8,0,12
1929916,21,13,1992,8,"male",808,386,120,6,16,4,10,2,6
1929946,19,7,1994,7,"female",294,242,44,0,0,0,0,0,0
1929964,69,7,1944,11,"female",1467,119,40,87,79,1,52,86,27
1929977,29,16,1984,4,"female",364,1,1,0,0,0,0,0,0
1929983,19,17,1994,8,"male",318,36,20,0,2,0,0,0,2
1930004,43,16,1970,9,"female",765,180,78,2461,15,2461,14,0,1
1930008,23,1,1990,1,"male",118,7,6,4,0,0,0,4,0
1930010,35,7,1978,12,"male",199,0,0,0,0,0,0,0,0
1930022,58,6,1955,5,"female",141,56,46,869,215,0,30,869,185
1930028,25,4,1988,2,"male",341,194,158,503,262,424,108,79,154
1930035,25,25,1988,9,"male",934,48,28,2,1,2,1,0,0
1930036,17,29,1996,12,"male",329,13,11,0,0,0,0,0,0
1930065,23,19,1990,3,"male",527,158,137,21,39,21,33,0,6
1930067,21,10,1992,11,"male",107,326,281,367,160,213,90,154,70
1930068,22,17,1991,4,"female",60,32,20,206,149,157,22,49,127
1930072,14,14,1999,6,"female",460,570,303,104,91,5,14,99,77
1930079,18,6,1995,2,"male",404,151,129,0,0,0,0,0,0
1930085,103,10,1910,10,"male",1204,261,85,259,348,56,60,203,288
1930086,14,10,1999,7,"female",15,219,9,26,35,26,20,0,15
1930092,65,20,1948,11,"male",561,14,10,22,12,22,10,0,2
1930095,27,25,1986,3,"male",108,145,112,41,439,41,309,0,130
1930124,50,23,1963,2,"male",309,79,22,1,9,0,1,1,8
1930161,71,1,1942,3,"female",188,37,25,7,36,0,31,7,5
1930170,108,26,1905,4,"male",39,7,5,11,1,11,0,0,1
1930176,15,14,1998,12,"male",670,77,36,111,71,111,29,0,42
1930181,17,19,1996,5,"female",560,154,93,6,48,6,36,0,12
1930221,106,19,1907,7,"male",1419,79,60,29,7,28,2,1,5
1930225,24,6,1989,3,"male",438,15,14,0,0,0,0,0,0
1930247,60,11,1953,9,"male",1596,40,22,10,8,6,6,4,2
1930250,32,1,1981,1,"male",663,11,6,0,0,0,0,0,0
1930251,102,24,1911,5,"male",760,87,40,39,11,7,6,32,5
1930265,71,23,1942,7,"female",1099,24,18,7,13,7,11,0,2
1930274,25,14,1988,1,"male",229,271,168,161,224,44,75,117,149
1930279,17,8,1996,10,"male",701,79,78,13,1,0,0,13,1
1930301,23,13,1990,7,"female",575,185,118,209,108,69,28,140,80
1930330,22,26,1991,3,"male",361,2,1,0,0,0,0,0,0
1930339,44,17,1969,3,"male",1013,264,232,405,127,241,97,164,30
1930344,25,11,1988,4,"male",103,1,0,1,1,1,1,0,0
1930362,34,9,1979,8,"female",237,167,120,232,321,229,234,3,87
1930395,103,20,1910,6,"male",689,309,220,0,0,0,0,0,0
1930403,72,14,1941,12,"female",1224,26,17,0,0,0,0,0,0
1930435,21,11,1992,7,"female",333,68,41,221,131,221,61,0,70
1930490,43,21,1970,6,"male",1206,75,64,141,18,140,11,1,7
1930506,31,4,1982,2,"male",232,1,0,1,2,0,0,1,2
1930519,20,2,1993,7,"female",252,72,53,88,111,1,25,87,86
1930545,26,15,1987,11,"male",417,19,5,2,22,2,15,0,7
1930562,51,30,1962,4,"male",226,30,18,7,3,7,3,0,0
1930581,29,18,1984,8,"female",303,113,59,3,0,3,0,0,0
1930595,51,28,1962,7,"male",808,34,17,110,40,110,32,0,8
1930605,20,21,1993,9,"male",345,48,31,0,0,0,0,0,0
1930630,28,15,1985,10,"male",711,149,21,1,6,1,4,0,2
1930650,52,26,1961,12,"female",2454,287,114,467,296,193,120,274,176
1930667,92,18,1921,10,"male",475,23,10,3,0,0,0,3,0
1930675,108,8,1905,7,"male",149,448,407,8,31,8,30,0,1
1930677,33,30,1980,12,"male",349,36,12,1,0,1,0,0,0
1930713,53,16,1960,1,"female",258,33,21,176,223,176,95,0,128
1930718,89,20,1924,7,"male",368,274,206,9,0,9,0,0,0
1930741,22,1,1991,5,"male",390,172,121,619,188,503,80,116,108
1930767,24,25,1989,5,"female",462,114,90,32,86,32,65,0,21
1930804,21,4,1992,12,"female",674,413,254,112,180,77,69,35,111
1930808,27,7,1986,9,"male",2089,769,406,2,1,2,1,0,0
1930843,40,16,1973,2,"male",1489,193,44,49,49,36,30,13,19
1930877,61,1,1952,11,"female",96,15,8,27,8,3,3,24,5
1930889,48,30,1965,3,"male",500,20,7,0,0,0,0,0,0
1930901,60,8,1953,2,"female",710,17,7,0,0,0,0,0,0
1930905,21,1,1992,9,"female",219,20,14,1,0,1,0,0,0
1930908,72,15,1941,5,"female",173,26,12,11,2,11,1,0,1
1930931,66,5,1947,11,"female",357,27,13,98,5,98,5,0,0
1930951,20,16,1993,1,"male",356,29,20,42,0,39,0,3,0
1930953,27,17,1986,6,"male",168,139,79,27,29,27,28,0,1
1930967,56,25,1957,2,"female",1769,118,68,132,253,110,149,22,104
1930971,28,15,1985,8,"male",694,42,32,7,2,7,0,0,2
1930989,16,27,1997,9,"female",145,0,0,0,0,0,0,0,0
1930998,18,23,1995,10,"male",278,215,109,1,1,1,1,0,0
1931016,53,27,1960,1,"male",1579,1,0,0,0,0,0,0,0
1931017,68,17,1945,8,"male",979,830,363,371,334,371,300,0,34
1931051,30,16,1983,5,"male",12,58,54,5,1,0,0,5,1
1931069,21,22,1992,5,"male",310,276,221,285,201,205,127,80,74
1931085,14,28,1999,4,"male",312,116,93,4,8,0,7,4,1
1931099,30,19,1983,6,"female",239,11,10,7,0,7,0,0,0
1931104,18,2,1995,7,"male",7,22,21,1,1,1,1,0,0
1931144,18,21,1995,4,"male",180,33,27,22,1,0,1,22,0
1931172,47,20,1966,6,"female",457,110,72,306,335,306,218,0,117
1931181,51,21,1962,9,"female",140,57,39,1328,69,1328,45,0,24
1931190,21,5,1992,9,"female",592,209,29,39,29,39,28,0,1
1931193,16,9,1997,6,"male",284,116,71,0,5,0,1,0,4
1931203,24,14,1989,11,"male",1547,246,150,97,100,97,45,0,55
1931207,48,25,1965,5,"male",590,73,66,1,1,1,1,0,0
1931243,77,3,1936,1,"male",166,42,18,1,1,0,1,1,0
1931244,19,1,1994,5,"male",574,890,733,119,762,44,355,75,407
1931254,24,5,1989,3,"male",37,25,8,6,1,6,0,0,1
1931277,40,31,1973,8,"male",558,16,5,0,1,0,1,0,0
1931288,108,28,1905,10,"male",42,25,6,0,0,0,0,0,0
1931297,36,3,1977,2,"male",540,56,32,50,1,50,0,0,1
1931318,52,13,1961,2,"female",630,0,0,0,0,0,0,0,0
1931327,38,10,1975,2,"male",362,51,45,5,3,5,1,0,2
1931377,19,27,1994,3,"male",195,298,69,3,43,3,31,0,12
1931382,60,12,1953,1,"male",212,58,54,0,0,0,0,0,0
1931383,25,9,1988,9,"female",516,1037,442,1911,2002,1775,1271,136,731
1931421,103,7,1910,5,"male",426,597,278,133,775,133,664,0,111
1931434,29,4,1984,1,"male",498,196,151,5,5,5,3,0,2
1931458,42,1,1971,1,"male",13,44,36,26,5,26,4,0,1
1931468,42,14,1971,2,"female",943,135,60,148,132,117,88,31,44
1931476,38,17,1975,2,"male",1104,69,25,58,12,0,11,58,1
1931489,17,19,1996,1,"male",382,184,130,0,0,0,0,0,0
1931512,29,12,1984,1,"male",936,263,186,127,157,127,59,0,98
1931518,17,9,1996,5,"male",4,27,12,4,15,4,15,0,0
1931520,48,22,1965,12,"male",1769,81,41,15,14,5,7,10,7
1931528,22,27,1991,11,"female",266,26,22,0,7,0,4,0,3
1931530,23,7,1990,4,"male",662,275,178,1,0,1,0,0,0
1931562,16,4,1997,3,"male",834,250,195,3,1,2,0,1,1
1931573,30,5,1983,9,"female",372,328,205,276,325,99,173,177,152
1931651,20,3,1993,3,"male",374,512,465,6,3,6,2,0,1
1931654,26,30,1987,7,"male",239,369,285,15,13,15,6,0,7
1931657,17,2,1996,1,"male",30,5,5,0,0,0,0,0,0
1931683,55,28,1958,11,"male",468,148,101,1,1,0,1,1,0
1931687,38,25,1975,9,"male",20,12,11,255,48,171,6,84,42
1931705,54,3,1959,12,"male",378,44,22,85,3,85,0,0,3
1931719,38,18,1975,8,"male",203,0,0,0,0,0,0,0,0
1931725,29,22,1984,1,"male",579,54,25,0,1,0,1,0,0
1931747,76,27,1937,10,"female",370,83,42,572,29,0,6,572,23
1931753,21,3,1992,11,"male",354,107,90,2,0,2,0,0,0
1931772,102,7,1911,10,"male",381,36,30,2,0,2,0,0,0
1931780,19,22,1994,10,"male",466,350,206,149,354,124,266,25,88
1931798,108,31,1905,1,"male",1709,308,91,2,17,0,13,2,4
1931811,58,1,1955,12,"female",489,268,196,10,22,10,22,0,0
1931825,17,26,1996,8,"male",351,84,50,80,39,80,34,0,5
1931860,23,19,1990,6,"male",250,41,26,16,7,1,4,15,3
1931892,34,3,1979,9,"female",796,566,99,469,665,262,197,207,468
1931896,22,15,1991,3,"male",838,114,102,0,14,0,10,0,4
1931906,21,25,1992,9,"male",384,153,34,7672,1492,7453,1292,219,200
1931919,23,11,1990,11,"male",501,320,203,78,88,18,31,60,57
1931931,29,12,1984,12,"male",811,98,77,3,4,2,2,1,2
1931968,18,29,1995,5,"female",571,2,1,0,0,0,0,0,0
1931981,103,29,1910,10,"female",725,576,454,196,313,196,232,0,81
1931993,26,3,1987,5,"female",164,40,15,0,0,0,0,0,0
1931995,100,15,1913,2,"male",1377,109,12,17,58,16,19,1,39
1931997,26,16,1987,8,"female",126,1,0,0,0,0,0,0,0
1932008,16,3,1997,3,"male",262,474,355,123,1,49,1,74,0
1932015,49,17,1964,8,"female",1606,184,132,181,97,173,69,8,28
1932020,80,3,1933,7,"male",515,115,57,0,1,0,1,0,0
1932038,22,12,1991,9,"male",264,305,275,15,8,15,8,0,0
1932084,25,8,1988,8,"male",202,53,28,0,0,0,0,0,0
1932089,27,3,1986,9,"male",490,4,4,0,0,0,0,0,0
1932095,53,24,1960,3,"female",1175,72,50,6,12,6,10,0,2
1932101,27,19,1986,8,"male",282,28,17,0,0,0,0,0,0
1932115,21,3,1992,6,"male",747,649,491,144,20,144,14,0,6
1932129,22,20,1991,1,"male",52,3,1,1,3,1,3,0,0
1932135,113,11,1900,7,"female",1622,83,47,0,0,0,0,0,0
1932139,54,15,1959,8,"male",715,27,15,0,0,0,0,0,0
1932172,23,24,1990,8,"male",29,46,26,9,13,9,13,0,0
1932221,62,11,1951,1,"male",504,12,11,0,0,0,0,0,0
1932225,16,3,1997,6,"male",488,258,105,60,19,5,14,55,5
1932226,50,26,1963,12,"female",833,154,73,2710,744,1533,253,1177,491
1932310,108,7,1905,7,"male",175,94,82,3,0,3,0,0,0
1932332,26,14,1987,6,"female",542,426,316,62,66,3,13,59,53
1932350,75,1,1938,10,"male",1133,80,63,1,0,1,0,0,0
1932356,33,16,1980,11,"male",148,18,15,0,0,0,0,0,0
1932364,56,13,1957,5,"female",569,57,45,17,25,17,13,0,12
1932410,17,19,1996,3,"male",270,99,36,69,44,63,23,6,21
1932416,33,13,1980,5,"male",525,36,10,0,9,0,8,0,1
1932435,27,25,1986,1,"male",341,13,11,17,1,0,1,17,0
1932447,113,27,1900,12,"female",1317,205,28,1,1,0,1,1,0
1932450,26,18,1987,10,"male",348,34,15,1,1,0,0,1,1
1932477,43,21,1970,12,"female",105,24,19,38,36,38,10,0,26
1932495,31,2,1982,2,"male",268,59,37,18,1,18,1,0,0
1932502,30,23,1983,4,"female",482,20,4,117,98,117,40,0,58
1932519,64,4,1949,4,"female",638,29,24,74,0,74,0,0,0
1932544,99,8,1914,7,"male",503,770,545,10,5,10,5,0,0
1932547,24,15,1989,3,"male",490,92,80,0,0,0,0,0,0
1932553,30,1,1983,8,"male",559,83,47,6,1,6,1,0,0
1932631,39,12,1974,11,"male",244,10,6,11,15,11,12,0,3
1932638,85,16,1928,1,"male",1161,177,83,16,184,0,60,16,124
1932656,53,20,1960,12,"male",737,30,6,3,0,3,0,0,0
1932660,64,25,1949,7,"female",263,31,14,0,0,0,0,0,0
1932681,25,16,1988,3,"female",416,163,144,0,0,0,0,0,0
1932682,17,20,1996,3,"male",257,120,54,0,0,0,0,0,0
1932713,19,14,1994,1,"female",417,536,429,38,101,38,91,0,10
1932731,29,25,1984,5,"male",119,114,59,1,3,1,2,0,1
1932743,28,13,1985,2,"female",152,92,61,2,4,0,1,2,3
1932749,21,11,1992,10,"male",104,62,39,0,0,0,0,0,0
1932793,31,28,1982,10,"male",453,294,283,25,8,13,3,12,5
1932810,15,23,1998,2,"male",271,555,339,3,64,3,46,0,18
1932824,58,15,1955,9,"male",203,15,15,0,0,0,0,0,0
1932833,53,19,1960,6,"female",71,87,83,333,71,333,53,0,18
1932842,33,14,1980,12,"male",537,60,54,4,0,3,0,1,0
1932847,33,1,1980,9,"male",43,145,54,1,3,1,3,0,0
1932852,19,24,1994,8,"female",318,52,29,297,149,4,49,293,100
1932861,23,1,1990,8,"female",312,45,31,2046,635,2045,314,1,321
1932862,42,8,1971,7,"male",580,68,52,0,0,0,0,0,0
1932866,21,20,1992,7,"female",481,126,98,23,39,23,24,0,15
1932867,19,27,1994,1,"male",554,24,7,6,14,6,11,0,3
1932901,53,17,1960,11,"female",1208,94,40,8,43,6,28,2,15
1932911,33,13,1980,12,"male",6,0,0,0,2,0,0,0,2
1932934,41,1,1972,3,"male",1033,37,21,4,2,4,2,0,0
1932974,37,26,1976,9,"female",87,361,44,82,35,0,16,82,19
1932983,57,17,1956,5,"female",0,0,0,0,0,0,0,0,0
1933033,22,2,1991,2,"male",233,27,8,0,0,0,0,0,0
1933066,25,26,1988,6,"female",366,116,70,0,13,0,12,0,1
1933074,21,15,1992,1,"male",103,77,25,24,40,24,26,0,14
1933077,17,25,1996,9,"female",167,101,32,19,14,10,12,9,2
1933090,60,2,1953,8,"male",520,37,28,5,5,5,4,0,1
1933106,23,10,1990,10,"male",361,727,533,2960,756,2960,604,0,152
1933120,22,30,1991,5,"female",1185,20,5,65,87,45,45,20,42
1933140,22,16,1991,8,"female",284,66,32,63,105,40,46,23,59
1933153,74,4,1939,7,"male",463,129,98,33,12,0,5,33,7
1933175,21,25,1992,3,"male",17,0,0,3,24,3,7,0,17
1933182,18,21,1995,8,"male",592,36,24,0,0,0,0,0,0
1933188,29,26,1984,8,"male",604,90,61,0,0,0,0,0,0
1933220,18,13,1995,5,"male",410,49,40,31,5,0,0,31,5
1933236,22,28,1991,4,"male",412,668,562,1,8,0,7,1,1
1933268,33,17,1980,9,"male",372,91,52,1,23,0,7,1,16
1933276,62,17,1951,4,"male",483,51,19,0,2,0,2,0,0
1933277,19,17,1994,1,"male",494,340,187,19,32,19,19,0,13
1933290,50,5,1963,6,"male",284,130,51,12,4,12,1,0,3
1933292,41,11,1972,12,"male",1006,401,323,56,34,56,26,0,8
1933300,51,2,1962,7,"male",677,19,5,5,0,5,0,0,0
1933307,27,2,1986,12,"female",602,113,32,9,0,9,0,0,0
1933322,19,3,1994,7,"female",287,225,96,0,0,0,0,0,0
1933335,62,15,1951,4,"female",848,84,49,35,1,35,1,0,0
1933346,23,8,1990,8,"male",150,251,245,21,9,21,7,0,2
1933370,47,24,1966,10,"male",580,62,18,141,105,140,86,1,19
1933404,19,23,1994,8,"male",554,841,613,308,362,308,166,0,196
1933431,20,8,1993,8,"female",1591,1855,744,1689,1416,1355,729,334,687
1933434,23,8,1990,11,"male",342,55,35,0,2,0,0,0,2
1933459,23,24,1990,7,"male",356,154,127,3,7,0,6,3,1
1933463,50,3,1963,10,"female",358,121,95,48,44,14,11,34,33
1933467,17,23,1996,4,"male",723,1,1,0,0,0,0,0,0
1933474,20,14,1993,12,"female",494,281,100,301,242,36,156,265,86
1933481,38,25,1975,3,"female",269,0,0,0,0,0,0,0,0
1933500,67,16,1946,9,"female",2048,206,99,244,122,188,44,56,78
1933516,69,9,1944,12,"female",760,769,525,78,56,31,31,47,25
1933517,23,28,1990,2,"female",744,366,265,56,52,26,14,30,38
1933518,20,6,1993,12,"male",363,30,22,11,4,3,2,8,2
1933551,55,25,1958,5,"male",110,38,25,0,0,0,0,0,0
1933552,35,5,1978,1,"female",321,115,66,0,0,0,0,0,0
1933560,24,3,1989,10,"male",364,293,258,7,8,7,7,0,1
1933566,32,4,1981,4,"female",1571,1100,223,406,1073,59,523,347,550
1933594,64,22,1949,9,"male",764,19,13,78,2,78,1,0,1
1933609,24,2,1989,3,"male",631,89,52,6,0,1,0,5,0
1933614,38,20,1975,3,"male",89,0,0,0,0,0,0,0,0
1933633,22,22,1991,9,"female",41,35,28,5,12,5,11,0,1
1933634,32,28,1981,4,"female",581,731,491,56,102,56,93,0,9
1933693,18,21,1995,1,"male",101,20,7,0,0,0,0,0,0
1933695,18,12,1995,2,"male",40,12,9,0,0,0,0,0,0
1933697,28,2,1985,12,"male",204,116,29,0,1,0,0,0,1
1933734,17,1,1996,1,"female",17,10,6,1,1,1,1,0,0
1933749,56,30,1957,4,"female",1330,17,11,16,2,16,1,0,1
1933766,18,8,1995,2,"male",311,317,189,37,44,37,39,0,5
1933767,59,9,1954,2,"male",459,257,144,34,16,34,9,0,7
1933777,18,26,1995,10,"female",448,143,47,37,18,37,16,0,2
1933801,56,14,1957,3,"female",267,92,47,80,382,69,126,11,256
1933838,19,5,1994,9,"female",306,171,122,694,386,91,101,603,285
1933853,23,24,1990,8,"male",490,62,47,0,0,0,0,0,0
1933862,21,27,1992,8,"male",425,88,17,28,5,17,2,11,3
1933884,25,4,1988,8,"female",482,115,55,1,0,1,0,0,0
1933889,27,5,1986,3,"male",721,23,9,0,0,0,0,0,0
1933905,23,25,1990,6,"female",26,12,10,0,0,0,0,0,0
1933910,16,8,1997,2,"male",566,1277,972,0,3,0,2,0,1
1933912,43,19,1970,2,"male",336,33,32,19,8,19,5,0,3
1933915,14,3,1999,10,"female",94,164,87,73,59,56,32,17,27
1933934,61,6,1952,7,"female",234,103,74,1242,284,0,129,1242,155
1933937,27,28,1986,7,"male",447,0,0,0,0,0,0,0,0
1933948,34,15,1979,12,"male",88,1,1,0,0,0,0,0,0
1933965,25,1,1988,1,"male",526,56,27,30,89,30,52,0,37
1933970,19,20,1994,9,"male",538,27,10,10,0,0,0,10,0
1933991,59,23,1954,9,"female",370,45,22,98,25,98,11,0,14
1934010,20,15,1993,10,"female",578,25,1,8,38,8,35,0,3
1934020,24,27,1989,8,"female",531,79,42,6,1,6,1,0,0
1934029,58,10,1955,4,"female",1492,5,2,0,0,0,0,0,0
1934031,38,2,1975,12,"female",591,55,35,1,2,1,2,0,0
1934043,29,28,1984,9,"male",411,99,63,105,39,65,29,40,10
1934065,24,10,1989,12,"female",134,43,15,0,0,0,0,0,0
1934108,18,4,1995,2,"female",592,51,27,0,0,0,0,0,0
1934121,38,5,1975,8,"male",66,21,10,108,61,108,53,0,8
1934150,19,18,1994,1,"male",242,11,10,14,0,14,0,0,0
1934173,83,2,1930,8,"male",1022,785,476,53,84,51,48,2,36
1934209,29,14,1984,11,"female",179,51,38,227,42,227,39,0,3
1934213,17,3,1996,8,"male",795,379,290,2,6,2,5,0,1
1934216,47,22,1966,2,"male",2123,88,32,2,8,2,7,0,1
1934217,16,13,1997,11,"male",1076,588,255,110,40,3,26,107,14
1934224,53,29,1960,12,"female",152,3,2,0,0,0,0,0,0
1934229,16,26,1997,2,"female",83,9,1,0,1,0,0,0,1
1934334,17,7,1996,12,"male",85,165,54,16,11,16,10,0,1
1934356,21,9,1992,11,"male",9,22,20,39,43,17,36,22,7
1934387,28,1,1985,1,"male",504,111,90,12,4,0,1,12,3
1934412,28,2,1985,5,"male",768,192,123,100,820,100,754,0,66
1934422,22,5,1991,5,"female",287,61,26,13,49,13,24,0,25
1934433,18,24,1995,4,"female",471,343,186,126,238,126,167,0,71
1934453,25,21,1988,3,"male",134,31,18,0,0,0,0,0,0
1934496,22,4,1991,7,"male",560,103,63,0,0,0,0,0,0
1934507,24,1,1989,1,"male",11,23,20,1,0,1,0,0,0
1934550,33,3,1980,6,"male",641,27,27,0,0,0,0,0,0
1934585,21,21,1992,6,"female",442,50,33,1,2,1,2,0,0
1934588,23,5,1990,2,"male",30,61,59,89,42,89,38,0,4
1934595,18,2,1995,2,"male",263,104,68,23,2,23,1,0,1
1934639,44,2,1969,3,"male",134,7,5,33,3,33,3,0,0
1934654,20,14,1993,10,"male",205,92,56,7,1,3,1,4,0
1934656,20,28,1993,11,"male",102,67,67,1,0,1,0,0,0
1934663,72,24,1941,5,"female",719,54,30,8,1,4,0,4,1
1934680,24,28,1989,5,"female",112,106,61,2,30,0,26,2,4
1934714,35,28,1978,7,"male",509,252,234,0,18,0,17,0,1
1934718,26,4,1987,4,"male",472,149,71,5,0,0,0,5,0
1934744,31,8,1982,12,"male",1237,99,56,39,11,16,7,23,4
1934745,59,1,1954,7,"male",725,77,45,5,8,3,4,2,4
1934746,59,29,1954,9,"male",644,8,8,0,0,0,0,0,0
1934748,62,12,1951,12,"female",1093,36,16,2,3,2,3,0,0
1934749,21,17,1992,5,"male",220,108,67,4,5,4,1,0,4
1934759,14,8,1999,9,"male",285,82,68,5,1,0,0,5,1
1934766,43,3,1970,1,"male",1499,1,1,3,0,1,0,2,0
1934771,26,12,1987,8,"male",114,35,26,5,6,5,6,0,0
1934791,65,8,1948,11,"male",928,270,35,13,0,13,0,0,0
1934824,16,22,1997,8,"male",443,1053,985,955,582,22,347,933,235
1934841,38,28,1975,8,"male",592,1,1,0,0,0,0,0,0
1934856,26,28,1987,4,"female",12,51,30,128,114,126,76,2,38
1934859,45,20,1968,6,"male",365,62,30,81,17,0,3,81,14
1934866,103,10,1910,12,"male",886,449,424,1,14,1,8,0,6
1934932,16,13,1997,8,"male",350,377,159,71,80,69,47,2,33
1934950,26,15,1987,3,"male",284,4,0,0,0,0,0,0,0
1934971,30,22,1983,9,"male",704,296,133,44,2,44,1,0,1
1934987,100,5,1913,9,"female",1632,104,42,26,0,14,0,12,0
1934998,26,12,1987,8,"male",885,305,181,234,483,234,453,0,30
1935011,108,25,1905,5,"female",1008,403,139,2,9,2,8,0,1
1935015,51,9,1962,9,"female",131,23,10,3,1,3,1,0,0
1935024,22,1,1991,8,"male",261,76,48,0,0,0,0,0,0
1935042,24,6,1989,10,"female",80,17,0,0,0,0,0,0,0
1935064,77,18,1936,6,"male",1303,732,607,94,181,56,87,38,94
1935083,56,19,1957,9,"female",845,41,15,1188,180,1188,135,0,45
1935137,65,29,1948,12,"female",1597,386,28,28,101,0,27,28,74
1935139,18,3,1995,6,"male",41,65,52,17,9,17,8,0,1
1935191,108,1,1905,10,"female",785,119,40,3,15,3,10,0,5
1935208,42,19,1971,1,"female",342,69,48,35,16,3,7,32,9
1935222,19,19,1994,2,"female",58,34,25,2,0,2,0,0,0
1935258,28,27,1985,2,"female",1015,236,126,2084,1056,1913,870,171,186
1935266,55,24,1958,6,"male",663,43,19,0,0,0,0,0,0
1935274,15,30,1998,9,"female",319,550,256,240,129,131,33,109,96
1935277,67,30,1946,11,"male",313,16,11,0,1,0,1,0,0
1935291,24,16,1989,2,"male",788,41,14,1,1,0,0,1,1
1935293,108,18,1905,4,"female",81,41,29,70,133,70,62,0,71
1935343,18,15,1995,4,"male",636,316,238,5,71,5,53,0,18
1935344,23,1,1990,3,"male",118,29,26,189,10,189,7,0,3
1935358,67,3,1946,2,"female",201,2,2,13,3,1,2,12,1
1935362,32,23,1981,3,"male",523,128,117,5,0,5,0,0,0
1935372,51,11,1962,10,"female",9,10,10,129,52,0,41,129,11
1935404,40,18,1973,8,"female",533,125,85,39,29,0,4,39,25
1935411,17,23,1996,7,"male",314,3,1,0,0,0,0,0,0
1935416,51,13,1962,5,"male",332,37,28,2,0,2,0,0,0
1935421,23,1,1990,12,"female",273,269,26,2,3,2,3,0,0
1935430,36,27,1977,3,"female",292,207,72,307,250,110,135,197,115
1935447,36,19,1977,12,"male",78,9,7,602,4,602,3,0,1
1935448,107,22,1906,4,"male",1065,91,49,89,247,36,157,53,90
1935463,21,3,1992,10,"male",451,164,139,4,0,4,0,0,0
1935473,14,8,1999,9,"male",170,104,62,6,0,2,0,4,0
1935560,63,14,1950,3,"female",501,35,15,463,2,463,2,0,0
1935569,23,10,1990,4,"female",149,375,220,354,204,354,110,0,94
1935575,21,10,1992,7,"male",310,116,99,34,5,34,5,0,0
1935581,21,29,1992,11,"female",22,7,0,1,0,1,0,0,0
1935582,56,3,1957,7,"female",941,63,34,42,151,1,102,41,49
1935599,16,5,1997,4,"female",331,562,56,327,509,327,418,0,91
1935607,30,7,1983,1,"male",352,41,15,270,0,270,0,0,0
1935631,16,2,1997,2,"male",346,137,80,6,11,1,6,5,5
1935663,58,6,1955,8,"female",600,30,22,96,10,0,0,96,10
1935681,22,29,1991,8,"female",659,58,4,6,2,6,2,0,0
1935686,14,26,1999,10,"female",244,419,186,482,259,482,182,0,77
1935693,17,17,1996,5,"male",139,160,122,4,6,4,6,0,0
1935697,71,9,1942,12,"female",708,65,43,0,11,0,8,0,3
1935702,25,1,1988,1,"male",230,18,17,1,1,1,1,0,0
1935708,13,17,2000,4,"male",165,129,74,4,28,4,15,0,13
1935732,23,20,1990,12,"male",528,300,254,0,1,0,0,0,1
1935776,32,7,1981,7,"female",195,47,35,10,7,10,7,0,0
1935785,21,6,1992,2,"male",162,80,57,8,15,8,13,0,2
1935799,20,17,1993,7,"male",869,799,521,131,83,131,75,0,8
1935821,102,10,1911,1,"male",1102,54,29,14,4,4,1,10,3
1935835,28,1,1985,1,"male",312,75,51,2,20,2,8,0,12
1935865,20,27,1993,6,"male",449,73,44,0,0,0,0,0,0
1935872,50,31,1963,1,"female",410,26,10,84,2,84,2,0,0
1935888,30,25,1983,10,"male",457,627,469,1089,239,1081,215,8,24
1935890,37,10,1976,9,"male",139,12,10,8,1,0,0,8,1
1935897,44,13,1969,6,"female",131,77,60,128,125,128,28,0,97
1935924,24,1,1989,4,"female",223,7,3,0,0,0,0,0,0
1935947,36,10,1977,6,"female",390,99,35,454,68,280,41,174,27
1935970,64,29,1949,4,"male",100,17,5,3,0,3,0,0,0
1935975,26,14,1987,12,"male",918,22,18,1,0,1,0,0,0
1935986,41,3,1972,5,"male",27,4,2,1,0,1,0,0,0
1936015,50,30,1963,7,"male",136,123,115,14,11,14,8,0,3
1936066,30,15,1983,11,"female",376,23,17,183,99,95,54,88,45
1936081,30,11,1983,10,"male",1797,86,46,11,19,9,18,2,1
1936083,17,3,1996,4,"female",5,25,9,1,4,1,2,0,2
1936090,15,5,1998,5,"female",286,228,30,2,15,2,8,0,7
1936122,37,6,1976,6,"female",1618,144,88,347,327,113,243,234,84
1936142,24,2,1989,9,"female",433,126,116,158,82,32,44,126,38
1936154,19,11,1994,3,"female",303,1073,481,198,460,115,307,83,153
1936177,21,9,1992,11,"female",340,120,63,10,11,10,7,0,4
1936186,17,8,1996,11,"male",234,35,30,0,0,0,0,0,0
1936231,21,1,1992,8,"female",760,206,79,6,0,0,0,6,0
1936241,48,20,1965,3,"male",153,27,16,0,0,0,0,0,0
1936247,18,21,1995,11,"male",412,257,189,26,20,26,16,0,4
1936262,54,14,1959,6,"female",1007,109,41,372,352,372,80,0,272
1936274,23,4,1990,7,"female",1022,14,9,74,19,74,13,0,6
1936283,19,12,1994,5,"female",371,228,101,2,11,2,3,0,8
1936325,19,1,1994,1,"male",328,73,54,63,140,63,135,0,5
1936372,25,24,1988,6,"male",180,31,31,15,28,15,22,0,6
1936376,45,6,1968,5,"female",555,30,9,16,2,16,2,0,0
1936409,28,29,1985,12,"female",275,0,0,0,0,0,0,0,0
1936437,78,15,1935,12,"female",151,4,1,3,6,3,2,0,4
1936456,108,8,1905,5,"male",1719,57,30,0,0,0,0,0,0
1936458,15,18,1998,12,"female",383,285,187,1,14,1,7,0,7
1936478,22,12,1991,12,"female",1600,175,94,28,270,28,170,0,100
1936525,28,13,1985,5,"female",561,235,110,50,37,50,36,0,1
1936540,51,3,1962,4,"male",575,53,35,19,1,19,0,0,1
1936618,17,10,1996,10,"male",297,241,203,2,4,0,0,2,4
1936637,20,7,1993,7,"female",432,113,43,14,20,6,13,8,7
1936639,33,20,1980,4,"male",168,12,10,227,5,227,3,0,2
1936648,59,29,1954,1,"female",1777,69,20,189,58,0,10,189,48
1936650,26,1,1987,1,"female",318,2,2,0,0,0,0,0,0
1936680,25,22,1988,3,"female",581,51,12,3,96,3,75,0,21
1936692,26,10,1987,11,"female",33,90,79,58,120,58,86,0,34
1936707,17,2,1996,9,"female",573,40,16,0,0,0,0,0,0
1936728,36,17,1977,2,NA,2130,515,292,3372,3168,2348,1812,1024,1356
1936755,33,11,1980,12,"male",92,24,11,0,0,0,0,0,0
1936791,40,6,1973,9,"male",256,61,43,312,7,192,5,120,2
1936832,27,23,1986,10,"female",593,39,19,293,600,289,370,4,230
1936833,68,13,1945,9,"male",1205,368,307,38,16,38,13,0,3
1936854,61,7,1952,8,"female",2108,29,14,52,10,0,5,52,5
1936866,43,11,1970,4,"female",195,155,92,153,130,153,110,0,20
1936867,48,6,1965,7,"male",1592,160,110,1885,230,1885,94,0,136
1936870,67,25,1946,9,"female",902,15,7,2,0,0,0,2,0
1936879,63,12,1950,1,"male",492,46,35,58,27,0,1,58,26
1936887,23,2,1990,8,"female",505,48,15,65,60,65,51,0,9
1936962,28,10,1985,10,"female",210,12,2,23,34,23,21,0,13
1936996,55,2,1958,12,"male",203,50,44,201,228,13,25,188,203
1937058,52,6,1961,10,"female",152,31,25,9,14,9,8,0,6
1937062,23,9,1990,10,"male",323,97,46,21,123,21,30,0,93
1937094,54,10,1959,12,"female",1454,264,133,72,216,69,116,3,100
1937097,27,26,1986,4,"male",375,18,10,0,4,0,0,0,4
1937106,27,5,1986,3,"male",325,40,30,0,0,0,0,0,0
1937129,19,26,1994,9,"female",362,229,152,8,7,8,5,0,2
1937130,51,16,1962,11,"male",115,48,46,4,5,0,4,4,1
1937153,29,9,1984,11,"male",247,60,32,30,8,13,0,17,8
1937158,65,5,1948,7,"male",1644,59,21,3,14,0,1,3,13
1937162,49,11,1964,3,"male",473,0,0,0,0,0,0,0,0
1937169,27,13,1986,3,"female",405,344,199,65,93,1,25,64,68
1937176,19,19,1994,2,"male",455,546,376,262,463,262,260,0,203
1937195,23,4,1990,1,"female",184,87,72,3,35,3,24,0,11
1937298,44,3,1969,6,"male",1134,58,37,0,0,0,0,0,0
1937307,16,10,1997,10,"male",3,0,0,0,0,0,0,0,0
1937313,17,4,1996,11,"male",752,314,120,178,39,177,27,1,12
1937340,14,3,1999,7,"female",309,321,187,183,73,183,20,0,53
1937342,102,28,1911,11,"male",935,578,391,155,17,141,13,14,4
1937346,25,9,1988,12,"male",274,91,69,6,1,6,1,0,0
1937352,44,26,1969,12,"female",460,205,159,463,367,145,193,318,174
1937354,21,5,1992,3,"male",487,148,52,0,18,0,13,0,5
1937357,21,20,1992,3,"male",634,203,97,304,422,197,208,107,214
1937376,69,15,1944,9,"female",346,2,1,0,0,0,0,0,0
1937379,90,9,1923,2,"male",1287,2474,336,2,12,0,2,2,10
1937399,32,1,1981,9,"male",1068,10,1,1,1,1,1,0,0
1937412,23,29,1990,12,"male",212,197,122,10,11,4,10,6,1
1937420,18,27,1995,8,"female",431,413,142,31,32,31,31,0,1
1937426,53,6,1960,6,"male",199,71,35,1,1,1,1,0,0
1937441,41,2,1972,1,"female",57,57,50,1297,1341,1297,975,0,366
1937455,14,11,1999,3,"male",341,56,24,0,0,0,0,0,0
1937465,22,1,1991,1,"male",686,315,219,169,81,169,59,0,22
1937476,43,20,1970,2,"male",436,64,37,51,11,33,9,18,2
1937506,17,29,1996,2,"male",313,230,220,17,3,17,3,0,0
1937569,20,24,1993,12,"male",523,49,29,2,2,2,2,0,0
1937572,34,7,1979,6,"male",130,56,53,99,9,99,8,0,1
1937575,14,27,1999,3,"male",9,2,2,0,0,0,0,0,0
1937634,22,10,1991,1,"female",491,416,142,1,11,0,3,1,8
1937635,30,11,1983,9,"male",1172,203,27,8,64,0,15,8,49
1937645,27,15,1986,10,"female",569,122,78,236,270,236,203,0,67
1937682,22,1,1991,4,"female",409,14,9,0,0,0,0,0,0
1937721,17,28,1996,4,"male",426,45,35,0,0,0,0,0,0
1937737,21,15,1992,2,"male",314,285,66,135,2,135,2,0,0
1937738,24,31,1989,7,"female",346,64,41,53,72,53,68,0,4
1937753,20,6,1993,7,"male",245,14,14,14,2,14,2,0,0
1937761,103,11,1910,2,"female",1057,609,133,221,118,218,86,3,32
1937763,18,10,1995,5,"male",659,303,209,63,146,63,130,0,16
1937785,24,15,1989,1,"male",472,157,119,28,1,28,1,0,0
1937808,52,23,1961,3,"female",1376,56,18,30,12,30,10,0,2
1937848,19,18,1994,8,"male",300,50,13,86,8,86,6,0,2
1937861,51,19,1962,9,"male",1743,53,28,3,15,3,4,0,11
1937885,102,27,1911,9,"male",574,162,108,42,23,42,23,0,0
1937916,17,15,1996,1,"male",182,334,320,2,1,1,1,1,0
1937930,67,27,1946,12,"male",1461,31,18,29,1,29,1,0,0
1938024,65,20,1948,12,"female",581,42,25,0,0,0,0,0,0
1938073,13,1,2000,1,"female",29,1,1,0,0,0,0,0,0
1938080,108,1,1905,1,"female",893,5,2,2,1,2,1,0,0
1938084,18,21,1995,10,"female",206,136,114,33,6,33,1,0,5
1938094,51,13,1962,3,"male",483,41,27,8,5,0,2,8,3
1938107,31,15,1982,1,"male",1704,1222,507,60,28,60,26,0,2
1938108,28,2,1985,8,"female",629,3,3,413,12,2,0,411,12
1938156,64,25,1949,3,"male",253,19,11,3,14,3,5,0,9
1938164,107,20,1906,10,"female",945,55,41,683,378,0,60,683,318
1938192,26,16,1987,9,"female",93,70,57,121,72,121,24,0,48
1938194,15,1,1998,1,"female",512,256,171,256,61,99,4,157,57
1938206,46,1,1967,6,"male",352,46,17,1,0,1,0,0,0
1938221,18,12,1995,11,"male",240,65,24,0,7,0,6,0,1
1938230,25,22,1988,2,"male",536,8,8,0,0,0,0,0,0
1938255,62,1,1951,9,"female",401,72,47,154,11,97,4,57,7
1938294,22,13,1991,5,"female",326,70,24,124,50,124,38,0,12
1938320,23,3,1990,5,"female",205,151,49,6,3,1,0,5,3
1938346,56,28,1957,1,"male",722,91,63,2,1,2,1,0,0
1938356,24,1,1989,12,"male",734,84,69,404,66,404,21,0,45
1938368,25,18,1988,5,"male",324,311,102,13,33,10,23,3,10
1938377,36,7,1977,7,"male",266,44,41,0,0,0,0,0,0
1938386,48,4,1965,7,"male",233,40,22,1,33,1,7,0,26
1938407,67,27,1946,5,"male",1898,34,4,23,0,0,0,23,0
1938413,108,2,1905,9,"male",199,1526,1419,211,161,211,113,0,48
1938423,21,17,1992,6,"female",257,45,17,7,13,7,11,0,2
1938435,33,1,1980,1,"female",258,1,1,2,0,0,0,2,0
1938464,33,10,1980,11,"female",334,92,60,301,32,301,22,0,10
1938470,101,3,1912,11,"female",2337,129,88,88,1,88,0,0,1
1938524,52,12,1961,10,"male",1161,212,57,123,116,123,91,0,25
1938544,18,1,1995,8,"male",148,128,49,3,6,3,6,0,0
1938572,23,13,1990,10,"male",19,56,53,12,25,12,21,0,4
1938592,16,12,1997,12,"male",271,519,392,17,19,1,6,16,13
1938617,69,31,1944,3,"male",823,46,36,7,7,0,0,7,7
1938621,43,11,1970,5,"male",216,32,19,7,16,7,16,0,0
1938632,14,15,1999,9,"male",403,207,25,0,4,0,3,0,1
1938633,93,11,1920,2,"male",1192,198,103,58,40,58,25,0,15
1938635,24,31,1989,3,"male",505,235,216,67,12,67,7,0,5
1938712,43,5,1970,1,"male",1082,233,86,6,2,0,0,6,2
1938718,33,1,1980,3,"female",1020,29,9,0,0,0,0,0,0
1938724,18,31,1995,5,"female",43,231,33,50,243,50,166,0,77
1938728,35,26,1978,8,"female",381,67,35,113,341,113,253,0,88
1938755,26,1,1987,1,"male",518,4,2,0,0,0,0,0,0
1938759,40,7,1973,3,"male",543,39,22,8,26,8,26,0,0
1938797,63,14,1950,3,"male",880,229,133,167,84,167,82,0,2
1938807,55,27,1958,11,"male",279,0,0,0,0,0,0,0,0
1938838,22,12,1991,12,"male",554,89,31,0,3,0,1,0,2
1938851,53,4,1960,1,"male",166,2,0,5,5,0,0,5,5
1938858,38,22,1975,1,"male",235,67,30,2,10,1,4,1,6
1938870,35,5,1978,6,"male",273,69,21,0,0,0,0,0,0
1938873,58,29,1955,9,"female",143,78,67,3,30,0,0,3,30
1938874,16,29,1997,3,"female",938,4697,924,1823,2791,1600,2460,223,331
1938889,68,6,1945,6,"male",690,164,98,256,446,0,133,256,313
1938892,15,14,1998,3,"female",299,83,54,84,31,23,12,61,19
1938895,30,2,1983,6,"male",32,12,8,4,4,4,1,0,3
1938902,63,22,1950,1,"male",469,126,82,2,1,2,1,0,0
1938915,53,20,1960,11,"female",640,4,0,0,0,0,0,0,0
1938916,15,8,1998,5,"male",114,24,9,1,0,1,0,0,0
1938940,37,26,1976,10,"male",501,12,11,3,3,0,0,3,3
1938950,22,2,1991,5,"male",472,103,94,1,0,1,0,0,0
1938951,15,17,1998,2,"female",225,236,217,40,3,40,2,0,1
1939000,18,2,1995,11,"male",517,425,291,120,49,120,44,0,5
1939017,73,25,1940,8,"female",1181,136,98,42,29,0,13,42,16
1939027,67,15,1946,6,"female",305,77,44,19,11,19,5,0,6
1939040,25,1,1988,1,"male",122,195,182,183,75,183,8,0,67
1939049,65,4,1948,3,"female",1032,78,53,57,7,57,6,0,1
1939065,22,16,1991,2,"female",682,0,0,49,16,0,7,49,9
1939085,58,23,1955,4,"female",167,39,39,0,0,0,0,0,0
1939087,48,21,1965,12,"male",548,95,73,2395,109,197,50,2198,59
1939089,75,9,1938,7,"female",1000,87,62,33,71,33,41,0,30
1939102,34,7,1979,2,"male",264,259,221,19,1,0,0,19,1
1939104,25,1,1988,1,"male",257,14,5,0,0,0,0,0,0
1939105,24,21,1989,1,"male",584,481,380,53,60,53,49,0,11
1939112,70,12,1943,1,"male",575,37,21,0,0,0,0,0,0
1939123,29,21,1984,3,"female",474,232,174,189,433,189,238,0,195
1939130,18,17,1995,4,"male",539,994,222,107,45,35,26,72,19
1939136,18,30,1995,6,"female",164,1,1,0,0,0,0,0,0
1939156,28,4,1985,1,"male",432,477,299,31,137,0,25,31,112
1939190,16,21,1997,12,"male",288,1002,733,31,17,1,9,30,8
1939199,19,14,1994,4,"male",316,149,114,0,0,0,0,0,0
1939202,20,26,1993,3,"female",195,59,53,2,6,2,6,0,0
1939212,27,27,1986,9,"male",1701,341,244,2,4,0,1,2,3
1939238,72,11,1941,2,"female",1020,157,62,103,15,3,3,100,12
1939266,20,20,1993,5,"male",47,25,9,0,0,0,0,0,0
1939328,20,7,1993,9,"female",569,304,33,3,22,3,17,0,5
1939375,58,4,1955,11,"female",1598,238,156,58,60,58,46,0,14
1939391,61,2,1952,2,"female",361,239,102,81,289,80,80,1,209
1939413,26,26,1987,12,"male",1131,243,217,0,0,0,0,0,0
1939423,15,1,1998,1,"male",19,2,1,0,1,0,1,0,0
1939449,16,20,1997,3,"female",490,137,68,127,278,125,259,2,19
1939471,28,5,1985,10,"male",73,21,9,2,0,2,0,0,0
1939477,59,10,1954,4,"male",847,193,83,0,4,0,1,0,3
1939483,18,6,1995,1,"male",337,337,258,12,7,12,1,0,6
1939500,22,15,1991,5,"male",285,97,64,45,23,45,23,0,0
1939506,23,16,1990,1,"female",202,223,114,11,42,7,18,4,24
1939510,21,29,1992,2,"male",612,542,376,27,46,27,38,0,8
1939525,49,6,1964,3,"female",808,60,30,73,3,73,3,0,0
1939539,29,27,1984,1,"male",404,90,57,322,199,322,145,0,54
1939546,22,22,1991,7,"male",447,203,122,60,30,60,18,0,12
1939615,36,10,1977,1,"male",413,67,47,1,0,1,0,0,0
1939619,79,7,1934,5,"male",927,94,31,15,4,0,2,15,2
1939673,102,1,1911,1,"male",938,526,314,663,511,131,174,532,337
1939737,24,8,1989,11,"male",372,157,130,0,0,0,0,0,0
1939738,25,17,1988,8,"male",267,163,124,18,7,14,4,4,3
1939739,28,26,1985,10,"female",523,51,32,0,0,0,0,0,0
1939752,49,11,1964,11,"female",1357,30,19,2,0,2,0,0,0
1939779,37,3,1976,9,"female",593,68,31,7,0,0,0,7,0
1939788,33,16,1980,4,"female",229,195,132,46,73,46,69,0,4
1939792,28,8,1985,2,"male",308,125,101,0,12,0,1,0,11
1939822,47,16,1966,11,"female",838,191,133,50,8,38,7,12,1
1939866,16,5,1997,12,"male",26,1,1,323,3,42,0,281,3
1939875,18,8,1995,10,"male",207,204,166,0,1,0,1,0,0
1939888,30,23,1983,1,"female",314,29,14,0,0,0,0,0,0
1939911,50,6,1963,1,"male",130,27,6,1,6,0,4,1,2
1939920,27,5,1986,4,"female",339,168,89,0,0,0,0,0,0
1939926,33,24,1980,11,"female",288,71,65,242,224,226,182,16,42
1939997,28,4,1985,9,"male",290,65,45,1,0,1,0,0,0
1940063,55,4,1958,8,"male",457,47,28,0,0,0,0,0,0
1940133,25,9,1988,6,"female",1101,433,98,306,1073,54,894,252,179
1940138,15,18,1998,3,"female",348,203,84,109,266,109,219,0,47
1940186,29,15,1984,7,"male",776,451,391,2,13,2,9,0,4
1940194,18,31,1995,3,"female",158,387,263,61,128,61,112,0,16
1940196,21,25,1992,6,"male",37,96,93,12,4,12,4,0,0
1940240,28,9,1985,11,"male",440,36,29,144,18,144,16,0,2
1940245,18,12,1995,4,"male",243,109,77,67,4,67,4,0,0
1940261,108,12,1905,4,"male",940,671,170,3,8,3,5,0,3
1940315,15,9,1998,4,"female",453,80,10,52,0,52,0,0,0
1940318,34,8,1979,6,"male",659,13,10,0,0,0,0,0,0
1940353,26,4,1987,9,"male",588,247,204,5,10,5,10,0,0
1940365,64,20,1949,9,"female",2133,257,166,2327,1145,1175,796,1152,349
1940403,18,2,1995,2,"male",6,0,0,0,2,0,0,0,2
1940406,84,11,1929,6,"female",1678,28,11,0,0,0,0,0,0
1940422,25,4,1988,7,"male",40,43,29,134,15,134,14,0,1
1940428,19,10,1994,5,"male",370,497,429,219,14,207,11,12,3
1940494,23,5,1990,1,"male",403,365,235,5,10,5,6,0,4
1940498,40,18,1973,12,"male",476,92,24,0,0,0,0,0,0
1940544,25,8,1988,8,"male",216,0,0,0,0,0,0,0,0
1940555,29,25,1984,3,"male",484,7,5,0,0,0,0,0,0
1940580,28,27,1985,9,"female",158,117,47,341,162,341,52,0,110
1940598,15,11,1998,11,"male",380,60,23,7,5,0,5,7,0
1940613,36,3,1977,1,"male",44,1,1,17,24,0,0,17,24
1940630,18,7,1995,4,"male",600,591,428,28,167,28,84,0,83
1940637,16,16,1997,6,"male",677,438,390,6,4,6,4,0,0
1940644,39,5,1974,3,"male",601,22,11,54,2,54,1,0,1
1940649,55,31,1958,5,"male",202,8,7,2,0,0,0,2,0
1940665,56,13,1957,1,"male",325,47,33,623,112,434,73,189,39
1940685,27,1,1986,1,"female",493,158,134,1,1,1,1,0,0
1940694,23,1,1990,1,"male",193,18,17,16,17,16,17,0,0
1940745,42,25,1971,11,"male",564,12,3,0,7,0,7,0,0
1940763,50,29,1963,1,"male",379,0,0,0,0,0,0,0,0
1940780,30,3,1983,11,"male",353,219,148,177,212,125,165,52,47
1940791,23,7,1990,2,"male",438,172,119,0,0,0,0,0,0
1940798,108,6,1905,10,"female",1064,57,50,0,1,0,0,0,1
1940805,40,29,1973,1,"male",846,383,337,3,0,2,0,1,0
1940815,65,13,1948,7,"female",464,10,9,4,0,0,0,4,0
1940837,63,25,1950,12,"male",1946,355,89,0,0,0,0,0,0
1940851,31,28,1982,8,"male",813,35,12,17,0,17,0,0,0
1940928,55,28,1958,1,"female",26,0,0,0,0,0,0,0,0
1940937,52,20,1961,1,"female",626,57,27,2,1,2,0,0,1
1940972,17,9,1996,4,"female",314,260,161,0,0,0,0,0,0
1941001,108,1,1905,9,"female",831,1168,531,742,1518,106,771,636,747
1941016,23,15,1990,10,"female",68,56,52,3,8,0,1,3,7
1941020,40,28,1973,5,"female",292,17,9,2,0,2,0,0,0
1941059,67,25,1946,5,"female",616,31,17,56,9,35,9,21,0
1941076,29,27,1984,1,"male",222,28,17,1,0,1,0,0,0
1941082,113,2,1900,4,"female",2053,201,153,372,32,0,23,372,9
1941095,31,9,1982,3,"male",36,13,13,32,16,32,13,0,3
1941107,22,26,1991,6,"male",309,139,94,79,94,79,55,0,39
1941125,17,18,1996,8,"female",364,177,93,51,50,50,48,1,2
1941137,68,17,1945,8,"male",717,173,130,158,3,158,0,0,3
1941141,44,24,1969,5,"female",579,24,12,7,12,1,5,6,7
1941142,56,21,1957,9,"female",272,64,36,9,22,9,6,0,16
1941153,37,14,1976,1,"female",433,96,33,479,336,137,97,342,239
1941159,25,28,1988,2,"male",139,40,24,1,18,1,6,0,12
1941191,67,4,1946,1,"female",1095,39,26,54,32,11,8,43,24
1941217,68,19,1945,10,"female",452,20,17,26,2,0,2,26,0
1941224,59,26,1954,11,"male",248,29,8,21,2,19,0,2,2
1941229,76,24,1937,8,"female",1613,154,78,183,60,136,40,47,20
1941245,38,30,1975,1,"male",262,86,43,4,0,0,0,4,0
1941248,36,30,1977,11,"male",607,6,2,1,0,1,0,0,0
1941250,47,15,1966,11,"female",393,62,56,8,9,6,7,2,2
1941254,28,19,1985,9,"female",11,284,130,667,575,440,260,227,315
1941273,25,14,1988,12,"male",316,12,7,6,0,0,0,6,0
1941274,53,19,1960,9,"male",368,52,45,1,0,1,0,0,0
1941277,58,12,1955,7,"male",551,57,56,8,14,0,3,8,11
1941278,80,10,1933,7,"female",1673,171,110,789,430,209,209,580,221
1941306,15,5,1998,7,"male",430,91,67,35,26,33,16,2,10
1941317,75,11,1938,1,"female",2090,244,119,293,661,0,75,293,586
1941325,64,7,1949,7,"female",1347,29,15,16,3,16,1,0,2
1941333,61,29,1952,3,"female",413,102,51,178,719,1,91,177,628
1941346,33,10,1980,8,"male",313,176,160,28,7,28,7,0,0
1941347,20,6,1993,6,"female",224,244,27,3,35,3,27,0,8
1941348,20,26,1993,3,"male",313,214,188,15,9,13,6,2,3
1941353,22,25,1991,5,"male",542,93,65,0,7,0,1,0,6
1941387,31,16,1982,8,"male",361,167,157,13,0,13,0,0,0
1941408,13,12,2000,9,"male",44,4,4,0,0,0,0,0,0
1941424,14,2,1999,12,"male",265,186,29,10,11,10,11,0,0
1941433,58,15,1955,9,"female",299,89,69,104,161,0,6,104,155
1941449,18,1,1995,12,"female",182,79,58,84,1,83,1,1,0
1941461,23,7,1990,9,"female",94,84,76,16,43,16,40,0,3
1941475,17,24,1996,12,"female",1426,3384,1100,756,646,111,462,645,184
1941499,69,26,1944,12,"female",68,7,7,4,0,4,0,0,0
1941505,39,8,1974,12,"male",433,52,49,0,0,0,0,0,0
1941514,18,4,1995,3,"male",60,8,3,0,0,0,0,0,0
1941515,27,30,1986,5,"female",703,49,19,0,0,0,0,0,0
1941541,59,7,1954,6,"female",405,23,9,3,0,3,0,0,0
1941575,108,21,1905,3,"male",339,64,53,3,3,3,3,0,0
1941579,41,16,1972,5,"male",851,38,23,0,3,0,3,0,0
1941583,23,26,1990,10,"female",270,418,107,284,352,119,183,165,169
1941597,22,17,1991,1,"male",183,560,445,298,267,224,147,74,120
1941603,20,1,1993,1,"male",299,3151,401,0,62,0,54,0,8
1941631,17,6,1996,9,"female",524,4452,454,328,548,236,264,92,284
1941632,108,19,1905,1,"female",1964,1991,535,90,255,87,218,3,37
1941657,35,20,1978,7,"female",333,13,9,4,1,4,1,0,0
1941662,58,26,1955,1,"female",1187,186,101,21,35,18,27,3,8
1941680,26,6,1987,11,"male",580,308,239,18,1,18,1,0,0
1941693,55,7,1958,10,"male",1091,23,4,0,0,0,0,0,0
1941697,25,14,1988,8,"male",892,384,292,0,1,0,0,0,1
1941699,33,23,1980,5,"male",223,100,88,5,7,5,6,0,1
1941724,25,18,1988,10,"male",8,5,3,5,4,5,4,0,0
1941742,108,22,1905,4,"male",489,254,241,30,131,30,118,0,13
1941752,45,8,1968,7,"female",21,71,55,317,258,317,240,0,18
1941757,26,10,1987,1,"male",358,12,12,1,1,1,0,0,1
1941760,30,3,1983,1,"female",621,1,0,0,0,0,0,0,0
1941763,21,13,1992,11,"male",557,24,15,3,1,3,0,0,1
1941792,68,5,1945,5,"male",886,976,871,11,1,11,1,0,0
1941814,36,26,1977,6,"male",15,14,14,4,0,4,0,0,0
1941853,29,18,1984,6,"female",303,57,9,0,0,0,0,0,0
1941868,28,22,1985,1,"male",195,55,8,34,0,33,0,1,0
1941884,29,23,1984,4,"male",407,254,110,47,21,47,12,0,9
1941901,25,2,1988,2,"male",258,73,50,5,3,5,3,0,0
1941912,16,1,1997,8,"male",267,82,60,4,1,1,1,3,0
1941926,28,28,1985,4,"male",222,33,27,0,0,0,0,0,0
1941937,21,4,1992,10,"male",405,668,421,593,1642,267,1070,326,572
1941947,15,7,1998,11,"male",589,160,66,2,6,2,6,0,0
1941955,81,22,1932,5,"male",2254,118,85,0,0,0,0,0,0
1941984,43,1,1970,12,"male",232,1,1,4,0,4,0,0,0
1942019,19,20,1994,1,"male",366,40,26,0,0,0,0,0,0
1942029,63,15,1950,2,"female",1191,76,18,1,0,0,0,1,0
1942054,29,19,1984,10,"female",441,96,56,6,15,6,9,0,6
1942072,21,12,1992,10,"male",374,154,110,8,10,7,6,1,4
1942077,15,19,1998,11,"female",827,675,440,591,536,450,191,141,345
1942099,24,27,1989,2,"female",256,183,68,5,20,5,19,0,1
1942104,45,23,1968,11,"male",200,70,53,56,6,56,4,0,2
1942108,33,26,1980,1,"male",291,67,51,0,0,0,0,0,0
1942115,22,28,1991,11,"male",232,5,4,5,5,5,3,0,2
1942116,39,12,1974,2,"male",631,18,8,1,1,1,1,0,0
1942124,16,15,1997,7,"female",313,4578,399,253,6118,10,3526,243,2592
1942125,23,13,1990,12,"female",122,173,147,519,148,519,64,0,84
1942126,19,18,1994,11,"female",361,55,26,11,15,0,2,11,13
1942131,14,14,1999,8,"female",411,124,52,10,1,10,0,0,1
1942137,23,15,1990,7,"female",1115,2901,1068,38,507,14,411,24,96
1942151,25,19,1988,9,"female",450,10,3,3,0,3,0,0,0
1942172,108,30,1905,6,"female",1083,901,609,41,41,41,29,0,12
1942187,25,12,1988,12,"female",324,80,48,5,7,5,5,0,2
1942210,23,26,1990,11,"female",1937,290,156,1196,905,440,461,756,444
1942225,67,27,1946,5,"male",547,24,11,0,0,0,0,0,0
1942231,38,3,1975,2,"male",50,1,1,2,0,0,0,2,0
1942233,25,1,1988,1,"male",161,11,7,2,1,2,1,0,0
1942259,25,2,1988,1,"female",89,13,6,30,79,30,60,0,19
1942277,64,25,1949,4,NA,2318,86,18,4,0,4,0,0,0
1942278,17,3,1996,10,"female",29,34,34,0,0,0,0,0,0
1942326,15,28,1998,1,"female",222,643,233,791,2500,717,1424,74,1076
1942327,103,2,1910,5,"female",1754,81,36,245,124,72,19,173,105
1942347,22,25,1991,4,"male",170,9,4,3,0,3,0,0,0
1942372,42,31,1971,1,"male",300,22,16,0,2,0,2,0,0
1942386,36,14,1977,5,"male",211,2,2,0,0,0,0,0,0
1942393,19,23,1994,11,"male",59,198,184,101,195,59,102,42,93
1942423,28,21,1985,7,"male",271,27,16,0,0,0,0,0,0
1942425,21,24,1992,12,"male",183,197,160,1,0,1,0,0,0
1942455,72,30,1941,9,"female",360,3,1,0,0,0,0,0,0
1942465,61,15,1952,8,"male",1386,42,26,1,1,0,1,1,0
1942466,59,19,1954,10,"female",1368,166,82,590,530,586,412,4,118
1942480,27,17,1986,6,"female",415,40,18,148,14,0,4,148,10
1942484,33,27,1980,7,"male",415,104,72,0,0,0,0,0,0
1942516,19,27,1994,10,"male",945,886,383,287,434,287,324,0,110
1942528,24,23,1989,4,"male",21,28,25,0,0,0,0,0,0
1942563,24,14,1989,9,"female",1496,148,77,22,34,12,9,10,25
1942590,56,26,1957,5,"female",76,67,62,36,5,36,3,0,2
1942599,16,9,1997,2,"male",235,197,138,0,2,0,0,0,2
1942610,32,22,1981,6,"male",233,39,23,0,0,0,0,0,0
1942651,21,9,1992,4,"male",373,473,409,896,136,895,113,0,23
1942655,20,18,1993,8,"female",107,137,91,215,323,134,166,81,157
1942667,23,8,1990,9,"male",175,23,17,0,3,0,2,0,1
1942676,19,26,1994,1,"male",62,41,19,4,39,4,16,0,23
1942681,20,9,1993,11,"male",370,222,104,38,23,38,18,0,5
1942721,23,1,1990,1,"male",489,488,395,119,40,119,34,0,6
1942752,19,9,1994,5,"male",822,130,70,0,8,0,8,0,0
1942753,21,31,1992,7,"male",665,83,58,0,0,0,0,0,0
1942756,60,29,1953,4,"female",1216,70,18,3236,1995,791,276,2445,1719
1942766,42,12,1971,9,"female",93,0,0,0,0,0,0,0,0
1942785,49,5,1964,6,"male",1105,103,50,2,0,2,0,0,0
1942838,20,29,1993,1,"female",206,189,144,356,158,339,76,17,82
1942839,24,21,1989,8,"male",622,84,68,3,1,3,1,0,0
1942843,25,12,1988,5,"male",1211,445,361,0,1,0,1,0,0
1942847,83,30,1930,4,"male",183,29,27,10,16,3,9,7,7
1942869,60,21,1953,4,"male",756,1578,1282,521,2672,83,1960,438,712
1942931,21,8,1992,9,"female",3,28,23,77,86,65,49,12,37
1942937,24,8,1989,4,"male",528,91,60,14,63,0,35,14,28
1942951,25,8,1988,12,"female",1544,886,495,3387,5380,3051,3544,336,1836
1942973,42,24,1971,12,"female",1290,251,105,1541,1634,1432,1000,109,634
1943030,28,16,1985,5,"male",13,19,15,21,5,0,3,21,2
1943070,39,10,1974,6,"male",282,4,3,0,0,0,0,0,0
1943090,20,5,1993,11,"male",326,34,15,3,1,3,0,0,1
1943122,22,28,1991,3,"female",531,86,40,87,84,87,73,0,11
1943134,22,15,1991,12,"female",367,340,31,580,454,580,268,0,186
1943150,50,3,1963,7,"female",442,5,3,0,0,0,0,0,0
1943157,13,30,2000,1,"female",250,218,122,9,8,7,2,2,6
1943167,21,31,1992,7,"female",408,254,68,95,123,75,95,20,28
1943178,19,4,1994,4,"male",298,116,102,0,0,0,0,0,0
1943192,55,12,1958,2,"male",95,0,0,0,0,0,0,0,0
1943217,20,12,1993,4,"female",446,212,141,1,38,1,26,0,12
1943232,31,1,1982,9,"female",584,50,29,48,19,24,7,24,12
1943237,24,10,1989,3,"female",828,360,173,5,15,5,13,0,2
1943238,24,1,1989,1,"male",990,89,35,9,16,9,13,0,3
1943258,38,4,1975,4,"male",334,8,5,5,0,5,0,0,0
1943333,20,23,1993,2,"male",406,44,31,0,0,0,0,0,0
1943336,65,12,1948,5,"female",470,45,17,8,1,8,0,0,1
1943393,17,30,1996,3,"male",303,379,345,5,16,5,12,0,4
1943407,69,13,1944,9,"male",1191,47,17,3,2,0,1,3,1
1943410,24,12,1989,5,"male",582,1366,1284,3,5,3,3,0,2
1943446,53,18,1960,5,"female",619,100,50,179,22,179,17,0,5
1943464,20,20,1993,9,"male",304,247,204,376,0,376,0,0,0
1943475,61,18,1952,4,"female",754,27,14,1,5,1,5,0,0
1943484,18,10,1995,10,"female",35,8,7,3,10,3,10,0,0
1943494,16,4,1997,6,"female",203,333,176,38,42,38,37,0,5
1943503,27,28,1986,11,"male",735,147,62,0,0,0,0,0,0
1943505,23,30,1990,1,"female",1517,83,22,378,422,0,182,378,240
1943531,55,15,1958,3,"female",1026,26,7,4,0,0,0,4,0
1943551,38,14,1975,3,"female",791,180,110,118,21,73,4,45,17
1943571,25,5,1988,9,"male",1392,309,171,26,788,0,601,26,187
1943624,16,3,1997,9,"male",177,273,256,69,10,44,7,25,3
1943633,33,20,1980,2,"female",668,126,98,177,224,177,131,0,93
1943692,14,21,1999,1,"female",446,301,111,513,476,125,293,388,183
1943693,33,19,1980,11,"female",71,40,26,239,127,207,127,32,0
1943697,43,19,1970,5,"male",126,99,41,3,17,2,8,1,9
1943728,42,8,1971,9,"male",121,2,1,0,0,0,0,0,0
1943734,81,29,1932,12,"male",1347,92,55,2,0,0,0,2,0
1943754,100,21,1913,7,"female",1804,250,160,250,134,240,95,10,39
1943766,28,7,1985,8,"male",396,51,49,7,1,7,0,0,1
1943829,21,11,1992,10,"male",429,90,24,11,21,0,15,11,6
1943844,18,10,1995,3,"male",388,98,76,4,0,0,0,4,0
1943851,54,28,1959,12,"male",3,3,3,10,7,0,0,10,7
1943852,16,10,1997,4,"male",402,285,231,23,18,0,5,23,13
1943866,46,10,1967,6,"male",884,45,14,55,138,47,130,8,8
1943878,27,12,1986,12,"female",441,13,10,0,10,0,5,0,5
1943902,108,5,1905,5,"male",212,103,89,87,92,82,10,5,82
1943922,15,3,1998,1,"male",338,0,0,0,0,0,0,0,0
1943930,63,20,1950,12,"female",1359,35,6,11,24,4,9,7,15
1943964,14,9,1999,4,"female",457,23,14,0,0,0,0,0,0
1943966,27,20,1986,6,"male",434,3,2,0,2,0,0,0,2
1944000,80,18,1933,7,"female",1678,64,5,172,23,0,18,172,5
1944002,22,2,1991,10,"male",223,169,107,6,29,0,3,6,26
1944053,20,13,1993,9,"male",228,32,13,7,17,7,7,0,10
1944059,17,17,1996,7,"female",383,1128,750,582,1562,575,1276,7,286
1944081,28,2,1985,9,"female",102,20,16,12,5,12,5,0,0
1944083,18,1,1995,1,"male",191,213,185,3,1,3,1,0,0
1944098,26,15,1987,5,"male",335,35,32,0,1,0,1,0,0
1944147,47,18,1966,6,"female",714,27,18,0,0,0,0,0,0
1944157,18,5,1995,7,"female",196,4,3,5,2,0,0,5,2
1944174,36,4,1977,8,"male",300,11,8,0,11,0,4,0,7
1944177,49,26,1964,1,"male",1484,33,25,0,0,0,0,0,0
1944210,20,20,1993,11,"male",110,21,9,6,12,6,4,0,8
1944251,18,11,1995,1,"male",1022,980,601,296,461,203,156,93,305
1944269,16,1,1997,12,"female",595,232,116,412,294,412,232,0,62
1944279,20,14,1993,1,"female",624,140,6,11,0,11,0,0,0
1944286,34,9,1979,12,"female",142,23,14,2,3,2,2,0,1
1944298,22,9,1991,6,"male",394,41,35,410,89,401,78,9,11
1944299,75,13,1938,6,"female",635,37,24,3,2,0,2,3,0
1944309,20,3,1993,4,"male",614,145,71,43,3,24,2,19,1
1944312,108,22,1905,2,"female",660,77,40,0,0,0,0,0,0
1944330,30,7,1983,9,"male",381,89,33,4,0,3,0,1,0
1944335,30,11,1983,7,"male",753,3,0,0,0,0,0,0,0
1944339,37,16,1976,8,"female",739,18,16,7,0,0,0,7,0
1944349,28,24,1985,1,"male",660,62,31,170,29,0,15,170,14
1944361,18,26,1995,2,"female",242,1191,825,612,281,612,264,0,17
1944375,17,1,1996,9,"male",554,52,37,8,3,8,2,0,1
1944379,25,1,1988,1,"male",63,6,6,2,0,2,0,0,0
1944412,18,9,1995,9,"female",490,48,25,1,0,1,0,0,0
1944414,63,27,1950,5,"female",1471,105,75,147,162,0,62,147,100
1944420,31,22,1982,4,"female",163,5,2,33,1,1,0,32,1
1944435,33,29,1980,10,"female",499,299,148,1063,1205,1063,1076,0,129
1944459,113,21,1900,11,"female",1747,643,555,38,149,0,46,38,103
1944484,49,11,1964,8,"male",662,81,43,44,38,1,9,43,29
1944486,19,24,1994,9,"male",609,214,119,17,0,0,0,17,0
1944490,18,20,1995,8,"female",74,12,10,4,0,4,0,0,0
1944495,34,6,1979,2,"male",634,112,54,3,77,1,25,2,52
1944505,24,25,1989,8,"male",760,31,14,0,0,0,0,0,0
1944512,23,28,1990,2,"male",332,40,23,0,0,0,0,0,0
1944547,21,9,1992,7,"male",229,452,364,214,145,193,77,21,68
1944564,27,4,1986,1,"male",208,76,56,60,9,0,2,60,7
1944583,17,19,1996,1,"female",105,638,477,14,61,14,51,0,10
1944591,23,1,1990,8,"male",295,87,52,7,7,7,2,0,5
1944616,89,1,1924,4,"male",2058,51,31,15,1,0,0,15,1
1944657,53,13,1960,10,"female",1513,318,195,737,591,343,270,394,321
1944663,26,23,1987,10,"female",13,153,148,226,59,100,27,126,32
1944707,66,19,1947,12,"male",1095,377,256,339,483,0,168,339,315
1944711,25,30,1988,10,"male",312,297,246,279,61,278,53,1,8
1944712,29,22,1984,4,"male",357,1,1,0,0,0,0,0,0
1944762,27,1,1986,1,"male",74,3,3,2,0,2,0,0,0
1944796,25,23,1988,5,"female",1102,632,380,582,421,463,102,119,319
1944805,55,5,1958,1,"female",243,36,18,335,139,0,18,335,121
1944820,14,9,1999,7,"female",118,264,222,10,7,10,5,0,2
1944846,58,21,1955,7,"male",373,17,12,0,0,0,0,0,0
1944852,36,4,1977,12,"male",177,24,19,1,0,1,0,0,0
1944856,13,6,2000,1,"male",125,91,53,10,2,0,1,10,1
1944877,108,13,1905,1,NA,2322,280,182,24,51,18,23,6,28
1944887,18,10,1995,10,"female",92,36,24,1,1,0,0,1,1
1944893,17,9,1996,5,"female",51,50,31,107,79,9,26,98,53
1944894,29,23,1984,2,"female",750,346,178,658,961,552,783,106,178
1944909,74,10,1939,5,"male",1600,25,3,6,1,0,1,6,0
1944937,108,5,1905,10,"female",2304,565,209,97,105,97,85,0,20
1944961,35,3,1978,9,"female",401,186,67,24,34,7,1,17,33
1944963,29,27,1984,1,"male",361,29,24,0,0,0,0,0,0
1944970,55,8,1958,3,"male",1768,116,45,128,66,82,22,46,44
1945017,34,27,1979,8,"female",374,45,26,0,1,0,1,0,0
1945049,24,10,1989,4,"female",447,422,295,2100,1052,68,461,2032,591
1945060,30,7,1983,8,"male",415,50,21,0,0,0,0,0,0
1945062,42,31,1971,7,"female",1306,148,54,132,17,131,6,1,11
1945087,15,4,1998,4,"male",695,208,174,2,5,1,5,1,0
1945116,52,11,1961,3,"female",1503,238,103,102,204,101,84,1,120
1945161,46,22,1967,11,"female",480,358,246,394,239,30,67,364,172
1945168,14,28,1999,5,"female",450,233,110,19,3,19,2,0,1
1945208,25,10,1988,12,"male",107,3,2,13,0,13,0,0,0
1945308,98,20,1915,10,"female",917,1322,539,19,43,15,20,4,23
1945309,18,28,1995,9,"female",300,405,209,48,55,45,44,3,11
1945310,54,7,1959,7,"male",817,184,136,49,45,48,4,1,41
1945400,65,14,1948,4,"female",374,32,27,78,14,78,8,0,6
1945414,26,4,1987,5,"female",528,57,28,4,0,4,0,0,0
1945415,19,7,1994,12,"female",399,30,21,0,3,0,2,0,1
1945467,33,12,1980,1,"female",1534,304,78,113,397,69,254,44,143
1945479,34,19,1979,11,"male",126,117,106,14,28,14,28,0,0
1945482,29,1,1984,1,"female",99,61,34,10,2,0,1,10,1
1945486,46,8,1967,6,"male",1303,228,171,402,82,21,38,381,44
1945506,47,1,1966,10,"female",350,62,34,5,1,0,1,5,0
1945526,23,23,1990,1,"male",223,0,0,0,0,0,0,0,0
1945619,47,14,1966,6,"female",1079,263,107,60,47,0,17,60,30
1945632,26,19,1987,5,"male",691,265,113,46,11,46,11,0,0
1945638,60,15,1953,11,"male",1476,358,224,240,276,226,183,14,93
1945643,44,4,1969,1,"male",301,24,12,17,8,1,6,16,2
1945671,18,17,1995,3,"male",645,1777,1083,485,469,471,332,14,137
1945674,16,31,1997,5,"male",259,55,42,3,0,0,0,3,0
1945686,108,26,1905,2,"male",1570,460,142,30,109,28,75,2,34
1945690,19,20,1994,1,"male",477,689,324,489,1092,486,1030,3,62
1945703,17,10,1996,4,"male",513,145,49,54,3,51,3,3,0
1945705,16,15,1997,4,"male",312,0,0,0,0,0,0,0,0
1945716,17,8,1996,11,"male",797,561,426,2,0,2,0,0,0
1945719,20,18,1993,9,"male",376,360,299,20,22,20,13,0,9
1945731,22,11,1991,2,"male",590,57,32,13,10,0,5,13,5
1945755,25,27,1988,10,"male",269,13,10,0,1,0,1,0,0
1945788,57,9,1956,2,"male",115,3,2,0,0,0,0,0,0
1945802,21,11,1992,7,"female",514,64,34,943,911,186,399,757,512
1945814,18,6,1995,3,"male",190,39,13,0,0,0,0,0,0
1945850,19,1,1994,11,"male",121,5,1,0,0,0,0,0,0
1945854,61,16,1952,5,"female",1674,203,129,436,49,0,41,436,8
1945873,24,1,1989,4,"male",554,312,236,25,166,25,70,0,96
1945921,23,1,1990,10,"male",107,28,24,51,31,51,23,0,8
1945937,50,2,1963,2,"female",90,66,31,6,5,6,5,0,0
1945967,22,14,1991,11,"male",418,21,13,0,0,0,0,0,0
1945975,22,15,1991,6,"female",1233,187,113,1335,436,1156,292,179,144
1945982,21,4,1992,3,"female",512,170,89,6,0,6,0,0,0
1945994,40,22,1973,5,"female",861,92,44,120,204,120,122,0,82
1945998,47,5,1966,10,"male",376,7,5,0,0,0,0,0,0
1946005,20,13,1993,4,"male",231,224,177,69,99,45,71,24,28
1946009,71,1,1942,1,"male",621,78,54,75,7,0,0,75,7
1946012,15,24,1998,8,"female",305,221,93,0,0,0,0,0,0
1946015,22,9,1991,8,"male",146,55,54,4,1,0,0,4,1
1946055,40,7,1973,4,"male",97,7,7,0,0,0,0,0,0
1946096,36,16,1977,10,"female",170,53,41,121,226,56,139,65,87
1946100,62,21,1951,7,"female",422,54,45,10,24,0,4,10,20
1946130,16,21,1997,3,"female",71,209,15,1,2,0,0,1,2
1946137,23,19,1990,3,"female",220,53,30,234,155,8,23,226,132
1946171,18,16,1995,7,"female",263,322,183,111,47,4,8,107,39
1946217,60,11,1953,9,"male",446,29,20,114,8,12,3,102,5
1946219,19,11,1994,1,"male",517,340,292,857,199,852,101,5,98
1946226,106,25,1907,5,"female",1814,63,19,118,7,0,2,118,5
1946240,18,16,1995,9,"male",467,227,80,26,20,26,19,0,1
1946245,67,10,1946,10,"female",756,44,31,4,46,0,21,4,25
1946246,31,21,1982,9,"male",448,1,0,0,0,0,0,0,0
1946270,25,20,1988,2,"female",278,101,54,0,1,0,1,0,0
1946286,72,28,1941,7,"female",216,50,42,0,1,0,1,0,0
1946315,26,6,1987,10,"male",342,169,140,4,6,1,5,3,1
1946320,64,17,1949,12,"female",1189,82,54,13,9,1,4,12,5
1946325,22,1,1991,11,"female",988,216,126,10,8,10,5,0,3
1946328,19,12,1994,12,"female",243,78,15,81,2,76,2,5,0
1946347,20,11,1993,5,"male",635,91,64,1,0,1,0,0,0
1946348,21,12,1992,3,"male",493,87,60,9,2,4,1,5,1
1946349,81,22,1932,5,"male",1432,2,2,0,0,0,0,0,0
1946421,113,1,1900,1,"male",1158,99,69,1,2,1,2,0,0
1946426,19,3,1994,11,"female",483,500,94,22,68,22,59,0,9
1946460,63,29,1950,11,"male",404,3,2,0,0,0,0,0,0
1946463,38,2,1975,5,"female",203,18,9,0,0,0,0,0,0
1946486,17,29,1996,7,"female",182,266,185,170,53,170,51,0,2
1946493,16,14,1997,12,"female",222,178,139,0,1,0,1,0,0
1946527,26,27,1987,8,"female",397,136,99,2,2,2,2,0,0
1946548,17,8,1996,1,"male",90,298,248,4438,1947,2574,888,1864,1059
1946558,15,3,1998,8,"male",301,71,61,0,0,0,0,0,0
1946574,43,3,1970,1,"male",752,49,26,0,1,0,1,0,0
1946588,27,22,1986,9,"female",1297,456,292,1305,685,1305,448,0,237
1946631,54,3,1959,11,"male",54,76,70,974,142,974,122,0,20
1946653,57,30,1956,11,"male",20,155,46,7,55,0,17,7,38
1946666,59,19,1954,10,"male",1304,29,11,1,9,0,2,1,7
1946673,14,15,1999,10,"male",339,376,222,1,5,1,5,0,0
1946680,59,29,1954,11,"female",1177,46,22,18,6,0,6,18,0
1946697,64,14,1949,1,"female",1519,46,35,52,31,49,23,3,8
1946707,23,28,1990,4,"female",583,69,55,84,41,84,38,0,3
1946713,30,2,1983,2,"male",114,34,21,44,40,44,33,0,7
1946759,58,25,1955,10,"male",1358,22,13,1,0,0,0,1,0
1946771,49,18,1964,10,"male",1093,633,381,177,246,177,179,0,67
1946784,23,13,1990,9,"female",339,144,117,245,301,238,134,7,167
1946831,37,13,1976,5,"female",77,67,45,206,215,206,136,0,79
1946844,20,16,1993,4,"female",870,152,81,0,8,0,3,0,5
1946858,67,5,1946,9,"female",479,128,17,1034,688,0,130,1034,558
1946865,31,14,1982,12,"female",308,39,14,17,17,17,12,0,5
1946882,63,16,1950,7,"male",1474,56,16,0,0,0,0,0,0
1946912,38,1,1975,1,"male",369,38,23,0,9,0,3,0,6
1946916,47,12,1966,9,"female",839,86,43,169,131,169,110,0,21
1946927,22,11,1991,8,"male",143,360,340,138,56,20,16,118,40
1946931,23,6,1990,11,"male",618,6,1,0,0,0,0,0,0
1946934,66,24,1947,1,"female",2107,55,24,16,4,16,3,0,1
1946940,18,12,1995,1,"female",292,451,335,19,179,19,170,0,9
1946986,50,8,1963,2,"male",551,65,44,2,15,1,3,1,12
1947001,52,6,1961,9,"male",1063,138,18,0,0,0,0,0,0
1947015,56,27,1957,3,"male",357,163,116,60,7,60,5,0,2
1947031,20,20,1993,2,"female",230,322,80,6,34,6,33,0,1
1947050,26,14,1987,9,"male",462,346,266,604,170,604,112,0,58
1947071,33,24,1980,9,"male",1489,190,64,1,3,1,3,0,0
1947072,23,15,1990,12,"male",272,37,26,1,1,0,1,1,0
1947074,60,24,1953,3,"male",1622,54,17,54,28,38,27,16,1
1947078,23,7,1990,8,"male",107,401,205,1359,992,363,597,996,395
1947079,22,13,1991,10,"male",695,248,229,44,18,20,4,24,14
1947106,108,18,1905,12,"male",224,92,44,86,82,0,27,86,55
1947141,40,1,1973,4,"male",110,60,53,3,1,3,0,0,1
1947156,61,26,1952,7,"female",64,28,12,59,28,57,12,2,16
1947171,16,20,1997,5,"female",542,354,247,410,168,409,116,1,52
1947204,23,11,1990,2,"female",89,159,95,1809,815,1809,647,0,168
1947208,49,16,1964,5,"female",358,137,94,448,20,448,11,0,9
1947212,58,8,1955,9,"female",32,13,5,2,3,2,3,0,0
1947232,29,12,1984,4,"male",322,44,15,0,3,0,3,0,0
1947268,66,8,1947,1,"male",1031,20,15,4,8,0,5,4,3
1947271,32,14,1981,10,"male",1627,354,58,110,137,78,82,32,55
1947281,103,13,1910,8,"female",1257,120,87,7,0,7,0,0,0
1947303,23,9,1990,11,"female",649,194,39,8,14,8,8,0,6
1947362,57,27,1956,8,"male",1274,80,31,15,15,3,7,12,8
1947399,63,27,1950,9,"male",1332,43,12,0,0,0,0,0,0
1947409,23,23,1990,3,"male",119,322,278,6,16,6,16,0,0
1947417,75,3,1938,6,"male",1826,50,23,2,4,0,2,2,2
1947419,70,10,1943,10,"male",549,24,11,1,6,0,3,1,3
1947423,19,12,1994,7,"male",109,122,114,179,37,128,24,51,13
1947493,22,14,1991,4,"female",59,115,54,15,48,15,46,0,2
1947535,79,28,1934,12,"female",1532,41,15,8,1,8,0,0,1
1947625,21,1,1992,1,"female",231,14,8,374,0,374,0,0,0
1947636,26,1,1987,1,"male",149,34,10,0,0,0,0,0,0
1947654,23,20,1990,4,"male",473,35,13,0,2,0,0,0,2
1947671,53,25,1960,7,"female",541,329,318,6,183,1,20,5,163
1947687,32,13,1981,11,"male",560,527,433,653,569,503,130,150,439
1947696,93,7,1920,4,"female",663,84,49,16,5,16,4,0,1
1947711,22,4,1991,1,"female",370,338,228,8,2,8,1,0,1
1947719,62,20,1951,12,"male",416,229,91,5,1,0,0,5,1
1947725,28,19,1985,3,"male",588,59,47,0,0,0,0,0,0
1947766,51,29,1962,4,"male",314,21,13,7,0,7,0,0,0
1947775,16,2,1997,2,"male",191,675,635,0,0,0,0,0,0
1947799,25,1,1988,1,"female",296,6,4,4474,44,110,14,4364,30
1947800,28,25,1985,9,"female",613,62,40,102,154,102,71,0,83
1947809,21,19,1992,12,"male",511,68,51,1,2,1,2,0,0
1947820,94,5,1919,2,"female",1532,684,431,157,134,153,110,4,24
1947831,57,5,1956,1,"male",824,68,44,7,3,7,2,0,1
1947834,19,24,1994,6,"male",199,53,30,33,7,23,3,10,4
1947842,45,27,1968,9,"female",421,85,67,3,17,3,9,0,8
1947845,16,3,1997,3,"female",1167,425,159,5,0,5,0,0,0
1947852,25,4,1988,6,"female",51,31,28,0,0,0,0,0,0
1947862,33,12,1980,11,"female",423,10,1,28,6,28,4,0,2
1947864,49,9,1964,9,"male",148,88,79,0,0,0,0,0,0
1947865,69,12,1944,9,"male",789,51,24,8,3,4,2,4,1
1947885,23,10,1990,1,"male",98,107,81,144,12,54,10,90,2
1947886,63,9,1950,3,"female",422,17,11,11,1,11,1,0,0
1947927,38,11,1975,6,"male",11,10,9,140,40,140,31,0,9
1947946,19,8,1994,7,"male",528,147,47,4,4,4,0,0,4
1947947,46,22,1967,4,"female",630,125,76,3,9,3,7,0,2
1947979,23,3,1990,1,"male",60,10,10,0,1,0,0,0,1
1947982,22,3,1991,5,"female",253,809,281,405,376,302,223,103,153
1948038,29,20,1984,8,"female",226,20,4,22,26,22,20,0,6
1948066,67,23,1946,3,"female",85,14,12,1,0,0,0,1,0
1948072,22,30,1991,8,"male",480,411,363,61,66,4,11,57,55
1948079,32,9,1981,6,"female",145,38,27,8,3,1,0,7,3
1948094,22,2,1991,5,"female",131,69,43,0,0,0,0,0,0
1948126,45,3,1968,1,"male",30,8,0,0,0,0,0,0,0
1948202,14,20,1999,6,"male",290,90,66,0,0,0,0,0,0
1948227,53,20,1960,7,"female",1011,24,20,4,0,4,0,0,0
1948229,73,12,1940,4,"male",1466,9,4,0,0,0,0,0,0
1948240,48,6,1965,10,"male",1020,10,1,1,1,1,1,0,0
1948261,31,7,1982,7,"female",355,19,12,11,4,0,1,11,3
1948264,23,10,1990,4,"male",733,166,78,148,153,148,76,0,77
1948304,54,4,1959,6,"male",1184,53,22,37,78,22,23,15,55
1948313,100,1,1913,2,"male",224,25,11,30,9,30,9,0,0
1948327,59,24,1954,5,"male",505,10,10,1,0,1,0,0,0
1948335,15,11,1998,5,"male",343,386,156,23,173,0,83,23,90
1948356,26,13,1987,2,"male",666,1,0,0,0,0,0,0,0
1948366,19,15,1994,3,"female",484,202,161,6,0,0,0,6,0
1948401,22,15,1991,6,"female",530,54,45,1,1,1,0,0,1
1948424,48,25,1965,1,"female",430,26,13,57,5,57,2,0,3
1948437,54,8,1959,12,"male",644,264,181,44,83,44,54,0,29
1948481,25,1,1988,1,"male",106,18,7,0,2,0,2,0,0
1948482,56,3,1957,8,"female",1921,116,49,54,46,18,17,36,29
1948490,28,12,1985,8,"female",152,84,64,20,20,11,12,9,8
1948499,15,29,1998,3,"female",563,1150,556,173,154,166,64,7,90
1948500,25,12,1988,6,"male",11,6,3,5,0,5,0,0,0
1948593,17,3,1996,11,"male",536,83,71,3,0,0,0,3,0
1948595,28,25,1985,12,"male",539,162,128,0,0,0,0,0,0
1948605,15,30,1998,1,"male",328,165,95,0,0,0,0,0,0
1948627,23,29,1990,10,"male",994,359,119,12,2,0,2,12,0
1948661,32,1,1981,1,"female",612,109,6,144,91,101,49,43,42
1948675,38,1,1975,7,"female",305,22,16,13,14,13,10,0,4
1948693,20,23,1993,12,"female",792,2624,517,7460,2513,958,1670,6502,843
1948698,16,17,1997,4,"male",295,43,41,0,0,0,0,0,0
1948764,45,2,1968,11,"male",705,205,88,11,0,7,0,4,0
1948772,46,17,1967,6,"female",198,30,18,21,0,21,0,0,0
1948776,33,20,1980,5,"male",401,32,17,3,5,3,5,0,0
1948781,21,3,1992,2,"male",1136,197,131,9,0,9,0,0,0
1948791,31,1,1982,1,"male",317,18,11,18,0,2,0,16,0
1948812,56,8,1957,4,"male",1109,28,15,0,0,0,0,0,0
1948844,48,3,1965,7,"male",612,44,26,86,80,71,56,15,24
1948852,18,3,1995,2,"female",257,476,371,3,4,3,3,0,1
1948855,61,27,1952,4,"female",2039,173,110,600,241,206,94,394,147
1948859,94,29,1919,7,"male",534,13,8,0,0,0,0,0,0
1948863,21,5,1992,6,"female",302,1,0,0,0,0,0,0,0
1948871,33,16,1980,1,"male",216,2,2,194,67,0,10,194,57
1948874,44,24,1969,2,"male",450,17,6,7,0,7,0,0,0
1948887,26,10,1987,10,"male",131,27,16,2,3,2,3,0,0
1948895,33,1,1980,1,"female",16,1,1,2,1,0,0,2,1
1948912,63,11,1950,12,"female",454,33,25,18,4,0,0,18,4
1948918,32,20,1981,10,"male",523,219,38,86,76,85,61,1,15
1948920,27,17,1986,6,"male",316,50,32,0,0,0,0,0,0
1948932,19,5,1994,4,"female",361,1280,474,99,467,83,381,16,86
1948944,18,8,1995,10,"male",589,511,404,1,0,0,0,1,0
1948952,38,12,1975,12,"female",69,83,21,147,114,147,107,0,7
1948999,47,27,1966,11,"male",162,188,153,88,61,67,41,21,20
1949004,62,12,1951,5,"male",844,29,19,0,0,0,0,0,0
1949013,14,15,1999,3,"male",134,63,45,2,1,2,1,0,0
1949048,15,19,1998,5,"female",529,88,53,49,66,0,38,49,28
1949061,16,15,1997,6,"female",414,307,139,445,381,445,327,0,54
1949075,48,26,1965,5,"male",439,41,19,9,4,3,3,6,1
1949090,60,15,1953,7,"male",983,16,13,2,12,0,3,2,9
1949108,17,26,1996,12,"male",192,363,265,6,3,6,3,0,0
1949138,44,18,1969,5,"female",362,184,161,3,5,3,5,0,0
1949164,27,9,1986,8,"female",387,23,2,0,0,0,0,0,0
1949170,86,26,1927,3,"male",1548,370,158,34,4,0,1,34,3
1949174,65,20,1948,12,"male",2050,439,95,30,133,30,35,0,98
1949208,64,3,1949,11,"female",440,77,48,115,46,0,13,115,33
1949222,23,15,1990,6,"male",421,71,34,7,9,7,8,0,1
1949247,34,9,1979,9,"male",291,22,12,123,63,123,46,0,17
1949265,25,24,1988,10,"male",358,127,98,4,0,4,0,0,0
1949289,21,15,1992,9,"female",458,102,29,8,0,4,0,4,0
1949290,23,5,1990,11,"male",435,172,71,37,159,37,124,0,35
1949292,18,7,1995,6,"male",476,877,793,99,5,99,4,0,1
1949313,40,6,1973,3,"female",419,37,36,0,2,0,1,0,1
1949343,22,1,1991,1,"male",602,0,0,0,0,0,0,0,0
1949347,24,16,1989,12,"male",504,112,28,1,0,1,0,0,0
1949356,53,25,1960,9,"male",551,10,4,0,0,0,0,0,0
1949363,17,7,1996,11,"male",96,54,42,15,15,15,11,0,4
1949370,26,2,1987,5,"female",330,78,53,2,3,0,3,2,0
1949377,31,1,1982,1,"male",481,53,10,1,0,0,0,1,0
1949406,68,22,1945,10,"male",1276,1992,1529,199,127,187,91,12,36
1949417,20,26,1993,1,"male",822,510,447,58,35,26,23,32,12
1949460,43,3,1970,11,"male",228,12,12,0,0,0,0,0,0
1949479,24,18,1989,7,"male",412,99,85,2,24,0,10,2,14
1949491,30,23,1983,3,"male",27,9,9,0,0,0,0,0,0
1949508,27,21,1986,5,"male",27,22,22,6,1,6,1,0,0
1949517,22,28,1991,12,"male",438,325,62,3,2,3,1,0,1
1949519,68,28,1945,3,"female",661,49,20,105,30,0,16,105,14
1949536,13,1,2000,2,"male",261,37,26,0,0,0,0,0,0
1949542,17,27,1996,11,"male",418,141,117,0,8,0,3,0,5
1949565,36,3,1977,5,"male",482,22,8,0,1,0,1,0,0
1949570,51,12,1962,2,"female",525,81,38,415,320,391,196,24,124
1949576,46,11,1967,6,"female",516,257,196,50,47,23,27,27,20
1949593,61,21,1952,11,"male",318,42,22,3,2,0,0,3,2
1949609,26,19,1987,11,"male",209,56,23,2,0,2,0,0,0
1949611,17,25,1996,12,"male",80,92,53,0,3,0,1,0,2
1949616,20,4,1993,1,"female",19,2,2,0,0,0,0,0,0
1949632,22,11,1991,5,"male",728,184,148,30,132,30,70,0,62
1949633,53,7,1960,4,"female",1098,26,20,144,62,126,31,18,31
1949638,16,1,1997,8,"female",23,28,15,16,6,11,6,5,0
1949642,40,11,1973,9,"female",478,70,60,2385,119,2385,83,0,36
1949667,18,20,1995,4,"male",216,152,93,21,64,20,25,1,39
1949675,44,14,1969,5,"male",427,621,453,0,0,0,0,0,0
1949676,52,8,1961,10,"male",643,32,21,1,1,1,0,0,1
1949678,26,30,1987,9,"female",195,14,9,1,1,1,1,0,0
1949681,22,30,1991,10,"male",471,117,69,31,1,31,1,0,0
1949709,22,4,1991,10,"male",144,41,31,1,0,1,0,0,0
1949751,64,5,1949,12,"male",803,145,70,1,76,0,19,1,57
1949766,27,25,1986,12,"male",436,95,50,1,0,1,0,0,0
1949783,40,21,1973,11,"male",239,237,215,5,18,5,6,0,12
1949814,49,9,1964,11,"female",1135,72,48,35,54,35,22,0,32
1949843,22,16,1991,8,"female",531,796,631,2270,1083,1832,832,438,251
1949851,23,26,1990,1,"male",678,80,37,0,1,0,1,0,0
1949852,25,3,1988,2,"male",258,28,22,0,0,0,0,0,0
1949862,34,18,1979,5,"male",1063,540,303,0,1,0,1,0,0
1949868,16,12,1997,2,"female",153,828,683,20,56,20,33,0,23
1949883,60,3,1953,10,"male",2309,168,113,188,38,188,16,0,22
1949895,18,7,1995,11,"male",266,72,14,0,0,0,0,0,0
1949928,15,6,1998,1,"male",506,105,77,443,18,443,17,0,1
1949930,56,3,1957,12,"male",432,119,67,67,86,67,73,0,13
1949951,40,24,1973,6,"male",310,89,38,0,25,0,2,0,23
1949964,29,3,1984,3,"male",71,55,38,24,19,24,16,0,3
1949966,19,24,1994,6,"female",813,1181,815,185,486,98,230,87,256
1949971,14,27,1999,10,"male",354,211,94,69,52,0,10,69,42
1949979,25,1,1988,1,"female",167,22,18,0,3,0,1,0,2
1950081,67,12,1946,9,"female",1616,44,23,56,47,22,31,34,16
1950148,18,4,1995,4,"male",325,55,37,4,1,4,1,0,0
1950167,19,27,1994,12,"female",471,230,66,58,178,3,38,55,140
1950174,42,31,1971,10,"female",441,3,2,3,3,3,2,0,1
1950200,16,23,1997,12,"male",503,40,31,0,0,0,0,0,0
1950215,64,11,1949,6,"male",131,28,22,102,32,102,30,0,2
1950239,24,24,1989,12,"male",204,61,49,0,0,0,0,0,0
1950285,76,20,1937,12,"female",1311,39,27,83,66,0,9,83,57
1950293,22,10,1991,4,"male",21,48,44,0,7,0,6,0,1
1950301,18,3,1995,7,"male",301,16,16,0,0,0,0,0,0
1950308,20,9,1993,4,"male",120,62,54,3,0,0,0,3,0
1950316,23,15,1990,7,"female",510,32,11,14,15,0,3,14,12
1950362,50,4,1963,11,"male",505,43,34,17,0,17,0,0,0
1950370,21,2,1992,9,"male",737,317,191,6,0,6,0,0,0
1950405,53,10,1960,9,"male",725,204,128,31,46,17,42,14,4
1950450,24,2,1989,11,"female",812,257,66,0,0,0,0,0,0
1950481,22,16,1991,8,"female",64,25,23,2,9,2,9,0,0
1950491,30,24,1983,7,"male",106,8,8,17,0,17,0,0,0
1950544,18,18,1995,7,"female",501,279,149,53,66,53,51,0,15
1950549,26,27,1987,4,"male",395,23,22,161,2,40,1,121,1
1950560,25,7,1988,1,"male",172,38,29,0,0,0,0,0,0
1950586,29,2,1984,2,"male",349,14,6,0,11,0,11,0,0
1950623,37,31,1976,10,"male",251,2,2,0,0,0,0,0,0
1950626,61,19,1952,10,"female",136,41,11,46,41,46,20,0,21
1950628,31,5,1982,6,"female",635,30,17,336,126,336,68,0,58
1950687,32,1,1981,6,"female",299,29,23,0,1,0,0,0,1
1950692,59,25,1954,5,"male",889,10,7,14,5,11,5,3,0
1950694,33,12,1980,12,"female",529,0,0,0,0,0,0,0,0
1950702,61,5,1952,12,"female",11,10,9,11,11,0,1,11,10
1950767,25,25,1988,12,"female",326,486,287,1,0,1,0,0,0
1950780,73,6,1940,6,"female",690,25,16,9,10,2,2,7,8
1950787,23,7,1990,4,"female",270,114,82,1225,1137,1225,782,0,355
1950795,18,2,1995,2,"male",523,708,431,70,192,47,122,23,70
1950800,23,9,1990,2,"female",308,54,33,19,0,19,0,0,0
1950816,15,27,1998,2,"male",349,225,144,126,110,22,23,104,87
1950901,32,28,1981,8,"female",391,53,23,39,25,34,16,5,9
1950908,34,13,1979,11,"male",666,40,23,1412,3220,1412,1798,0,1422
1950912,103,12,1910,3,"male",1018,761,570,191,206,139,116,52,90
1950918,24,20,1989,4,"male",467,90,69,4,0,4,0,0,0
1950923,92,25,1921,12,"female",1531,18,15,17,19,2,16,15,3
1950945,20,1,1993,10,"male",100,89,74,0,0,0,0,0,0
1950958,64,6,1949,2,"female",1068,420,174,3716,1229,3716,750,0,479
1950995,21,1,1992,1,"male",147,0,0,0,0,0,0,0,0
1951003,84,30,1929,3,"male",534,3,0,0,0,0,0,0,0
1951019,29,1,1984,1,"male",51,23,22,8,0,8,0,0,0
1951062,21,1,1992,4,"male",234,102,89,16,6,16,6,0,0
1951068,29,1,1984,8,"male",108,5,1,0,0,0,0,0,0
1951070,92,25,1921,12,"male",1913,517,226,58,15,8,8,50,7
1951096,25,1,1988,1,"female",59,0,0,0,0,0,0,0,0
1951116,19,1,1994,1,"female",68,206,138,686,1153,676,531,10,622
1951128,23,12,1990,10,"male",200,24,24,0,0,0,0,0,0
1951131,39,1,1974,1,"female",381,15,13,11,1,11,1,0,0
1951138,31,24,1982,2,"male",236,70,50,11,33,5,15,6,18
1951151,68,15,1945,9,"male",1062,32,14,13,29,13,22,0,7
1951153,53,20,1960,8,"female",1578,550,323,233,580,218,288,15,292
1951180,19,29,1994,9,"male",14,9,4,0,0,0,0,0,0
1951181,32,6,1981,3,"female",732,49,31,77,35,77,34,0,1
1951191,32,31,1981,8,"male",162,43,31,16,5,0,4,16,1
1951212,36,12,1977,9,"male",543,7,4,0,0,0,0,0,0
1951239,22,31,1991,12,"male",132,147,109,20,2,1,0,19,2
1951252,54,9,1959,7,"female",376,196,114,111,175,0,43,111,132
1951265,101,3,1912,7,"female",540,126,86,109,9,109,9,0,0
1951285,27,29,1986,9,"male",248,228,219,0,3,0,3,0,0
1951292,22,4,1991,4,"male",429,35,19,35,34,16,16,19,18
1951308,33,7,1980,5,"male",385,86,50,5,6,5,6,0,0
1951354,17,11,1996,8,"male",14,0,0,0,0,0,0,0,0
1951355,66,29,1947,6,"female",715,363,268,90,13,27,4,63,9
1951384,38,30,1975,3,"male",593,243,195,1345,241,1345,224,0,17
1951410,20,2,1993,9,"female",249,15,13,37,33,37,18,0,15
1951441,37,14,1976,11,"female",524,51,26,75,244,1,37,74,207
1951446,42,9,1971,4,"male",198,264,221,0,2,0,0,0,2
1951480,108,12,1905,10,"male",922,136,89,0,0,0,0,0,0
1951487,39,30,1974,6,"male",394,36,25,5,11,0,2,5,9
1951528,31,19,1982,11,"male",525,109,43,110,16,110,11,0,5
1951549,28,12,1985,12,"female",618,392,305,63,561,63,382,0,179
1951581,23,28,1990,1,"female",1377,425,171,17,147,17,100,0,47
1951625,25,1,1988,1,"male",71,27,21,0,0,0,0,0,0
1951641,54,6,1959,2,"female",1091,57,30,3,11,0,6,3,5
1951646,59,6,1954,5,"male",1845,56,18,1,6,1,4,0,2
1951660,15,20,1998,2,"male",493,200,77,0,1,0,1,0,0
1951669,103,19,1910,10,"male",1918,575,436,19,9,0,1,19,8
1951686,33,19,1980,7,"female",409,24,12,12,0,12,0,0,0
1951692,41,12,1972,10,"male",511,20,16,1,2,1,2,0,0
1951732,15,28,1998,9,"female",887,985,610,1459,2178,1159,1062,300,1116
1951736,50,24,1963,8,"male",284,28,18,570,17,518,3,52,14
1951740,18,11,1995,1,"male",449,52,42,0,2,0,2,0,0
1951743,14,16,1999,6,"male",103,170,158,0,0,0,0,0,0
1951759,50,20,1963,6,"female",663,59,18,48,34,18,20,30,14
1951761,33,6,1980,3,"male",308,16,14,5,0,5,0,0,0
1951781,21,14,1992,10,"female",179,348,187,31,53,31,31,0,22
1951806,19,1,1994,4,"female",560,55,38,0,0,0,0,0,0
1951840,21,9,1992,4,"male",371,349,104,465,1410,423,903,42,507
1951864,24,2,1989,10,"female",520,157,109,5,10,5,3,0,7
1951866,16,17,1997,9,"female",251,208,105,8,0,8,0,0,0
1951891,28,19,1985,7,"male",1282,199,115,75,137,72,117,3,20
1951901,16,23,1997,11,"male",598,38,27,175,12,0,2,175,10
1951908,43,17,1970,4,"female",418,188,90,96,7,96,5,0,2
1951920,43,31,1970,7,"male",616,291,211,1,40,1,32,0,8
1951924,42,2,1971,3,"female",1046,96,45,16,43,16,5,0,38
1951968,23,17,1990,4,"male",791,0,0,0,0,0,0,0,0
1951972,22,9,1991,6,"female",660,51,33,0,0,0,0,0,0
1952029,53,17,1960,4,"male",2069,177,143,37,66,21,42,16,24
1952045,14,4,1999,5,"female",510,236,128,8,1,8,0,0,1
1952068,101,10,1912,8,"female",472,230,102,52,0,52,0,0,0
1952069,15,5,1998,2,"female",220,297,179,360,129,0,36,360,93
1952076,35,29,1978,11,"female",893,1,1,58,7,31,7,27,0
1952077,38,19,1975,12,"female",182,140,124,288,167,288,140,0,27
1952082,30,1,1983,9,"male",319,70,50,6,2,6,2,0,0
1952097,32,1,1981,1,"male",7,0,0,2,0,2,0,0,0
1952125,17,10,1996,8,"male",415,350,271,664,38,664,30,0,8
1952127,55,3,1958,1,"female",1107,147,52,1318,809,1316,501,2,308
1952128,104,18,1909,9,"female",349,618,303,28,4,28,2,0,2
1952156,67,20,1946,3,"female",635,57,34,37,19,11,16,26,3
1952159,22,7,1991,9,"male",548,774,291,662,1225,319,468,343,757
1952215,60,18,1953,8,"male",1839,122,53,2,6,2,4,0,2
1952225,24,6,1989,12,"female",797,476,274,46,128,46,100,0,28
1952230,22,26,1991,6,"female",653,502,339,568,342,35,133,533,209
1952235,22,12,1991,2,"male",525,63,47,0,0,0,0,0,0
1952249,18,9,1995,12,"male",102,7,6,0,0,0,0,0,0
1952264,31,28,1982,8,"male",514,210,95,97,81,42,35,55,46
1952278,54,8,1959,2,"female",1166,84,51,27,43,27,33,0,10
1952280,51,5,1962,5,"female",428,76,44,149,30,12,25,137,5
1952286,25,9,1988,12,"female",309,621,270,125,194,44,80,81,114
1952297,21,30,1992,4,"female",463,3345,680,30,354,30,216,0,138
1952307,22,10,1991,1,"male",105,51,21,9,13,3,9,6,4
1952342,25,2,1988,4,"male",738,100,30,104,77,87,52,17,25
1952345,30,20,1983,12,"male",597,96,82,105,46,90,36,15,10
1952358,49,9,1964,2,"male",207,8,3,0,0,0,0,0,0
1952369,75,18,1938,11,"female",1142,34,18,84,12,0,4,84,8
1952371,25,2,1988,10,"female",420,55,36,0,4,0,4,0,0
1952385,52,30,1961,3,"male",48,14,13,0,0,0,0,0,0
1952407,60,18,1953,9,"female",1472,599,463,642,806,0,189,642,617
1952466,18,23,1995,8,"male",581,77,27,0,9,0,8,0,1
1952484,48,29,1965,7,"male",17,18,15,46,26,45,19,1,7
1952499,103,9,1910,7,"female",1457,69,40,3,2,3,2,0,0
1952536,29,14,1984,2,"male",802,2,2,0,0,0,0,0,0
1952573,18,8,1995,8,"female",328,373,125,78,133,78,114,0,19
1952575,24,20,1989,8,"female",430,1861,818,1268,201,1268,188,0,13
1952598,39,2,1974,3,"female",8,0,0,0,0,0,0,0,0
1952629,25,18,1988,4,"female",256,355,121,2,0,2,0,0,0
1952660,23,22,1990,1,"male",848,358,211,191,48,80,20,111,28
1952666,21,20,1992,9,"male",563,16,15,39,9,10,4,29,5
1952682,21,22,1992,3,"male",1704,128,86,109,46,109,20,0,26
1952688,65,15,1948,9,"female",743,31,13,25,1,0,1,25,0
1952719,15,6,1998,9,"male",285,142,59,2,14,0,12,2,2
1952720,18,6,1995,11,"female",595,459,342,49,87,38,41,11,46
1952740,25,25,1988,12,"male",325,184,99,36,58,36,28,0,30
1952756,100,28,1913,8,"female",962,89,68,325,235,321,168,4,67
1952778,25,10,1988,6,"male",99,94,78,2,2,2,2,0,0
1952781,31,2,1982,2,"male",397,87,44,0,0,0,0,0,0
1952792,22,1,1991,1,"male",769,0,0,0,0,0,0,0,0
1952851,68,1,1945,2,"male",1327,707,408,247,63,247,58,0,5
1952878,20,13,1993,3,"male",722,574,382,9,5,2,2,7,3
1952892,55,17,1958,5,"female",1440,54,31,146,86,146,75,0,11
1952926,20,15,1993,11,"male",466,322,280,238,302,238,210,0,92
1952928,33,31,1980,10,"male",433,99,26,754,93,754,70,0,23
1952941,18,27,1995,10,"female",798,147,104,2065,769,1882,428,183,341
1952942,61,28,1952,1,"female",1815,81,40,74,26,24,17,50,9
1952949,54,14,1959,11,"male",233,0,0,0,0,0,0,0,0
1952952,27,21,1986,8,"male",292,9,8,0,0,0,0,0,0
1952962,64,12,1949,8,"male",559,21,17,0,31,0,1,0,30
1952963,67,13,1946,2,"male",671,128,82,1,3,1,3,0,0
1952975,103,22,1910,6,"male",1138,611,297,328,158,328,120,0,38
1952987,27,24,1986,7,"male",561,229,147,7,2,0,0,7,2
1953013,29,1,1984,1,"male",384,43,42,61,3,61,3,0,0
1953023,108,5,1905,8,"female",115,395,211,27,17,27,14,0,3
1953039,16,27,1997,12,"male",307,245,161,1,1,0,0,1,1
1953066,22,10,1991,4,"male",441,202,169,13,6,13,6,0,0
1953089,27,22,1986,10,"female",309,29,1,1,0,1,0,0,0
1953103,25,20,1988,4,"male",267,57,42,41,25,40,14,1,11
1953119,20,1,1993,1,"male",183,22,21,0,0,0,0,0,0
1953121,22,15,1991,5,"female",765,5,4,18,199,15,0,3,199
1953154,20,28,1993,4,"male",623,210,126,0,6,0,6,0,0
1953166,100,1,1913,4,"female",2173,195,73,114,442,27,128,87,314
1953179,15,10,1998,7,"male",403,91,62,5,6,5,5,0,1
1953187,25,2,1988,1,"male",198,17,13,91,46,91,18,0,28
1953202,55,21,1958,5,"male",687,63,25,0,0,0,0,0,0
1953217,32,7,1981,8,"male",417,139,65,197,48,197,46,0,2
1953249,19,4,1994,4,"male",582,492,435,79,899,79,828,0,71
1953255,20,28,1993,7,"male",226,243,204,34,2,34,2,0,0
1953269,25,31,1988,8,"male",228,32,26,0,0,0,0,0,0
1953312,15,20,1998,4,"female",456,64,39,22,1,22,1,0,0
1953343,56,2,1957,11,"female",145,135,93,112,165,8,30,104,135
1953361,52,15,1961,6,"female",746,80,70,47,19,0,3,47,16
1953364,21,1,1992,5,"female",14,42,21,171,83,171,72,0,11
1953396,21,1,1992,6,"male",549,339,190,67,2,67,2,0,0
1953409,18,29,1995,5,"female",973,126,92,197,98,148,35,49,63
1953431,37,18,1976,9,"male",470,270,201,0,1,0,0,0,1
1953454,30,30,1983,8,"female",387,13,11,7,11,0,7,7,4
1953464,64,14,1949,2,"male",181,32,9,71,0,0,0,71,0
1953469,23,21,1990,2,"male",429,28,23,0,3,0,1,0,2
1953470,26,1,1987,1,"male",337,59,42,0,0,0,0,0,0
1953483,60,25,1953,2,"female",230,12,6,0,0,0,0,0,0
1953488,53,25,1960,11,"female",690,36,23,1314,52,1314,52,0,0
1953503,113,29,1900,10,"male",1345,418,308,417,115,417,106,0,9
1953546,31,17,1982,1,"male",267,0,0,0,0,0,0,0,0
1953559,69,9,1944,1,"female",1852,148,43,948,601,0,224,948,377
1953560,28,24,1985,9,"male",446,49,9,1,13,1,7,0,6
1953566,26,5,1987,4,"female",294,46,23,80,31,80,6,0,25
1953567,53,30,1960,11,"female",69,79,50,28,9,28,8,0,1
1953611,27,6,1986,6,"male",645,154,69,35,5,35,5,0,0
1953624,46,20,1967,5,"male",438,187,137,340,79,340,63,0,16
1953641,14,27,1999,9,"male",207,193,66,42,27,42,24,0,3
1953649,91,31,1922,1,"male",693,99,84,242,87,242,80,0,7
1953666,55,18,1958,12,"female",80,51,19,1071,53,1071,31,0,22
1953670,51,20,1962,6,"male",295,173,125,269,39,269,31,0,8
1953680,24,14,1989,2,"male",510,74,55,0,6,0,0,0,6
1953693,62,25,1951,1,"female",1189,44,30,29,2,29,2,0,0
1953719,21,14,1992,12,"male",423,183,111,9,36,9,26,0,10
1953731,21,5,1992,10,"female",245,303,153,59,97,59,63,0,34
1953746,31,21,1982,2,"male",168,61,53,1,3,1,3,0,0
1953751,57,28,1956,2,"female",687,38,20,9,0,9,0,0,0
1953763,22,28,1991,12,"female",280,341,259,1345,1140,1075,517,270,623
1953779,16,1,1997,6,"female",463,1060,598,693,921,673,674,20,247
1953792,57,14,1956,4,"female",1153,167,46,137,224,136,180,1,44
1953793,21,29,1992,1,"female",242,5,5,0,0,0,0,0,0
1953811,52,14,1961,7,"male",730,67,37,0,0,0,0,0,0
1953831,53,9,1960,1,"female",114,55,39,9,7,9,5,0,2
1953841,32,31,1981,5,"male",807,9,5,5,12,3,1,2,11
1953850,53,7,1960,5,"female",88,6,2,2,11,0,9,2,2
1953857,15,6,1998,1,"male",264,238,187,343,78,343,63,0,15
1953909,25,29,1988,3,"male",39,26,15,1,15,1,14,0,1
1953928,20,11,1993,8,"male",406,67,56,6,6,5,4,1,2
1953934,26,4,1987,2,"female",61,1,1,0,0,0,0,0,0
1953936,33,30,1980,7,"male",864,33,29,50,32,50,27,0,5
1953938,20,4,1993,9,"male",255,130,95,3,2,2,2,1,0
1953950,14,9,1999,9,"female",4,1,0,0,0,0,0,0,0
1953960,62,1,1951,6,"female",94,36,10,0,7,0,7,0,0
1953962,17,27,1996,7,"male",60,53,41,102,238,23,56,79,182
1953971,20,23,1993,7,"male",269,221,151,62,9,20,8,42,1
1953978,19,2,1994,8,"male",436,240,153,0,0,0,0,0,0
1953998,19,12,1994,11,"female",533,688,366,556,678,501,548,55,130
1954039,26,7,1987,6,"male",525,31,18,1,0,1,0,0,0
1954041,27,1,1986,4,"male",584,44,15,43,7,43,7,0,0
1954076,20,28,1993,10,"female",517,503,159,1121,564,308,220,813,344
1954106,19,10,1994,8,"male",471,136,126,1,7,1,0,0,7
1954110,35,2,1978,4,"male",541,59,23,0,2,0,1,0,1
1954118,24,19,1989,4,"male",36,30,23,1,0,1,0,0,0
1954136,44,18,1969,11,"male",572,273,238,96,43,96,34,0,9
1954173,42,29,1971,9,"female",209,224,157,350,109,233,70,117,39
1954221,39,2,1974,6,"female",471,3,0,4,0,0,0,4,0
1954251,27,25,1986,5,"female",412,91,43,1,1,1,1,0,0
1954295,19,16,1994,9,"female",606,387,325,1,57,1,53,0,4
1954306,15,21,1998,2,"female",352,453,277,236,297,236,271,0,26
1954336,15,25,1998,4,"male",1079,1601,1286,1762,1229,404,762,1358,467
1954344,21,3,1992,3,"female",699,159,63,2,30,2,21,0,9
1954371,25,11,1988,1,"female",248,0,0,1,0,1,0,0,0
1954382,23,12,1990,12,"male",519,88,50,4,3,0,1,4,2
1954391,24,27,1989,4,"male",370,0,0,0,0,0,0,0,0
1954397,18,16,1995,8,"female",131,376,141,271,97,271,79,0,18
1954414,61,22,1952,3,"female",1368,89,31,11,50,5,34,6,16
1954453,23,20,1990,5,"male",355,29,10,11,1,11,1,0,0
1954460,24,23,1989,1,"female",90,72,42,228,193,102,108,126,85
1954490,108,9,1905,9,"female",1280,125,66,885,701,377,341,508,360
1954534,30,11,1983,8,"female",1022,112,41,162,133,87,66,75,67
1954539,20,5,1993,7,"male",430,131,103,31,4,31,4,0,0
1954599,41,22,1972,1,"male",423,136,73,72,37,5,10,67,27
1954600,25,21,1988,3,"male",549,35,22,12,16,12,12,0,4
1954625,21,3,1992,12,"female",112,99,40,0,4,0,3,0,1
1954628,55,21,1958,1,"male",1320,59,2,0,2,0,2,0,0
1954646,21,16,1992,10,"female",104,79,61,2,95,2,22,0,73
1954648,46,12,1967,4,"male",595,15,9,112,16,89,12,23,4
1954672,15,16,1998,4,"male",441,29,16,1,1,0,0,1,1
1954686,39,9,1974,3,"female",472,112,76,393,81,393,76,0,5
1954745,28,1,1985,10,"male",449,166,162,0,1,0,1,0,0
1954753,26,17,1987,1,"male",145,46,15,1,4,1,3,0,1
1954773,21,11,1992,5,"male",47,21,10,3,0,3,0,0,0
1954782,24,19,1989,2,"female",254,161,136,6,2,0,1,6,1
1954817,16,24,1997,2,"male",812,239,120,3,0,3,0,0,0
1954831,24,6,1989,12,"female",178,67,43,9,16,3,7,6,9
1954836,27,15,1986,12,"male",54,220,197,1164,445,1164,425,0,20
1954905,34,23,1979,12,"male",339,38,34,42,44,42,40,0,4
1954942,63,18,1950,12,"female",621,14,6,0,0,0,0,0,0
1954991,27,2,1986,11,"female",134,126,107,171,83,171,67,0,16
1955001,21,1,1992,2,"male",205,21,13,48,9,0,2,48,7
1955010,38,10,1975,2,"male",179,33,23,0,0,0,0,0,0
1955029,66,1,1947,9,"male",66,66,27,73,5,73,5,0,0
1955101,31,14,1982,3,"male",358,18,17,2,0,0,0,2,0
1955125,17,8,1996,2,"male",285,109,38,28,11,24,5,4,6
1955134,31,27,1982,1,"female",560,49,30,234,87,234,69,0,18
1955142,65,29,1948,4,"female",738,42,7,1,1,0,1,1,0
1955175,30,17,1983,1,"male",579,54,19,2,0,2,0,0,0
1955180,53,24,1960,8,"male",327,54,21,6,0,0,0,6,0
1955196,55,23,1958,10,"female",325,35,30,41,9,39,8,2,1
1955220,19,17,1994,4,"male",106,6,3,1,1,1,1,0,0
1955228,25,7,1988,6,"male",235,483,438,17,55,17,48,0,7
1955272,34,12,1979,12,"male",136,95,80,34,83,34,73,0,10
1955288,16,1,1997,1,"male",0,0,0,4,1,4,0,0,1
1955303,38,23,1975,7,"male",389,108,89,1811,1036,797,643,1014,393
1955319,21,19,1992,10,"male",25,43,22,6,4,6,4,0,0
1955323,33,19,1980,10,"male",104,61,56,25,1,0,0,25,1
1955328,53,7,1960,12,"female",697,106,93,37,75,37,59,0,16
1955338,102,30,1911,3,"male",407,13,13,7,7,0,7,7,0
1955356,103,23,1910,9,"female",1029,729,356,5,18,5,15,0,3
1955365,17,23,1996,7,"male",635,287,231,61,7,1,2,60,5
1955366,102,26,1911,3,"male",985,914,572,118,244,91,49,27,195
1955373,23,7,1990,9,"male",537,1270,1118,47,11,47,10,0,1
1955378,29,17,1984,7,"male",984,119,49,7,12,0,4,7,8
1955403,59,21,1954,7,"male",1077,36,12,0,0,0,0,0,0
1955412,103,26,1910,6,"male",889,90,60,0,0,0,0,0,0
1955425,36,30,1977,9,"male",155,112,29,2,23,2,17,0,6
1955433,19,23,1994,12,"female",300,42,22,1299,164,1299,98,0,66
1955451,15,17,1998,11,"male",123,402,266,9,131,6,58,3,73
1955474,19,18,1994,10,"male",517,1000,853,5367,3338,2780,2530,2587,808
1955480,21,7,1992,1,"male",49,150,79,185,12,185,9,0,3
1955503,96,7,1917,10,"female",604,4803,555,313,501,0,219,313,282
1955511,45,25,1968,6,"male",537,66,49,46,47,29,22,17,25
1955524,28,1,1985,12,"male",1593,601,389,2,1,1,0,1,1
1955530,26,5,1987,2,"female",446,143,42,11,0,11,0,0,0
1955537,20,5,1993,1,"female",465,100,52,7,14,7,6,0,8
1955574,50,25,1963,3,"female",192,61,37,1252,46,1252,37,0,9
1955575,14,25,1999,1,"female",68,40,24,44,54,44,9,0,45
1955583,23,28,1990,5,"male",201,100,71,1,1,1,1,0,0
1955587,62,14,1951,11,"female",996,115,42,521,200,14,111,507,89
1955608,68,26,1945,3,"male",542,27,6,0,0,0,0,0,0
1955645,18,2,1995,2,"male",521,9,6,2,0,2,0,0,0
1955692,18,26,1995,6,"female",389,690,378,1394,1019,1394,992,0,27
1955753,25,14,1988,11,"male",703,22,11,43,4,39,3,4,1
1955767,33,27,1980,3,"female",285,166,126,76,82,75,36,1,46
1955769,30,25,1983,12,"female",292,4,2,0,0,0,0,0,0
1955770,29,11,1984,6,"male",327,110,59,14,2,14,2,0,0
1955801,31,7,1982,7,"female",128,45,36,63,255,63,239,0,16
1955818,58,23,1955,3,"female",1823,209,58,121,91,111,68,10,23
1955819,30,10,1983,5,"female",901,75,46,129,51,123,27,6,24
1955823,27,25,1986,10,"male",297,92,74,44,11,44,11,0,0
1955848,43,8,1970,2,"male",19,5,4,4,1,4,1,0,0
1955862,47,30,1966,8,"male",896,78,63,1,5,1,4,0,1
1955881,19,15,1994,8,"female",707,50,32,1980,873,1410,406,570,467
1955912,21,1,1992,4,"male",15,57,52,7,3,7,3,0,0
1955966,46,27,1967,5,"female",784,68,39,462,598,240,324,222,274
1956025,17,1,1996,10,"female",72,32,20,0,0,0,0,0,0
1956036,93,18,1920,2,"male",140,64,54,16,2,16,0,0,2
1956049,60,28,1953,11,"female",1093,42,15,152,41,40,13,112,28
1956062,32,21,1981,5,"male",315,67,20,1,20,1,6,0,14
1956068,40,27,1973,7,"female",382,31,29,299,12,299,8,0,4
1956090,57,15,1956,4,"female",458,25,21,13,3,0,1,13,2
1956100,27,3,1986,3,"female",314,195,48,124,404,124,143,0,261
1956126,108,25,1905,2,"male",1415,737,391,240,470,18,328,222,142
1956140,25,18,1988,6,"male",178,113,81,8,0,8,0,0,0
1956164,22,15,1991,6,"male",226,1,1,0,0,0,0,0,0
1956175,30,22,1983,6,"female",407,10,7,0,0,0,0,0,0
1956179,15,1,1998,8,"male",148,41,37,4,0,4,0,0,0
1956197,24,12,1989,6,"male",437,58,50,26,2,22,0,4,2
1956216,24,18,1989,7,"male",448,32,27,0,0,0,0,0,0
1956240,50,17,1963,6,"male",319,21,10,0,0,0,0,0,0
1956244,22,10,1991,5,"male",394,844,704,24,220,24,204,0,16
1956268,47,1,1966,1,"female",381,39,33,97,6,97,4,0,2
1956270,35,2,1978,3,"male",745,11,9,18,5,0,0,18,5
1956298,41,20,1972,3,"female",272,31,20,53,27,53,27,0,0
1956302,69,3,1944,5,"female",1274,389,147,19,1,19,1,0,0
1956311,26,14,1987,10,"female",1202,63,43,1,10,1,3,0,7
1956349,22,1,1991,7,"female",391,48,10,6,15,6,5,0,10
1956386,22,30,1991,12,"female",440,132,70,356,347,117,150,239,197
1956412,28,27,1985,3,"male",34,21,20,1,2,1,1,0,1
1956416,25,1,1988,1,"male",76,1,1,1,0,1,0,0,0
1956435,35,26,1978,7,"female",547,97,61,102,161,22,78,80,83
1956443,25,1,1988,1,"male",47,15,11,1,0,1,0,0,0
1956512,15,11,1998,2,"male",250,212,136,363,5,348,0,15,5
1956525,25,2,1988,11,"female",229,188,57,0,0,0,0,0,0
1956528,18,23,1995,2,"male",142,55,50,0,13,0,2,0,11
1956540,16,16,1997,4,"male",285,705,289,590,397,556,88,34,309
1956595,29,10,1984,4,"male",614,377,270,136,84,136,76,0,8
1956596,19,10,1994,9,"male",334,1711,67,14,0,0,0,14,0
1956619,45,29,1968,8,"male",458,84,69,0,0,0,0,0,0
1956620,39,21,1974,1,"male",740,17,7,0,0,0,0,0,0
1956677,14,3,1999,1,"male",229,84,72,4,0,4,0,0,0
1956690,35,6,1978,12,"female",203,2,1,3,0,3,0,0,0
1956696,23,26,1990,10,"male",406,171,75,8,5,8,5,0,0
1956710,55,5,1958,11,"female",498,47,32,16,15,15,6,1,9
1956728,28,14,1985,9,"female",111,1,1,0,0,0,0,0,0
1956740,16,16,1997,4,"male",453,79,54,2,1,0,1,2,0
1956742,17,9,1996,2,"male",133,83,69,3,5,3,5,0,0
1956774,28,21,1985,12,"male",578,67,38,0,0,0,0,0,0
1956776,34,1,1979,1,"female",564,1,1,4,0,0,0,4,0
1956808,61,22,1952,1,"female",1007,65,33,0,20,0,5,0,15
1956816,20,17,1993,9,"male",161,52,52,0,0,0,0,0,0
1956852,49,26,1964,3,"female",426,44,6,5,2,0,1,5,1
1956857,35,11,1978,4,"female",435,37,18,58,15,2,1,56,14
1956871,21,4,1992,5,"male",496,628,542,14,4,14,4,0,0
1956894,20,27,1993,7,"male",502,412,219,10,5,10,4,0,1
1956898,30,5,1983,6,"male",167,7,7,1,0,1,0,0,0
1956901,29,10,1984,8,"female",696,3,2,0,0,0,0,0,0
1956944,17,4,1996,2,"female",354,627,320,227,231,122,142,105,89
1956963,45,10,1968,11,"male",151,129,101,114,8,114,6,0,2
1956983,61,1,1952,2,"male",2379,32,3,0,0,0,0,0,0
1956991,25,16,1988,9,"male",132,44,43,108,4,108,4,0,0
1956997,23,17,1990,8,"female",373,230,198,123,466,123,354,0,112
1957012,18,12,1995,6,"male",193,21,15,0,0,0,0,0,0
1957025,30,11,1983,3,"female",272,52,34,3,4,0,2,3,2
1957035,16,14,1997,1,"female",604,73,59,0,1,0,1,0,0
1957052,21,1,1992,1,"male",834,3,3,0,0,0,0,0,0
1957068,43,1,1970,7,"male",583,148,37,12,8,12,7,0,1
1957069,22,8,1991,9,"male",162,276,180,34,80,31,68,3,12
1957116,108,23,1905,3,"female",1101,4063,399,388,1161,16,502,372,659
1957119,20,22,1993,3,"male",148,16,11,7,19,7,5,0,14
1957128,14,31,1999,8,"female",390,150,57,309,196,309,177,0,19
1957132,24,17,1989,12,"female",297,193,45,1690,502,1690,102,0,400
1957187,64,5,1949,12,"female",1680,353,137,262,369,256,215,6,154
1957208,59,1,1954,2,"male",272,16,5,14,18,14,13,0,5
1957223,25,13,1988,3,"female",464,67,50,15,15,0,7,15,8
1957247,25,27,1988,11,"male",566,314,180,258,165,258,155,0,10
1957252,42,10,1971,7,"female",301,22,10,0,4,0,3,0,1
1957284,27,22,1986,8,"female",141,113,6,17,13,17,12,0,1
1957338,33,9,1980,7,"female",331,316,183,15,40,15,34,0,6
1957344,56,27,1957,8,"male",2142,87,25,12,0,12,0,0,0
1957356,31,2,1982,2,"male",185,13,12,0,0,0,0,0,0
1957378,19,6,1994,8,"male",163,52,42,0,0,0,0,0,0
1957379,36,25,1977,9,"female",314,8,3,3,0,3,0,0,0
1957387,20,30,1993,3,"female",968,3071,1827,936,3038,110,1741,826,1297
1957398,93,9,1920,11,"male",1577,285,169,358,233,0,173,358,60
1957399,17,27,1996,12,"male",512,899,771,531,192,531,166,0,26
1957426,27,29,1986,9,"male",646,116,76,175,92,175,64,0,28
1957427,75,23,1938,8,"female",354,26,19,36,6,0,6,36,0
1957453,108,17,1905,11,"female",1715,439,208,380,543,24,155,356,388
1957487,31,10,1982,3,"male",242,26,19,32,9,32,5,0,4
1957490,65,30,1948,1,"male",1076,67,32,45,59,0,23,45,36
1957494,30,11,1983,11,"male",403,131,126,1,1,1,1,0,0
1957512,16,24,1997,6,"female",497,262,187,34,22,34,11,0,11
1957516,13,11,2000,4,"female",260,192,151,232,153,228,87,4,66
1957518,24,3,1989,3,"male",368,72,46,14,0,14,0,0,0
1957523,15,16,1998,7,"male",46,51,22,25,0,1,0,24,0
1957526,13,1,2000,2,"male",45,1,1,7,2,7,2,0,0
1957529,20,18,1993,8,"female",29,20,16,683,209,608,165,75,44
1957581,56,1,1957,8,"female",1611,103,58,27,28,27,23,0,5
1957598,48,29,1965,5,"female",253,196,36,46,51,46,36,0,15
1957627,43,2,1970,2,"male",194,20,13,0,0,0,0,0,0
1957659,18,15,1995,3,"female",139,104,88,10,9,0,2,10,7
1957707,44,26,1969,5,"female",972,190,162,9,8,9,2,0,6
1957714,54,30,1959,3,"female",508,354,140,0,5,0,5,0,0
1957723,19,4,1994,4,"male",408,751,621,220,129,220,93,0,36
1957725,24,2,1989,1,"female",360,67,29,22,29,20,15,2,14
1957750,98,12,1915,12,"female",1121,39,31,6,4,5,4,1,0
1957812,72,29,1941,9,"male",936,96,22,1,2,1,0,0,2
1957816,21,6,1992,12,"female",1552,440,237,126,172,120,91,6,81
1957832,54,25,1959,2,"male",1936,485,153,600,261,474,101,126,160
1957845,29,25,1984,8,"male",740,1,0,0,0,0,0,0,0
1957873,72,4,1941,4,"male",1686,17,5,17,8,1,7,16,1
1957889,64,31,1949,8,"male",536,41,20,2,0,0,0,2,0
1957925,29,8,1984,4,"female",40,62,52,532,495,495,371,37,124
1957928,59,12,1954,4,"male",1552,52,15,0,0,0,0,0,0
1957935,49,14,1964,7,"female",91,9,3,2,1,0,0,2,1
1957941,18,1,1995,3,"male",472,79,51,83,34,83,25,0,9
1957963,51,11,1962,11,"female",514,11,9,0,0,0,0,0,0
1957965,28,17,1985,5,"female",1307,277,31,1,2,1,2,0,0
1957984,51,14,1962,10,"female",141,47,41,34,26,34,21,0,5
1957992,41,31,1972,5,"female",447,51,19,20,16,16,12,4,4
1958001,23,2,1990,2,"female",143,3,2,54,12,0,0,54,12
1958016,20,27,1993,1,"female",244,37,13,4,3,4,3,0,0
1958027,21,20,1992,11,"male",141,62,36,12,75,12,53,0,22
1958030,31,7,1982,7,"female",252,40,35,0,4,0,2,0,2
1958062,59,29,1954,11,"female",659,63,36,2,1,2,1,0,0
1958071,23,20,1990,9,"male",87,25,22,0,0,0,0,0,0
1958085,16,16,1997,10,"female",637,833,450,549,1387,170,577,379,810
1958093,59,29,1954,4,"male",346,27,24,0,0,0,0,0,0
1958094,108,13,1905,5,"female",1247,730,177,0,1,0,0,0,1
1958109,44,4,1969,6,"female",557,9,9,0,0,0,0,0,0
1958114,63,7,1950,4,"female",211,76,53,4,5,4,5,0,0
1958120,41,10,1972,6,"female",119,5,5,2,1,2,1,0,0
1958130,44,3,1969,7,"male",369,181,103,34,74,11,46,23,28
1958131,43,23,1970,6,"male",1674,64,16,9,1,9,1,0,0
1958142,16,27,1997,12,"female",395,67,64,0,2,0,0,0,2
1958143,27,24,1986,12,"female",245,115,61,31,43,31,40,0,3
1958145,25,1,1988,1,"male",25,1,1,3,3,3,3,0,0
1958149,31,23,1982,3,"female",360,44,42,13,4,7,4,6,0
1958169,47,12,1966,5,"male",233,28,7,0,0,0,0,0,0
1958170,54,24,1959,11,"female",1070,33,19,310,132,0,73,310,59
1958185,20,9,1993,11,"female",639,58,24,1,5,1,2,0,3
1958194,19,29,1994,4,"male",925,371,160,25,14,12,6,13,8
1958196,25,14,1988,9,"female",226,48,21,177,206,37,74,140,132
1958197,19,6,1994,9,"male",1446,882,706,6,8,6,7,0,1
1958204,15,13,1998,3,"male",554,143,96,0,4,0,2,0,2
1958249,23,25,1990,7,"male",312,150,107,0,0,0,0,0,0
1958254,64,23,1949,12,"male",1685,142,32,65,11,65,11,0,0
1958289,15,12,1998,11,"male",89,2,1,0,0,0,0,0,0
1958290,48,13,1965,8,"male",301,27,22,1,3,0,2,1,1
1958300,48,4,1965,10,"male",778,42,12,0,0,0,0,0,0
1958319,52,26,1961,10,"female",294,193,134,143,83,143,72,0,11
1958364,59,7,1954,10,"female",221,52,47,0,0,0,0,0,0
1958369,18,12,1995,11,"male",396,36,31,361,3,361,3,0,0
1958384,13,10,2000,3,"male",221,225,175,3,4,3,3,0,1
1958398,19,28,1994,3,"female",219,256,199,27,30,27,23,0,7
1958443,47,18,1966,11,"female",1070,342,253,50,7,50,5,0,2
1958466,26,1,1987,1,"female",18,0,0,15,0,15,0,0,0
1958489,20,7,1993,1,"male",487,97,47,26,9,26,7,0,2
1958520,94,19,1919,1,"male",1894,70,31,4,1,0,1,4,0
1958524,23,17,1990,5,"male",159,14,10,5,1,0,1,5,0
1958570,19,22,1994,5,"female",336,15,12,0,1,0,1,0,0
1958578,63,6,1950,6,"female",815,29,18,185,51,0,4,185,47
1958592,41,9,1972,5,"male",176,0,0,0,2,0,0,0,2
1958610,34,23,1979,8,"male",165,0,0,0,0,0,0,0,0
1958683,21,27,1992,7,"female",237,219,52,31,27,31,22,0,5
1958716,18,4,1995,10,"female",388,371,116,4,7,4,7,0,0
1958746,20,11,1993,3,"male",965,312,164,37,152,3,76,34,76
1958800,22,9,1991,9,"male",742,73,30,23,8,23,5,0,3
1958803,16,16,1997,2,"male",273,390,251,5,0,4,0,1,0
1958839,61,19,1952,9,"female",1641,134,106,86,62,83,60,3,2
1958854,19,6,1994,2,"male",316,334,278,27,36,27,29,0,7
1958867,16,16,1997,4,"male",648,1173,823,220,153,52,99,168,54
1958869,22,25,1991,5,"male",248,20,8,0,0,0,0,0,0
1958889,100,22,1913,1,"male",699,368,210,210,16,210,14,0,2
1958891,17,30,1996,9,"female",876,214,72,205,127,203,117,2,10
1958894,18,14,1995,2,"female",280,6,3,1,0,0,0,1,0
1958923,19,21,1994,7,"male",585,144,45,4,1,1,0,3,1
1958941,23,30,1990,5,"male",1145,185,171,3,9,3,8,0,1
1958943,40,28,1973,6,"male",219,81,70,6,2,5,2,1,0
1958967,23,8,1990,1,"female",256,51,34,1,0,1,0,0,0
1958975,30,1,1983,1,"male",395,30,12,0,0,0,0,0,0
1958976,27,29,1986,7,"male",264,8,2,0,2,0,2,0,0
1958994,51,10,1962,10,"male",43,47,36,103,1,103,1,0,0
1959033,48,27,1965,7,"male",328,38,27,1,2,1,0,0,2
1959035,33,1,1980,1,"male",61,4,2,15,2,15,2,0,0
1959042,40,23,1973,5,"female",146,81,45,25,4,25,4,0,0
1959045,71,4,1942,8,"female",506,24,12,24,12,24,8,0,4
1959055,35,20,1978,4,"male",214,7,6,0,1,0,0,0,1
1959106,21,23,1992,11,"male",88,68,52,5,29,5,8,0,21
1959115,46,13,1967,3,"female",562,275,195,33,28,32,18,1,10
1959147,26,14,1987,7,"male",710,99,28,4,4,4,4,0,0
1959154,28,10,1985,10,"male",156,431,392,166,360,40,191,126,169
1959168,41,23,1972,10,"female",515,106,60,122,324,93,179,29,145
1959173,24,8,1989,1,"male",482,320,287,4,9,4,8,0,1
1959184,16,30,1997,7,"male",147,94,77,7,42,4,13,3,29
1959218,40,18,1973,2,"male",313,106,79,142,13,142,8,0,5
1959227,19,27,1994,12,"female",1184,79,53,81,147,51,106,30,41
1959228,16,14,1997,1,"male",243,4,4,1,0,1,0,0,0
1959245,36,14,1977,8,"male",408,61,43,190,63,189,37,1,26
1959256,24,31,1989,8,"male",364,22,19,0,0,0,0,0,0
1959260,36,12,1977,12,"female",375,197,120,67,111,38,91,29,20
1959274,27,31,1986,10,"female",525,118,19,3,2,3,1,0,1
1959285,23,30,1990,3,"male",416,70,38,0,2,0,2,0,0
1959288,57,6,1956,10,"female",265,53,21,5,14,5,9,0,5
1959289,18,1,1995,1,"male",226,13,11,0,0,0,0,0,0
1959290,30,22,1983,7,"male",1155,335,58,0,4,0,2,0,2
1959321,25,21,1988,9,"male",45,19,17,8,0,8,0,0,0
1959351,27,27,1986,4,"male",628,2,1,78,0,78,0,0,0
1959359,18,4,1995,3,"female",632,203,109,6054,3440,6054,1745,0,1695
1959370,45,16,1968,7,"female",376,104,63,0,1,0,1,0,0
1959386,20,1,1993,5,"male",297,44,17,2,0,2,0,0,0
1959403,22,23,1991,3,"female",349,259,138,576,390,576,351,0,39
1959407,39,21,1974,10,"male",149,180,127,75,210,75,177,0,33
1959411,100,17,1913,9,"male",96,109,105,16,12,16,8,0,4
1959420,23,27,1990,2,"male",76,704,676,871,1628,871,1326,0,302
1959425,18,24,1995,10,"female",104,1075,287,13,221,13,171,0,50
1959431,18,1,1995,5,"male",567,1725,706,2,0,2,0,0,0
1959478,67,18,1946,4,"female",1332,97,30,494,741,1,191,493,550
1959492,16,13,1997,10,"female",345,16,9,1,2,1,1,0,1
1959494,33,20,1980,3,"male",159,23,22,2,1,2,1,0,0
1959506,33,22,1980,2,"male",679,82,54,15,17,12,12,3,5
1959526,41,9,1972,11,"female",126,46,32,780,267,780,250,0,17
1959549,25,2,1988,2,"female",330,61,22,11,7,11,5,0,2
1959565,20,29,1993,6,"male",47,144,137,15,27,15,25,0,2
1959579,61,5,1952,12,"female",293,108,63,38,67,38,29,0,38
1959586,22,1,1991,1,"male",360,73,25,46,59,46,59,0,0
1959597,15,4,1998,8,"female",252,392,73,34,128,4,60,30,68
1959598,17,12,1996,12,"male",425,339,305,198,241,198,199,0,42
1959599,17,31,1996,1,"female",134,90,41,331,258,329,157,2,101
1959613,51,12,1962,8,"female",1505,115,56,1402,627,1402,437,0,190
1959667,17,16,1996,12,"female",516,4282,1192,251,1115,251,665,0,450
1959685,36,30,1977,5,"male",348,7,2,0,0,0,0,0,0
1959707,57,13,1956,7,"female",1506,265,199,146,76,67,40,79,36
1959718,23,9,1990,12,"male",176,33,31,50,6,27,3,23,3
1959720,52,29,1961,4,"male",318,0,0,0,0,0,0,0,0
1959736,27,13,1986,5,"female",355,57,33,120,55,92,31,28,24
1959754,13,1,2000,2,"female",122,71,56,0,0,0,0,0,0
1959770,21,15,1992,2,"male",361,48,38,0,0,0,0,0,0
1959803,31,12,1982,11,"male",89,53,34,77,44,75,39,2,5
1959804,23,15,1990,1,"female",144,8,3,1,4,0,2,1,2
1959809,25,1,1988,1,"male",31,4,4,92,12,92,10,0,2
1959829,35,6,1978,9,"male",562,118,62,7,0,0,0,7,0
1959841,70,2,1943,11,"female",13,32,24,0,0,0,0,0,0
1959849,20,22,1993,12,"female",206,293,119,70,85,70,72,0,13
1959886,21,20,1992,10,"male",587,2784,809,5177,5423,4759,3278,418,2145
1959894,60,13,1953,7,"female",1172,15,4,1,0,1,0,0,0
1959896,74,18,1939,7,"male",239,30,24,8,16,8,9,0,7
1959901,23,28,1990,5,"female",368,64,36,32,34,32,15,0,19
1959926,69,26,1944,9,"female",18,20,17,1,2,0,0,1,2
1959927,18,8,1995,6,"male",86,38,30,7,1,7,1,0,0
1959964,38,6,1975,6,"female",98,106,78,78,18,78,16,0,2
1959966,30,7,1983,12,"female",712,5,2,0,0,0,0,0,0
1959972,26,9,1987,6,"female",459,35,27,443,0,443,0,0,0
1959991,40,8,1973,6,"male",261,53,39,9,0,9,0,0,0
1960001,27,22,1986,3,"male",283,1,1,0,0,0,0,0,0
1960014,28,2,1985,3,"male",723,218,158,68,3,68,0,0,3
1960027,23,14,1990,1,"female",191,6,4,3,6,3,6,0,0
1960097,25,28,1988,1,"male",404,31,17,0,2,0,2,0,0
1960129,103,16,1910,4,"female",2111,152,90,7,0,7,0,0,0
1960143,24,10,1989,10,"male",112,156,102,14,2,0,0,14,2
1960151,40,1,1973,11,"female",159,10,8,0,1,0,1,0,0
1960207,24,6,1989,12,"male",500,336,193,2,10,2,7,0,3
1960217,38,17,1975,7,"female",259,169,97,601,121,601,95,0,26
1960225,14,15,1999,12,"female",271,8,4,0,0,0,0,0,0
1960245,59,24,1954,12,"female",2348,772,296,1822,556,1819,325,3,231
1960276,23,7,1990,1,"male",306,53,38,78,26,78,24,0,2
1960295,26,4,1987,9,"male",325,441,206,68,39,67,9,1,30
1960342,16,21,1997,4,"female",569,1049,483,561,446,184,309,377,137
1960351,47,10,1966,3,"male",234,31,22,1,0,1,0,0,0
1960362,103,21,1910,12,"female",830,143,86,243,52,243,46,0,6
1960373,52,9,1961,11,"male",371,84,28,307,196,4,98,303,98
1960386,30,26,1983,11,"male",577,29,26,27,0,27,0,0,0
1960387,36,23,1977,11,"male",1737,69,21,0,0,0,0,0,0
1960416,37,24,1976,10,"male",556,89,52,29,2,0,0,29,2
1960425,66,14,1947,10,"male",25,14,12,18,1,18,1,0,0
1960453,25,5,1988,6,"female",178,175,83,253,315,253,190,0,125
1960473,14,10,1999,5,"female",568,1554,703,246,198,1,103,245,95
1960475,17,12,1996,7,"male",711,2756,2338,511,627,511,504,0,123
1960521,24,13,1989,8,"male",327,114,102,3,3,3,2,0,1
1960588,25,1,1988,1,"male",134,68,61,0,1,0,0,0,1
1960600,27,28,1986,11,"female",554,3,2,3,8,3,8,0,0
1960614,106,20,1907,8,"male",991,929,336,21,3,21,3,0,0
1960624,33,10,1980,3,"female",418,117,92,1020,201,991,144,29,57
1960632,53,13,1960,3,"male",273,27,17,0,0,0,0,0,0
1960643,48,15,1965,8,"male",1414,100,48,20,16,0,4,20,12
1960656,19,6,1994,1,"male",20,3,2,0,0,0,0,0,0
1960662,66,21,1947,5,"male",212,68,21,8,2,0,0,8,2
1960666,26,23,1987,7,"male",423,281,174,4,1,4,1,0,0
1960701,24,23,1989,7,"male",155,1,1,0,0,0,0,0,0
1960705,28,7,1985,2,"male",273,31,20,0,3,0,3,0,0
1960712,16,8,1997,10,"female",443,609,427,235,104,129,68,106,36
1960722,20,17,1993,1,"male",407,86,63,268,467,212,52,56,415
1960728,103,15,1910,10,"male",1341,257,96,5,4,3,1,2,3
1960730,44,10,1969,3,"male",406,72,72,64,17,61,12,3,5
1960735,29,17,1984,12,"female",146,78,66,16,48,3,14,13,34
1960743,18,6,1995,9,"female",257,263,164,87,72,62,32,25,40
1960749,18,3,1995,9,"female",207,388,273,30,51,30,41,0,10
1960751,29,4,1984,5,"male",503,71,55,17,1,4,0,13,1
1960771,21,9,1992,12,"male",351,69,21,0,0,0,0,0,0
1960774,61,1,1952,1,"male",604,94,54,28,72,28,52,0,20
1960779,20,19,1993,1,"male",727,29,23,0,0,0,0,0,0
1960793,25,15,1988,3,"female",403,2095,293,109,3148,109,2434,0,714
1960801,99,26,1914,3,"female",1377,141,61,27,42,27,34,0,8
1960810,25,1,1988,1,"male",63,46,45,0,3,0,3,0,0
1960816,18,25,1995,12,"male",1103,393,318,11,7,4,2,7,5
1960817,53,27,1960,12,"female",1800,231,135,836,861,699,447,137,414
1960818,100,17,1913,3,"male",582,382,331,59,46,59,44,0,2
1960830,73,5,1940,10,"female",1969,124,74,78,138,22,82,56,56
1960847,22,11,1991,3,"female",653,184,71,27,16,27,13,0,3
1960854,21,6,1992,4,"male",671,343,254,2,0,2,0,0,0
1960855,19,6,1994,11,"male",899,190,94,10,0,1,0,9,0
1960928,47,27,1966,10,"female",1944,546,129,220,650,159,363,61,287
1960929,50,25,1963,6,"female",53,395,344,1333,740,1332,369,1,371
1960933,21,17,1992,12,"male",548,264,94,100,68,98,48,2,20
1960957,40,6,1973,8,"male",661,49,30,0,0,0,0,0,0
1960958,17,29,1996,8,"male",907,82,47,5,6,3,0,2,6
1960959,32,23,1981,1,"male",624,44,21,0,0,0,0,0,0
1960960,93,27,1920,11,"male",733,84,31,0,2,0,2,0,0
1960986,63,25,1950,8,"female",87,53,36,14,6,0,4,14,2
1960991,28,8,1985,7,"male",335,188,149,1,0,1,0,0,0
1961007,49,24,1964,12,"male",480,209,150,50,21,50,11,0,10
1961020,67,30,1946,11,"male",1071,64,30,4,18,0,4,4,14
1961023,25,3,1988,2,"male",478,20,9,14,26,0,5,14,21
1961085,24,14,1989,1,"male",653,5,2,2,0,0,0,2,0
1961107,40,28,1973,6,"female",387,85,32,1208,543,1208,403,0,140
1961132,23,15,1990,12,"male",673,378,221,508,254,508,209,0,45
1961168,20,4,1993,10,"female",409,592,475,1761,1373,704,762,1057,611
1961172,32,1,1981,6,"female",1639,219,84,11,4,11,3,0,1
1961204,17,15,1996,3,"female",439,156,114,34,6,34,5,0,1
1961224,52,7,1961,11,"male",1063,88,80,4,8,4,8,0,0
1961264,77,22,1936,2,"female",1769,33,16,18,5,18,0,0,5
1961273,16,1,1997,1,"male",83,88,54,0,2,0,2,0,0
1961285,25,19,1988,7,"female",725,117,35,15,12,15,12,0,0
1961295,26,4,1987,6,"female",116,32,32,0,8,0,0,0,8
1961304,103,2,1910,8,"female",804,915,319,2,10,2,5,0,5
1961331,45,27,1968,8,"female",82,22,14,36,38,36,30,0,8
1961334,23,11,1990,7,"female",492,15,6,63,27,58,16,5,11
1961389,33,28,1980,12,"male",224,153,104,267,392,267,386,0,6
1961393,52,1,1961,3,"male",641,419,154,7,43,7,37,0,6
1961416,15,20,1998,8,"female",55,134,90,0,0,0,0,0,0
1961440,33,8,1980,3,"male",414,1,0,0,0,0,0,0,0
1961450,20,27,1993,4,"male",300,144,95,804,44,804,43,0,1
1961467,46,25,1967,11,"male",209,22,22,6,4,0,3,6,1
1961476,30,25,1983,2,"male",749,13,8,0,0,0,0,0,0
1961523,21,29,1992,3,"female",227,434,332,141,372,70,170,71,202
1961552,63,8,1950,1,"female",940,19,14,1,22,0,10,1,12
1961609,19,9,1994,10,"female",724,32,11,99,16,43,8,56,8
1961616,17,26,1996,12,"male",376,39,37,0,6,0,0,0,6
1961641,17,1,1996,11,"female",119,18,14,1,0,1,0,0,0
1961659,21,26,1992,2,"female",607,170,132,106,108,104,63,2,45
1961680,30,10,1983,3,"male",164,26,18,40,0,40,0,0,0
1961741,50,20,1963,5,"male",242,77,52,15,30,15,19,0,11
1961745,55,14,1958,2,"female",993,77,62,25,19,20,12,5,7
1961803,46,28,1967,6,"female",527,57,26,22,56,9,20,13,36
1961823,23,28,1990,3,"female",176,1078,36,396,1165,333,942,63,223
1961841,25,7,1988,5,"male",511,873,752,0,0,0,0,0,0
1961852,30,1,1983,9,"female",124,89,55,51,103,51,53,0,50
1961886,29,9,1984,9,"male",85,32,6,42,14,42,14,0,0
1961892,61,18,1952,10,"female",1473,20,8,0,0,0,0,0,0
1961895,31,25,1982,1,"male",544,28,10,0,4,0,3,0,1
1961899,17,26,1996,7,"male",168,183,161,0,0,0,0,0,0
1961902,44,27,1969,10,"male",498,35,13,0,0,0,0,0,0
1961920,45,23,1968,12,"male",491,62,24,27,0,27,0,0,0
1961939,21,6,1992,2,"male",735,196,66,19,31,16,20,3,11
1961963,108,1,1905,4,"male",1382,62,36,6,2,1,1,5,1
1961984,30,24,1983,7,"female",801,123,69,86,18,84,13,2,5
1961992,72,23,1941,5,"male",10,29,27,2,3,2,3,0,0
1961998,17,19,1996,1,"male",193,3,3,4,0,0,0,4,0
1962023,15,13,1998,5,"female",594,4631,1947,12234,14095,12083,10056,151,4039
1962024,24,18,1989,6,"male",522,139,108,29,13,29,11,0,2
1962038,27,5,1986,4,"male",86,33,30,302,141,227,50,75,91
1962053,17,9,1996,5,"male",338,343,280,44,55,44,43,0,12
1962067,26,15,1987,9,"female",243,120,38,201,71,15,37,186,34
1962076,108,8,1905,7,"male",1021,158,85,11,0,0,0,11,0
1962083,29,14,1984,4,"female",311,39,27,147,34,39,23,108,11
1962088,48,12,1965,12,"female",359,10,3,2,4,2,4,0,0
1962139,25,5,1988,1,"male",155,454,422,97,358,97,306,0,52
1962153,19,1,1994,10,"male",280,262,249,595,177,584,144,11,33
1962154,28,19,1985,11,"male",130,44,24,0,0,0,0,0,0
1962155,68,28,1945,1,"female",846,9,4,1,0,0,0,1,0
1962180,62,6,1951,10,"female",302,65,55,8,51,8,17,0,34
1962183,25,8,1988,8,"male",737,71,39,1,2,0,2,1,0
1962196,30,4,1983,11,"male",495,149,121,31,50,31,49,0,1
1962201,14,21,1999,7,"female",57,263,194,5,73,5,67,0,6
1962226,17,3,1996,9,"male",207,29,21,1,0,0,0,1,0
1962227,86,16,1927,7,"male",1815,96,62,0,0,0,0,0,0
1962245,28,19,1985,10,"female",696,218,86,24,46,24,32,0,14
1962247,26,3,1987,10,"female",238,362,45,12,2,12,1,0,1
1962269,98,15,1915,8,"female",282,767,190,182,130,182,108,0,22
1962271,60,17,1953,3,NA,1238,185,46,23,15,1,6,22,9
1962274,67,4,1946,11,"female",520,142,104,403,98,249,33,154,65
1962276,23,16,1990,1,"male",394,51,38,8,6,3,5,5,1
1962293,19,21,1994,12,"male",266,83,34,1,0,1,0,0,0
1962296,52,6,1961,1,"male",207,97,88,1,4,0,3,1,1
1962306,20,7,1993,2,"male",409,209,173,0,25,0,25,0,0
1962327,21,5,1992,5,"male",60,160,136,172,120,3,92,169,28
1962366,21,24,1992,4,"male",710,149,121,2,16,1,7,1,9
1962417,20,16,1993,11,"female",10,35,25,2,7,2,5,0,2
1962423,22,12,1991,12,"male",450,84,53,13,136,13,86,0,50
1962434,50,4,1963,1,"male",897,102,58,108,90,51,55,57,35
1962443,64,9,1949,5,"female",1538,15,14,0,0,0,0,0,0
1962459,19,11,1994,10,"female",445,171,68,114,139,109,81,5,58
1962480,43,31,1970,5,"male",332,19,14,69,48,69,42,0,6
1962500,83,8,1930,12,"female",1721,104,22,73,9,49,3,24,6
1962517,58,6,1955,6,"male",1727,38,11,0,2,0,2,0,0
1962533,93,18,1920,4,"female",1138,329,183,1548,1127,1,363,1547,764
1962534,51,21,1962,11,"female",407,48,29,33,14,33,9,0,5
1962550,23,3,1990,1,"female",286,66,44,14,9,6,2,8,7
1962589,54,23,1959,6,"female",499,198,135,3134,1820,3132,1182,2,638
1962594,19,1,1994,5,"male",432,100,77,24,20,0,5,24,15
1962622,15,11,1998,9,"male",565,54,32,0,0,0,0,0,0
1962626,27,3,1986,3,"female",302,74,31,0,0,0,0,0,0
1962628,68,1,1945,1,"male",288,18,11,0,2,0,1,0,1
1962632,28,21,1985,7,"female",200,116,63,191,566,191,198,0,368
1962670,28,21,1985,12,"female",618,122,62,98,75,98,35,0,40
1962687,108,6,1905,6,"male",907,218,80,31,4,31,4,0,0
1962695,106,7,1907,7,"male",1046,262,130,22,24,14,18,8,6
1962696,52,29,1961,3,"female",380,82,54,469,442,469,233,0,209
1962700,45,26,1968,8,"male",363,44,22,178,291,178,237,0,54
1962727,45,27,1968,10,"male",560,149,94,225,45,57,17,168,28
1962749,68,20,1945,4,"male",1507,862,180,60,99,59,43,1,56
1962751,32,3,1981,1,"female",441,1804,366,6320,6808,6286,4659,34,2149
1962760,28,8,1985,8,"male",498,8,8,2,0,2,0,0,0
1962764,18,11,1995,4,"male",299,105,34,14,2,14,1,0,1
1962836,24,8,1989,12,"male",358,399,364,4,9,4,7,0,2
1962838,16,18,1997,12,"male",239,373,200,99,67,73,55,26,12
1962847,22,26,1991,10,"male",301,58,31,22,37,22,25,0,12
1962882,30,29,1983,8,"female",632,565,308,559,500,559,381,0,119
1962895,34,4,1979,5,"male",337,253,241,513,72,513,69,0,3
1962914,42,25,1971,6,"male",496,37,24,1,6,1,5,0,1
1962949,51,9,1962,6,"male",1624,39,34,53,1,53,1,0,0
1962960,19,29,1994,4,"male",253,1,1,0,0,0,0,0,0
1962978,30,17,1983,5,"male",660,579,496,5,5,0,1,5,4
1962987,26,22,1987,2,"male",577,774,656,15,17,15,16,0,1
1963016,48,27,1965,9,"female",730,109,55,8,44,0,1,8,43
1963028,17,11,1996,9,"male",15,102,81,59,37,57,37,2,0
1963048,19,1,1994,1,"male",594,3564,781,4007,6578,2796,3520,1211,3058
1963091,40,12,1973,2,"female",500,213,117,681,522,631,240,50,282
1963096,49,9,1964,10,"male",1093,55,24,0,2,0,2,0,0
1963102,16,3,1997,9,"male",293,195,117,14,31,4,2,10,29
1963116,15,13,1998,8,"female",379,938,205,1979,1175,919,559,1060,616
1963122,23,22,1990,3,"male",169,6,4,1,0,1,0,0,0
1963135,23,8,1990,6,"female",280,344,69,24,172,22,95,2,77
1963159,75,25,1938,8,"female",796,14,10,31,23,31,16,0,7
1963177,51,5,1962,8,"male",965,41,34,6,0,6,0,0,0
1963179,33,1,1980,1,"male",440,112,65,1,0,1,0,0,0
1963185,22,16,1991,4,"female",464,89,50,33,109,15,51,18,58
1963187,21,8,1992,2,"male",414,459,165,412,304,276,53,136,251
1963203,29,31,1984,10,"male",998,174,86,27,26,27,16,0,10
1963275,48,22,1965,10,"male",92,146,120,9,16,9,8,0,8
1963283,31,24,1982,10,"male",19,12,9,415,61,415,53,0,8
1963316,17,29,1996,11,"male",110,8,4,0,0,0,0,0,0
1963326,30,15,1983,6,"male",590,168,111,0,0,0,0,0,0
1963358,28,2,1985,2,"male",24,22,12,67,49,66,39,1,10
1963366,19,9,1994,10,"female",1090,1881,1526,111,823,42,478,69,345
1963408,31,10,1982,3,"male",593,558,467,12,7,10,6,2,1
1963412,38,16,1975,11,"male",226,4,0,0,0,0,0,0,0
1963420,32,16,1981,5,"female",288,78,58,41,20,41,20,0,0
1963421,44,22,1969,8,"female",294,122,87,11,170,11,81,0,89
1963439,49,8,1964,4,"female",821,91,54,261,192,133,62,128,130
1963452,75,11,1938,1,"female",805,41,27,466,13,0,2,466,11
1963473,31,22,1982,4,"male",864,48,28,4,2,3,2,1,0
1963475,49,2,1964,4,"male",409,43,17,2,22,2,5,0,17
1963484,18,17,1995,12,"female",235,0,0,0,0,0,0,0,0
1963527,40,1,1973,2,"female",1507,151,85,103,52,103,47,0,5
1963557,28,3,1985,8,"male",131,0,0,0,0,0,0,0,0
1963581,33,6,1980,1,"female",1793,319,136,552,634,115,474,437,160
1963585,66,6,1947,9,"male",1304,87,63,0,0,0,0,0,0
1963588,51,6,1962,4,"male",59,14,13,8,5,8,3,0,2
1963595,23,14,1990,2,"female",1511,241,121,45,118,32,97,13,21
1963616,25,17,1988,8,"female",293,20,13,3,0,0,0,3,0
1963623,20,8,1993,5,"male",805,205,36,11,30,11,7,0,23
1963645,16,14,1997,9,"male",279,484,249,8,0,8,0,0,0
1963670,25,18,1988,7,"male",153,80,79,6,3,0,0,6,3
1963694,16,12,1997,2,"female",444,4220,1361,49,619,49,483,0,136
1963702,22,27,1991,4,"female",203,563,427,221,1140,131,582,90,558
1963706,35,5,1978,9,"male",233,82,70,4,1,4,1,0,0
1963725,19,10,1994,10,"female",501,75,60,0,0,0,0,0,0
1963746,25,4,1988,4,"female",534,31,29,115,76,91,34,24,42
1963769,35,21,1978,12,"female",286,193,121,260,111,260,86,0,25
1963791,23,30,1990,1,"male",229,33,25,7,1,0,1,7,0
1963826,101,1,1912,4,"male",1590,1199,750,92,160,70,95,22,65
1963860,58,22,1955,10,"male",493,16,16,343,304,0,13,343,291
1963878,45,9,1968,10,"female",672,70,46,322,298,177,251,145,47
1963893,23,22,1990,9,"female",492,83,60,12,28,10,28,2,0
1963894,99,8,1914,3,"female",1421,4731,591,19,154,19,124,0,30
1963918,53,24,1960,9,"male",783,241,128,0,1,0,1,0,0
1963939,82,16,1931,10,"female",1691,142,104,226,468,52,341,174,127
1963945,29,1,1984,6,"male",48,12,9,0,0,0,0,0,0
1963952,19,30,1994,5,"female",808,523,406,237,158,59,66,178,92
1963973,29,2,1984,2,"female",221,20,17,40,10,40,2,0,8
1964045,53,23,1960,1,"male",154,125,78,117,6,117,3,0,3
1964051,18,9,1995,12,"female",755,542,233,21,13,21,11,0,2
1964069,65,3,1948,3,"female",1930,210,69,285,826,0,159,285,667
1964115,57,31,1956,5,"female",37,100,91,93,10,77,6,16,4
1964149,21,24,1992,4,"male",285,5,5,0,0,0,0,0,0
1964152,22,8,1991,4,"male",155,117,105,43,19,14,6,29,13
1964161,22,3,1991,4,"female",164,921,773,705,1067,198,488,507,579
1964167,20,7,1993,1,"male",1030,860,483,25,5,3,3,22,2
1964211,15,29,1998,8,"male",371,436,348,18,22,18,22,0,0
1964280,28,14,1985,7,"female",359,32,28,0,0,0,0,0,0
1964285,24,16,1989,4,"male",318,144,90,0,1,0,0,0,1
1964288,47,17,1966,8,"male",382,23,19,1,0,1,0,0,0
1964298,47,31,1966,1,"female",505,25,14,0,1,0,1,0,0
1964308,55,24,1958,12,"female",406,32,10,12,31,12,24,0,7
1964324,28,25,1985,1,"female",781,71,24,0,0,0,0,0,0
1964344,62,29,1951,7,"female",449,7,6,197,115,0,8,197,107
1964376,31,27,1982,6,"male",799,178,103,0,2,0,2,0,0
1964420,32,5,1981,6,"male",56,8,5,48,4,41,4,7,0
1964428,93,1,1920,11,"male",423,272,151,6,3,6,3,0,0
1964451,24,18,1989,4,"male",404,820,696,2731,305,2659,266,72,39
1964460,53,20,1960,3,"female",510,67,41,16,20,0,3,16,17
1964510,57,10,1956,6,"male",527,79,48,112,1,112,1,0,0
1964543,19,20,1994,8,"male",385,138,81,61,0,61,0,0,0
1964570,16,12,1997,4,"male",263,242,214,16,69,16,21,0,48
1964601,20,9,1993,2,"male",534,3048,2248,26,120,26,71,0,49
1964611,36,20,1977,6,"male",153,27,21,1,14,0,7,1,7
1964617,32,12,1981,4,"male",649,1,0,0,0,0,0,0,0
1964645,16,27,1997,3,"male",241,271,215,510,664,510,444,0,220
1964646,57,10,1956,9,"male",138,174,84,30,50,0,41,30,9
1964652,57,1,1956,2,"male",114,91,44,1,5,0,0,1,5
1964654,15,23,1998,12,"female",317,735,265,1063,611,359,192,704,419
1964655,58,23,1955,5,"female",844,19,10,0,1,0,1,0,0
1964684,36,10,1977,7,"male",1124,73,43,62,23,0,9,62,14
1964723,40,14,1973,10,"male",416,78,23,0,0,0,0,0,0
1964729,70,30,1943,5,"male",1421,108,22,53,16,51,8,2,8
1964743,15,14,1998,8,"male",461,173,132,3,0,0,0,3,0
1964809,14,29,1999,7,"female",13,62,47,3,1,3,1,0,0
1964820,20,8,1993,12,"female",1810,691,503,89,220,73,114,16,106
1964905,15,6,1998,8,"female",407,130,62,286,67,245,40,41,27
1964951,15,16,1998,4,"male",488,47,16,3,4,0,0,3,4
1964963,75,19,1938,11,"female",1466,61,26,17,1,0,1,17,0
1964984,36,2,1977,5,"male",789,10,5,0,1,0,0,0,1
1964987,14,7,1999,8,"male",264,40,4,32,4,32,2,0,2
1964994,49,12,1964,6,"male",1338,40,18,0,0,0,0,0,0
1964996,28,20,1985,4,"male",217,0,0,0,0,0,0,0,0
1965013,56,19,1957,9,"female",897,43,26,1,11,0,8,1,3
1965024,33,31,1980,5,"female",422,36,22,44,0,44,0,0,0
1965029,53,1,1960,6,"male",802,7,5,0,0,0,0,0,0
1965051,34,21,1979,7,"male",48,5,5,1,0,1,0,0,0
1965075,68,21,1945,2,"male",1395,29,21,27,18,27,10,0,8
1965076,27,31,1986,7,"male",877,69,20,181,136,181,60,0,76
1965081,20,1,1993,5,"male",184,185,112,214,209,173,82,41,127
1965094,25,19,1988,5,"male",993,158,119,5,0,5,0,0,0
1965095,33,26,1980,2,"male",680,39,33,1,21,1,20,0,1
1965113,28,17,1985,2,"female",172,169,136,22,210,20,139,2,71
1965117,53,15,1960,7,"female",219,51,21,40,6,40,4,0,2
1965124,52,11,1961,7,"female",789,157,87,71,64,71,31,0,33
1965127,29,2,1984,12,"male",540,82,37,5,2,0,1,5,1
1965129,33,10,1980,10,"female",464,89,45,214,409,214,395,0,14
1965133,28,24,1985,11,"male",742,126,88,1,4,1,4,0,0
1965164,32,3,1981,2,"male",126,3,1,3,0,3,0,0,0
1965172,26,26,1987,4,"female",237,133,63,0,0,0,0,0,0
1965186,19,24,1994,5,"male",877,471,404,3,2,3,1,0,1
1965234,25,1,1988,1,"male",189,16,15,0,1,0,0,0,1
1965237,64,24,1949,7,"male",1199,21,17,17,19,17,16,0,3
1965242,43,19,1970,12,"male",268,52,32,7,1,7,1,0,0
1965275,63,7,1950,5,"female",735,86,63,24,6,0,5,24,1
1965293,66,11,1947,2,"male",285,32,8,0,0,0,0,0,0
1965301,15,23,1998,10,"female",192,640,472,355,487,62,293,293,194
1965316,50,23,1963,4,"male",26,60,14,16,34,15,34,1,0
1965324,103,1,1910,5,"male",992,362,221,223,63,223,50,0,13
1965340,15,18,1998,12,"male",306,271,232,8,8,8,7,0,1
1965354,67,14,1946,5,"female",966,29,22,25,5,25,5,0,0
1965355,92,1,1921,1,"male",1809,43,32,0,0,0,0,0,0
1965357,53,11,1960,9,"female",1448,49,21,12,50,5,32,7,18
1965380,24,14,1989,3,"female",213,71,39,40,32,38,32,2,0
1965384,21,10,1992,7,"male",6,2,2,0,1,0,1,0,0
1965397,27,2,1986,6,"male",200,74,62,0,0,0,0,0,0
1965405,27,19,1986,8,"male",1682,311,117,26,78,19,54,7,24
1965438,26,12,1987,6,"male",393,19,17,16,37,0,16,16,21
1965446,58,26,1955,7,"female",1354,59,17,26,7,26,3,0,4
1965449,13,18,2000,2,"female",734,801,466,194,159,31,109,163,50
1965472,31,1,1982,1,"male",261,13,11,0,0,0,0,0,0
1965476,44,16,1969,6,"male",370,30,16,20,27,14,20,6,7
1965493,19,8,1994,12,"male",202,66,48,2,0,2,0,0,0
1965497,19,4,1994,8,"male",963,63,44,2,1,2,0,0,1
1965503,30,22,1983,3,"male",236,80,48,0,2,0,1,0,1
1965523,17,22,1996,12,"male",493,448,212,36,30,36,14,0,16
1965549,50,17,1963,12,"male",1349,539,139,1,5,1,3,0,2
1965559,103,10,1910,11,"male",1407,309,172,13,2,13,0,0,2
1965568,102,27,1911,2,"male",874,65,16,1,1,1,0,0,1
1965597,33,9,1980,10,"male",370,61,30,4,5,4,2,0,3
1965599,63,8,1950,12,"female",583,152,89,0,0,0,0,0,0
1965627,39,1,1974,5,"male",480,72,48,0,0,0,0,0,0
1965654,19,18,1994,11,"male",521,5,3,0,0,0,0,0,0
1965669,29,7,1984,8,"male",884,169,125,0,39,0,28,0,11
1965720,52,17,1961,2,"female",1659,249,189,104,85,55,28,49,57
1965742,32,22,1981,6,"male",374,24,16,5,2,5,2,0,0
1965746,16,24,1997,11,"female",293,194,114,447,1355,210,241,237,1114
1965760,30,1,1983,6,"female",893,210,128,1587,797,1518,378,69,419
1965775,15,27,1998,7,"male",809,774,375,24,194,22,78,2,116
1965790,18,7,1995,10,"male",57,23,4,2,2,2,2,0,0
1965791,108,13,1905,2,"male",1984,505,242,303,210,25,81,278,129
1965814,28,3,1985,6,"male",591,84,44,12,96,7,57,5,39
1965815,108,18,1905,6,"male",365,242,231,0,0,0,0,0,0
1965828,33,18,1980,8,"male",271,207,117,1227,181,1227,160,0,21
1965830,78,16,1935,3,"female",1538,95,52,10,44,10,30,0,14
1965845,27,3,1986,10,"male",846,214,154,11,32,11,31,0,1
1965866,22,1,1991,4,"female",179,10,7,9,74,9,31,0,43
1965870,17,9,1996,6,"female",632,418,122,277,192,166,64,111,128
1965872,26,15,1987,1,"male",12,6,2,1,1,1,1,0,0
1965881,54,11,1959,12,"male",860,77,33,1,58,1,34,0,24
1965891,26,13,1987,9,"female",486,64,25,9,11,9,6,0,5
1965892,103,15,1910,1,"male",854,197,84,6,11,6,10,0,1
1965898,24,11,1989,7,"male",465,516,335,5,2,3,0,2,2
1965905,25,4,1988,10,"male",365,65,40,57,34,57,15,0,19
1965906,23,20,1990,2,"female",267,0,0,0,0,0,0,0,0
1965927,17,25,1996,12,"male",313,136,33,1,16,1,7,0,9
1965956,25,28,1988,10,"female",400,40,5,0,2,0,2,0,0
1965957,38,4,1975,10,"male",518,34,21,8,6,8,6,0,0
1965969,27,22,1986,5,"male",288,51,31,92,2,92,0,0,2
1965989,56,17,1957,9,"male",1512,71,33,10,72,5,57,5,15
1966000,59,6,1954,9,"female",1307,94,75,84,93,84,68,0,25
1966001,21,31,1992,8,"male",426,116,92,0,1,0,1,0,0
1966014,15,30,1998,5,"female",1457,2989,607,842,1254,196,782,646,472
1966029,59,5,1954,7,"male",511,27,21,2,20,2,10,0,10
1966034,64,18,1949,7,"male",658,269,147,5,83,0,32,5,51
1966059,30,22,1983,4,"male",440,94,35,22,7,22,6,0,1
1966067,29,1,1984,1,"male",278,15,7,28,6,28,5,0,1
1966071,25,28,1988,9,"female",152,384,284,3,134,2,80,1,54
1966097,100,2,1913,11,"female",1497,158,24,17,30,17,24,0,6
1966102,46,19,1967,10,"female",12,44,13,85,68,80,21,5,47
1966134,36,10,1977,5,"male",418,118,95,16,4,16,4,0,0
1966159,22,1,1991,1,"male",139,0,0,0,0,0,0,0,0
1966176,23,6,1990,4,"male",551,101,47,0,0,0,0,0,0
1966193,61,29,1952,4,"male",914,60,33,39,4,0,4,39,0
1966199,39,1,1974,1,"female",542,33,15,0,0,0,0,0,0
1966206,28,1,1985,1,"male",315,39,36,0,0,0,0,0,0
1966216,35,22,1978,4,"female",194,86,78,45,238,1,84,44,154
1966230,37,28,1976,1,"female",925,5,3,97,38,97,30,0,8
1966233,93,18,1920,9,"female",361,262,176,681,825,681,732,0,93
1966251,23,26,1990,6,"male",381,283,244,10,74,10,59,0,15
1966259,19,5,1994,12,"female",1057,196,120,1,5,1,1,0,4
1966262,71,11,1942,10,"male",118,63,8,16,14,0,0,16,14
1966289,24,2,1989,4,"male",132,31,28,0,1,0,1,0,0
1966302,32,21,1981,5,"male",197,107,81,0,10,0,10,0,0
1966322,40,7,1973,12,"male",1252,4,0,0,0,0,0,0,0
1966326,22,22,1991,11,"male",557,303,230,5,11,5,5,0,6
1966332,22,6,1991,6,"female",193,66,40,0,0,0,0,0,0
1966335,20,10,1993,10,"male",626,30,21,0,8,0,7,0,1
1966342,108,10,1905,10,"male",60,153,91,44,43,44,35,0,8
1966347,65,27,1948,6,"female",1111,14,5,0,0,0,0,0,0
1966351,33,12,1980,6,"male",125,78,78,0,0,0,0,0,0
1966352,24,13,1989,3,"male",513,175,97,0,7,0,7,0,0
1966380,69,1,1944,10,"female",538,14,11,67,6,0,4,67,2
1966398,61,7,1952,9,"female",422,191,183,177,595,0,272,177,323
1966405,52,4,1961,5,"female",1447,32,9,13,10,13,10,0,0
1966438,24,27,1989,5,"male",702,63,43,0,0,0,0,0,0
1966439,18,18,1995,7,"female",91,229,89,367,377,156,141,211,236
1966449,19,15,1994,5,"male",226,80,30,0,1,0,1,0,0
1966452,50,15,1963,7,"male",219,6,4,5,11,0,11,5,0
1966463,20,1,1993,7,"male",182,22,16,20,4,20,4,0,0
1966478,28,18,1985,9,"male",295,91,36,22,17,22,13,0,4
1966481,23,1,1990,1,"male",447,2,2,0,0,0,0,0,0
1966485,29,20,1984,9,"male",589,139,52,0,4,0,1,0,3
1966490,52,6,1961,8,"male",1568,57,39,1,2,1,1,0,1
1966499,108,26,1905,10,"female",1104,51,23,26,68,0,51,26,17
1966506,34,3,1979,6,"female",648,17,11,9,40,8,20,1,20
1966521,26,24,1987,11,"female",644,3,0,0,1,0,1,0,0
1966524,24,3,1989,3,"male",658,569,159,170,619,159,231,11,388
1966559,100,22,1913,3,"female",1082,242,147,91,24,91,20,0,4
1966564,33,4,1980,2,"male",340,125,92,1,0,1,0,0,0
1966569,31,22,1982,1,"female",261,157,122,372,79,372,68,0,11
1966574,24,3,1989,3,"male",1503,78,8,3,0,2,0,1,0
1966587,18,22,1995,8,"male",891,895,299,278,93,275,62,3,31
1966588,21,18,1992,7,"female",589,207,169,314,464,242,185,72,279
1966603,15,16,1998,10,"male",333,894,825,14,3,2,1,12,2
1966664,32,19,1981,11,"female",174,45,43,920,660,920,592,0,68
1966682,24,17,1989,7,"female",92,23,21,8,67,8,67,0,0
1966694,65,20,1948,4,"male",2389,132,82,2,1,1,1,1,0
1966698,57,7,1956,9,"male",615,21,11,9,16,4,9,5,7
1966750,18,14,1995,2,"male",37,329,313,55,53,55,52,0,1
1966752,50,30,1963,5,"female",723,280,179,23,288,20,132,3,156
1966820,23,9,1990,4,"female",1624,442,227,1287,1829,492,500,795,1329
1966829,61,23,1952,11,"male",481,125,110,52,112,10,69,42,43
1966846,28,24,1985,2,"male",48,34,24,118,14,118,9,0,5
1966857,76,17,1937,1,"female",285,15,8,44,4,44,1,0,3
1966886,18,27,1995,2,"female",286,60,38,0,1,0,0,0,1
1966910,22,19,1991,1,"male",212,31,21,0,1,0,0,0,1
1966920,27,12,1986,9,"female",270,214,86,178,285,174,190,4,95
1966942,27,12,1986,4,"female",529,35,20,16,27,1,18,15,9
1966990,28,26,1985,6,"female",1425,29,17,69,5,5,1,64,4
1966999,24,24,1989,6,"male",501,78,67,7,9,7,0,0,9
1967013,24,21,1989,11,"female",531,509,355,697,304,626,99,71,205
1967050,18,14,1995,12,"male",1092,308,249,171,21,28,13,143,8
1967057,35,23,1978,2,"female",376,436,167,30,4,0,4,30,0
1967065,18,1,1995,1,"male",116,18,16,0,1,0,0,0,1
1967072,51,20,1962,3,"female",193,15,8,43,28,0,3,43,25
1967115,17,22,1996,10,"female",393,576,405,33,32,0,0,33,32
1967128,18,12,1995,7,"male",514,1557,1132,4750,2497,4504,1788,246,709
1967141,35,16,1978,11,"female",563,14,8,1,0,1,0,0,0
1967149,43,1,1970,3,"male",25,31,31,0,2,0,2,0,0
1967153,28,5,1985,1,"female",366,68,34,15,42,7,18,8,24
1967156,20,15,1993,7,"male",442,86,48,15,5,13,0,2,5
1967158,50,2,1963,9,"male",393,45,33,13,0,11,0,2,0
1967187,24,23,1989,4,"male",418,144,70,0,34,0,33,0,1
1967220,17,28,1996,2,"male",128,108,95,1,3,0,1,1,2
1967270,29,13,1984,9,"male",480,53,29,1,0,1,0,0,0
1967295,17,8,1996,1,"female",510,3197,1147,899,337,38,110,861,227
1967304,15,12,1998,12,"male",160,1001,835,8,6,8,6,0,0
1967305,24,28,1989,3,"female",469,251,173,14,47,14,17,0,30
1967308,19,4,1994,5,"male",231,68,53,0,0,0,0,0,0
1967337,19,30,1994,5,"female",191,77,53,10,13,8,7,2,6
1967342,14,1,1999,8,"male",545,47,27,4,1,0,1,4,0
1967356,18,14,1995,5,"female",1063,870,375,1257,2380,562,1522,695,858
1967391,25,6,1988,4,"male",249,38,29,155,67,155,60,0,7
1967408,27,3,1986,12,"male",491,68,39,40,49,40,37,0,12
1967451,16,6,1997,1,"male",104,24,24,4,5,4,4,0,1
1967460,23,13,1990,9,"female",110,2,0,0,0,0,0,0,0
1967471,25,7,1988,10,"male",571,0,0,0,0,0,0,0,0
1967480,43,11,1970,7,"female",601,55,21,138,44,138,35,0,9
1967483,108,23,1905,1,"male",109,47,32,8,9,1,4,7,5
1967496,59,8,1954,12,"male",937,149,91,1,0,0,0,1,0
1967549,33,14,1980,7,"female",1871,74,29,40,40,30,33,10,7
1967555,30,10,1983,10,"male",252,92,91,2,2,2,1,0,1
1967563,52,18,1961,6,"female",836,439,254,23,43,0,6,23,37
1967580,20,22,1993,12,"male",103,360,254,78,164,43,89,35,75
1967596,17,16,1996,2,"female",450,2,2,27,2,17,2,10,0
1967634,25,1,1988,1,"female",17,1,1,3,1,3,1,0,0
1967647,52,15,1961,2,"male",586,66,29,48,2,0,1,48,1
1967671,17,10,1996,6,"male",172,24,18,0,2,0,0,0,2
1967715,60,3,1953,11,"male",913,16,11,12,2,0,0,12,2
1967747,33,16,1980,10,"female",557,65,60,53,3,53,3,0,0
1967748,26,17,1987,4,"male",394,1576,1017,127,480,127,356,0,124
1967750,20,24,1993,6,"female",656,707,576,0,1,0,0,0,1
1967756,103,17,1910,10,"female",849,179,54,412,268,412,265,0,3
1967764,41,23,1972,2,"male",99,30,22,0,1,0,1,0,0
1967800,48,6,1965,7,"male",447,1569,221,1,5,0,3,1,2
1967809,42,2,1971,1,"male",179,0,0,0,0,0,0,0,0
1967816,23,26,1990,4,"male",314,252,134,371,65,308,44,63,21
1967829,103,28,1910,9,"male",1207,198,132,27,38,27,34,0,4
1967855,49,17,1964,6,"male",553,319,192,89,303,29,103,60,200
1967859,59,15,1954,11,"male",528,29,12,3,1,3,0,0,1
1967869,31,4,1982,4,"male",243,57,55,3,1,3,1,0,0
1967895,38,22,1975,11,"female",408,31,17,52,63,52,58,0,5
1967911,66,29,1947,5,"male",719,74,13,0,0,0,0,0,0
1967914,28,9,1985,3,"female",367,81,67,67,96,67,81,0,15
1967937,47,29,1966,7,"male",637,249,170,11,101,11,76,0,25
1967976,37,8,1976,4,"male",530,0,0,1,0,0,0,1,0
1968016,32,11,1981,7,"female",446,48,23,0,3,0,3,0,0
1968039,21,9,1992,3,"female",208,204,152,3865,2058,702,1592,3163,466
1968048,54,15,1959,7,"male",266,68,19,96,68,96,35,0,33
1968060,16,18,1997,7,"male",665,199,131,0,5,0,2,0,3
1968113,31,27,1982,2,"female",803,3,2,0,0,0,0,0,0
1968117,14,6,1999,8,"male",224,137,88,75,12,75,12,0,0
1968125,39,31,1974,1,"male",210,17,15,12,8,12,8,0,0
1968126,43,1,1970,1,"male",132,10,8,11,2,11,1,0,1
1968150,52,9,1961,3,"male",560,45,13,13,3,13,2,0,1
1968152,53,13,1960,9,"female",1172,21,3,1,0,1,0,0,0
1968175,43,18,1970,6,"female",255,36,9,12,20,12,10,0,10
1968180,15,22,1998,10,"male",82,3,2,0,0,0,0,0,0
1968193,19,21,1994,10,"male",608,434,337,4,23,4,22,0,1
1968199,16,24,1997,8,"female",385,153,73,64,11,15,2,49,9
1968200,24,8,1989,8,"male",798,3,2,0,0,0,0,0,0
1968204,16,24,1997,8,"male",53,24,17,10,22,10,17,0,5
1968209,39,12,1974,12,"male",286,47,21,9,48,9,24,0,24
1968223,23,10,1990,2,"male",573,1665,1486,2,249,1,168,1,81
1968233,35,16,1978,10,"male",140,16,15,99,10,0,1,99,9
1968234,23,17,1990,4,"male",810,91,40,10,4,10,4,0,0
1968239,31,17,1982,7,"male",32,11,8,0,0,0,0,0,0
1968242,26,20,1987,1,"male",423,211,155,1,0,1,0,0,0
1968257,18,10,1995,6,"male",615,267,232,0,0,0,0,0,0
1968264,22,8,1991,12,"female",642,346,113,0,0,0,0,0,0
1968286,66,28,1947,5,"male",240,126,24,1173,632,0,175,1173,457
1968304,22,16,1991,2,"male",373,451,259,459,149,420,81,39,68
1968313,44,3,1969,2,"female",339,148,83,5,138,1,60,4,78
1968338,45,25,1968,6,"male",209,7,2,0,0,0,0,0,0
1968341,49,17,1964,11,"male",156,74,56,4,13,1,5,3,8
1968345,40,23,1973,10,"male",503,104,63,1,1,1,1,0,0
1968399,38,29,1975,4,"male",135,106,77,351,53,351,29,0,24
1968400,19,20,1994,2,"male",472,251,177,8,11,8,9,0,2
1968407,26,9,1987,10,"male",600,236,179,32,45,32,40,0,5
1968409,43,30,1970,6,"female",291,4,2,1,5,1,5,0,0
1968421,20,21,1993,10,"male",912,71,38,0,13,0,7,0,6
1968426,34,22,1979,6,"female",433,42,20,27,2,27,2,0,0
1968458,36,11,1977,2,"male",615,98,71,16,17,16,4,0,13
1968497,21,19,1992,5,"male",10,25,15,4,4,4,3,0,1
1968500,34,2,1979,10,"female",586,266,148,98,92,13,7,85,85
1968535,31,13,1982,6,"female",184,38,23,21,19,7,8,14,11
1968576,31,12,1982,9,"female",37,143,19,180,751,177,742,3,9
1968597,17,15,1996,7,"female",457,397,247,571,177,571,154,0,23
1968599,17,1,1996,5,"male",294,24,20,0,6,0,6,0,0
1968602,19,20,1994,4,"male",140,145,92,23,32,1,19,22,13
1968628,38,1,1975,1,"male",248,33,25,2,40,2,8,0,32
1968639,27,1,1986,1,"male",254,25,19,0,4,0,1,0,3
1968641,48,29,1965,12,"male",1673,38,27,29,17,29,11,0,6
1968677,55,4,1958,7,"female",412,89,63,87,53,1,37,86,16
1968684,63,1,1950,1,"female",1039,98,29,22,27,22,20,0,7
1968734,22,16,1991,11,"female",355,602,328,476,321,134,141,342,180
1968770,17,1,1996,3,"male",142,54,49,25,7,25,5,0,2
1968824,37,18,1976,11,"female",139,40,33,97,36,97,36,0,0
1968863,21,8,1992,6,"female",390,1355,444,13,142,13,129,0,13
1968865,53,4,1960,6,"male",1134,69,54,1030,21,999,7,31,14
1968874,25,2,1988,8,"male",397,52,41,10,19,10,17,0,2
1968891,43,20,1970,8,"male",76,14,11,0,0,0,0,0,0
1968895,19,31,1994,12,"female",171,31,6,3,3,0,3,3,0
1968903,96,13,1917,8,"female",1769,204,78,383,178,237,113,146,65
1968906,16,23,1997,4,"female",71,301,149,57,63,56,29,1,34
1968954,108,20,1905,10,"male",524,134,101,1,9,1,9,0,0
1968961,51,25,1962,8,"male",182,25,8,10,2,0,0,10,2
1968979,14,1,1999,1,"male",621,52,41,41,27,41,19,0,8
1968981,16,1,1997,10,"female",282,113,41,732,930,1,118,731,812
1969030,18,21,1995,11,"female",1002,866,352,931,1257,394,546,537,711
1969060,35,9,1978,3,"male",371,24,23,0,0,0,0,0,0
1969068,28,14,1985,12,"female",290,2218,1618,4626,10268,4290,4250,336,6018
1969090,78,7,1935,7,"male",1546,76,47,59,21,0,6,59,15
1969091,27,8,1986,5,"male",289,4,1,0,0,0,0,0,0
1969098,18,15,1995,1,"male",10,6,6,0,0,0,0,0,0
1969106,25,1,1988,1,"male",268,23,12,47,24,47,21,0,3
1969110,61,15,1952,11,"male",610,9,3,6,0,5,0,1,0
1969145,26,9,1987,10,"male",403,33,12,0,0,0,0,0,0
1969160,18,28,1995,4,"female",681,1440,817,999,1714,999,1056,0,658
1969170,31,10,1982,10,"male",115,4,4,0,0,0,0,0,0
1969183,33,3,1980,3,"male",73,40,33,8,1,8,1,0,0
1969199,34,6,1979,6,"male",1187,82,37,3,12,3,1,0,11
1969206,25,1,1988,1,"male",236,234,226,9,2,9,2,0,0
1969211,52,12,1961,7,"male",1781,375,107,150,241,150,114,0,127
1969213,108,6,1905,10,"male",317,17,4,15,13,13,3,2,10
1969215,76,1,1937,3,"male",37,26,26,3,13,0,3,3,10
1969216,17,10,1996,11,"female",945,136,56,0,0,0,0,0,0
1969224,19,15,1994,8,"male",60,27,25,16,14,16,11,0,3
1969227,21,13,1992,8,"male",384,44,30,303,123,0,79,303,44
1969265,65,9,1948,11,"female",179,23,19,11,13,11,12,0,1
1969279,32,8,1981,8,"male",730,112,90,2,2,0,2,2,0
1969293,18,16,1995,5,"male",231,234,96,33,20,33,13,0,7
1969298,60,24,1953,5,"male",1653,208,130,45,7,45,6,0,1
1969314,55,8,1958,7,"male",1272,46,16,5,0,2,0,3,0
1969339,61,14,1952,3,"male",1593,59,23,1,9,0,1,1,8
1969359,52,5,1961,6,"female",135,39,27,250,99,158,59,92,40
1969396,19,18,1994,10,"female",492,887,581,969,449,591,249,378,200
1969398,26,17,1987,11,"female",118,82,46,272,54,272,43,0,11
1969406,20,3,1993,2,"male",337,385,227,2757,1328,2754,1110,3,218
1969414,18,25,1995,11,"female",127,8,4,0,0,0,0,0,0
1969438,33,3,1980,4,"female",286,13,11,316,8,316,3,0,5
1969439,16,7,1997,8,"male",255,1,1,3,2,0,0,3,2
1969441,61,1,1952,11,"female",1155,162,98,686,323,0,127,686,196
1969444,16,25,1997,2,"male",219,140,101,9,0,0,0,9,0
1969457,23,18,1990,10,"male",73,172,110,25,128,25,121,0,7
1969481,16,26,1997,2,"male",46,15,12,2,0,0,0,2,0
1969511,26,13,1987,7,"female",449,177,79,49,8,2,1,47,7
1969515,14,4,1999,3,"male",308,46,25,5,0,5,0,0,0
1969537,15,1,1998,7,"male",80,2,2,0,0,0,0,0,0
1969540,27,27,1986,9,"male",387,257,195,5,13,5,10,0,3
1969543,27,27,1986,2,"female",446,191,103,3,2,3,2,0,0
1969545,31,21,1982,5,"female",202,81,42,28,25,2,16,26,9
1969548,103,7,1910,1,"female",1408,142,52,6,1,6,0,0,1
1969549,49,1,1964,8,"male",150,4,2,0,0,0,0,0,0
1969581,27,15,1986,9,"female",115,50,38,263,161,263,134,0,27
1969585,32,14,1981,9,"male",800,9,7,0,0,0,0,0,0
1969590,26,4,1987,7,"male",432,537,470,138,229,138,212,0,17
1969598,68,19,1945,7,"female",1545,30,10,1,1,1,1,0,0
1969627,22,21,1991,1,"male",820,317,173,1,0,1,0,0,0
1969637,21,14,1992,1,"male",315,17,12,1,0,1,0,0,0
1969666,18,5,1995,2,"female",611,1663,240,854,649,640,331,214,318
1969667,57,23,1956,2,"female",727,27,22,0,0,0,0,0,0
1969675,20,19,1993,4,"male",46,88,73,0,0,0,0,0,0
1969689,20,18,1993,7,"male",704,81,36,86,48,85,42,1,6
1969728,50,16,1963,10,"female",641,18,9,0,3,0,1,0,2
1969753,15,22,1998,12,"male",799,277,96,6,24,6,10,0,14
1969766,51,24,1962,12,"male",724,22,19,0,0,0,0,0,0
1969795,53,15,1960,3,"male",439,35,8,103,71,13,64,90,7
1969807,18,11,1995,12,"female",144,236,142,17,14,2,5,15,9
1969813,36,11,1977,9,"male",673,56,31,3,1,3,0,0,1
1969826,50,11,1963,5,"male",306,58,27,8,2,7,1,1,1
1969830,36,22,1977,3,"female",707,342,201,12,95,0,28,12,67
1969844,15,19,1998,4,"female",628,981,131,46,44,0,25,46,19
1969868,28,1,1985,2,"male",22,42,27,31,24,31,23,0,1
1969874,63,12,1950,4,"female",35,32,23,6,5,0,0,6,5
1969899,30,25,1983,3,"male",940,200,40,31,11,31,1,0,10
1969900,15,25,1998,9,"male",412,40,13,0,1,0,1,0,0
1969924,21,17,1992,1,"male",332,33,27,5,0,0,0,5,0
1969934,16,2,1997,7,"female",553,1635,660,22,92,22,74,0,18
1969957,64,2,1949,10,"male",270,91,39,56,1,56,1,0,0
1969983,93,11,1920,3,"male",1385,813,617,28,12,2,2,26,10
1970007,27,27,1986,8,"male",534,476,277,284,388,284,274,0,114
1970008,17,6,1996,7,"male",321,305,94,650,800,519,605,131,195
1970021,23,1,1990,1,"male",126,46,43,0,64,0,12,0,52
1970026,41,9,1972,9,"male",550,2,0,0,0,0,0,0,0
1970054,16,2,1997,2,"female",458,227,29,0,0,0,0,0,0
1970134,46,28,1967,8,"female",671,105,24,36,60,36,48,0,12
1970137,50,1,1963,6,"male",451,3,3,3,0,3,0,0,0
1970142,44,23,1969,4,"male",62,45,37,14,26,14,8,0,18
1970148,48,3,1965,7,"female",30,62,52,113,32,113,7,0,25
1970159,27,19,1986,7,"male",539,352,263,1,1,1,1,0,0
1970175,74,3,1939,5,"male",837,38,29,3,17,0,7,3,10
1970193,18,15,1995,7,"male",114,88,78,111,12,111,9,0,3
1970201,55,6,1958,2,"female",1325,46,18,20,3,20,1,0,2
1970211,33,25,1980,3,"female",951,438,174,534,1251,337,644,197,607
1970216,14,10,1999,4,"male",37,44,44,0,2,0,2,0,0
1970221,63,1,1950,1,"male",203,44,26,0,1,0,0,0,1
1970241,59,9,1954,11,"female",1247,67,33,17,14,0,1,17,13
1970255,62,12,1951,12,"female",111,21,16,24,10,0,6,24,4
1970266,23,3,1990,11,"male",617,995,892,0,0,0,0,0,0
1970270,66,15,1947,9,"male",1675,41,4,6,0,4,0,2,0
1970292,22,14,1991,3,"male",336,86,40,0,0,0,0,0,0
1970298,104,27,1909,12,"male",894,267,199,2,4,1,2,1,2
1970335,27,4,1986,11,"male",645,152,24,48,0,48,0,0,0
1970343,30,14,1983,4,"female",372,43,26,106,141,63,139,43,2
1970359,17,19,1996,12,"male",398,180,153,11,8,3,6,8,2
1970361,18,12,1995,12,"male",340,247,218,0,1,0,1,0,0
1970374,29,24,1984,4,"female",317,94,81,5,0,5,0,0,0
1970384,18,5,1995,5,"female",249,248,127,0,2,0,1,0,1
1970424,39,1,1974,1,"male",576,365,178,3,12,3,10,0,2
1970432,15,25,1998,1,"female",559,273,114,34,89,34,78,0,11
1970447,72,3,1941,6,"male",1375,54,30,2,45,0,7,2,38
1970476,15,3,1998,7,"male",499,26,14,9,0,9,0,0,0
1970495,25,9,1988,3,"male",786,1,0,0,0,0,0,0,0
1970519,47,8,1966,2,"female",708,98,40,289,368,130,191,159,177
1970524,33,12,1980,6,"female",187,25,16,1,0,1,0,0,0
1970531,17,5,1996,7,"male",324,68,50,8,0,8,0,0,0
1970539,18,16,1995,8,"male",185,205,142,16,0,16,0,0,0
1970540,15,14,1998,6,"male",24,14,7,2,5,2,5,0,0
1970547,29,10,1984,11,"male",200,142,139,24,85,24,45,0,40
1970552,55,14,1958,8,"female",620,52,16,30,93,30,74,0,19
1970564,17,18,1996,5,"female",376,354,217,162,160,91,76,71,84
1970588,19,5,1994,11,"male",592,464,335,730,440,727,196,3,244
1970592,24,19,1989,11,"female",167,145,87,510,420,510,305,0,115
1970597,74,27,1939,11,"male",832,4630,831,966,39536,941,10199,25,29337
1970603,50,21,1963,2,"male",114,15,10,21,1,17,0,4,1
1970607,32,4,1981,10,"male",336,2,1,0,0,0,0,0,0
1970615,108,22,1905,6,"male",1514,484,121,0,0,0,0,0,0
1970642,42,31,1971,5,"female",654,77,46,10,12,10,9,0,3
1970644,49,7,1964,3,"female",257,58,27,25,5,0,1,25,4
1970647,16,11,1997,2,"female",245,178,76,6,3,6,2,0,1
1970659,61,22,1952,5,"female",790,95,49,1,0,0,0,1,0
1970680,17,10,1996,10,"male",291,48,20,3,0,3,0,0,0
1970683,19,13,1994,6,"male",1462,410,215,13,7,5,4,8,3
1970686,67,24,1946,2,"male",890,20,19,4,0,2,0,2,0
1970701,55,1,1958,1,"male",10,1,1,0,0,0,0,0,0
1970746,46,11,1967,2,"male",501,23,3,10,17,0,9,10,8
1970792,53,3,1960,9,"male",1116,364,160,1,50,0,31,1,19
1970802,52,4,1961,8,"male",1697,68,27,72,2,72,2,0,0
1970875,22,4,1991,2,"female",414,20,8,0,0,0,0,0,0
1970882,16,16,1997,6,"male",500,217,150,35,34,34,16,1,18
1970892,25,11,1988,8,"female",430,75,16,0,0,0,0,0,0
1970921,54,15,1959,8,"female",117,21,12,86,6,2,5,84,1
1970934,23,1,1990,7,"female",362,17,8,2,0,2,0,0,0
1970948,31,18,1982,5,"male",1016,282,171,764,648,759,198,5,450
1970953,51,6,1962,3,"female",555,94,26,194,53,184,16,10,37
1970977,53,18,1960,1,"female",26,1,0,0,0,0,0,0,0
1970980,46,4,1967,7,"female",47,140,125,12,1,12,1,0,0
1970998,57,27,1956,11,"male",17,69,58,8,9,1,1,7,8
1971009,18,18,1995,11,"male",10,1,1,0,0,0,0,0,0
1971014,26,7,1987,9,"male",749,182,146,12,47,12,40,0,7
1971022,68,3,1945,7,"female",1580,71,23,28,3,0,2,28,1
1971028,20,25,1993,2,"male",627,676,459,277,83,271,74,6,9
1971033,97,4,1916,6,"female",1544,53,28,0,1,0,0,0,1
1971056,44,4,1969,2,"male",153,77,38,122,111,122,42,0,69
1971064,24,4,1989,9,"female",301,31,25,1,0,1,0,0,0
1971071,50,14,1963,9,"male",314,188,134,2,0,2,0,0,0
1971074,28,5,1985,5,"male",607,31,17,0,2,0,2,0,0
1971098,25,4,1988,1,"male",13,1,1,1,0,1,0,0,0
1971101,16,29,1997,5,"female",90,39,15,237,396,19,45,218,351
1971131,68,12,1945,3,"male",550,584,347,21652,10220,21652,8584,0,1636
1971135,18,3,1995,7,"male",342,4,2,0,0,0,0,0,0
1971151,46,11,1967,10,"female",209,36,21,22,16,22,14,0,2
1971184,68,8,1945,3,"male",705,48,28,33,38,33,34,0,4
1971190,20,1,1993,7,"female",314,26,17,583,44,568,32,15,12
1971198,23,1,1990,1,"male",179,120,83,2,9,2,5,0,4
1971272,64,7,1949,1,"female",1450,139,38,15,68,13,45,2,23
1971278,25,7,1988,4,"male",407,492,427,16,20,12,19,4,1
1971289,18,15,1995,11,"female",207,209,50,613,302,579,224,34,78
1971294,65,3,1948,2,"female",281,45,32,17,4,17,4,0,0
1971301,76,20,1937,1,"female",1281,1,1,0,0,0,0,0,0
1971310,19,30,1994,1,"female",371,282,217,57,90,34,33,23,57
1971312,20,8,1993,6,"male",716,68,32,1,0,1,0,0,0
1971325,14,22,1999,4,"male",608,296,232,18,4,0,1,18,3
1971329,34,16,1979,6,"male",233,44,29,1,4,0,0,1,4
1971333,47,30,1966,10,"male",80,37,31,1,2,1,0,0,2
1971355,56,10,1957,9,"female",373,97,71,427,62,0,20,427,42
1971375,62,1,1951,6,"female",379,41,34,747,61,39,35,708,26
1971380,68,17,1945,7,"female",2387,168,55,185,65,5,52,180,13
1971396,64,27,1949,6,"male",1489,67,22,0,1,0,1,0,0
1971400,24,6,1989,4,"male",936,20,2,0,0,0,0,0,0
1971421,98,29,1915,10,"male",1725,19,11,121,111,9,70,112,41
1971422,28,22,1985,11,"male",458,198,126,53,257,49,218,4,39
1971426,32,22,1981,4,"male",536,268,129,12,4,12,4,0,0
1971449,26,8,1987,7,"male",1231,136,77,2,11,2,10,0,1
1971462,48,10,1965,6,"male",546,10,0,0,0,0,0,0,0
1971505,14,26,1999,6,"male",165,29,22,3,1,0,1,3,0
1971515,23,4,1990,4,"male",606,151,102,2,1,2,1,0,0
1971537,47,4,1966,11,"male",676,105,69,14,0,0,0,14,0
1971560,31,20,1982,2,"female",181,26,5,7,4,0,2,7,2
1971576,45,10,1968,1,"female",1957,477,297,94,69,94,39,0,30
1971584,15,10,1998,3,"female",28,269,144,502,1064,274,691,228,373
1971589,33,10,1980,5,"female",954,311,189,10,30,10,21,0,9
1971610,47,31,1966,12,"male",813,19,11,0,8,0,4,0,4
1971648,19,15,1994,5,"male",950,55,30,0,0,0,0,0,0
1971649,34,1,1979,2,"male",654,703,494,438,354,438,191,0,163
1971671,24,25,1989,4,"male",133,21,19,4,8,4,1,0,7
1971672,51,25,1962,8,"female",613,110,92,181,153,148,72,33,81
1971755,27,10,1986,10,"male",7,19,16,0,2,0,1,0,1
1971804,63,16,1950,11,"female",1108,410,230,491,107,91,45,400,62
1971812,16,10,1997,12,"male",257,230,133,0,0,0,0,0,0
1971818,19,17,1994,6,"male",319,163,150,0,6,0,6,0,0
1971825,19,1,1994,1,"male",647,110,54,16,0,16,0,0,0
1971841,62,12,1951,3,"male",1357,61,15,0,13,0,5,0,8
1971850,22,18,1991,12,"male",382,180,108,90,100,90,67,0,33
1971858,58,11,1955,1,"male",756,13,8,1,1,1,1,0,0
1971868,17,8,1996,9,"male",466,320,235,31,53,31,46,0,7
1971930,35,17,1978,2,"female",142,382,262,724,777,724,662,0,115
1971990,18,24,1995,10,"female",356,1958,957,3981,5968,3215,2636,766,3332
1972012,35,11,1978,11,"male",21,0,0,0,0,0,0,0,0
1972013,103,28,1910,1,"female",307,826,464,409,1033,409,930,0,103
1972051,49,5,1964,4,"male",101,21,16,0,0,0,0,0,0
1972054,19,17,1994,4,"male",428,111,66,1,4,1,3,0,1
1972081,23,27,1990,11,"female",327,29,20,0,0,0,0,0,0
1972087,22,4,1991,5,"male",556,192,74,0,0,0,0,0,0
1972088,17,21,1996,11,"male",630,269,115,84,27,0,24,84,3
1972097,18,16,1995,1,"male",13,0,0,0,0,0,0,0,0
1972104,31,15,1982,1,"male",252,46,30,0,0,0,0,0,0
1972138,48,27,1965,3,"male",771,25,11,5,0,5,0,0,0
1972180,52,11,1961,2,"male",1096,69,38,6,4,2,3,4,1
1972188,25,10,1988,1,"male",61,28,25,5,2,5,2,0,0
1972190,25,12,1988,6,"male",25,28,17,0,0,0,0,0,0
1972204,27,18,1986,1,"male",381,9,7,63,1,63,1,0,0
1972209,24,25,1989,1,"male",320,44,40,115,72,87,53,28,19
1972221,54,25,1959,2,"male",588,87,60,186,27,186,8,0,19
1972272,108,9,1905,5,"female",1588,255,100,510,585,226,317,284,268
1972288,49,28,1964,4,"male",800,158,81,18,270,15,190,3,80
1972318,14,18,1999,3,"male",192,246,152,449,264,419,125,30,139
1972324,29,27,1984,8,"male",195,62,50,0,9,0,2,0,7
1972351,44,7,1969,4,"male",319,43,35,3,1,3,0,0,1
1972365,16,24,1997,9,"female",293,86,39,270,39,270,31,0,8
1972382,63,23,1950,7,"male",102,171,124,25,5,25,5,0,0
1972400,14,30,1999,3,"female",325,34,29,1587,838,561,160,1026,678
1972406,25,20,1988,2,"male",115,14,8,0,0,0,0,0,0
1972429,18,6,1995,6,"female",209,266,175,221,179,103,157,118,22
1972436,61,6,1952,2,"female",937,96,17,34,11,2,0,32,11
1972446,26,10,1987,8,"male",405,227,97,40,8,39,6,1,2
1972449,79,29,1934,12,"female",915,7,4,0,0,0,0,0,0
1972462,18,7,1995,1,"female",644,2778,1131,962,856,878,612,84,244
1972464,16,5,1997,3,"female",578,963,287,216,80,216,68,0,12
1972477,21,8,1992,10,"female",292,398,113,229,473,179,318,50,155
1972498,44,14,1969,6,"male",117,30,16,38,22,38,17,0,5
1972504,23,10,1990,12,"female",256,30,26,104,25,58,3,46,22
1972540,25,22,1988,11,"male",530,63,53,43,6,43,5,0,1
1972570,47,15,1966,4,"male",530,18,7,71,56,71,33,0,23
1972579,45,1,1968,6,"male",594,99,83,6,4,6,3,0,1
1972594,51,28,1962,9,"female",258,289,164,422,134,0,32,422,102
1972601,53,4,1960,11,"male",155,111,77,25,13,25,5,0,8
1972612,37,12,1976,6,"male",578,199,51,1,1,1,1,0,0
1972626,17,27,1996,12,"female",770,228,185,20,12,10,9,10,3
1972627,19,26,1994,12,"female",236,1293,138,58,654,58,468,0,186
1972647,22,21,1991,10,"male",12,13,10,2,2,2,1,0,1
1972681,54,15,1959,12,"male",1036,236,82,68,31,0,4,68,27
1972685,70,8,1943,10,"male",399,24,13,19,22,19,20,0,2
1972686,77,20,1936,2,"female",17,14,10,5,4,0,0,5,4
1972687,72,12,1941,10,"male",261,9,9,0,0,0,0,0,0
1972694,55,27,1958,12,"male",311,121,106,80,45,72,23,8,22
1972726,53,26,1960,9,"male",1197,119,46,0,4,0,0,0,4
1972739,69,14,1944,7,"male",585,61,43,3,12,1,5,2,7
1972742,25,17,1988,6,"male",182,30,21,1,0,1,0,0,0
1972743,24,2,1989,2,"male",258,241,234,0,15,0,13,0,2
1972756,61,20,1952,6,"male",1597,144,68,4,63,0,23,4,40
1972775,19,6,1994,2,"male",404,219,164,7,0,2,0,5,0
1972808,56,5,1957,6,"female",94,55,47,60,83,1,31,59,52
1972826,24,6,1989,4,"male",43,2,0,9,7,9,7,0,0
1972831,54,11,1959,7,"male",173,53,48,49,8,49,5,0,3
1972868,23,30,1990,7,"male",226,568,427,107,163,82,116,25,47
1972878,17,18,1996,1,"female",280,87,49,6,11,0,0,6,11
1972884,108,2,1905,8,"male",1761,485,316,905,140,0,47,905,93
1972903,42,15,1971,8,"male",205,94,51,154,208,154,137,0,71
1972989,23,6,1990,12,"male",196,51,49,143,13,143,3,0,10
1973019,79,17,1934,12,"female",411,98,70,199,110,0,30,199,80
1973021,59,26,1954,4,"female",136,7,7,1,2,0,0,1,2
1973036,29,1,1984,9,"male",768,44,38,0,11,0,8,0,3
1973047,20,15,1993,10,"male",511,53,30,0,7,0,4,0,3
1973060,36,3,1977,10,"male",729,30,12,11,0,11,0,0,0
1973073,41,19,1972,7,"male",1322,86,44,10,6,10,4,0,2
1973095,28,7,1985,8,"female",409,38,24,27,2,27,2,0,0
1973136,61,18,1952,5,"female",873,72,51,13,19,12,5,1,14
1973153,27,2,1986,2,"male",562,101,56,58,31,47,16,11,15
1973193,28,30,1985,9,"male",1365,346,254,1,6,1,0,0,6
1973199,27,12,1986,1,"male",484,65,17,44,11,44,7,0,4
1973221,40,2,1973,10,"female",314,117,111,354,5,0,0,354,5
1973230,17,15,1996,3,"male",140,196,183,1,1,0,0,1,1
1973235,31,15,1982,6,"female",17,4,3,2,2,2,2,0,0
1973238,68,5,1945,8,"female",1431,628,302,20,481,0,107,20,374
1973247,25,11,1988,12,"male",1265,66,35,7,8,7,6,0,2
1973249,65,13,1948,6,"female",713,214,136,257,160,46,62,211,98
1973269,22,5,1991,7,"male",377,145,109,6,5,6,1,0,4
1973276,25,4,1988,10,"male",626,328,142,66,14,66,11,0,3
1973287,63,30,1950,11,"male",426,69,27,0,18,0,0,0,18
1973301,27,5,1986,2,"female",608,42,33,0,0,0,0,0,0
1973340,21,4,1992,1,"male",147,36,25,0,0,0,0,0,0
1973345,31,18,1982,8,"female",1499,449,195,254,840,201,548,53,292
1973360,16,20,1997,1,"female",324,559,366,404,299,388,207,16,92
1973377,19,23,1994,9,"female",286,36,30,279,75,273,47,6,28
1973406,19,13,1994,3,"male",202,266,187,2,14,2,11,0,3
1973409,20,13,1993,12,"male",851,46,26,10,0,10,0,0,0
1973420,45,1,1968,1,"male",534,70,36,206,14,0,1,206,13
1973433,108,9,1905,9,"female",1197,45,27,6,0,0,0,6,0
1973437,43,28,1970,9,"male",556,313,146,4,4,1,3,3,1
1973444,29,29,1984,6,"male",203,9,0,0,0,0,0,0,0
1973448,28,19,1985,5,"female",321,40,14,42,90,42,45,0,45
1973451,25,15,1988,5,"male",940,101,69,0,0,0,0,0,0
1973467,44,15,1969,2,"female",1921,261,123,200,291,22,57,178,234
1973479,53,19,1960,5,"male",137,5,1,2,1,2,1,0,0
1973483,47,18,1966,4,"male",347,87,70,0,6,0,6,0,0
1973524,40,2,1973,6,"female",333,15,7,0,1,0,1,0,0
1973531,19,11,1994,5,"male",840,298,170,14,37,14,28,0,9
1973540,24,1,1989,9,"female",571,121,72,61,46,61,36,0,10
1973545,53,24,1960,3,"male",506,4,3,0,0,0,0,0,0
1973551,23,14,1990,12,"female",350,119,43,1,0,1,0,0,0
1973605,21,21,1992,2,"male",131,11,11,1,0,1,0,0,0
1973612,16,30,1997,3,"female",267,300,77,156,124,60,90,96,34
1973616,16,21,1997,3,"female",405,520,253,166,95,166,54,0,41
1973629,58,25,1955,4,"female",75,52,43,52,4,52,2,0,2
1973650,38,19,1975,12,"female",618,85,62,92,145,92,124,0,21
1973657,20,3,1993,3,"male",315,276,253,0,30,0,11,0,19
1973668,43,10,1970,9,"female",294,46,21,53,27,3,7,50,20
1973692,19,28,1994,6,"male",487,173,137,0,0,0,0,0,0
1973697,16,21,1997,5,"male",642,1668,1428,77,62,77,57,0,5
1973701,108,17,1905,6,"male",140,35,21,43,127,34,47,9,80
1973725,15,5,1998,8,"male",269,31,20,47,2,47,2,0,0
1973738,18,14,1995,7,"female",406,222,153,60,64,40,47,20,17
1973759,23,20,1990,6,"male",34,2,1,2,0,0,0,2,0
1973783,72,19,1941,10,"male",1415,43,20,1,2,0,2,1,0
1973788,16,4,1997,1,"male",26,19,12,34,34,34,24,0,10
1973789,16,30,1997,1,"female",174,307,233,107,74,42,49,65,25
1973803,35,1,1978,1,"male",213,6,6,10,0,10,0,0,0
1973827,30,4,1983,4,"male",320,28,18,0,0,0,0,0,0
1973829,51,7,1962,11,"female",955,152,92,86,47,86,38,0,9
1973843,58,22,1955,12,"male",588,83,54,1007,770,0,101,1007,669
1973850,13,5,2000,1,"male",292,34,22,0,0,0,0,0,0
1973856,45,5,1968,1,"male",921,9,7,0,1,0,0,0,1
1973859,64,14,1949,9,"female",1487,58,45,8,0,8,0,0,0
1973864,16,5,1997,5,"female",95,322,79,508,420,508,299,0,121
1973874,58,23,1955,10,"male",1319,20,16,1710,125,1710,116,0,9
1973885,19,10,1994,11,"male",207,32,16,5,0,5,0,0,0
1973898,22,17,1991,4,"male",261,11,10,6,1,0,0,6,1
1973939,49,29,1964,10,"female",349,115,56,611,165,611,140,0,25
1973941,53,10,1960,9,"female",234,99,67,92,30,17,12,75,18
1973943,51,20,1962,6,"female",1643,326,210,32,19,19,13,13,6
1973960,22,26,1991,2,"female",334,388,360,849,1116,849,947,0,169
1973972,14,1,1999,10,"female",41,39,17,9,18,0,1,9,17
1973975,25,25,1988,7,"female",204,52,19,9,1,9,1,0,0
1974007,25,1,1988,1,"male",946,1,1,0,0,0,0,0,0
1974024,24,1,1989,1,"male",263,82,39,0,14,0,3,0,11
1974026,18,19,1995,12,"female",541,197,137,91,99,84,56,7,43
1974028,20,5,1993,4,"male",563,29,24,1,0,0,0,1,0
1974118,29,28,1984,10,"female",527,101,86,60,57,57,46,3,11
1974123,19,7,1994,1,"male",30,27,22,437,112,437,110,0,2
1974132,60,16,1953,2,"female",1475,88,33,68,33,0,16,68,17
1974174,20,16,1993,7,"female",250,75,42,0,1,0,0,0,1
1974177,20,2,1993,7,"male",363,71,18,0,0,0,0,0,0
1974182,14,24,1999,9,"male",191,99,84,0,0,0,0,0,0
1974188,21,2,1992,2,"female",399,4211,28,18,1027,18,724,0,303
1974197,53,27,1960,7,"female",700,417,316,80,42,29,28,51,14
1974238,17,19,1996,8,"male",172,793,768,748,601,59,318,689,283
1974254,28,18,1985,1,"male",917,340,238,15,82,14,35,1,47
1974256,47,4,1966,4,"female",699,96,82,886,395,21,175,865,220
1974257,16,15,1997,4,"male",505,193,98,0,0,0,0,0,0
1974258,63,22,1950,6,"female",177,80,42,2,3,0,3,2,0
1974283,27,1,1986,12,"male",430,471,409,18,28,18,26,0,2
1974330,35,12,1978,10,"male",415,8,3,4,1,4,1,0,0
1974339,23,17,1990,5,"male",611,117,83,7,4,5,0,2,4
1974373,60,23,1953,10,"male",1004,111,62,222,209,125,93,97,116
1974377,76,4,1937,1,"male",1333,352,35,1,0,0,0,1,0
1974379,63,7,1950,6,"male",1770,63,28,51,4,42,2,9,2
1974394,27,8,1986,1,"female",786,209,39,17,33,17,25,0,8
1974416,49,9,1964,3,"female",1478,195,85,82,77,1,28,81,49
1974440,91,4,1922,7,"male",397,601,230,0,0,0,0,0,0
1974459,29,5,1984,7,"male",752,5,0,9,35,7,11,2,24
1974465,23,10,1990,11,"male",406,19,14,48,64,48,60,0,4
1974488,66,26,1947,10,"female",839,46,38,10,11,0,4,10,7
1974551,16,24,1997,2,"male",610,196,130,1,19,1,12,0,7
1974617,25,10,1988,6,"male",64,28,28,161,4,161,4,0,0
1974632,33,25,1980,4,"female",422,3,1,1,0,0,0,1,0
1974671,69,6,1944,2,"female",73,564,440,539,703,0,119,539,584
1974687,78,24,1935,10,"male",876,446,388,6,67,6,26,0,41
1974700,36,13,1977,4,"female",467,37,25,49,2,49,2,0,0
1974709,47,25,1966,1,"female",608,77,43,45,48,0,15,45,33
1974717,25,2,1988,12,"male",189,126,95,0,0,0,0,0,0
1974719,56,25,1957,2,"male",1582,61,5,5,13,5,7,0,6
1974721,14,3,1999,9,"male",384,244,45,12,0,12,0,0,0
1974722,17,29,1996,7,"female",170,72,39,84,61,84,12,0,49
1974749,22,18,1991,9,"male",1187,163,81,73,119,61,73,12,46
1974753,67,21,1946,12,"female",985,13,6,11,3,0,1,11,2
1974773,108,7,1905,7,"female",577,418,297,0,0,0,0,0,0
1974782,88,20,1925,6,"female",839,523,247,3,1,3,1,0,0
1974841,24,29,1989,7,"male",397,240,221,0,1,0,0,0,1
1974869,24,11,1989,2,"female",361,285,115,2073,1394,247,852,1826,542
1974879,25,16,1988,10,"female",440,184,121,46,184,43,75,3,109
1974891,22,15,1991,1,"male",9,43,35,8,7,8,7,0,0
1974908,18,9,1995,8,"male",110,99,49,95,26,95,12,0,14
1974913,26,4,1987,6,"male",383,87,77,9,0,9,0,0,0
1974916,24,12,1989,4,"male",128,29,20,17,14,17,5,0,9
1974932,18,15,1995,4,"female",762,562,364,0,2,0,2,0,0
1974946,99,21,1914,1,"female",1764,216,90,155,386,155,366,0,20
1974976,16,5,1997,5,"female",405,1911,566,283,2026,283,1830,0,196
1975002,40,16,1973,11,"female",255,114,97,627,287,410,205,217,82
1975005,34,25,1979,10,"male",413,107,42,0,11,0,9,0,2
1975014,18,10,1995,3,"male",200,196,135,15,7,7,0,8,7
1975017,22,6,1991,10,"female",306,28,15,4,30,4,20,0,10
1975081,93,13,1920,11,"female",126,45,29,454,106,454,73,0,33
1975088,49,25,1964,3,"female",443,64,45,62,33,0,9,62,24
1975100,18,3,1995,10,"female",247,2624,1770,580,528,435,443,145,85
1975125,29,27,1984,6,"male",212,50,47,17,16,17,14,0,2
1975126,59,15,1954,3,"female",1270,63,14,102,33,14,21,88,12
1975134,57,11,1956,8,"male",784,38,28,32,47,32,46,0,1
1975144,53,9,1960,12,"male",460,297,215,8432,450,8432,266,0,184
1975146,61,6,1952,5,"male",136,58,35,14,19,14,11,0,8
1975147,24,15,1989,12,"male",500,450,341,47,11,47,11,0,0
1975151,26,3,1987,9,"male",798,482,336,67,19,67,11,0,8
1975206,40,22,1973,8,"male",129,5,0,0,0,0,0,0,0
1975219,27,7,1986,7,"female",310,38,16,1,10,1,4,0,6
1975231,18,23,1995,1,"male",238,165,153,0,0,0,0,0,0
1975252,35,3,1978,9,"female",289,126,64,301,344,95,106,206,238
1975253,54,14,1959,2,"female",1620,110,42,3,1,3,1,0,0
1975270,20,4,1993,4,"male",373,7,2,0,1,0,1,0,0
1975298,66,3,1947,3,"female",897,63,42,80,22,0,15,80,7
1975312,111,1,1902,1,"male",2217,184,86,71,79,63,66,8,13
1975314,44,9,1969,2,"female",36,2,1,0,0,0,0,0,0
1975317,18,2,1995,9,"female",51,590,228,226,376,226,274,0,102
1975318,44,26,1969,10,"male",676,69,51,6,5,4,4,2,1
1975328,20,14,1993,7,"male",135,33,24,0,0,0,0,0,0
1975349,56,19,1957,3,"male",979,110,62,35,101,14,45,21,56
1975350,23,25,1990,1,"male",23,10,6,2,1,2,1,0,0
1975362,21,2,1992,9,"female",364,517,460,18,19,9,7,9,12
1975381,54,22,1959,7,"female",295,176,90,2511,315,869,84,1642,231
1975397,16,9,1997,8,"female",385,574,450,283,55,49,25,234,30
1975398,14,14,1999,1,"female",173,108,85,0,0,0,0,0,0
1975419,15,3,1998,9,"male",121,134,95,11,2,0,0,11,2
1975432,69,20,1944,10,"male",1447,28,14,0,0,0,0,0,0
1975433,23,1,1990,1,"female",117,29,26,11,0,11,0,0,0
1975464,29,23,1984,8,"male",329,169,96,15,0,14,0,1,0
1975474,21,29,1992,10,"male",1043,70,28,7,27,7,22,0,5
1975493,30,18,1983,11,"male",357,1,1,30,0,0,0,30,0
1975519,25,1,1988,1,"male",102,1,0,4,0,4,0,0,0
1975547,62,22,1951,12,"female",167,66,50,0,5,0,4,0,1
1975599,103,31,1910,12,"male",523,24,9,223,465,59,377,164,88
1975610,20,14,1993,4,"female",58,0,0,0,0,0,0,0,0
1975615,19,14,1994,10,"male",348,207,76,0,1,0,1,0,0
1975631,21,13,1992,12,"male",736,416,222,29,38,23,14,6,24
1975636,18,17,1995,1,"male",324,48,21,1,2,1,1,0,1
1975650,23,4,1990,3,"male",454,269,156,6,17,6,14,0,3
1975659,99,1,1914,10,"male",593,474,301,0,1,0,1,0,0
1975691,17,11,1996,4,"male",300,231,196,29,6,29,6,0,0
1975693,23,12,1990,12,"male",110,115,82,2,2,0,1,2,1
1975704,18,6,1995,5,"male",48,44,39,28,3,28,0,0,3
1975708,17,7,1996,11,"male",374,106,90,5,0,5,0,0,0
1975730,40,30,1973,1,"female",740,81,42,214,35,80,28,134,7
1975731,20,24,1993,4,"male",306,26,26,0,0,0,0,0,0
1975741,37,24,1976,1,"female",733,1,1,0,0,0,0,0,0
1975747,67,9,1946,5,"female",2226,120,62,137,202,43,82,94,120
1975772,26,1,1987,1,"male",355,2,2,0,0,0,0,0,0
1975773,15,27,1998,9,"female",39,208,29,361,492,39,60,322,432
1975775,19,16,1994,1,"female",471,161,51,33,51,9,8,24,43
1975785,64,15,1949,2,"female",1337,43,22,4,6,0,3,4,3
1975805,50,22,1963,5,"female",145,161,95,46,3,17,1,29,2
1975834,59,10,1954,11,"female",799,137,30,75,130,74,78,1,52
1975840,19,10,1994,8,"female",763,1115,419,763,1029,119,548,644,481
1975886,25,19,1988,7,"male",337,83,57,20,4,20,4,0,0
1975887,25,24,1988,7,"male",555,3,2,0,0,0,0,0,0
1975888,23,12,1990,4,"male",305,20,2,0,0,0,0,0,0
1975917,14,19,1999,3,"male",240,131,76,37,1,37,1,0,0
1975931,64,23,1949,8,"female",67,10,5,49,5,49,2,0,3
1975938,17,16,1996,9,"female",1255,1253,299,407,863,27,668,380,195
1975939,22,4,1991,5,"male",131,25,22,0,4,0,2,0,2
1975958,31,22,1982,4,"male",361,3,3,0,0,0,0,0,0
1976007,49,11,1964,9,"male",328,42,31,24,3,24,1,0,2
1976011,16,16,1997,4,"male",844,1593,1062,905,1338,188,822,717,516
1976017,17,27,1996,12,"female",244,517,99,24,72,24,63,0,9
1976018,30,1,1983,4,"male",338,255,198,40,13,30,7,10,6
1976028,26,29,1987,5,"female",477,123,73,9,2,9,2,0,0
1976030,66,5,1947,11,"male",422,138,93,99,203,99,114,0,89
1976048,33,12,1980,10,"female",424,41,28,10,5,8,5,2,0
1976067,33,15,1980,5,"male",28,18,13,3,1,3,0,0,1
1976086,15,3,1998,10,"male",224,148,106,20,8,20,5,0,3
1976102,63,24,1950,10,"male",712,55,26,0,0,0,0,0,0
1976129,16,9,1997,5,"male",588,296,160,5,0,5,0,0,0
1976180,47,19,1966,6,"male",33,385,356,4539,1811,4539,1490,0,321
1976185,16,4,1997,6,"male",614,286,237,6,53,6,31,0,22
1976189,108,28,1905,3,"male",2126,300,96,16,36,7,13,9,23
1976194,29,9,1984,4,"male",414,77,42,9,1,0,0,9,1
1976203,59,14,1954,3,"male",1342,64,19,0,0,0,0,0,0
1976208,57,6,1956,8,"male",294,267,104,204,293,203,149,1,144
1976214,19,25,1994,5,"male",416,42,30,11,23,8,2,3,21
1976216,33,29,1980,12,"female",247,50,11,0,0,0,0,0,0
1976235,43,16,1970,3,"male",487,86,47,12,50,10,11,2,39
1976247,56,28,1957,5,"female",971,73,40,65,11,65,9,0,2
1976272,21,15,1992,4,"male",661,253,178,16,47,16,32,0,15
1976280,53,4,1960,3,"female",324,154,112,35,37,0,6,35,31
1976286,55,20,1958,12,"male",1567,106,48,259,117,173,79,86,38
1976309,47,1,1966,11,"female",414,147,80,105,70,0,18,105,52
1976379,16,22,1997,1,"male",379,154,128,2,15,2,11,0,4
1976412,38,4,1975,2,"male",362,2,0,0,0,0,0,0,0
1976419,19,18,1994,2,"female",365,9,4,6,2,0,0,6,2
1976464,21,9,1992,12,"female",26,9,7,12,10,12,5,0,5
1976477,75,7,1938,11,"female",1603,21,5,0,0,0,0,0,0
1976488,44,19,1969,2,"male",557,39,13,37,5,0,2,37,3
1976492,83,2,1930,3,"female",799,38,34,46,121,0,48,46,73
1976493,18,25,1995,9,"female",306,214,185,49,30,47,21,2,9
1976516,41,30,1972,4,"male",941,30,12,13,3,0,0,13,3
1976549,23,21,1990,3,"male",31,1,0,61,2,0,0,61,2
1976552,27,2,1986,4,"male",72,182,107,2,0,2,0,0,0
1976560,21,3,1992,1,"male",300,0,0,0,0,0,0,0,0
1976587,20,10,1993,7,"female",622,240,176,24,7,0,1,24,6
1976615,14,1,1999,1,"male",45,95,81,0,0,0,0,0,0
1976629,63,8,1950,1,"male",197,41,26,1,1,1,1,0,0
1976635,33,14,1980,11,"male",757,169,146,18,29,18,15,0,14
1976677,18,11,1995,5,"male",152,64,42,0,0,0,0,0,0
1976687,22,20,1991,6,"male",147,238,223,33,4,8,1,25,3
1976698,25,22,1988,6,"female",913,92,49,1807,81,1807,15,0,66
1976706,70,13,1943,7,"male",556,22,19,34,6,0,1,34,5
1976709,19,25,1994,3,"male",268,147,110,7,66,7,44,0,22
1976722,54,19,1959,6,"male",164,71,33,17,17,17,12,0,5
1976746,20,6,1993,1,"female",220,6,4,5,0,5,0,0,0
1976748,19,11,1994,8,"female",524,895,681,277,479,277,331,0,148
1976777,19,5,1994,7,"male",317,51,25,0,4,0,0,0,4
1976782,17,31,1996,7,"male",567,555,460,369,253,106,94,263,159
1976796,58,3,1955,3,"male",1513,32,6,0,5,0,2,0,3
1976806,26,2,1987,1,"female",277,90,28,100,85,100,79,0,6
1976818,19,10,1994,11,"male",676,52,30,1,0,1,0,0,0
1976820,15,8,1998,12,"female",277,196,142,106,39,106,13,0,26
1976839,44,11,1969,7,"female",241,52,29,28,97,28,67,0,30
1976863,103,20,1910,6,"female",703,204,70,123,38,123,10,0,28
1976866,23,14,1990,9,"female",402,202,136,80,80,46,42,34,38
1976882,26,16,1987,11,"female",747,854,386,9013,7927,1728,4254,7285,3673
1976884,26,20,1987,10,"male",781,107,96,14,6,14,6,0,0
1976900,61,22,1952,9,"female",682,120,75,7,44,7,26,0,18
1976906,80,27,1933,9,"female",1226,8,6,66,2,0,0,66,2
1976917,19,29,1994,4,"male",328,99,80,0,1,0,0,0,1
1976945,18,16,1995,4,"male",454,178,113,6,1,4,1,2,0
1976948,34,29,1979,1,"male",954,354,204,249,190,203,77,46,113
1976993,31,30,1982,10,"male",30,42,39,25,13,25,13,0,0
1977007,16,17,1997,3,"female",408,339,298,60,298,11,202,49,96
1977026,23,13,1990,11,"male",207,0,0,0,0,0,0,0,0
1977046,25,24,1988,8,"male",35,50,31,15,2,15,2,0,0
1977050,47,23,1966,11,"male",483,56,41,150,34,150,29,0,5
1977055,40,23,1973,6,"male",535,27,19,3,3,2,1,1,2
1977070,19,15,1994,6,"male",349,224,198,164,85,149,52,15,33
1977074,58,9,1955,8,"male",714,228,194,461,83,451,40,10,43
1977098,35,24,1978,6,"male",1707,161,61,0,1,0,0,0,1
1977124,37,5,1976,7,"male",290,125,61,8,2,0,0,8,2
1977125,55,1,1958,9,"male",627,17,10,56,5,56,4,0,1
1977152,36,21,1977,3,"male",14,154,145,51,69,51,64,0,5
1977153,20,25,1993,5,"male",760,58,39,0,0,0,0,0,0
1977191,18,30,1995,8,"male",462,220,119,31,20,31,20,0,0
1977223,34,15,1979,5,"male",91,15,9,4,0,4,0,0,0
1977237,19,5,1994,9,"male",34,2,2,0,0,0,0,0,0
1977254,28,9,1985,4,"male",572,244,196,21,17,21,5,0,12
1977266,14,13,1999,7,"male",65,301,254,2,3,0,0,2,3
1977270,59,19,1954,12,"female",998,56,26,78,1,78,1,0,0
1977291,13,1,2000,1,"male",265,15,9,14,9,14,4,0,5
1977300,24,20,1989,11,"female",1384,195,42,0,0,0,0,0,0
1977384,31,27,1982,9,"male",342,25,11,3,0,3,0,0,0
1977398,108,10,1905,6,"female",1685,174,69,114,53,93,23,21,30
1977444,53,9,1960,12,"male",128,68,39,233,35,0,2,233,33
1977481,27,1,1986,4,"male",146,58,39,13,2,13,2,0,0
1977491,22,8,1991,4,"female",413,168,83,188,294,188,205,0,89
1977498,59,17,1954,11,"male",359,56,21,45,19,43,11,2,8
1977502,50,1,1963,6,"female",673,12,10,6,4,0,4,6,0
1977551,17,22,1996,8,"male",600,106,49,6,5,4,4,2,1
1977557,33,5,1980,6,"male",548,82,26,27,79,27,21,0,58
1977566,62,3,1951,1,"female",1122,59,31,584,333,0,76,584,257
1977583,28,13,1985,1,"male",406,61,39,0,0,0,0,0,0
1977606,54,16,1959,7,"female",798,75,48,224,141,184,109,40,32
1977625,61,6,1952,1,"female",1115,90,22,7,35,1,10,6,25
1977633,23,7,1990,10,"male",287,133,73,2,0,2,0,0,0
1977639,43,6,1970,7,"female",570,36,12,64,90,64,67,0,23
1977651,25,1,1988,1,"male",36,5,1,0,0,0,0,0,0
1977676,20,22,1993,7,"male",414,99,88,102,14,45,2,57,12
1977693,26,8,1987,7,"male",81,147,79,8,16,8,16,0,0
1977724,71,26,1942,12,"male",34,215,158,43,82,43,82,0,0
1977729,54,3,1959,6,"female",1039,99,55,392,327,392,269,0,58
1977768,18,11,1995,2,"male",1047,605,328,793,361,790,178,3,183
1977782,22,17,1991,11,"male",548,258,228,9,11,4,2,5,9
1977851,23,21,1990,12,"female",361,33,12,87,39,87,7,0,32
1977855,64,20,1949,7,"female",134,59,49,254,4,254,1,0,3
1977857,14,20,1999,7,"male",106,3,2,14,1,0,1,14,0
1977901,44,21,1969,10,"female",444,12,3,30,11,30,10,0,1
1977922,49,27,1964,5,"female",352,29,22,50,3,50,1,0,2
1977934,27,1,1986,5,"male",144,22,22,1,0,1,0,0,0
1977953,18,12,1995,12,"male",345,209,112,15,36,13,28,2,8
1977958,53,15,1960,6,"female",31,72,69,7,25,0,11,7,14
1977961,71,18,1942,12,"female",430,21,17,10,2,0,0,10,2
1977986,20,9,1993,8,"female",468,36,23,1798,199,1283,128,515,71
1978005,65,20,1948,8,"female",888,162,107,1,2,1,2,0,0
1978010,80,31,1933,8,"male",1034,66,40,1,1,0,0,1,1
1978012,24,17,1989,6,"male",675,167,46,8,22,8,9,0,13
1978021,23,30,1990,7,"female",428,49,35,1,3,1,1,0,2
1978037,79,12,1934,11,"female",1230,111,69,406,116,0,13,406,103
1978050,25,6,1988,11,"female",719,399,133,65,68,65,53,0,15
1978053,18,11,1995,4,"male",375,387,254,1,3,1,3,0,0
1978085,102,1,1911,4,"female",2214,530,275,12,62,6,20,6,42
1978088,82,10,1931,9,"female",676,30,24,65,2,62,1,3,1
1978096,30,1,1983,1,"female",903,0,0,0,0,0,0,0,0
1978112,21,14,1992,6,"male",418,32,28,0,0,0,0,0,0
1978181,23,8,1990,1,"male",108,59,45,311,62,311,60,0,2
1978218,26,12,1987,8,"male",141,44,43,0,0,0,0,0,0
1978230,44,20,1969,9,"male",915,98,48,78,0,11,0,67,0
1978246,35,12,1978,3,"female",46,318,148,21,440,21,328,0,112
1978252,23,13,1990,7,"female",249,250,199,12,17,12,11,0,6
1978297,23,2,1990,10,"male",418,35,31,54,24,53,19,1,5
1978299,46,21,1967,8,"male",606,148,111,322,309,322,216,0,93
1978315,33,5,1980,5,"male",1460,122,99,2,72,0,20,2,52
1978329,42,14,1971,7,"male",265,26,16,9,9,9,8,0,1
1978335,15,23,1998,4,"female",96,587,267,231,356,86,192,145,164
1978406,16,27,1997,10,"female",549,548,279,310,234,218,209,92,25
1978441,24,18,1989,1,"male",239,164,70,0,14,0,14,0,0
1978450,28,10,1985,8,"male",445,72,34,446,230,360,158,86,72
1978472,47,1,1966,3,"male",1361,331,134,0,0,0,0,0,0
1978490,29,8,1984,11,"male",731,199,62,2,0,2,0,0,0
1978521,16,18,1997,2,"male",1047,12,6,0,0,0,0,0,0
1978550,65,29,1948,2,"male",467,3,1,4,6,0,0,4,6
1978551,17,4,1996,5,"male",300,96,49,18,10,18,9,0,1
1978565,25,14,1988,12,"female",259,7,7,1,0,1,0,0,0
1978576,42,4,1971,12,"male",519,56,45,1,1,1,1,0,0
1978591,17,26,1996,5,"male",351,402,342,550,53,550,36,0,17
1978602,49,2,1964,1,"male",29,1,1,22,12,22,8,0,4
1978609,21,28,1992,9,"male",793,317,206,10,1,10,0,0,1
1978617,20,2,1993,8,"male",382,696,631,16,103,16,86,0,17
1978619,101,28,1912,10,"female",658,199,104,151,90,151,71,0,19
1978630,31,15,1982,12,"male",211,217,148,66,88,66,64,0,24
1978631,54,6,1959,9,"male",1115,127,57,4,3,4,3,0,0
1978665,18,11,1995,3,"male",522,147,109,0,0,0,0,0,0
1978687,18,13,1995,1,"male",589,711,508,0,1,0,1,0,0
1978693,28,1,1985,1,"male",445,10,10,0,0,0,0,0,0
1978703,73,7,1940,11,"female",430,30,27,6,0,0,0,6,0
1978732,38,28,1975,7,"female",190,119,66,897,895,897,754,0,141
1978771,33,19,1980,1,"male",1461,11,7,11,2,11,0,0,2
1978793,34,28,1979,9,"male",261,0,0,0,0,0,0,0,0
1978794,21,29,1992,2,"male",1302,1399,1140,146,70,5,22,141,48
1978825,41,7,1972,4,"female",2173,21,16,0,0,0,0,0,0
1978826,49,19,1964,8,"male",450,12,7,0,0,0,0,0,0
1978840,19,8,1994,10,"male",677,484,366,2,8,1,3,1,5
1978860,30,13,1983,7,"female",1050,220,130,19,5,19,2,0,3
1978880,25,20,1988,2,"male",60,15,12,1,0,1,0,0,0
1978921,33,31,1980,7,"female",160,151,130,1,6,1,6,0,0
1978925,23,29,1990,1,"female",371,270,226,503,263,263,118,240,145
1978934,20,2,1993,10,"male",861,121,83,21,18,21,13,0,5
1978935,18,1,1995,4,"female",503,240,220,0,0,0,0,0,0
1978960,17,12,1996,12,"male",488,119,45,11,6,11,6,0,0
1978969,17,7,1996,8,"male",58,22,15,0,1,0,0,0,1
1978988,38,1,1975,1,"female",299,6,3,2,3,2,0,0,3
1979006,32,25,1981,7,"female",672,124,98,2,14,2,7,0,7
1979029,53,5,1960,12,"female",260,3,0,1,0,0,0,1,0
1979055,23,9,1990,5,"female",292,48,22,45,21,45,13,0,8
1979057,33,5,1980,1,"female",425,211,62,83,99,83,71,0,28
1979060,56,1,1957,1,"male",648,128,109,16,4,16,3,0,1
1979074,34,27,1979,11,"female",501,28,21,0,1,0,0,0,1
1979082,59,2,1954,5,"male",113,68,63,121,29,121,17,0,12
1979135,17,1,1996,10,"male",13,12,11,0,0,0,0,0,0
1979141,46,26,1967,11,"female",372,1,1,0,0,0,0,0,0
1979193,19,4,1994,7,"female",527,108,75,5,8,5,5,0,3
1979207,26,4,1987,9,"female",393,263,110,19,50,19,36,0,14
1979209,17,12,1996,10,"male",590,132,79,14,15,10,6,4,9
1979221,58,16,1955,7,"female",2068,134,74,152,253,51,151,101,102
1979223,27,1,1986,1,"male",264,167,114,570,172,549,139,21,33
1979237,38,7,1975,2,"male",144,42,31,0,0,0,0,0,0
1979240,56,22,1957,8,"female",265,42,21,2,19,2,5,0,14
1979261,14,2,1999,11,"male",94,123,108,13,34,0,14,13,20
1979268,52,1,1961,6,"female",1675,356,186,1105,2232,93,1203,1012,1029
1979281,14,11,1999,2,"male",231,122,110,0,0,0,0,0,0
1979299,43,3,1970,7,"male",1660,189,61,0,0,0,0,0,0
1979331,46,7,1967,2,"male",412,0,0,0,0,0,0,0,0
1979338,21,20,1992,8,"male",705,27,16,11,1,0,0,11,1
1979349,64,25,1949,6,"female",246,35,21,100,7,100,7,0,0
1979352,43,3,1970,1,"male",30,2,2,1,0,1,0,0,0
1979353,62,23,1951,3,"female",1370,112,72,37,41,0,9,37,32
1979359,60,13,1953,11,"female",1824,53,36,80,74,26,38,54,36
1979389,23,1,1990,1,"male",283,336,235,862,140,828,95,34,45
1979396,16,13,1997,3,"female",25,22,16,0,9,0,5,0,4
1979407,81,18,1932,1,"female",1364,171,107,74,8,3,7,71,1
1979411,15,27,1998,7,"male",42,126,123,616,55,607,48,9,7
1979428,15,9,1998,9,"female",48,300,144,2119,1837,1630,951,489,886
1979429,26,1,1987,1,"male",543,106,97,9,2,9,2,0,0
1979435,19,20,1994,6,"female",667,251,82,0,0,0,0,0,0
1979436,40,15,1973,9,"male",277,173,162,14,34,1,17,13,17
1979444,39,16,1974,6,"female",105,19,14,300,19,300,15,0,4
1979486,23,1,1990,2,"male",480,57,18,72,36,0,23,72,13
1979491,107,12,1906,12,"male",1335,208,161,26,12,26,8,0,4
1979506,19,28,1994,7,"male",512,170,65,0,0,0,0,0,0
1979526,40,14,1973,3,"male",235,0,0,7,0,7,0,0,0
1979634,19,1,1994,1,"male",327,59,53,19,0,6,0,13,0
1979642,18,20,1995,2,"male",452,196,112,1,10,1,10,0,0
1979672,15,30,1998,8,"female",108,312,96,4,82,4,80,0,2
1979676,18,30,1995,10,"male",489,903,450,427,658,399,296,28,362
1979677,102,22,1911,9,"male",1814,38,13,10,1,0,1,10,0
1979686,18,2,1995,4,"female",633,1391,718,442,814,416,592,26,222
1979696,27,20,1986,7,"female",404,87,62,6,31,6,25,0,6
1979726,31,1,1982,5,"male",154,52,34,2,4,2,2,0,2
1979735,22,8,1991,8,"male",755,0,0,0,0,0,0,0,0
1979737,18,1,1995,1,"male",359,90,77,2,0,2,0,0,0
1979743,72,2,1941,11,NA,1978,109,42,53,29,53,22,0,7
1979751,30,2,1983,4,"male",389,14,13,0,5,0,4,0,1
1979760,61,28,1952,9,"female",2127,147,56,260,372,223,141,37,231
1979767,71,26,1942,8,"male",1693,12,6,1,1,0,1,1,0
1979775,29,8,1984,1,"male",278,111,50,7,80,7,31,0,49
1979781,55,20,1958,8,"male",305,8,5,2,2,0,1,2,1
1979790,66,7,1947,1,"male",62,53,38,78,77,0,34,78,43
1979801,29,7,1984,1,"female",433,126,69,29,4,0,0,29,4
1979839,33,4,1980,7,"male",256,1,1,0,0,0,0,0,0
1979847,26,11,1987,2,"male",1321,274,153,0,0,0,0,0,0
1979880,56,9,1957,12,"male",1882,4,3,0,0,0,0,0,0
1979882,19,11,1994,7,"female",190,107,75,96,88,68,67,28,21
1979887,50,31,1963,3,"male",550,70,49,0,12,0,9,0,3
1979897,63,1,1950,1,NA,2101,164,122,37,6,37,5,0,1
1979939,26,19,1987,7,"female",86,113,90,900,321,900,190,0,131
1980001,14,19,1999,9,"male",326,312,104,139,65,70,45,69,20
1980028,18,19,1995,1,"male",448,103,67,82,3,8,0,74,3
1980034,18,9,1995,5,"female",778,1295,978,2354,3160,1989,2526,365,634
1980085,34,22,1979,8,"male",584,16,14,5,3,5,0,0,3
1980089,16,11,1997,12,"male",823,208,95,53,37,53,30,0,7
1980093,38,10,1975,10,"male",201,41,23,27,9,27,8,0,1
1980108,80,30,1933,11,"male",904,21,10,2,4,0,0,2,4
1980123,25,1,1988,1,"female",3,4,4,14,2,14,2,0,0
1980139,26,26,1987,4,"male",74,3,1,0,0,0,0,0,0
1980155,60,2,1953,12,"male",648,85,58,1092,347,1092,180,0,167
1980203,16,12,1997,5,"male",154,71,50,0,0,0,0,0,0
1980211,17,18,1996,5,"male",266,183,57,29,42,15,25,14,17
1980238,24,1,1989,1,"male",664,262,119,5,2,5,1,0,1
1980245,70,17,1943,10,"female",1656,133,49,1203,156,1203,64,0,92
1980261,51,2,1962,1,"male",1426,16,3,0,0,0,0,0,0
1980271,49,3,1964,10,"male",509,93,90,112,15,112,8,0,7
1980273,15,13,1998,5,"male",124,91,60,37,44,8,10,29,34
1980301,40,8,1973,8,"male",719,103,81,9,4,2,3,7,1
1980305,22,19,1991,2,"female",2,8,5,1,2,0,0,1,2
1980327,19,16,1994,8,"male",567,205,126,0,0,0,0,0,0
1980346,19,6,1994,4,"male",425,74,22,0,10,0,10,0,0
1980398,46,9,1967,3,"male",346,46,34,25,21,0,2,25,19
1980401,20,2,1993,3,"male",250,103,73,0,2,0,1,0,1
1980405,44,31,1969,8,"male",363,253,112,7,3,0,1,7,2
1980413,66,11,1947,5,"female",1093,57,30,49,13,49,11,0,2
1980419,37,4,1976,12,"male",438,12,4,14,11,14,11,0,0
1980424,33,6,1980,11,"male",168,40,22,1,10,1,5,0,5
1980431,24,29,1989,7,"female",242,109,51,13,92,13,73,0,19
1980441,14,15,1999,8,"male",41,54,33,0,0,0,0,0,0
1980445,55,5,1958,9,"female",593,120,86,1,6,0,2,1,4
1980455,23,30,1990,3,"male",124,89,55,22,6,22,4,0,2
1980465,32,21,1981,6,"male",586,45,29,1,0,1,0,0,0
1980484,50,24,1963,1,"female",367,315,275,11,1,0,1,11,0
1980487,15,22,1998,4,"female",641,106,46,128,190,86,52,42,138
1980502,19,26,1994,5,"male",703,237,215,42,16,24,9,18,7
1980525,80,22,1933,12,"male",622,77,45,46,38,41,20,5,18
1980544,51,13,1962,5,"female",1566,94,41,39,92,36,40,3,52
1980558,47,25,1966,5,"female",402,49,36,1961,441,1961,216,0,225
1980621,16,21,1997,5,"female",442,136,91,673,350,132,158,541,192
1980637,19,24,1994,7,"female",136,107,86,49,9,47,8,2,1
1980648,24,27,1989,1,"female",72,38,29,1393,1271,15,422,1378,849
1980662,22,5,1991,12,"male",151,72,65,0,0,0,0,0,0
1980663,26,20,1987,10,"male",467,119,69,0,0,0,0,0,0
1980692,102,4,1911,1,"female",339,111,50,9,8,9,6,0,2
1980740,57,5,1956,6,"female",725,53,37,91,1,91,0,0,1
1980758,18,10,1995,1,"male",329,216,196,7,12,0,2,7,10
1980760,76,9,1937,5,"female",2200,51,20,0,0,0,0,0,0
1980781,100,8,1913,10,"female",32,44,37,169,228,139,155,30,73
1980783,26,15,1987,10,"female",685,125,107,3,3,3,1,0,2
1980814,16,4,1997,6,"male",307,119,96,8,3,0,0,8,3
1980822,32,20,1981,2,"male",621,30,16,2,0,2,0,0,0
1980829,20,14,1993,2,"male",541,21,11,0,0,0,0,0,0
1980838,26,1,1987,1,"male",446,70,64,0,3,0,3,0,0
1980849,31,31,1982,3,"female",110,82,65,121,97,26,22,95,75
1980851,20,6,1993,12,"female",507,70,33,18,32,18,32,0,0
1980865,23,24,1990,1,"male",710,269,202,62,9,47,4,15,5
1980911,16,8,1997,2,"male",567,616,364,152,410,113,308,39,102
1980941,20,17,1993,11,"male",518,263,114,322,126,322,79,0,47
1980963,42,18,1971,5,"male",355,216,42,1,43,0,25,1,18
1980992,19,5,1994,12,"female",373,4589,1720,841,10253,663,2982,178,7271
1981012,48,12,1965,10,"male",2054,281,233,296,260,296,227,0,33
1981040,16,29,1997,8,"female",277,101,51,15,23,15,13,0,10
1981055,30,10,1983,12,"male",269,76,58,2,1,2,0,0,1
1981060,26,28,1987,12,"male",88,7,6,0,2,0,1,0,1
1981082,23,5,1990,6,"female",81,300,133,172,305,120,123,52,182
1981085,18,31,1995,12,"male",371,1,1,0,0,0,0,0,0
1981108,17,16,1996,12,"male",130,193,167,13,0,13,0,0,0
1981109,26,2,1987,10,"male",193,131,113,26,37,26,34,0,3
1981113,30,11,1983,7,"female",421,93,55,10,3,10,3,0,0
1981130,23,10,1990,1,"male",66,1,1,0,1,0,1,0,0
1981134,17,1,1996,1,"female",102,39,15,13,9,0,5,13,4
1981142,15,25,1998,1,"female",839,821,470,762,155,428,56,334,99
1981143,36,29,1977,9,"male",362,126,88,185,386,13,106,172,280
1981167,57,26,1956,4,"male",677,89,44,120,115,120,68,0,47
1981178,18,20,1995,1,"female",1297,2447,1036,2164,2945,108,1360,2056,1585
1981208,19,7,1994,8,"male",299,664,292,793,686,776,471,17,215
1981212,55,22,1958,10,"female",1695,127,77,467,150,0,16,467,134
1981236,25,1,1988,1,"male",280,163,121,20,6,20,6,0,0
1981258,19,12,1994,10,"male",378,181,157,2,7,2,6,0,1
1981272,27,4,1986,1,"female",713,90,48,144,188,35,79,109,109
1981326,15,25,1998,7,"male",258,176,111,7,0,0,0,7,0
1981328,18,11,1995,7,"female",588,111,53,1,0,0,0,1,0
1981336,26,12,1987,8,"female",230,39,13,0,1,0,1,0,0
1981345,15,23,1998,8,"male",84,54,47,0,0,0,0,0,0
1981369,16,13,1997,4,"female",552,153,34,441,186,441,177,0,9
1981383,26,1,1987,7,"male",175,31,25,9,1,9,0,0,1
1981387,28,2,1985,1,"male",286,26,12,24,0,0,0,24,0
1981396,25,17,1988,10,"female",63,61,41,88,55,88,25,0,30
1981454,65,28,1948,10,"male",1480,51,18,8,4,0,2,8,2
1981460,22,11,1991,8,"male",466,192,175,3,0,3,0,0,0
1981487,51,26,1962,2,"female",73,13,12,0,2,0,2,0,0
1981501,16,11,1997,5,"male",293,5,4,2,0,2,0,0,0
1981503,33,10,1980,5,"female",305,26,24,1,1,1,0,0,1
1981504,23,30,1990,7,"male",491,1241,681,1104,2437,892,1504,212,933
1981513,26,10,1987,2,"male",751,10,8,0,0,0,0,0,0
1981516,103,4,1910,2,"female",845,271,56,19,345,19,342,0,3
1981520,23,30,1990,1,"male",438,111,97,2,23,2,15,0,8
1981527,18,1,1995,5,"male",258,1921,1684,0,2,0,1,0,1
1981530,29,9,1984,10,"male",78,153,141,5,5,5,2,0,3
1981545,26,1,1987,1,"male",111,6,4,5,7,5,5,0,2
1981553,36,1,1977,8,"male",273,0,0,0,0,0,0,0,0
1981571,18,17,1995,10,"female",460,118,54,33,25,33,18,0,7
1981576,51,22,1962,6,"male",1747,85,38,7,2,7,2,0,0
1981593,36,3,1977,3,"female",132,35,34,1,0,1,0,0,0
1981633,21,2,1992,2,"male",493,263,219,0,4,0,4,0,0
1981644,34,12,1979,10,"male",209,101,96,0,0,0,0,0,0
1981700,27,18,1986,11,"female",503,132,95,96,41,96,37,0,4
1981711,40,12,1973,5,"female",558,30,9,139,14,0,7,139,7
1981712,18,4,1995,8,"male",73,16,11,0,0,0,0,0,0
1981715,47,16,1966,1,"female",359,37,19,21,28,21,9,0,19
1981740,29,1,1984,1,"male",539,25,20,0,0,0,0,0,0
1981752,29,26,1984,5,"male",1332,352,128,292,578,281,276,11,302
1981753,20,30,1993,10,"female",720,166,71,140,121,138,75,2,46
1981790,32,1,1981,7,"male",443,126,91,28,14,28,10,0,4
1981798,19,13,1994,6,"female",342,2,2,1,0,0,0,1,0
1981801,27,21,1986,4,"male",269,108,84,86,27,34,15,52,12
1981820,48,11,1965,9,"female",389,28,20,86,17,86,9,0,8
1981848,19,7,1994,7,"male",655,26,16,2,0,2,0,0,0
1981850,31,10,1982,3,"female",375,76,31,474,113,474,93,0,20
1981856,73,24,1940,6,"female",822,30,17,55,9,0,7,55,2
1981859,33,9,1980,8,"female",107,8,3,2,0,0,0,2,0
1981867,18,1,1995,3,"male",340,45,41,3,0,3,0,0,0
1981900,17,12,1996,1,"male",178,61,41,0,0,0,0,0,0
1981921,27,22,1986,11,"female",1686,319,192,340,520,340,509,0,11
1981932,25,2,1988,4,"male",47,27,13,5,7,1,5,4,2
1981968,25,2,1988,6,"male",407,42,23,0,0,0,0,0,0
1981990,17,24,1996,8,"female",278,535,51,183,22,183,11,0,11
1981996,25,22,1988,1,"male",94,39,38,11,10,11,8,0,2
1982017,66,5,1947,4,"female",1797,610,410,1077,1205,877,707,200,498
1982061,17,17,1996,10,"male",250,38,16,2,0,0,0,2,0
1982087,67,28,1946,3,"female",1191,115,98,672,255,672,180,0,75
1982148,21,25,1992,11,"male",525,382,319,375,53,375,47,0,6
1982163,17,16,1996,5,"male",373,111,108,16,34,16,29,0,5
1982166,32,23,1981,2,"male",453,10,5,24,26,22,24,2,2
1982193,24,26,1989,9,"female",697,242,80,32,243,12,101,20,142
1982223,20,11,1993,4,"female",334,140,38,309,239,309,158,0,81
1982233,66,1,1947,4,"male",636,5,2,1,0,1,0,0,0
1982245,33,19,1980,2,"male",253,81,54,147,84,139,77,8,7
1982261,39,15,1974,9,"male",63,30,10,3,72,3,15,0,57
1982268,18,25,1995,6,"female",218,488,370,223,143,223,104,0,39
1982282,28,20,1985,7,"male",404,223,131,4,14,4,9,0,5
1982292,33,18,1980,2,"male",376,5,4,1,0,1,0,0,0
1982299,113,23,1900,2,"male",1242,148,44,6,0,2,0,4,0
1982311,24,19,1989,2,"female",197,21,14,23,12,0,1,23,11
1982322,60,20,1953,2,"male",1630,70,9,0,9,0,1,0,8
1982327,19,20,1994,3,"male",331,291,121,32,14,31,12,1,2
1982338,64,11,1949,7,"female",214,24,8,2,3,0,0,2,3
1982340,23,3,1990,5,"female",194,70,42,0,0,0,0,0,0
1982347,24,13,1989,6,"male",332,280,224,2,1,1,0,1,1
1982383,13,11,2000,4,"male",222,36,20,0,0,0,0,0,0
1982397,21,2,1992,7,"male",148,21,15,1,0,1,0,0,0
1982423,103,21,1910,9,"male",539,1080,890,609,174,609,157,0,17
1982431,26,1,1987,4,"male",246,72,62,0,5,0,0,0,5
1982448,20,13,1993,12,"female",560,750,328,280,496,280,408,0,88
1982461,63,2,1950,11,"female",1621,135,71,25,10,0,3,25,7
1982463,66,19,1947,3,"female",1322,219,49,588,144,20,75,568,69
1982464,17,28,1996,3,"male",1003,472,175,248,237,92,69,156,168
1982487,19,11,1994,3,"male",538,736,425,442,688,302,383,140,305
1982488,54,19,1959,4,"male",1793,37,2,0,0,0,0,0,0
1982513,64,26,1949,1,"female",884,47,30,0,2,0,2,0,0
1982522,62,12,1951,9,"female",634,219,160,497,109,496,60,1,49
1982523,17,3,1996,12,"female",254,425,120,0,10,0,7,0,3
1982525,22,1,1991,1,"male",106,27,15,0,0,0,0,0,0
1982575,55,16,1958,6,"male",365,201,114,277,103,277,98,0,5
1982578,108,13,1905,9,"male",132,25,23,53,25,1,6,52,19
1982591,20,28,1993,7,"female",540,432,229,99,183,68,79,31,104
1982667,26,17,1987,6,"male",905,359,258,5,23,5,21,0,2
1982681,68,21,1945,8,"male",446,116,81,0,9,0,1,0,8
1982703,19,5,1994,5,"male",315,199,129,290,195,278,155,12,40
1982704,37,7,1976,10,"male",565,36,32,18,3,17,3,1,0
1982727,38,10,1975,10,"female",425,19,8,1,10,1,10,0,0
1982735,14,1,1999,5,"male",134,162,64,112,49,101,25,11,24
1982739,80,29,1933,10,"male",396,559,466,138,177,25,104,113,73
1982755,18,8,1995,8,"female",408,716,501,59,30,58,28,1,2
1982770,23,29,1990,1,"male",128,7,6,0,0,0,0,0,0
1982789,27,12,1986,6,"male",182,5,3,0,0,0,0,0,0
1982803,18,3,1995,11,"female",13,45,41,187,259,180,103,7,156
1982846,87,3,1926,10,"male",164,297,135,111,137,0,18,111,119
1982854,63,19,1950,4,"male",740,15,11,3,1,3,0,0,1
1982860,46,4,1967,8,"male",334,73,54,8,1,0,0,8,1
1982878,19,19,1994,5,"female",98,180,127,1565,623,1553,373,12,250
1982899,52,27,1961,2,"female",647,132,95,2,4,2,2,0,2
1982906,53,22,1960,7,"female",532,67,49,67,70,65,47,2,23
1982966,17,24,1996,8,"male",591,1578,932,349,1083,312,405,37,678
1982995,26,25,1987,12,"male",457,55,43,28,6,28,6,0,0
1983006,25,9,1988,9,"male",421,106,62,28,9,28,7,0,2
1983014,68,4,1945,6,"male",216,193,125,97,46,97,19,0,27
1983035,19,17,1994,1,"female",441,1,1,0,0,0,0,0,0
1983037,20,13,1993,1,"female",718,97,71,3,2,3,1,0,1
1983045,40,4,1973,5,"female",636,4,4,0,0,0,0,0,0
1983062,44,10,1969,6,"female",415,104,81,86,15,86,12,0,3
1983077,20,26,1993,9,"male",485,338,182,313,34,313,28,0,6
1983194,26,7,1987,1,"female",1023,186,127,210,183,86,93,124,90
1983199,27,9,1986,11,"male",765,33,4,0,0,0,0,0,0
1983207,19,10,1994,6,"female",345,114,63,13,2,13,2,0,0
1983219,26,2,1987,10,"female",711,695,283,90,154,90,145,0,9
1983229,44,6,1969,1,"female",69,5,3,0,0,0,0,0,0
1983240,59,25,1954,5,"male",466,87,75,29,4,0,0,29,4
1983246,24,17,1989,5,"male",202,78,63,10,1,10,0,0,1
1983277,45,9,1968,7,"male",614,5,0,0,0,0,0,0,0
1983290,90,29,1923,10,"male",1412,335,160,364,543,354,388,10,155
1983295,18,29,1995,10,"male",3,35,35,8,1,3,1,5,0
1983301,29,4,1984,12,"male",454,237,99,2,141,2,44,0,97
1983310,51,20,1962,10,"male",599,8,5,5,1,0,0,5,1
1983315,23,5,1990,5,"male",259,141,139,6,3,4,3,2,0
1983322,14,6,1999,12,"male",605,56,26,18,7,7,3,11,4
1983372,52,20,1961,8,"female",18,29,26,14,24,0,16,14,8
1983388,21,6,1992,12,"male",266,119,63,0,0,0,0,0,0
1983413,28,2,1985,5,"female",320,130,98,14,30,0,1,14,29
1983446,56,8,1957,10,"female",110,36,23,98,27,0,0,98,27
1983459,51,8,1962,9,"female",737,213,40,266,129,52,69,214,60
1983460,18,12,1995,4,"male",272,525,186,103,27,93,18,10,9
1983517,67,12,1946,12,"female",313,75,70,0,1,0,1,0,0
1983520,78,6,1935,3,"female",10,25,22,6,31,6,29,0,2
1983524,36,7,1977,1,"female",187,81,28,116,55,116,45,0,10
1983547,29,22,1984,6,"male",395,96,82,17,2,17,1,0,1
1983559,23,7,1990,3,"female",361,239,120,488,107,358,55,130,52
1983561,23,20,1990,12,"female",447,237,200,17,165,17,135,0,30
1983566,59,23,1954,2,"female",413,27,18,36,12,0,3,36,9
1983587,24,4,1989,12,"female",395,4,4,0,0,0,0,0,0
1983596,27,14,1986,12,"male",1399,200,98,21,44,16,30,5,14
1983612,17,18,1996,6,"male",83,5,2,17,7,0,2,17,5
1983697,41,10,1972,5,"male",323,7,2,0,0,0,0,0,0
1983709,21,16,1992,7,"male",850,197,119,95,74,10,27,85,47
1983718,19,26,1994,8,"female",298,143,92,1,4,1,1,0,3
1983725,17,22,1996,2,"male",607,359,331,4,201,4,175,0,26
1983728,30,21,1983,8,"female",1448,307,92,153,279,153,160,0,119
1983752,26,25,1987,9,"male",418,113,90,0,4,0,4,0,0
1983753,61,12,1952,12,"female",1335,16,9,15,15,15,10,0,5
1983756,21,23,1992,12,"male",157,59,52,13,6,6,1,7,5
1983763,25,24,1988,7,"female",318,212,169,160,257,159,73,1,184
1983780,46,20,1967,3,"male",378,175,130,6,1,6,0,0,1
1983789,35,15,1978,10,"male",877,21,16,24,51,21,38,3,13
1983799,73,21,1940,6,"female",214,32,31,2,16,0,7,2,9
1983802,34,16,1979,2,"female",423,80,48,29,22,29,9,0,13
1983825,52,7,1961,5,"female",893,127,72,3,28,0,1,3,27
1983843,46,8,1967,3,"female",572,59,8,4,19,4,19,0,0
1983873,31,22,1982,4,"female",119,164,86,474,606,1,151,473,455
1983920,20,18,1993,4,"female",850,2387,566,874,2374,283,1101,591,1273
1983940,26,28,1987,4,"male",187,91,81,1,0,1,0,0,0
1983951,41,1,1972,1,"female",716,11,3,0,0,0,0,0,0
1983953,23,14,1990,3,"female",735,135,106,11,50,3,20,8,30
1983980,27,4,1986,1,"male",174,123,33,259,51,259,34,0,17
1983981,51,1,1962,2,"female",780,161,58,320,26,0,15,320,11
1983984,33,5,1980,6,"male",403,1,1,3,1,0,0,3,1
1983985,25,3,1988,12,"male",224,22,20,0,0,0,0,0,0
1984008,67,28,1946,7,"male",1341,72,39,193,30,110,13,83,17
1984053,17,1,1996,5,"male",92,242,143,93,84,93,59,0,25
1984054,67,23,1946,2,"female",1228,13,5,20,4,20,4,0,0
1984059,62,25,1951,1,"female",214,67,62,0,0,0,0,0,0
1984060,71,12,1942,10,"male",350,97,84,17,3,0,1,17,2
1984068,39,28,1974,7,"female",321,767,365,3191,1250,3134,652,57,598
1984075,58,8,1955,9,"male",910,249,128,184,111,184,76,0,35
1984089,53,1,1960,10,"male",1109,91,52,1,4,1,0,0,4
1984125,26,1,1987,1,"female",151,17,17,1,2,1,1,0,1
1984160,22,18,1991,6,"male",821,46,33,0,0,0,0,0,0
1984194,29,15,1984,8,"male",272,1,1,0,0,0,0,0,0
1984209,54,14,1959,9,"male",1800,9,5,0,0,0,0,0,0
1984235,34,5,1979,3,"male",368,30,20,1,0,0,0,1,0
1984245,67,24,1946,11,"female",1416,657,201,29,21,29,18,0,3
1984249,63,1,1950,1,"male",1590,105,66,0,2,0,0,0,2
1984251,23,20,1990,10,"male",307,26,26,0,0,0,0,0,0
1984275,18,19,1995,9,"female",463,288,121,39,2,39,2,0,0
1984343,25,26,1988,6,"male",102,49,47,2,4,2,4,0,0
1984347,23,19,1990,5,"male",228,133,96,0,0,0,0,0,0
1984355,65,5,1948,3,"female",1901,101,30,5,22,0,0,5,22
1984360,25,1,1988,1,"male",195,1,1,1,0,1,0,0,0
1984364,65,22,1948,5,"male",373,40,31,121,24,121,12,0,12
1984388,24,12,1989,4,"male",242,147,82,0,1,0,1,0,0
1984395,54,26,1959,2,"female",675,58,30,2,1,2,1,0,0
1984406,49,14,1964,9,"female",1433,291,182,3,13,3,7,0,6
1984411,27,29,1986,3,"male",301,51,24,10,7,10,7,0,0
1984414,21,28,1992,12,"male",796,377,139,18,1,0,0,18,1
1984419,24,5,1989,4,"female",381,43,34,15,15,15,7,0,8
1984440,25,18,1988,8,"female",778,200,113,5,9,5,6,0,3
1984449,41,23,1972,12,"male",276,19,15,4,0,4,0,0,0
1984464,60,13,1953,2,"female",595,91,70,0,1,0,1,0,0
1984481,103,10,1910,10,"female",1144,1086,475,130,178,96,154,34,24
1984516,27,23,1986,3,"male",270,5,1,0,0,0,0,0,0
1984530,17,3,1996,11,"female",356,116,54,8,34,8,21,0,13
1984551,45,4,1968,1,"male",380,42,27,92,52,19,5,73,47
1984555,28,12,1985,2,"male",6,11,1,0,4,0,3,0,1
1984582,25,10,1988,6,"female",290,111,50,21,87,0,5,21,82
1984584,21,22,1992,9,"female",46,339,315,2917,1804,2823,1586,94,218
1984613,30,4,1983,1,"male",368,5,3,0,0,0,0,0,0
1984645,26,14,1987,1,"male",92,1,1,0,0,0,0,0,0
1984646,108,27,1905,11,"male",1179,1778,764,0,0,0,0,0,0
1984687,26,17,1987,8,"male",481,180,148,208,346,208,308,0,38
1984696,28,22,1985,7,"female",331,160,93,12,3,0,2,12,1
1984698,61,12,1952,1,"male",531,16,2,1,0,0,0,1,0
1984713,18,7,1995,7,"male",16,17,10,15,4,15,4,0,0
1984732,22,7,1991,4,"female",455,50,43,15,22,14,18,1,4
1984739,58,27,1955,4,"female",620,63,32,145,195,13,147,132,48
1984797,61,7,1952,4,"female",385,216,78,1002,583,83,279,919,304
1984839,53,12,1960,2,"male",435,361,248,1651,95,1651,71,0,24
1984852,41,12,1972,11,"male",846,19,14,2,9,2,7,0,2
1984860,20,16,1993,1,"male",221,75,40,300,107,300,31,0,76
1984871,20,26,1993,7,"female",286,26,12,68,19,49,12,19,7
1984872,101,30,1912,3,"male",1441,703,416,197,25,1,11,196,14
1984897,48,7,1965,5,"female",1371,86,38,391,132,200,78,191,54
1984901,43,24,1970,6,"female",231,83,45,175,449,45,155,130,294
1984923,45,25,1968,12,"male",417,85,74,360,37,0,6,360,31
1984969,20,22,1993,1,"male",448,116,68,2,0,2,0,0,0
1984978,21,8,1992,9,"male",361,201,147,5,0,0,0,5,0
1984998,18,12,1995,9,"male",387,168,130,0,0,0,0,0,0
1985010,33,14,1980,8,"female",53,0,0,11,3,11,3,0,0
1985021,94,22,1919,5,"male",828,343,186,24,6,24,6,0,0
1985032,17,4,1996,12,"female",176,34,20,2,0,2,0,0,0
1985033,25,1,1988,1,"male",272,75,42,59,59,47,25,12,34
1985042,17,9,1996,5,"female",205,957,226,73,66,72,37,1,29
1985044,18,11,1995,1,"male",817,1520,764,64,2,63,0,1,2
1985045,62,8,1951,12,"female",350,44,37,284,76,284,62,0,14
1985093,35,2,1978,5,"female",536,70,58,0,0,0,0,0,0
1985104,15,7,1998,11,"female",106,225,143,27,18,27,10,0,8
1985106,102,1,1911,1,"female",1718,25,9,0,0,0,0,0,0
1985133,46,18,1967,6,"female",974,77,33,110,92,79,52,31,40
1985144,21,25,1992,9,"female",14,3,3,1,2,1,1,0,1
1985162,70,21,1943,4,"female",374,77,49,86,197,0,14,86,183
1985167,39,16,1974,6,"male",291,57,55,0,10,0,1,0,9
1985170,101,1,1912,1,"male",1829,771,440,370,409,44,181,326,228
1985175,34,12,1979,12,"male",446,3,0,0,0,0,0,0,0
1985184,49,28,1964,6,"female",1275,352,144,155,233,2,106,153,127
1985241,108,8,1905,5,"female",1558,194,100,1976,984,386,212,1590,772
1985311,96,6,1917,1,"female",905,196,43,48,34,48,33,0,1
1985320,23,1,1990,1,"female",137,497,339,1648,478,1367,269,281,209
1985334,23,27,1990,11,"female",565,141,94,0,0,0,0,0,0
1985335,56,5,1957,1,"male",339,83,62,88,36,40,30,48,6
1985366,46,14,1967,6,"female",183,19,13,7,0,6,0,1,0
1985385,22,23,1991,11,"male",288,53,39,81,60,81,37,0,23
1985400,55,27,1958,5,"male",375,19,12,3,4,1,3,2,1
1985427,23,15,1990,4,"female",322,3,2,3,3,3,3,0,0
1985475,103,1,1910,1,"male",1495,124,51,5,24,0,11,5,13
1985516,59,3,1954,11,"male",377,41,16,95,174,95,133,0,41
1985563,30,29,1983,8,"female",272,85,41,19,40,19,30,0,10
1985566,62,12,1951,12,"female",820,213,120,796,110,0,35,796,75
1985586,32,15,1981,3,"male",393,166,81,329,583,329,408,0,175
1985589,110,10,1903,7,"female",1512,64,29,4,1,3,1,1,0
1985613,24,19,1989,12,"male",802,110,55,37,2,37,1,0,1
1985628,43,4,1970,5,"male",552,1,0,0,0,0,0,0,0
1985647,19,18,1994,2,"male",182,71,48,0,2,0,2,0,0
1985667,66,10,1947,3,"female",138,67,38,92,27,92,25,0,2
1985673,14,16,1999,6,"male",444,73,53,0,2,0,0,0,2
1985676,80,1,1933,4,"male",431,0,0,6,4,0,2,6,2
1985688,49,19,1964,11,"male",260,50,50,15,9,12,4,3,5
1985700,108,12,1905,9,"female",2130,130,37,0,0,0,0,0,0
1985714,60,3,1953,2,"female",80,159,51,303,206,0,21,303,185
1985772,23,26,1990,2,"male",1614,436,290,67,99,50,67,17,32
1985791,33,19,1980,7,"female",340,89,28,29,9,29,9,0,0
1985798,18,9,1995,8,"male",79,298,207,274,3,252,3,22,0
1985812,29,4,1984,7,"male",31,65,49,346,262,346,172,0,90
1985823,56,4,1957,2,"male",330,27,25,2,0,2,0,0,0
1985838,57,10,1956,7,"male",354,19,13,0,0,0,0,0,0
1985848,15,4,1998,9,"male",245,107,62,9,0,9,0,0,0
1985856,14,1,1999,1,"male",312,219,192,12,13,12,13,0,0
1985857,19,1,1994,1,"male",196,90,68,58,179,55,108,3,71
1985862,62,30,1951,7,"female",145,72,54,451,270,347,226,104,44
1985871,25,1,1988,1,"male",331,188,150,491,68,491,58,0,10
1985880,66,16,1947,5,"male",2333,112,65,69,68,36,46,33,22
1985891,22,6,1991,1,"female",299,26,24,2,0,1,0,1,0
1985900,23,4,1990,11,"male",210,62,35,3,3,0,0,3,3
1985956,40,10,1973,9,"female",540,123,74,0,0,0,0,0,0
1985999,24,22,1989,7,"male",136,0,0,0,0,0,0,0,0
1986074,103,12,1910,3,"male",852,825,529,93,144,93,117,0,27
1986090,66,27,1947,12,"female",1892,143,73,3,12,3,9,0,3
1986156,22,1,1991,1,"male",586,78,50,0,20,0,19,0,1
1986163,99,3,1914,3,"male",1883,223,65,80,189,3,48,77,141
1986171,106,21,1907,1,"male",1805,145,55,76,90,74,32,2,58
1986209,21,30,1992,8,"male",1182,8,0,0,3,0,1,0,2
1986213,20,28,1993,12,"female",345,238,95,0,2,0,2,0,0
1986360,17,24,1996,6,"female",197,599,529,602,1125,602,925,0,200
1986362,32,28,1981,12,"female",148,36,19,44,24,44,15,0,9
1986369,59,3,1954,9,"female",36,16,13,71,56,71,55,0,1
1986388,21,20,1992,11,"male",256,53,18,90,51,90,35,0,16
1986397,17,6,1996,1,"male",1076,166,74,0,48,0,37,0,11
1986426,54,31,1959,5,"male",278,33,21,0,0,0,0,0,0
1986439,14,7,1999,7,"female",168,44,21,1237,393,1127,137,110,256
1986440,18,19,1995,12,"male",492,241,126,23,0,23,0,0,0
1986469,21,23,1992,12,"male",397,525,494,1,2,1,1,0,1
1986491,24,26,1989,2,"female",437,109,58,8,43,7,14,1,29
1986492,17,13,1996,1,"female",35,224,193,1506,1003,282,135,1224,868
1986500,15,24,1998,8,"female",446,204,146,153,81,144,21,9,60
1986506,20,15,1993,11,"male",174,149,83,0,1,0,1,0,0
1986508,43,16,1970,1,"female",563,187,177,0,4,0,4,0,0
1986526,19,1,1994,1,"male",470,36,33,2,1,2,1,0,0
1986529,24,29,1989,4,"male",203,210,152,123,6,123,6,0,0
1986533,62,2,1951,11,"female",980,134,87,62,86,0,11,62,75
1986553,19,24,1994,6,"male",95,14,11,2,1,2,1,0,0
1986555,63,20,1950,6,"male",1147,47,28,17,17,0,10,17,7
1986556,23,4,1990,10,"female",222,64,12,10,12,10,11,0,1
1986561,23,22,1990,5,"male",431,184,140,14,1,14,0,0,1
1986580,108,6,1905,12,"male",1648,419,242,72,47,31,15,41,32
1986589,28,31,1985,12,"male",660,26,23,2,7,0,6,2,1
1986609,18,13,1995,5,"male",586,199,138,0,1,0,1,0,0
1986611,24,28,1989,5,"female",328,56,48,10,68,10,52,0,16
1986629,23,13,1990,2,"female",519,162,136,20,117,20,60,0,57
1986631,44,27,1969,10,"female",346,24,12,136,63,136,59,0,4
1986650,19,19,1994,2,"male",553,35,16,622,40,558,7,64,33
1986711,68,2,1945,7,"female",777,595,345,297,444,297,373,0,71
1986713,35,9,1978,4,"male",149,57,28,0,12,0,3,0,9
1986729,23,4,1990,3,"male",183,58,49,0,0,0,0,0,0
1986739,20,25,1993,6,"female",115,75,56,2306,1584,1746,1139,560,445
1986747,26,16,1987,8,"male",577,87,41,2,77,1,23,1,54
1986751,59,26,1954,11,"female",20,32,30,25,40,25,30,0,10
1986772,39,22,1974,2,"female",172,50,40,23,130,23,130,0,0
1986808,65,11,1948,8,"female",1289,18,8,9,0,7,0,2,0
1986810,22,21,1991,2,"female",281,15,6,11,5,0,1,11,4
1986833,17,19,1996,9,"male",229,116,96,2,17,2,10,0,7
1986862,19,30,1994,4,"male",486,697,523,263,139,263,99,0,40
1986883,20,17,1993,11,"female",357,224,107,0,11,0,11,0,0
1986891,17,10,1996,1,"male",218,233,129,2,0,2,0,0,0
1986895,16,18,1997,3,"male",278,1178,1079,41,16,32,11,9,5
1986913,23,17,1990,2,"female",236,2,2,0,1,0,1,0,0
1986916,50,16,1963,10,"male",912,210,106,26,41,26,21,0,20
1986919,38,17,1975,9,"male",387,27,11,1,8,1,4,0,4
1986927,25,1,1988,1,"male",171,45,34,0,0,0,0,0,0
1986944,29,25,1984,5,"male",427,116,66,19,13,19,12,0,1
1986961,19,7,1994,7,"male",396,225,138,0,3,0,3,0,0
1986982,71,27,1942,7,"female",9,44,24,0,0,0,0,0,0
1986995,55,15,1958,5,"female",971,39,26,24,46,24,9,0,37
1987075,18,7,1995,5,"female",241,1497,809,117,280,63,108,54,172
1987089,49,24,1964,8,"female",290,48,39,34,57,14,8,20,49
1987093,31,3,1982,3,"male",427,475,333,174,24,174,15,0,9
1987094,31,4,1982,9,"female",246,293,280,140,195,135,110,5,85
1987131,43,7,1970,7,"male",487,86,32,3,0,3,0,0,0
1987137,66,11,1947,7,"male",993,79,56,21,0,10,0,11,0
1987183,58,30,1955,1,"female",1660,132,14,7,4,0,1,7,3
1987207,20,13,1993,5,"male",439,3,2,10,1,8,1,2,0
1987209,29,26,1984,12,"female",556,13,4,0,0,0,0,0,0
1987217,23,8,1990,11,"male",173,4304,166,9,49,0,42,9,7
1987222,29,11,1984,6,"male",584,163,99,0,8,0,5,0,3
1987236,24,19,1989,12,"male",793,1587,1197,347,953,196,481,151,472
1987242,91,1,1922,1,"female",1062,23,14,3,11,2,9,1,2
1987247,18,14,1995,9,"male",654,974,640,233,87,59,63,174,24
1987248,23,1,1990,2,"male",89,2,1,17,0,13,0,4,0
1987256,29,28,1984,12,"male",364,197,30,1,77,0,22,1,55
1987274,21,8,1992,10,"male",817,1451,1195,144,93,127,73,17,20
1987277,16,26,1997,12,"female",335,159,89,52,15,51,6,1,9
1987282,18,17,1995,3,"male",336,54,26,219,354,14,62,205,292
1987289,24,3,1989,7,"female",31,1,1,53,19,51,19,2,0
1987349,29,29,1984,3,"female",722,743,473,129,505,46,434,83,71
1987379,28,17,1985,7,"male",235,79,43,0,0,0,0,0,0
1987392,23,15,1990,7,"female",1535,391,202,204,207,187,143,17,64
1987399,45,12,1968,1,"female",1137,53,26,13,104,13,95,0,9
1987404,25,1,1988,1,"female",279,27,18,55,10,55,7,0,3
1987408,21,9,1992,6,"male",327,174,80,83,8,80,5,3,3
1987417,72,28,1941,10,"male",1977,170,6,0,1,0,0,0,1
1987439,23,19,1990,2,"male",567,81,69,0,27,0,27,0,0
1987440,20,10,1993,10,"male",914,2434,711,184,1022,86,878,98,144
1987455,26,29,1987,1,"male",520,45,24,0,2,0,0,0,2
1987466,23,1,1990,7,"male",672,52,39,1,0,1,0,0,0
1987467,34,25,1979,3,"male",221,41,9,1,2,1,0,0,2
1987482,28,5,1985,2,"male",683,9,4,2,1,2,1,0,0
1987493,20,30,1993,9,"female",360,409,254,1,5,1,4,0,1
1987494,58,10,1955,5,"male",307,43,25,122,36,3,22,119,14
1987507,61,22,1952,5,"female",1755,44,23,20,37,0,21,20,16
1987511,66,19,1947,6,"male",1459,144,126,183,243,182,81,1,162
1987520,14,13,1999,5,"female",275,567,312,422,208,373,146,49,62
1987528,55,24,1958,8,"female",1746,253,139,244,424,56,176,188,248
1987533,20,10,1993,10,"female",103,40,25,1,9,1,4,0,5
1987534,39,14,1974,12,"female",998,526,157,1790,4135,449,1504,1341,2631
1987537,18,25,1995,7,"female",315,292,203,359,177,359,164,0,13
1987553,18,17,1995,6,"male",425,2,1,0,0,0,0,0,0
1987554,60,17,1953,4,"female",529,40,24,333,53,333,42,0,11
1987557,48,5,1965,1,"male",713,115,92,16,21,16,15,0,6
1987572,17,3,1996,3,"male",310,79,45,0,1,0,1,0,0
1987578,67,13,1946,11,"female",1718,126,24,81,114,81,106,0,8
1987582,28,11,1985,9,"male",39,112,92,0,1,0,0,0,1
1987622,45,28,1968,2,"female",1838,24,14,20,8,12,1,8,7
1987643,82,1,1931,1,"male",807,507,268,0,0,0,0,0,0
1987650,42,2,1971,11,"male",65,56,47,108,10,107,9,1,1
1987658,16,4,1997,9,"male",305,122,5,1,0,1,0,0,0
1987673,29,18,1984,4,"female",1182,225,142,497,583,497,477,0,106
1987701,19,22,1994,1,"male",217,82,58,0,0,0,0,0,0
1987719,26,13,1987,1,"male",303,30,25,1,10,1,10,0,0
1987750,52,13,1961,8,"male",609,6,2,0,4,0,4,0,0
1987783,24,12,1989,5,"male",498,3,3,0,0,0,0,0,0
1987799,25,1,1988,1,"female",179,40,30,15,8,15,6,0,2
1987817,42,26,1971,12,"male",615,3,3,0,0,0,0,0,0
1987856,81,15,1932,6,"male",57,29,16,1,1,1,1,0,0
1987884,28,1,1985,1,"male",211,6,3,0,0,0,0,0,0
1987887,53,14,1960,9,"female",1808,92,36,1,13,1,12,0,1
1987935,38,13,1975,1,"male",268,107,66,1,0,1,0,0,0
1987949,31,25,1982,5,"male",264,18,8,0,0,0,0,0,0
1987965,55,9,1958,12,"male",735,62,27,24,3,24,1,0,2
1987991,19,15,1994,6,"female",195,612,402,669,432,192,156,477,276
1987993,37,3,1976,6,"female",433,33,20,0,2,0,1,0,1
1988043,25,21,1988,8,"male",60,230,219,4,0,4,0,0,0
1988047,37,1,1976,8,"female",510,61,54,51,29,51,25,0,4
1988106,15,17,1998,6,"male",87,105,79,181,150,85,39,96,111
1988113,16,6,1997,2,"female",533,495,161,1081,453,1081,436,0,17
1988152,44,1,1969,1,"male",258,187,82,391,206,391,152,0,54
1988173,41,9,1972,4,"male",684,21,2,0,0,0,0,0,0
1988198,19,20,1994,5,"male",484,38,32,0,0,0,0,0,0
1988201,26,25,1987,3,"male",46,11,9,0,0,0,0,0,0
1988208,18,19,1995,8,"male",124,42,31,24,6,22,6,2,0
1988246,27,14,1986,9,"male",362,10,5,0,0,0,0,0,0
1988258,19,3,1994,1,"male",507,490,399,1,0,0,0,1,0
1988305,14,5,1999,7,"male",120,47,34,1,0,1,0,0,0
1988314,57,27,1956,4,"female",107,52,39,4910,390,4910,93,0,297
1988318,39,4,1974,1,"female",968,250,121,69,129,60,91,9,38
1988331,23,2,1990,10,"male",624,166,72,82,0,67,0,15,0
1988337,19,21,1994,6,"female",1349,615,262,1265,842,1017,563,248,279
1988339,21,2,1992,2,"male",192,1,1,1,0,0,0,1,0
1988376,54,24,1959,2,"female",1824,25,13,0,7,0,6,0,1
1988377,18,3,1995,11,"male",454,832,633,4,4,4,4,0,0
1988424,15,17,1998,3,"male",259,57,32,0,0,0,0,0,0
1988438,26,11,1987,9,"male",109,51,16,8,9,8,6,0,3
1988477,38,30,1975,1,"male",340,67,38,14,21,14,19,0,2
1988490,17,13,1996,3,"male",454,31,17,0,1,0,1,0,0
1988518,29,14,1984,11,"female",307,79,53,7,6,7,6,0,0
1988557,60,24,1953,7,"female",2066,83,58,229,22,227,18,2,4
1988596,52,27,1961,9,"female",804,89,60,88,69,77,35,11,34
1988685,20,13,1993,6,"male",464,596,468,115,71,115,68,0,3
1988689,19,31,1994,7,"female",1413,4482,305,71,1575,22,1169,49,406
1988691,103,4,1910,3,"female",1510,183,59,339,164,339,62,0,102
1988719,22,9,1991,4,"male",310,189,143,64,9,48,6,16,3
1988722,75,14,1938,5,"female",798,48,32,0,0,0,0,0,0
1988732,21,21,1992,1,"female",413,90,45,41,91,41,67,0,24
1988756,49,28,1964,5,"male",440,236,110,61,15,3,6,58,9
1988809,30,22,1983,9,"male",254,32,28,1,8,1,3,0,5
1988833,25,15,1988,5,"male",280,50,45,164,2,0,1,164,1
1988838,53,26,1960,10,"female",564,303,241,260,471,88,180,172,291
1988846,15,21,1998,2,"male",283,80,27,0,0,0,0,0,0
1988856,50,26,1963,12,"male",91,2,1,1,2,1,2,0,0
1988863,27,2,1986,3,"female",380,2,1,0,0,0,0,0,0
1988875,20,9,1993,1,"male",731,138,93,1,0,1,0,0,0
1988960,48,7,1965,4,"male",1273,27,6,2,4,0,3,2,1
1988963,22,27,1991,12,"male",138,34,28,6,2,6,1,0,1
1988968,61,31,1952,12,"male",222,101,57,22,73,0,32,22,41
1988988,59,23,1954,2,"female",127,96,82,88,22,88,14,0,8
1989046,52,30,1961,4,"male",263,71,43,95,72,83,43,12,29
1989050,33,1,1980,3,"female",768,2,2,0,0,0,0,0,0
1989055,16,8,1997,1,"male",725,50,38,0,1,0,0,0,1
1989075,18,23,1995,10,"female",168,921,662,69,154,4,92,65,62
1989106,40,2,1973,4,"female",96,7,1,0,0,0,0,0,0
1989118,18,11,1995,2,"female",304,219,123,263,121,8,37,255,84
1989145,16,10,1997,8,"male",798,9,7,0,0,0,0,0,0
1989210,20,1,1993,1,"male",254,44,25,0,0,0,0,0,0
1989235,21,7,1992,1,"female",47,556,285,311,204,57,121,254,83
1989244,51,4,1962,10,"female",135,79,45,81,16,81,4,0,12
1989264,24,27,1989,2,"female",162,4,3,0,0,0,0,0,0
1989268,22,22,1991,9,"male",85,79,64,1,1,1,1,0,0
1989285,40,28,1973,5,"male",1037,61,42,0,18,0,13,0,5
1989286,16,21,1997,12,"male",632,130,50,5,0,5,0,0,0
1989290,17,10,1996,5,"male",209,86,72,2,2,2,2,0,0
1989301,18,8,1995,8,"male",293,298,204,921,284,504,153,417,131
1989328,101,18,1912,11,"female",1829,550,253,970,155,970,105,0,50
1989331,77,1,1936,4,"male",124,128,97,142,106,69,49,73,57
1989332,25,1,1988,1,"male",11,15,12,1,1,1,1,0,0
1989369,52,19,1961,2,"female",734,459,273,2096,866,1781,656,315,210
1989428,26,1,1987,1,"male",365,5,2,27,1,27,0,0,1
1989445,46,20,1967,1,"male",405,76,41,2066,674,2066,587,0,87
1989448,108,16,1905,9,"male",1358,209,85,16,20,16,20,0,0
1989462,27,31,1986,8,"male",98,57,50,130,58,29,46,101,12
1989465,18,8,1995,8,"female",330,203,141,0,0,0,0,0,0
1989472,48,4,1965,8,"female",329,23,19,94,183,1,140,93,43
1989519,28,29,1985,10,"female",832,1314,482,5958,5595,5958,4978,0,617
1989554,15,19,1998,1,"male",262,117,49,0,0,0,0,0,0
1989624,19,27,1994,12,"male",60,156,155,3,0,3,0,0,0
1989641,27,5,1986,6,"female",382,75,15,1,0,0,0,1,0
1989651,25,26,1988,6,"female",465,73,48,421,157,421,137,0,20
1989673,20,6,1993,5,"male",295,26,18,6,16,6,10,0,6
1989680,51,11,1962,5,"female",519,77,45,87,78,0,52,87,26
1989689,24,10,1989,1,"male",249,3,3,1,0,1,0,0,0
1989715,21,22,1992,7,"male",218,333,259,661,214,661,159,0,55
1989717,58,24,1955,1,"female",1629,111,58,34,11,2,6,32,5
1989726,22,13,1991,9,"female",201,456,231,521,617,254,300,267,317
1989730,59,22,1954,2,"female",610,59,30,65,89,65,40,0,49
1989744,48,16,1965,6,"male",456,201,104,0,23,0,13,0,10
1989746,30,1,1983,1,"male",830,448,201,7,11,7,8,0,3
1989786,29,17,1984,2,"female",1404,145,81,119,109,118,80,1,29
1989808,22,23,1991,10,"female",487,266,49,101,262,95,178,6,84
1989833,35,31,1978,7,"male",95,5,4,2,3,2,2,0,1
1989843,21,13,1992,8,"male",123,47,17,0,0,0,0,0,0
1989856,44,5,1969,2,"male",602,168,116,95,139,94,107,1,32
1989864,98,29,1915,7,"male",51,52,40,14,2,14,2,0,0
1989867,73,23,1940,4,"female",1708,46,12,5,17,0,6,5,11
1989877,20,13,1993,5,"male",430,2,1,310,19,0,0,310,19
1989899,29,3,1984,3,"female",408,142,75,172,111,45,53,127,58
1989911,77,27,1936,7,"male",1211,361,271,339,222,0,93,339,129
1989914,37,8,1976,8,"female",851,181,109,1102,1054,174,353,928,701
1989950,42,27,1971,10,"male",516,49,32,1,0,1,0,0,0
1989986,17,25,1996,3,"female",335,598,248,1918,1061,1819,296,99,765
1989988,25,1,1988,1,"male",79,13,11,0,0,0,0,0,0
1990018,20,14,1993,11,"male",338,2,1,1,0,1,0,0,0
1990031,25,4,1988,6,"male",148,66,54,0,0,0,0,0,0
1990039,59,25,1954,5,"female",726,7,3,33,29,0,0,33,29
1990050,15,1,1998,10,"male",194,558,335,30,116,30,56,0,60
1990056,18,5,1995,10,"female",135,385,332,52,0,26,0,26,0
1990060,18,23,1995,8,"female",422,584,265,615,775,575,667,40,108
1990064,21,22,1992,12,"male",532,91,78,8,3,0,0,8,3
1990093,15,21,1998,6,"female",566,430,262,111,9,111,0,0,9
1990119,31,27,1982,8,"male",354,59,47,11,106,10,18,1,88
1990149,18,18,1995,4,"male",437,50,25,0,1,0,1,0,0
1990150,33,8,1980,10,"male",450,11,10,7,4,7,4,0,0
1990160,70,28,1943,5,"female",1882,19,9,2,17,2,10,0,7
1990162,52,10,1961,9,"female",636,72,60,19,1,0,0,19,1
1990195,18,28,1995,1,"female",337,1065,699,1402,459,25,74,1377,385
1990217,46,25,1967,1,"female",1960,158,96,437,172,435,105,2,67
1990218,15,24,1998,5,"female",170,136,69,5,7,5,7,0,0
1990225,50,16,1963,1,"male",133,36,28,14,84,13,41,1,43
1990228,27,26,1986,8,"male",640,18,15,1,0,0,0,1,0
1990257,42,24,1971,12,"female",404,108,37,46,21,46,15,0,6
1990317,56,30,1957,12,"female",1752,317,177,794,365,304,270,490,95
1990345,30,28,1983,5,"female",974,51,12,0,1,0,0,0,1
1990381,18,4,1995,3,"male",378,131,100,37,16,37,14,0,2
1990397,50,11,1963,10,"male",515,2,1,0,1,0,1,0,0
1990423,105,1,1908,10,"male",1234,460,389,21,43,1,28,20,15
1990430,99,18,1914,6,"male",542,452,376,0,8,0,5,0,3
1990466,19,23,1994,8,"male",237,156,109,154,85,14,21,140,64
1990485,57,29,1956,12,"female",909,11,7,69,36,0,1,69,35
1990507,59,6,1954,10,"female",465,60,24,3,22,3,8,0,14
1990512,17,14,1996,5,"male",589,90,61,0,1,0,1,0,0
1990520,22,15,1991,10,"male",599,256,99,3,47,3,38,0,9
1990525,23,19,1990,11,"female",361,346,209,478,1310,478,1123,0,187
1990541,30,12,1983,4,"female",298,107,43,3,15,3,10,0,5
1990594,18,13,1995,9,"male",98,43,31,1,0,1,0,0,0
1990606,54,17,1959,1,"male",283,0,0,0,0,0,0,0,0
1990611,20,26,1993,10,"male",166,161,34,0,1,0,1,0,0
1990622,48,23,1965,8,"female",1701,112,64,705,265,705,78,0,187
1990639,30,8,1983,11,"male",146,31,13,4,11,4,4,0,7
1990654,22,2,1991,10,"female",186,71,48,5,25,5,23,0,2
1990663,16,9,1997,6,"male",717,208,123,191,148,42,26,149,122
1990666,23,31,1990,10,"male",172,283,224,9,5,9,5,0,0
1990674,22,6,1991,6,"male",197,248,192,0,0,0,0,0,0
1990678,29,21,1984,11,"male",428,71,61,287,109,287,95,0,14
1990698,16,6,1997,3,"female",197,663,353,302,878,288,378,14,500
1990710,18,11,1995,1,"male",97,289,243,3,1,0,0,3,1
1990721,22,12,1991,9,"male",969,448,284,0,5,0,1,0,4
1990750,64,1,1949,9,"female",488,25,24,3,5,0,0,3,5
1990784,21,3,1992,10,"male",462,775,544,95,246,4,113,91,133
1990799,21,12,1992,7,"female",620,41,6,6,0,0,0,6,0
1990820,16,16,1997,11,"female",653,695,518,152,151,125,144,27,7
1990865,19,31,1994,7,"male",65,46,30,0,0,0,0,0,0
1990873,17,21,1996,10,"male",350,122,97,12,1,1,0,11,1
1990876,71,10,1942,3,"male",1817,11,6,1,37,0,2,1,35
1990877,35,30,1978,3,"male",260,106,83,1,1,1,1,0,0
1990880,15,12,1998,10,"male",335,195,146,4,24,4,22,0,2
1990884,58,7,1955,3,"male",408,37,30,125,1,115,1,10,0
1990911,49,8,1964,7,"male",780,21,16,0,0,0,0,0,0
1990932,17,10,1996,9,"male",1163,374,271,0,0,0,0,0,0
1990944,84,12,1929,10,"female",943,25,13,14,52,1,26,13,26
1990967,14,4,1999,5,"male",228,154,103,3,1,0,0,3,1
1990985,107,22,1906,5,"male",1146,275,219,6,79,5,73,1,6
1990992,49,15,1964,7,"male",1500,103,56,0,0,0,0,0,0
1991013,28,26,1985,8,"male",221,92,80,0,0,0,0,0,0
1991036,26,20,1987,5,"male",151,43,39,150,8,26,6,124,2
1991043,17,12,1996,12,"male",24,13,11,1,0,1,0,0,0
1991046,48,19,1965,9,"male",627,164,124,1,1,1,1,0,0
1991069,17,5,1996,2,"male",339,286,270,0,7,0,6,0,1
1991078,103,1,1910,1,"female",616,277,133,69,33,69,29,0,4
1991084,56,17,1957,12,"female",977,147,82,889,931,889,203,0,728
1991094,77,21,1936,12,"female",827,62,21,98,21,2,1,96,20
1991096,73,4,1940,6,"male",414,29,26,0,0,0,0,0,0
1991112,19,14,1994,12,"male",465,104,77,32,8,32,7,0,1
1991128,34,8,1979,6,"female",417,17,10,0,0,0,0,0,0
1991135,43,19,1970,11,"male",788,218,155,33,45,33,32,0,13
1991137,103,26,1910,6,"male",947,171,124,0,4,0,0,0,4
1991140,23,29,1990,9,"male",281,0,0,0,0,0,0,0,0
1991142,45,8,1968,11,"female",476,73,40,0,0,0,0,0,0
1991164,25,15,1988,1,"male",260,58,50,25,22,25,16,0,6
1991199,29,14,1984,6,"female",136,2,2,0,0,0,0,0,0
1991212,20,1,1993,1,"male",342,81,44,3,1,2,1,1,0
1991223,25,2,1988,1,"male",146,6,1,0,0,0,0,0,0
1991240,29,4,1984,5,"male",603,70,42,0,2,0,1,0,1
1991242,50,24,1963,1,"male",929,1,1,3,3,3,3,0,0
1991273,48,1,1965,2,"female",310,12,8,0,1,0,1,0,0
1991308,93,1,1920,1,"female",1703,35,18,13,34,0,17,13,17
1991325,19,14,1994,9,"male",669,1044,949,0,6,0,4,0,2
1991380,23,10,1990,1,"female",418,328,192,3,2,0,2,3,0
1991385,24,14,1989,7,"male",156,38,30,0,0,0,0,0,0
1991402,68,20,1945,6,"male",712,231,140,124,147,124,91,0,56
1991405,22,27,1991,1,"male",37,44,29,0,0,0,0,0,0
1991435,17,13,1996,12,"female",904,795,322,1,10,1,9,0,1
1991488,17,20,1996,7,"male",219,38,35,2,0,0,0,2,0
1991505,44,14,1969,6,"male",414,114,86,2,1,2,0,0,1
1991529,18,14,1995,7,"female",414,476,355,5,99,5,63,0,36
1991530,68,12,1945,12,"male",301,0,0,0,0,0,0,0,0
1991534,17,21,1996,12,"female",443,277,202,76,49,76,49,0,0
1991546,25,2,1988,4,"female",524,101,56,170,202,167,59,3,143
1991549,27,26,1986,1,"male",732,118,53,23,1,16,1,7,0
1991555,29,7,1984,9,"male",1039,98,51,0,1,0,1,0,0
1991556,19,11,1994,9,"male",432,166,54,17,14,17,14,0,0
1991560,18,1,1995,1,"male",430,256,170,0,1,0,0,0,1
1991564,26,23,1987,10,"female",107,229,181,603,381,164,195,439,186
1991581,33,1,1980,1,"male",163,13,11,3,2,3,2,0,0
1991592,14,5,1999,9,"male",331,93,55,31,5,16,2,15,3
1991605,63,6,1950,12,"female",410,39,27,60,25,0,11,60,14
1991606,24,1,1989,5,"male",766,68,21,40,107,0,7,40,100
1991610,18,13,1995,11,"female",110,214,93,241,544,241,345,0,199
1991613,32,5,1981,12,"male",635,76,14,0,11,0,7,0,4
1991635,19,12,1994,10,"female",280,1524,985,13,132,3,82,10,50
1991637,24,30,1989,8,"female",403,101,59,7,4,0,0,7,4
1991646,16,13,1997,11,"male",676,1038,783,217,570,169,358,48,212
1991653,54,5,1959,7,"female",305,34,23,259,142,259,80,0,62
1991686,25,24,1988,10,"female",408,99,43,81,180,81,130,0,50
1991701,31,17,1982,9,"male",484,28,10,0,0,0,0,0,0
1991725,57,2,1956,3,"female",179,1,1,2,0,0,0,2,0
1991738,59,9,1954,10,"female",1497,87,48,61,70,61,57,0,13
1991754,23,1,1990,1,"male",472,1,1,0,0,0,0,0,0
1991779,34,8,1979,10,"female",290,45,31,2,0,2,0,0,0
1991784,20,15,1993,1,"female",712,3131,935,11142,37450,887,14806,10255,22644
1991845,38,21,1975,9,"male",42,63,31,9,43,5,23,4,20
1991878,14,1,1999,3,"male",121,27,21,3,1,0,0,3,1
1991908,46,1,1967,2,"female",216,29,26,128,14,128,14,0,0
1991933,23,22,1990,6,"female",888,559,378,829,1066,516,545,313,521
1991942,53,1,1960,1,"male",1214,7,6,2,0,2,0,0,0
1991944,14,27,1999,7,"male",204,206,174,74,21,70,15,4,6
1991988,69,14,1944,10,"female",1214,220,141,128,54,1,32,127,22
1992007,22,25,1991,12,"female",399,77,44,29,32,29,28,0,4
1992025,51,11,1962,12,"male",675,31,10,14,1,3,1,11,0
1992038,13,11,2000,5,"male",129,91,85,2,0,0,0,2,0
1992040,26,23,1987,6,"male",195,18,5,0,0,0,0,0,0
1992057,64,12,1949,7,"female",558,61,8,64,4,0,2,64,2
1992070,20,6,1993,5,"male",223,191,113,0,0,0,0,0,0
1992075,24,13,1989,7,"female",118,644,526,1599,1635,524,748,1075,887
1992084,16,27,1997,7,"male",125,212,208,1,4,1,3,0,1
1992085,19,19,1994,8,"male",407,449,252,5,1,0,0,5,1
1992132,44,21,1969,5,"male",1989,107,32,0,1,0,1,0,0
1992164,36,19,1977,11,"male",619,12,11,0,4,0,4,0,0
1992187,25,1,1988,1,"male",138,127,121,0,0,0,0,0,0
1992210,24,19,1989,11,"male",627,171,51,126,244,126,231,0,13
1992218,49,2,1964,9,"male",885,73,35,105,63,104,46,1,17
1992223,63,1,1950,1,"female",359,43,33,11,7,11,4,0,3
1992236,17,16,1996,4,"male",323,198,121,335,248,2,55,333,193
1992241,33,1,1980,1,"male",487,596,537,79,35,79,29,0,6
1992250,15,5,1998,3,"male",280,1,0,0,0,0,0,0,0
1992272,64,13,1949,7,"female",1870,77,45,13,0,13,0,0,0
1992313,49,6,1964,4,"male",171,36,25,5,4,5,4,0,0
1992314,25,14,1988,11,"female",553,145,44,206,153,206,152,0,1
1992329,51,2,1962,9,"female",533,76,44,46,35,34,17,12,18
1992346,24,26,1989,9,"male",21,51,41,21,6,18,6,3,0
1992396,63,16,1950,2,"male",1241,40,30,0,0,0,0,0,0
1992417,18,3,1995,10,"male",741,1865,1370,0,44,0,34,0,10
1992425,14,27,1999,7,"female",60,8,4,0,0,0,0,0,0
1992431,34,7,1979,3,"male",343,174,70,0,0,0,0,0,0
1992445,68,5,1945,8,"male",1544,72,39,142,5,0,1,142,4
1992450,29,15,1984,1,"male",320,27,22,0,0,0,0,0,0
1992473,72,4,1941,3,"female",357,56,34,5,19,5,9,0,10
1992483,52,30,1961,10,"female",531,191,129,0,16,0,11,0,5
1992494,32,23,1981,11,"male",137,22,17,0,1,0,1,0,0
1992513,15,24,1998,5,"female",377,305,229,9,6,0,2,9,4
1992518,49,30,1964,11,"male",439,21,21,4,0,3,0,1,0
1992531,17,31,1996,5,"female",286,251,50,55,25,17,5,38,20
1992563,24,7,1989,3,"male",495,182,124,21,13,21,7,0,6
1992599,49,1,1964,9,"female",185,83,51,0,20,0,16,0,4
1992635,34,14,1979,10,"female",407,154,100,303,57,1,29,302,28
1992640,30,11,1983,5,"male",447,216,142,13,5,13,3,0,2
1992653,19,13,1994,3,"female",101,62,24,9,3,3,2,6,1
1992697,16,28,1997,6,"female",520,380,216,576,577,471,225,105,352
1992715,61,1,1952,10,"female",2,18,17,82,33,82,19,0,14
1992719,69,6,1944,7,"male",912,45,24,0,2,0,1,0,1
1992733,19,9,1994,8,"female",153,128,120,234,109,214,55,20,54
1992736,26,2,1987,1,"female",137,81,18,0,1,0,1,0,0
1992740,19,1,1994,1,"male",216,97,85,0,16,0,9,0,7
1992781,26,1,1987,1,"male",500,2,2,0,0,0,0,0,0
1992793,48,1,1965,8,"male",289,119,85,137,223,110,92,27,131
1992796,22,25,1991,6,"male",459,1,1,0,0,0,0,0,0
1992823,23,11,1990,2,"male",748,73,47,0,3,0,3,0,0
1992828,70,23,1943,4,"female",484,18,6,0,0,0,0,0,0
1992837,20,11,1993,3,"female",142,162,78,51,48,51,42,0,6
1992854,21,10,1992,5,"male",338,470,431,0,25,0,19,0,6
1992924,43,25,1970,4,"male",461,87,68,107,129,107,97,0,32
1992951,22,4,1991,9,"female",519,139,55,1,6,1,1,0,5
1992978,28,28,1985,4,"male",488,43,40,4,4,4,4,0,0
1992997,67,1,1946,1,"male",357,186,159,48,140,7,61,41,79
1993020,28,1,1985,1,"male",606,196,163,13,2,13,1,0,1
1993042,29,15,1984,1,"male",676,201,111,25,21,11,15,14,6
1993065,23,12,1990,3,"male",355,256,71,0,3,0,0,0,3
1993119,17,22,1996,9,"female",391,297,173,33,13,33,11,0,2
1993131,32,23,1981,4,"female",1757,153,96,332,407,327,254,5,153
1993138,53,10,1960,6,"female",1110,100,59,173,53,18,13,155,40
1993145,47,13,1966,10,"female",141,41,18,24,6,0,1,24,5
1993159,60,1,1953,5,"male",954,228,2,8,34,8,10,0,24
1993163,63,11,1950,11,"male",695,65,19,1,127,0,24,1,103
1993223,82,7,1931,11,"female",787,74,29,39,4,18,3,21,1
1993254,113,14,1900,6,"female",1520,156,75,150,225,29,130,121,95
1993267,18,4,1995,6,"male",740,145,42,2,0,1,0,1,0
1993268,23,4,1990,6,"male",792,328,240,0,17,0,16,0,1
1993280,68,27,1945,5,"female",305,1062,755,0,1,0,1,0,0
1993294,49,10,1964,4,"male",714,23,11,31,1,0,1,31,0
1993304,101,29,1912,4,"male",1896,49,20,0,0,0,0,0,0
1993348,31,2,1982,11,"female",291,25,15,0,0,0,0,0,0
1993354,16,25,1997,7,"male",65,10,9,0,0,0,0,0,0
1993359,105,10,1908,5,"male",557,179,161,13,5,2,3,11,2
1993373,20,29,1993,1,"male",57,1,1,0,1,0,1,0,0
1993375,23,9,1990,9,"male",344,0,0,0,0,0,0,0,0
1993407,43,22,1970,4,"female",216,169,51,3161,1626,3160,851,1,775
1993431,27,2,1986,11,"female",195,10,1,0,0,0,0,0,0
1993448,69,2,1944,6,"male",1417,41,19,216,47,55,8,161,39
1993457,38,27,1975,7,"male",304,2,2,22,3,0,1,22,2
1993481,14,25,1999,2,"female",322,193,113,2816,1262,1980,724,836,538
1993485,19,8,1994,7,"female",461,217,184,62,88,62,46,0,42
1993519,23,30,1990,1,"female",682,200,45,187,14,187,9,0,5
1993538,46,27,1967,3,"male",224,169,151,48,34,46,25,2,9
1993556,35,12,1978,2,"male",344,5,4,0,0,0,0,0,0
1993569,19,7,1994,10,"female",454,894,550,317,606,13,250,304,356
1993585,14,11,1999,11,"male",186,89,58,0,1,0,1,0,0
1993615,40,3,1973,8,"female",933,244,145,62,156,62,149,0,7
1993620,44,29,1969,11,"male",550,90,27,42,23,42,20,0,3
1993626,108,22,1905,6,"male",70,83,62,0,0,0,0,0,0
1993635,33,4,1980,7,"male",265,132,127,14,7,7,3,7,4
1993642,69,24,1944,10,"male",1828,130,118,8,71,8,20,0,51
1993684,43,25,1970,3,"male",563,21,11,0,0,0,0,0,0
1993685,27,30,1986,11,"male",454,20,16,0,0,0,0,0,0
1993687,63,4,1950,12,"female",1766,53,28,1205,77,1205,71,0,6
1993691,61,4,1952,7,"male",308,132,84,1,9,1,8,0,1
1993740,21,11,1992,2,"female",231,78,62,3,53,3,23,0,30
1993744,103,30,1910,5,"male",872,144,55,1,0,1,0,0,0
1993755,42,25,1971,12,"male",658,52,18,1,0,1,0,0,0
1993756,55,30,1958,9,"female",294,136,66,281,450,281,220,0,230
1993758,20,1,1993,1,"male",171,92,73,0,0,0,0,0,0
1993770,32,9,1981,9,"male",361,52,33,3,20,2,8,1,12
1993782,20,13,1993,3,"male",52,4,2,0,0,0,0,0,0
1993789,55,10,1958,8,"male",979,21,3,0,0,0,0,0,0
1993826,32,6,1981,4,"male",462,93,64,1,5,1,5,0,0
1993832,34,1,1979,2,"male",650,60,58,13,3,13,1,0,2
1993843,29,1,1984,1,"female",509,114,20,0,0,0,0,0,0
1993844,108,22,1905,2,"female",1486,133,33,3,13,3,13,0,0
1993857,41,6,1972,8,"male",1144,601,411,43,136,43,78,0,58
1993880,42,15,1971,8,"male",873,84,35,43,356,42,294,1,62
1993884,61,22,1952,6,"female",508,23,16,0,0,0,0,0,0
1993894,19,13,1994,5,"male",187,89,61,1,0,1,0,0,0
1993898,29,21,1984,6,"male",491,32,24,9,2,9,1,0,1
1993910,26,2,1987,10,"male",399,59,55,0,1,0,0,0,1
1993943,17,14,1996,2,"male",1010,80,50,8,7,3,4,5,3
1993959,21,4,1992,7,"female",1380,3095,333,168,495,137,382,31,113
1993963,27,28,1986,8,"male",273,3,3,0,0,0,0,0,0
1993991,68,20,1945,2,"male",845,13,9,9,1,8,1,1,0
1993998,59,20,1954,5,"female",744,183,100,0,0,0,0,0,0
1994030,69,7,1944,2,"male",1349,60,35,3,0,0,0,3,0
1994059,24,1,1989,1,"male",13,38,35,3,2,3,1,0,1
1994073,18,26,1995,5,"female",353,299,24,2,2,2,1,0,1
1994083,31,11,1982,1,"male",135,12,11,0,0,0,0,0,0
1994095,16,8,1997,10,"male",89,14,7,1,2,1,2,0,0
1994104,34,13,1979,5,"male",646,53,27,29,69,29,59,0,10
1994110,18,20,1995,10,"male",264,19,13,88,6,79,3,9,3
1994114,22,1,1991,9,"female",597,297,170,28,74,4,33,24,41
1994124,38,14,1975,9,"male",1016,29,27,175,44,175,34,0,10
1994132,53,9,1960,1,"male",319,14,11,0,0,0,0,0,0
1994153,24,19,1989,11,"male",424,10,9,0,0,0,0,0,0
1994167,21,31,1992,5,"female",855,157,58,13,1,2,0,11,1
1994175,53,29,1960,11,"female",1403,95,59,144,59,141,42,3,17
1994183,24,28,1989,8,"male",422,25,20,1,0,1,0,0,0
1994186,18,14,1995,3,"male",14,16,16,0,0,0,0,0,0
1994198,103,15,1910,7,"male",1011,877,673,35,5,35,3,0,2
1994201,17,4,1996,11,"male",54,2842,2276,3701,1908,482,392,3219,1516
1994211,55,26,1958,8,"male",263,243,68,6,6,6,2,0,4
1994223,30,13,1983,7,"male",625,477,357,64,50,62,25,2,25
1994227,91,28,1922,8,"female",288,70,36,41,16,41,14,0,2
1994245,18,15,1995,5,"female",380,68,49,613,72,601,38,12,34
1994250,22,22,1991,9,"female",5,7,4,114,14,36,6,78,8
1994283,18,17,1995,9,"female",83,268,250,2,12,2,10,0,2
1994304,76,16,1937,11,"female",746,26,16,97,12,0,5,97,7
1994309,108,3,1905,3,NA,2077,337,207,12,0,3,0,9,0
1994319,21,1,1992,7,"male",108,88,83,6,3,6,1,0,2
1994357,18,12,1995,9,"male",969,3494,2309,8210,13971,2399,7645,5811,6326
1994386,27,9,1986,10,"male",205,25,19,0,1,0,1,0,0
1994392,14,4,1999,5,"female",314,88,51,2,1,0,1,2,0
1994397,23,4,1990,2,"male",313,72,54,25,21,24,4,1,17
1994398,39,13,1974,11,"male",97,81,47,0,2,0,0,0,2
1994401,18,5,1995,5,"male",679,1253,899,1,35,1,20,0,15
1994410,33,30,1980,3,"male",186,1,1,1,0,1,0,0,0
1994411,41,3,1972,9,"male",373,236,113,46,13,35,8,11,5
1994428,16,8,1997,5,"male",473,1476,1321,1224,47,298,33,926,14
1994437,29,25,1984,12,"male",406,45,21,0,1,0,0,0,1
1994469,23,22,1990,7,"female",409,47,35,66,50,66,32,0,18
1994475,15,26,1998,11,"female",784,129,102,147,0,147,0,0,0
1994504,28,21,1985,2,"male",429,143,82,13,1,13,1,0,0
1994526,27,16,1986,2,"female",206,46,36,2,0,0,0,2,0
1994538,26,20,1987,4,"female",270,137,111,641,199,641,169,0,30
1994558,33,7,1980,5,"male",779,364,297,164,48,164,30,0,18
1994601,83,4,1930,11,"male",219,123,47,13,6,13,3,0,3
1994622,16,30,1997,11,"male",222,126,91,12,10,12,8,0,2
1994638,23,17,1990,10,"male",380,122,97,7,72,7,46,0,26
1994650,21,28,1992,10,"female",216,169,122,58,25,58,25,0,0
1994669,68,24,1945,5,"male",481,533,452,191,68,191,60,0,8
1994738,22,1,1991,7,"male",791,48,32,248,273,149,181,99,92
1994755,18,20,1995,1,"male",424,221,188,42,25,42,20,0,5
1994783,93,24,1920,5,"male",819,350,259,93,25,93,19,0,6
1994800,49,1,1964,7,"male",278,20,20,3,2,0,0,3,2
1994846,71,16,1942,12,"male",1467,12,3,0,0,0,0,0,0
1994880,20,15,1993,12,"male",495,446,325,18,14,18,9,0,5
1994883,23,19,1990,12,"male",657,28,21,1,0,0,0,1,0
1994885,31,8,1982,10,"female",249,84,62,50,67,14,36,36,31
1994904,108,30,1905,8,"male",1264,237,69,218,152,218,68,0,84
1994921,22,10,1991,8,"male",150,6,6,0,0,0,0,0,0
1994930,18,3,1995,3,"male",564,82,64,0,4,0,4,0,0
1994936,31,16,1982,4,"male",449,73,70,0,0,0,0,0,0
1994943,28,30,1985,6,"male",28,34,34,0,0,0,0,0,0
1994981,18,18,1995,8,"female",47,53,28,171,109,171,63,0,46
1995120,21,11,1992,7,"female",315,648,58,475,179,475,129,0,50
1995133,16,16,1997,3,"male",123,159,138,3,5,3,5,0,0
1995136,37,6,1976,7,"male",659,345,170,37,174,22,89,15,85
1995138,108,3,1905,1,"male",30,36,35,50,14,17,9,33,5
1995158,23,11,1990,4,"female",1369,685,285,1728,2170,1363,1579,365,591
1995184,44,27,1969,2,"male",391,83,61,0,0,0,0,0,0
1995186,25,21,1988,7,"male",69,46,25,6,9,6,2,0,7
1995195,25,6,1988,1,"male",632,135,83,0,0,0,0,0,0
1995248,49,13,1964,6,"male",167,68,40,2,0,0,0,2,0
1995249,27,26,1986,7,"female",677,321,204,188,192,87,56,101,136
1995260,20,14,1993,10,"male",367,154,147,6,2,2,2,4,0
1995275,60,24,1953,12,"female",1910,105,73,121,92,119,67,2,25
1995298,22,9,1991,7,"male",423,8,6,1,0,1,0,0,0
1995334,46,16,1967,10,"female",270,34,18,49,35,0,1,49,34
1995357,43,21,1970,10,"female",376,61,29,2,0,2,0,0,0
1995370,59,1,1954,4,"male",267,66,45,953,413,953,282,0,131
1995387,45,7,1968,11,"male",758,73,30,26,11,3,6,23,5
1995388,18,31,1995,8,"female",816,1534,601,3,187,3,157,0,30
1995399,35,30,1978,8,"male",533,177,88,1,1,0,1,1,0
1995416,18,16,1995,9,"male",91,97,57,9,1,6,1,3,0
1995439,20,17,1993,3,"male",432,27,22,57,11,57,11,0,0
1995445,24,22,1989,5,"female",582,309,72,1,2,1,2,0,0
1995478,16,5,1997,8,"male",187,107,50,14,1,0,1,14,0
1995482,45,29,1968,6,"male",90,149,115,215,129,215,121,0,8
1995506,14,21,1999,12,"male",218,46,21,4,5,4,5,0,0
1995536,16,19,1997,4,"male",282,331,201,435,227,332,130,103,97
1995545,22,9,1991,9,"male",197,62,45,0,1,0,0,0,1
1995558,18,13,1995,3,"male",23,61,22,43,116,43,55,0,61
1995593,15,21,1998,11,"female",925,564,355,410,341,215,99,195,242
1995612,108,9,1905,6,"female",861,97,37,2,24,2,24,0,0
1995615,31,27,1982,3,"female",397,179,35,0,9,0,4,0,5
1995633,23,25,1990,2,"male",38,1,1,3,7,3,4,0,3
1995636,23,5,1990,3,"male",440,11,8,0,0,0,0,0,0
1995653,28,2,1985,1,"male",1266,24,18,9,5,9,4,0,1
1995690,95,3,1918,5,"female",1854,152,70,132,92,131,70,1,22
1995749,36,17,1977,8,"female",1254,437,129,159,38,159,26,0,12
1995753,24,26,1989,10,"female",105,190,119,2472,2606,2004,1817,468,789
1995754,16,14,1997,6,"female",468,412,268,28,28,0,7,28,21
1995755,21,12,1992,11,"male",740,131,95,16,22,16,4,0,18
1995788,32,12,1981,11,"female",205,15,15,0,0,0,0,0,0
1995810,16,16,1997,11,"male",236,246,128,6,2,4,0,2,2
1995812,42,18,1971,4,"male",564,68,46,6,0,6,0,0,0
1995837,19,3,1994,11,"male",406,156,67,72,68,41,24,31,44
1995847,31,16,1982,10,"female",416,21,15,7,0,7,0,0,0
1995859,19,14,1994,10,"male",597,186,39,2,1,2,1,0,0
1995881,18,27,1995,3,"male",438,638,580,0,0,0,0,0,0
1995930,63,27,1950,7,"male",901,1713,1327,2652,1719,263,1124,2389,595
1995932,42,18,1971,8,"female",569,12,9,44,2,42,0,2,2
1995954,20,19,1993,1,"male",176,147,123,0,0,0,0,0,0
1995974,37,21,1976,5,"male",145,47,26,85,133,85,87,0,46
1995991,20,25,1993,3,"male",503,120,41,2,0,2,0,0,0
1995998,21,27,1992,4,"male",322,119,65,4,31,4,24,0,7
1996006,15,18,1998,4,"male",548,224,116,122,132,122,56,0,76
1996055,39,14,1974,10,"female",1190,261,50,188,184,184,103,4,81
1996093,15,17,1998,12,"male",266,123,112,42,34,42,22,0,12
1996101,25,16,1988,7,"female",788,274,190,477,292,122,61,355,231
1996123,73,29,1940,7,"female",97,69,43,2482,295,0,184,2482,111
1996151,52,7,1961,1,"male",296,29,19,8,5,8,5,0,0
1996158,44,12,1969,7,"male",463,1,1,0,1,0,1,0,0
1996166,46,25,1967,2,"female",670,151,94,399,229,295,71,104,158
1996167,46,3,1967,10,"female",242,36,25,117,18,75,10,42,8
1996170,26,2,1987,2,"female",347,96,13,35,92,35,87,0,5
1996176,21,22,1992,10,"male",990,439,259,5,26,2,13,3,13
1996178,59,9,1954,2,"female",411,15,8,3,3,3,3,0,0
1996194,14,10,1999,10,"female",4,0,0,0,0,0,0,0,0
1996201,24,5,1989,5,"female",24,38,31,23,27,23,14,0,13
1996227,28,8,1985,3,"male",547,99,83,4,2,4,2,0,0
1996244,70,18,1943,5,"female",1406,37,9,3,0,3,0,0,0
1996293,20,16,1993,12,"male",44,67,63,14,0,14,0,0,0
1996303,17,18,1996,2,"male",297,75,55,0,0,0,0,0,0
1996305,54,8,1959,1,"male",965,8,5,0,0,0,0,0,0
1996314,52,7,1961,12,"male",370,50,23,1,0,1,0,0,0
1996326,43,24,1970,9,"male",486,77,39,64,22,64,18,0,4
1996337,17,12,1996,1,"female",846,252,116,514,450,0,82,514,368
1996347,108,13,1905,9,"female",1688,382,181,28,39,28,30,0,9
1996358,28,5,1985,3,"male",2,8,6,0,0,0,0,0,0
1996376,15,14,1998,8,"male",10,14,9,2,1,2,1,0,0
1996396,18,4,1995,4,"female",393,213,56,41,69,41,60,0,9
1996420,38,26,1975,8,"female",627,261,137,5,12,5,2,0,10
1996424,65,14,1948,4,"male",1928,106,35,8,56,8,40,0,16
1996428,25,3,1988,10,"female",409,68,51,2,31,2,19,0,12
1996469,49,25,1964,5,"male",418,83,75,5,0,5,0,0,0
1996473,54,16,1959,8,"male",1167,54,11,37,14,0,8,37,6
1996481,15,10,1998,1,"female",217,90,22,363,18,363,18,0,0
1996496,31,31,1982,1,"male",252,54,31,17,17,17,8,0,9
1996519,63,19,1950,9,"female",415,11,7,12,10,0,7,12,3
1996534,17,29,1996,3,"female",1004,375,156,794,934,786,561,8,373
1996549,75,26,1938,5,"male",2188,791,587,122,80,122,51,0,29
1996554,19,31,1994,1,"male",416,165,81,1,32,1,5,0,27
1996572,21,13,1992,3,"male",169,97,84,0,2,0,1,0,1
1996576,23,7,1990,4,"female",55,494,198,756,747,315,384,441,363
1996601,16,3,1997,7,"female",396,482,171,77,172,75,78,2,94
1996635,49,23,1964,6,"female",736,262,185,8,32,8,22,0,10
1996640,17,27,1996,11,"female",844,432,203,493,796,278,451,215,345
1996642,23,9,1990,5,"female",1402,682,147,31,74,13,67,18,7
1996691,28,23,1985,8,"female",1157,335,173,491,1237,395,810,96,427
1996699,16,1,1997,1,"male",17,10,9,0,0,0,0,0,0
1996736,23,24,1990,1,"male",47,8,5,0,0,0,0,0,0
1996752,32,6,1981,1,"male",365,99,48,267,265,267,218,0,47
1996765,108,23,1905,9,"female",2008,138,58,18,4,15,4,3,0
1996777,51,20,1962,4,"male",818,73,46,142,29,0,1,142,28
1996778,19,28,1994,7,"female",234,8,5,96,275,0,31,96,244
1996820,36,5,1977,4,"male",711,7,3,6,0,6,0,0,0
1996839,27,15,1986,7,"male",534,48,44,1,2,1,1,0,1
1996844,19,13,1994,6,"female",950,183,109,1004,888,11,336,993,552
1996857,63,6,1950,9,"female",854,62,38,2,6,0,2,2,4
1996871,22,28,1991,6,"female",486,76,35,523,514,523,421,0,93
1996876,19,9,1994,10,"male",385,143,125,18,1,0,1,18,0
1996883,102,6,1911,12,"male",404,144,112,34,3,29,3,5,0
1996900,15,12,1998,4,"male",543,468,242,164,192,136,98,28,94
1996934,14,12,1999,3,"male",46,223,196,68,16,0,5,68,11
1996973,14,11,1999,8,"male",62,4,4,1,0,1,0,0,0
1996979,30,1,1983,4,"male",15,37,19,10,4,3,2,7,2
1997063,33,11,1980,6,"male",116,30,21,0,2,0,2,0,0
1997090,20,3,1993,6,"female",234,81,60,34,32,31,23,3,9
1997100,22,21,1991,8,"female",343,275,160,75,53,75,47,0,6
1997131,17,15,1996,10,"male",201,150,117,3,44,3,19,0,25
1997138,29,12,1984,10,"female",575,14,11,24,6,24,4,0,2
1997145,53,23,1960,8,"male",701,7,2,22,5,22,5,0,0
1997179,40,18,1973,11,"female",370,2,1,0,0,0,0,0,0
1997188,22,18,1991,1,"female",712,897,545,922,1133,479,801,443,332
1997202,63,3,1950,2,"male",308,176,119,1,3,0,0,1,3
1997205,35,1,1978,6,"male",644,16,7,0,0,0,0,0,0
1997250,64,16,1949,10,"female",20,48,33,0,0,0,0,0,0
1997253,50,5,1963,6,"female",356,59,45,10,30,10,14,0,16
1997265,15,15,1998,11,"female",15,8,8,0,0,0,0,0,0
1997272,67,24,1946,10,"female",1617,105,49,457,537,58,207,399,330
1997276,58,24,1955,9,"female",630,25,23,28,0,28,0,0,0
1997277,20,11,1993,7,"male",171,16,12,5,0,5,0,0,0
1997285,66,20,1947,5,"male",1264,81,57,19,10,19,4,0,6
1997287,18,14,1995,8,"female",373,296,205,104,719,60,461,44,258
1997288,33,21,1980,3,"female",300,18,16,484,108,479,15,5,93
1997307,23,6,1990,9,"female",1210,97,24,1115,2343,427,657,688,1686
1997315,98,2,1915,12,"female",119,31,10,52,16,52,14,0,2
1997360,27,5,1986,1,"female",415,0,0,0,0,0,0,0,0
1997361,26,1,1987,1,"female",492,27,25,11,1,11,1,0,0
1997376,31,23,1982,5,"female",1149,815,517,40,54,18,48,22,6
1997381,65,3,1948,2,"male",22,209,108,37,24,0,15,37,9
1997414,28,15,1985,4,"female",211,59,42,52,34,52,25,0,9
1997438,44,14,1969,12,"male",318,122,97,56,46,56,30,0,16
1997450,68,10,1945,8,"male",411,392,328,87,16,87,16,0,0
1997494,33,5,1980,7,"male",189,99,81,128,38,128,38,0,0
1997498,18,16,1995,12,"female",230,174,116,47,47,15,11,32,36
1997528,48,23,1965,5,"female",698,1,1,125,3,125,3,0,0
1997534,42,7,1971,6,"female",271,25,22,6,1,6,1,0,0
1997538,33,28,1980,9,"female",571,24,9,1,8,1,8,0,0
1997550,33,12,1980,7,"female",324,66,32,1775,356,1775,347,0,9
1997555,48,12,1965,1,"female",1349,194,54,159,302,121,112,38,190
1997561,24,16,1989,8,"male",66,219,101,138,192,138,175,0,17
1997599,56,13,1957,6,"female",908,47,23,1056,434,14,329,1042,105
1997601,39,24,1974,6,"male",419,707,505,46,279,17,217,29,62
1997609,23,9,1990,9,"male",663,115,33,0,0,0,0,0,0
1997634,26,3,1987,6,"female",798,343,183,42,31,42,23,0,8
1997661,62,4,1951,11,"female",408,41,17,58,13,10,7,48,6
1997669,20,25,1993,2,"female",415,79,66,6,1,4,1,2,0
1997681,14,11,1999,12,"male",301,714,486,80,6,0,1,80,5
1997688,15,24,1998,4,"male",178,74,65,1,1,1,0,0,1
1997696,64,26,1949,4,"male",327,7,1,0,0,0,0,0,0
1997723,29,24,1984,7,"male",781,137,84,1,14,1,9,0,5
1997741,33,27,1980,10,"male",350,29,18,2,2,1,2,1,0
1997749,35,17,1978,2,"male",106,1,1,3,0,3,0,0,0
1997781,108,31,1905,12,"male",1317,792,450,4,29,4,16,0,13
1997798,47,24,1966,6,"female",1996,287,113,48,294,48,201,0,93
1997805,62,30,1951,11,"female",229,85,78,516,217,0,71,516,146
1997808,25,22,1988,1,"male",471,1,1,0,0,0,0,0,0
1997818,26,8,1987,5,"male",368,4,3,190,127,190,51,0,76
1997827,39,10,1974,2,"male",76,64,50,2,4,2,3,0,1
1997872,28,5,1985,5,"male",239,199,159,1,0,1,0,0,0
1997903,21,7,1992,7,"female",327,297,243,10,59,2,32,8,27
1997945,64,24,1949,8,"female",1057,183,78,120,23,0,5,120,18
1997954,43,10,1970,3,"female",484,616,420,8,4,0,0,8,4
1997955,16,27,1997,7,"female",275,795,60,1,6,1,6,0,0
1997959,26,23,1987,11,"male",175,249,84,1,2,1,0,0,2
1997961,27,29,1986,6,"male",186,34,22,43,0,0,0,43,0
1997967,42,27,1971,2,"male",608,32,14,0,0,0,0,0,0
1997976,24,18,1989,5,"female",602,49,31,21,2,2,1,19,1
1998011,14,25,1999,5,"female",46,250,29,0,1,0,1,0,0
1998015,15,6,1998,5,"male",491,307,250,19,24,3,8,16,16
1998060,21,19,1992,10,"male",101,1,1,0,0,0,0,0,0
1998079,15,3,1998,5,"female",80,207,22,12,23,12,22,0,1
1998083,23,1,1990,4,"male",302,83,72,17,1,17,1,0,0
1998123,61,2,1952,11,"female",1684,111,58,1878,683,121,156,1757,527
1998137,39,11,1974,2,"female",35,123,117,490,469,70,160,420,309
1998169,25,4,1988,4,"female",212,37,21,11,15,11,14,0,1
1998199,22,12,1991,3,"male",629,38,17,0,18,0,7,0,11
1998210,35,18,1978,5,"female",617,102,60,0,8,0,8,0,0
1998221,19,29,1994,11,"female",1167,515,228,590,720,309,281,281,439
1998229,40,7,1973,8,"male",71,10,9,2,0,2,0,0,0
1998235,20,17,1993,11,"female",18,28,5,4,3,0,0,4,3
1998254,44,1,1969,2,"male",1591,171,84,54,35,47,23,7,12
1998272,20,1,1993,8,"male",902,223,111,6,17,6,15,0,2
1998277,57,17,1956,2,"female",70,14,12,2,1,2,0,0,1
1998288,51,3,1962,11,"male",353,783,619,35,1,0,0,35,1
1998336,28,8,1985,9,"male",175,22,17,24,1,24,1,0,0
1998339,23,23,1990,4,"male",392,15,11,0,0,0,0,0,0
1998342,14,7,1999,1,"male",112,74,63,4,4,1,0,3,4
1998353,66,3,1947,5,"male",316,1,0,0,0,0,0,0,0
1998404,26,22,1987,8,"female",319,109,46,24,10,24,9,0,1
1998428,15,13,1998,9,"female",110,127,85,77,65,77,54,0,11
1998437,20,3,1993,3,"male",366,51,27,15,8,15,8,0,0
1998477,20,10,1993,10,"male",272,135,50,76,25,76,19,0,6
1998486,51,22,1962,11,"male",101,42,30,40,1,40,1,0,0
1998492,32,30,1981,12,"female",1515,357,155,2444,1237,792,894,1652,343
1998550,21,24,1992,4,"male",556,6,2,0,2,0,2,0,0
1998554,68,25,1945,4,"male",295,196,176,104,18,104,10,0,8
1998561,28,1,1985,5,"male",455,57,53,0,3,0,3,0,0
1998573,23,25,1990,8,"female",415,294,146,10,23,10,18,0,5
1998587,33,12,1980,2,"male",242,137,88,3930,1340,3169,965,761,375
1998602,16,22,1997,3,"female",51,401,285,31,107,13,64,18,43
1998604,36,26,1977,3,"male",1067,1,1,0,0,0,0,0,0
1998616,18,18,1995,1,"male",624,123,69,0,0,0,0,0,0
1998639,20,8,1993,6,"male",173,106,96,0,0,0,0,0,0
1998640,17,6,1996,2,"female",433,41,9,1,1,1,0,0,1
1998672,23,26,1990,5,"male",281,0,0,0,0,0,0,0,0
1998673,23,20,1990,4,"female",309,8,5,194,266,50,26,144,240
1998688,27,6,1986,6,"female",372,91,66,0,1,0,0,0,1
1998699,16,3,1997,3,"female",152,527,353,229,485,208,174,21,311
1998715,57,13,1956,11,"female",790,170,145,3944,410,87,75,3857,335
1998729,16,19,1997,10,"male",797,946,749,61,251,59,168,2,83
1998733,50,11,1963,3,"female",222,92,35,88,23,88,23,0,0
1998754,23,1,1990,1,"female",129,14,14,1,0,1,0,0,0
1998757,28,18,1985,8,"male",196,220,182,5,3,2,0,3,3
1998787,20,6,1993,9,"male",573,736,394,6,34,6,22,0,12
1998817,23,12,1990,11,"male",678,238,168,121,249,101,57,20,192
1998872,74,11,1939,7,"female",667,81,44,0,0,0,0,0,0
1998876,59,10,1954,12,"male",131,8,7,0,2,0,2,0,0
1998877,28,14,1985,9,"male",76,92,80,168,308,164,219,4,89
1998888,57,14,1956,10,"male",1080,76,49,0,0,0,0,0,0
1998890,24,6,1989,6,"female",181,333,256,993,511,799,361,194,150
1998914,18,22,1995,4,"female",1288,808,353,4179,2318,3704,1184,475,1134
1998938,28,18,1985,6,"male",554,6,4,24,4,24,4,0,0
1998954,36,16,1977,3,"male",331,7,4,3,11,0,0,3,11
1998968,27,1,1986,1,"male",247,48,46,0,0,0,0,0,0
1998999,21,14,1992,2,"male",196,62,54,0,0,0,0,0,0
1999025,24,5,1989,3,"male",661,85,53,227,13,44,3,183,10
1999030,41,5,1972,12,"male",423,5,5,67,1,62,1,5,0
1999047,53,5,1960,12,"male",965,129,61,0,1,0,0,0,1
1999053,39,27,1974,3,"female",590,10,5,1,0,1,0,0,0
1999094,19,7,1994,2,"female",588,1862,605,298,1283,214,817,84,466
1999122,26,6,1987,8,"male",567,135,94,12,26,11,14,1,12
1999127,53,24,1960,8,"female",734,167,132,81,53,43,43,38,10
1999133,49,11,1964,4,"female",1960,98,56,317,67,317,53,0,14
1999146,45,22,1968,12,"male",469,100,69,39,14,0,14,39,0
1999155,42,5,1971,10,"male",18,17,10,1,3,1,0,0,3
1999162,15,26,1998,11,"female",27,54,15,43,7,43,2,0,5
1999163,52,22,1961,9,"male",203,42,36,43,3,26,3,17,0
1999189,68,30,1945,4,"female",1150,14,2,1,1,0,1,1,0
1999218,54,17,1959,4,"male",435,58,33,1572,753,296,343,1276,410
1999220,28,1,1985,1,"male",462,58,55,0,0,0,0,0,0
1999225,29,22,1984,11,"male",365,259,181,209,114,209,57,0,57
1999226,17,31,1996,10,"female",321,29,14,1,2,1,2,0,0
1999233,17,20,1996,5,"male",169,1,1,0,0,0,0,0,0
1999238,25,14,1988,9,"male",252,74,60,4,2,4,2,0,0
1999249,27,21,1986,6,"female",417,85,64,10,0,9,0,1,0
1999250,30,15,1983,3,"male",339,2,1,0,2,0,1,0,1
1999260,37,26,1976,7,"male",688,485,366,2705,12799,2250,7668,455,5131
1999264,57,24,1956,7,"female",1589,66,38,16,3,16,3,0,0
1999290,27,27,1986,8,"female",87,89,73,3,14,3,7,0,7
1999300,33,3,1980,8,"male",299,104,80,32,14,32,11,0,3
1999322,38,13,1975,5,"male",281,89,44,11,102,0,18,11,84
1999334,94,19,1919,3,"female",559,1747,969,26,109,26,97,0,12
1999377,21,22,1992,9,"male",258,132,95,7,7,4,2,3,5
1999397,69,19,1944,8,"male",220,15,13,0,2,0,1,0,1
1999405,36,25,1977,8,"male",561,186,145,0,0,0,0,0,0
1999407,26,12,1987,1,"female",252,7,6,30,39,29,7,1,32
1999409,21,5,1992,12,"male",396,425,332,5,27,5,9,0,18
1999452,61,8,1952,11,"female",1504,188,55,191,66,191,54,0,12
1999495,27,2,1986,5,"male",299,69,47,5,25,5,17,0,8
1999523,41,11,1972,8,"male",1982,50,19,6,3,0,2,6,1
1999533,33,26,1980,5,"female",516,320,206,1,12,0,5,1,7
1999553,66,13,1947,8,"female",621,344,164,34,2,34,1,0,1
1999565,19,6,1994,3,"male",637,161,51,49,0,49,0,0,0
1999578,62,16,1951,8,"male",660,173,139,8,142,8,84,0,58
1999579,53,25,1960,1,"male",1484,79,46,16,11,15,5,1,6
1999587,35,11,1978,1,"female",589,64,49,39,41,39,38,0,3
1999596,60,14,1953,7,"male",1019,1,0,0,0,0,0,0,0
1999630,25,29,1988,4,"female",861,197,121,3,23,3,18,0,5
1999637,20,3,1993,3,"male",344,56,43,14,12,14,12,0,0
1999668,49,12,1964,12,"female",138,49,19,12,33,11,26,1,7
1999670,51,8,1962,11,"female",761,79,46,156,26,155,17,1,9
1999689,51,24,1962,5,"male",315,18,13,21,12,21,8,0,4
1999712,64,23,1949,7,"female",1773,93,44,176,99,26,38,150,61
1999717,22,26,1991,4,"female",659,47,23,2,1,0,0,2,1
1999726,58,6,1955,11,"male",1802,62,8,5,0,0,0,5,0
1999738,20,11,1993,12,"female",370,1837,740,6916,9643,2296,6543,4620,3100
1999748,29,29,1984,2,"male",950,2,1,0,0,0,0,0,0
1999752,94,3,1919,9,"female",1793,464,238,247,203,239,94,8,109
1999756,32,10,1981,2,"male",207,94,64,0,3,0,1,0,2
1999765,17,10,1996,3,"male",111,593,538,238,245,210,190,28,55
1999780,75,17,1938,8,"female",123,21,9,1,0,1,0,0,0
1999852,16,1,1997,7,"male",698,232,116,1,0,1,0,0,0
1999883,23,25,1990,9,"male",256,190,102,16,18,2,2,14,16
1999922,17,28,1996,11,"male",586,155,127,7,1,7,1,0,0
1999925,42,22,1971,9,"male",525,87,40,5,2,5,1,0,1
1999979,23,14,1990,5,"male",86,83,75,0,1,0,1,0,0
1999995,15,22,1998,11,"female",576,990,84,2,5,2,5,0,0
2000006,16,18,1997,1,"male",439,265,184,1,0,1,0,0,0
2000017,26,18,1987,1,"male",42,13,13,0,4,0,3,0,1
2000040,18,9,1995,11,"male",555,437,223,79,126,79,120,0,6
2000049,37,17,1976,8,"male",161,50,37,1,2,1,2,0,0
2000068,19,13,1994,8,"male",897,49,32,7,1,6,1,1,0
2000099,22,6,1991,12,"female",1062,592,171,105,259,74,141,31,118
2000151,44,12,1969,9,"male",296,80,33,0,1,0,0,0,1
2000165,19,4,1994,10,"male",236,37,29,70,30,70,14,0,16
2000171,27,12,1986,5,"female",464,0,0,0,0,0,0,0,0
2000176,43,5,1970,5,"male",674,34,18,3,1,3,1,0,0
2000185,22,12,1991,5,"female",290,237,24,3,5,3,5,0,0
2000199,52,15,1961,11,"female",350,81,53,56,30,54,21,2,9
2000205,20,15,1993,11,"male",36,2,1,0,0,0,0,0,0
2000236,42,13,1971,6,"female",612,51,13,78,71,78,67,0,4
2000250,26,3,1987,12,"male",374,7,2,0,0,0,0,0,0
2000263,46,9,1967,9,"female",1767,476,334,592,1329,591,770,1,559
2000265,14,12,1999,12,"male",323,560,221,2,11,0,1,2,10
2000272,18,3,1995,5,"female",437,295,0,41,66,23,37,18,29
2000273,19,29,1994,12,"male",399,349,292,133,81,133,67,0,14
2000274,52,8,1961,1,"male",939,46,26,70,40,59,25,11,15
2000279,103,19,1910,5,"male",1181,236,145,0,24,0,11,0,13
2000301,33,24,1980,1,"male",247,45,27,0,0,0,0,0,0
2000308,19,12,1994,9,"female",345,46,19,18,0,18,0,0,0
2000322,14,8,1999,1,"male",124,6,5,0,0,0,0,0,0
2000324,68,31,1945,5,"female",1147,413,293,313,31,2,22,311,9
2000334,61,23,1952,12,"female",229,20,16,3,2,3,0,0,2
2000353,26,15,1987,10,"female",266,1,0,0,0,0,0,0,0
2000368,27,22,1986,12,"male",22,27,24,0,0,0,0,0,0
2000391,43,3,1970,8,"female",403,82,52,360,176,355,132,5,44
2000394,24,23,1989,1,"female",336,15,12,0,1,0,1,0,0
2000396,24,23,1989,11,"female",321,66,38,732,255,732,140,0,115
2000417,18,2,1995,4,"female",280,37,21,10,1,0,0,10,1
2000436,53,12,1960,9,"female",973,46,15,292,309,292,232,0,77
2000444,21,4,1992,7,"male",465,165,102,2,11,0,0,2,11
2000451,23,8,1990,12,"female",173,11,9,3,1,1,1,2,0
2000453,65,17,1948,3,"male",477,44,3,8,36,0,30,8,6
2000477,108,13,1905,11,"female",1367,258,123,598,165,92,62,506,103
2000516,78,18,1935,6,"female",1195,49,17,0,0,0,0,0,0
2000518,15,30,1998,7,"female",32,63,63,145,38,55,12,90,26
2000550,52,9,1961,2,"male",1825,49,36,59,107,39,64,20,43
2000570,26,4,1987,9,"male",770,105,70,0,0,0,0,0,0
2000572,49,27,1964,4,"female",654,74,34,53,56,53,46,0,10
2000575,15,30,1998,12,"female",420,811,453,3943,4443,3937,2250,6,2193
2000578,17,11,1996,5,"male",699,38,10,1,0,1,0,0,0
2000608,30,24,1983,7,"female",660,273,177,204,196,180,80,24,116
2000615,16,12,1997,5,"male",530,545,473,226,0,225,0,1,0
2000648,36,29,1977,12,"female",1142,54,33,203,211,203,201,0,10
2000657,36,3,1977,9,"female",971,6,3,208,4,208,4,0,0
2000675,63,30,1950,8,"female",1292,28,13,5,2,0,0,5,2
2000688,20,18,1993,12,"female",646,130,52,36,37,36,31,0,6
2000703,21,16,1992,8,"female",433,351,196,22,93,7,32,15,61
2000723,27,28,1986,1,"female",660,174,107,6,20,0,9,6,11
2000766,56,1,1957,12,"female",1015,57,29,167,216,167,142,0,74
2000776,17,18,1996,4,"female",916,1094,604,1358,967,1023,362,335,605
2000784,19,10,1994,10,"female",307,79,34,0,0,0,0,0,0
2000789,20,11,1993,5,"female",536,14,11,8,1,8,1,0,0
2000850,18,9,1995,8,"female",251,223,156,367,474,308,181,59,293
2000858,13,12,2000,1,"female",154,3,3,0,0,0,0,0,0
2000859,63,13,1950,1,"female",1326,193,71,3,10,3,8,0,2
2000866,62,16,1951,4,"male",1341,212,110,2,1,2,1,0,0
2000874,52,6,1961,4,"female",354,63,25,26,4,0,1,26,3
2000875,37,21,1976,4,"male",326,40,30,229,179,229,130,0,49
2000880,28,15,1985,12,"male",150,23,14,2,4,0,3,2,1
2000909,26,25,1987,6,"male",474,31,11,53,34,53,33,0,1
2000918,18,19,1995,1,"female",598,705,414,63,52,24,44,39,8
2000924,15,13,1998,5,"male",254,16,8,2,0,0,0,2,0
2000931,20,3,1993,6,"male",785,144,105,0,27,0,24,0,3
2000939,51,7,1962,11,"female",386,251,202,115,35,72,21,43,14
2000944,29,3,1984,4,"male",697,102,12,34,22,34,21,0,1
2000969,18,31,1995,1,"male",215,17,6,4,4,4,3,0,1
2001003,44,10,1969,11,"female",259,33,26,14,57,14,38,0,19
2001006,15,14,1998,8,"female",331,491,294,153,5,136,2,17,3
2001007,38,26,1975,10,"female",355,145,130,125,75,79,46,46,29
2001017,37,26,1976,3,"male",192,43,26,3,1,3,1,0,0
2001034,32,14,1981,3,"male",276,38,31,0,0,0,0,0,0
2001093,25,10,1988,12,"male",543,48,33,34,21,0,6,34,15
2001107,58,10,1955,2,"female",460,1,1,1,0,1,0,0,0
2001136,19,9,1994,2,"male",54,63,62,31,25,31,23,0,2
2001137,18,7,1995,7,"female",176,54,22,0,0,0,0,0,0
2001184,20,23,1993,7,"female",130,106,63,63,22,63,22,0,0
2001188,20,7,1993,7,"male",538,188,102,0,0,0,0,0,0
2001191,49,12,1964,12,"male",147,19,19,0,0,0,0,0,0
2001214,21,24,1992,4,"female",419,206,97,572,342,14,17,558,325
2001216,15,3,1998,4,"male",26,16,16,2,3,0,2,2,1
2001219,26,12,1987,6,"male",472,124,118,2,0,2,0,0,0
2001228,29,19,1984,10,"male",175,212,138,186,312,179,217,7,95
2001249,108,31,1905,3,"male",1031,727,473,57,118,57,97,0,21
2001284,33,30,1980,12,"male",825,26,25,3,1,3,1,0,0
2001313,28,1,1985,1,"male",116,40,31,27,15,27,15,0,0
2001347,23,24,1990,12,"female",207,50,26,24,11,15,10,9,1
2001367,15,6,1998,8,"male",765,68,35,31,0,31,0,0,0
2001395,22,17,1991,2,"male",382,39,9,1,18,0,9,1,9
2001397,32,26,1981,12,"female",9,0,0,0,0,0,0,0,0
2001431,34,28,1979,6,"male",460,432,388,252,0,252,0,0,0
2001432,50,9,1963,8,"male",691,98,69,1,0,1,0,0,0
2001446,29,22,1984,1,"male",82,39,27,5,164,5,106,0,58
2001464,20,27,1993,2,"male",534,27,15,0,0,0,0,0,0
2001466,113,1,1900,1,"male",1286,621,413,424,72,424,53,0,19
2001472,24,11,1989,9,"male",30,8,8,0,0,0,0,0,0
2001473,21,22,1992,8,"male",73,328,258,567,174,550,101,17,73
2001480,20,4,1993,1,"male",975,1034,585,845,559,425,250,420,309
2001502,33,9,1980,5,"female",905,1027,375,1231,2490,1202,1361,29,1129
2001507,43,10,1970,12,"female",1174,123,89,946,464,946,373,0,91
2001526,70,19,1943,10,"female",923,37,24,1358,10,1358,9,0,1
2001529,17,10,1996,9,"female",135,105,56,160,410,150,88,10,322
2001590,17,3,1996,11,"male",206,700,579,27,12,27,2,0,10
2001604,54,8,1959,8,"female",176,47,22,1957,41,1957,29,0,12
2001647,32,30,1981,5,"male",231,29,22,4,55,4,48,0,7
2001673,27,15,1986,2,"male",242,5,3,7,0,7,0,0,0
2001681,19,6,1994,4,"male",291,163,99,358,301,110,157,248,144
2001688,24,12,1989,3,"male",747,18,9,0,9,0,3,0,6
2001719,43,11,1970,10,"male",887,65,32,2,3,2,1,0,2
2001725,41,22,1972,9,"female",538,104,96,191,52,183,21,8,31
2001809,42,2,1971,11,"female",784,218,88,61,44,61,28,0,16
2001831,70,15,1943,6,"male",785,2664,1468,1621,3067,589,1854,1032,1213
2001834,33,1,1980,7,"male",86,4,4,0,0,0,0,0,0
2001866,26,29,1987,5,"male",895,297,200,0,5,0,2,0,3
2001867,17,3,1996,3,"female",478,1821,428,8,983,8,795,0,188
2001900,61,30,1952,4,"male",977,22,3,1,1,1,1,0,0
2001904,55,25,1958,12,"male",448,14,13,7,0,7,0,0,0
2001909,61,7,1952,3,"male",176,143,122,118,48,0,11,118,37
2001922,32,5,1981,3,"male",213,43,27,0,0,0,0,0,0
2001926,21,7,1992,3,"male",247,46,18,0,0,0,0,0,0
2001931,19,14,1994,7,"female",215,136,86,7,2,0,1,7,1
2001941,33,29,1980,9,"male",408,15,8,18,4,18,4,0,0
2001945,33,26,1980,12,"male",672,80,36,66,31,60,12,6,19
2001952,18,3,1995,5,"male",141,82,63,0,2,0,0,0,2
2001966,25,25,1988,12,"male",279,163,100,267,74,267,36,0,38
2001980,36,24,1977,5,"male",556,112,31,367,524,367,494,0,30
2002007,24,24,1989,1,"female",191,103,78,418,688,418,549,0,139
2002048,72,7,1941,9,"male",1724,48,19,0,0,0,0,0,0
2002054,23,14,1990,2,"female",428,260,164,0,0,0,0,0,0
2002073,16,3,1997,11,"male",328,176,118,0,0,0,0,0,0
2002092,26,1,1987,1,"male",375,44,22,0,4,0,4,0,0
2002114,22,4,1991,1,"male",558,5,0,0,0,0,0,0,0
2002143,17,28,1996,5,"male",428,312,18,53,61,53,40,0,21
2002146,46,28,1967,9,"female",1421,0,0,0,0,0,0,0,0
2002153,17,25,1996,10,"male",274,127,117,33,4,33,4,0,0
2002166,26,29,1987,10,"male",348,15,8,0,0,0,0,0,0
2002236,79,21,1934,7,"female",8,1,1,1,4,0,0,1,4
2002249,29,5,1984,12,"male",426,335,304,1,0,1,0,0,0
2002259,108,29,1905,5,"male",1032,435,50,28,30,1,6,27,24
2002261,62,14,1951,9,"female",909,43,6,31,8,9,3,22,5
2002270,51,13,1962,10,"male",124,0,0,0,0,0,0,0,0
2002273,31,2,1982,2,"male",632,200,72,2,2,2,1,0,1
2002281,16,13,1997,3,"male",741,235,171,0,3,0,3,0,0
2002287,14,21,1999,2,"female",481,1352,462,3214,598,3212,484,2,114
2002298,23,15,1990,4,"female",263,138,28,126,25,126,21,0,4
2002307,25,3,1988,8,"male",485,203,54,12,32,12,12,0,20
2002317,33,2,1980,2,"male",467,14,9,4,4,4,4,0,0
2002324,29,26,1984,5,"male",323,233,170,37,22,37,16,0,6
2002360,17,3,1996,1,"female",707,2178,526,2252,2848,64,1751,2188,1097
2002363,18,1,1995,1,"male",599,102,72,0,7,0,1,0,6
2002378,22,12,1991,5,"female",387,349,98,469,519,468,333,1,186
2002382,71,1,1942,7,"male",104,35,31,969,119,969,82,0,37
2002391,32,8,1981,7,"female",404,234,150,15,35,2,6,13,29
2002413,28,7,1985,4,"female",1537,220,113,234,146,153,47,81,99
2002417,29,31,1984,10,"female",534,80,71,8,28,0,6,8,22
2002446,103,15,1910,3,"male",1117,285,114,24,21,24,20,0,1
2002447,25,28,1988,2,"male",421,2,2,1,0,1,0,0,0
2002451,53,28,1960,10,"male",423,7,4,0,11,0,11,0,0
2002459,17,2,1996,10,"male",415,215,152,50,3,50,3,0,0
2002468,51,14,1962,9,"male",418,2,2,0,0,0,0,0,0
2002473,29,12,1984,12,"male",151,5,3,0,0,0,0,0,0
2002489,24,4,1989,3,"male",854,51,45,14,5,0,2,14,3
2002497,25,16,1988,4,"male",515,142,66,33,8,1,1,32,7
2002516,22,19,1991,8,"female",578,437,103,68,71,68,51,0,20
2002571,58,22,1955,9,"male",669,144,118,55,15,55,5,0,10
2002575,19,17,1994,11,"male",206,82,38,2,11,2,2,0,9
2002599,27,10,1986,10,"male",296,98,64,358,179,328,147,30,32
2002617,24,5,1989,3,"male",126,82,74,40,30,4,16,36,14
2002626,27,28,1986,2,"female",345,41,20,8,2,8,1,0,1
2002632,57,31,1956,3,"female",650,196,58,163,97,0,46,163,51
2002651,97,4,1916,6,"male",1660,478,325,228,174,228,130,0,44
2002653,111,16,1902,8,"male",1471,585,245,48,47,2,19,46,28
2002678,24,21,1989,9,"female",699,83,20,17,56,12,23,5,33
2002700,21,2,1992,7,"female",295,167,151,70,26,70,21,0,5
2002720,22,1,1991,10,"female",357,44,32,7,1,0,0,7,1
2002754,15,4,1998,12,"male",868,512,390,35,5,11,5,24,0
2002756,53,9,1960,3,"male",289,55,41,290,135,222,132,68,3
2002763,34,8,1979,10,"female",268,9,5,0,0,0,0,0,0
2002788,21,10,1992,7,"male",189,177,108,46,85,24,52,22,33
2002795,51,13,1962,6,"female",1792,10,3,5,34,1,14,4,20
2002813,55,24,1958,7,"female",793,51,31,2,7,0,4,2,3
2002820,28,27,1985,3,"male",225,106,86,0,1,0,0,0,1
2002855,25,6,1988,5,"female",341,45,29,24,51,24,45,0,6
2002857,56,23,1957,6,"male",705,61,24,1,0,0,0,1,0
2002868,26,1,1987,7,"male",69,19,18,18,25,18,24,0,1
2002881,17,6,1996,5,"female",113,324,35,0,0,0,0,0,0
2002902,25,1,1988,8,"male",243,12,12,2,1,2,1,0,0
2002938,19,20,1994,3,"male",231,12,12,0,0,0,0,0,0
2002945,72,20,1941,9,"female",1721,24,10,0,0,0,0,0,0
2003003,41,16,1972,1,"male",375,13,5,0,1,0,1,0,0
2003021,55,26,1958,5,"male",283,22,14,3,12,0,8,3,4
2003086,17,13,1996,1,"male",782,223,142,56,58,28,16,28,42
2003109,39,15,1974,5,"female",184,16,3,2,10,1,10,1,0
2003114,21,23,1992,4,"female",645,349,172,1475,614,1449,245,26,369
2003119,27,26,1986,7,"female",190,167,95,24,26,1,10,23,16
2003161,68,17,1945,8,"male",20,24,21,1,0,0,0,1,0
2003170,103,1,1910,12,"male",1235,92,72,4,0,4,0,0,0
2003183,25,1,1988,1,"male",179,54,43,451,28,451,26,0,2
2003191,57,5,1956,11,"male",1323,81,28,2,2,0,1,2,1
2003204,14,10,1999,11,"male",218,97,93,0,0,0,0,0,0
2003233,56,15,1957,8,"female",712,17,10,0,3,0,3,0,0
2003237,41,28,1972,3,"female",518,50,27,125,42,70,30,55,12
2003239,41,6,1972,10,"male",385,243,136,0,3,0,3,0,0
2003255,60,24,1953,12,"female",569,8,7,19,1,0,0,19,1
2003289,43,19,1970,8,"female",765,115,59,72,15,72,8,0,7
2003299,80,24,1933,8,"male",453,21,11,0,0,0,0,0,0
2003300,20,3,1993,10,"female",173,48,33,336,193,94,96,242,97
2003305,19,28,1994,11,"female",719,6,3,0,0,0,0,0,0
2003334,31,31,1982,3,"male",944,197,149,106,25,21,17,85,8
2003348,23,1,1990,1,"male",371,20,17,3,6,3,0,0,6
2003350,25,30,1988,11,"female",782,1130,588,598,663,428,182,170,481
2003355,19,23,1994,6,"female",339,312,171,257,54,246,31,11,23
2003375,62,13,1951,8,"female",292,8,1,0,0,0,0,0,0
2003376,22,23,1991,3,"female",344,78,45,53,65,53,63,0,2
2003401,43,14,1970,7,"male",1708,51,27,5,5,0,3,5,2
2003404,26,3,1987,3,"male",179,82,43,0,0,0,0,0,0
2003454,69,27,1944,3,"female",703,157,96,1574,333,0,112,1574,221
2003455,83,9,1930,7,"female",901,233,142,0,0,0,0,0,0
2003491,27,29,1986,6,"female",164,29,23,4,11,4,10,0,1
2003516,36,16,1977,5,"male",603,174,123,8,9,8,5,0,4
2003531,54,9,1959,8,"female",524,38,26,220,41,220,28,0,13
2003539,63,10,1950,1,"female",27,51,50,333,128,52,72,281,56
2003547,26,11,1987,8,"male",424,24,20,127,0,127,0,0,0
2003551,21,10,1992,6,"female",299,265,82,85,51,72,25,13,26
2003590,19,15,1994,3,"female",568,376,153,7,49,7,32,0,17
2003623,54,9,1959,1,"male",53,14,8,12,1,6,1,6,0
2003645,78,19,1935,11,"male",1638,110,45,58,6,39,4,19,2
2003662,74,8,1939,10,"male",725,79,58,10,16,0,7,10,9
2003680,24,26,1989,12,"male",149,1,0,0,0,0,0,0,0
2003708,44,2,1969,11,"male",1714,55,31,4,5,0,4,4,1
2003712,20,4,1993,5,"female",141,69,14,0,1,0,0,0,1
2003734,45,12,1968,7,"male",413,119,60,82,421,82,188,0,233
2003737,27,5,1986,4,"female",1763,311,98,662,835,455,567,207,268
2003765,33,20,1980,8,"female",136,68,47,85,60,85,48,0,12
2003804,49,24,1964,8,"male",450,3,1,0,0,0,0,0,0
2003813,28,23,1985,9,"male",234,213,209,30,32,26,18,4,14
2003825,27,21,1986,5,"female",773,94,67,30,1,29,1,1,0
2003879,77,23,1936,1,"male",2171,1408,249,12,28,12,24,0,4
2003883,21,28,1992,1,"female",455,155,115,286,177,286,142,0,35
2003899,27,10,1986,12,"female",435,20,14,210,115,202,41,8,74
2003927,62,10,1951,11,"female",1888,411,217,989,497,345,196,644,301
2003933,70,13,1943,6,"female",1147,21,5,3,1,0,1,3,0
2003947,16,28,1997,4,"male",88,1,1,0,0,0,0,0,0
2003950,41,31,1972,12,"male",439,1137,897,187,202,187,182,0,20
2003957,32,21,1981,12,"male",235,14,3,0,0,0,0,0,0
2003959,19,14,1994,8,"female",88,45,33,11,8,11,6,0,2
2003961,53,9,1960,3,"male",1294,565,238,0,20,0,18,0,2
2004013,20,14,1993,12,"male",219,538,469,440,1386,382,1162,58,224
2004031,20,18,1993,1,"male",1153,12,5,0,1,0,0,0,1
2004035,45,10,1968,6,"male",102,7,2,3,283,3,183,0,100
2004036,17,28,1996,5,"male",165,19,15,3,3,3,3,0,0
2004039,35,5,1978,4,"female",603,36,17,25,7,25,7,0,0
2004052,17,16,1996,6,"male",527,341,149,121,59,1,22,120,37
2004059,53,13,1960,6,"male",603,61,39,2,11,1,5,1,6
2004095,17,29,1996,8,"male",752,293,159,107,29,103,5,4,24
2004125,17,7,1996,2,"male",660,87,41,68,5,64,1,4,4
2004147,14,24,1999,10,"female",241,846,54,162,239,162,209,0,30
2004187,70,11,1943,5,"female",1614,37,20,10,23,0,5,10,18
2004209,18,5,1995,12,"male",368,20,12,12,0,12,0,0,0
2004254,16,20,1997,10,"male",107,150,94,2,1,2,1,0,0
2004258,14,25,1999,9,"male",152,6,5,0,0,0,0,0,0
2004272,14,6,1999,8,"female",840,970,574,524,41,2,8,522,33
2004278,30,15,1983,4,"female",221,100,66,491,567,409,455,82,112
2004315,29,31,1984,1,"female",219,98,41,4,22,4,9,0,13
2004323,72,17,1941,12,"female",1231,49,27,0,1,0,0,0,1
2004336,23,18,1990,4,"male",85,64,51,15,9,6,5,9,4
2004337,27,24,1986,4,"male",1209,56,16,93,50,91,40,2,10
2004355,26,20,1987,3,"female",274,180,162,126,88,120,78,6,10
2004379,26,26,1987,9,"male",371,145,134,6,2,0,2,6,0
2004392,19,3,1994,5,"female",791,157,62,34,66,0,12,34,54
2004407,34,11,1979,3,"male",274,4,4,1,0,1,0,0,0
2004440,44,18,1969,3,"male",206,147,13,254,13,250,10,4,3
2004461,38,16,1975,7,"female",303,23,11,17,12,17,5,0,7
2004464,13,1,2000,1,"male",52,25,16,3,0,3,0,0,0
2004477,17,11,1996,9,"female",596,405,234,3,12,3,11,0,1
2004488,15,8,1998,8,"female",50,74,19,65,88,65,58,0,30
2004502,23,12,1990,10,"female",305,58,32,0,2,0,2,0,0
2004505,51,15,1962,5,"female",12,9,8,8,3,8,1,0,2
2004521,18,25,1995,6,"male",215,100,69,30,45,30,40,0,5
2004546,19,2,1994,9,"male",365,106,82,1,0,1,0,0,0
2004608,30,29,1983,1,"male",62,5,2,3,1,3,1,0,0
2004610,56,29,1957,9,"female",350,36,17,168,196,168,160,0,36
2004639,20,28,1993,2,"female",305,314,127,28,331,28,209,0,122
2004654,15,30,1998,4,"male",786,492,205,7,21,6,19,1,2
2004659,44,20,1969,3,"male",631,32,19,1,14,1,3,0,11
2004667,23,16,1990,10,"male",341,273,214,64,44,64,42,0,2
2004714,24,20,1989,5,"male",278,45,41,1,0,1,0,0,0
2004722,15,4,1998,3,"male",241,168,122,1,0,1,0,0,0
2004846,16,13,1997,11,"female",279,1057,832,151,108,11,64,140,44
2004848,23,25,1990,12,"male",165,386,363,1,1,1,1,0,0
2004850,28,13,1985,9,"male",543,33,33,0,0,0,0,0,0
2004875,20,21,1993,9,"male",126,188,167,87,16,87,13,0,3
2004880,56,28,1957,10,"male",1807,2092,712,120,431,94,149,26,282
2004885,101,2,1912,7,"female",516,361,170,107,66,107,50,0,16
2004892,69,29,1944,6,"female",1673,45,18,2,30,0,19,2,11
2004939,15,20,1998,11,"male",230,60,25,10,44,8,39,2,5
2004963,43,27,1970,8,"male",496,23,20,3,2,3,2,0,0
2004993,50,1,1963,5,"male",298,9,1,0,0,0,0,0,0
2005008,43,24,1970,5,"female",904,24,14,57,66,57,66,0,0
2005016,39,25,1974,10,"female",597,23,12,42,0,42,0,0,0
2005113,34,23,1979,8,"male",365,69,57,0,1,0,1,0,0
2005136,16,17,1997,9,"female",614,1383,246,49,404,49,260,0,144
2005142,31,20,1982,2,"male",264,33,32,0,1,0,0,0,1
2005148,24,20,1989,2,"male",453,29,12,0,0,0,0,0,0
2005168,26,22,1987,3,"male",256,326,291,977,182,977,174,0,8
2005187,35,5,1978,11,"male",523,69,42,0,2,0,2,0,0
2005208,68,12,1945,12,"female",629,38,17,10,9,0,0,10,9
2005236,26,10,1987,1,"male",12,4,3,3,1,3,1,0,0
2005251,24,17,1989,9,"male",296,169,145,11,0,0,0,11,0
2005268,37,5,1976,8,"female",204,123,111,1364,599,1315,239,49,360
2005276,53,14,1960,12,"male",191,8,7,1,0,1,0,0,0
2005288,34,8,1979,8,"male",385,95,87,0,0,0,0,0,0
2005295,27,21,1986,12,"male",320,113,101,1,2,1,2,0,0
2005321,55,22,1958,10,"male",920,13,4,1,0,0,0,1,0
2005325,23,1,1990,1,"male",339,0,0,0,0,0,0,0,0
2005340,113,4,1900,5,"male",1280,189,109,521,103,521,84,0,19
2005352,29,16,1984,7,"male",240,11,0,0,0,0,0,0,0
2005415,21,5,1992,2,"male",204,181,142,128,23,128,22,0,1
2005421,94,2,1919,6,"male",1259,897,214,2,7,2,5,0,2
2005434,32,7,1981,1,"male",142,104,88,25,14,25,10,0,4
2005452,13,9,2000,3,"male",70,2,2,0,0,0,0,0,0
2005476,33,30,1980,11,"male",358,15,13,1,0,0,0,1,0
2005522,108,14,1905,5,"female",365,98,66,1,6,1,6,0,0
2005570,76,18,1937,2,NA,2135,17,12,1,2,0,1,1,1
2005578,29,18,1984,3,"female",376,18,8,0,0,0,0,0,0
2005590,28,3,1985,6,"male",1088,18,16,0,1,0,0,0,1
2005602,52,8,1961,3,"female",137,42,40,1162,494,18,121,1144,373
2005631,36,28,1977,12,"male",1203,173,131,3,34,2,14,1,20
2005668,48,2,1965,12,"female",1571,58,40,17,9,11,4,6,5
2005686,19,24,1994,2,"female",106,95,63,8,20,8,20,0,0
2005692,40,8,1973,11,"female",719,182,81,7,60,5,29,2,31
2005747,62,15,1951,8,"female",1836,504,273,95,65,48,31,47,34
2005787,18,1,1995,3,"male",446,986,378,53,160,53,132,0,28
2005789,63,25,1950,12,"male",651,383,221,109,33,0,13,109,20
2005808,19,28,1994,5,"male",427,0,0,0,0,0,0,0,0
2005817,102,21,1911,9,"female",1762,312,85,186,561,117,335,69,226
2005821,63,4,1950,11,"male",1820,37,5,0,1,0,0,0,1
2005852,108,20,1905,4,"male",202,170,133,4,0,4,0,0,0
2005864,103,22,1910,4,"female",1148,160,50,28,27,28,15,0,12
2005871,18,6,1995,6,"female",793,421,166,495,680,139,165,356,515
2005896,21,28,1992,11,"male",391,353,293,1,4,0,1,1,3
2005903,17,3,1996,1,"male",537,317,271,7,2,6,1,1,1
2005922,26,8,1987,1,"male",622,174,121,69,83,18,43,51,40
2005940,30,16,1983,9,"male",409,18,9,144,11,144,10,0,1
2005957,88,25,1925,9,"female",689,151,82,24,5,24,2,0,3
2006001,20,6,1993,10,"female",158,1105,1048,2,5,2,4,0,1
2006025,26,19,1987,12,"male",912,225,157,79,11,0,8,79,3
2006047,16,20,1997,2,"female",363,1470,1197,310,384,310,338,0,46
2006066,22,17,1991,8,"male",167,538,437,269,100,269,97,0,3
2006070,57,2,1956,2,"female",1844,519,233,351,360,342,312,9,48
2006079,21,11,1992,1,"male",231,87,76,3,6,0,6,3,0
2006085,30,25,1983,4,"male",232,118,111,25,2,25,2,0,0
2006094,29,22,1984,10,"female",374,36,22,96,94,96,84,0,10
2006117,20,22,1993,5,"female",364,269,89,18,32,18,22,0,10
2006144,15,24,1998,5,"female",104,442,110,133,105,133,56,0,49
2006149,26,1,1987,1,"male",418,34,18,231,16,231,15,0,1
2006153,21,28,1992,8,"female",527,140,38,33,6,0,1,33,5
2006170,75,29,1938,10,"female",1788,119,41,8,33,1,26,7,7
2006222,63,15,1950,10,"male",512,159,111,16,57,4,33,12,24
2006245,45,28,1968,10,"female",646,216,121,131,289,28,61,103,228
2006273,69,21,1944,3,"male",1139,40,17,60,26,55,10,5,16
2006294,15,29,1998,9,"female",409,446,375,242,54,139,11,103,43
2006309,18,9,1995,12,"male",314,168,141,105,35,64,24,41,11
2006314,15,6,1998,12,"male",572,278,222,68,41,59,25,9,16
2006323,39,15,1974,5,"male",606,16,11,0,0,0,0,0,0
2006363,18,21,1995,7,"male",214,897,625,41,113,41,94,0,19
2006369,36,19,1977,4,"female",362,85,38,6,1,0,0,6,1
2006378,26,11,1987,5,"male",415,632,529,12,7,12,7,0,0
2006398,16,16,1997,12,"male",276,69,50,22,98,22,58,0,40
2006418,56,23,1957,11,"female",161,30,29,258,43,0,2,258,41
2006420,15,15,1998,5,"female",333,441,114,182,215,182,206,0,9
2006422,108,1,1905,1,"male",1409,85,48,3,1,3,0,0,1
2006429,20,17,1993,7,"male",106,16,11,76,9,74,7,2,2
2006493,55,12,1958,9,"female",1600,96,25,258,75,130,22,128,53
2006494,17,15,1996,11,"male",718,308,192,60,10,15,1,45,9
2006514,45,29,1968,10,"female",283,384,141,685,655,157,170,528,485
2006575,21,5,1992,11,"female",469,185,59,778,736,529,361,249,375
2006579,17,4,1996,11,"female",82,80,36,42,5,42,5,0,0
2006587,16,20,1997,10,"female",79,4,3,0,0,0,0,0,0
2006643,37,1,1976,6,"male",1043,43,30,53,30,53,17,0,13
2006702,16,12,1997,2,"male",236,154,119,57,9,53,2,4,7
2006735,74,2,1939,7,"male",1536,740,350,156,44,156,37,0,7
2006742,34,15,1979,11,"female",450,137,77,5,0,0,0,5,0
2006766,18,1,1995,6,"female",205,1229,26,877,1760,184,1123,693,637
2006801,33,13,1980,1,"female",1210,77,63,233,123,233,94,0,29
2006823,33,26,1980,6,"male",300,0,0,0,0,0,0,0,0
2006825,20,21,1993,12,"female",138,416,67,50,33,50,25,0,8
2006863,72,1,1941,10,"female",1223,30,17,1,3,1,3,0,0
2006877,93,25,1920,1,"male",1435,298,96,1035,418,368,241,667,177
2006880,65,1,1948,1,"male",405,25,11,6,3,6,2,0,1
2006886,103,12,1910,12,"male",403,47,39,0,0,0,0,0,0
2006905,57,3,1956,1,"male",662,437,305,19,4,19,3,0,1
2006910,18,10,1995,2,"male",752,1293,1025,0,5,0,4,0,1
2006959,72,23,1941,3,"female",1606,121,72,373,220,363,149,10,71
2007008,46,28,1967,10,"female",1889,146,87,82,212,68,162,14,50
2007018,21,5,1992,1,NA,227,79,34,11,3,11,1,0,2
2007020,16,28,1997,12,"male",71,63,63,0,0,0,0,0,0
2007060,18,20,1995,11,"female",1193,660,326,69,587,62,383,7,204
2007114,61,24,1952,1,"male",1402,34,19,24,40,24,26,0,14
2007117,53,21,1960,2,"male",340,22,15,0,1,0,0,0,1
2007162,23,1,1990,1,"male",379,11,10,1,5,0,2,1,3
2007167,16,24,1997,6,"male",359,8,6,0,0,0,0,0,0
2007187,46,18,1967,3,"male",41,0,0,0,0,0,0,0,0
2007192,48,2,1965,9,"female",453,31,18,97,15,17,2,80,13
2007212,36,1,1977,4,"male",455,38,12,27,56,27,37,0,19
2007239,74,14,1939,12,"male",541,0,0,0,0,0,0,0,0
2007244,55,13,1958,8,"female",184,190,91,82,406,82,112,0,294
2007245,21,11,1992,7,"male",270,42,21,1,0,1,0,0,0
2007247,50,4,1963,12,"female",57,159,109,678,421,118,137,560,284
2007250,31,5,1982,6,"female",337,91,73,3,2,3,0,0,2
2007255,39,1,1974,5,"male",289,9,5,2,0,2,0,0,0
2007256,49,2,1964,2,"male",1681,54,12,2,10,2,9,0,1
2007269,30,16,1983,5,"female",513,71,25,25,34,25,26,0,8
2007346,30,12,1983,11,"female",466,51,26,2,0,2,0,0,0
2007372,39,1,1974,11,"male",620,23,18,2,0,2,0,0,0
2007379,36,29,1977,10,"male",400,0,0,0,0,0,0,0,0
2007387,20,16,1993,4,"female",326,2,0,1,0,0,0,1,0
2007391,19,14,1994,10,"female",487,263,125,7,0,7,0,0,0
2007407,57,7,1956,9,"female",1034,69,31,13,3,3,3,10,0
2007415,29,7,1984,8,"female",475,3441,2074,408,1638,338,1037,70,601
2007421,100,15,1913,4,"female",2308,899,407,137,191,51,87,86,104
2007428,68,2,1945,12,"male",704,321,182,527,59,454,52,73,7
2007431,18,19,1995,6,"female",214,215,115,159,261,149,179,10,82
2007444,19,9,1994,12,"male",436,393,344,2,10,2,9,0,1
2007457,65,31,1948,7,"male",1204,269,121,0,3,0,1,0,2
2007503,45,31,1968,5,"male",35,9,6,1,2,0,0,1,2
2007521,54,5,1959,4,"female",608,161,117,303,205,303,75,0,130
2007554,19,19,1994,2,"male",514,87,67,0,0,0,0,0,0
2007581,26,23,1987,9,"female",371,163,142,256,183,12,109,244,74
2007607,57,21,1956,4,"female",1091,183,60,53,207,22,79,31,128
2007618,17,14,1996,3,"male",678,1,0,0,0,0,0,0,0
2007633,44,22,1969,4,"female",411,317,120,256,177,256,147,0,30
2007646,113,15,1900,4,"male",2158,23,9,5,16,4,13,1,3
2007662,22,1,1991,1,"female",229,46,44,0,1,0,1,0,0
2007672,16,8,1997,4,"male",251,281,210,0,9,0,1,0,8
2007684,64,31,1949,1,"male",1758,816,86,272,200,20,134,252,66
2007688,74,7,1939,12,"female",1727,288,230,732,350,0,83,732,267
2007714,18,20,1995,1,"male",140,3,3,2,0,2,0,0,0
2007764,19,2,1994,5,"female",482,123,44,4,0,4,0,0,0
2007770,54,8,1959,4,"female",1705,381,112,51,40,51,23,0,17
2007777,21,14,1992,3,"male",163,245,197,792,253,775,109,17,144
2007783,93,29,1920,4,"female",1116,129,97,277,56,0,13,277,43
2007789,31,10,1982,8,"male",1286,1,0,1,1,0,1,1,0
2007797,23,23,1990,3,"male",453,68,46,42,16,42,10,0,6
2007810,47,24,1966,9,"female",35,1,1,0,0,0,0,0,0
2007845,14,15,1999,2,"male",296,90,28,6,0,6,0,0,0
2007868,19,7,1994,5,"male",102,312,282,189,137,189,88,0,49
2007893,28,22,1985,9,"female",309,3,1,0,0,0,0,0,0
2007896,23,11,1990,5,"male",241,1,1,0,0,0,0,0,0
2007914,31,12,1982,5,"female",336,29,18,160,4,160,3,0,1
2007945,18,15,1995,9,"female",173,108,97,5,3,0,0,5,3
2007967,68,23,1945,3,"male",142,5,4,1,3,0,3,1,0
2008004,19,24,1994,10,"male",259,66,14,784,527,398,188,386,339
2008011,27,28,1986,11,"female",213,29,7,23,26,23,16,0,10
2008033,18,6,1995,7,"female",215,1,1,0,0,0,0,0,0
2008057,65,8,1948,4,"female",1809,247,215,536,428,181,245,355,183
2008062,15,22,1998,9,"male",554,105,47,21,2,20,1,1,1
2008069,32,12,1981,11,"female",348,100,69,17,22,17,5,0,17
2008083,20,21,1993,3,"male",716,31,21,18,2,0,1,18,1
2008127,15,2,1998,6,"male",172,74,50,13,3,11,1,2,2
2008132,36,1,1977,12,"male",245,10,8,0,0,0,0,0,0
2008170,18,19,1995,9,"female",210,236,24,377,297,377,137,0,160
2008209,69,8,1944,12,"male",103,37,15,8,27,0,6,8,21
2008214,14,7,1999,5,"male",242,0,0,0,0,0,0,0,0
2008218,52,9,1961,10,"female",750,169,38,150,415,60,183,90,232
2008221,19,20,1994,2,"female",361,352,210,127,107,127,92,0,15
2008229,36,31,1977,7,"female",270,65,43,256,258,17,134,239,124
2008237,17,8,1996,2,"male",339,116,93,5,30,5,27,0,3
2008238,27,13,1986,6,"male",245,1,0,0,0,0,0,0,0
2008248,33,1,1980,1,"male",440,294,265,111,95,111,73,0,22
2008256,16,15,1997,8,"female",314,205,164,28,121,26,74,2,47
2008257,48,14,1965,2,"female",287,149,111,27,12,0,6,27,6
2008297,76,7,1937,7,"male",791,65,20,1,3,1,3,0,0
2008319,23,24,1990,6,"female",659,305,101,47,44,47,22,0,22
2008324,19,25,1994,11,"male",1316,17,0,0,0,0,0,0,0
2008339,53,11,1960,10,"male",1741,7,4,0,0,0,0,0,0
2008344,14,5,1999,10,"female",44,14,10,0,2,0,2,0,0
2008375,28,23,1985,10,"male",451,289,226,0,0,0,0,0,0
2008380,35,4,1978,1,"male",164,52,16,204,64,204,44,0,20
2008405,26,8,1987,5,"female",380,156,123,76,61,21,40,55,21
2008416,56,13,1957,10,"female",653,54,33,364,124,364,106,0,18
2008419,30,28,1983,8,"male",632,14,6,0,0,0,0,0,0
2008429,31,30,1982,12,"female",1153,33,23,78,102,43,86,35,16
2008436,20,9,1993,11,"male",839,94,12,1,6,1,5,0,1
2008446,23,1,1990,1,"male",381,111,103,4,2,0,1,4,1
2008449,71,10,1942,7,"female",1094,29,13,5,6,0,1,5,5
2008489,61,30,1952,4,"male",1186,0,0,0,0,0,0,0,0
2008547,103,22,1910,1,"male",828,830,343,87,201,52,127,35,74
2008558,69,4,1944,4,"male",1402,37,14,1,9,0,1,1,8
2008564,28,9,1985,12,"male",828,351,180,0,0,0,0,0,0
2008570,23,18,1990,12,"male",477,38,28,0,0,0,0,0,0
2008638,23,18,1990,7,"male",370,335,281,0,4,0,4,0,0
2008671,28,13,1985,9,"female",308,58,22,0,0,0,0,0,0
2008673,14,31,1999,7,"male",448,184,105,1,0,0,0,1,0
2008698,45,10,1968,10,"male",1208,66,35,8,16,8,3,0,13
2008733,18,5,1995,5,"male",216,61,49,350,249,30,68,320,181
2008742,24,20,1989,6,"female",642,75,32,16,32,7,6,9,26
2008758,46,9,1967,7,"male",477,21,13,0,0,0,0,0,0
2008761,19,30,1994,12,"male",13,23,13,10,16,8,6,2,10
2008762,18,20,1995,6,"male",85,25,23,1,0,1,0,0,0
2008771,36,21,1977,12,"female",496,48,11,84,353,84,293,0,60
2008783,32,27,1981,8,"male",354,18,18,0,0,0,0,0,0
2008848,35,3,1978,3,"female",347,160,44,0,0,0,0,0,0
2008876,34,7,1979,8,"male",45,25,23,3,4,3,4,0,0
2008882,36,3,1977,4,"male",454,0,0,0,0,0,0,0,0
2008908,23,5,1990,7,"male",873,17,10,0,2,0,1,0,1
2008909,20,8,1993,7,"male",491,2,1,10,2,10,2,0,0
2008919,23,12,1990,9,"female",375,645,127,1669,2772,1669,2419,0,353
2008936,15,2,1998,6,"male",48,28,20,197,15,197,9,0,6
2008938,18,18,1995,9,"female",578,275,221,30,7,29,2,1,5
2008951,35,3,1978,2,"female",1112,451,188,83,67,6,42,77,25
2008961,108,31,1905,7,"male",1222,299,207,3,21,1,18,2,3
2008978,23,25,1990,5,"male",513,139,97,13,1,13,1,0,0
2008986,28,12,1985,1,"male",612,23,22,0,0,0,0,0,0
2008991,27,25,1986,5,"female",657,45,29,240,16,240,6,0,10
2008995,47,2,1966,3,"female",241,30,17,139,49,21,15,118,34
2009000,39,21,1974,9,"female",117,8,7,4,0,1,0,3,0
2009008,19,11,1994,12,"female",668,95,29,43,3,43,3,0,0
2009031,72,3,1941,2,"male",620,42,28,1,1,0,1,1,0
2009038,58,10,1955,11,"male",396,37,14,42,10,0,4,42,6
2009060,23,10,1990,2,"male",777,264,165,14,10,14,8,0,2
2009070,20,1,1993,1,"male",642,264,16,0,38,0,31,0,7
2009077,25,5,1988,4,"male",1123,6,4,10,4,10,4,0,0
2009082,32,5,1981,4,"female",487,31,14,1,0,1,0,0,0
2009084,19,9,1994,9,"male",1123,39,24,123,197,31,176,92,21
2009088,108,5,1905,2,"male",1840,152,61,15,92,15,54,0,38
2009158,104,20,1909,3,"female",167,104,51,2,2,2,1,0,1
2009173,38,10,1975,7,"male",864,131,30,1,30,1,6,0,24
2009194,59,19,1954,8,"male",1785,92,45,140,7,3,2,137,5
2009221,21,10,1992,9,"female",325,361,44,118,297,118,292,0,5
2009230,49,1,1964,8,"male",955,2,1,0,0,0,0,0,0
2009244,49,1,1964,12,"male",64,0,0,3,0,3,0,0,0
2009252,59,27,1954,7,"male",455,1,0,0,0,0,0,0,0
2009259,16,23,1997,8,"male",503,18,9,0,0,0,0,0,0
2009271,49,1,1964,5,"male",418,5,4,5,1,5,1,0,0
2009289,20,14,1993,12,"male",1106,783,714,20,46,6,28,14,18
2009322,26,15,1987,12,"male",241,81,37,4,7,4,5,0,2
2009328,40,17,1973,9,"male",527,8,4,2,1,0,0,2,1
2009330,58,6,1955,11,"female",202,31,17,1,1,0,0,1,1
2009333,17,20,1996,10,"male",504,340,258,8,5,7,4,1,1
2009362,26,1,1987,1,"male",374,58,50,5,0,5,0,0,0
2009381,22,7,1991,12,"male",225,85,50,78,43,78,34,0,9
2009428,32,2,1981,2,"male",484,49,28,0,0,0,0,0,0
2009464,25,6,1988,5,"female",58,1,1,83,48,83,42,0,6
2009479,53,5,1960,10,"female",186,48,17,0,2,0,0,0,2
2009497,26,14,1987,1,"male",92,186,126,236,159,236,145,0,14
2009566,56,22,1957,1,"female",740,181,105,1835,788,1451,510,384,278
2009574,16,1,1997,9,"male",385,180,142,9,19,0,1,9,18
2009642,16,17,1997,8,"male",302,288,258,1,0,1,0,0,0
2009673,32,7,1981,6,"male",505,36,21,1,1,1,1,0,0
2009722,16,29,1997,5,"female",546,1733,1055,2277,3119,973,1830,1304,1289
2009743,36,19,1977,12,"male",174,2,1,0,0,0,0,0,0
2009801,30,4,1983,1,"male",56,21,6,3,5,3,4,0,1
2009825,24,17,1989,7,"male",259,504,455,34,10,34,10,0,0
2009861,22,29,1991,5,"female",623,167,112,145,238,134,196,11,42
2009873,62,7,1951,5,"female",1749,95,48,122,129,0,67,122,62
2009890,56,28,1957,2,"female",921,79,28,4,7,1,4,3,3
2009908,25,19,1988,3,"male",405,9,5,1,0,1,0,0,0
2009918,70,3,1943,9,"male",1720,105,27,7,25,7,14,0,11
2009928,40,28,1973,3,"male",148,78,75,0,0,0,0,0,0
2009947,14,16,1999,7,"male",126,85,64,1,0,1,0,0,0
2009951,15,6,1998,11,"male",300,45,27,7,0,7,0,0,0
2009952,31,12,1982,9,"female",136,2,1,7,10,7,5,0,5
2009958,31,3,1982,3,"male",569,7,2,67,0,67,0,0,0
2009960,27,20,1986,6,"male",152,4,3,0,1,0,1,0,0
2009966,46,3,1967,8,"male",223,0,0,0,0,0,0,0,0
2009980,15,17,1998,6,"male",399,308,242,0,1,0,1,0,0
2009992,18,29,1995,10,"male",759,177,93,2,17,2,15,0,2
2009998,18,24,1995,11,"male",273,321,265,280,271,34,60,246,211
2010019,65,4,1948,1,"male",865,44,33,0,0,0,0,0,0
2010020,32,25,1981,4,"female",233,23,19,10,0,0,0,10,0
2010032,39,13,1974,6,"female",216,22,17,1,0,1,0,0,0
2010033,23,11,1990,9,"male",27,0,0,0,0,0,0,0,0
2010034,29,1,1984,8,"male",324,62,58,4,1,0,1,4,0
2010050,17,8,1996,4,"male",410,0,0,0,0,0,0,0,0
2010052,18,13,1995,4,"male",205,72,54,0,0,0,0,0,0
2010091,18,19,1995,6,"female",264,549,450,715,1620,685,959,30,661
2010103,16,24,1997,7,"female",482,1055,580,217,521,132,234,85,287
2010118,13,24,2000,3,"female",468,200,69,33,31,26,13,7,18
2010119,97,24,1916,12,"female",892,44,13,36,15,0,1,36,14
2010138,58,6,1955,7,"male",546,131,81,51,146,17,27,34,119
2010140,26,11,1987,7,"female",222,121,87,26,14,26,11,0,3
2010161,94,12,1919,6,"male",207,104,70,84,202,0,80,84,122
2010196,14,29,1999,7,"male",155,6,5,0,0,0,0,0,0
2010197,43,9,1970,7,"female",1798,231,125,136,136,24,47,112,89
2010201,34,12,1979,7,"female",349,29,12,0,0,0,0,0,0
2010218,18,15,1995,10,"female",274,198,94,54,21,54,17,0,4
2010226,24,1,1989,1,"female",658,298,110,184,485,79,156,105,329
2010232,22,11,1991,11,"male",86,146,134,0,0,0,0,0,0
2010239,22,10,1991,7,"male",666,861,637,7,45,0,24,7,21
2010285,57,29,1956,1,"female",569,68,39,2,2,2,2,0,0
2010326,18,12,1995,5,"male",8,25,24,15,6,15,6,0,0
2010349,48,30,1965,4,"male",724,94,42,156,67,156,37,0,30
2010356,106,17,1907,11,"female",394,56,16,7,8,7,6,0,2
2010382,65,1,1948,6,"male",13,11,6,2,2,0,0,2,2
2010390,27,20,1986,9,"female",177,39,25,8,2,8,1,0,1
2010391,33,17,1980,9,"female",215,24,17,1590,1242,1590,1127,0,115
2010401,18,19,1995,8,"male",51,19,9,37,5,32,5,5,0
2010402,20,20,1993,8,"female",416,888,286,20,21,0,10,20,11
2010417,19,21,1994,1,"male",239,10,5,14,7,14,7,0,0
2010421,17,2,1996,9,"male",708,59,7,0,8,0,8,0,0
2010444,36,1,1977,1,"male",266,9,6,0,18,0,7,0,11
2010455,65,19,1948,5,"female",619,182,152,0,16,0,0,0,16
2010464,18,28,1995,9,"female",442,126,98,2,0,0,0,2,0
2010477,40,30,1973,10,"male",1326,22,11,0,18,0,14,0,4
2010484,14,3,1999,1,"female",307,327,206,135,175,135,144,0,31
2010512,39,13,1974,2,"male",306,20,8,2,1,2,0,0,1
2010528,33,27,1980,5,"male",622,199,85,1,0,1,0,0,0
2010575,34,8,1979,8,"male",111,41,33,1,7,1,6,0,1
2010618,32,11,1981,1,"male",17,1,1,0,0,0,0,0,0
2010629,56,27,1957,5,"male",296,35,23,335,128,324,32,11,96
2010660,30,24,1983,1,"male",687,35,13,1,20,1,20,0,0
2010675,26,1,1987,1,"male",333,4,4,1,0,1,0,0,0
2010688,27,13,1986,7,"male",683,89,29,9,0,9,0,0,0
2010697,27,28,1986,9,"male",233,76,74,4,3,4,3,0,0
2010721,38,10,1975,8,"female",260,66,18,3,5,2,0,1,5
2010734,108,23,1905,2,"female",1463,3448,1308,330,581,16,354,314,227
2010754,24,9,1989,5,"male",323,387,219,1,4,1,3,0,1
2010767,86,3,1927,4,"male",821,39,18,17,2,4,2,13,0
2010770,28,2,1985,12,"male",470,95,67,38,18,38,17,0,1
2010805,23,9,1990,5,"male",4,2,2,5,0,5,0,0,0
2010812,25,1,1988,1,"male",52,2,2,0,0,0,0,0,0
2010814,43,15,1970,11,"male",134,69,46,12,29,12,16,0,13
2010846,31,8,1982,4,"female",256,247,173,127,127,127,100,0,27
2010853,41,30,1972,7,"female",441,10,4,384,43,0,22,384,21
2010859,22,28,1991,4,"female",1136,62,18,17,0,17,0,0,0
2010861,20,28,1993,11,"female",993,897,797,12,187,12,160,0,27
2010882,28,4,1985,4,"male",310,86,12,0,18,0,2,0,16
2010891,54,4,1959,4,"female",1322,62,10,3,4,1,3,2,1
2010892,27,5,1986,3,"male",299,40,21,1,0,1,0,0,0
2010898,22,1,1991,1,"female",542,19,9,4,1,4,1,0,0
2010912,22,2,1991,1,"male",52,9,9,9,0,9,0,0,0
2010923,49,11,1964,3,"female",286,150,20,69,328,67,45,2,283
2010929,26,20,1987,7,"female",525,361,268,619,366,594,335,25,31
2010951,51,12,1962,12,"male",479,118,74,71,155,71,144,0,11
2010994,63,1,1950,1,"female",566,22,6,3,1,3,0,0,1
2010998,47,28,1966,3,"male",1109,33,4,0,0,0,0,0,0
2011003,13,26,2000,3,"female",636,249,115,145,382,3,38,142,344
2011017,20,11,1993,2,"female",1045,279,87,54,36,54,6,0,30
2011036,17,5,1996,12,"male",703,356,235,8,0,7,0,1,0
2011045,24,1,1989,10,"male",263,36,21,0,0,0,0,0,0
2011053,21,19,1992,11,"male",710,256,164,40,0,40,0,0,0
2011066,21,13,1992,4,"female",341,307,101,4841,425,4841,375,0,50
2011081,19,30,1994,8,"female",372,1169,497,42,27,42,27,0,0
2011176,27,15,1986,10,"male",1541,359,217,0,0,0,0,0,0
2011203,35,11,1978,10,"female",438,23,12,12,22,12,19,0,3
2011206,33,26,1980,1,"female",132,43,37,2,3,2,3,0,0
2011227,25,5,1988,5,"male",435,218,189,63,8,63,5,0,3
2011259,58,2,1955,8,"male",345,65,36,0,0,0,0,0,0
2011271,22,1,1991,4,"male",279,140,124,22,33,22,30,0,3
2011285,21,5,1992,10,"male",651,24,18,0,0,0,0,0,0
2011319,53,2,1960,2,"male",305,39,39,38,9,38,9,0,0
2011352,105,18,1908,6,"male",908,417,278,245,232,12,99,233,133
2011373,45,17,1968,8,"female",444,11,6,6,0,6,0,0,0
2011394,47,4,1966,9,"male",780,67,40,0,4,0,4,0,0
2011406,51,26,1962,12,"female",2182,318,154,83,58,83,45,0,13
2011417,33,8,1980,10,"male",319,459,359,169,67,66,25,103,42
2011449,14,27,1999,9,"male",112,36,23,10,23,9,9,1,14
2011461,52,20,1961,8,"female",1519,185,138,749,471,500,205,249,266
2011468,29,27,1984,3,"female",630,72,28,290,169,3,20,287,149
2011488,18,26,1995,5,"male",6,17,17,26,2,26,2,0,0
2011492,16,5,1997,10,"male",700,566,377,62,13,62,12,0,1
2011504,21,18,1992,3,"female",127,57,40,7,7,7,3,0,4
2011522,35,4,1978,5,"male",1346,15,10,36,4,7,4,29,0
2011524,26,18,1987,3,"male",65,53,43,6,2,2,0,4,2
2011537,33,1,1980,1,"female",54,49,28,81,15,81,7,0,8
2011542,43,7,1970,11,"male",768,597,408,466,293,419,169,47,124
2011578,25,1,1988,1,"male",31,20,11,108,31,65,11,43,20
2011605,28,11,1985,5,"male",135,94,76,76,2,76,2,0,0
2011609,17,15,1996,9,"female",718,1544,1001,257,227,44,60,213,167
2011616,25,23,1988,7,"female",94,33,29,208,8,208,8,0,0
2011618,19,10,1994,8,"female",240,219,85,3,17,3,9,0,8
2011636,24,10,1989,10,"male",523,11,8,0,0,0,0,0,0
2011647,18,26,1995,7,"male",409,367,269,7,0,0,0,7,0
2011685,73,21,1940,9,"female",951,29,11,50,20,50,4,0,16
2011687,24,19,1989,8,"male",173,0,0,0,0,0,0,0,0
2011718,40,2,1973,12,"male",398,87,55,0,0,0,0,0,0
2011732,31,6,1982,12,"male",712,21,14,58,66,58,19,0,47
2011743,21,4,1992,10,"female",1101,576,371,123,213,123,144,0,69
2011744,15,14,1998,5,"male",577,35,20,5,2,5,2,0,0
2011770,38,10,1975,1,"male",1789,12,12,3,0,0,0,3,0
2011801,18,10,1995,3,"male",460,39,25,18,2,18,2,0,0
2011826,36,10,1977,3,"male",270,87,77,19,45,19,36,0,9
2011835,56,24,1957,6,"female",125,22,17,193,88,193,71,0,17
2011869,27,30,1986,10,"male",468,42,26,26,48,15,26,11,22
2011873,73,9,1940,2,"female",1346,20,12,6,2,4,2,2,0
2011888,22,12,1991,6,"female",378,954,314,2527,1949,123,1042,2404,907
2011894,108,30,1905,12,"male",1980,181,141,185,6,0,2,185,4
2011913,38,10,1975,6,"female",711,227,113,244,266,168,193,76,73
2011915,26,15,1987,5,"male",362,221,169,22,3,22,3,0,0
2011926,19,16,1994,5,"female",137,130,55,0,0,0,0,0,0
2011933,33,8,1980,5,"male",214,23,11,5098,193,5098,178,0,15
2011942,29,13,1984,2,"male",203,363,331,17,11,15,6,2,5
2011961,14,18,1999,1,"female",244,968,645,1,8,1,5,0,3
2011993,23,15,1990,5,"male",199,77,71,7,19,6,11,1,8
2011997,94,1,1919,1,"male",1379,507,281,83,43,45,26,38,17
2012001,20,18,1993,12,"female",578,164,124,1328,1668,1328,357,0,1311
2012009,81,1,1932,1,"female",921,40,24,669,133,7,39,662,94
2012042,22,1,1991,10,"female",218,95,75,167,25,167,18,0,7
2012074,18,3,1995,5,"female",600,707,351,17,117,17,71,0,46
2012091,30,1,1983,1,"male",257,32,21,3,2,2,2,1,0
2012094,25,7,1988,9,"male",562,258,127,16,8,16,8,0,0
2012117,21,22,1992,12,"female",682,208,81,1,7,1,6,0,1
2012130,48,13,1965,6,"male",82,33,28,576,1,576,1,0,0
2012138,29,23,1984,10,"female",196,28,16,17,6,0,3,17,3
2012160,74,21,1939,8,"female",476,15,11,0,0,0,0,0,0
2012163,14,11,1999,5,"male",873,3463,2110,1659,1385,442,784,1217,601
2012178,18,24,1995,8,"female",551,788,346,3,5,3,4,0,1
2012200,50,13,1963,7,"female",1024,3,1,147,0,0,0,147,0
2012206,40,19,1973,1,"male",503,915,608,121,415,44,262,77,153
2012264,20,10,1993,5,"male",201,2,2,0,0,0,0,0,0
2012269,25,6,1988,1,"female",147,25,12,801,60,208,16,593,44
2012310,38,26,1975,11,"male",376,101,54,11,17,11,11,0,6
2012333,20,1,1993,3,"female",444,149,56,163,40,134,20,29,20
2012340,19,9,1994,9,"male",1222,252,149,360,107,306,72,54,35
2012356,68,15,1945,12,"female",245,36,3,92,41,0,10,92,31
2012359,42,19,1971,3,"female",280,121,80,16,32,16,20,0,12
2012369,18,10,1995,3,"female",821,1831,480,203,98,8,33,195,65
2012421,50,15,1963,1,"male",44,9,6,1,2,1,1,0,1
2012432,99,3,1914,7,"male",1012,27,6,0,2,0,2,0,0
2012487,27,15,1986,11,"female",437,75,41,224,65,224,54,0,11
2012496,64,7,1949,2,"female",171,38,23,176,6,175,4,1,2
2012528,31,9,1982,1,"female",1575,476,158,157,62,157,44,0,18
2012534,17,27,1996,9,"male",777,540,416,25,17,25,13,0,4
2012547,27,24,1986,5,"male",472,495,460,0,0,0,0,0,0
2012560,19,10,1994,9,"female",461,1209,795,750,1730,486,850,264,880
2012568,23,6,1990,9,"female",1510,414,179,13,59,11,30,2,29
2012577,52,23,1961,6,"female",347,650,501,335,176,335,166,0,10
2012585,18,21,1995,9,"female",595,214,11,48,0,48,0,0,0
2012619,15,29,1998,1,"male",329,133,105,29,29,28,12,1,17
2012645,26,8,1987,11,"female",481,225,164,0,1,0,0,0,1
2012656,18,5,1995,1,"male",46,46,38,2,12,2,9,0,3
2012688,20,25,1993,4,"male",176,3,0,8,0,0,0,8,0
2012693,40,1,1973,1,"male",300,86,48,0,3,0,0,0,3
2012700,53,22,1960,12,"female",240,55,32,192,38,0,3,192,35
2012703,19,26,1994,9,"female",1568,433,148,1357,1079,1113,840,244,239
2012724,24,5,1989,4,"male",565,75,57,0,10,0,0,0,10
2012745,17,2,1996,2,"male",372,289,163,114,46,97,24,17,22
2012773,52,2,1961,2,"female",1013,98,56,258,43,0,21,258,22
2012788,51,18,1962,3,"male",564,7,5,0,1,0,1,0,0
2012790,18,12,1995,12,"male",239,88,39,216,92,208,47,8,45
2012814,27,24,1986,11,"female",592,249,211,29,29,15,25,14,4
2012822,70,17,1943,10,"female",591,59,27,36,99,0,39,36,60
2012829,55,7,1958,6,"female",741,39,15,344,150,339,51,5,99
2012847,24,8,1989,9,"male",420,14,6,0,0,0,0,0,0
2012855,63,17,1950,9,"female",1541,131,40,946,291,946,223,0,68
2012889,29,29,1984,12,"female",514,315,237,29,161,6,90,23,71
2012904,18,12,1995,10,"male",293,467,405,28,11,28,9,0,2
2012909,103,1,1910,1,"male",415,28,27,1,0,0,0,1,0
2012914,24,19,1989,10,"female",402,129,87,15,15,15,9,0,6
2012983,54,28,1959,2,"male",441,0,0,0,0,0,0,0,0
2013008,18,13,1995,3,"female",460,300,57,389,285,222,195,167,90
2013019,49,25,1964,2,"male",645,134,56,5,2,0,1,5,1
2013054,27,3,1986,10,"male",9,27,11,9,3,9,3,0,0
2013063,20,29,1993,12,"male",1438,132,97,227,128,115,76,112,52
2013086,57,23,1956,10,"female",1384,370,196,896,1136,236,297,660,839
2013108,37,2,1976,8,"male",440,25,1,129,86,129,81,0,5
2013112,68,6,1945,1,"male",474,218,107,2,15,2,13,0,2
2013114,34,1,1979,1,"female",604,31,13,49,31,4,11,45,20
2013124,30,16,1983,6,"female",620,212,148,600,393,505,213,95,180
2013128,23,28,1990,1,"female",145,178,146,14,7,14,2,0,5
2013129,77,23,1936,2,"male",1770,10,4,0,1,0,1,0,0
2013141,30,17,1983,9,"male",669,79,18,0,0,0,0,0,0
2013151,25,1,1988,1,"male",0,0,0,0,0,0,0,0,0
2013159,26,17,1987,9,"female",1076,921,322,1289,2019,847,1824,442,195
2013177,19,19,1994,1,"female",191,308,234,517,348,153,106,364,242
2013188,60,8,1953,6,"male",1659,336,178,246,400,246,293,0,107
2013203,17,30,1996,12,"female",167,283,237,12,26,4,18,8,8
2013205,18,16,1995,1,"male",334,5,3,0,0,0,0,0,0
2013207,23,27,1990,1,"male",361,147,44,0,0,0,0,0,0
2013214,108,21,1905,2,"male",772,282,186,22,11,0,3,22,8
2013242,88,26,1925,8,"female",1429,84,35,66,130,0,45,66,85
2013245,28,15,1985,4,"male",23,0,0,1,3,0,1,1,2
2013265,49,10,1964,4,"male",804,91,24,0,20,0,4,0,16
2013270,27,5,1986,8,"male",627,35,11,30,13,30,13,0,0
2013284,16,18,1997,5,"female",280,169,55,17,50,6,7,11,43
2013309,18,12,1995,12,"male",201,202,184,0,7,0,3,0,4
2013339,18,29,1995,3,"male",482,43,21,1,1,1,1,0,0
2013357,18,5,1995,5,"male",96,81,64,3,0,3,0,0,0
2013384,52,10,1961,6,"female",149,83,58,314,236,314,196,0,40
2013410,61,23,1952,7,"female",726,76,27,776,421,2,189,774,232
2013414,80,6,1933,12,"male",272,115,77,56,40,27,26,29,14
2013440,23,31,1990,5,"male",439,100,86,11,36,11,16,0,20
2013471,99,24,1914,4,"male",865,252,162,62,26,1,3,61,23
2013504,26,15,1987,8,"female",905,399,173,420,534,260,207,160,327
2013530,23,12,1990,1,"male",87,72,19,4,8,4,7,0,1
2013560,54,14,1959,1,"female",1073,15,6,8,2,6,1,2,1
2013569,19,10,1994,11,"male",645,345,158,9,35,8,14,1,21
2013570,18,17,1995,2,"male",193,10,3,0,0,0,0,0,0
2013583,17,25,1996,6,"male",184,136,127,5,1,0,0,5,1
2013591,36,13,1977,5,"female",1809,109,67,60,43,60,27,0,16
2013599,34,13,1979,10,"male",284,19,13,14,51,0,9,14,42
2013699,33,17,1980,2,"male",29,11,10,2,1,2,1,0,0
2013725,28,25,1985,5,"male",406,59,49,10,6,10,4,0,2
2013780,23,28,1990,10,"male",257,284,123,19,45,16,26,3,19
2013783,25,1,1988,1,"male",265,46,38,0,0,0,0,0,0
2013785,48,14,1965,3,"male",595,37,26,2,2,0,0,2,2
2013786,18,2,1995,4,"female",874,442,67,2,7,1,4,1,3
2013797,36,11,1977,10,"female",890,263,130,464,355,17,187,447,168
2013801,19,17,1994,2,"male",337,804,540,61,496,59,240,2,256
2013814,22,5,1991,6,"male",303,69,31,6,51,6,44,0,7
2013849,100,12,1913,10,"male",1728,1776,540,201,111,96,47,105,64
2013871,52,9,1961,11,"male",543,0,0,0,0,0,0,0,0
2013876,42,15,1971,4,"female",925,74,47,136,20,111,11,25,9
2013879,22,30,1991,3,"male",238,27,20,24,8,24,2,0,6
2013892,24,15,1989,8,"female",380,62,17,3,0,0,0,3,0
2013897,22,10,1991,10,"female",680,404,293,676,150,675,145,1,5
2013901,23,25,1990,10,"male",256,0,0,0,0,0,0,0,0
2013911,25,1,1988,1,"female",194,1,1,8,14,8,4,0,10
2013928,68,17,1945,8,"female",127,6,3,0,0,0,0,0,0
2013942,24,12,1989,8,"male",370,190,72,180,127,180,97,0,30
2013950,28,5,1985,5,"male",342,117,103,0,0,0,0,0,0
2013958,47,23,1966,10,"female",219,43,34,558,48,545,47,13,1
2013964,21,3,1992,2,"male",383,0,0,0,0,0,0,0,0
2013972,24,2,1989,2,"female",329,327,277,170,230,170,205,0,25
2013976,55,4,1958,7,"male",58,16,14,13,5,0,1,13,4
2013982,15,7,1998,3,"male",278,63,48,1,1,1,1,0,0
2013990,15,11,1998,7,"female",157,17,12,5,1,0,0,5,1
2014042,19,19,1994,10,"male",1024,528,346,6,9,6,7,0,2
2014061,23,23,1990,8,"male",79,105,86,7,5,7,5,0,0
2014127,48,23,1965,10,"female",1182,34,9,0,6,0,1,0,5
2014136,25,25,1988,10,"male",266,193,134,8,296,8,194,0,102
2014218,19,2,1994,2,"male",90,33,19,1,3,1,0,0,3
2014245,20,28,1993,3,"male",574,179,68,7,9,2,8,5,1
2014273,35,13,1978,7,"female",866,360,182,4,4,4,4,0,0
2014275,89,1,1924,4,"male",2219,96,33,32,66,15,29,17,37
2014299,23,2,1990,3,"male",623,990,573,1606,908,204,429,1402,479
2014301,22,2,1991,1,"female",226,7,2,1,0,0,0,1,0
2014315,54,6,1959,6,"female",228,29,22,490,12,490,11,0,1
2014346,23,14,1990,8,"male",392,55,51,7,0,0,0,7,0
2014348,17,1,1996,1,"male",646,125,90,1,1,1,1,0,0
2014352,72,8,1941,7,"male",134,211,139,4,1,4,0,0,1
2014357,25,4,1988,11,"female",483,95,35,20,17,20,14,0,3
2014368,24,12,1989,5,"male",839,99,20,0,1,0,1,0,0
2014369,28,20,1985,2,"male",258,104,55,0,1,0,0,0,1
2014372,23,8,1990,4,"male",647,121,56,6,5,6,5,0,0
2014389,28,2,1985,10,"female",263,290,156,343,423,343,336,0,87
2014400,36,3,1977,3,"male",376,92,28,0,0,0,0,0,0
2014402,56,19,1957,11,"male",472,26,16,0,0,0,0,0,0
2014403,34,9,1979,1,"male",591,36,12,8,16,4,15,4,1
2014430,25,20,1988,3,"male",456,77,47,0,0,0,0,0,0
2014433,21,6,1992,7,"female",447,257,78,48,209,48,111,0,98
2014442,17,12,1996,9,"male",268,460,302,10,182,10,135,0,47
2014445,18,21,1995,3,"female",371,267,249,50,0,50,0,0,0
2014447,84,12,1929,7,"female",2285,606,243,296,164,251,138,45,26
2014458,100,1,1913,1,NA,1870,234,183,83,81,17,43,66,38
2014462,28,10,1985,12,"male",254,42,36,0,0,0,0,0,0
2014474,75,3,1938,12,"female",1168,42,20,0,0,0,0,0,0
2014511,25,23,1988,8,"female",521,269,146,30,88,0,17,30,71
2014526,68,6,1945,5,"female",779,558,341,881,595,810,463,71,132
2014539,33,1,1980,5,"male",108,4,3,4,0,0,0,4,0
2014599,15,13,1998,9,"male",1,5,5,0,0,0,0,0,0
2014605,81,29,1932,2,"male",1344,84,40,60,6,53,1,7,5
2014609,26,26,1987,4,"female",322,739,557,1979,781,1979,555,0,226
2014619,52,24,1961,2,"male",179,54,49,0,0,0,0,0,0
2014629,23,6,1990,4,"male",355,56,35,0,201,0,175,0,26
2014672,55,26,1958,12,"male",701,119,16,10,7,0,1,10,6
2014674,16,21,1997,11,"female",272,251,165,82,25,59,18,23,7
2014684,22,25,1991,3,"female",279,93,43,111,10,111,7,0,3
2014698,61,12,1952,3,"male",1442,291,106,0,0,0,0,0,0
2014715,26,1,1987,1,"male",28,11,6,4,2,4,2,0,0
2014718,24,12,1989,2,"male",143,40,36,13,0,13,0,0,0
2014731,28,25,1985,6,"male",441,101,90,6,5,6,4,0,1
2014741,28,3,1985,9,"female",8,2,2,4,8,4,8,0,0
2014762,18,19,1995,11,"male",609,266,116,85,65,48,14,37,51
2014766,43,11,1970,10,"male",91,5,4,0,0,0,0,0,0
2014774,16,19,1997,6,"male",119,49,28,7,0,7,0,0,0
2014775,56,27,1957,3,"female",2089,255,46,235,269,235,136,0,133
2014809,18,14,1995,4,"female",915,452,317,417,539,383,307,34,232
2014825,20,14,1993,1,"male",332,75,50,19,0,19,0,0,0
2014832,55,6,1958,12,"female",566,97,57,0,2,0,1,0,1
2014852,16,22,1997,7,"female",465,142,64,17,62,17,41,0,21
2014859,44,8,1969,1,"male",579,111,33,10,34,3,27,7,7
2014897,52,9,1961,6,"male",583,128,65,2,13,2,10,0,3
2014928,38,31,1975,7,"female",259,61,47,15,48,15,27,0,21
2014938,30,15,1983,9,"female",605,126,57,259,144,259,103,0,41
2015001,18,14,1995,6,"female",590,403,198,524,1705,493,718,31,987
2015007,19,3,1994,2,"male",356,52,15,4,8,3,4,1,4
2015052,23,1,1990,1,"male",252,84,61,0,0,0,0,0,0
2015057,17,14,1996,1,"male",294,197,103,4,6,4,5,0,1
2015096,24,9,1989,11,"male",897,116,75,0,1,0,0,0,1
2015105,17,16,1996,11,"female",570,432,364,83,20,70,11,13,9
2015135,15,1,1998,5,"female",458,2225,641,2124,1486,1852,1261,272,225
2015159,23,7,1990,10,"male",515,14,14,0,0,0,0,0,0
2015182,33,1,1980,1,"male",672,56,45,40,25,40,18,0,7
2015185,16,30,1997,11,"female",410,1004,804,15,27,15,22,0,5
2015192,52,3,1961,2,"female",871,363,208,1807,562,1277,89,530,473
2015208,18,11,1995,3,"male",72,114,95,95,54,76,22,19,32
2015214,61,31,1952,12,"female",443,78,37,10,18,0,5,10,13
2015217,105,26,1908,3,"male",360,153,89,94,36,94,33,0,3
2015231,17,21,1996,7,"female",861,627,190,2,31,1,15,1,16
2015236,58,19,1955,5,"female",1528,105,47,438,185,426,59,12,126
2015247,69,25,1944,10,"male",586,30,10,61,27,50,20,11,7
2015266,50,31,1963,7,"male",526,221,164,42,82,9,19,33,63
2015281,103,23,1910,3,"male",772,172,34,5,1,5,1,0,0
2015299,23,7,1990,8,"female",173,94,91,149,47,148,40,1,7
2015368,29,31,1984,10,"male",436,22,15,0,0,0,0,0,0
2015376,38,2,1975,9,"male",476,265,119,25,7,5,5,20,2
2015390,23,1,1990,1,"female",141,4,3,0,0,0,0,0,0
2015402,17,2,1996,3,"male",454,226,149,168,89,57,45,111,44
2015432,26,7,1987,9,"male",221,47,19,36,12,36,12,0,0
2015442,37,20,1976,12,"male",1013,72,36,43,52,43,46,0,6
2015477,42,6,1971,8,"male",65,133,35,6,56,4,37,2,19
2015485,102,1,1911,1,"male",851,105,37,4,2,0,0,4,2
2015493,60,30,1953,6,"female",1000,17,9,2,20,2,18,0,2
2015495,26,12,1987,4,"female",1211,112,96,717,275,335,121,382,154
2015498,101,15,1912,2,"male",372,130,51,4,1,4,0,0,1
2015523,25,2,1988,11,"female",539,678,477,334,253,248,122,86,131
2015535,33,31,1980,8,"female",517,1,1,0,0,0,0,0,0
2015537,18,1,1995,9,"male",162,23,11,5,2,0,0,5,2
2015555,46,4,1967,9,"male",420,141,130,0,4,0,1,0,3
2015575,62,25,1951,9,"male",380,27,22,288,87,288,36,0,51
2015615,29,24,1984,10,"male",152,68,57,2,9,1,4,1,5
2015619,50,29,1963,10,"female",96,70,46,63,37,60,27,3,10
2015634,46,24,1967,2,"female",459,107,17,312,128,312,78,0,50
2015643,56,6,1957,5,"female",781,29,17,18,5,0,5,18,0
2015671,25,24,1988,9,"male",445,97,86,0,11,0,7,0,4
2015709,55,29,1958,4,"male",694,38,30,247,48,172,39,75,9
2015720,43,14,1970,2,"female",699,9,5,15,3,0,0,15,3
2015722,39,5,1974,3,"female",1472,1394,638,639,166,189,83,450,83
2015727,55,31,1958,12,"female",827,30,12,0,1,0,1,0,0
2015745,21,17,1992,6,"male",577,158,87,0,4,0,3,0,1
2015766,19,15,1994,7,"female",501,123,52,28,3,28,2,0,1
2015776,22,6,1991,1,"female",363,139,75,476,594,243,260,233,334
2015818,37,1,1976,7,"male",803,460,403,188,163,176,88,12,75
2015819,47,3,1966,1,"female",274,31,4,107,43,107,26,0,17
2015855,50,18,1963,10,"male",704,646,506,7,21,7,11,0,10
2015867,49,25,1964,10,"female",1757,477,168,2314,1324,1386,672,928,652
2015868,23,1,1990,1,"male",17,27,23,30,17,28,10,2,7
2015870,16,8,1997,2,"female",407,368,117,16,28,16,23,0,5
2015874,28,24,1985,5,"female",323,0,0,0,0,0,0,0,0
2015875,28,13,1985,4,"female",409,254,138,0,3,0,1,0,2
2015892,108,14,1905,2,"female",1826,898,620,479,306,4,173,475,133
2015899,26,8,1987,8,"male",85,94,89,7,3,7,2,0,1
2015925,70,19,1943,11,"female",765,35,29,5,8,2,7,3,1
2015936,49,21,1964,5,"male",538,9,8,17,11,0,1,17,10
2015961,22,2,1991,6,"male",247,258,226,0,0,0,0,0,0
2015962,28,3,1985,10,"male",139,28,26,4,0,4,0,0,0
2015968,26,3,1987,6,"male",77,33,32,11,2,11,2,0,0
2015971,17,1,1996,3,"male",540,4135,2450,14,62,0,51,14,11
2015976,31,30,1982,9,"female",113,41,25,7,10,6,4,1,6
2015985,47,16,1966,2,"female",802,168,146,1,6,1,6,0,0
2015988,31,12,1982,4,"female",425,47,23,26,39,26,33,0,6
2016045,21,3,1992,4,"male",181,107,105,1,1,0,1,1,0
2016056,32,31,1981,12,"female",196,133,113,45,54,45,37,0,17
2016073,25,7,1988,9,"male",145,82,49,0,1,0,0,0,1
2016085,108,13,1905,3,"female",942,82,48,0,0,0,0,0,0
2016092,28,15,1985,1,"male",457,0,0,0,0,0,0,0,0
2016110,53,10,1960,11,"male",38,15,13,0,0,0,0,0,0
2016176,25,26,1988,6,"female",427,737,675,1,4,0,4,1,0
2016178,33,1,1980,1,"female",523,66,47,7,11,7,11,0,0
2016180,26,26,1987,1,"male",271,18,11,0,0,0,0,0,0
2016190,24,1,1989,1,"female",67,5,4,10,12,10,11,0,1
2016261,33,26,1980,9,"female",610,151,100,1255,657,1162,481,93,176
2016266,26,14,1987,2,"male",83,0,0,1,0,0,0,1,0
2016278,43,23,1970,4,"male",684,28,4,34,11,34,11,0,0
2016281,68,17,1945,2,"male",489,374,303,1,5,1,5,0,0
2016293,15,8,1998,2,"male",353,241,202,121,26,117,20,4,6
2016304,24,11,1989,10,"male",131,39,30,22,12,22,6,0,6
2016333,69,1,1944,12,"female",928,27,20,1,1,1,1,0,0
2016352,33,9,1980,9,"male",460,2,2,0,0,0,0,0,0
2016364,28,18,1985,5,"male",92,8,8,12,15,12,15,0,0
2016377,33,20,1980,12,"male",416,0,0,0,0,0,0,0,0
2016379,43,30,1970,9,"female",458,30,17,322,44,322,31,0,13
2016422,21,5,1992,7,"female",90,12,4,22,2,22,2,0,0
2016438,21,7,1992,3,"female",454,422,163,1005,819,24,273,981,546
2016439,19,23,1994,5,"male",77,71,46,9,7,9,5,0,2
2016465,21,4,1992,10,"male",562,281,159,43,30,41,23,2,7
2016473,36,24,1977,6,"male",70,41,32,8,2,8,2,0,0
2016480,19,9,1994,5,"male",14,8,7,1,0,1,0,0,0
2016525,19,25,1994,5,"male",46,10,2,0,0,0,0,0,0
2016544,46,14,1967,4,"male",204,57,37,4,0,0,0,4,0
2016551,21,26,1992,10,"male",211,57,37,0,0,0,0,0,0
2016552,34,1,1979,1,"male",94,6,3,90,26,86,26,4,0
2016555,31,13,1982,10,"male",280,172,155,5,12,5,12,0,0
2016559,36,9,1977,10,"male",174,144,77,48,70,48,44,0,26
2016596,25,20,1988,3,"male",139,101,29,6,0,6,0,0,0
2016605,18,28,1995,1,"female",202,80,31,704,145,704,111,0,34
2016615,18,2,1995,10,"female",384,212,73,170,256,35,164,135,92
2016636,21,29,1992,7,"male",380,9,9,3,0,0,0,3,0
2016665,27,17,1986,5,"male",406,30,24,0,0,0,0,0,0
2016682,23,1,1990,1,"female",211,12,6,2,3,2,3,0,0
2016701,23,1,1990,12,"female",130,127,92,50,38,50,36,0,2
2016707,37,28,1976,4,"female",1121,1282,1011,1007,845,461,246,546,599
2016714,62,26,1951,11,"male",706,93,75,16,23,0,17,16,6
2016747,24,1,1989,1,"male",90,6,4,0,5,0,1,0,4
2016748,22,1,1991,1,"male",333,20,20,0,0,0,0,0,0
2016753,47,20,1966,1,"female",390,91,55,8,3,8,0,0,3
2016802,18,24,1995,4,"male",257,51,34,6,12,6,1,0,11
2016869,18,2,1995,7,"female",467,236,180,2,15,2,15,0,0
2016882,57,5,1956,11,"female",729,188,100,22,60,2,26,20,34
2016889,50,6,1963,11,"male",104,0,0,0,0,0,0,0,0
2016898,29,7,1984,9,"female",684,185,80,209,14,205,10,4,4
2016903,25,1,1988,1,"female",97,11,11,9,5,9,1,0,4
2016963,21,15,1992,3,"male",456,184,88,5,10,0,6,5,4
2016975,33,24,1980,6,"male",703,559,353,3,10,3,10,0,0
2016990,21,15,1992,7,"female",345,37,4,4,36,4,33,0,3
2017014,26,1,1987,1,"male",347,86,70,74,246,74,210,0,36
2017016,71,17,1942,11,"male",642,25,12,6,8,6,7,0,1
2017023,21,25,1992,7,"female",21,6,6,34,12,27,3,7,9
2017031,24,6,1989,3,"male",745,34,8,2,4,2,4,0,0
2017057,27,10,1986,11,"male",222,93,31,1,0,1,0,0,0
2017074,24,4,1989,8,"male",502,124,88,18,26,18,12,0,14
2017088,65,12,1948,11,"female",53,27,24,2,0,2,0,0,0
2017103,30,30,1983,3,"male",26,11,11,0,0,0,0,0,0
2017161,21,23,1992,9,"male",219,243,228,59,30,59,30,0,0
2017215,47,23,1966,11,"male",317,1,1,2,0,2,0,0,0
2017244,39,6,1974,9,"male",437,18,13,0,0,0,0,0,0
2017284,36,24,1977,8,"male",392,27,19,4,17,4,17,0,0
2017292,28,12,1985,9,"male",857,175,155,55,36,22,19,33,17
2017313,22,20,1991,9,"male",331,45,22,5,11,5,7,0,4
2017333,53,24,1960,1,"female",328,86,61,329,135,329,40,0,95
2017371,19,18,1994,4,"male",269,92,47,124,2,124,2,0,0
2017383,35,3,1978,7,"male",457,0,0,0,0,0,0,0,0
2017402,15,19,1998,10,"male",164,410,357,7,36,7,26,0,10
2017409,24,7,1989,1,"male",65,42,31,18,3,18,3,0,0
2017432,20,5,1993,3,"male",392,38,1,0,12,0,3,0,9
2017437,26,25,1987,11,"male",575,59,41,0,0,0,0,0,0
2017453,33,30,1980,6,"male",241,112,76,40,10,40,4,0,6
2017492,20,23,1993,9,"male",240,6,2,69,3,4,3,65,0
2017494,52,24,1961,8,"male",742,5,5,0,0,0,0,0,0
2017498,27,10,1986,10,"male",693,288,192,4,46,4,40,0,6
2017531,45,28,1968,5,"male",225,60,21,0,0,0,0,0,0
2017537,20,13,1993,10,"male",411,129,75,171,333,157,226,14,107
2017576,18,22,1995,1,"female",456,602,461,2133,1056,2133,990,0,66
2017580,24,31,1989,8,"female",472,206,162,114,1,114,1,0,0
2017585,45,15,1968,12,"female",815,272,192,2010,1819,2010,1485,0,334
2017594,20,4,1993,11,"male",230,169,115,84,54,78,38,6,16
2017648,42,23,1971,8,"female",678,25,11,3,0,0,0,3,0
2017667,19,24,1994,5,"female",448,1294,271,4267,2623,473,1912,3794,711
2017668,28,25,1985,12,"female",1364,74,38,13,115,13,96,0,19
2017682,101,23,1912,3,"male",1349,240,113,32,75,32,53,0,22
2017684,17,8,1996,10,"female",349,524,317,39,42,39,32,0,10
2017712,28,5,1985,6,"male",313,10,2,0,0,0,0,0,0
2017714,19,5,1994,5,"male",398,22,17,8,4,6,0,2,4
2017740,32,3,1981,7,"male",683,48,22,0,0,0,0,0,0
2017741,31,17,1982,7,"female",304,155,63,207,348,207,259,0,89
2017755,28,18,1985,8,"male",272,61,30,0,0,0,0,0,0
2017762,26,8,1987,10,"male",27,11,3,0,0,0,0,0,0
2017769,17,16,1996,10,"male",208,29,26,18,1,18,1,0,0
2017786,20,19,1993,8,"male",614,415,300,73,282,73,230,0,52
2017824,16,13,1997,10,"female",67,279,235,1183,239,1183,206,0,33
2017837,24,2,1989,5,"male",63,70,60,0,0,0,0,0,0
2017852,19,12,1994,7,"male",628,217,113,0,0,0,0,0,0
2017854,18,14,1995,10,"male",106,97,86,1,1,1,1,0,0
2017864,93,15,1920,4,"male",1291,40,6,135,1,0,1,135,0
2017873,38,3,1975,11,"male",505,40,34,0,3,0,1,0,2
2017939,55,22,1958,10,"female",938,73,49,123,56,26,12,97,44
2017974,19,7,1994,3,"male",916,118,64,0,7,0,2,0,5
2017975,30,8,1983,4,"male",521,718,598,1,0,1,0,0,0
2018005,20,11,1993,7,"male",492,52,32,2,1,0,1,2,0
2018038,31,13,1982,2,"male",600,2,0,0,0,0,0,0,0
2018065,28,13,1985,7,"female",75,5,3,51,103,31,51,20,52
2018102,17,6,1996,10,"male",102,81,75,1,0,1,0,0,0
2018127,22,26,1991,10,"male",123,34,28,1,0,0,0,1,0
2018142,25,14,1988,10,"male",166,18,12,6,5,4,4,2,1
2018147,29,5,1984,5,"male",241,24,17,0,0,0,0,0,0
2018164,19,25,1994,9,"male",16,0,0,0,0,0,0,0,0
2018169,19,4,1994,7,"male",317,121,84,3,0,3,0,0,0
2018187,40,3,1973,4,"male",644,40,19,8,43,6,33,2,10
2018225,37,5,1976,9,"male",600,0,0,0,0,0,0,0,0
2018233,20,20,1993,3,"male",364,78,61,4,0,4,0,0,0
2018265,20,4,1993,11,"male",446,458,49,0,1,0,0,0,1
2018270,30,29,1983,8,"female",142,50,23,10,23,10,10,0,13
2018316,91,8,1922,8,"male",665,149,79,10,13,10,11,0,2
2018323,34,25,1979,11,"male",180,16,12,34,14,34,13,0,1
2018333,103,4,1910,11,"female",142,413,172,125,189,105,109,20,80
2018359,30,20,1983,1,"male",234,27,25,6,1,6,1,0,0
2018360,30,9,1983,9,"male",354,116,56,3,16,3,7,0,9
2018383,22,6,1991,7,"male",31,5,5,22,1,22,1,0,0
2018391,108,13,1905,9,"female",683,92,39,12,6,12,6,0,0
2018395,19,19,1994,4,"male",50,55,5,0,3,0,0,0,3
2018434,15,29,1998,4,"female",490,1162,910,459,1088,459,1068,0,20
2018438,17,2,1996,2,"female",397,13,11,52,71,15,42,37,29
2018462,25,13,1988,12,"female",190,7,3,0,0,0,0,0,0
2018466,36,17,1977,2,"male",76,95,73,287,460,287,422,0,38
2018516,20,8,1993,1,"female",638,458,334,127,34,127,26,0,8
2018517,19,17,1994,9,"male",279,143,120,3,2,3,0,0,2
2018524,53,5,1960,4,"female",227,404,141,8,91,8,72,0,19
2018556,20,2,1993,2,"male",233,104,88,8,8,8,6,0,2
2018558,57,25,1956,6,"female",850,61,43,5,24,0,18,5,6
2018562,63,29,1950,9,"female",1841,141,51,34,130,0,43,34,87
2018576,58,27,1955,5,"female",83,24,11,26,3,26,1,0,2
2018605,21,14,1992,5,"male",997,45,38,22,2,4,2,18,0
2018614,50,4,1963,4,"male",292,24,19,0,0,0,0,0,0
2018616,24,14,1989,12,"male",243,107,59,53,0,53,0,0,0
2018619,56,8,1957,10,"female",526,32,25,9,0,0,0,9,0
2018624,25,24,1988,9,"male",256,57,44,3,0,0,0,3,0
2018670,25,6,1988,4,"male",370,413,232,9,207,9,131,0,76
2018674,25,18,1988,11,"female",320,146,113,14,94,14,84,0,10
2018692,27,16,1986,9,"male",522,67,35,1,0,1,0,0,0
2018693,68,7,1945,9,"female",41,33,21,1,5,1,4,0,1
2018696,20,28,1993,4,"female",1744,197,88,324,100,303,78,21,22
2018700,33,12,1980,2,"female",352,53,20,67,109,67,64,0,45
2018713,43,7,1970,6,"male",823,2,0,5,2,0,0,5,2
2018730,45,18,1968,1,"male",703,240,180,8,12,8,11,0,1
2018740,23,4,1990,5,"male",207,2,2,0,0,0,0,0,0
2018756,33,14,1980,4,"female",118,110,71,37,47,0,9,37,38
2018761,19,7,1994,3,"female",465,356,105,19,76,19,49,0,27
2018769,27,21,1986,5,"male",334,9,9,25,0,0,0,25,0
2018776,21,23,1992,9,"female",192,826,393,133,227,133,180,0,47
2018796,55,21,1958,6,"male",543,22,4,1,3,0,1,1,2
2018799,43,26,1970,5,"female",313,33,14,0,0,0,0,0,0
2018802,63,23,1950,2,"male",126,43,41,132,14,132,11,0,3
2018805,55,11,1958,2,"female",368,72,55,156,17,0,4,156,13
2018812,44,11,1969,3,"male",192,96,81,377,91,377,76,0,15
2018852,25,8,1988,3,"male",279,269,135,2,1,0,1,2,0
2018860,73,2,1940,5,"male",1860,42,9,0,0,0,0,0,0
2018869,56,25,1957,3,"male",907,23,17,3,1,3,1,0,0
2018874,43,1,1970,3,"male",438,257,131,22,17,22,10,0,7
2018875,16,21,1997,11,"female",96,288,247,2933,226,2933,163,0,63
2018879,17,13,1996,9,"male",177,137,114,11,3,0,2,11,1
2018880,23,2,1990,11,"male",303,129,116,50,50,50,36,0,14
2018887,78,20,1935,9,"male",896,31,12,2,6,0,3,2,3
2018925,20,17,1993,10,"female",255,55,26,24,37,24,25,0,12
2018931,24,29,1989,6,"male",11,0,0,0,0,0,0,0,0
2018950,58,12,1955,3,"male",410,2,1,0,4,0,3,0,1
2018959,38,20,1975,4,"female",2314,266,156,760,861,709,688,51,173
2018973,14,8,1999,5,"male",501,43,4,0,3,0,3,0,0
2018981,16,22,1997,6,"male",857,110,92,13,27,12,18,1,9
2018984,45,22,1968,12,"male",598,24,15,12,4,12,1,0,3
2018991,21,11,1992,4,"male",720,263,186,19,0,13,0,6,0
2019005,26,1,1987,1,"male",173,8,8,0,0,0,0,0,0
2019016,19,31,1994,8,"male",191,309,258,2,8,2,4,0,4
2019019,17,3,1996,2,"male",133,83,62,0,0,0,0,0,0
2019029,48,17,1965,2,"male",1119,67,19,1,8,1,6,0,2
2019036,45,1,1968,1,"female",675,31,17,1,0,1,0,0,0
2019055,62,5,1951,11,"male",668,51,34,7,4,0,0,7,4
2019078,28,3,1985,11,"female",419,2,2,4,5,4,3,0,2
2019123,33,1,1980,1,"male",165,98,96,0,1,0,0,0,1
2019132,31,20,1982,1,"male",544,10,1,0,0,0,0,0,0
2019152,22,6,1991,2,"male",343,5,4,0,0,0,0,0,0
2019174,21,8,1992,12,"male",207,150,147,17,11,0,10,17,1
2019175,25,10,1988,12,"female",447,181,105,9,7,9,7,0,0
2019196,23,20,1990,11,"male",698,24,18,2,0,2,0,0,0
2019205,39,30,1974,3,"male",123,14,9,1,0,1,0,0,0
2019209,24,20,1989,7,"male",10,14,10,26,16,26,16,0,0
2019226,27,5,1986,2,"male",399,117,95,16,46,6,5,10,41
2019229,16,25,1997,4,"male",554,135,66,6,21,6,9,0,12
2019247,15,31,1998,5,"female",325,1174,1061,0,8,0,6,0,2
2019264,22,20,1991,8,"male",570,157,67,12,52,12,51,0,1
2019269,17,26,1996,3,"male",216,265,114,10,5,10,1,0,4
2019282,64,15,1949,12,"male",1509,42,13,2,0,2,0,0,0
2019305,19,23,1994,12,"male",244,70,44,7,9,7,8,0,1
2019320,20,1,1993,1,"female",1,5,4,25,41,25,41,0,0
2019352,21,21,1992,11,"female",525,257,100,25,0,25,0,0,0
2019366,56,2,1957,5,"male",1094,18,6,0,0,0,0,0,0
2019426,19,20,1994,9,"female",347,192,159,130,268,128,228,2,40
2019428,16,10,1997,1,"female",421,410,386,1,6,0,4,1,2
2019475,23,31,1990,5,"female",283,90,38,61,6,61,3,0,3
2019505,33,6,1980,1,"male",562,28,18,37,13,37,13,0,0
2019608,61,1,1952,1,"male",422,68,57,23,64,23,19,0,45
2019625,20,24,1993,7,"male",905,280,236,0,1,0,1,0,0
2019629,24,26,1989,5,"male",824,268,78,10,1,10,1,0,0
2019633,23,14,1990,11,"male",362,89,43,0,0,0,0,0,0
2019702,24,19,1989,12,"male",290,9,1,4,1,0,0,4,1
2019704,61,4,1952,4,"male",1659,152,114,11,1,2,1,9,0
2019710,85,31,1928,5,"male",28,55,54,0,5,0,3,0,2
2019727,50,1,1963,1,"male",589,1,0,0,0,0,0,0,0
2019751,41,20,1972,10,"female",221,7,4,5,18,0,18,5,0
2019780,19,22,1994,5,"female",328,30,16,291,405,79,129,212,276
2019784,20,7,1993,2,"male",503,13,10,2,0,2,0,0,0
2019809,40,23,1973,11,"male",998,142,79,5,32,4,23,1,9
2019828,24,7,1989,9,"female",1344,121,30,2,1,0,0,2,1
2019839,18,3,1995,10,"female",414,430,310,4,23,4,13,0,10
2019851,35,22,1978,11,"female",651,11,8,1,0,1,0,0,0
2019886,17,19,1996,6,"female",510,65,49,32,24,12,0,20,24
2019888,66,9,1947,6,"male",1411,102,46,1,1,1,1,0,0
2019905,108,1,1905,7,NA,1332,967,537,150,1311,76,671,74,640
2019919,102,28,1911,8,"male",926,201,135,134,55,13,1,121,54
2019927,25,1,1988,1,"male",942,184,143,21,21,21,20,0,1
2019930,23,5,1990,12,"male",399,158,143,8,0,8,0,0,0
2019938,14,24,1999,4,"male",82,12,10,0,0,0,0,0,0
2019951,25,1,1988,1,"female",144,10,6,0,0,0,0,0,0
2019983,22,30,1991,8,"male",266,124,107,0,0,0,0,0,0
2019989,16,11,1997,11,"male",24,191,116,1,2,1,2,0,0
2019994,19,7,1994,11,"male",324,127,85,3,1,3,1,0,0
2020004,27,20,1986,7,"female",1082,191,126,11,49,11,30,0,19
2020052,25,30,1988,8,"female",65,225,60,1293,826,1288,638,5,188
2020053,78,23,1935,9,"female",1226,9,6,0,0,0,0,0,0
2020072,95,27,1918,11,"male",1497,338,139,13,39,10,37,3,2
2020073,26,1,1987,8,"male",482,37,17,7,2,7,2,0,0
2020077,19,17,1994,5,"male",627,39,37,1,0,0,0,1,0
2020083,55,5,1958,11,"female",433,43,20,73,36,73,35,0,1
2020120,63,15,1950,2,"female",127,44,22,481,94,481,72,0,22
2020124,21,8,1992,3,"male",63,13,8,19,4,19,4,0,0
2020183,16,14,1997,3,"female",335,1988,77,8,111,8,75,0,36
2020194,45,17,1968,2,"male",1209,5,3,2,0,2,0,0,0
2020208,62,31,1951,12,"female",463,19,10,0,4,0,2,0,2
2020220,53,7,1960,3,"male",646,33,12,32,106,0,59,32,47
2020251,79,24,1934,12,"male",1155,45,20,0,0,0,0,0,0
2020279,22,14,1991,7,"male",667,299,215,460,129,460,116,0,13
2020283,34,6,1979,6,"female",715,39,20,0,7,0,3,0,4
2020312,29,12,1984,6,"male",185,3,3,0,0,0,0,0,0
2020324,29,3,1984,8,"male",393,26,17,0,0,0,0,0,0
2020346,17,5,1996,7,"female",323,853,435,1064,3148,287,959,777,2189
2020370,96,31,1917,10,"male",660,184,128,41,8,41,4,0,4
2020382,69,25,1944,7,"male",1699,124,56,139,1,52,0,87,1
2020386,43,19,1970,11,"male",105,54,42,1,6,1,1,0,5
2020406,69,22,1944,11,"male",1855,30,12,0,1,0,0,0,1
2020413,26,25,1987,12,"female",357,40,13,33,28,33,20,0,8
2020414,48,2,1965,6,"male",1849,30,8,26,17,26,8,0,9
2020419,19,10,1994,2,"female",247,4,3,0,0,0,0,0,0
2020433,18,29,1995,12,"female",480,390,151,141,67,80,9,61,58
2020436,107,13,1906,1,"male",2269,314,213,196,560,74,271,122,289
2020444,24,25,1989,2,"female",245,28,9,0,0,0,0,0,0
2020469,15,14,1998,2,"male",274,156,153,2,0,2,0,0,0
2020480,63,11,1950,4,"female",497,51,20,411,147,14,40,397,107
2020515,54,10,1959,2,"female",139,86,67,22,7,22,6,0,1
2020526,30,10,1983,4,"male",182,1,1,1,0,1,0,0,0
2020532,18,15,1995,9,"female",101,121,79,11,18,11,6,0,12
2020537,15,30,1998,6,"male",63,0,0,0,0,0,0,0,0
2020546,43,24,1970,10,"female",74,333,201,1994,1099,1994,844,0,255
2020552,35,8,1978,2,"female",108,66,48,4,10,4,8,0,2
2020579,60,17,1953,10,"male",247,23,12,11,13,11,8,0,5
2020586,100,8,1913,2,"female",1338,81,52,1,53,1,3,0,50
2020591,108,6,1905,10,"male",184,95,76,29,38,26,31,3,7
2020601,26,28,1987,3,"male",208,208,175,156,103,46,16,110,87
2020621,15,18,1998,8,"female",209,438,209,2,0,1,0,1,0
2020657,15,2,1998,2,"male",126,28,20,1,3,1,2,0,1
2020663,33,25,1980,6,"female",584,126,85,184,294,144,99,40,195
2020680,44,24,1969,12,"female",227,35,13,322,189,303,41,19,148
2020690,15,12,1998,12,"female",101,152,101,0,0,0,0,0,0
2020699,41,18,1972,9,"male",239,28,10,0,0,0,0,0,0
2020703,42,13,1971,2,"male",152,34,19,12,15,12,11,0,4
2020727,19,3,1994,6,"male",413,722,672,0,49,0,0,0,49
2020736,39,31,1974,10,"male",1549,53,22,2,44,2,15,0,29
2020766,53,21,1960,1,"female",393,50,38,336,145,333,72,3,73
2020778,15,17,1998,6,"female",158,432,308,1755,1028,94,288,1661,740
2020785,43,3,1970,6,"female",704,50,28,42,16,40,10,2,6
2020797,15,24,1998,7,"female",418,1144,723,1780,547,1750,402,30,145
2020800,14,19,1999,7,"male",270,141,66,1,1,0,0,1,1
2020827,13,4,2000,1,"male",254,92,75,3,3,2,2,1,1
2020835,17,1,1996,8,"male",396,58,41,44,0,39,0,5,0
2020844,36,19,1977,8,"male",23,12,12,8,1,8,1,0,0
2020847,59,15,1954,7,"female",539,26,4,20,28,8,18,12,10
2020928,66,11,1947,3,"female",910,85,45,23,9,6,3,17,6
2020967,57,3,1956,1,"female",2092,274,109,1087,407,387,159,700,248
2020996,25,30,1988,12,"male",162,18,15,2,1,1,1,1,0
2021024,20,7,1993,2,"male",901,357,226,14,0,14,0,0,0
2021032,70,17,1943,8,"female",29,8,7,4,0,4,0,0,0
2021056,56,16,1957,12,"male",843,114,73,1309,544,875,202,434,342
2021058,26,8,1987,10,"male",325,28,26,624,9,522,5,102,4
2021059,29,8,1984,2,"male",323,165,109,25,99,25,87,0,12
2021060,47,9,1966,5,"male",503,3,2,0,0,0,0,0,0
2021065,40,28,1973,7,"male",742,102,70,100,29,100,29,0,0
2021089,36,23,1977,6,"female",217,11,10,0,0,0,0,0,0
2021097,57,18,1956,6,"female",441,99,79,1,2,1,2,0,0
2021124,18,13,1995,7,"male",230,124,40,16,21,0,1,16,20
2021133,87,9,1926,10,"male",1432,248,96,0,3,0,3,0,0
2021136,18,20,1995,2,"female",529,254,72,300,323,263,202,37,121
2021145,25,12,1988,3,"male",176,64,34,3761,135,3757,64,4,71
2021157,67,16,1946,3,"female",1014,65,21,5,119,1,91,4,28
2021256,108,15,1905,5,"female",1648,457,138,11,3,10,2,1,1
2021258,28,30,1985,4,"female",2521,155,100,152,291,117,215,35,76
2021266,27,6,1986,12,"male",24,0,0,0,0,0,0,0,0
2021324,57,30,1956,12,"male",457,126,112,1,0,0,0,1,0
2021336,30,26,1983,11,"male",1716,370,193,1,0,0,0,1,0
2021341,17,12,1996,11,"female",435,13,7,140,15,23,2,117,13
2021376,79,25,1934,7,"female",208,30,29,2,0,0,0,2,0
2021384,19,8,1994,12,"male",113,131,115,0,0,0,0,0,0
2021394,27,1,1986,1,"male",438,14,12,14,49,1,19,13,30
2021401,29,31,1984,12,"female",592,1,0,0,0,0,0,0,0
2021430,20,13,1993,11,"male",283,178,132,2756,655,1095,360,1661,295
2021460,31,20,1982,6,"male",612,81,65,9,11,9,9,0,2
2021466,22,14,1991,5,"male",198,141,40,206,86,206,80,0,6
2021504,67,18,1946,7,"female",1062,84,37,4,17,2,9,2,8
2021508,56,2,1957,4,"female",569,40,34,183,92,166,56,17,36
2021521,28,1,1985,1,"male",41,0,0,1,1,1,0,0,1
2021539,27,20,1986,7,"female",1264,36,21,130,223,130,122,0,101
2021567,18,13,1995,2,"female",416,357,157,15,3,15,3,0,0
2021570,45,5,1968,8,"male",458,24,13,0,0,0,0,0,0
2021597,18,6,1995,4,"male",256,107,70,579,61,579,21,0,40
2021598,57,17,1956,7,"male",1309,168,55,5,32,1,12,4,20
2021610,54,4,1959,7,"female",544,43,11,48,16,1,10,47,6
2021618,18,17,1995,12,"male",371,78,27,196,35,190,28,6,7
2021634,16,19,1997,4,"female",241,10,6,0,0,0,0,0,0
2021640,54,25,1959,10,"female",538,3,2,0,0,0,0,0,0
2021651,36,10,1977,11,"male",259,35,24,10,6,10,5,0,1
2021652,71,7,1942,10,"male",1059,12,6,49,15,0,5,49,10
2021688,94,9,1919,6,"male",918,198,149,7,1,7,1,0,0
2021711,65,21,1948,9,"male",1821,20,4,24,19,15,8,9,11
2021720,31,8,1982,4,"female",396,169,151,0,0,0,0,0,0
2021728,24,19,1989,9,"female",100,130,94,93,145,93,131,0,14
2021743,21,17,1992,11,"male",535,340,137,35,98,32,54,3,44
2021762,22,1,1991,3,"male",387,92,63,2,1,1,1,1,0
2021764,94,10,1919,4,"male",1880,45,21,3,3,3,2,0,1
2021778,70,18,1943,5,"male",655,251,178,113,4,0,1,113,3
2021811,36,9,1977,10,"male",622,293,256,0,6,0,1,0,5
2021818,20,1,1993,5,"male",468,612,528,37,14,24,8,13,6
2021824,108,29,1905,10,"female",985,692,525,15,11,6,9,9,2
2021837,25,17,1988,7,"female",178,87,69,164,109,164,74,0,35
2021857,18,19,1995,12,"male",169,370,329,24,1,1,0,23,1
2021868,19,13,1994,11,"male",227,34,21,1,0,1,0,0,0
2021897,22,24,1991,9,"male",496,225,122,190,23,166,10,24,13
2021937,30,3,1983,10,"female",506,42,24,7,9,7,8,0,1
2021975,28,17,1985,5,"male",604,27,21,0,0,0,0,0,0
2022004,47,12,1966,1,"female",168,133,66,641,93,641,81,0,12
2022016,95,1,1918,9,"male",807,2337,334,32,599,0,164,32,435
2022048,27,22,1986,12,"male",63,14,8,4,0,4,0,0,0
2022101,20,26,1993,2,"male",147,3,2,0,0,0,0,0,0
2022112,25,20,1988,1,"male",335,1,0,0,0,0,0,0,0
2022116,21,5,1992,8,"male",29,8,8,0,0,0,0,0,0
2022122,46,4,1967,10,"male",255,204,144,70,67,12,44,58,23
2022131,43,7,1970,2,"female",200,62,36,0,0,0,0,0,0
2022147,39,26,1974,8,"male",112,46,34,2,13,2,7,0,6
2022161,21,2,1992,2,"male",439,64,64,26,13,26,11,0,2
2022172,63,15,1950,9,"female",411,0,0,0,0,0,0,0,0
2022175,20,5,1993,11,"female",40,42,9,10,19,10,19,0,0
2022203,47,21,1966,10,"male",635,36,23,60,18,60,8,0,10
2022206,14,17,1999,6,"female",182,150,101,828,38,777,19,51,19
2022218,25,30,1988,3,"female",426,166,145,1,0,0,0,1,0
2022228,33,10,1980,8,"male",320,9,9,17,0,0,0,17,0
2022235,16,4,1997,11,"female",84,254,97,218,154,215,73,3,81
2022258,31,16,1982,5,"male",974,122,73,43,45,36,21,7,24
2022283,19,5,1994,10,"male",214,406,157,85,138,85,90,0,48
2022295,47,26,1966,10,"male",640,13,2,4,3,4,2,0,1
2022317,14,11,1999,5,"female",157,14,3,0,10,0,6,0,4
2022323,92,20,1921,1,"male",203,55,44,3,17,1,6,2,11
2022371,15,18,1998,6,"female",779,720,441,2093,382,2002,224,91,158
2022397,29,16,1984,4,"female",79,195,176,764,510,169,335,595,175
2022402,14,2,1999,7,"male",475,60,27,0,0,0,0,0,0
2022429,19,14,1994,1,"male",146,1,1,1,0,1,0,0,0
2022440,21,5,1992,7,"female",968,195,89,158,193,50,113,108,80
2022446,36,31,1977,12,"female",151,57,40,1,4,1,4,0,0
2022460,32,23,1981,6,"male",412,671,611,823,310,823,232,0,78
2022477,50,4,1963,6,"female",1330,1185,873,1959,545,1657,165,302,380
2022485,25,22,1988,11,"male",77,8,8,0,0,0,0,0,0
2022492,18,1,1995,10,"male",145,23,19,1,3,0,0,1,3
2022510,23,17,1990,1,"female",675,67,38,1,2,1,2,0,0
2022516,34,10,1979,11,"female",1489,202,61,2452,3520,1859,2970,593,550
2022591,35,20,1978,7,"female",149,62,48,108,113,73,34,35,79
2022632,16,18,1997,2,"male",3,7,7,1,0,0,0,1,0
2022661,29,19,1984,9,"female",1229,729,421,140,100,33,35,107,65
2022667,28,2,1985,8,"female",453,372,172,2,92,0,37,2,55
2022668,26,24,1987,9,"female",88,42,7,0,3,0,3,0,0
2022670,20,9,1993,2,"male",338,402,260,5,3,0,0,5,3
2022677,30,21,1983,12,"male",289,1,1,0,0,0,0,0,0
2022682,51,16,1962,3,"male",23,47,33,23,43,23,26,0,17
2022715,34,27,1979,3,"female",445,213,125,2,8,0,7,2,1
2022720,19,11,1994,12,"female",388,169,95,426,73,1,16,425,57
2022724,52,19,1961,6,"male",133,0,0,0,0,0,0,0,0
2022737,32,13,1981,7,"male",222,17,2,0,4,0,0,0,4
2022740,20,24,1993,8,"female",413,53,10,14,7,14,4,0,3
2022741,33,5,1980,9,"female",532,117,57,132,125,102,61,30,64
2022745,49,2,1964,11,"female",443,257,119,0,0,0,0,0,0
2022750,28,8,1985,4,"male",367,262,142,31,54,31,32,0,22
2022781,31,19,1982,6,"female",1407,232,128,408,607,384,533,24,74
2022802,20,10,1993,3,"female",270,24,14,36,39,33,36,3,3
2022803,66,21,1947,10,"male",1105,346,193,652,657,16,239,636,418
2022804,18,1,1995,1,"female",367,306,154,10,9,7,7,3,2
2022882,63,15,1950,6,"female",90,60,48,0,32,0,13,0,19
2022892,33,15,1980,4,"male",260,93,84,134,132,134,128,0,4
2022911,27,15,1986,7,"male",132,65,57,29,8,8,5,21,3
2022933,92,7,1921,7,"female",644,6,2,4,9,0,1,4,8
2022937,21,6,1992,8,"female",278,309,161,3,1,3,1,0,0
2022940,30,23,1983,1,"male",573,31,12,66,87,66,85,0,2
2022941,57,7,1956,11,"female",2005,411,230,344,784,309,228,35,556
2022961,107,3,1906,8,"male",1284,503,327,33,2,33,2,0,0
2022971,26,31,1987,7,"female",465,183,151,64,60,46,33,18,27
2022976,23,2,1990,2,"male",475,76,45,0,0,0,0,0,0
2023047,63,7,1950,11,"female",1406,36,13,1689,58,7,25,1682,33
2023054,19,9,1994,8,"female",149,55,44,56,28,56,23,0,5
2023116,21,14,1992,11,"female",532,462,88,1916,967,39,127,1877,840
2023128,28,2,1985,12,"male",790,52,44,0,0,0,0,0,0
2023137,26,10,1987,6,"female",258,33,10,137,155,137,102,0,53
2023146,48,10,1965,6,"male",488,109,76,34,12,34,4,0,8
2023147,59,16,1954,1,"male",782,60,38,2,8,1,4,1,4
2023162,15,10,1998,2,"male",503,2,2,0,0,0,0,0,0
2023173,25,12,1988,8,"male",155,136,107,7,7,7,7,0,0
2023194,19,17,1994,3,"female",90,25,14,1761,257,1761,234,0,23
2023237,31,30,1982,3,"female",366,96,37,13,50,13,34,0,16
2023268,39,14,1974,4,"female",652,53,36,3,0,3,0,0,0
2023269,73,4,1940,9,"male",142,26,23,1,0,0,0,1,0
2023293,25,25,1988,10,"female",1633,236,56,7,11,5,6,2,5
2023304,18,25,1995,11,"female",677,479,279,173,24,45,18,128,6
2023307,17,18,1996,12,"male",276,337,206,47,45,47,41,0,4
2023336,66,25,1947,10,"male",1386,177,73,55,22,6,1,49,21
2023350,30,12,1983,10,"female",140,314,143,243,708,243,498,0,210
2023418,24,1,1989,9,"female",499,1650,412,2230,8340,2230,7170,0,1170
2023421,52,5,1961,3,"male",514,229,184,39,50,39,44,0,6
2023422,38,15,1975,9,"male",648,42,20,0,0,0,0,0,0
2023430,88,25,1925,9,"female",300,63,22,39,6,39,4,0,2
2023459,55,27,1958,4,"female",1512,118,48,163,157,124,133,39,24
2023466,23,8,1990,8,"male",52,22,21,14,3,14,3,0,0
2023470,33,19,1980,2,"male",889,252,145,0,2,0,2,0,0
2023487,31,1,1982,1,"male",301,29,28,54,45,54,28,0,17
2023541,42,18,1971,12,"female",184,215,194,370,252,370,128,0,124
2023556,55,22,1958,2,"male",127,43,34,382,93,382,74,0,19
2023567,54,22,1959,6,"male",807,187,86,0,2,0,1,0,1
2023589,62,7,1951,8,"female",549,26,14,229,84,0,27,229,57
2023625,23,3,1990,4,"male",632,231,182,130,1,130,0,0,1
2023656,21,19,1992,11,"female",225,14,11,288,117,55,11,233,106
2023667,27,25,1986,7,"male",790,161,69,0,0,0,0,0,0
2023671,45,4,1968,12,"male",431,0,0,0,0,0,0,0,0
2023676,56,23,1957,12,"male",170,121,83,28,59,0,13,28,46
2023680,25,18,1988,7,"female",692,3,3,207,0,86,0,121,0
2023703,16,9,1997,9,"male",409,136,31,14,15,11,3,3,12
2023763,31,16,1982,7,"female",573,31,4,0,11,0,11,0,0
2023767,19,7,1994,10,"male",581,78,31,8,23,6,5,2,18
2023771,25,8,1988,12,"female",720,215,123,66,81,1,39,65,42
2023779,15,3,1998,11,"male",384,147,15,0,2,0,1,0,1
2023809,37,18,1976,1,"male",516,121,102,318,266,318,221,0,45
2023838,22,23,1991,8,"female",90,134,56,42,50,42,42,0,8
2023850,80,16,1933,10,"female",357,79,68,32,31,0,9,32,22
2023854,21,6,1992,5,"male",311,25,18,1,1,1,1,0,0
2023875,108,31,1905,7,"male",1449,347,123,30,2,0,0,30,2
2023879,20,25,1993,11,"male",445,50,19,0,0,0,0,0,0
2023892,26,5,1987,7,"female",443,15,8,2,2,2,2,0,0
2023923,38,12,1975,10,"male",595,13,2,1,3,1,1,0,2
2023963,47,1,1966,3,"male",836,298,200,1180,188,1180,112,0,76
2023983,54,24,1959,10,"male",999,180,46,32,41,17,16,15,25
2023995,43,7,1970,3,"male",665,1,1,0,0,0,0,0,0
2024016,33,17,1980,3,"male",554,43,24,0,0,0,0,0,0
2024025,40,13,1973,10,"male",558,2,2,0,0,0,0,0,0
2024037,19,13,1994,6,"male",62,0,0,0,0,0,0,0,0
2024090,102,9,1911,8,"male",1445,690,131,61,149,61,98,0,51
2024135,31,12,1982,1,NA,227,2,2,0,0,0,0,0,0
2024159,54,16,1959,3,"female",2083,78,34,508,1371,127,54,381,1317
2024177,72,28,1941,1,"male",1194,37,9,0,0,0,0,0,0
2024191,32,6,1981,10,"male",828,132,122,457,337,290,281,167,56
2024258,23,18,1990,7,"female",570,8,6,0,0,0,0,0,0
2024266,59,17,1954,1,"male",52,2,1,0,0,0,0,0,0
2024272,18,20,1995,4,"male",77,69,62,3,6,3,6,0,0
2024308,80,3,1933,3,"male",214,2384,516,50,18,50,14,0,4
2024321,108,5,1905,6,"male",1736,174,44,229,182,146,107,83,75
2024331,26,19,1987,5,"male",589,116,106,5,3,5,1,0,2
2024371,18,23,1995,5,"male",217,98,63,23,30,23,23,0,7
2024391,31,5,1982,9,"male",1036,72,43,19,2,19,0,0,2
2024424,42,30,1971,12,"male",71,36,32,29,9,29,7,0,2
2024430,28,5,1985,5,"female",205,45,20,0,1,0,0,0,1
2024432,18,6,1995,3,"male",192,178,160,58,35,57,28,1,7
2024442,60,15,1953,12,"male",402,85,65,0,0,0,0,0,0
2024451,14,5,1999,1,"male",260,31,31,85,7,38,7,47,0
2024456,16,14,1997,4,"male",260,60,25,0,0,0,0,0,0
2024461,24,19,1989,8,"male",244,134,68,5,15,2,2,3,13
2024462,14,6,1999,5,"female",272,92,43,0,0,0,0,0,0
2024463,28,8,1985,9,"male",29,0,0,0,0,0,0,0,0
2024465,103,27,1910,7,"female",347,44,33,22,14,22,13,0,1
2024467,63,15,1950,9,"male",457,1,1,0,0,0,0,0,0
2024509,30,11,1983,2,"female",565,368,300,175,693,174,504,1,189
2024514,48,25,1965,6,"female",1647,198,120,420,188,89,112,331,76
2024515,68,1,1945,3,"male",157,130,81,20,140,0,3,20,137
2024559,85,27,1928,12,"female",129,61,41,123,11,0,1,123,10
2024598,20,8,1993,1,"female",230,322,132,16,34,5,16,11,18
2024629,28,6,1985,12,"male",84,41,37,170,32,62,11,108,21
2024652,29,4,1984,1,"male",640,31,26,0,0,0,0,0,0
2024660,66,7,1947,5,"female",1741,33,22,0,0,0,0,0,0
2024664,103,18,1910,12,"male",864,332,226,37,113,2,23,35,90
2024668,44,19,1969,4,"female",160,52,11,89,79,89,57,0,22
2024753,24,22,1989,6,"male",645,56,21,3,10,3,7,0,3
2024758,39,6,1974,10,"female",218,5,3,24,0,24,0,0,0
2024779,16,13,1997,11,"male",301,201,108,0,2,0,2,0,0
2024804,18,8,1995,6,"male",512,258,219,57,11,1,0,56,11
2024813,23,20,1990,3,"female",262,141,99,409,190,409,174,0,16
2024819,16,17,1997,7,"female",663,519,341,224,268,86,157,138,111
2024855,69,27,1944,2,"male",477,83,28,579,285,0,120,579,165
2024882,18,14,1995,8,"female",169,161,115,352,634,345,488,7,146
2024906,63,23,1950,9,"male",333,47,40,36,1,9,1,27,0
2024908,24,30,1989,12,"male",565,76,45,0,0,0,0,0,0
2024966,54,25,1959,6,"female",1798,65,29,171,131,166,66,5,65
2025044,17,30,1996,8,"female",390,680,489,0,3,0,1,0,2
2025049,38,6,1975,6,"male",158,35,23,1,7,1,7,0,0
2025054,54,11,1959,12,"female",452,35,19,11,8,11,2,0,6
2025059,42,10,1971,7,"male",255,1,1,0,0,0,0,0,0
2025122,31,16,1982,12,"male",254,51,38,0,0,0,0,0,0
2025148,53,30,1960,5,"male",596,98,38,10,1,10,1,0,0
2025174,17,2,1996,6,"male",327,100,88,24,34,24,21,0,13
2025194,42,26,1971,8,"male",552,42,28,0,0,0,0,0,0
2025208,47,17,1966,8,"male",950,6,5,19,2,19,2,0,0
2025216,55,4,1958,10,"female",37,22,20,0,0,0,0,0,0
2025254,18,30,1995,12,"male",262,223,70,51,173,8,132,43,41
2025316,26,14,1987,9,"male",46,34,22,0,1,0,0,0,1
2025325,44,20,1969,5,"male",259,175,87,0,15,0,14,0,1
2025357,46,31,1967,12,"male",574,155,103,171,12,171,2,0,10
2025358,108,27,1905,4,"female",528,227,77,7,6,7,4,0,2
2025364,21,8,1992,8,"male",637,725,581,243,326,214,247,29,79
2025372,44,1,1969,7,"female",411,114,38,73,80,0,42,73,38
2025391,41,25,1972,1,"female",398,92,86,170,124,170,115,0,9
2025393,17,8,1996,1,"male",418,79,34,0,0,0,0,0,0
2025427,20,6,1993,12,"female",788,448,304,1,4,1,4,0,0
2025438,26,30,1987,7,"male",144,9,8,8,3,8,3,0,0
2025446,21,5,1992,4,"male",250,136,63,1,36,1,24,0,12
2025453,63,5,1950,9,"female",1303,56,23,323,244,323,96,0,148
2025476,68,8,1945,8,"male",229,91,84,37,3,37,2,0,1
2025499,57,23,1956,6,"male",1504,80,33,35,51,0,12,35,39
2025500,23,6,1990,7,"male",374,73,46,10,2,0,2,10,0
2025518,103,17,1910,6,"male",646,1178,680,30,1673,27,1202,3,471
2025541,108,31,1905,1,"male",1450,215,123,7,6,0,3,7,3
2025542,22,12,1991,7,"female",793,67,50,0,0,0,0,0,0
2025546,59,1,1954,1,"female",227,22,21,0,1,0,1,0,0
2025548,34,9,1979,8,"female",45,33,28,292,216,236,180,56,36
2025549,22,13,1991,12,"male",1020,249,120,85,74,85,62,0,12
2025558,34,27,1979,9,"male",1074,93,34,17,20,15,11,2,9
2025583,64,22,1949,10,"male",1691,138,44,14,38,14,24,0,14
2025586,19,6,1994,9,"male",192,186,164,11,1,11,1,0,0
2025598,17,6,1996,6,"male",156,67,48,0,0,0,0,0,0
2025601,19,15,1994,6,"female",82,12,11,55,59,55,43,0,16
2025605,53,3,1960,12,"female",367,39,14,0,0,0,0,0,0
2025624,27,1,1986,1,"male",386,33,24,0,1,0,0,0,1
2025636,13,10,2000,2,"female",150,100,60,130,68,123,31,7,37
2025639,31,1,1982,6,"male",17,0,0,0,0,0,0,0,0
2025640,22,18,1991,4,"male",486,289,174,1,71,1,63,0,8
2025679,94,13,1919,9,"male",897,184,88,106,32,106,28,0,4
2025685,18,15,1995,8,"male",147,18,9,2,19,2,16,0,3
2025698,18,5,1995,6,"female",660,599,371,1953,1207,1952,1046,1,161
2025725,45,25,1968,11,"male",1589,77,24,15,3,15,3,0,0
2025740,24,9,1989,4,"male",365,41,15,3,1,0,0,3,1
2025751,68,1,1945,8,"male",1729,66,32,26,19,0,0,26,19
2025758,58,24,1955,7,"male",287,7,7,0,0,0,0,0,0
2025778,62,21,1951,7,"male",1994,58,17,1,7,1,6,0,1
2025806,25,28,1988,3,"male",179,428,315,351,45,351,38,0,7
2025815,17,17,1996,8,"male",22,70,68,20,16,20,12,0,4
2025825,31,17,1982,8,"male",306,135,93,11,12,0,4,11,8
2025831,25,24,1988,1,"male",224,93,66,0,4,0,1,0,3
2025862,86,4,1927,5,"female",739,291,222,361,103,0,10,361,93
2025881,24,25,1989,12,"female",185,50,27,0,5,0,2,0,3
2025883,22,14,1991,9,"male",924,315,139,78,67,78,34,0,33
2025940,18,22,1995,8,"female",309,652,322,62,462,62,377,0,85
2025950,19,11,1994,3,"female",446,104,49,0,2,0,1,0,1
2025955,44,6,1969,7,"female",762,17,8,1,4,1,3,0,1
2025968,18,12,1995,8,"male",34,79,71,72,70,72,67,0,3
2025985,42,28,1971,1,"male",533,94,56,8,8,0,3,8,5
2025994,103,20,1910,2,"male",1221,1463,740,2455,993,2353,831,102,162
2025999,100,31,1913,12,"male",1299,965,608,257,229,252,167,5,62
2026030,106,19,1907,5,"male",1572,240,199,180,95,110,77,70,18
2026066,53,25,1960,10,"female",334,135,105,822,806,609,555,213,251
2026067,33,13,1980,12,"female",491,64,42,50,5,50,4,0,1
2026079,33,24,1980,4,"male",407,25,8,0,0,0,0,0,0
2026113,14,25,1999,12,"female",93,0,0,0,0,0,0,0,0
2026129,26,20,1987,3,"female",223,5,3,0,0,0,0,0,0
2026133,31,16,1982,3,"female",78,42,38,34,2,34,2,0,0
2026138,19,24,1994,2,"male",323,25,3,0,1,0,0,0,1
2026179,38,2,1975,7,"male",338,12,9,18,4,18,4,0,0
2026195,29,21,1984,10,"female",411,354,195,32,261,32,147,0,114
2026206,27,26,1986,6,"female",127,25,10,0,0,0,0,0,0
2026238,31,2,1982,9,"female",206,7,3,0,0,0,0,0,0
2026244,65,7,1948,2,"female",938,73,45,107,5,33,4,74,1
2026246,36,27,1977,7,"male",675,266,76,36,12,33,10,3,2
2026257,70,3,1943,8,"male",1356,56,41,0,0,0,0,0,0
2026264,86,18,1927,2,"male",2318,553,107,0,2,0,0,0,2
2026267,25,10,1988,1,"male",219,52,51,38,22,38,22,0,0
2026277,23,1,1990,1,"male",102,86,58,16,74,16,52,0,22
2026295,19,11,1994,11,"male",152,0,0,0,0,0,0,0,0
2026324,108,5,1905,6,"male",145,289,257,29,28,0,6,29,22
2026343,50,10,1963,3,"male",935,100,67,0,0,0,0,0,0
2026377,19,10,1994,10,"male",242,0,0,0,0,0,0,0,0
2026394,39,20,1974,2,"male",1632,256,63,28,18,28,13,0,5
2026403,24,23,1989,7,"female",136,48,27,38,73,28,51,10,22
2026409,36,28,1977,9,"female",421,19,13,12,0,12,0,0,0
2026420,36,3,1977,5,"male",437,23,21,156,65,156,60,0,5
2026443,54,19,1959,6,"male",525,67,59,48,7,46,7,2,0
2026454,28,12,1985,2,"male",837,58,41,0,0,0,0,0,0
2026525,24,31,1989,1,"male",429,47,42,21,4,21,4,0,0
2026527,33,12,1980,1,"female",379,1,0,0,0,0,0,0,0
2026536,17,4,1996,11,"female",332,264,7,15,219,6,137,9,82
2026602,78,20,1935,11,"female",1262,203,79,615,21,615,20,0,1
2026621,20,28,1993,4,"male",586,327,220,29,70,29,55,0,15
2026631,52,30,1961,3,"female",573,312,273,320,175,320,127,0,48
2026650,108,1,1905,1,"male",1191,222,95,18,1,5,0,13,1
2026660,46,11,1967,9,"male",341,20,13,1,1,1,0,0,1
2026674,34,23,1979,8,"female",449,113,62,244,189,69,130,175,59
2026681,24,14,1989,2,"male",630,39,30,7,1,7,1,0,0
2026685,50,15,1963,3,"female",779,30,12,0,0,0,0,0,0
2026720,113,23,1900,10,"female",1702,133,49,177,90,14,69,163,21
2026725,29,10,1984,8,"male",689,309,19,29,244,29,139,0,105
2026732,40,21,1973,7,"male",1278,2840,2213,0,6,0,5,0,1
2026740,33,23,1980,6,"female",288,61,37,8,17,8,7,0,10
2026757,24,6,1989,1,"female",548,171,83,386,364,107,159,279,205
2026765,14,4,1999,5,"female",375,41,22,0,0,0,0,0,0
2026766,35,8,1978,9,"female",176,81,66,30,29,7,21,23,8
2026782,14,1,1999,1,"male",473,16,12,28,16,25,8,3,8
2026820,24,20,1989,12,"male",234,209,167,0,2,0,2,0,0
2026878,36,11,1977,11,"male",46,4,3,0,0,0,0,0,0
2026879,32,1,1981,1,"male",276,2,2,0,0,0,0,0,0
2026885,23,23,1990,5,"male",492,95,10,0,0,0,0,0,0
2026888,33,27,1980,10,"female",383,163,104,0,0,0,0,0,0
2026901,21,1,1992,7,"male",336,129,105,2,7,2,7,0,0
2026922,15,7,1998,7,"female",268,116,33,14,13,14,0,0,13
2026923,15,21,1998,4,"male",81,3,1,0,0,0,0,0,0
2026930,25,19,1988,7,"female",280,56,18,36,71,36,69,0,2
2026952,63,6,1950,8,"female",2159,1194,724,158,1919,156,1086,2,833
2026958,51,5,1962,9,"female",174,95,66,4,108,4,44,0,64
2026994,65,30,1948,1,"female",285,35,19,2,1,0,1,2,0
2026995,16,5,1997,8,"male",973,1,1,0,2,0,2,0,0
2026998,26,1,1987,1,"female",572,1,0,0,0,0,0,0,0
2027005,16,9,1997,2,"female",688,2,0,5,0,0,0,5,0
2027011,31,4,1982,11,"male",388,47,36,1,0,1,0,0,0
2027054,25,10,1988,3,"male",370,122,73,88,43,0,24,88,19
2027090,100,1,1913,1,"female",1545,510,312,1569,827,397,371,1172,456
2027138,18,27,1995,9,"male",215,270,202,0,1,0,1,0,0
2027140,68,4,1945,12,"male",2179,454,151,1,6,1,4,0,2
2027151,22,8,1991,7,"female",757,157,44,90,159,85,96,5,63
2027187,25,1,1988,1,"male",297,69,21,1,0,1,0,0,0
2027296,27,23,1986,10,"female",313,47,46,49,88,49,54,0,34
2027308,29,5,1984,2,"male",292,157,126,0,2,0,0,0,2
2027328,18,24,1995,1,"female",236,83,66,1237,375,0,133,1237,242
2027342,24,9,1989,6,"female",349,215,81,175,197,175,138,0,59
2027384,23,4,1990,6,"female",304,220,49,0,1,0,1,0,0
2027403,108,30,1905,1,"male",1159,347,232,246,106,245,30,1,76
2027406,57,14,1956,6,"female",354,25,13,6,20,6,19,0,1
2027422,25,8,1988,11,"male",84,0,0,0,0,0,0,0,0
2027438,57,19,1956,6,"female",487,27,8,23,0,23,0,0,0
2027440,63,16,1950,9,"male",1454,62,52,0,0,0,0,0,0
2027474,16,12,1997,10,"male",520,85,25,0,14,0,9,0,5
2027488,40,11,1973,4,"female",300,43,28,15,1,11,1,4,0
2027503,17,16,1996,7,"male",156,174,149,250,263,250,196,0,67
2027539,14,5,1999,11,"male",25,30,10,0,0,0,0,0,0
2027550,43,28,1970,9,"male",947,98,40,254,41,0,9,254,32
2027562,29,27,1984,4,"male",228,208,63,24,92,24,79,0,13
2027588,38,22,1975,1,"female",222,98,56,81,90,80,36,1,54
2027604,40,20,1973,10,"female",334,79,62,217,173,38,52,179,121
2027610,17,9,1996,3,"male",397,144,115,74,77,74,71,0,6
2027628,53,24,1960,12,"male",1431,622,534,2,45,2,41,0,4
2027655,16,6,1997,1,"male",1329,132,50,1,4,1,4,0,0
2027658,35,18,1978,5,"female",411,26,12,29,47,29,11,0,36
2027706,13,11,2000,8,"female",101,1008,676,498,1936,391,1188,107,748
2027708,18,20,1995,10,"male",559,137,79,42,45,42,33,0,12
2027719,54,8,1959,6,NA,1998,82,43,0,0,0,0,0,0
2027739,70,30,1943,10,"female",247,71,54,1751,525,0,166,1751,359
2027750,26,19,1987,7,"female",255,61,20,543,88,543,80,0,8
2027767,67,1,1946,8,"male",1359,75,48,46,25,46,18,0,7
2027774,34,14,1979,2,"female",363,73,38,0,0,0,0,0,0
2027797,42,3,1971,12,"male",622,157,106,16,22,15,21,1,1
2027818,68,3,1945,4,"male",912,314,226,34,18,0,15,34,3
2027819,51,31,1962,3,"female",1722,391,316,465,452,465,331,0,121
2027825,33,1,1980,1,"male",107,1,0,5,2,5,1,0,1
2027864,48,20,1965,4,"female",74,27,13,1,0,1,0,0,0
2027877,19,13,1994,5,"male",88,40,35,0,0,0,0,0,0
2027915,18,5,1995,4,"female",261,66,45,7,0,1,0,6,0
2027928,34,19,1979,4,"male",152,168,138,30,39,30,32,0,7
2028009,25,21,1988,11,"female",384,92,53,120,6,34,4,86,2
2028030,44,12,1969,8,"female",184,389,324,3089,2427,3088,1268,1,1159
2028061,16,10,1997,8,"male",13,148,46,121,125,111,70,10,55
2028064,34,19,1979,6,"male",20,11,5,6,3,6,3,0,0
2028084,41,6,1972,10,"female",960,244,195,990,872,635,588,355,284
2028129,14,5,1999,5,"male",83,41,16,2,0,2,0,0,0
2028134,74,1,1939,1,"female",42,16,14,2,0,2,0,0,0
2028152,36,23,1977,5,"male",172,207,111,29,449,29,394,0,55
2028173,39,6,1974,11,"male",292,50,31,138,30,138,26,0,4
2028220,22,3,1991,1,"female",103,37,28,2,10,2,1,0,9
2028242,28,6,1985,4,"female",361,368,324,224,296,224,261,0,35
2028244,20,14,1993,9,"male",156,1,1,0,0,0,0,0,0
2028245,21,24,1992,10,"male",1610,206,203,0,0,0,0,0,0
2028258,41,16,1972,6,"male",50,35,31,132,16,132,8,0,8
2028288,14,12,1999,4,"male",888,357,183,38,83,38,57,0,26
2028305,49,26,1964,11,"female",1777,41,17,9,25,9,12,0,13
2028317,18,27,1995,2,"male",210,146,89,0,0,0,0,0,0
2028336,19,29,1994,7,"female",129,3,2,658,41,441,3,217,38
2028341,29,15,1984,11,"female",503,306,93,5,37,5,19,0,18
2028350,17,28,1996,10,"male",479,39,5,21,7,21,7,0,0
2028366,26,1,1987,1,"male",304,3,1,18,0,6,0,12,0
2028369,17,1,1996,1,"male",60,59,51,6,0,6,0,0,0
2028381,108,20,1905,4,"female",1208,388,23,5,13,5,6,0,7
2028412,41,2,1972,8,"male",650,30,9,0,0,0,0,0,0
2028415,16,12,1997,5,"female",350,3704,528,2274,1163,2274,970,0,193
2028423,20,28,1993,11,"female",559,176,48,97,19,97,17,0,2
2028428,17,10,1996,8,"male",650,55,35,0,0,0,0,0,0
2028450,19,20,1994,12,"female",237,540,377,191,273,179,166,12,107
2028480,14,10,1999,3,"female",3,99,85,1,2,1,2,0,0
2028488,20,7,1993,11,"female",550,193,141,34,27,0,0,34,27
2028503,27,28,1986,4,"female",628,161,92,80,125,80,99,0,26
2028531,34,27,1979,4,"male",816,1,0,0,0,0,0,0,0
2028558,21,10,1992,12,"male",1601,1806,892,161,314,42,207,119,107
2028559,23,4,1990,1,"male",462,360,301,10,3,0,0,10,3
2028566,26,9,1987,1,"male",23,0,0,0,0,0,0,0,0
2028582,21,30,1992,4,"male",139,80,57,13,10,13,10,0,0
2028622,31,5,1982,11,"male",232,161,97,26,7,2,1,24,6
2028654,23,20,1990,9,"female",44,6,5,64,14,64,14,0,0
2028787,33,14,1980,1,"female",270,4,4,6,0,1,0,5,0
2028792,15,5,1998,2,"female",341,2159,656,1476,3821,1156,3046,320,775
2028840,52,23,1961,10,"male",399,209,62,2,7,0,1,2,6
2028844,55,28,1958,11,"female",509,22,15,43,17,43,13,0,4
2028847,24,1,1989,1,"male",39,0,0,2,2,2,2,0,0
2028848,108,30,1905,9,"male",1592,275,147,45,16,0,8,45,8
2028864,23,13,1990,11,"male",552,83,45,18,45,18,45,0,0
2028867,24,1,1989,4,"female",400,168,86,102,90,102,73,0,17
2028877,45,12,1968,7,"male",345,10,6,0,0,0,0,0,0
2028904,32,30,1981,6,"male",308,127,111,3,32,3,16,0,16
2028920,30,24,1983,6,"female",783,46,24,5,3,4,1,1,2
2028964,22,1,1991,1,"male",232,62,57,0,0,0,0,0,0
2028968,23,10,1990,4,"male",1154,547,245,42,9,41,5,1,4
2028971,24,23,1989,1,"male",424,5,1,0,0,0,0,0,0
2028979,50,31,1963,1,"male",536,709,602,1215,1166,1215,820,0,346
2028987,17,16,1996,4,"male",499,47,13,1,2,0,0,1,2
2029022,18,10,1995,10,"male",514,29,25,0,1,0,1,0,0
2029068,20,23,1993,1,"female",1010,151,97,324,62,313,32,11,30
2029073,15,19,1998,11,"male",678,1910,1357,32,105,18,56,14,49
2029090,63,20,1950,11,"female",894,545,293,539,770,515,478,24,292
2029110,22,17,1991,9,"female",380,188,131,147,64,146,41,1,23
2029117,21,6,1992,2,"male",324,525,268,117,144,7,38,110,106
2029125,55,29,1958,7,"male",415,32,17,0,0,0,0,0,0
2029137,31,28,1982,5,"male",753,43,28,17,6,0,4,17,2
2029138,50,13,1963,6,"female",1367,142,70,332,83,0,12,332,71
2029167,34,28,1979,3,"female",334,8,6,6,1,0,0,6,1
2029176,49,8,1964,10,"female",583,45,22,37,41,0,12,37,29
2029178,17,17,1996,5,"male",628,76,46,4,2,0,1,4,1
2029185,27,30,1986,5,"male",7,2,2,1,0,1,0,0,0
2029211,19,8,1994,1,"female",644,271,129,99,17,99,17,0,0
2029246,28,5,1985,7,"male",313,25,17,2,2,2,2,0,0
2029256,65,13,1948,6,"male",230,16,9,0,0,0,0,0,0
2029271,34,4,1979,10,"male",18,0,0,0,0,0,0,0,0
2029292,22,25,1991,9,"female",1126,1135,120,12,353,6,235,6,118
2029329,47,30,1966,3,"male",973,250,77,224,372,156,229,68,143
2029333,21,9,1992,11,"male",296,271,150,6,13,6,8,0,5
2029338,26,28,1987,6,"female",621,124,95,108,104,108,66,0,38
2029360,18,20,1995,7,"male",11,0,0,0,0,0,0,0,0
2029372,23,7,1990,12,"female",427,110,73,348,113,327,88,21,25
2029417,51,20,1962,3,"male",643,21,12,0,0,0,0,0,0
2029419,20,14,1993,7,"male",319,25,17,2,0,2,0,0,0
2029442,58,22,1955,6,"male",454,203,45,0,1,0,1,0,0
2029460,27,21,1986,9,"male",738,99,68,39,19,39,9,0,10
2029474,19,5,1994,8,"male",96,23,8,145,4,101,3,44,1
2029477,39,13,1974,7,"female",254,116,76,432,149,96,43,336,106
2029487,49,30,1964,6,"male",384,23,22,0,4,0,0,0,4
2029526,23,4,1990,2,"female",473,1767,1446,3599,1827,2255,901,1344,926
2029540,63,19,1950,7,"female",837,434,230,14,148,0,28,14,120
2029557,24,4,1989,4,"male",285,158,82,649,215,640,192,9,23
2029587,53,18,1960,7,"female",192,74,53,43,17,43,5,0,12
2029600,16,8,1997,5,"male",113,133,102,93,15,63,15,30,0
2029654,55,15,1958,1,"male",512,89,65,0,4,0,2,0,2
2029714,60,9,1953,5,"female",593,55,49,45,25,0,14,45,11
2029728,40,12,1973,4,"female",38,16,13,2,2,2,0,0,2
2029733,24,11,1989,8,"male",670,273,198,16,3,16,3,0,0
2029771,15,24,1998,1,"female",132,23,16,7,0,7,0,0,0
2029793,30,1,1983,4,"female",418,150,104,8,1,8,1,0,0
2029797,18,14,1995,6,"male",525,29,25,5,1,0,0,5,1
2029816,21,12,1992,1,"male",466,757,499,9,17,9,7,0,10
2029834,31,6,1982,2,"male",369,34,23,63,10,0,0,63,10
2029839,23,17,1990,5,"female",211,58,7,11,2,11,2,0,0
2029840,94,17,1919,4,"male",580,245,117,1,8,1,8,0,0
2029860,15,3,1998,3,"female",343,611,67,0,8,0,6,0,2
2029863,16,3,1997,2,"male",225,89,48,35,0,3,0,32,0
2029885,47,22,1966,10,"male",922,75,33,336,65,334,60,2,5
2029909,60,10,1953,10,"female",1103,263,106,719,237,571,138,148,99
2030017,60,28,1953,12,"male",283,32,30,0,0,0,0,0,0
2030023,62,1,1951,12,"male",204,65,58,0,0,0,0,0,0
2030035,29,23,1984,12,"male",5,1,1,110,11,110,10,0,1
2030038,18,14,1995,8,"male",290,862,677,27,4,27,2,0,2
2030040,108,21,1905,9,"female",764,141,66,5,61,5,56,0,5
2030055,17,3,1996,11,"male",66,141,128,4,4,3,1,1,3
2030086,25,4,1988,2,"male",295,291,206,128,34,87,13,41,21
2030105,35,10,1978,10,"female",506,73,31,15,3,0,0,15,3
2030131,28,3,1985,12,"male",1627,23,20,18,1,15,0,3,1
2030153,40,13,1973,9,"female",450,214,127,1,0,1,0,0,0
2030154,18,30,1995,6,"male",222,38,35,16,0,16,0,0,0
2030175,17,2,1996,11,"female",572,172,130,59,126,26,42,33,84
2030201,31,1,1982,12,"female",165,35,14,14,17,14,9,0,8
2030219,38,18,1975,1,"male",436,31,24,0,0,0,0,0,0
2030230,21,27,1992,7,"male",308,33,17,31,5,31,5,0,0
2030263,34,21,1979,5,"male",1300,97,34,43,102,43,72,0,30
2030317,101,5,1912,4,"female",2272,61,34,3,2,0,1,3,1
2030323,54,15,1959,9,"female",1026,394,311,3,279,0,23,3,256
2030361,29,24,1984,8,"male",675,136,125,163,2,152,0,11,2
2030369,102,1,1911,1,"male",1755,1029,811,138,100,31,69,107,31
2030384,17,2,1996,6,"female",629,99,53,29,115,29,41,0,74
2030442,30,15,1983,4,"female",464,148,66,408,527,408,471,0,56
2030464,55,2,1958,10,"female",430,7,1,0,0,0,0,0,0
2030467,68,7,1945,12,"female",49,11,5,55,5,0,4,55,1
2030490,15,13,1998,3,"male",38,32,22,6,0,6,0,0,0
2030504,21,5,1992,8,"female",449,249,176,535,662,241,316,294,346
2030523,24,6,1989,9,"male",778,530,191,75,90,46,9,29,81
2030541,27,29,1986,6,"male",865,261,141,5,0,0,0,5,0
2030556,25,1,1988,11,"female",312,57,43,391,269,391,36,0,233
2030561,19,24,1994,5,"male",441,362,227,724,716,8,77,716,639
2030568,36,13,1977,8,"male",20,11,9,8,1,8,1,0,0
2030578,17,15,1996,9,"male",145,95,83,71,27,10,22,61,5
2030589,14,12,1999,12,"female",156,57,47,7,0,7,0,0,0
2030598,19,18,1994,10,"female",408,18,8,0,0,0,0,0,0
2030599,103,5,1910,1,"female",1265,32,18,61,65,59,56,2,9
2030616,23,16,1990,11,"male",1658,382,193,730,647,388,471,342,176
2030650,33,23,1980,10,"male",1348,114,26,0,0,0,0,0,0
2030655,27,8,1986,7,"female",189,9,6,0,0,0,0,0,0
2030678,42,24,1971,10,"male",822,30,20,2,14,2,12,0,2
2030680,26,27,1987,7,"male",715,109,54,1,5,1,4,0,1
2030682,41,3,1972,12,"male",1364,16,3,0,0,0,0,0,0
2030687,27,5,1986,1,"female",601,119,27,9,74,8,57,1,17
2030693,16,21,1997,9,"male",273,29,17,1,0,0,0,1,0
2030726,57,18,1956,12,"female",362,3,2,0,0,0,0,0,0
2030769,22,27,1991,6,"female",174,69,38,11,3,11,3,0,0
2030796,27,9,1986,4,"female",468,33,20,1,2,0,0,1,2
2030819,39,10,1974,6,"female",472,6,4,10,127,10,113,0,14
2030839,73,4,1940,4,"female",1405,21,13,10,1,0,1,10,0
2030852,18,9,1995,12,"female",246,487,264,31,171,31,120,0,51
2030863,26,10,1987,2,"female",352,170,110,2,72,2,20,0,52
2030865,30,1,1983,5,"male",272,67,53,9,12,9,11,0,1
2030868,14,5,1999,8,"female",631,63,41,423,63,375,43,48,20
2030883,20,5,1993,12,"female",263,86,47,79,56,79,40,0,16
2030888,20,9,1993,9,"female",533,260,48,176,296,104,78,72,218
2030890,21,13,1992,5,"male",206,16,10,10,3,10,1,0,2
2030932,26,27,1987,7,"male",338,76,53,6,7,0,2,6,5
2030947,58,21,1955,7,"female",1419,215,129,60,203,60,109,0,94
2030973,24,12,1989,6,"male",337,155,72,27,27,27,3,0,24
2030991,50,12,1963,1,"male",393,69,57,2,4,0,2,2,2
2031003,17,28,1996,6,"female",276,307,239,68,320,68,281,0,39
2031018,15,15,1998,5,"male",326,217,161,41,9,41,5,0,4
2031030,25,14,1988,2,"female",323,2,2,0,0,0,0,0,0
2031038,16,13,1997,8,"male",152,221,185,20,9,20,1,0,8
2031070,65,23,1948,7,"female",1692,358,210,1145,1026,0,715,1145,311
2031078,23,6,1990,8,"male",801,45,24,0,6,0,2,0,4
2031089,63,18,1950,2,"male",252,18,14,0,0,0,0,0,0
2031109,19,7,1994,6,"female",753,443,214,328,206,273,157,55,49
2031144,23,17,1990,5,"male",511,54,28,14,11,3,7,11,4
2031152,24,2,1989,5,"male",100,1,1,0,0,0,0,0,0
2031170,104,8,1909,10,"male",1690,127,84,250,186,33,26,217,160
2031180,18,26,1995,9,"male",1278,2133,702,2075,8095,1936,7173,139,922
2031181,18,25,1995,1,"male",193,105,78,1,0,1,0,0,0
2031182,35,12,1978,6,"male",500,147,75,25,0,25,0,0,0
2031186,61,26,1952,7,"female",823,63,32,217,99,208,94,9,5
2031189,22,5,1991,3,"female",1373,349,187,244,260,170,90,74,170
2031190,64,3,1949,12,"male",469,33,8,0,3,0,1,0,2
2031205,23,10,1990,3,"male",395,212,150,0,15,0,6,0,9
2031226,48,26,1965,9,"female",184,14,13,0,0,0,0,0,0
2031232,103,20,1910,2,"male",1526,191,91,39,36,39,33,0,3
2031242,30,22,1983,2,"male",265,53,44,8,0,8,0,0,0
2031245,19,10,1994,5,"male",228,206,136,0,2,0,2,0,0
2031246,32,23,1981,3,"male",148,24,6,179,169,1,138,178,31
2031249,15,30,1998,11,"male",14,1,1,0,0,0,0,0,0
2031261,19,30,1994,3,"female",401,41,14,1,1,1,0,0,1
2031281,18,6,1995,6,"female",196,197,97,118,203,112,115,6,88
2031307,54,9,1959,4,"male",622,50,41,15,21,7,13,8,8
2031310,27,5,1986,7,"male",142,139,97,0,0,0,0,0,0
2031316,103,15,1910,10,"male",717,95,53,2,1,2,0,0,1
2031321,18,24,1995,10,"male",402,159,127,36,47,36,12,0,35
2031344,108,14,1905,4,"male",2888,430,183,54,103,54,93,0,10
2031347,36,15,1977,9,"female",588,29,24,145,8,24,3,121,5
2031398,51,27,1962,1,"male",463,42,24,18,10,11,8,7,2
2031407,45,28,1968,10,"female",1941,214,117,225,342,144,249,81,93
2031421,33,1,1980,1,"male",32,19,16,6,18,6,14,0,4
2031473,33,8,1980,7,"male",561,0,0,0,0,0,0,0,0
2031487,55,11,1958,10,"male",1071,145,23,17,28,15,20,2,8
2031512,47,7,1966,4,"male",33,56,2,46,29,46,28,0,1
2031527,18,30,1995,5,"female",72,2,1,0,0,0,0,0,0
2031567,31,8,1982,1,"female",185,64,29,270,120,270,78,0,42
2031573,30,24,1983,8,"female",399,134,101,101,32,101,25,0,7
2031583,55,8,1958,10,"female",784,77,45,56,87,56,76,0,11
2031588,58,20,1955,11,"female",2254,62,28,24,34,24,6,0,28
2031589,67,12,1946,5,"female",1790,119,81,102,38,6,15,96,23
2031598,23,4,1990,11,"female",616,58,23,21,12,21,11,0,1
2031622,61,19,1952,3,"female",231,34,21,6,2,0,1,6,1
2031632,47,6,1966,9,"female",416,35,26,92,26,5,17,87,9
2031641,50,12,1963,10,"female",629,21,12,0,0,0,0,0,0
2031673,108,8,1905,10,"male",1437,214,151,186,205,1,104,185,101
2031688,20,15,1993,1,"male",21,2,1,1,1,1,0,0,1
2031699,30,1,1983,1,"female",147,40,17,256,301,256,244,0,57
2031722,25,26,1988,5,"female",107,1,1,5,0,5,0,0,0
2031733,19,24,1994,6,"male",648,245,145,3,8,2,0,1,8
2031734,24,17,1989,9,"male",202,117,84,7,8,0,0,7,8
2031741,108,15,1905,2,"female",513,53,24,2,0,2,0,0,0
2031753,94,26,1919,3,"male",585,40,24,24,11,24,10,0,1
2031763,33,4,1980,2,"female",262,2,2,0,0,0,0,0,0
2031764,27,14,1986,4,"female",371,165,155,35,236,32,160,3,76
2031804,20,30,1993,3,"female",1884,110,67,166,229,113,92,53,137
2031813,18,5,1995,7,"male",635,746,605,30,6,30,4,0,2
2031816,27,15,1986,5,"male",284,201,165,40,36,40,36,0,0
2031851,41,25,1972,6,"male",359,109,43,2,4,2,4,0,0
2031855,35,16,1978,5,"female",523,105,70,2,50,2,42,0,8
2031866,14,4,1999,11,"female",187,182,94,13,59,10,29,3,30
2031875,17,27,1996,5,"male",384,623,519,396,538,73,443,323,95
2031922,25,22,1988,2,"male",147,56,48,9,5,9,1,0,4
2031953,19,25,1994,7,"male",687,179,81,48,1,40,1,8,0
2031967,60,4,1953,1,"female",290,71,47,140,180,91,148,49,32
2031981,100,23,1913,10,"female",1561,764,467,872,820,863,391,9,429
2032015,24,31,1989,7,"male",108,23,13,3,0,3,0,0,0
2032033,59,16,1954,10,"male",1725,495,88,2,8,1,4,1,4
2032044,58,12,1955,5,"female",1597,83,23,17,10,17,9,0,1
2032056,24,15,1989,8,"male",132,76,68,0,0,0,0,0,0
2032067,19,18,1994,3,"male",627,383,236,0,9,0,6,0,3
2032080,47,21,1966,4,"female",194,108,57,39,24,17,7,22,17
2032083,20,1,1993,2,"male",386,1,0,0,0,0,0,0,0
2032088,67,1,1946,5,"male",1389,47,20,1,26,1,17,0,9
2032131,33,24,1980,4,"female",252,47,36,59,49,59,44,0,5
2032151,103,10,1910,10,"male",753,781,667,124,75,25,32,99,43
2032161,19,8,1994,9,"female",679,468,200,670,411,670,384,0,27
2032165,24,17,1989,7,"male",327,95,56,14,10,14,8,0,2
2032176,17,28,1996,5,"female",515,290,173,0,6,0,1,0,5
2032244,14,1,1999,1,"male",150,832,651,230,29,200,23,30,6
2032245,39,28,1974,3,"male",1014,308,230,458,248,458,198,0,50
2032261,36,31,1977,10,"female",347,126,109,0,0,0,0,0,0
2032338,21,12,1992,6,"male",234,231,104,64,3,13,1,51,2
2032364,52,11,1961,12,"female",1419,14,7,76,123,0,2,76,121
2032399,30,9,1983,5,"male",422,4,3,0,0,0,0,0,0
2032415,18,4,1995,1,"male",134,89,81,3,1,2,0,1,1
2032419,91,30,1922,9,"male",1596,224,129,39,50,1,26,38,24
2032432,41,9,1972,8,"male",186,35,28,109,31,109,13,0,18
2032436,27,5,1986,5,"female",125,36,18,72,50,46,4,26,46
2032479,21,6,1992,7,"female",545,9,0,0,0,0,0,0,0
2032540,58,7,1955,12,"male",1569,14,8,1,1,0,1,1,0
2032565,27,7,1986,4,"female",790,198,66,241,79,241,65,0,14
2032569,28,7,1985,10,"male",619,37,21,3,2,3,2,0,0
2032577,28,3,1985,3,"male",863,35,31,1,0,1,0,0,0
2032587,48,21,1965,6,"female",71,36,29,18,0,18,0,0,0
2032608,31,1,1982,1,"male",568,224,99,2,0,2,0,0,0
2032618,48,18,1965,3,"female",12,14,6,16,11,2,5,14,6
2032669,50,11,1963,1,"male",1407,131,84,215,81,215,42,0,39
2032676,25,3,1988,12,"female",228,277,194,65,89,5,58,60,31
2032677,21,24,1992,3,"male",404,99,58,197,129,34,30,163,99
2032685,18,28,1995,2,"male",427,22,8,0,2,0,1,0,1
2032708,26,10,1987,10,"female",428,25,20,3,0,3,0,0,0
2032713,97,8,1916,11,"female",397,29,23,222,62,0,7,222,55
2032729,22,18,1991,8,"male",122,59,55,1,1,1,0,0,1
2032761,64,29,1949,5,"male",206,86,82,7,2,2,2,5,0
2032779,55,5,1958,7,"female",358,19,12,10,8,10,6,0,2
2032789,19,4,1994,5,"male",105,2,2,0,0,0,0,0,0
2032903,30,2,1983,2,"male",477,76,72,0,1,0,1,0,0
2032910,17,6,1996,6,"male",748,141,100,41,7,34,5,7,2
2032923,54,22,1959,10,"male",1265,62,21,0,0,0,0,0,0
2032933,33,29,1980,12,"female",678,214,101,127,91,105,37,22,54
2032971,29,14,1984,4,"female",747,620,310,139,35,139,26,0,9
2032982,63,24,1950,1,"male",1418,55,41,33,45,33,33,0,12
2032983,17,5,1996,4,"female",147,289,85,20,32,20,31,0,1
2033030,39,31,1974,12,"female",472,1,0,0,0,0,0,0,0
2033033,46,4,1967,1,"female",252,2,1,0,1,0,1,0,0
2033038,68,7,1945,4,"male",1016,24,2,0,0,0,0,0,0
2033044,108,5,1905,3,"female",226,93,54,0,0,0,0,0,0
2033074,22,19,1991,1,"male",91,74,57,23,17,23,7,0,10
2033076,15,26,1998,12,"male",37,15,13,0,0,0,0,0,0
2033115,60,20,1953,3,"female",588,24,12,75,26,32,17,43,9
2033147,59,25,1954,10,"male",297,18,9,0,0,0,0,0,0
2033174,35,20,1978,9,"male",173,126,73,58,24,25,10,33,14
2033229,42,29,1971,8,"male",651,83,13,0,3,0,1,0,2
2033245,48,14,1965,11,"female",1453,112,37,1224,257,997,177,227,80
2033248,54,11,1959,12,"male",438,372,216,89,10,0,1,89,9
2033276,30,31,1983,10,"male",854,92,23,0,0,0,0,0,0
2033326,16,8,1997,9,"male",154,6,3,10,3,10,2,0,1
2033330,52,11,1961,5,"female",457,62,37,169,7,169,3,0,4
2033374,15,21,1998,12,"female",348,1461,194,10,64,10,59,0,5
2033434,33,1,1980,1,"male",113,26,14,663,175,658,131,5,44
2033463,19,21,1994,12,"male",457,409,363,176,86,176,68,0,18
2033469,37,30,1976,9,"male",387,129,90,0,0,0,0,0,0
2033478,62,21,1951,7,"male",549,22,18,0,0,0,0,0,0
2033481,14,10,1999,10,"male",82,64,38,0,0,0,0,0,0
2033513,54,30,1959,4,"female",29,21,17,4,7,4,4,0,3
2033515,25,10,1988,2,"male",621,64,21,0,1,0,0,0,1
2033516,52,25,1961,6,"male",407,85,45,46,54,8,20,38,34
2033532,68,17,1945,8,"male",1276,484,268,71,118,71,108,0,10
2033601,25,13,1988,1,"female",196,15,7,39,16,39,10,0,6
2033608,45,29,1968,5,"female",499,33,25,60,24,60,21,0,3
2033628,19,2,1994,8,"male",316,927,769,827,638,808,441,19,197
2033630,25,1,1988,1,"female",148,53,44,2,103,2,43,0,60
2033650,18,27,1995,11,"female",379,285,147,177,119,174,98,3,21
2033679,35,28,1978,4,"female",124,25,7,0,0,0,0,0,0
2033726,27,26,1986,8,"male",76,27,20,0,0,0,0,0,0
2033730,21,29,1992,5,"female",585,33,13,14,17,14,16,0,1
2033731,14,9,1999,9,"female",465,467,252,851,380,807,219,44,161
2033746,22,8,1991,1,"male",194,8,7,2,2,2,2,0,0
2033812,25,12,1988,8,"female",668,586,350,204,623,135,444,69,179
2033817,14,21,1999,4,"male",307,628,398,652,1092,409,374,243,718
2033835,31,9,1982,1,"male",137,36,18,0,1,0,1,0,0
2033840,45,1,1968,7,"male",421,84,43,0,0,0,0,0,0
2033841,32,19,1981,11,"male",17,0,0,0,0,0,0,0,0
2033859,18,13,1995,11,"male",577,0,0,0,0,0,0,0,0
2033887,32,11,1981,9,"female",903,70,35,311,72,307,47,4,25
2033891,24,17,1989,8,"female",952,286,150,1,39,1,30,0,9
2033892,20,15,1993,8,"male",369,117,89,9,8,9,7,0,1
2033916,37,25,1976,3,"female",1108,104,43,27,55,27,36,0,19
2033944,36,7,1977,7,"female",722,0,0,0,0,0,0,0,0
2033957,34,23,1979,1,"male",417,128,104,67,29,67,26,0,3
2033967,18,6,1995,1,"male",19,4,4,0,0,0,0,0,0
2033995,30,1,1983,7,"female",102,75,46,0,0,0,0,0,0
2033997,31,25,1982,8,"female",515,25,7,0,1,0,1,0,0
2033999,19,9,1994,8,"female",537,2671,1636,0,222,0,156,0,66
2034007,57,6,1956,9,"female",589,74,32,5,23,2,14,3,9
2034022,36,7,1977,10,"male",293,37,29,4,4,3,3,1,1
2034031,19,8,1994,9,"female",223,76,28,1,1,1,1,0,0
2034053,19,2,1994,10,"male",1495,61,49,961,131,165,51,796,80
2034074,108,1,1905,1,"female",1661,670,278,34,20,0,14,34,6
2034088,35,8,1978,1,"female",263,78,53,1,2,1,1,0,1
2034147,32,4,1981,4,"female",369,8,5,5,0,0,0,5,0
2034152,53,15,1960,12,"male",355,86,57,47,50,47,45,0,5
2034163,62,17,1951,8,"female",833,39,22,19,15,0,11,19,4
2034253,13,3,2000,5,"female",138,303,75,124,26,116,9,8,17
2034277,17,10,1996,6,"male",351,325,259,0,1,0,0,0,1
2034279,58,30,1955,12,"male",258,53,48,4,6,4,4,0,2
2034291,40,1,1973,3,"male",454,12,9,0,0,0,0,0,0
2034293,18,23,1995,3,"male",622,491,377,0,2,0,2,0,0
2034303,26,27,1987,10,"female",249,172,149,702,242,702,113,0,129
2034305,23,10,1990,2,"female",62,5,5,0,2,0,2,0,0
2034313,24,1,1989,1,"female",196,28,13,726,35,726,22,0,13
2034323,19,17,1994,7,"male",369,213,168,1,0,0,0,1,0
2034337,17,7,1996,9,"female",309,10,4,0,0,0,0,0,0
2034354,23,12,1990,3,"female",406,80,59,1,0,0,0,1,0
2034357,17,1,1996,1,"male",258,246,121,0,0,0,0,0,0
2034381,15,26,1998,1,"female",238,2,2,4,0,2,0,2,0
2034396,24,30,1989,4,"female",397,63,27,333,121,333,104,0,17
2034402,34,21,1979,2,"male",1543,65,44,1,1,0,1,1,0
2034457,60,20,1953,9,"female",2083,209,100,10,273,1,171,9,102
2034463,20,23,1993,3,"female",377,72,23,0,0,0,0,0,0
2034467,37,1,1976,1,"female",506,21,12,0,1,0,1,0,0
2034477,49,5,1964,5,"female",240,126,35,8,1,8,1,0,0
2034545,21,1,1992,2,"male",283,13,9,2,0,2,0,0,0
2034547,15,15,1998,12,"female",597,324,255,405,110,121,30,284,80
2034548,66,12,1947,12,"female",1870,702,416,423,288,423,209,0,79
2034582,46,23,1967,3,"female",703,10,7,24,39,5,27,19,12
2034606,18,24,1995,9,"male",217,104,34,9,5,9,2,0,3
2034615,18,21,1995,8,"male",809,759,515,0,45,0,28,0,17
2034664,24,9,1989,9,"male",526,125,62,22,0,22,0,0,0
2034694,22,30,1991,8,"male",431,186,104,30,56,30,56,0,0
2034696,33,17,1980,7,"male",1242,201,130,1,12,1,3,0,9
2034716,41,4,1972,6,"male",1244,91,17,7,22,2,12,5,10
2034734,21,18,1992,2,"male",360,64,51,11,1,0,0,11,1
2034740,15,28,1998,1,"female",253,244,133,11,0,11,0,0,0
2034800,25,22,1988,10,"male",486,502,404,10,9,10,9,0,0
2034802,93,4,1920,1,"female",1310,108,44,0,20,0,17,0,3
2034806,36,28,1977,9,"male",302,18,12,4,9,4,7,0,2
2034822,49,19,1964,10,"female",1399,371,160,1200,436,651,254,549,182
2034827,19,4,1994,9,"male",254,193,35,1,2,1,1,0,1
2034842,82,15,1931,11,"female",600,1,0,0,0,0,0,0,0
2034850,17,16,1996,9,"male",34,58,37,6,1,5,1,1,0
2034853,108,30,1905,5,"female",89,113,106,42,33,0,16,42,17
2034894,20,30,1993,5,"female",256,164,62,123,39,123,35,0,4
2034916,17,24,1996,2,"male",656,49,0,0,4,0,4,0,0
2034933,23,9,1990,2,"male",866,595,281,174,95,107,76,67,19
2034935,23,11,1990,6,"female",198,46,14,16,37,16,36,0,1
2034942,43,20,1970,2,"male",252,11,9,0,1,0,1,0,0
2035018,34,4,1979,12,"female",464,327,238,347,145,346,104,1,41
2035023,50,8,1963,12,"female",105,94,37,267,264,267,237,0,27
2035080,16,15,1997,1,"female",885,2502,1315,1870,883,40,240,1830,643
2035119,103,7,1910,7,"female",55,81,30,8,14,8,8,0,6
2035160,98,3,1915,1,"male",2054,48,10,164,28,164,20,0,8
2035186,58,22,1955,9,"female",378,102,76,15,28,2,3,13,25
2035211,23,30,1990,6,"male",356,1241,1065,12,11,11,11,1,0
2035247,13,1,2000,4,"male",84,24,16,3,0,0,0,3,0
2035250,29,18,1984,11,"male",455,258,98,8,4,1,3,7,1
2035265,24,5,1989,9,"female",131,34,28,0,0,0,0,0,0
2035274,19,19,1994,7,"male",427,371,257,36,6,4,3,32,3
2035279,51,11,1962,12,"female",406,71,44,3,4,3,1,0,3
2035285,20,1,1993,1,"male",61,22,5,3853,2935,3751,1067,102,1868
2035304,52,11,1961,12,"male",856,44,23,0,0,0,0,0,0
2035306,28,11,1985,11,"female",864,186,79,93,156,72,88,21,68
2035307,32,1,1981,1,"male",429,7,6,0,0,0,0,0,0
2035318,36,11,1977,6,"female",113,48,36,980,222,859,137,121,85
2035331,23,7,1990,9,"male",2,1,1,0,0,0,0,0,0
2035347,20,8,1993,10,"male",168,10,8,4,0,4,0,0,0
2035370,14,7,1999,7,"male",73,132,99,4,28,4,16,0,12
2035399,52,18,1961,8,"female",111,79,56,0,0,0,0,0,0
2035421,104,1,1909,11,"female",1057,650,140,69,83,69,70,0,13
2035429,43,29,1970,1,"male",297,58,49,1,0,0,0,1,0
2035435,18,27,1995,4,"female",347,110,71,0,0,0,0,0,0
2035450,90,3,1923,2,"female",811,15,6,6,14,0,1,6,13
2035474,25,1,1988,1,"female",42,28,22,2,19,2,15,0,4
2035475,23,9,1990,9,"male",156,30,25,1,0,0,0,1,0
2035485,54,5,1959,8,"male",801,3469,1557,5744,1978,2001,1301,3743,677
2035503,42,30,1971,11,"male",251,13,7,0,0,0,0,0,0
2035530,89,18,1924,10,"male",1240,107,41,26,26,6,17,20,9
2035543,103,14,1910,5,"female",803,590,385,446,1545,6,518,440,1027
2035574,68,1,1945,6,"male",322,71,52,244,130,244,86,0,44
2035589,55,24,1958,8,"female",222,111,93,83,47,0,19,83,28
2035613,40,7,1973,10,"male",19,7,6,80,10,0,1,80,9
2035651,30,27,1983,11,"male",357,384,286,100,100,28,37,72,63
2035670,20,3,1993,12,"male",519,151,91,50,4,50,4,0,0
2035682,36,2,1977,12,"male",601,93,52,45,59,45,51,0,8
2035687,24,2,1989,3,"female",402,1184,721,289,369,289,256,0,113
2035689,19,5,1994,3,"male",193,22,19,2,0,2,0,0,0
2035692,55,13,1958,4,"male",314,9,6,0,1,0,0,0,1
2035695,56,16,1957,11,"male",333,64,37,13,0,8,0,5,0
2035737,50,20,1963,3,"female",4,7,7,30,1,30,1,0,0
2035741,16,26,1997,9,"male",901,497,154,83,23,1,7,82,16
2035747,25,15,1988,4,"male",652,63,57,1,0,1,0,0,0
2035754,23,1,1990,1,"male",234,62,51,0,0,0,0,0,0
2035759,15,5,1998,7,"male",443,25,20,0,23,0,23,0,0
2035762,73,24,1940,6,"male",330,32,27,128,118,6,18,122,100
2035769,31,16,1982,7,"male",207,42,33,130,2,130,1,0,1
2035781,20,8,1993,1,"female",744,22,16,0,0,0,0,0,0
2035785,14,9,1999,5,"female",291,302,111,28,44,0,21,28,23
2035803,99,10,1914,12,"male",1733,171,29,1,4,1,2,0,2
2035827,54,16,1959,9,"female",311,8,7,24,0,24,0,0,0
2035849,54,16,1959,7,"female",1223,176,86,5,16,4,8,1,8
2035876,23,5,1990,4,"male",934,0,0,0,0,0,0,0,0
2035911,37,14,1976,10,"male",535,130,109,0,0,0,0,0,0
2035931,27,23,1986,2,"female",63,366,307,950,741,639,533,311,208
2035936,17,23,1996,9,"male",381,353,324,4,9,4,8,0,1
2035947,108,22,1905,1,"female",1093,152,68,81,264,66,54,15,210
2035950,21,19,1992,1,"male",431,84,20,101,61,52,36,49,25
2035967,27,14,1986,5,"female",406,154,62,760,1951,150,1053,610,898
2035996,33,20,1980,4,"male",319,252,196,9,0,9,0,0,0
2036042,44,8,1969,4,"female",1732,49,34,106,32,81,14,25,18
2036047,25,20,1988,10,"male",458,78,47,0,0,0,0,0,0
2036076,53,12,1960,11,"female",21,4,4,3,1,3,1,0,0
2036093,41,1,1972,1,"female",482,0,0,0,0,0,0,0,0
2036109,49,16,1964,6,"female",238,216,200,85,446,85,247,0,199
2036128,53,24,1960,9,"male",661,90,48,22,22,22,13,0,9
2036185,54,29,1959,11,"female",264,34,27,21,1,21,0,0,1
2036191,24,1,1989,6,"male",490,9,7,0,0,0,0,0,0
2036198,32,20,1981,2,"male",22,42,37,15,12,14,2,1,10
2036206,43,27,1970,11,"female",102,45,29,25,21,25,17,0,4
2036209,106,15,1907,2,"male",18,76,54,159,36,0,10,159,26
2036213,49,22,1964,12,"female",581,86,58,20,60,0,32,20,28
2036222,43,16,1970,7,"male",490,70,16,0,59,0,37,0,22
2036251,16,21,1997,11,"male",323,50,34,3,0,3,0,0,0
2036258,60,10,1953,11,"male",67,6,6,0,0,0,0,0,0
2036272,21,16,1992,8,"female",505,238,110,0,0,0,0,0,0
2036280,23,29,1990,1,"male",511,89,40,1,1,0,0,1,1
2036295,19,15,1994,12,"female",434,471,254,584,254,584,202,0,52
2036297,33,10,1980,10,"male",11,37,12,0,0,0,0,0,0
2036304,51,19,1962,4,"male",552,20,12,1,1,0,0,1,1
2036326,57,24,1956,7,"male",62,76,53,1,3,0,2,1,1
2036349,19,24,1994,5,"male",726,305,236,0,1,0,1,0,0
2036360,19,24,1994,9,"female",122,41,30,48,1,0,0,48,1
2036392,39,7,1974,3,"female",479,196,125,422,180,92,128,330,52
2036393,22,16,1991,11,"male",508,301,245,54,4,54,4,0,0
2036394,26,1,1987,1,"female",408,1,1,2,2,2,2,0,0
2036407,59,17,1954,1,"male",1369,176,109,1,0,1,0,0,0
2036419,28,10,1985,4,"male",172,112,86,0,3,0,2,0,1
2036431,28,2,1985,9,"female",338,90,49,81,167,8,129,73,38
2036442,21,21,1992,2,"male",397,150,125,0,1,0,0,0,1
2036528,30,3,1983,3,"male",680,0,0,0,0,0,0,0,0
2036535,19,1,1994,1,"male",329,65,59,0,5,0,1,0,4
2036538,16,13,1997,9,"male",140,97,79,0,1,0,1,0,0
2036543,16,14,1997,8,"male",39,25,20,6,4,6,4,0,0
2036544,84,10,1929,4,"female",312,33,20,46,42,0,4,46,38
2036569,18,6,1995,1,"male",70,52,39,3,8,3,0,0,8
2036584,34,25,1979,2,"male",328,3,1,2,0,0,0,2,0
2036610,20,20,1993,4,"male",845,82,46,0,0,0,0,0,0
2036652,38,8,1975,9,"female",55,30,23,745,97,745,78,0,19
2036749,22,11,1991,6,"male",105,175,131,375,9,375,9,0,0
2036757,19,22,1994,7,"male",354,59,38,0,0,0,0,0,0
2036771,20,25,1993,12,"male",176,105,31,0,0,0,0,0,0
2036780,37,5,1976,1,"female",586,177,134,305,277,275,144,30,133
2036788,52,19,1961,7,"male",162,8,3,5,1,5,1,0,0
2036806,37,27,1976,7,"female",41,19,14,112,51,112,7,0,44
2036817,62,18,1951,11,"female",1604,74,37,76,107,76,67,0,40
2036821,42,2,1971,7,"male",459,0,0,0,0,0,0,0,0
2036903,54,6,1959,4,"male",54,1,1,0,0,0,0,0,0
2036922,32,1,1981,7,"female",485,4,2,1,1,0,0,1,1
2036926,31,16,1982,2,"male",496,171,80,14,5,14,3,0,2
2036960,57,14,1956,4,"female",503,119,73,68,60,13,24,55,36
2036967,33,20,1980,5,"male",754,65,34,44,89,27,39,17,50
2036978,27,1,1986,3,"male",366,20,15,0,0,0,0,0,0
2036993,32,2,1981,2,"male",620,187,115,3,2,3,2,0,0
2037009,18,5,1995,3,"female",819,1124,506,526,178,471,94,55,84
2037044,55,9,1958,10,"female",409,53,24,1546,220,1546,151,0,69
2037060,33,10,1980,2,"male",555,55,51,0,0,0,0,0,0
2037084,65,7,1948,4,"female",109,0,0,0,0,0,0,0,0
2037123,15,20,1998,9,"female",513,35,11,199,11,0,5,199,6
2037138,15,10,1998,10,"female",446,217,76,1,6,1,5,0,1
2037147,19,1,1994,10,"female",702,379,222,3,2,3,2,0,0
2037157,18,23,1995,9,"male",62,86,25,2,15,2,12,0,3
2037158,19,10,1994,4,"male",65,15,8,0,0,0,0,0,0
2037166,19,15,1994,8,"male",68,61,35,165,51,165,45,0,6
2037168,85,15,1928,8,"male",7,814,662,30,8,0,8,30,0
2037203,25,1,1988,4,"male",264,196,73,15,4,15,3,0,1
2037222,106,1,1907,12,"female",1406,208,49,84,97,40,70,44,27
2037242,18,10,1995,5,"male",807,69,46,0,5,0,1,0,4
2037243,58,10,1955,6,"male",505,49,36,68,91,0,17,68,74
2037247,24,12,1989,12,"male",909,592,445,16,15,6,14,10,1
2037263,16,11,1997,11,"female",33,42,18,2,1,0,0,2,1
2037271,14,10,1999,1,"male",326,1255,1127,335,103,212,66,123,37
2037280,31,31,1982,12,"male",83,18,11,18,3,18,3,0,0
2037309,30,7,1983,1,"female",470,211,139,3,0,0,0,3,0
2037318,39,31,1974,12,"female",159,5,0,0,0,0,0,0,0
2037370,30,1,1983,1,"male",430,104,63,79,41,79,39,0,2
2037375,89,16,1924,1,"female",1612,167,63,1186,370,1174,253,12,117
2037410,37,21,1976,5,"female",474,28,17,2,9,0,5,2,4
2037416,53,18,1960,2,"female",411,45,36,1,10,1,4,0,6
2037420,24,23,1989,10,"female",1443,595,284,165,81,164,68,1,13
2037447,19,29,1994,7,"male",427,306,259,38,59,36,46,2,13
2037482,63,2,1950,11,"female",1898,132,47,321,237,303,122,18,115
2037486,21,15,1992,7,"male",206,144,133,89,37,89,30,0,7
2037499,21,22,1992,11,"male",434,30,24,80,48,0,4,80,44
2037503,55,19,1958,8,"male",327,135,79,13,4,13,4,0,0
2037504,106,18,1907,11,"male",295,113,71,1,5,1,3,0,2
2037509,18,2,1995,7,"male",12,41,36,48,22,48,22,0,0
2037537,21,25,1992,5,"female",191,69,51,1,2,0,0,1,2
2037545,19,8,1994,11,"female",478,267,240,0,0,0,0,0,0
2037569,101,26,1912,6,"female",1532,253,65,2,1,1,1,1,0
2037575,24,6,1989,6,"female",269,231,144,1045,118,1045,114,0,4
2037593,42,19,1971,2,"male",415,5,4,0,0,0,0,0,0
2037603,26,1,1987,7,"male",294,42,26,0,0,0,0,0,0
2037607,19,12,1994,11,"male",598,115,57,0,1,0,1,0,0
2037620,17,13,1996,12,"male",450,288,255,2,0,0,0,2,0
2037625,39,1,1974,6,"female",190,69,49,918,391,873,139,45,252
2037629,67,2,1946,8,"male",560,23,9,0,0,0,0,0,0
2037662,30,31,1983,7,"female",268,123,87,59,89,59,55,0,34
2037678,103,23,1910,8,"female",1285,364,171,214,94,35,28,179,66
2037679,39,24,1974,9,"female",541,24,11,9,3,9,2,0,1
2037682,103,1,1910,5,"male",711,214,177,12,1,12,1,0,0
2037693,41,23,1972,7,"male",407,32,24,6,1,6,1,0,0
2037699,27,26,1986,3,"male",495,61,22,3,0,3,0,0,0
2037727,21,10,1992,1,"male",418,102,86,1,44,1,13,0,31
2037748,15,18,1998,2,"male",221,0,0,0,0,0,0,0,0
2037760,28,3,1985,7,"male",51,54,44,7,10,7,9,0,1
2037784,28,23,1985,10,"male",549,0,0,0,2,0,2,0,0
2037822,21,1,1992,1,"male",66,0,0,0,0,0,0,0,0
2037823,33,2,1980,1,"male",183,140,91,0,0,0,0,0,0
2037878,19,10,1994,6,"female",350,330,165,86,200,86,176,0,24
2037887,15,20,1998,8,"female",207,195,152,66,84,66,58,0,26
2037897,19,2,1994,12,"male",813,246,150,14,6,0,3,14,3
2037907,38,16,1975,5,"female",641,100,58,91,84,91,83,0,1
2037908,18,2,1995,7,"male",264,166,119,0,2,0,2,0,0
2037914,14,1,1999,1,"female",14,18,11,0,2,0,0,0,2
2037923,19,10,1994,12,"female",805,971,184,122,221,78,210,44,11
2037925,23,9,1990,4,"male",337,41,38,1,0,1,0,0,0
2037926,22,1,1991,1,"female",567,72,11,0,0,0,0,0,0
2037958,32,21,1981,5,"male",255,82,55,51,72,51,37,0,35
2038069,43,14,1970,10,"male",262,5,5,0,1,0,0,0,1
2038089,58,15,1955,11,"female",638,108,59,108,72,0,11,108,61
2038092,44,9,1969,3,"male",113,2,2,1,0,1,0,0,0
2038114,25,22,1988,9,"female",76,82,70,2,6,2,5,0,1
2038115,21,26,1992,10,"female",718,4698,811,475,871,475,759,0,112
2038119,62,25,1951,6,"male",450,2,2,3,4,0,2,3,2
2038137,42,20,1971,1,"female",834,15,8,8,0,0,0,8,0
2038149,27,26,1986,2,"male",413,151,125,65,11,65,7,0,4
2038150,29,19,1984,12,"male",451,107,81,0,0,0,0,0,0
2038159,22,17,1991,3,"male",195,7,5,9,14,9,9,0,5
2038163,44,23,1969,4,"female",2058,203,57,249,253,173,178,76,75
2038176,60,31,1953,10,"female",336,12,5,4,5,0,4,4,1
2038193,52,5,1961,4,"male",819,3,3,9,0,8,0,1,0
2038203,32,13,1981,9,"male",1034,20,5,2,3,2,3,0,0
2038211,33,23,1980,2,"male",250,103,45,7,21,7,15,0,6
2038241,31,15,1982,1,"male",48,0,0,0,0,0,0,0,0
2038242,22,17,1991,5,"female",254,40,17,1,0,1,0,0,0
2038258,42,6,1971,7,"male",1467,14,8,0,1,0,1,0,0
2038291,35,21,1978,4,"male",1902,26,23,512,298,510,265,2,33
2038310,64,22,1949,8,"female",1372,64,28,149,36,0,0,149,36
2038312,30,3,1983,3,"female",412,285,262,1,2,1,2,0,0
2038330,108,7,1905,9,"female",2278,67,35,56,37,34,23,22,14
2038352,40,27,1973,9,"male",559,19,15,2,5,2,4,0,1
2038354,58,8,1955,8,"female",576,130,103,171,180,147,57,24,123
2038359,81,26,1932,4,"male",1383,53,25,327,114,0,16,327,98
2038374,21,10,1992,2,"male",59,52,39,74,9,74,8,0,1
2038376,56,13,1957,9,"female",1716,199,68,261,278,215,134,46,144
2038380,17,7,1996,11,"female",538,1011,683,442,1554,416,927,26,627
2038450,103,7,1910,12,"female",606,145,66,10,8,10,8,0,0
2038457,21,30,1992,12,"male",278,28,25,0,0,0,0,0,0
2038473,15,31,1998,8,"female",75,28,21,7,1,7,1,0,0
2038478,17,15,1996,1,"male",422,26,11,0,0,0,0,0,0
2038516,27,2,1986,12,"female",804,437,298,26,114,25,72,1,42
2038542,18,4,1995,12,"male",447,78,58,0,0,0,0,0,0
2038549,64,26,1949,8,"male",1138,68,28,2,0,0,0,2,0
2038554,103,2,1910,2,"female",327,314,63,1,3,1,1,0,2
2038556,30,30,1983,3,"male",488,9,8,2,3,2,3,0,0
2038559,49,5,1964,12,"male",591,109,99,65,82,0,37,65,45
2038561,20,11,1993,6,"female",887,406,257,1018,1955,987,1542,31,413
2038572,20,30,1993,12,"female",354,412,238,248,378,166,170,82,208
2038585,14,6,1999,4,"male",128,22,14,0,0,0,0,0,0
2038588,22,8,1991,11,"male",36,155,151,0,0,0,0,0,0
2038590,60,9,1953,7,"female",250,58,44,180,16,180,7,0,9
2038623,69,8,1944,5,"female",1000,20,11,395,201,14,19,381,182
2038634,17,29,1996,2,"male",269,70,42,20,19,3,2,17,17
2038640,19,1,1994,3,"female",209,231,186,142,71,138,49,4,22
2038641,108,7,1905,5,"male",1385,90,49,16,14,16,1,0,13
2038656,22,25,1991,10,"male",679,196,149,58,4,58,3,0,1
2038683,32,26,1981,5,"male",524,193,83,66,7,66,4,0,3
2038693,54,17,1959,9,"male",735,36,18,2,6,2,3,0,3
2038696,26,1,1987,1,"male",454,17,13,34,0,34,0,0,0
2038702,53,8,1960,7,"female",526,52,38,5,2,0,0,5,2
2038722,23,24,1990,8,"female",624,156,115,435,388,423,326,12,62
2038768,15,2,1998,8,"female",388,821,157,9,20,9,15,0,5
2038777,25,1,1988,1,"male",194,21,9,3,0,3,0,0,0
2038788,23,1,1990,1,"male",209,3,3,0,0,0,0,0,0
2038799,28,5,1985,9,"female",495,117,37,510,320,1,237,509,83
2038824,39,1,1974,1,"male",575,168,85,2,0,1,0,1,0
2038837,29,30,1984,6,"male",386,17,11,1,1,0,0,1,1
2038841,20,1,1993,1,"female",604,100,56,0,0,0,0,0,0
2038846,15,6,1998,7,"male",321,58,13,1,0,1,0,0,0
2038849,25,8,1988,8,"male",124,128,115,921,248,921,186,0,62
2038885,27,8,1986,8,"male",483,162,126,8,15,3,11,5,4
2038896,18,1,1995,1,"male",612,225,106,2,1,2,1,0,0
2038900,19,12,1994,5,"female",728,413,252,23,92,23,32,0,60
2038901,20,14,1993,2,"male",480,80,45,0,18,0,4,0,14
2038913,32,26,1981,11,"female",603,72,40,369,1147,132,479,237,668
2038922,48,11,1965,12,"male",189,71,48,1,4,1,4,0,0
2038950,57,18,1956,3,"female",1440,35,27,0,0,0,0,0,0
2038953,31,8,1982,4,"male",206,0,0,0,0,0,0,0,0
2038965,20,6,1993,5,"female",258,703,490,710,629,13,401,697,228
2038967,29,15,1984,7,"female",566,7,4,422,6,0,1,422,5
2038976,27,28,1986,4,"male",457,52,29,1,0,0,0,1,0
2039035,51,4,1962,3,"male",55,22,16,0,0,0,0,0,0
2039058,14,1,1999,12,"male",356,121,63,2,2,0,0,2,2
2039060,15,8,1998,6,"male",495,29,17,22,0,0,0,22,0
2039063,37,23,1976,8,"male",2,6,6,0,2,0,2,0,0
2039082,23,6,1990,4,"male",937,191,163,1,15,0,3,1,12
2039101,55,30,1958,9,"male",1107,57,42,31,2,0,1,31,1
2039104,26,15,1987,1,"male",458,299,192,2,5,2,5,0,0
2039107,22,14,1991,11,"male",136,99,70,4,4,4,3,0,1
2039191,27,8,1986,6,"female",541,119,69,21,37,21,35,0,2
2039207,41,23,1972,6,"male",126,14,10,0,0,0,0,0,0
2039213,26,3,1987,12,"male",550,13,7,0,0,0,0,0,0
2039227,23,12,1990,12,"male",228,203,180,32,11,32,9,0,2
2039232,15,14,1998,9,"male",238,252,92,173,139,64,77,109,62
2039234,99,30,1914,6,"female",238,97,27,0,0,0,0,0,0
2039237,66,27,1947,11,"female",1601,86,43,11,71,0,24,11,47
2039261,18,18,1995,1,"female",424,429,290,102,192,75,78,27,114
2039264,21,9,1992,5,"male",465,124,92,16,15,9,8,7,7
2039266,31,16,1982,8,"female",161,57,43,927,1455,7,127,920,1328
2039309,75,24,1938,1,"female",2009,316,125,157,13,156,4,1,9
2039311,66,5,1947,9,"female",1962,35,6,585,176,577,74,8,102
2039320,32,1,1981,5,"female",552,228,65,36,81,36,25,0,56
2039321,56,12,1957,11,"female",384,32,13,12,1,12,0,0,1
2039336,65,9,1948,3,"female",276,49,36,177,88,177,66,0,22
2039340,68,4,1945,7,"female",570,74,36,0,0,0,0,0,0
2039342,24,21,1989,6,"male",621,450,396,441,441,441,327,0,114
2039346,100,13,1913,9,"female",769,202,151,123,94,7,51,116,43
2039348,19,12,1994,10,"female",370,1826,661,825,1536,825,1398,0,138
2039352,43,24,1970,4,"female",1205,784,83,80,728,80,583,0,145
2039357,42,20,1971,3,"female",616,32,19,6,1,6,1,0,0
2039360,17,10,1996,7,"female",1532,3461,718,5,141,4,81,1,60
2039397,26,26,1987,8,"female",744,1141,109,4,0,4,0,0,0
2039405,101,9,1912,5,"female",553,373,178,1610,742,1467,457,143,285
2039410,17,16,1996,5,"female",397,322,204,159,45,124,24,35,21
2039425,22,9,1991,7,"female",21,338,311,1232,876,1184,682,48,194
2039440,57,21,1956,10,"female",1463,163,77,331,201,323,145,8,56
2039451,23,3,1990,11,"male",352,196,141,28,7,28,5,0,2
2039469,40,26,1973,1,"male",170,55,38,16,0,16,0,0,0
2039527,33,21,1980,8,"male",639,67,6,0,0,0,0,0,0
2039528,56,20,1957,7,"female",493,37,18,0,0,0,0,0,0
2039547,33,25,1980,11,"male",438,244,210,89,53,89,46,0,7
2039556,21,3,1992,2,"male",353,6,5,0,0,0,0,0,0
2039568,22,14,1991,7,"female",499,185,127,55,36,55,16,0,20
2039602,71,16,1942,8,"female",1002,63,49,0,0,0,0,0,0
2039653,21,3,1992,9,"female",452,51,35,2,10,2,7,0,3
2039670,26,1,1987,1,"female",332,14,4,0,0,0,0,0,0
2039692,55,30,1958,9,"male",368,13,9,84,60,30,46,54,14
2039698,19,3,1994,3,"female",624,565,433,2925,1115,1863,693,1062,422
2039704,23,11,1990,8,"male",719,132,111,0,1,0,1,0,0
2039723,37,1,1976,1,"male",264,6,5,10,8,10,8,0,0
2039740,19,19,1994,8,"female",840,1086,657,313,394,82,290,231,104
2039746,24,22,1989,12,"male",378,47,1,0,0,0,0,0,0
2039751,15,12,1998,10,"female",183,118,87,0,0,0,0,0,0
2039754,27,11,1986,7,"male",458,471,406,173,116,173,108,0,8
2039758,66,24,1947,2,"male",1846,0,0,0,0,0,0,0,0
2039787,28,16,1985,2,"male",582,96,46,21,12,13,8,8,4
2039793,19,6,1994,6,"female",414,424,269,413,289,6,23,407,266
2039811,20,10,1993,12,"male",267,10,5,0,1,0,0,0,1
2039828,28,8,1985,5,"male",267,85,19,10,0,5,0,5,0
2039839,57,2,1956,6,"male",270,292,133,2,2,2,2,0,0
2039844,27,18,1986,4,"male",354,237,189,4,9,4,6,0,3
2039849,13,7,2000,2,"female",224,119,45,25,60,25,28,0,32
2039853,28,16,1985,1,"male",1003,204,147,3,2,3,2,0,0
2039870,27,10,1986,7,"female",366,48,34,0,1,0,1,0,0
2039872,29,14,1984,3,"male",386,22,21,7,5,5,0,2,5
2039884,67,14,1946,9,"male",1728,8,5,1,1,1,1,0,0
2039886,27,28,1986,3,"female",532,41,8,3,0,3,0,0,0
2039887,64,8,1949,10,"female",421,67,57,20,13,20,7,0,6
2039892,48,4,1965,4,"male",23,1,1,0,0,0,0,0,0
2039893,20,13,1993,11,"male",157,72,40,6,7,6,4,0,3
2039901,16,1,1997,1,"male",1178,2,0,0,0,0,0,0,0
2039908,20,2,1993,9,"female",336,920,276,91,122,64,57,27,65
2039932,27,14,1986,9,"male",397,76,57,0,4,0,4,0,0
2039935,47,12,1966,3,"female",413,184,117,1077,1075,0,93,1077,982
2039967,72,8,1941,6,"male",388,2,2,0,0,0,0,0,0
2040001,65,20,1948,8,"male",912,319,164,96,9,96,4,0,5
2040016,63,27,1950,10,"male",135,44,31,8,4,8,4,0,0
2040040,69,14,1944,10,"female",385,167,97,111,108,90,46,21,62
2040059,60,12,1953,9,"male",1283,220,90,13,149,1,86,12,63
2040078,94,1,1919,1,"female",979,4,3,0,0,0,0,0,0
2040102,20,28,1993,9,"female",686,280,147,449,617,219,417,230,200
2040105,37,2,1976,2,"male",1337,13,12,11,6,9,3,2,3
2040127,38,19,1975,5,"female",819,547,331,129,187,129,132,0,55
2040133,30,10,1983,6,"male",329,107,73,0,0,0,0,0,0
2040151,34,25,1979,3,"male",786,1,0,0,0,0,0,0,0
2040167,21,3,1992,12,"male",221,99,93,2,0,0,0,2,0
2040179,30,23,1983,9,"female",762,6,2,2,1,2,1,0,0
2040211,61,22,1952,3,"female",223,37,28,3,85,0,64,3,21
2040216,21,1,1992,1,"female",648,163,74,40,1,40,1,0,0
2040218,46,18,1967,5,"female",186,45,22,108,11,108,5,0,6
2040238,14,9,1999,2,"female",465,1582,1055,337,1544,98,872,239,672
2040247,44,3,1969,12,"male",708,70,30,0,0,0,0,0,0
2040256,26,18,1987,9,"female",1545,898,252,107,269,71,137,36,132
2040263,18,2,1995,1,"male",640,215,110,2640,634,2501,419,139,215
2040267,84,11,1929,11,"female",611,33,21,14,9,0,2,14,7
2040268,19,5,1994,5,"male",286,330,274,35,90,35,81,0,9
2040320,18,19,1995,9,"female",397,76,61,92,8,0,4,92,4
2040343,22,14,1991,1,"male",23,1,1,0,0,0,0,0,0
2040354,53,19,1960,3,"male",434,35,25,109,66,34,42,75,24
2040372,20,11,1993,6,"male",135,50,17,0,0,0,0,0,0
2040394,108,2,1905,4,"male",467,249,151,1042,441,1042,428,0,13
2040401,25,1,1988,1,"male",416,5,4,1,0,0,0,1,0
2040413,16,24,1997,12,"female",314,2,1,1,0,1,0,0,0
2040443,53,23,1960,5,"female",265,173,44,50,79,50,47,0,32
2040444,26,2,1987,1,"male",601,408,360,624,1042,624,986,0,56
2040470,51,29,1962,4,"female",1167,91,40,315,339,18,175,297,164
2040478,40,29,1973,9,"male",515,82,60,5,2,0,0,5,2
2040502,17,17,1996,11,"female",10,18,14,74,9,74,5,0,4
2040504,65,14,1948,1,"male",926,202,165,601,940,522,568,79,372
2040514,16,30,1997,8,"male",429,1,1,1,0,1,0,0,0
2040585,17,24,1996,5,"male",80,338,330,22,1,22,1,0,0
2040606,16,13,1997,6,"male",192,521,383,986,107,705,69,281,38
2040610,23,3,1990,6,"male",402,253,154,41,17,33,10,8,7
2040613,26,8,1987,4,"male",685,119,105,6,3,1,3,5,0
2040634,45,25,1968,8,"female",508,38,26,0,0,0,0,0,0
2040678,22,17,1991,2,"male",506,198,172,12,3,6,2,6,1
2040681,55,8,1958,5,"female",1827,18,10,2,4,2,4,0,0
2040717,19,11,1994,8,"female",306,723,364,428,642,409,350,19,292
2040720,73,1,1940,4,"female",2478,128,49,1,20,0,16,1,4
2040778,36,26,1977,9,"male",432,48,34,0,0,0,0,0,0
2040783,19,2,1994,2,"female",423,1115,467,1434,4191,1404,2715,30,1476
2040786,18,17,1995,11,"female",294,286,237,29,1,29,1,0,0
2040816,18,18,1995,1,"female",186,102,51,16,42,4,9,12,33
2040829,33,19,1980,9,"female",273,134,111,2825,3,2825,2,0,1
2040855,60,9,1953,8,"female",1273,17,7,5,9,0,5,5,4
2040890,21,30,1992,11,"female",475,52,28,0,3,0,3,0,0
2040932,15,23,1998,10,"male",573,169,111,32,5,5,0,27,5
2040935,22,21,1991,9,"male",588,90,22,5,2,1,1,4,1
2040942,71,27,1942,1,"male",867,23,11,5,2,5,1,0,1
2040943,30,12,1983,8,"male",111,151,120,45,63,26,40,19,23
2041002,50,13,1963,10,"female",1034,231,132,1207,738,165,191,1042,547
2041061,19,4,1994,7,"male",132,23,13,4,4,0,1,4,3
2041084,21,14,1992,11,"male",173,137,100,50,47,31,26,19,21
2041104,22,2,1991,1,"male",540,3,3,0,0,0,0,0,0
2041179,14,18,1999,11,"female",301,70,32,3,2,0,0,3,2
2041181,17,1,1996,3,"male",138,67,46,23,2,2,0,21,2
2041207,31,4,1982,4,"male",226,1,1,0,1,0,1,0,0
2041234,15,23,1998,9,"female",325,145,91,82,24,82,15,0,9
2041242,25,6,1988,1,"female",406,36,23,21,17,17,13,4,4
2041253,108,23,1905,8,"female",850,63,55,27,66,0,9,27,57
2041255,20,31,1993,7,"male",1544,221,54,71,54,71,33,0,21
2041292,21,10,1992,11,"male",336,80,62,22,32,22,25,0,7
2041297,22,19,1991,7,"female",277,14,4,0,0,0,0,0,0
2041350,35,24,1978,11,"female",414,31,15,65,77,65,75,0,2
2041372,27,23,1986,10,"male",402,55,47,1,0,1,0,0,0
2041414,19,28,1994,6,"male",119,135,125,3,0,3,0,0,0
2041424,23,12,1990,12,"male",80,75,49,22,16,17,4,5,12
2041427,37,25,1976,4,"female",267,43,35,71,163,71,144,0,19
2041440,36,8,1977,2,"male",443,50,39,0,0,0,0,0,0
2041443,38,26,1975,7,"male",504,4,1,0,0,0,0,0,0
2041447,31,28,1982,7,"male",485,274,261,0,0,0,0,0,0
2041454,16,12,1997,1,"male",481,519,461,53,4,53,4,0,0
2041458,22,27,1991,3,"male",394,29,28,0,0,0,0,0,0
2041476,19,6,1994,10,"female",590,162,82,1,0,1,0,0,0
2041477,33,1,1980,1,"male",25,65,35,2,3,2,1,0,2
2041507,24,11,1989,8,"male",298,3,2,0,0,0,0,0,0
2041508,13,23,2000,3,"female",140,362,35,1,5,1,5,0,0
2041538,44,19,1969,12,"male",549,100,35,0,0,0,0,0,0
2041602,63,23,1950,12,"female",810,129,100,442,198,413,118,29,80
2041608,52,1,1961,11,"male",716,9,9,1,0,1,0,0,0
2041675,56,16,1957,9,"male",536,38,22,1,0,1,0,0,0
2041682,19,16,1994,7,"female",612,0,0,0,0,0,0,0,0
2041688,19,12,1994,10,"male",454,291,151,0,28,0,20,0,8
2041706,32,15,1981,2,"male",6,12,11,1,0,0,0,1,0
2041710,38,1,1975,8,"male",581,294,211,0,14,0,9,0,5
2041725,19,3,1994,10,"male",36,389,316,3071,1195,2947,302,124,893
2041738,20,10,1993,7,"female",319,102,40,1,42,1,42,0,0
2041740,56,21,1957,2,"female",1228,63,16,48,24,48,5,0,19
2041756,23,22,1990,2,"male",431,66,41,214,0,214,0,0,0
2041791,56,1,1957,11,"male",338,58,43,0,0,0,0,0,0
2041856,29,2,1984,2,"male",577,18,11,0,0,0,0,0,0
2041869,98,15,1915,9,"male",1200,296,109,14,8,14,3,0,5
2041883,31,18,1982,11,"male",327,64,47,91,61,91,54,0,7
2041916,106,22,1907,4,"male",1315,195,151,121,121,117,69,4,52
2041936,21,21,1992,12,"female",549,74,35,8,3,8,3,0,0
2041944,60,20,1953,2,"female",172,95,60,18,62,0,13,18,49
2041957,27,10,1986,7,"male",125,223,201,70,147,32,93,38,54
2041972,31,23,1982,11,"male",369,42,31,80,3,80,3,0,0
2042001,50,10,1963,9,"female",1317,105,69,66,83,66,66,0,17
2042029,64,26,1949,8,"female",1574,225,130,665,129,665,102,0,27
2042034,21,3,1992,9,"male",442,99,62,0,0,0,0,0,0
2042057,28,26,1985,6,"male",674,14,4,0,2,0,2,0,0
2042071,84,17,1929,6,"male",58,4,4,0,0,0,0,0,0
2042103,34,10,1979,10,"female",164,190,152,276,170,210,131,66,39
2042118,55,15,1958,10,"male",623,82,44,0,1,0,1,0,0
2042137,74,4,1939,3,"male",88,436,245,136,113,0,3,136,110
2042152,46,25,1967,11,"female",273,46,18,5,18,5,8,0,10
2042156,25,1,1988,1,"female",71,6,5,5,0,5,0,0,0
2042173,46,3,1967,11,"female",2050,538,400,104,116,99,104,5,12
2042181,31,7,1982,7,"male",696,242,116,0,2,0,2,0,0
2042207,108,9,1905,6,"female",235,66,15,72,12,72,8,0,4
2042208,60,14,1953,10,"male",79,69,54,26,46,26,21,0,25
2042243,21,9,1992,11,"female",1072,1975,385,65,212,6,101,59,111
2042245,31,5,1982,6,"female",302,121,82,697,139,194,32,503,107
2042248,58,16,1955,4,"female",1930,13,6,2,1,1,1,1,0
2042256,28,19,1985,9,"male",577,137,98,41,9,18,0,23,9
2042285,17,21,1996,3,"male",561,8,5,0,0,0,0,0,0
2042289,16,17,1997,5,"female",472,1,1,0,0,0,0,0,0
2042299,22,27,1991,6,"female",713,114,74,49,79,27,59,22,20
2042321,43,11,1970,3,"male",504,11,6,20,0,14,0,6,0
2042331,16,25,1997,11,"male",578,529,326,3,28,3,28,0,0
2042360,108,8,1905,8,"female",1076,309,209,11,4,11,4,0,0
2042381,46,22,1967,5,"male",645,118,69,370,598,354,454,16,144
2042382,33,31,1980,8,"male",316,159,109,0,6,0,3,0,3
2042400,23,15,1990,8,"female",465,123,29,84,121,84,118,0,3
2042436,53,29,1960,3,"female",280,34,18,7,3,7,2,0,1
2042440,34,25,1979,3,"male",181,94,63,148,94,130,64,18,30
2042465,21,23,1992,3,"male",469,81,60,0,0,0,0,0,0
2042479,18,14,1995,1,"female",544,4,2,7,0,7,0,0,0
2042482,20,23,1993,10,"female",702,336,138,1,3,1,1,0,2
2042491,88,25,1925,10,"male",685,417,274,1068,488,4,356,1064,132
2042512,18,8,1995,8,"male",325,255,130,26,23,19,15,7,8
2042547,25,15,1988,2,"female",830,38,4,0,1,0,1,0,0
2042554,23,25,1990,1,"male",547,94,34,3,0,3,0,0,0
2042576,45,21,1968,4,"male",563,12,3,1,0,1,0,0,0
2042607,45,9,1968,8,"female",814,61,37,206,13,206,8,0,5
2042633,15,17,1998,4,"female",5,7,7,0,0,0,0,0,0
2042658,22,9,1991,9,"female",456,142,38,3,60,3,30,0,30
2042663,29,27,1984,12,"female",393,173,155,59,79,45,67,14,12
2042673,28,1,1985,1,"female",317,67,39,213,278,213,208,0,70
2042675,21,8,1992,5,"female",485,52,38,3,1,0,1,3,0
2042688,15,18,1998,2,"male",902,1143,803,446,122,365,112,81,10
2042706,21,1,1992,6,"male",33,29,27,1,3,1,3,0,0
2042736,77,7,1936,3,"female",43,744,359,44,8,10,6,34,2
2042743,16,1,1997,8,"male",72,15,14,1,1,1,1,0,0
2042745,108,1,1905,4,"female",1361,23,8,20,26,0,16,20,10
2042749,54,11,1959,12,"female",966,150,94,50,191,50,157,0,34
2042761,20,21,1993,2,"male",456,104,67,2,0,2,0,0,0
2042815,31,10,1982,4,"male",192,59,38,2,1,2,0,0,1
2042824,34,30,1979,12,"male",566,93,39,0,2,0,2,0,0
2042846,19,14,1994,7,"male",303,338,160,1,0,0,0,1,0
2042855,26,25,1987,4,"male",90,7,7,0,0,0,0,0,0
2042867,52,23,1961,9,"male",379,3,3,0,0,0,0,0,0
2042870,63,18,1950,7,"female",1688,36,21,0,1,0,1,0,0
2042877,21,18,1992,1,"female",638,994,536,351,56,351,38,0,18
2042890,23,10,1990,11,"male",779,1575,909,2580,1944,276,1553,2304,391
2042902,22,3,1991,5,"female",385,30,20,30,0,30,0,0,0
2042905,17,18,1996,10,"male",536,1,1,0,0,0,0,0,0
2042941,35,24,1978,4,"male",284,144,121,143,172,142,125,1,47
2042959,37,10,1976,6,"male",1741,160,96,121,26,121,17,0,9
2042987,19,23,1994,5,"female",491,374,263,716,222,662,113,54,109
2043003,32,5,1981,9,"male",18,12,9,0,0,0,0,0,0
2043007,14,15,1999,5,"female",77,647,173,64,108,57,96,7,12
2043030,28,18,1985,2,"male",304,8,8,0,0,0,0,0,0
2043062,63,23,1950,10,"male",1625,263,155,40,22,0,2,40,20
2043081,108,8,1905,3,"male",1202,528,244,122,106,88,44,34,62
2043082,18,14,1995,6,"female",460,845,584,704,486,282,280,422,206
2043088,19,22,1994,5,"female",438,219,121,0,86,0,46,0,40
2043101,74,3,1939,3,"male",1168,78,21,67,6,0,5,67,1
2043120,39,3,1974,10,"female",309,201,36,53,84,53,14,0,70
2043122,17,19,1996,4,"female",211,384,249,923,306,880,144,43,162
2043133,14,16,1999,11,"male",160,56,47,6,40,6,34,0,6
2043134,18,8,1995,2,"female",74,379,327,13,122,13,43,0,79
2043136,29,21,1984,10,"female",333,25,18,41,0,41,0,0,0
2043189,24,9,1989,3,"male",668,103,69,5,5,5,3,0,2
2043206,24,5,1989,3,"male",418,62,49,1,3,1,3,0,0
2043216,53,27,1960,10,"female",1112,38,23,2,19,2,17,0,2
2043219,60,19,1953,4,"female",293,103,78,165,25,165,18,0,7
2043226,30,4,1983,8,"female",217,11,5,0,0,0,0,0,0
2043228,68,23,1945,1,"male",569,620,412,2956,1679,2956,1480,0,199
2043245,49,30,1964,8,"male",96,4,4,1,0,1,0,0,0
2043257,21,18,1992,3,"male",574,23,17,0,0,0,0,0,0
2043260,61,21,1952,3,"male",234,0,0,0,0,0,0,0,0
2043277,65,6,1948,10,"female",373,26,18,0,0,0,0,0,0
2043292,59,23,1954,6,"female",1112,830,638,1267,86,0,27,1267,59
2043317,73,13,1940,12,"male",571,75,25,1,0,1,0,0,0
2043326,16,5,1997,7,"male",110,7,7,0,0,0,0,0,0
2043330,14,8,1999,2,"male",376,41,34,0,0,0,0,0,0
2043333,23,7,1990,8,"male",128,2,2,0,0,0,0,0,0
2043384,23,20,1990,12,"female",586,76,26,0,11,0,7,0,4
2043395,29,2,1984,10,"male",411,1,1,0,0,0,0,0,0
2043403,15,15,1998,3,"female",419,347,278,2664,1562,2421,1007,243,555
2043406,37,5,1976,5,"male",278,1,1,0,0,0,0,0,0
2043414,18,9,1995,3,"female",317,1412,539,287,1005,273,424,14,581
2043422,25,27,1988,2,"male",38,37,27,5,7,5,2,0,5
2043447,20,24,1993,3,"male",682,36,30,0,0,0,0,0,0
2043488,23,26,1990,12,"female",544,138,91,90,110,77,68,13,42
2043500,45,12,1968,1,"male",227,12,5,49,14,12,6,37,8
2043501,19,16,1994,5,"male",686,82,39,46,46,36,37,10,9
2043509,34,2,1979,2,"female",200,1,1,0,0,0,0,0,0
2043516,83,15,1930,9,"male",1742,261,173,1,8,1,4,0,4
2043526,29,3,1984,7,"male",774,91,56,6,47,0,32,6,15
2043527,18,11,1995,8,"male",80,0,0,0,0,0,0,0,0
2043528,103,21,1910,5,"male",643,221,180,12,10,9,10,3,0
2043530,22,1,1991,10,"male",597,245,161,0,10,0,3,0,7
2043539,18,6,1995,3,"female",244,18,5,14,2,0,0,14,2
2043558,56,12,1957,1,"male",391,11,4,0,0,0,0,0,0
2043603,36,21,1977,11,"female",267,67,41,299,119,299,91,0,28
2043629,51,18,1962,5,"female",841,178,37,79,86,79,46,0,40
2043651,53,12,1960,8,"male",631,225,143,7,114,7,88,0,26
2043664,17,30,1996,6,"female",707,544,391,319,117,286,78,33,39
2043678,23,19,1990,5,"male",809,219,100,5,5,5,3,0,2
2043698,83,23,1930,3,"female",1096,1208,316,750,806,569,476,181,330
2043737,32,17,1981,10,"female",260,45,21,229,39,226,36,3,3
2043769,35,8,1978,12,"female",191,65,44,82,69,82,64,0,5
2043771,15,23,1998,1,"female",331,217,186,2,4,1,4,1,0
2043796,21,3,1992,1,"male",62,6,4,5,4,0,0,5,4
2043810,30,11,1983,4,"female",967,163,95,70,69,40,20,30,49
2043820,20,16,1993,6,"male",433,571,476,0,0,0,0,0,0
2043867,29,14,1984,8,"male",286,2,1,0,0,0,0,0,0
2043884,21,12,1992,8,"female",134,107,39,2,13,2,4,0,9
2043893,31,17,1982,10,"male",671,100,73,64,93,64,93,0,0
2043894,63,3,1950,3,"female",1071,245,221,20,16,10,6,10,10
2043914,23,14,1990,8,"female",482,209,98,55,73,46,41,9,32
2043936,31,24,1982,5,"male",679,44,39,0,1,0,1,0,0
2043942,13,20,2000,3,"male",186,74,30,19,3,0,2,19,1
2043943,22,23,1991,8,"female",458,140,120,35,15,31,10,4,5
2043944,65,19,1948,3,"male",361,30,9,0,1,0,1,0,0
2043950,53,27,1960,4,"male",36,10,10,4,0,4,0,0,0
2043962,21,31,1992,8,"female",463,314,105,7,5,7,4,0,1
2043971,50,11,1963,9,"male",916,64,14,43,30,43,21,0,9
2043995,30,12,1983,1,"female",510,12,1,0,0,0,0,0,0
2043996,52,8,1961,3,"female",1559,124,63,38,13,38,6,0,7
2044010,20,7,1993,8,"male",273,121,83,55,11,55,10,0,1
2044019,24,18,1989,11,"male",628,216,16,6,0,5,0,1,0
2044031,42,20,1971,11,"male",244,158,44,502,76,502,53,0,23
2044055,65,6,1948,1,"male",1429,68,25,4,0,2,0,2,0
2044091,103,12,1910,10,"female",574,4229,594,49,1196,36,1022,13,174
2044121,16,27,1997,10,"male",463,62,41,107,12,107,11,0,1
2044122,57,3,1956,2,"female",1476,82,23,414,237,354,168,60,69
2044124,17,14,1996,11,"female",646,194,152,390,95,390,77,0,18
2044135,18,2,1995,12,"male",946,337,283,20,0,20,0,0,0
2044138,60,13,1953,8,"male",455,359,300,77,82,76,73,1,9
2044139,21,23,1992,10,"female",155,143,80,0,4,0,1,0,3
2044148,49,3,1964,2,"female",575,26,10,8,5,0,3,8,2
2044155,62,5,1951,9,NA,2047,5,0,0,1,0,1,0,0
2044180,24,7,1989,10,"female",499,217,134,259,821,121,534,138,287
2044199,103,13,1910,7,"female",506,344,218,371,212,371,51,0,161
2044201,17,6,1996,9,"female",649,447,263,30,40,13,8,17,32
2044208,36,18,1977,8,"female",533,177,105,4,7,4,7,0,0
2044214,35,24,1978,7,"male",439,48,43,9,24,9,10,0,14
2044224,58,15,1955,5,"male",1720,149,59,0,0,0,0,0,0
2044250,19,2,1994,5,"male",943,64,35,0,1,0,1,0,0
2044252,19,4,1994,4,"female",456,876,345,769,362,769,324,0,38
2044256,54,2,1959,6,"female",1674,78,44,580,142,580,96,0,46
2044292,16,4,1997,6,"male",9,0,0,0,0,0,0,0,0
2044321,23,3,1990,3,"male",636,16,12,19,10,19,10,0,0
2044322,19,22,1994,2,"male",122,19,14,0,0,0,0,0,0
2044338,42,8,1971,3,"male",407,60,32,26,8,25,4,1,4
2044374,23,15,1990,8,"female",39,90,5,1,2,1,0,0,2
2044410,37,28,1976,2,"female",452,153,69,17,68,17,43,0,25
2044420,103,12,1910,12,"male",579,59,31,9,0,0,0,9,0
2044428,58,12,1955,9,"male",422,12,10,0,0,0,0,0,0
2044446,56,25,1957,12,"female",345,103,77,252,105,0,27,252,78
2044452,20,4,1993,11,"male",172,221,142,36,124,36,74,0,50
2044465,27,10,1986,4,"male",668,136,79,3,19,1,9,2,10
2044495,58,1,1955,1,"male",278,8,8,20,8,4,6,16,2
2044507,19,3,1994,4,"female",37,65,53,7,28,7,25,0,3
2044513,21,10,1992,2,"male",10,8,5,1,7,0,4,1,3
2044546,15,30,1998,3,"female",126,258,217,778,309,403,123,375,186
2044551,24,24,1989,3,"male",398,11,7,8,0,0,0,8,0
2044559,30,2,1983,5,"female",191,68,42,42,56,35,33,7,23
2044582,36,8,1977,8,"female",395,141,84,55,30,14,9,41,21
2044584,63,3,1950,6,"male",515,272,200,6,35,1,11,5,24
2044589,26,3,1987,3,"female",119,151,105,0,0,0,0,0,0
2044592,30,2,1983,2,"male",532,32,29,3,0,3,0,0,0
2044605,74,3,1939,3,"female",1607,46,16,51,16,51,10,0,6
2044625,27,16,1986,5,"female",176,877,598,1090,1573,197,728,893,845
2044654,54,9,1959,10,"female",391,50,40,31,32,0,22,31,10
2044688,19,13,1994,7,"female",308,85,60,115,70,115,18,0,52
2044695,19,29,1994,4,"male",412,56,48,206,21,206,21,0,0
2044721,24,5,1989,5,"female",22,6,6,0,0,0,0,0,0
2044723,30,3,1983,1,"male",196,39,26,2,1,2,0,0,1
2044783,38,5,1975,8,"female",225,56,35,18,5,18,0,0,5
2044803,26,18,1987,3,"male",81,19,13,7,3,7,1,0,2
2044844,25,3,1988,3,"male",50,169,155,11,8,11,8,0,0
2044847,60,16,1953,1,"female",837,79,54,129,21,129,20,0,1
2044852,61,23,1952,12,"male",141,2,2,0,0,0,0,0,0
2044855,19,20,1994,1,"male",625,186,78,39,6,39,5,0,1
2044856,48,12,1965,11,"male",1120,141,132,1,5,0,0,1,5
2044860,45,9,1968,1,"female",435,168,148,759,374,743,151,16,223
2044903,49,25,1964,10,"male",570,75,53,18,5,17,5,1,0
2044908,36,18,1977,8,"male",526,181,63,35,14,35,12,0,2
2044921,21,8,1992,2,"male",220,42,39,0,0,0,0,0,0
2044941,60,17,1953,1,"female",2304,123,50,53,41,53,36,0,5
2044987,18,25,1995,9,"female",24,10,4,170,163,170,23,0,140
2044998,71,23,1942,9,"male",350,64,56,13,20,0,3,13,17
2045002,73,9,1940,9,"female",1093,62,44,0,0,0,0,0,0
2045040,103,5,1910,4,"male",602,475,307,1,7,1,5,0,2
2045059,18,1,1995,11,"male",586,244,181,108,37,0,15,108,22
2045061,102,4,1911,11,"male",1852,758,279,21,138,0,56,21,82
2045069,19,19,1994,5,"male",505,262,95,7,0,7,0,0,0
2045070,36,10,1977,11,"male",483,51,7,9,29,9,28,0,1
2045102,14,14,1999,9,"female",121,329,21,5,21,5,17,0,4
2045123,20,12,1993,1,"male",504,190,88,0,1,0,0,0,1
2045135,91,29,1922,12,"male",2205,1144,823,58,51,6,36,52,15
2045149,36,16,1977,9,"female",178,135,43,9,29,0,13,9,16
2045152,93,6,1920,6,"female",1132,92,65,59,12,59,7,0,5
2045165,26,1,1987,1,"male",355,8,4,0,0,0,0,0,0
2045173,27,22,1986,11,"male",401,2,1,0,2,0,2,0,0
2045259,14,27,1999,8,"male",89,262,217,172,74,169,66,3,8
2045294,51,21,1962,1,"male",523,63,46,26,4,26,2,0,2
2045305,25,1,1988,1,"male",281,23,18,41,8,34,6,7,2
2045330,46,7,1967,7,"female",495,15,9,0,5,0,2,0,3
2045385,29,11,1984,1,"male",201,22,11,19,4,18,3,1,1
2045433,55,8,1958,8,"male",35,2,2,0,0,0,0,0,0
2045439,19,6,1994,3,"female",230,122,64,21,27,21,21,0,6
2045459,65,12,1948,2,"female",1217,180,27,149,70,43,43,106,27
2045500,19,9,1994,8,"male",148,5,2,10,2,10,0,0,2
2045503,52,13,1961,3,"male",623,15,1,0,0,0,0,0,0
2045521,23,21,1990,5,"male",335,309,185,0,0,0,0,0,0
2045526,22,21,1991,9,"female",921,132,15,5,14,5,11,0,3
2045539,52,8,1961,1,"male",1588,51,26,0,0,0,0,0,0
2045540,26,1,1987,1,"female",93,10,6,6,2,6,1,0,1
2045542,21,10,1992,10,"female",296,62,58,0,0,0,0,0,0
2045561,20,4,1993,10,"male",106,28,24,157,46,155,27,2,19
2045621,36,3,1977,10,"male",54,7,7,0,0,0,0,0,0
2045622,18,28,1995,2,"female",395,4376,326,37,153,37,121,0,32
2045625,39,14,1974,11,"female",407,442,381,175,378,145,189,30,189
2045632,17,8,1996,1,"female",137,89,67,529,230,516,141,13,89
2045647,15,15,1998,4,"female",283,47,12,29,7,29,6,0,1
2045670,37,19,1976,4,"male",59,12,6,7,2,7,2,0,0
2045676,26,29,1987,10,"female",215,37,17,6,3,6,3,0,0
2045714,22,1,1991,10,"female",526,73,26,18,131,8,60,10,71
2045715,18,13,1995,12,"male",131,101,87,3,5,3,2,0,3
2045729,24,16,1989,6,"male",504,124,95,14,8,14,8,0,0
2045732,41,17,1972,7,"male",284,57,46,5,1,5,0,0,1
2045750,15,23,1998,11,"male",208,78,67,1,1,1,0,0,1
2045777,58,30,1955,5,"male",317,73,35,605,400,487,106,118,294
2045792,28,9,1985,10,"male",384,14,7,2,5,2,0,0,5
2045795,19,1,1994,1,"male",278,20,7,0,0,0,0,0,0
2045815,44,11,1969,7,"male",471,39,9,1,0,1,0,0,0
2045848,46,6,1967,5,"female",249,77,41,59,34,59,17,0,17
2045855,23,8,1990,7,"female",212,122,115,20,7,20,2,0,5
2045872,35,1,1978,2,"female",216,76,46,84,50,84,40,0,10
2045874,17,1,1996,10,"female",499,1074,640,43,146,1,36,42,110
2045882,27,5,1986,3,"female",934,168,97,190,16,178,10,12,6
2045893,38,3,1975,9,"male",613,57,39,0,0,0,0,0,0
2045896,18,15,1995,5,"male",322,356,81,2,71,1,45,1,26
2045898,19,8,1994,8,"female",465,349,161,9,27,9,26,0,1
2045913,19,11,1994,7,"male",324,0,0,0,0,0,0,0,0
2045940,41,15,1972,8,"female",781,80,51,20,2,10,0,10,2
2045996,21,25,1992,5,"male",532,335,219,8,16,6,9,2,7
2046002,43,2,1970,9,"female",390,22,7,9,4,9,3,0,1
2046003,103,15,1910,12,"female",336,239,39,14,0,2,0,12,0
2046053,44,3,1969,3,"male",314,46,25,106,60,106,45,0,15
2046090,45,20,1968,12,"male",523,7,2,153,1,0,1,153,0
2046105,21,1,1992,1,"male",444,8,4,0,0,0,0,0,0
2046117,20,23,1993,10,"male",654,1926,379,18,24,0,10,18,14
2046121,23,19,1990,11,"female",187,55,28,5,3,0,0,5,3
2046122,14,26,1999,6,"male",287,200,118,0,1,0,0,0,1
2046127,34,31,1979,3,"male",487,56,45,6,70,6,56,0,14
2046135,23,25,1990,3,"male",309,176,39,0,1,0,0,0,1
2046168,21,22,1992,12,"female",362,480,187,760,579,20,227,740,352
2046187,66,2,1947,12,"male",880,221,158,122,42,111,37,11,5
2046188,18,31,1995,5,"female",319,74,66,0,0,0,0,0,0
2046192,18,7,1995,12,"female",372,596,44,69,354,69,213,0,141
2046203,108,24,1905,12,"male",2118,507,364,7,1,7,0,0,1
2046278,24,10,1989,9,"female",461,286,176,230,262,230,207,0,55
2046321,21,5,1992,3,"female",403,102,51,7,2,0,0,7,2
2046326,14,4,1999,12,"male",82,0,0,0,0,0,0,0,0
2046334,17,14,1996,6,"male",174,571,524,12,5,0,0,12,5
2046360,25,1,1988,1,"male",199,84,49,0,1,0,1,0,0
2046370,113,18,1900,7,"male",1137,156,26,257,9,257,3,0,6
2046382,37,4,1976,5,"male",1726,43,19,26,33,26,21,0,12
2046409,36,11,1977,7,"female",473,105,79,230,466,156,217,74,249
2046420,20,28,1993,6,"male",166,135,116,6,3,6,3,0,0
2046422,20,16,1993,9,"male",430,449,420,100,6,77,6,23,0
2046449,18,18,1995,8,"female",262,1220,721,608,1163,602,895,6,268
2046471,53,30,1960,12,"female",672,44,34,330,98,330,52,0,46
2046477,14,11,1999,12,"female",83,961,158,167,1246,139,595,28,651
2046490,68,5,1945,9,"male",911,210,126,0,16,0,11,0,5
2046499,68,17,1945,8,"female",1311,658,85,3,5,3,4,0,1
2046504,67,24,1946,11,"female",1019,81,45,82,134,1,39,81,95
2046515,41,26,1972,3,"female",709,12,2,0,1,0,1,0,0
2046528,18,22,1995,3,"female",360,458,314,82,39,60,32,22,7
2046576,13,1,2000,1,"male",128,39,33,4,0,0,0,4,0
2046581,16,21,1997,9,"male",611,654,617,370,17,370,14,0,3
2046593,18,19,1995,12,"male",426,70,56,5,0,1,0,4,0
2046622,18,26,1995,5,"female",365,522,342,1,1,1,1,0,0
2046635,19,4,1994,4,"male",189,47,45,15,0,0,0,15,0
2046711,31,7,1982,12,"female",1595,153,30,154,19,36,15,118,4
2046760,31,28,1982,10,"female",1950,224,141,552,301,548,289,4,12
2046762,27,8,1986,6,"male",1266,48,24,56,0,56,0,0,0
2046764,94,4,1919,1,"male",463,748,466,507,397,507,339,0,58
2046780,45,21,1968,6,"male",1598,148,105,29,8,27,8,2,0
2046788,37,12,1976,2,"male",249,38,18,0,0,0,0,0,0
2046806,40,30,1973,10,"male",579,2,0,0,0,0,0,0,0
2046810,17,9,1996,8,"male",210,15,15,0,4,0,4,0,0
2046840,20,11,1993,7,"female",1040,420,244,209,368,175,187,34,181
2046845,17,1,1996,5,"male",228,121,60,5,45,2,32,3,13
2046848,26,1,1987,1,"male",781,451,293,36,149,26,130,10,19
2046876,53,15,1960,7,"female",175,93,82,39,35,0,19,39,16
2046877,39,10,1974,6,"male",573,42,22,2,0,1,0,1,0
2046896,26,26,1987,9,"female",367,76,43,2,8,2,6,0,2
2046899,41,28,1972,5,"female",211,78,44,1250,1457,1250,783,0,674
2046912,43,19,1970,10,"male",783,89,35,10,12,10,12,0,0
2046919,48,2,1965,1,"female",431,40,27,1,8,1,6,0,2
2046945,19,20,1994,2,"male",359,189,108,20,16,20,5,0,11
2046988,23,25,1990,7,"female",205,91,60,931,278,673,58,258,220
2047003,19,17,1994,12,"female",620,6,3,1,0,1,0,0,0
2047026,47,17,1966,8,"female",939,52,41,0,2,0,0,0,2
2047056,63,2,1950,9,"male",1186,181,110,32,16,28,11,4,5
2047058,17,1,1996,3,"male",17,10,7,4,10,4,9,0,1
2047060,21,2,1992,10,"male",590,268,165,0,0,0,0,0,0
2047101,36,20,1977,6,"female",572,14,12,51,23,0,10,51,13
2047148,20,11,1993,7,"male",411,25,16,0,0,0,0,0,0
2047184,25,26,1988,5,"male",576,143,74,33,84,33,58,0,26
2047186,26,6,1987,11,"male",710,274,138,14,44,2,17,12,27
2047190,48,13,1965,2,"female",1498,339,230,2,2,0,0,2,2
2047214,106,8,1907,3,"male",98,90,74,8,26,8,22,0,4
2047217,38,14,1975,7,"female",408,99,47,93,16,85,9,8,7
2047241,19,15,1994,9,"male",211,40,33,1,0,1,0,0,0
2047255,54,18,1959,8,"female",818,30,17,101,19,0,11,101,8
2047276,14,25,1999,8,"male",275,205,115,7,0,0,0,7,0
2047279,22,7,1991,4,"male",763,83,61,2,2,2,2,0,0
2047291,21,15,1992,3,"male",206,329,278,466,74,466,47,0,27
2047310,58,29,1955,11,"female",641,24,10,26,4,26,3,0,1
2047331,17,17,1996,4,"female",254,337,63,4,0,4,0,0,0
2047332,29,11,1984,4,"female",531,75,44,76,92,52,47,24,45
2047400,31,17,1982,8,"female",152,4,4,1,0,1,0,0,0
2047424,25,28,1988,5,"male",496,283,240,1,4,1,4,0,0
2047444,61,29,1952,6,"male",854,61,42,0,1,0,1,0,0
2047450,48,11,1965,2,"female",763,556,394,1162,641,61,144,1101,497
2047469,23,19,1990,3,"female",759,154,67,10,94,2,22,8,72
2047475,65,12,1948,11,"female",1486,132,66,204,124,204,55,0,69
2047486,25,13,1988,12,"male",584,130,63,25,18,23,15,2,3
2047492,55,28,1958,2,"male",427,15,14,0,0,0,0,0,0
2047496,56,16,1957,10,"male",196,1,0,10,8,0,0,10,8
2047514,34,28,1979,7,"male",626,8,7,19,1,0,0,19,1
2047564,72,6,1941,8,"female",352,33,28,0,0,0,0,0,0
2047576,28,20,1985,10,"male",236,73,39,26,16,26,7,0,9
2047581,30,7,1983,11,"female",711,62,44,91,49,61,32,30,17
2047593,44,15,1969,1,"male",129,45,14,14,62,14,28,0,34
2047607,25,29,1988,7,"male",40,22,17,0,0,0,0,0,0
2047616,33,21,1980,6,"male",1360,586,392,413,1353,84,1179,329,174
2047626,67,5,1946,10,"male",1245,26,17,41,4,0,4,41,0
2047636,44,23,1969,9,"male",292,92,59,20,28,20,3,0,25
2047656,23,25,1990,4,"male",147,0,0,7,23,0,1,7,22
2047657,15,4,1998,8,"female",92,74,15,1,19,1,13,0,6
2047735,63,15,1950,3,"female",1454,83,36,61,64,61,49,0,15
2047768,21,7,1992,9,"male",199,68,60,0,1,0,0,0,1
2047785,14,31,1999,1,"male",422,28,13,0,0,0,0,0,0
2047797,68,25,1945,10,"female",1972,34,12,110,36,98,23,12,13
2047798,20,16,1993,9,"male",713,1862,390,913,1960,342,977,571,983
2047818,78,17,1935,11,"male",725,139,118,18,1,1,0,17,1
2047822,37,12,1976,1,"female",499,12,5,0,0,0,0,0,0
2047827,26,1,1987,11,"male",312,16,13,1,1,1,1,0,0
2047848,58,25,1955,12,"female",1037,207,108,31,19,0,9,31,10
2047859,15,20,1998,11,"male",56,15,11,13,8,13,3,0,5
2047865,35,26,1978,3,"male",1821,195,41,1,2,1,2,0,0
2047898,39,19,1974,12,"male",958,29,9,0,0,0,0,0,0
2047928,33,15,1980,5,"male",660,1,1,0,0,0,0,0,0
2047929,20,26,1993,6,"male",363,129,106,5,1,0,1,5,0
2047930,108,28,1905,8,"male",969,1344,1052,29,71,27,54,2,17
2047939,19,13,1994,12,"male",225,620,548,0,7,0,6,0,1
2047940,108,2,1905,8,"male",1777,266,199,2,41,0,30,2,11
2047946,57,5,1956,3,"female",54,142,129,134,20,31,10,103,10
2047962,103,2,1910,1,"male",796,923,528,208,149,110,53,98,96
2047969,63,11,1950,6,"female",1675,96,72,271,45,0,16,271,29
2047974,24,2,1989,9,"female",445,167,101,34,8,34,5,0,3
2047981,18,18,1995,2,"male",451,281,154,55,10,48,9,7,1
2048043,41,2,1972,3,"male",55,0,0,0,0,0,0,0,0
2048046,20,28,1993,5,"male",678,379,291,0,0,0,0,0,0
2048054,19,16,1994,10,"female",535,1197,734,127,346,87,223,40,123
2048064,70,16,1943,3,"male",1980,217,51,0,0,0,0,0,0
2048105,25,25,1988,10,"male",84,47,29,1,13,1,11,0,2
2048149,28,2,1985,9,"male",130,70,48,220,94,220,55,0,39
2048167,30,12,1983,12,"female",976,23,11,6,0,6,0,0,0
2048193,37,21,1976,7,"male",158,27,27,0,0,0,0,0,0
2048210,18,21,1995,7,"male",188,121,108,4,0,0,0,4,0
2048212,27,3,1986,4,"female",76,51,44,0,3,0,3,0,0
2048223,56,26,1957,1,"female",373,16,14,27,2,0,0,27,2
2048228,20,12,1993,8,"female",248,262,182,193,310,149,243,44,67
2048247,39,15,1974,6,"male",477,259,196,782,302,11,113,771,189
2048262,23,11,1990,2,"male",347,97,90,280,25,280,24,0,1
2048265,31,1,1982,9,"male",109,77,76,0,1,0,1,0,0
2048290,14,7,1999,7,"female",376,501,411,71,235,66,152,5,83
2048291,40,28,1973,8,"female",415,56,34,0,0,0,0,0,0
2048292,47,13,1966,9,"male",1479,258,56,2,1,2,1,0,0
2048294,23,8,1990,8,"male",29,41,24,15,10,15,9,0,1
2048325,63,26,1950,10,"female",304,77,39,156,11,156,11,0,0
2048347,56,29,1957,10,"male",321,62,4,14,3,14,2,0,1
2048351,19,23,1994,10,"female",642,818,276,0,0,0,0,0,0
2048361,28,8,1985,8,"male",145,54,40,0,8,0,0,0,8
2048367,52,12,1961,9,"male",166,45,15,17,6,17,4,0,2
2048373,77,31,1936,5,"male",1863,62,20,0,0,0,0,0,0
2048379,18,9,1995,8,"male",513,439,114,13,11,13,6,0,5
2048393,25,25,1988,12,"male",131,201,197,128,24,52,17,76,7
2048400,113,23,1900,6,"female",2238,435,275,543,746,475,521,68,225
2048427,48,30,1965,7,"female",419,0,0,0,0,0,0,0,0
2048429,17,17,1996,6,"male",288,19,10,8,14,7,4,1,10
2048440,24,19,1989,5,"female",422,64,45,3,249,2,9,1,240
2048449,72,2,1941,3,"male",1655,30,0,0,0,0,0,0,0
2048462,22,12,1991,8,"female",400,54,13,11,22,6,14,5,8
2048484,37,6,1976,4,"female",584,23,11,2,32,2,27,0,5
2048503,63,31,1950,12,"female",1199,85,35,118,22,1,17,117,5
2048522,42,31,1971,5,"female",354,160,104,48,27,0,3,48,24
2048526,59,14,1954,9,"male",796,29,10,1,0,0,0,1,0
2048532,19,30,1994,4,"male",243,271,235,78,39,78,38,0,1
2048533,27,28,1986,6,"male",402,82,60,5,12,0,10,5,2
2048555,19,19,1994,8,"male",373,31,21,0,0,0,0,0,0
2048568,19,28,1994,10,"male",45,133,127,219,237,145,159,74,78
2048574,46,16,1967,7,"female",233,303,226,926,1178,926,405,0,773
2048610,19,6,1994,6,"female",330,333,252,1,0,1,0,0,0
2048614,28,8,1985,9,"male",528,447,381,595,374,595,364,0,10
2048623,41,2,1972,4,"male",233,5,1,2,0,0,0,2,0
2048627,19,22,1994,6,"male",1358,768,526,0,2,0,2,0,0
2048648,52,5,1961,5,"male",877,27,20,0,2,0,1,0,1
2048649,20,18,1993,6,"male",596,367,214,65,87,63,59,2,28
2048716,18,1,1995,8,"female",106,59,48,286,4,286,3,0,1
2048718,37,5,1976,3,"male",1365,14,11,3,4,0,1,3,3
2048733,26,1,1987,1,"male",309,4,2,0,0,0,0,0,0
2048763,55,31,1958,3,"female",1469,330,108,37,130,0,27,37,103
2048772,32,18,1981,6,"male",208,109,84,50,49,36,25,14,24
2048783,59,21,1954,8,"female",2313,180,130,204,229,137,177,67,52
2048787,20,18,1993,5,"female",637,344,295,184,286,184,153,0,133
2048793,22,15,1991,11,"male",6,0,0,7,5,6,1,1,4
2048806,18,11,1995,4,"male",51,35,25,0,0,0,0,0,0
2048809,84,19,1929,8,"female",1339,97,64,802,274,59,213,743,61
2048839,26,14,1987,1,"male",777,707,547,1,1,0,0,1,1
2048851,81,17,1932,4,"male",1093,54,25,0,0,0,0,0,0
2048865,25,20,1988,5,"male",758,50,20,0,0,0,0,0,0
2048904,19,11,1994,1,"female",945,580,217,530,448,424,244,106,204
2048940,25,9,1988,11,"male",298,202,133,54,33,54,24,0,9
2048944,71,23,1942,7,"female",209,20,16,8,1,8,1,0,0
2048947,26,18,1987,3,"male",457,6,6,0,1,0,1,0,0
2048985,56,10,1957,7,"male",1460,43,26,27,29,0,16,27,13
2048990,65,27,1948,4,"male",593,92,72,186,180,137,79,49,101
2048993,29,8,1984,10,"female",557,208,85,3,5,3,4,0,1
2049011,67,8,1946,9,"male",1811,46,33,6,4,0,1,6,3
2049012,63,20,1950,1,"female",1810,82,34,311,21,311,11,0,10
2049020,33,20,1980,12,"male",848,15,7,0,0,0,0,0,0
2049022,26,17,1987,12,"male",550,171,110,3,6,0,1,3,5
2049031,31,18,1982,9,"male",271,386,86,2,0,2,0,0,0
2049037,50,17,1963,3,"male",292,47,20,0,0,0,0,0,0
2049048,24,8,1989,2,"male",300,85,58,47,28,42,21,5,7
2049114,56,10,1957,4,"female",1338,147,96,127,92,9,55,118,37
2049137,99,3,1914,6,"female",1074,555,137,0,1,0,1,0,0
2049142,25,12,1988,6,"male",269,53,16,0,0,0,0,0,0
2049188,18,6,1995,12,"female",365,41,16,2,1,2,1,0,0
2049198,18,7,1995,3,"male",417,129,87,0,0,0,0,0,0
2049261,15,12,1998,11,"male",9,2,2,1,0,1,0,0,0
2049310,53,10,1960,11,"male",290,95,79,7,20,7,6,0,14
2049311,33,20,1980,11,"female",813,87,35,379,58,377,26,2,32
2049326,32,16,1981,8,"male",90,117,67,59,336,59,299,0,37
2049339,57,14,1956,7,"male",494,32,23,0,0,0,0,0,0
2049366,26,17,1987,5,"male",560,30,22,9,4,4,1,5,3
2049374,22,15,1991,1,"female",1434,453,309,75,126,51,97,24,29
2049392,68,28,1945,8,"male",1053,387,223,290,130,290,115,0,15
2049433,26,1,1987,2,"female",16,0,0,0,0,0,0,0,0
2049482,53,12,1960,6,"female",82,2,2,0,0,0,0,0,0
2049501,23,3,1990,4,"male",439,211,139,6,5,6,5,0,0
2049512,63,1,1950,8,"male",278,64,25,4,1,0,0,4,1
2049540,15,12,1998,12,"female",261,186,109,48,196,26,120,22,76
2049557,21,30,1992,9,"female",352,390,173,59,170,59,90,0,80
2049600,38,24,1975,10,"female",413,79,25,431,247,431,200,0,47
2049626,17,10,1996,3,"female",108,49,16,95,3,95,3,0,0
2049637,24,22,1989,8,"male",29,256,31,16,24,16,15,0,9
2049658,63,12,1950,10,"female",436,41,35,102,99,0,55,102,44
2049660,69,24,1944,12,"male",185,152,45,14,24,14,21,0,3
2049663,83,8,1930,1,"male",613,90,37,75,34,0,12,75,22
2049667,62,2,1951,9,"female",373,44,43,1,3,1,3,0,0
2049684,28,30,1985,11,"male",10,0,0,0,0,0,0,0,0
2049688,39,6,1974,2,"female",229,45,41,1,2,1,2,0,0
2049697,25,16,1988,5,"male",572,6,3,7,9,7,9,0,0
2049698,30,27,1983,7,"male",636,24,19,2,2,2,0,0,2
2049727,87,3,1926,10,"male",1063,78,44,1,0,0,0,1,0
2049743,56,2,1957,1,"female",612,42,22,1,1,1,0,0,1
2049766,19,2,1994,6,"male",501,366,275,296,152,296,128,0,24
2049783,46,14,1967,3,"male",2396,97,43,11,5,11,3,0,2
2049787,41,22,1972,6,"male",260,3,0,0,0,0,0,0,0
2049791,29,20,1984,1,"male",444,1,1,15,0,0,0,15,0
2049792,19,22,1994,9,"male",420,24,19,2,0,2,0,0,0
2049819,19,5,1994,8,"male",614,46,17,2,0,2,0,0,0
2049821,16,20,1997,6,"male",100,23,21,0,3,0,1,0,2
2049826,23,18,1990,6,"female",644,446,175,84,46,84,44,0,2
2049850,26,18,1987,12,"female",201,163,74,31,9,25,7,6,2
2049851,21,16,1992,8,"male",32,7,4,5,3,5,2,0,1
2049867,42,10,1971,10,"female",325,79,64,218,17,218,16,0,1
2049875,19,20,1994,4,"male",945,600,533,0,18,0,12,0,6
2049893,46,21,1967,6,"male",2101,168,48,34,117,34,59,0,58
2049936,102,24,1911,10,"female",1844,329,105,169,66,169,51,0,15
2049940,35,1,1978,3,"male",422,100,62,16,11,3,4,13,7
2049991,16,19,1997,4,"male",1221,1207,758,123,129,123,63,0,66
2050012,26,11,1987,3,"male",281,367,326,68,6,68,6,0,0
2050029,15,15,1998,8,"female",58,211,38,22,36,22,26,0,10
2050034,17,19,1996,9,"male",315,150,102,5,3,5,0,0,3
2050035,31,2,1982,4,"male",361,887,713,6895,4189,6575,2353,320,1836
2050074,23,7,1990,7,"male",385,233,186,0,5,0,4,0,1
2050119,32,7,1981,2,"male",1721,578,158,15,212,10,140,5,72
2050125,24,6,1989,8,"female",553,254,163,17,136,17,123,0,13
2050133,29,11,1984,9,"female",242,0,0,0,0,0,0,0,0
2050147,33,11,1980,9,"male",406,51,25,2,1,2,1,0,0
2050150,40,3,1973,9,"female",311,4,2,0,0,0,0,0,0
2050163,18,4,1995,7,"female",514,175,135,20,38,20,37,0,1
2050170,28,10,1985,1,"male",430,278,231,148,24,148,13,0,11
2050213,102,18,1911,1,"female",1069,952,800,2,0,1,0,1,0
2050221,24,1,1989,4,"male",54,5,4,2,0,2,0,0,0
2050223,65,1,1948,5,"male",402,14,8,0,0,0,0,0,0
2050240,16,19,1997,2,"female",151,2,2,16,0,16,0,0,0
2050257,52,9,1961,11,"female",428,123,105,0,0,0,0,0,0
2050265,64,27,1949,11,"female",981,76,42,0,0,0,0,0,0
2050299,108,9,1905,6,"male",743,231,171,4,11,4,9,0,2
2050320,19,17,1994,6,"female",609,1283,800,2720,1430,2472,1270,248,160
2050366,43,1,1970,1,"male",218,3,2,0,0,0,0,0,0
2050373,76,11,1937,12,"female",139,33,24,5,14,5,14,0,0
2050380,34,8,1979,10,"male",329,40,17,2,22,2,9,0,13
2050382,21,1,1992,1,"male",525,21,15,0,1,0,0,0,1
2050402,27,17,1986,5,"female",291,0,0,0,0,0,0,0,0
2050407,30,23,1983,4,"female",332,35,23,2,0,2,0,0,0
2050443,57,28,1956,12,"female",1542,82,17,2341,278,2341,141,0,137
2050454,76,27,1937,4,"female",274,7,7,0,0,0,0,0,0
2050464,23,9,1990,9,"male",891,154,111,14,17,0,1,14,16
2050470,73,23,1940,5,"male",1032,44,35,1,6,0,2,1,4
2050497,19,31,1994,3,"female",217,156,34,2,127,2,117,0,10
2050524,29,12,1984,4,"male",555,233,187,41,8,41,7,0,1
2050528,30,4,1983,10,"female",313,19,9,83,61,83,53,0,8
2050571,45,3,1968,2,"female",686,119,81,45,50,42,22,3,28
2050576,66,7,1947,12,"female",1809,56,32,53,49,0,13,53,36
2050593,53,22,1960,5,"female",744,137,36,1,0,1,0,0,0
2050609,68,10,1945,6,"female",860,55,27,127,10,0,8,127,2
2050624,30,3,1983,3,"male",547,59,19,14,16,13,2,1,14
2050626,27,29,1986,8,"male",401,120,82,2,2,2,2,0,0
2050652,27,12,1986,10,"male",32,67,54,82,42,82,33,0,9
2050664,36,26,1977,10,"male",276,37,21,18,2,16,0,2,2
2050665,33,1,1980,5,"male",275,50,28,2,2,2,2,0,0
2050683,15,26,1998,11,"female",6,35,30,0,3,0,2,0,1
2050696,26,3,1987,12,"male",236,110,65,0,3,0,3,0,0
2050703,17,3,1996,3,"male",647,260,230,9,5,4,3,5,2
2050716,25,8,1988,6,"female",1125,113,17,0,5,0,1,0,4
2050756,61,19,1952,9,"female",825,109,64,1665,105,1665,59,0,46
2050777,60,1,1953,3,"male",1864,113,71,84,112,53,50,31,62
2050801,103,11,1910,3,"female",1226,1490,267,6,7,6,6,0,1
2050803,43,2,1970,2,"male",532,21,5,0,0,0,0,0,0
2050823,54,15,1959,6,"female",123,231,183,72,15,69,11,3,4
2050858,23,22,1990,2,"male",1248,407,165,12,32,12,27,0,5
2050884,60,24,1953,12,"female",2022,186,120,2481,1576,230,334,2251,1242
2050909,21,1,1992,1,"male",63,14,11,9,0,9,0,0,0
2050915,29,1,1984,1,"male",225,5,2,4,2,3,1,1,1
2050971,14,3,1999,6,"male",413,2,2,0,0,0,0,0,0
2051019,25,1,1988,1,"male",127,38,33,13,29,5,11,8,18
2051037,20,5,1993,4,"male",101,18,11,0,0,0,0,0,0
2051092,14,9,1999,7,"male",183,216,192,11,22,11,7,0,15
2051094,19,20,1994,11,"male",51,29,8,0,0,0,0,0,0
2051152,41,17,1972,9,"male",767,36,32,0,2,0,1,0,1
2051211,69,23,1944,6,"male",726,17,12,0,0,0,0,0,0
2051217,52,27,1961,8,"female",189,29,13,0,0,0,0,0,0
2051234,107,28,1906,11,"male",1072,4284,792,2,9,2,7,0,2
2051252,49,14,1964,7,"male",392,71,8,0,0,0,0,0,0
2051259,33,24,1980,1,"female",747,30,9,0,0,0,0,0,0
2051262,15,19,1998,11,"male",689,730,270,1388,519,1382,205,6,314
2051268,32,15,1981,2,"male",419,49,34,5,24,5,8,0,16
2051271,25,7,1988,10,"female",896,32,30,48,9,48,9,0,0
2051286,33,19,1980,6,"male",971,97,48,230,75,230,72,0,3
2051289,33,4,1980,1,"male",547,74,61,9,1,5,0,4,1
2051344,30,2,1983,10,"male",651,632,155,145,604,73,304,72,300
2051357,17,16,1996,12,"female",116,465,345,1663,2229,534,1710,1129,519
2051370,47,9,1966,11,"female",142,41,21,305,161,305,136,0,25
2051375,25,16,1988,10,"female",237,2,2,10,0,0,0,10,0
2051379,76,18,1937,3,"male",617,13,7,5,3,0,0,5,3
2051380,108,22,1905,4,"male",1704,786,152,11,8,9,2,2,6
2051382,102,21,1911,9,"female",1411,371,238,7,5,6,2,1,3
2051385,108,26,1905,8,"female",156,27,16,27,5,0,0,27,5
2051407,18,1,1995,8,"female",425,274,198,350,156,282,106,68,50
2051417,41,18,1972,3,"female",264,38,33,265,13,265,7,0,6
2051430,64,1,1949,7,"female",198,4,2,0,0,0,0,0,0
2051445,17,2,1996,10,"male",292,427,252,0,0,0,0,0,0
2051446,25,13,1988,12,"male",422,29,21,26,2,26,2,0,0
2051489,45,27,1968,9,"female",512,2,2,0,0,0,0,0,0
2051520,24,15,1989,10,"female",228,76,39,434,127,414,63,20,64
2051538,42,25,1971,7,"male",21,0,0,0,0,0,0,0,0
2051541,49,16,1964,8,"female",754,84,53,58,1,58,1,0,0
2051554,51,10,1962,12,"male",78,61,40,46,6,46,6,0,0
2051563,21,22,1992,2,"male",117,88,86,3,7,3,6,0,1
2051585,31,23,1982,3,"female",220,284,179,1426,666,190,117,1236,549
2051597,42,14,1971,4,"female",170,95,79,16,9,5,7,11,2
2051600,55,5,1958,12,"male",764,108,28,66,55,25,22,41,33
2051613,15,3,1998,3,"female",991,503,240,122,293,117,93,5,200
2051615,36,16,1977,7,"male",104,37,14,20,130,20,110,0,20
2051649,31,23,1982,8,"female",114,5,4,8,8,8,8,0,0
2051653,25,31,1988,8,"female",221,112,101,6,2,0,0,6,2
2051666,18,8,1995,7,"female",231,67,30,90,16,0,6,90,10
2051697,50,30,1963,9,"male",644,150,87,32,31,0,13,32,18
2051728,15,7,1998,10,"male",50,3,1,0,0,0,0,0,0
2051741,27,18,1986,8,"male",568,123,82,0,16,0,6,0,10
2051771,56,5,1957,12,"male",944,48,32,31,2,0,1,31,1
2051779,25,3,1988,3,"female",198,17,13,0,0,0,0,0,0
2051793,21,23,1992,6,"male",361,234,153,5,14,5,11,0,3
2051794,13,12,2000,1,"female",449,930,524,634,802,402,273,232,529
2051840,52,12,1961,3,"male",672,155,102,55,35,55,30,0,5
2051855,25,25,1988,12,"female",1,0,0,0,0,0,0,0,0
2051877,26,5,1987,2,"male",474,19,13,1,0,0,0,1,0
2051884,73,20,1940,12,"male",1778,81,46,79,29,79,20,0,9
2051902,20,15,1993,12,"male",443,145,90,1,1,1,0,0,1
2051909,35,9,1978,1,"male",80,99,91,16,7,16,7,0,0
2051911,27,27,1986,3,"female",528,152,103,16,8,6,0,10,8
2051942,68,17,1945,8,"male",751,84,71,54,16,54,16,0,0
2051978,37,28,1976,1,"male",855,87,41,48,45,48,25,0,20
2051985,27,27,1986,7,"male",632,144,71,12,23,12,21,0,2
2052000,23,14,1990,2,"male",897,225,78,13,159,7,98,6,61
2052007,37,29,1976,6,"male",166,42,17,0,0,0,0,0,0
2052034,21,30,1992,9,"female",275,13,2,10,0,10,0,0,0
2052055,24,13,1989,11,"male",686,117,70,12,16,12,13,0,3
2052056,27,10,1986,9,"female",304,64,44,40,3,40,1,0,2
2052092,108,6,1905,8,"female",1836,385,158,7,196,7,149,0,47
2052107,14,9,1999,12,"male",412,61,43,50,5,50,4,0,1
2052121,65,28,1948,7,"female",36,82,49,35,131,0,94,35,37
2052145,19,20,1994,10,"male",266,66,53,2,6,2,4,0,2
2052158,32,24,1981,11,"male",443,182,147,6,20,0,6,6,14
2052212,16,23,1997,5,"female",569,3528,824,17,325,17,200,0,125
2052226,28,8,1985,10,"male",728,1150,919,177,277,177,182,0,95
2052236,61,15,1952,4,"male",886,17,14,0,1,0,0,0,1
2052248,20,11,1993,5,"male",398,23,3,0,0,0,0,0,0
2052318,65,31,1948,8,"female",1066,47,27,5,10,0,6,5,4
2052324,21,14,1992,4,"male",776,249,182,71,29,71,19,0,10
2052347,16,21,1997,9,"female",508,95,54,345,202,221,62,124,140
2052364,16,10,1997,11,"male",351,1048,627,9,53,9,40,0,13
2052390,25,3,1988,8,"female",185,202,95,2302,1635,2302,1484,0,151
2052410,110,24,1903,1,"male",2420,885,428,11,10,5,7,6,3
2052424,35,16,1978,7,"male",652,4,4,31,6,20,2,11,4
2052456,68,27,1945,9,"male",141,26,20,0,14,0,8,0,6
2052460,23,17,1990,7,"female",62,133,12,27,24,27,24,0,0
2052478,44,21,1969,1,"male",673,6,5,0,0,0,0,0,0
2052482,24,7,1989,7,"female",490,161,123,1,1,1,1,0,0
2052490,63,3,1950,3,"male",2199,40,28,0,0,0,0,0,0
2052521,45,29,1968,1,"male",142,4,3,0,0,0,0,0,0
2052548,21,26,1992,4,"male",20,32,27,9,13,9,2,0,11
2052550,18,4,1995,9,"female",149,133,117,49,17,0,2,49,15
2052567,23,1,1990,10,"male",170,4,1,0,0,0,0,0,0
2052577,33,11,1980,12,"male",632,185,151,15,94,15,94,0,0
2052585,30,10,1983,6,"female",76,50,38,447,168,244,78,203,90
2052595,43,13,1970,11,"female",226,4,4,0,0,0,0,0,0
2052602,28,6,1985,9,"male",683,108,70,7,1,7,1,0,0
2052604,16,9,1997,6,"female",550,200,130,88,337,87,273,1,64
2052620,57,15,1956,8,"female",2094,49,17,21,85,3,44,18,41
2052649,14,9,1999,8,"female",224,141,119,13,39,13,15,0,24
2052654,19,4,1994,5,"male",309,9,7,0,0,0,0,0,0
2052694,34,23,1979,3,"male",569,41,37,0,1,0,1,0,0
2052695,50,28,1963,8,"female",473,324,269,563,136,554,111,9,25
2052706,18,17,1995,3,"male",159,69,65,1,37,1,24,0,13
2052718,68,10,1945,3,"male",252,321,272,275,97,5,13,270,84
2052736,108,30,1905,11,"male",418,260,203,0,0,0,0,0,0
2052741,16,14,1997,6,"male",776,41,19,0,4,0,2,0,2
2052766,32,26,1981,6,"male",758,33,16,0,0,0,0,0,0
2052775,42,1,1971,4,"male",140,40,32,16,31,1,28,15,3
2052783,15,11,1998,9,"male",401,52,20,2,5,0,2,2,3
2052785,24,5,1989,2,"female",90,82,41,0,0,0,0,0,0
2052821,63,12,1950,8,"male",568,73,34,2,17,0,11,2,6
2052855,18,10,1995,10,"female",258,21,11,100,84,58,59,42,25
2052857,48,28,1965,3,"male",408,99,74,2,1,2,1,0,0
2052894,55,7,1958,2,"female",1296,270,163,363,222,44,132,319,90
2052948,30,7,1983,3,"male",328,74,47,416,228,350,202,66,26
2052955,59,15,1954,4,"female",1763,87,19,10,4,10,3,0,1
2052957,56,20,1957,4,"female",673,53,32,47,219,47,175,0,44
2052960,41,8,1972,10,"male",874,437,57,45,41,45,25,0,16
2053000,17,1,1996,8,"male",404,67,21,41,15,6,9,35,6
2053041,17,21,1996,8,"female",597,236,91,0,0,0,0,0,0
2053043,108,2,1905,6,"female",1184,149,106,119,17,0,5,119,12
2053050,25,1,1988,1,"male",243,13,9,1,1,1,0,0,1
2053061,20,22,1993,12,"male",429,197,155,12,0,12,0,0,0
2053072,21,17,1992,6,"male",55,21,17,0,0,0,0,0,0
2053084,40,14,1973,1,"male",254,1,0,23,2,23,0,0,2
2053125,43,28,1970,5,"female",348,58,26,21,59,13,46,8,13
2053153,27,1,1986,3,"male",220,166,137,878,71,878,58,0,13
2053177,107,6,1906,7,"male",847,154,53,6,8,6,2,0,6
2053179,18,25,1995,4,"male",819,128,67,0,0,0,0,0,0
2053187,58,6,1955,1,"male",279,45,27,35,1,0,0,35,1
2053206,20,15,1993,6,"female",567,177,71,59,11,59,11,0,0
2053212,29,28,1984,8,"male",80,30,9,0,0,0,0,0,0
2053228,24,1,1989,1,"male",63,37,24,114,54,114,27,0,27
2053241,45,21,1968,11,"male",701,75,61,0,1,0,1,0,0
2053247,41,18,1972,8,"male",610,3,2,0,0,0,0,0,0
2053256,17,27,1996,11,"male",475,132,93,478,177,423,144,55,33
2053262,52,16,1961,8,"female",432,28,22,58,41,58,28,0,13
2053300,22,22,1991,6,"male",586,882,648,37,11,37,11,0,0
2053306,19,23,1994,11,"female",182,268,92,268,103,268,70,0,33
2053321,67,12,1946,7,"male",660,33,19,0,0,0,0,0,0
2053334,52,12,1961,3,"female",257,51,21,10,43,10,33,0,10
2053368,58,11,1955,4,"male",275,34,24,0,7,0,5,0,2
2053382,65,26,1948,1,"male",1235,190,141,2,16,0,8,2,8
2053412,42,4,1971,6,"female",301,2,1,0,0,0,0,0,0
2053429,40,25,1973,4,"female",204,19,8,59,40,59,36,0,4
2053449,29,2,1984,3,"male",610,105,50,29,20,29,19,0,1
2053494,23,4,1990,9,"female",322,155,58,167,148,167,69,0,79
2053536,34,10,1979,8,"female",723,21,3,9,9,9,3,0,6
2053552,47,2,1966,5,"female",242,187,41,1243,1399,1100,744,143,655
2053581,16,23,1997,1,"male",474,35,15,0,1,0,1,0,0
2053582,20,1,1993,1,"male",546,232,150,8,3,8,3,0,0
2053589,33,24,1980,10,"male",26,39,28,4,0,4,0,0,0
2053592,35,12,1978,4,"male",77,40,17,0,0,0,0,0,0
2053602,22,23,1991,3,"male",237,106,70,57,2,45,1,12,1
2053663,22,15,1991,3,"female",495,369,156,239,106,239,101,0,5
2053669,17,12,1996,1,"male",568,127,66,52,52,0,27,52,25
2053691,28,28,1985,9,"female",329,915,805,103,61,101,37,2,24
2053701,30,6,1983,11,"male",841,56,15,0,0,0,0,0,0
2053721,53,27,1960,9,"female",25,43,36,7,14,7,3,0,11
2053736,59,2,1954,1,"male",2312,93,31,1,1,0,1,1,0
2053741,58,24,1955,4,"male",128,8,8,1,1,0,1,1,0
2053754,57,23,1956,7,"female",355,33,21,0,1,0,1,0,0
2053759,68,28,1945,12,"male",77,22,16,1,0,0,0,1,0
2053814,25,20,1988,9,"female",476,106,17,11,0,11,0,0,0
2053830,58,20,1955,6,"male",186,79,25,3,10,0,2,3,8
2053849,41,1,1972,1,"male",329,13,12,0,0,0,0,0,0
2053860,37,21,1976,1,"female",537,9,3,0,0,0,0,0,0
2053874,25,12,1988,10,"male",194,51,31,10,1,0,1,10,0
2053883,38,2,1975,1,"female",15,55,43,53,169,53,146,0,23
2053925,58,9,1955,3,"female",193,12,12,14,10,0,5,14,5
2054016,32,9,1981,7,"female",211,191,100,86,172,46,67,40,105
2054020,34,27,1979,5,"male",623,232,146,0,0,0,0,0,0
2054041,107,25,1906,6,"male",1363,288,127,0,2,0,2,0,0
2054052,36,17,1977,8,"male",37,96,83,63,46,53,28,10,18
2054088,23,30,1990,6,"female",99,52,49,100,144,80,122,20,22
2054095,15,29,1998,12,"male",293,171,138,2,6,1,1,1,5
2054145,25,11,1988,3,"male",395,57,45,0,2,0,1,0,1
2054167,39,3,1974,5,"male",90,42,35,6,0,6,0,0,0
2054193,23,4,1990,1,"male",308,58,33,16,1,16,0,0,1
2054214,69,8,1944,3,"female",1304,39,14,22,2,0,1,22,1
2054215,18,9,1995,10,"female",618,50,20,0,5,0,1,0,4
2054224,53,13,1960,8,"male",2124,81,40,80,68,51,44,29,24
2054227,19,19,1994,5,"female",319,128,58,0,9,0,9,0,0
2054252,26,19,1987,1,"female",387,17,11,92,12,92,12,0,0
2054255,28,1,1985,11,"male",492,38,33,25,56,25,36,0,20
2054294,24,1,1989,1,"male",5,2,2,1,0,1,0,0,0
2054376,108,28,1905,8,"male",1847,206,123,238,15,218,12,20,3
2054383,24,22,1989,1,"male",540,61,47,21,36,21,27,0,9
2054387,59,21,1954,2,"female",88,16,10,0,0,0,0,0,0
2054391,19,10,1994,10,"female",678,168,65,15,17,0,0,15,17
2054420,57,11,1956,6,"female",303,13,6,2,1,2,1,0,0
2054440,26,29,1987,9,"male",696,6,5,0,0,0,0,0,0
2054456,23,17,1990,5,"female",207,7,6,3,0,2,0,1,0
2054476,14,15,1999,1,"female",221,342,126,421,878,116,452,305,426
2054478,63,6,1950,10,"male",292,125,91,310,157,310,85,0,72
2054502,20,20,1993,5,"male",315,31,21,2,0,2,0,0,0
2054526,38,14,1975,5,"male",1494,40,12,1441,1329,1441,999,0,330
2054610,15,11,1998,1,"male",237,38,22,0,13,0,7,0,6
2054613,23,3,1990,11,"male",711,164,88,0,0,0,0,0,0
2054619,106,20,1907,11,"female",103,328,289,437,613,437,501,0,112
2054625,14,29,1999,3,"male",578,206,173,0,10,0,4,0,6
2054638,23,1,1990,1,"male",113,11,11,3,4,3,3,0,1
2054649,28,7,1985,4,"female",471,62,7,0,0,0,0,0,0
2054665,28,8,1985,10,"male",792,157,105,9,6,9,6,0,0
2054668,20,26,1993,8,"male",587,424,348,116,101,116,99,0,2
2054692,45,22,1968,11,"male",864,7,7,0,1,0,0,0,1
2054700,14,6,1999,9,"male",24,0,0,0,0,0,0,0,0
2054711,35,11,1978,4,"female",522,101,63,18,14,18,12,0,2
2054714,20,6,1993,3,"male",32,27,26,0,1,0,1,0,0
2054747,20,8,1993,1,"female",186,495,430,1236,310,1003,220,233,90
2054754,23,4,1990,2,"female",1179,3840,1830,9734,23008,1373,11651,8361,11357
2054790,53,26,1960,10,"male",627,28,12,0,0,0,0,0,0
2054817,33,16,1980,5,"female",1040,127,79,686,214,686,142,0,72
2054841,48,3,1965,9,"male",500,35,12,0,0,0,0,0,0
2054846,29,4,1984,10,"male",22,7,4,0,0,0,0,0,0
2054860,20,3,1993,3,"male",660,60,49,3,0,0,0,3,0
2054882,17,3,1996,3,"female",314,2,2,0,0,0,0,0,0
2054886,21,10,1992,5,"male",487,120,84,77,11,77,9,0,2
2054896,80,9,1933,7,"female",1659,48,17,1,1,0,0,1,1
2054927,24,21,1989,8,"male",156,7,4,24,21,0,8,24,13
2054930,95,20,1918,5,"male",375,271,169,102,237,102,233,0,4
2054931,18,15,1995,9,"female",313,155,73,272,112,272,101,0,11
2054935,17,19,1996,4,"female",473,1084,569,3074,4553,252,3515,2822,1038
2054954,31,26,1982,7,"male",640,14,3,0,0,0,0,0,0
2055005,24,3,1989,2,"male",602,449,372,4,90,1,47,3,43
2055024,66,23,1947,1,"male",1061,504,392,46,561,46,513,0,48
2055057,25,27,1988,4,"male",338,1,1,1,0,1,0,0,0
2055095,18,27,1995,2,"female",335,77,68,11,0,11,0,0,0
2055121,103,24,1910,11,"female",816,1978,1158,406,1466,406,1278,0,188
2055153,65,11,1948,11,"female",434,29,17,0,1,0,1,0,0
2055156,27,18,1986,10,"male",443,90,69,6,19,0,4,6,15
2055167,26,16,1987,8,"male",821,6,3,0,6,0,1,0,5
2055217,20,3,1993,4,"male",558,904,831,0,0,0,0,0,0
2055226,29,16,1984,10,"male",58,3,2,4,5,4,4,0,1
2055229,26,5,1987,9,"female",451,298,135,1,31,0,24,1,7
2055270,36,6,1977,10,"male",114,13,12,0,0,0,0,0,0
2055276,33,6,1980,12,"male",279,307,78,9,21,9,15,0,6
2055280,85,14,1928,3,"male",1527,128,35,28,5,0,0,28,5
2055284,15,3,1998,10,"female",119,419,301,0,0,0,0,0,0
2055295,27,1,1986,5,"male",668,147,84,83,52,66,29,17,23
2055301,53,20,1960,8,"male",223,27,18,0,2,0,1,0,1
2055305,14,26,1999,7,"female",503,271,228,127,89,85,38,42,51
2055313,16,23,1997,1,"female",365,1750,793,164,496,77,321,87,175
2055357,80,20,1933,1,"male",100,43,43,1,3,0,2,1,1
2055360,20,13,1993,1,"female",6,1,1,0,0,0,0,0,0
2055363,21,9,1992,12,"male",113,6,6,0,0,0,0,0,0
2055371,17,3,1996,1,"male",293,156,66,145,59,68,45,77,14
2055411,59,6,1954,2,"male",831,24,8,0,0,0,0,0,0
2055461,16,11,1997,11,"male",190,364,16,145,187,8,101,137,86
2055468,25,1,1988,1,"male",611,23,9,13,0,0,0,13,0
2055480,29,21,1984,2,"female",459,13,12,4,2,2,1,2,1
2055495,64,30,1949,11,"female",1257,114,34,700,30,0,11,700,19
2055511,62,20,1951,3,"male",893,87,73,0,0,0,0,0,0
2055557,66,21,1947,11,"female",1947,117,49,69,49,69,29,0,20
2055558,22,13,1991,5,"male",455,1041,624,104,73,59,34,45,39
2055571,31,27,1982,1,"female",275,56,27,1,4,1,4,0,0
2055573,38,15,1975,5,"male",650,54,9,14,32,14,22,0,10
2055602,19,30,1994,5,"male",548,374,313,16,34,0,10,16,24
2055619,74,29,1939,9,"female",505,39,26,217,30,0,5,217,25
2055629,63,15,1950,4,"male",1016,235,186,52,53,22,38,30,15
2055636,24,6,1989,5,"male",1421,637,488,441,103,435,94,6,9
2055639,58,2,1955,8,"female",418,23,7,2,0,0,0,2,0
2055711,24,4,1989,12,"male",298,185,159,74,18,74,11,0,7
2055731,15,15,1998,11,"male",17,11,4,2,0,2,0,0,0
2055747,25,1,1988,1,"male",303,287,280,11,0,11,0,0,0
2055749,57,15,1956,1,"male",1587,630,457,88,145,75,51,13,94
2055763,30,26,1983,10,"female",1429,51,22,3,24,0,5,3,19
2055768,19,17,1994,3,"female",302,64,35,13,74,13,44,0,30
2055779,20,25,1993,6,"male",175,81,59,22,30,22,22,0,8
2055784,62,17,1951,7,"male",453,17,7,0,0,0,0,0,0
2055796,33,18,1980,3,"male",653,108,31,0,0,0,0,0,0
2055826,20,9,1993,2,"male",391,38,22,0,1,0,1,0,0
2055852,22,4,1991,5,"male",585,24,13,15,11,15,6,0,5
2055875,32,22,1981,1,"female",92,29,27,11,22,11,16,0,6
2055882,60,16,1953,5,"female",2209,53,20,7,8,7,5,0,3
2055910,16,5,1997,5,"male",52,57,32,4,13,0,4,4,9
2055927,50,15,1963,8,"male",561,6,5,0,1,0,1,0,0
2055931,23,30,1990,4,"female",444,77,48,255,81,255,63,0,18
2055940,42,10,1971,12,"male",1804,648,389,47,5,46,2,1,3
2055941,25,23,1988,2,"female",574,78,42,5,15,5,7,0,8
2055962,17,10,1996,11,"female",89,211,24,5,3,5,3,0,0
2055983,17,21,1996,7,"female",827,253,125,4,2,4,2,0,0
2055991,30,25,1983,1,"female",77,8,5,0,0,0,0,0,0
2055995,58,20,1955,5,"male",679,416,257,1,22,0,22,1,0
2055998,93,1,1920,1,"female",58,7,7,20,5,0,0,20,5
2056071,28,29,1985,9,"female",464,70,23,5,34,2,22,3,12
2056081,64,13,1949,5,"female",1343,37,22,28,7,5,4,23,3
2056099,15,8,1998,9,"male",146,15,7,0,0,0,0,0,0
2056109,75,3,1938,7,"male",1511,4,2,0,0,0,0,0,0
2056123,24,13,1989,9,"female",452,42,34,3,0,3,0,0,0
2056126,89,5,1924,3,"male",595,399,327,41,8,29,2,12,6
2056130,23,12,1990,10,"male",263,113,17,0,0,0,0,0,0
2056135,22,10,1991,4,"male",214,436,422,9,9,7,6,2,3
2056139,86,18,1927,6,"male",1489,1330,747,8,192,8,182,0,10
2056150,48,6,1965,3,"female",533,292,220,852,303,0,66,852,237
2056154,17,12,1996,9,"female",481,321,239,31,53,30,18,1,35
2056173,15,20,1998,7,"female",459,418,145,301,203,265,58,36,145
2056179,16,15,1997,11,"male",493,208,171,1,0,1,0,0,0
2056190,14,24,1999,6,"female",305,660,455,17,72,17,45,0,27
2056194,53,8,1960,5,"female",322,3,2,0,0,0,0,0,0
2056222,59,19,1954,8,"male",649,79,48,121,71,111,11,10,60
2056260,42,26,1971,2,"female",189,22,16,10,41,10,34,0,7
2056278,63,22,1950,4,"female",420,97,72,97,25,97,9,0,16
2056305,64,11,1949,2,"male",1668,17,4,2,0,2,0,0,0
2056329,62,27,1951,11,"male",907,124,105,20,0,0,0,20,0
2056339,21,26,1992,4,"female",497,148,78,138,157,138,54,0,103
2056346,101,1,1912,1,"female",1598,115,78,10,43,0,4,10,39
2056368,19,14,1994,8,"male",244,219,188,4,9,2,5,2,4
2056378,108,18,1905,10,"female",2031,448,207,411,406,406,131,5,275
2056390,23,10,1990,1,"male",341,13,11,0,18,0,16,0,2
2056434,36,24,1977,11,"female",496,1270,542,2418,2487,860,667,1558,1820
2056436,20,10,1993,12,"male",552,74,41,0,0,0,0,0,0
2056446,50,31,1963,12,"female",283,13,7,55,1,0,1,55,0
2056463,18,1,1995,1,"female",404,2014,1324,5455,15089,2191,3799,3264,11290
2056481,14,14,1999,8,"male",319,371,293,488,40,377,33,111,7
2056486,18,14,1995,3,"female",709,652,303,11510,1939,11510,1795,0,144
2056494,18,1,1995,1,"female",546,2062,789,48,237,9,156,39,81
2056515,33,2,1980,1,"female",214,0,0,0,0,0,0,0,0
2056541,47,10,1966,3,"female",510,149,95,1260,943,18,342,1242,601
2056543,51,27,1962,7,"male",345,118,73,0,14,0,12,0,2
2056581,17,28,1996,12,"male",154,195,148,0,5,0,4,0,1
2056606,23,21,1990,8,"female",333,514,158,270,378,245,114,25,264
2056608,17,20,1996,6,"male",156,50,39,2,0,2,0,0,0
2056623,55,23,1958,10,"female",615,164,108,74,83,74,38,0,45
2056631,38,2,1975,4,"male",252,17,12,0,0,0,0,0,0
2056633,70,25,1943,1,"male",1334,126,39,24,5,24,3,0,2
2056646,68,29,1945,10,"female",1095,171,90,732,192,732,144,0,48
2056709,113,21,1900,11,"male",1708,542,401,35,1,35,0,0,1
2056716,63,1,1950,1,"female",251,320,82,12104,2806,12104,2755,0,51
2056757,22,20,1991,8,"male",154,5,4,0,0,0,0,0,0
2056762,45,15,1968,3,"female",451,202,99,7,45,0,13,7,32
2056770,26,17,1987,8,"male",947,140,44,1,1,0,1,1,0
2056787,35,2,1978,5,"male",2,0,0,0,0,0,0,0,0
2056789,29,10,1984,8,"male",237,9,4,0,2,0,2,0,0
2056802,50,27,1963,11,"female",1979,60,24,74,39,65,33,9,6
2056810,23,23,1990,6,"female",612,231,101,126,147,126,135,0,12
2056841,56,5,1957,5,"male",337,37,8,14,1,14,1,0,0
2056861,68,6,1945,7,"male",1819,38,12,0,2,0,0,0,2
2056913,16,23,1997,7,"female",549,427,246,6,60,5,49,1,11
2056924,14,30,1999,5,"male",596,204,154,35,46,29,16,6,30
2056954,51,8,1962,7,"female",474,9,1,18,0,18,0,0,0
2056964,18,17,1995,10,"male",248,94,50,6,11,6,9,0,2
2057026,26,1,1987,1,"female",321,30,17,15,1,15,1,0,0
2057050,53,16,1960,2,"female",707,27,18,0,1,0,1,0,0
2057051,21,14,1992,11,"male",434,56,1,24,27,24,24,0,3
2057059,32,6,1981,9,"male",234,194,75,3028,1289,3028,450,0,839
2057073,20,21,1993,6,"female",638,665,431,1,200,1,161,0,39
2057100,22,5,1991,6,"male",107,90,64,42,23,6,17,36,6
2057121,68,26,1945,6,"male",1098,369,303,209,118,0,6,209,112
2057129,16,21,1997,9,"female",370,251,103,52,10,52,9,0,1
2057150,65,27,1948,4,"female",6,26,25,22,45,22,26,0,19
2057164,15,28,1998,7,"female",512,290,188,12,9,12,6,0,3
2057226,79,29,1934,4,"female",1438,38,15,51,16,51,12,0,4
2057239,23,1,1990,1,"male",25,28,21,1,2,1,2,0,0
2057242,61,27,1952,8,"male",246,11,10,5,5,5,1,0,4
2057251,26,28,1987,1,"male",136,21,14,0,0,0,0,0,0
2057276,43,12,1970,8,"female",186,53,41,9,21,9,14,0,7
2057282,15,1,1998,7,"male",180,168,149,79,6,28,2,51,4
2057317,14,1,1999,1,"male",108,25,22,4,0,4,0,0,0
2057346,40,21,1973,11,"male",362,8,6,77,30,58,10,19,20
2057349,16,4,1997,8,"male",469,270,129,3,5,3,4,0,1
2057352,22,29,1991,4,"male",212,36,27,1,0,0,0,1,0
2057360,25,19,1988,5,"female",761,223,157,34,20,3,12,31,8
2057370,56,5,1957,7,"female",435,208,181,4,18,0,6,4,12
2057409,54,28,1959,10,"female",1185,30,16,262,42,199,35,63,7
2057411,23,16,1990,3,"male",606,44,33,10,0,10,0,0,0
2057447,46,24,1967,2,"female",436,9,3,2,0,2,0,0,0
2057456,20,12,1993,8,"female",38,204,184,2262,1255,61,343,2201,912
2057463,27,10,1986,9,"male",61,25,24,148,16,137,10,11,6
2057469,31,11,1982,1,"male",392,146,76,15,5,15,1,0,4
2057515,21,11,1992,2,"male",62,1,1,49,18,48,14,1,4
2057517,15,21,1998,8,"male",66,235,199,490,292,428,179,62,113
2057550,54,1,1959,5,"female",1568,2417,698,3227,3110,3207,1511,20,1599
2057576,51,4,1962,4,"male",1660,48,27,0,0,0,0,0,0
2057581,26,16,1987,4,"male",317,116,38,10,78,10,70,0,8
2057583,14,21,1999,2,"female",558,36,19,6,7,0,1,6,6
2057606,16,13,1997,5,"female",90,220,118,657,110,84,50,573,60
2057618,58,12,1955,3,"male",1267,46,15,11,84,9,40,2,44
2057628,24,10,1989,1,"female",210,4,1,0,0,0,0,0,0
2057630,20,26,1993,12,"female",302,87,60,9,25,9,18,0,7
2057646,67,26,1946,12,"male",1867,208,144,2038,2776,268,452,1770,2324
2057650,30,1,1983,1,"male",255,48,46,21,0,21,0,0,0
2057746,17,9,1996,9,"female",126,22,15,27,50,27,43,0,7
2057748,37,12,1976,12,"female",123,24,19,2,0,2,0,0,0
2057768,68,20,1945,12,"male",496,187,168,70,77,68,57,2,20
2057782,28,15,1985,9,"male",643,80,40,291,317,285,173,6,144
2057806,28,24,1985,9,"male",551,375,101,1496,441,73,249,1423,192
2057809,51,6,1962,10,"female",754,27,14,16,20,16,16,0,4
2057814,51,8,1962,12,"female",571,35,21,199,474,0,146,199,328
2057826,16,3,1997,4,"male",55,138,119,24,16,24,16,0,0
2057855,26,1,1987,1,"male",332,67,14,5,13,5,13,0,0
2057864,21,2,1992,1,"male",563,190,54,9,6,7,4,2,2
2057870,36,11,1977,5,"female",213,8,7,28,6,28,6,0,0
2057901,14,12,1999,1,"female",433,193,130,0,0,0,0,0,0
2057918,22,12,1991,8,"female",2148,245,104,393,511,33,331,360,180
2057927,113,17,1900,9,"male",1884,239,130,0,8,0,7,0,1
2057961,108,3,1905,7,"male",1697,344,117,28,30,27,29,1,1
2058003,32,8,1981,1,"male",133,26,24,14,0,5,0,9,0
2058059,108,26,1905,3,"male",205,4,2,0,0,0,0,0,0
2058078,19,7,1994,7,"female",528,205,110,1,4,0,4,1,0
2058106,103,12,1910,9,"male",1083,520,278,0,0,0,0,0,0
2058123,15,16,1998,4,"female",190,35,23,4,0,4,0,0,0
2058128,35,21,1978,6,"male",365,21,16,3,2,3,1,0,1
2058136,24,13,1989,4,"female",247,38,20,78,54,78,41,0,13
2058154,33,29,1980,6,"female",777,15,11,29,3,29,3,0,0
2058188,18,3,1995,1,"male",443,112,81,0,1,0,1,0,0
2058236,26,20,1987,3,"male",439,31,15,621,112,105,82,516,30
2058253,41,9,1972,8,"male",371,18,15,5,13,0,2,5,11
2058263,21,3,1992,7,"male",372,32,22,1,0,1,0,0,0
2058272,68,26,1945,4,"male",562,307,176,1,47,0,33,1,14
2058291,31,6,1982,6,"female",109,20,14,10,0,10,0,0,0
2058318,32,9,1981,6,"female",393,73,48,8,11,0,4,8,7
2058364,25,10,1988,6,"female",367,24,9,1,1,1,0,0,1
2058367,31,22,1982,11,"male",516,9,1,0,0,0,0,0,0
2058410,20,18,1993,2,"male",175,93,66,40,14,40,13,0,1
2058423,55,13,1958,1,"female",1776,938,519,990,1967,686,930,304,1037
2058436,28,15,1985,2,"male",811,0,0,0,0,0,0,0,0
2058446,18,28,1995,4,"male",177,74,50,6,1,6,0,0,1
2058470,72,31,1941,12,"female",116,43,26,197,49,197,40,0,9
2058505,37,4,1976,12,"male",403,56,33,2,8,2,5,0,3
2058521,23,25,1990,1,"male",153,11,10,0,1,0,1,0,0
2058557,29,23,1984,10,"male",1393,367,190,61,51,59,49,2,2
2058558,17,16,1996,8,"male",369,243,184,6,3,0,2,6,1
2058560,32,15,1981,11,"male",395,62,49,5,7,5,5,0,2
2058575,53,25,1960,11,"male",267,139,46,65,155,1,60,64,95
2058591,87,6,1926,8,"male",510,3,0,0,0,0,0,0,0
2058592,18,14,1995,11,"male",45,98,63,115,22,115,20,0,2
2058595,39,5,1974,4,"female",410,57,6,2,4,2,3,0,1
2058637,58,21,1955,8,"female",654,24,10,1,8,0,1,1,7
2058646,103,14,1910,9,"female",2141,82,43,53,30,53,20,0,10
2058653,15,22,1998,7,"male",291,45,30,241,127,241,65,0,62
2058684,56,2,1957,1,"female",183,85,52,0,0,0,0,0,0
2058706,22,1,1991,12,"female",277,224,140,735,581,540,392,195,189
2058751,22,1,1991,1,"male",117,102,91,0,0,0,0,0,0
2058770,19,28,1994,12,"male",481,2476,2103,66,2196,19,1685,47,511
2058804,18,24,1995,2,"male",307,35,29,83,26,83,26,0,0
2058813,16,2,1997,12,"female",118,420,230,472,385,456,344,16,41
2058817,26,20,1987,6,"female",146,64,16,51,17,51,11,0,6
2058852,14,21,1999,2,"male",362,5,5,0,3,0,3,0,0
2058864,42,14,1971,3,"male",140,0,0,0,0,0,0,0,0
2058894,23,17,1990,6,"female",23,26,21,0,0,0,0,0,0
2058921,68,19,1945,10,"female",1701,209,87,1892,684,1439,556,453,128
2058950,36,2,1977,5,"male",624,0,0,0,0,0,0,0,0
2058957,20,10,1993,9,"female",930,854,270,130,372,103,277,27,95
2058961,16,1,1997,4,"male",148,367,327,183,104,89,70,94,34
2058973,27,5,1986,7,"male",113,14,9,1,5,0,1,1,4
2058988,51,25,1962,7,"female",1930,245,164,585,1121,148,715,437,406
2058998,18,15,1995,4,"male",278,116,87,12,22,0,4,12,18
2059016,55,14,1958,9,"female",1143,134,89,15,276,6,196,9,80
2059030,39,27,1974,12,"male",394,12,1,6,15,6,14,0,1
2059035,81,10,1932,5,"male",554,224,180,1331,218,1331,178,0,40
2059051,25,13,1988,4,"male",35,21,17,0,0,0,0,0,0
2059080,63,15,1950,5,"male",81,45,32,2,50,0,7,2,43
2059121,35,25,1978,10,"female",1988,300,187,368,642,367,480,1,162
2059126,51,30,1962,7,"female",337,92,69,39,53,37,29,2,24
2059138,14,12,1999,9,"male",361,343,250,28,7,18,4,10,3
2059144,53,25,1960,3,"male",1445,28,13,6,9,6,3,0,6
2059148,53,24,1960,2,"male",1478,81,14,7,3,7,3,0,0
2059159,52,14,1961,7,"male",264,135,100,17,0,17,0,0,0
2059176,14,1,1999,1,"male",514,29,19,7,7,7,7,0,0
2059194,39,21,1974,7,"male",805,54,10,6,0,6,0,0,0
2059204,27,14,1986,11,"male",136,121,111,0,2,0,2,0,0
2059210,19,3,1994,8,"female",628,1481,458,55,13,55,11,0,2
2059227,25,12,1988,12,"female",315,130,77,46,1,46,0,0,1
2059240,42,4,1971,8,"female",384,134,81,55,340,50,105,5,235
2059241,23,2,1990,11,"female",257,40,19,0,0,0,0,0,0
2059267,26,16,1987,7,"male",333,194,104,93,42,54,21,39,21
2059280,23,22,1990,9,"female",279,316,62,70,53,70,52,0,1
2059300,25,12,1988,1,"male",295,57,39,13,4,0,2,13,2
2059317,103,4,1910,3,"male",638,663,320,0,5,0,5,0,0
2059421,25,2,1988,12,"male",126,180,152,295,101,295,80,0,21
2059462,59,9,1954,3,"male",765,90,65,360,321,360,149,0,172
2059475,26,13,1987,8,"male",432,680,610,2,2,0,2,2,0
2059490,15,1,1998,8,"female",127,11,6,1,4,1,2,0,2
2059498,29,6,1984,9,"male",344,39,9,0,0,0,0,0,0
2059508,68,24,1945,3,"female",554,190,119,13,33,7,25,6,8
2059523,63,30,1950,10,"male",791,76,44,1,2,1,1,0,1
2059573,78,23,1935,5,"male",1515,66,23,0,10,0,6,0,4
2059593,23,6,1990,3,"male",585,188,138,0,0,0,0,0,0
2059614,13,2,2000,2,"female",332,826,495,1024,683,125,145,899,538
2059630,33,26,1980,8,"male",790,140,103,42,25,29,18,13,7
2059636,51,15,1962,2,"female",555,42,11,6,0,6,0,0,0
2059643,13,5,2000,5,"female",169,147,77,185,83,108,37,77,46
2059647,15,2,1998,4,"male",649,252,222,1,1,1,1,0,0
2059670,28,7,1985,12,"female",18,7,7,2,2,2,2,0,0
2059675,32,23,1981,12,"female",72,238,111,1338,253,1333,226,5,27
2059710,52,6,1961,3,"male",650,51,44,9,51,0,25,9,26
2059712,19,24,1994,2,"female",361,92,77,0,2,0,2,0,0
2059759,21,22,1992,4,"male",277,148,69,60,51,15,40,45,11
2059781,18,5,1995,5,"female",208,1823,931,147,1352,147,844,0,508
2059790,25,20,1988,11,"male",182,70,42,0,0,0,0,0,0
2059795,29,30,1984,9,"male",585,113,107,0,0,0,0,0,0
2059803,113,19,1900,10,"female",1548,193,136,12,37,9,24,3,13
2059818,32,30,1981,8,"female",220,38,12,0,0,0,0,0,0
2059825,31,17,1982,11,"male",551,1,0,0,0,0,0,0,0
2059838,23,6,1990,4,"female",718,728,337,66,212,65,154,1,58
2059855,18,11,1995,11,"female",409,630,506,113,54,30,21,83,33
2059865,103,1,1910,1,"male",1780,192,41,8,36,1,18,7,18
2059888,29,28,1984,10,"male",158,13,5,0,0,0,0,0,0
2059927,30,21,1983,5,"female",364,187,116,11,6,0,1,11,5
2059941,64,5,1949,6,"male",5,41,30,1,3,1,1,0,2
2059968,23,19,1990,5,"female",176,109,50,1103,166,1103,81,0,85
2059974,21,7,1992,7,"male",123,69,49,67,136,41,113,26,23
2059982,22,24,1991,8,"male",210,18,14,0,0,0,0,0,0
2059997,21,10,1992,12,"female",705,523,245,377,462,236,84,141,378
2060013,33,28,1980,11,"female",43,31,13,0,0,0,0,0,0
2060033,25,27,1988,6,"female",400,169,72,388,150,137,55,251,95
2060046,27,23,1986,11,"male",302,15,9,17,0,17,0,0,0
2060068,31,6,1982,7,"female",451,193,60,543,565,543,336,0,229
2060071,48,30,1965,10,"male",540,16,8,0,0,0,0,0,0
2060106,20,21,1993,9,"male",1076,759,559,44,7,11,3,33,4
2060122,53,18,1960,6,"male",271,115,93,25,4,24,3,1,1
2060133,45,21,1968,9,"male",224,8,5,8,10,8,9,0,1
2060139,38,29,1975,11,"male",680,18,10,1,0,1,0,0,0
2060166,42,1,1971,2,"male",1044,30,8,0,0,0,0,0,0
2060195,32,5,1981,9,"male",513,229,200,12,12,12,8,0,4
2060196,20,28,1993,7,"female",607,341,247,104,83,101,47,3,36
2060234,22,11,1991,5,"male",241,147,62,0,0,0,0,0,0
2060238,41,4,1972,2,"male",580,565,219,1,16,0,4,1,12
2060250,21,14,1992,1,"female",561,108,25,17,15,9,13,8,2
2060255,35,5,1978,10,"male",106,19,18,53,14,3,6,50,8
2060268,103,4,1910,10,"male",467,77,53,2,0,2,0,0,0
2060270,52,23,1961,8,"male",203,22,14,7,0,7,0,0,0
2060297,72,8,1941,12,"female",332,22,17,542,59,0,49,542,10
2060315,53,6,1960,7,"female",270,120,74,14,47,9,17,5,30
2060330,23,20,1990,9,"male",335,98,79,6,5,3,1,3,4
2060339,49,3,1964,2,"female",777,605,441,258,357,146,263,112,94
2060359,24,1,1989,11,"male",159,62,49,1,2,1,1,0,1
2060363,30,9,1983,12,"male",251,43,22,47,35,47,16,0,19
2060364,24,1,1989,1,"male",12,20,17,3,132,3,50,0,82
2060376,83,24,1930,3,"male",801,287,153,10,46,0,21,10,25
2060379,34,1,1979,12,"male",429,28,23,4,1,4,0,0,1
2060400,34,7,1979,2,"male",264,42,38,11,2,10,0,1,2
2060403,108,20,1905,1,"male",811,330,210,266,493,266,261,0,232
2060420,18,22,1995,6,"female",268,2569,2130,40,430,40,388,0,42
2060431,17,16,1996,8,"female",449,589,475,4348,3446,2021,1983,2327,1463
2060432,109,1,1904,1,"male",2192,239,139,6,1,6,1,0,0
2060446,47,13,1966,8,"female",210,556,501,1214,642,830,193,384,449
2060450,18,3,1995,6,"female",78,30,27,0,0,0,0,0,0
2060457,19,11,1994,11,"male",238,237,165,177,281,17,122,160,159
2060461,29,1,1984,1,"male",406,44,32,34,1,0,1,34,0
2060473,26,1,1987,9,"male",361,193,131,83,35,79,30,4,5
2060495,28,30,1985,5,"male",431,2,2,1,0,1,0,0,0
2060498,66,15,1947,12,"female",945,52,45,40,26,40,23,0,3
2060510,55,23,1958,9,"male",1704,186,152,78,75,58,39,20,36
2060527,19,12,1994,2,"female",113,40,22,0,0,0,0,0,0
2060538,33,18,1980,10,"male",192,80,57,2,5,2,1,0,4
2060543,15,11,1998,4,"male",411,158,127,8,4,6,2,2,2
2060546,15,7,1998,8,"male",302,414,370,19,0,0,0,19,0
2060558,100,15,1913,8,"male",124,7,6,2,1,2,1,0,0
2060571,28,2,1985,2,"male",402,97,86,1,8,1,7,0,1
2060594,22,24,1991,8,"male",22,71,71,2,1,2,1,0,0
2060597,18,1,1995,3,"female",9,34,33,360,289,360,281,0,8
2060616,24,8,1989,10,"female",858,828,226,47,151,47,146,0,5
2060637,33,14,1980,10,"male",137,80,69,41,68,41,18,0,50
2060654,19,4,1994,1,"male",285,25,21,2,0,2,0,0,0
2060656,15,17,1998,1,"female",291,243,114,34,23,34,13,0,10
2060672,26,18,1987,6,"male",527,160,118,32,60,8,40,24,20
2060694,18,5,1995,6,"female",140,193,83,4,0,4,0,0,0
2060719,59,24,1954,6,"female",249,51,42,3,1,0,1,3,0
2060728,85,21,1928,5,"female",1678,774,336,112,59,6,17,106,42
2060743,19,4,1994,9,"male",539,183,118,282,422,267,162,15,260
2060763,22,1,1991,1,"male",226,60,39,168,205,83,143,85,62
2060766,56,5,1957,7,"male",1322,10,7,0,0,0,0,0,0
2060774,64,28,1949,12,"male",998,73,16,48,12,0,7,48,5
2060785,21,23,1992,8,"male",154,109,80,62,81,0,36,62,45
2060790,64,15,1949,8,"female",902,78,34,0,2,0,1,0,1
2060791,39,17,1974,6,"female",573,20,13,9,3,8,2,1,1
2060798,66,22,1947,3,"female",242,58,38,18,13,0,7,18,6
2060799,26,5,1987,5,"male",682,119,91,4,2,4,2,0,0
2060817,21,21,1992,11,"male",1278,1179,661,24,162,24,138,0,24
2060838,33,3,1980,10,"male",215,109,34,1,102,0,95,1,7
2060845,53,1,1960,11,"female",221,50,30,3,10,0,1,3,9
2060846,59,17,1954,12,"female",316,13,10,5,0,5,0,0,0
2060854,25,12,1988,11,"female",205,261,194,4,154,3,53,1,101
2060856,19,1,1994,9,"male",441,449,289,44,175,3,33,41,142
2060862,31,15,1982,1,"female",240,28,13,0,0,0,0,0,0
2060871,22,1,1991,6,"male",418,417,271,0,1,0,0,0,1
2060898,49,7,1964,10,"male",1513,268,152,17,21,13,15,4,6
2060915,18,3,1995,3,"female",47,114,39,61,52,61,38,0,14
2060917,22,25,1991,10,"male",617,17,8,0,2,0,1,0,1
2060930,53,12,1960,9,"female",485,44,17,61,0,61,0,0,0
2060989,52,24,1961,3,"female",484,13,7,0,0,0,0,0,0
2060998,19,17,1994,8,"female",973,1773,700,325,1514,291,751,34,763
2061012,15,1,1998,11,"female",140,144,98,970,586,884,535,86,51
2061055,26,13,1987,5,"male",484,138,96,2296,951,2296,517,0,434
2061065,53,27,1960,8,"female",451,2,2,2,0,2,0,0,0
2061070,51,16,1962,1,"female",1750,106,53,2,6,0,2,2,4
2061073,24,22,1989,10,"male",454,265,232,7,21,4,2,3,19
2061086,31,5,1982,10,"male",847,24,21,9,4,9,2,0,2
2061089,103,10,1910,1,"male",1094,476,368,95,182,95,173,0,9
2061094,33,12,1980,10,"male",315,24,20,1,4,1,4,0,0
2061095,64,5,1949,11,"female",639,77,17,15,9,15,9,0,0
2061129,52,24,1961,4,"female",884,802,556,1637,834,1637,462,0,372
2061137,19,11,1994,8,"male",270,292,267,82,26,82,19,0,7
2061139,42,11,1971,10,"female",610,47,21,337,140,337,122,0,18
2061142,50,27,1963,11,"female",691,14,5,24,43,24,41,0,2
2061156,29,4,1984,7,"female",451,132,82,46,37,46,34,0,3
2061164,27,1,1986,10,"male",101,5,1,0,0,0,0,0,0
2061187,40,21,1973,5,"male",508,112,47,2,2,0,0,2,2
2061212,70,31,1943,12,"male",475,49,34,299,93,0,66,299,27
2061219,72,4,1941,12,"female",445,11,4,0,0,0,0,0,0
2061220,43,26,1970,10,"male",223,80,75,11,0,11,0,0,0
2061244,49,4,1964,1,"female",641,26,17,0,3,0,2,0,1
2061246,21,26,1992,11,"female",404,208,63,220,194,151,58,69,136
2061251,37,8,1976,1,"female",271,596,313,40,110,40,78,0,32
2061296,16,11,1997,3,"female",818,129,64,412,354,284,205,128,149
2061318,18,10,1995,9,"male",37,49,34,3,7,3,7,0,0
2061333,27,5,1986,9,"male",122,182,172,20,15,20,12,0,3
2061343,45,14,1968,7,"female",596,83,47,39,60,0,33,39,27
2061358,43,1,1970,12,"female",274,40,22,300,6,46,1,254,5
2061377,23,18,1990,2,"female",441,355,145,673,360,552,247,121,113
2061378,24,1,1989,4,"female",321,84,62,16,3,0,3,16,0
2061381,108,1,1905,3,"male",462,190,95,1,59,1,44,0,15
2061396,46,14,1967,7,"female",681,30,12,8,4,8,4,0,0
2061397,20,26,1993,5,"male",19,35,32,9,10,9,7,0,3
2061419,26,17,1987,10,"male",36,38,24,0,0,0,0,0,0
2061435,29,5,1984,10,"male",482,103,58,0,1,0,1,0,0
2061449,52,26,1961,10,"male",120,61,48,10,50,10,34,0,16
2061473,38,20,1975,9,"female",294,9,0,6,1,6,1,0,0
2061517,17,12,1996,10,"female",217,32,22,35,14,35,8,0,6
2061524,19,8,1994,10,"female",275,468,33,72,29,72,27,0,2
2061535,20,25,1993,9,"female",251,42,36,3,0,3,0,0,0
2061553,31,7,1982,7,"male",13,6,6,1,0,1,0,0,0
2061555,28,11,1985,3,"female",159,63,52,406,180,406,86,0,94
2061556,25,8,1988,7,"male",569,332,286,49,28,49,24,0,4
2061560,18,15,1995,1,"female",436,55,41,170,157,170,56,0,101
2061570,36,4,1977,5,"female",279,716,519,56,300,56,202,0,98
2061571,23,3,1990,1,"male",503,407,371,2,5,0,2,2,3
2061576,54,23,1959,8,"male",712,243,45,166,48,0,19,166,29
2061578,22,1,1991,1,"male",395,121,47,222,32,48,15,174,17
2061579,51,12,1962,9,"female",154,13,13,11,2,11,2,0,0
2061615,50,20,1963,5,"female",236,36,22,0,0,0,0,0,0
2061651,17,12,1996,9,"female",574,1539,306,8,18,4,15,4,3
2061679,42,3,1971,4,"male",117,81,64,0,26,0,16,0,10
2061683,36,15,1977,11,"male",532,29,10,0,27,0,11,0,16
2061684,26,27,1987,2,"male",663,331,292,20,13,19,12,1,1
2061700,103,28,1910,8,"male",1540,847,506,156,400,156,240,0,160
2061737,18,20,1995,10,"female",362,1948,297,159,776,159,644,0,132
2061750,47,24,1966,3,"male",582,88,10,700,212,17,200,683,12
2061777,55,24,1958,4,"female",277,75,55,40,30,0,9,40,21
2061787,75,14,1938,12,"male",24,23,6,0,0,0,0,0,0
2061799,27,26,1986,7,"male",320,53,35,40,2,40,2,0,0
2061800,108,1,1905,1,"female",1225,47,15,0,5,0,0,0,5
2061810,42,29,1971,8,"female",357,105,67,21,63,21,31,0,32
2061858,48,1,1965,1,"male",363,215,183,5,38,3,21,2,17
2061865,94,3,1919,2,"male",950,709,323,109,73,109,58,0,15
2061875,48,21,1965,11,"female",839,70,48,45,33,45,26,0,7
2061906,20,27,1993,9,"male",337,293,203,56,56,56,14,0,42
2061922,22,7,1991,1,"male",62,57,35,42,0,42,0,0,0
2061954,47,19,1966,1,"female",1610,278,106,66,81,0,17,66,64
2061959,22,18,1991,10,"female",218,121,37,85,59,84,43,1,16
2061971,26,1,1987,1,"male",289,16,15,16,2,16,1,0,1
2061982,66,2,1947,4,"female",731,33,20,11,2,1,0,10,2
2062031,20,4,1993,2,"female",672,185,48,27,307,27,82,0,225
2062044,17,19,1996,5,"male",485,211,129,23,20,6,9,17,11
2062048,103,21,1910,8,"male",1201,33,26,12,0,8,0,4,0
2062053,35,24,1978,6,"female",180,37,28,1,0,1,0,0,0
2062062,16,7,1997,8,"female",872,1054,656,1150,589,237,357,913,232
2062090,16,3,1997,8,"female",890,238,75,104,72,102,43,2,29
2062106,14,24,1999,7,"female",417,322,233,126,1,30,0,96,1
2062123,72,11,1941,1,"female",139,100,39,1168,41,0,11,1168,30
2062134,21,28,1992,5,"female",599,54,48,38,0,38,0,0,0
2062139,21,4,1992,2,"female",437,27,21,15,9,3,4,12,5
2062175,14,5,1999,2,"female",796,1177,156,480,968,53,779,427,189
2062218,19,5,1994,3,"female",334,486,121,601,239,601,154,0,85
2062232,64,30,1949,7,"female",1443,92,30,38,27,22,20,16,7
2062271,52,3,1961,7,"female",352,123,38,143,25,128,7,15,18
2062274,22,1,1991,1,"female",282,46,35,87,45,87,24,0,21
2062286,23,14,1990,2,"male",317,7,7,0,0,0,0,0,0
2062291,32,26,1981,1,"female",354,73,27,0,2,0,0,0,2
2062297,50,18,1963,10,"male",330,13,8,0,0,0,0,0,0
2062309,83,24,1930,10,"male",1762,192,36,14,13,0,5,14,8
2062347,15,2,1998,8,"female",810,78,59,12,5,0,1,12,4
2062349,21,6,1992,6,"female",191,510,274,166,442,94,202,72,240
2062360,48,3,1965,6,"male",2006,40,34,1,1,0,1,1,0
2062363,17,30,1996,10,"male",117,66,60,0,4,0,3,0,1
2062385,72,7,1941,6,"male",507,112,87,1,0,0,0,1,0
2062394,93,26,1920,11,"male",757,57,39,2,0,0,0,2,0
2062411,18,10,1995,8,"male",249,413,350,1,13,1,12,0,1
2062421,20,1,1993,2,"male",355,74,48,13,24,13,11,0,13
2062478,16,7,1997,3,"male",642,165,44,20,9,20,9,0,0
2062485,42,24,1971,5,"female",1412,70,31,1983,65,1828,40,155,25
2062499,25,19,1988,5,"male",343,35,14,33,2,33,2,0,0
2062500,28,24,1985,3,"male",202,74,49,1,2,1,2,0,0
2062511,63,12,1950,7,"male",342,51,22,56,10,0,0,56,10
2062520,25,10,1988,8,"male",223,27,16,1,0,0,0,1,0
2062540,60,2,1953,3,"female",1221,47,18,30,3,30,3,0,0
2062543,13,28,2000,3,"female",0,0,0,0,0,0,0,0,0
2062562,18,28,1995,10,"male",82,294,277,366,74,366,54,0,20
2062569,24,22,1989,3,"female",714,84,8,27,0,27,0,0,0
2062580,25,21,1988,7,"male",1073,1357,1042,0,1,0,1,0,0
2062602,42,26,1971,8,"male",557,156,68,186,220,186,181,0,39
2062620,51,4,1962,4,"female",808,35,19,273,192,0,23,273,169
2062625,56,9,1957,5,"female",375,34,29,6,2,0,0,6,2
2062631,23,4,1990,9,"male",702,214,167,6,3,6,1,0,2
2062645,19,29,1994,11,"male",359,366,273,32,9,6,6,26,3
2062647,18,1,1995,1,"male",210,24,18,5,0,5,0,0,0
2062662,107,10,1906,7,"male",1365,476,70,221,114,221,81,0,33
2062669,31,31,1982,8,"female",205,143,55,47,16,47,7,0,9
2062672,61,30,1952,12,"male",1325,32,14,9,1,0,0,9,1
2062684,60,20,1953,8,"male",530,22,13,2,0,1,0,1,0
2062685,39,8,1974,9,"male",715,87,45,5,35,5,11,0,24
2062690,30,25,1983,4,"male",365,29,15,0,1,0,0,0,1
2062704,14,12,1999,11,"female",355,628,448,2662,859,1840,459,822,400
2062727,68,20,1945,3,"female",1737,54,22,7,0,6,0,1,0
2062752,85,23,1928,3,"male",559,118,71,2,1,2,0,0,1
2062758,34,5,1979,10,"female",1459,390,235,107,104,53,82,54,22
2062790,56,22,1957,11,"male",1203,99,45,36,70,35,23,1,47
2062822,61,5,1952,1,"male",275,46,25,21,26,21,20,0,6
2062828,14,13,1999,7,"male",439,648,586,4,0,4,0,0,0
2062857,20,11,1993,2,"female",321,53,41,53,0,53,0,0,0
2062865,27,28,1986,10,"male",213,151,134,2,5,0,0,2,5
2062950,22,5,1991,7,"male",417,26,25,3,0,3,0,0,0
2062955,15,3,1998,1,"female",613,407,156,1,27,1,18,0,9
2062957,57,18,1956,11,"male",349,31,10,11,25,11,13,0,12
2062959,42,6,1971,5,"male",354,40,15,1,0,1,0,0,0
2062977,19,9,1994,3,"female",442,339,214,8,8,8,1,0,7
2062995,30,1,1983,10,"male",47,2,1,53,10,53,10,0,0
2063006,21,12,1992,12,"male",15,17,12,4,3,4,1,0,2
2063008,73,15,1940,4,"male",216,200,121,5,44,5,40,0,4
2063021,33,23,1980,12,"female",398,79,71,19,66,19,42,0,24
2063032,63,12,1950,10,"female",822,85,62,992,27,969,15,23,12
2063041,64,30,1949,6,"female",1366,117,69,616,289,0,181,616,108
2063056,30,20,1983,7,"male",620,252,214,0,5,0,0,0,5
2063067,42,11,1971,2,"male",358,14,8,18,1,18,0,0,1
2063076,22,27,1991,11,"male",285,60,41,43,8,43,7,0,1
2063160,51,5,1962,8,"female",364,70,44,5,2,0,0,5,2
2063162,19,1,1994,1,"male",328,280,255,0,0,0,0,0,0
2063167,23,8,1990,10,"male",413,52,21,1,56,0,14,1,42
2063185,18,2,1995,2,"male",196,76,57,103,0,103,0,0,0
2063204,108,5,1905,4,"female",1088,528,192,12,7,12,6,0,1
2063212,68,28,1945,2,"male",1399,1252,1005,557,39,0,29,557,10
2063229,39,15,1974,5,"male",26,40,22,82,170,80,155,2,15
2063230,103,12,1910,7,"male",2483,514,339,2,0,2,0,0,0
2063237,15,24,1998,4,"female",235,72,34,0,0,0,0,0,0
2063243,28,20,1985,7,"male",554,75,34,43,27,31,15,12,12
2063275,19,12,1994,10,"male",516,362,154,322,168,97,47,225,121
2063284,97,10,1916,4,"female",391,80,59,14,10,14,10,0,0
2063291,36,2,1977,3,"female",457,191,169,88,88,16,61,72,27
2063306,15,22,1998,8,"male",22,0,0,0,0,0,0,0,0
2063326,24,22,1989,10,"male",420,237,86,10,3,8,2,2,1
2063340,60,16,1953,7,"female",132,25,22,2,0,2,0,0,0
2063417,55,14,1958,4,"male",412,117,108,186,108,0,25,186,83
2063426,31,1,1982,1,"female",115,19,15,205,107,204,63,1,44
2063450,69,13,1944,8,"female",382,143,61,256,43,255,39,1,4
2063455,16,3,1997,4,"female",31,0,0,0,0,0,0,0,0
2063468,64,1,1949,10,"male",374,4524,100,13,208,13,174,0,34
2063506,28,3,1985,9,"male",352,402,305,158,71,158,43,0,28
2063508,59,20,1954,3,"female",1456,43,17,71,80,40,43,31,37
2063511,26,25,1987,4,"male",348,612,540,68,19,68,9,0,10
2063513,24,27,1989,7,"male",1068,671,293,294,328,154,149,140,179
2063583,61,7,1952,11,"female",407,16,11,4,1,0,1,4,0
2063588,18,8,1995,9,"male",153,220,196,4,17,3,6,1,11
2063598,42,7,1971,5,"female",1160,106,32,32,142,32,124,0,18
2063658,23,15,1990,5,"female",18,9,3,11,8,11,7,0,1
2063664,25,1,1988,1,"male",24,8,8,91,14,91,4,0,10
2063696,107,29,1906,12,"male",328,3748,396,6203,19674,3667,17624,2536,2050
2063698,105,6,1908,9,"male",881,205,107,18,107,18,49,0,58
2063699,13,4,2000,3,"male",242,122,53,40,7,39,2,1,5
2063710,68,17,1945,8,"female",687,111,79,11,3,11,0,0,3
2063711,69,3,1944,12,"female",1646,49,33,79,6,29,5,50,1
2063763,26,1,1987,1,"male",233,28,21,12,1,12,1,0,0
2063788,13,21,2000,2,"male",127,110,94,85,3,71,2,14,1
2063811,28,3,1985,5,"male",37,7,6,48,0,24,0,24,0
2063832,17,8,1996,6,"male",252,20,15,0,0,0,0,0,0
2063854,16,13,1997,10,"female",333,143,67,467,323,309,210,158,113
2063870,37,7,1976,5,"male",342,30,10,0,0,0,0,0,0
2063876,44,12,1969,12,"male",1743,29,5,0,2,0,2,0,0
2063909,27,7,1986,2,"male",766,463,265,86,109,86,86,0,23
2063946,88,1,1925,8,"male",1221,14,8,0,0,0,0,0,0
2063951,19,14,1994,9,"female",52,199,111,613,400,608,210,5,190
2063952,26,10,1987,12,"male",314,151,111,177,2,177,1,0,1
2063953,20,10,1993,2,"male",130,0,0,0,0,0,0,0,0
2064020,76,23,1937,4,"male",155,590,495,494,57,43,33,451,24
2064048,36,16,1977,10,"male",413,72,62,33,14,33,10,0,4
2064053,17,25,1996,5,"male",590,327,251,0,1,0,1,0,0
2064071,16,27,1997,8,"male",129,181,99,10,32,1,22,9,10
2064098,26,9,1987,8,"male",832,157,94,214,160,212,91,2,69
2064099,28,25,1985,1,"male",657,199,31,0,0,0,0,0,0
2064106,57,14,1956,10,"male",1369,70,36,3,5,1,3,2,2
2064115,18,18,1995,11,"male",471,69,58,1,3,1,3,0,0
2064168,25,23,1988,9,"female",166,89,39,38,10,38,9,0,1
2064185,28,23,1985,5,"male",688,226,180,30,22,30,13,0,9
2064192,14,1,1999,1,"female",134,43,31,0,0,0,0,0,0
2064195,17,16,1996,8,"female",547,1659,216,349,760,346,338,3,422
2064201,70,16,1943,11,"female",1866,41,15,6,2,6,2,0,0
2064228,23,14,1990,12,"male",425,165,131,0,0,0,0,0,0
2064239,57,10,1956,3,"male",701,46,30,0,2,0,0,0,2
2064263,31,20,1982,8,"female",383,21,16,80,6,80,6,0,0
2064273,21,23,1992,2,"female",141,42,33,39,45,7,25,32,20
2064297,19,13,1994,12,"male",1190,245,155,1,5,0,1,1,4
2064305,38,2,1975,4,"female",332,91,69,80,75,80,23,0,52
2064313,74,11,1939,12,"male",711,22,21,24,6,0,2,24,4
2064318,17,4,1996,5,"female",258,324,232,275,166,262,145,13,21
2064325,44,9,1969,6,"female",1584,10,6,0,0,0,0,0,0
2064330,46,20,1967,8,"male",389,101,66,0,3,0,2,0,1
2064360,19,13,1994,11,"male",682,197,143,2,2,2,1,0,1
2064395,28,31,1985,10,"male",338,26,26,2,0,2,0,0,0
2064402,40,9,1973,7,"male",632,68,24,0,0,0,0,0,0
2064429,19,29,1994,4,"female",398,69,37,31,70,31,54,0,16
2064440,44,11,1969,1,"male",470,22,14,3,0,3,0,0,0
2064487,96,18,1917,9,"female",535,38,23,168,14,167,9,1,5
2064490,15,14,1998,2,"male",532,507,352,88,54,4,25,84,29
2064501,23,5,1990,5,"male",230,156,96,3,14,2,4,1,10
2064580,56,9,1957,4,"female",873,18,13,80,98,80,91,0,7
2064591,17,13,1996,7,"female",391,33,23,0,1,0,0,0,1
2064592,23,25,1990,4,"female",49,8,8,7,6,5,3,2,3
2064600,18,31,1995,7,"male",23,4,1,0,0,0,0,0,0
2064606,28,10,1985,5,"male",255,0,0,0,0,0,0,0,0
2064614,19,5,1994,1,"male",432,11,8,0,0,0,0,0,0
2064649,17,19,1996,7,"male",301,33,15,27,9,27,9,0,0
2064650,29,25,1984,12,"male",141,79,64,2,2,2,1,0,1
2064674,30,14,1983,10,"male",181,21,20,0,0,0,0,0,0
2064679,20,22,1993,7,"male",318,159,112,101,61,79,27,22,34
2064694,101,29,1912,2,"male",604,49,46,42,1,17,1,25,0
2064745,35,14,1978,4,"male",469,195,1,0,0,0,0,0,0
2064754,21,5,1992,5,"male",294,128,118,0,0,0,0,0,0
2064777,15,19,1998,2,"female",588,1959,543,14,247,14,188,0,59
2064789,52,17,1961,2,"male",160,12,9,1,3,0,0,1,3
2064816,39,30,1974,8,"female",400,27,13,81,53,81,49,0,4
2064850,15,6,1998,8,"female",400,942,519,763,397,667,165,96,232
2064858,31,16,1982,8,"female",862,66,27,10,25,10,6,0,19
2064865,62,21,1951,8,"female",1653,591,205,558,751,558,284,0,467
2064878,17,8,1996,8,"female",418,58,42,54,204,17,168,37,36
2064879,20,1,1993,9,"female",1462,341,115,608,484,567,424,41,60
2064912,107,13,1906,11,"male",2185,170,73,10,18,4,8,6,10
2064966,19,22,1994,9,"male",67,243,235,689,422,477,217,212,205
2065001,44,14,1969,3,"male",1056,51,23,36,74,36,55,0,19
2065047,91,22,1922,10,"male",70,15,12,0,0,0,0,0,0
2065054,21,14,1992,8,"female",396,71,15,2,0,1,0,1,0
2065057,50,13,1963,8,"male",533,31,6,23,5,23,1,0,4
2065107,17,6,1996,10,"male",378,675,574,20,4,1,1,19,3
2065129,67,11,1946,8,"male",138,97,47,46,17,46,6,0,11
2065146,27,8,1986,7,"female",1612,168,125,1036,205,159,103,877,102
2065172,21,15,1992,9,"female",233,55,15,21,16,21,16,0,0
2065176,63,14,1950,1,"male",1857,118,71,247,149,223,99,24,50
2065180,48,6,1965,3,"female",13,13,13,7,4,5,2,2,2
2065181,17,1,1996,1,"male",552,1478,935,2749,2220,2610,2014,139,206
2065219,65,14,1948,7,"female",1580,41,15,26,75,26,58,0,17
2065229,62,29,1951,1,"male",838,249,107,769,322,483,199,286,123
2065235,18,30,1995,8,"male",122,61,34,246,169,78,88,168,81
2065256,18,7,1995,3,"male",815,210,163,0,0,0,0,0,0
2065326,28,29,1985,8,"female",415,72,41,1,0,0,0,1,0
2065354,33,11,1980,6,"female",139,26,12,41,40,41,40,0,0
2065355,23,7,1990,12,"male",70,38,32,3,4,3,2,0,2
2065367,16,21,1997,3,"male",288,477,316,49,8,49,5,0,3
2065389,20,20,1993,9,"female",324,721,357,1422,2080,790,627,632,1453
2065391,23,16,1990,8,"male",247,92,80,7,4,7,3,0,1
2065392,19,1,1994,1,"male",157,26,17,13,0,13,0,0,0
2065402,24,15,1989,1,"male",273,67,50,2,1,2,1,0,0
2065425,22,1,1991,9,"female",533,101,68,38,32,38,24,0,8
2065432,51,29,1962,8,"female",1870,68,28,29,56,27,34,2,22
2065438,25,24,1988,9,"male",307,48,44,0,0,0,0,0,0
2065441,16,11,1997,8,"female",270,936,292,94,567,94,548,0,19
2065448,113,2,1900,4,NA,1366,101,66,90,49,0,31,90,18
2065461,48,4,1965,9,"female",102,6,6,0,0,0,0,0,0
2065499,25,8,1988,3,"male",164,69,63,127,1,40,1,87,0
2065500,61,23,1952,3,"female",357,0,0,0,0,0,0,0,0
2065510,19,26,1994,8,"male",456,12,1,5,0,5,0,0,0
2065513,53,31,1960,7,"male",4,4,1,0,0,0,0,0,0
2065515,31,24,1982,9,"female",621,98,36,224,320,187,62,37,258
2065532,17,6,1996,9,"male",92,160,135,29,6,16,2,13,4
2065535,59,14,1954,8,"male",421,31,27,0,0,0,0,0,0
2065544,29,6,1984,6,"male",1259,228,86,24,3,24,2,0,1
2065550,70,15,1943,12,"male",610,44,27,3,4,0,4,3,0
2065561,44,28,1969,1,"female",600,44,14,66,34,66,11,0,23
2065569,26,22,1987,12,"female",589,348,293,3,5,0,0,3,5
2065576,31,9,1982,9,"female",164,19,9,28,24,28,10,0,14
2065580,31,7,1982,6,"female",406,153,114,193,124,116,56,77,68
2065594,31,14,1982,12,"male",289,81,65,38,37,38,31,0,6
2065642,56,26,1957,10,"male",1611,63,30,0,2,0,1,0,1
2065671,28,1,1985,1,"female",539,28,18,1,1,1,1,0,0
2065691,19,28,1994,3,"male",97,31,26,36,14,36,4,0,10
2065695,17,30,1996,7,"male",611,262,224,21,8,15,5,6,3
2065711,50,16,1963,2,"female",127,15,15,75,11,75,6,0,5
2065720,108,22,1905,11,"male",1258,312,211,79,27,61,13,18,14
2065725,22,7,1991,12,"female",412,1326,651,1133,1968,1133,666,0,1302
2065730,28,1,1985,1,"male",382,77,55,496,13,496,9,0,4
2065735,20,17,1993,6,"female",1368,406,184,1235,3524,905,1757,330,1767
2065783,71,18,1942,12,"male",1656,89,60,44,7,44,5,0,2
2065786,20,18,1993,3,"female",493,280,96,0,32,0,26,0,6
2065799,17,31,1996,5,"male",1025,396,259,130,10,1,4,129,6
2065807,22,12,1991,9,"male",449,164,91,97,19,97,17,0,2
2065830,65,26,1948,2,"female",1166,32,17,0,0,0,0,0,0
2065844,18,5,1995,2,"male",552,414,344,69,60,69,53,0,7
2065849,29,9,1984,8,"male",283,8,6,0,0,0,0,0,0
2065869,23,10,1990,6,"male",394,66,40,4,0,4,0,0,0
2065900,18,4,1995,1,"male",560,223,145,2,3,0,3,2,0
2065952,16,10,1997,11,"female",264,95,69,3,0,3,0,0,0
2065956,68,14,1945,12,"female",51,24,16,40,2,39,2,1,0
2065967,60,29,1953,12,"male",508,116,90,0,2,0,2,0,0
2065974,19,9,1994,12,"female",405,199,80,158,158,158,131,0,27
2065975,21,10,1992,11,"female",1104,1388,774,4914,2192,4399,1985,515,207
2066004,64,8,1949,3,"male",1529,243,87,0,0,0,0,0,0
2066018,40,13,1973,8,"male",83,78,58,53,64,53,57,0,7
2066050,18,14,1995,8,"female",561,6,0,14,0,0,0,14,0
2066058,62,25,1951,2,"female",1560,171,95,16,77,1,38,15,39
2066063,49,21,1964,2,"female",428,93,79,100,47,62,45,38,2
2066065,50,5,1963,12,"female",749,277,194,49,16,0,1,49,15
2066095,61,12,1952,3,"female",1414,489,258,3383,1564,2199,1003,1184,561
2066108,14,24,1999,7,"male",437,67,45,0,9,0,5,0,4
2066122,46,12,1967,3,"male",444,112,36,4,71,0,41,4,30
2066143,20,19,1993,12,"female",701,460,350,245,131,153,72,92,59
2066150,17,30,1996,5,"female",46,51,47,0,8,0,2,0,6
2066168,39,13,1974,4,"male",1082,198,167,39,91,37,34,2,57
2066169,24,16,1989,1,"male",456,200,181,35,20,19,7,16,13
2066205,37,16,1976,4,"male",316,111,72,6,1,0,0,6,1
2066227,51,8,1962,2,"female",195,38,21,26,2,0,0,26,2
2066245,22,1,1991,1,"male",523,74,31,0,0,0,0,0,0
2066249,94,30,1919,3,"male",286,44,21,75,8,75,7,0,1
2066287,27,15,1986,1,"male",141,44,23,34,102,34,38,0,64
2066296,23,2,1990,4,"male",292,320,285,0,0,0,0,0,0
2066314,18,1,1995,1,"male",146,6,6,0,0,0,0,0,0
2066377,39,14,1974,4,"male",644,133,80,9,1,9,1,0,0
2066401,31,21,1982,10,"female",682,50,22,8,22,5,19,3,3
2066405,48,30,1965,3,"male",469,16,13,16,0,8,0,8,0
2066416,31,7,1982,2,"male",680,154,128,0,0,0,0,0,0
2066462,106,9,1907,12,"female",1293,397,129,219,134,217,57,2,77
2066518,42,6,1971,9,"female",341,131,93,262,245,262,160,0,85
2066541,83,29,1930,10,"male",1585,40,15,0,0,0,0,0,0
2066563,27,11,1986,12,"male",622,66,62,437,97,0,63,437,34
2066572,33,3,1980,2,"male",150,27,26,0,0,0,0,0,0
2066613,108,23,1905,5,"female",1168,116,61,27,16,17,7,10,9
2066629,68,30,1945,7,"male",978,156,21,5,0,0,0,5,0
2066651,27,6,1986,8,"male",216,10,10,1,0,1,0,0,0
2066659,56,27,1957,5,"female",740,57,38,62,27,0,21,62,6
2066660,56,12,1957,10,"female",110,18,7,0,10,0,0,0,10
2066679,29,20,1984,9,"male",276,213,200,95,0,0,0,95,0
2066682,25,25,1988,5,"male",613,200,166,3,1,3,0,0,1
2066741,20,16,1993,1,"female",1092,65,27,13,106,13,63,0,43
2066756,44,31,1969,5,"male",296,205,149,2,4,0,1,2,3
2066784,32,14,1981,2,"female",262,41,30,2,1,2,1,0,0
2066791,19,11,1994,3,"male",144,11,8,0,0,0,0,0,0
2066796,18,10,1995,8,"female",322,2382,670,276,802,276,727,0,75
2066807,28,10,1985,2,"male",350,136,135,1,0,0,0,1,0
2066878,18,20,1995,10,"male",86,74,59,220,127,114,81,106,46
2066900,24,2,1989,9,"male",1164,1089,659,13,29,13,13,0,16
2066938,16,9,1997,9,"male",427,406,351,19,8,4,5,15,3
2066954,62,20,1951,4,"male",1120,172,55,0,0,0,0,0,0
2066956,22,7,1991,8,"male",640,591,415,116,267,22,181,94,86
2066959,26,13,1987,1,"male",485,166,54,3,0,3,0,0,0
2066969,42,27,1971,4,"female",829,20,5,1,3,1,0,0,3
2066988,23,24,1990,10,"female",572,49,24,1121,274,1121,199,0,75
2067014,19,31,1994,8,"female",310,481,438,58,94,33,78,25,16
2067058,27,10,1986,1,"male",313,7,0,0,5,0,0,0,5
2067061,52,6,1961,10,"female",476,64,30,22,4,22,4,0,0
2067086,26,23,1987,10,"male",580,93,37,11,2,5,1,6,1
2067090,51,27,1962,11,"male",1608,216,112,819,472,501,318,318,154
2067103,25,29,1988,9,"male",363,21,16,43,23,43,20,0,3
2067112,19,30,1994,10,"female",1727,248,156,333,129,251,73,82,56
2067114,26,30,1987,4,"male",172,2,1,0,0,0,0,0,0
2067129,25,20,1988,8,"male",521,172,71,89,16,89,8,0,8
2067132,28,7,1985,8,"male",387,13,4,1,0,1,0,0,0
2067191,19,28,1994,7,"male",309,598,203,187,217,81,147,106,70
2067237,28,28,1985,4,"female",725,176,91,335,273,0,82,335,191
2067248,59,16,1954,3,"male",148,31,28,26,99,0,66,26,33
2067274,108,10,1905,5,"male",1092,525,436,7,19,0,0,7,19
2067280,79,10,1934,10,"female",64,17,11,16,0,16,0,0,0
2067300,103,29,1910,10,"female",1883,305,142,622,389,455,338,167,51
2067325,32,17,1981,11,"male",258,205,145,2,2,0,2,2,0
2067343,19,21,1994,11,"female",574,921,611,1487,2699,274,1520,1213,1179
2067407,56,27,1957,10,"male",556,75,24,21,10,1,5,20,5
2067410,20,28,1993,4,"male",777,66,23,0,0,0,0,0,0
2067411,108,12,1905,10,"male",882,663,278,33,7,0,0,33,7
2067439,50,1,1963,6,"male",750,4281,873,1137,906,1107,662,30,244
2067462,59,14,1954,3,"male",1899,132,19,0,0,0,0,0,0
2067469,72,13,1941,5,"male",630,159,88,3,12,1,5,2,7
2067472,14,8,1999,12,"male",495,45,24,5,0,0,0,5,0
2067474,54,16,1959,4,"male",308,48,28,1,0,1,0,0,0
2067482,24,5,1989,4,"male",562,2,2,0,0,0,0,0,0
2067499,67,14,1946,1,"female",908,62,40,0,1,0,1,0,0
2067518,23,14,1990,2,"male",598,118,71,2,0,2,0,0,0
2067538,52,15,1961,9,"male",185,6,5,0,0,0,0,0,0
2067552,40,19,1973,12,"male",277,1,1,0,0,0,0,0,0
2067576,41,24,1972,4,"female",438,62,22,620,247,567,155,53,92
2067604,49,18,1964,12,"female",1148,31,18,329,719,76,123,253,596
2067645,19,17,1994,6,"male",178,5,4,0,0,0,0,0,0
2067651,14,28,1999,1,"female",426,233,124,178,378,70,48,108,330
2067655,25,28,1988,4,"male",21,45,41,6,10,6,7,0,3
2067694,14,9,1999,7,"female",158,78,44,153,62,127,23,26,39
2067706,25,16,1988,2,"female",21,38,23,13,10,13,9,0,1
2067718,20,1,1993,7,"male",355,131,113,0,40,0,7,0,33
2067748,17,25,1996,5,"female",515,172,141,0,0,0,0,0,0
2067778,22,17,1991,8,"male",575,278,213,1,3,1,2,0,1
2067784,71,22,1942,9,"female",1398,73,47,102,19,0,7,102,12
2067785,23,9,1990,10,"male",424,130,104,0,0,0,0,0,0
2067805,49,28,1964,3,"female",281,28,20,5,13,5,13,0,0
2067816,30,2,1983,5,"male",241,130,121,0,34,0,18,0,16
2067821,108,1,1905,1,"male",1839,711,486,78,24,33,12,45,12
2067843,21,1,1992,1,"male",358,33,15,1,2,1,1,0,1
2067853,23,27,1990,5,"male",268,60,35,2,1,2,0,0,1
2067941,44,22,1969,12,"female",470,202,75,1402,210,1402,161,0,49
2067953,16,14,1997,5,"male",235,111,81,5,7,5,7,0,0
2067961,39,7,1974,11,"male",510,71,51,29,64,15,33,14,31
2067965,53,14,1960,11,"male",1451,202,148,77,60,77,45,0,15
2067980,67,19,1946,7,"female",1738,148,85,298,51,39,31,259,20
2068007,20,25,1993,2,"male",284,169,152,0,0,0,0,0,0
2068052,15,23,1998,7,"male",40,93,87,1,1,1,0,0,1
2068066,29,27,1984,12,"male",281,169,142,22,21,8,11,14,10
2068081,58,9,1955,7,"female",1765,551,289,75,74,23,19,52,55
2068086,20,30,1993,6,"male",28,34,15,54,58,54,23,0,35
2068114,41,17,1972,3,"female",619,154,135,262,151,247,69,15,82
2068131,16,11,1997,8,"male",122,34,27,0,0,0,0,0,0
2068141,18,5,1995,10,"male",625,1155,942,499,394,353,251,146,143
2068149,58,20,1955,5,"female",1393,87,53,147,249,123,205,24,44
2068219,17,13,1996,9,"female",673,218,105,97,18,95,15,2,3
2068230,19,10,1994,11,"male",305,237,186,8,10,8,7,0,3
2068258,43,10,1970,2,"male",213,28,26,0,0,0,0,0,0
2068276,27,13,1986,7,"male",668,334,175,89,34,89,23,0,11
2068281,26,1,1987,1,"male",32,26,19,0,0,0,0,0,0
2068291,23,10,1990,7,"male",429,22,13,0,0,0,0,0,0
2068339,61,18,1952,6,"male",1403,10,6,11,15,0,3,11,12
2068345,19,21,1994,8,"female",587,1305,918,337,529,316,387,21,142
2068393,18,1,1995,1,"male",108,59,44,304,58,304,37,0,21
2068419,22,15,1991,2,"male",739,236,166,0,0,0,0,0,0
2068421,27,29,1986,12,"male",311,74,51,6,2,0,1,6,1
2068436,26,16,1987,5,"male",448,64,28,1,4,1,2,0,2
2068445,24,10,1989,5,"female",722,340,298,0,5,0,4,0,1
2068456,17,16,1996,9,"male",526,989,658,218,66,166,41,52,25
2068469,23,14,1990,2,"male",661,845,495,0,0,0,0,0,0
2068486,18,18,1995,10,"female",613,1501,608,436,446,413,302,23,144
2068489,23,1,1990,12,"male",254,12,10,0,3,0,3,0,0
2068523,18,25,1995,3,"female",779,639,353,2,12,0,5,2,7
2068551,15,17,1998,12,"male",535,2077,1697,22,75,13,60,9,15
2068605,51,3,1962,11,"female",292,34,22,7,2,7,0,0,2
2068608,22,11,1991,4,"male",232,372,187,1815,621,1815,566,0,55
2068611,31,21,1982,4,"male",778,221,149,3,12,2,6,1,6
2068670,22,18,1991,7,"male",468,32,19,8,1,0,1,8,0
2068673,40,27,1973,3,"female",650,5,5,12,0,0,0,12,0
2068684,34,14,1979,3,"female",245,37,30,26,5,25,4,1,1
2068688,77,23,1936,10,"female",883,82,28,95,130,95,84,0,46
2068711,18,12,1995,12,"male",181,25,20,11,4,11,4,0,0
2068720,43,31,1970,3,"female",713,27,22,10,1,10,1,0,0
2068757,93,9,1920,12,"female",1248,737,400,488,179,36,47,452,132
2068781,56,14,1957,12,"male",392,18,13,0,6,0,3,0,3
2068796,69,14,1944,12,"male",753,39,17,8,17,8,14,0,3
2068824,48,26,1965,10,"male",1030,1,1,0,0,0,0,0,0
2068825,21,24,1992,3,"female",479,190,80,1,1,0,0,1,1
2068837,18,29,1995,10,"male",558,144,126,53,8,43,8,10,0
2068844,19,1,1994,6,"male",819,35,29,0,0,0,0,0,0
2068851,20,9,1993,4,"female",723,338,210,55,6,55,5,0,1
2068858,27,26,1986,11,"male",722,120,56,10,26,10,15,0,11
2068887,22,6,1991,2,"male",576,263,237,2,1,1,1,1,0
2068896,22,26,1991,9,"female",6,57,57,9,6,0,0,9,6
2068907,43,14,1970,9,"female",47,29,26,0,11,0,8,0,3
2068922,68,25,1945,3,"male",1570,190,108,102,3,94,2,8,1
2068952,25,8,1988,5,"female",432,23,14,25,13,25,7,0,6
2068953,69,13,1944,7,"male",2108,69,41,82,39,21,22,61,17
2068981,108,5,1905,8,"male",670,328,223,95,74,95,69,0,5
2069023,18,18,1995,3,"female",1031,4085,1454,274,618,272,452,2,166
2069094,53,27,1960,3,"male",1010,46,14,159,130,36,92,123,38
2069097,25,1,1988,1,"male",46,34,32,12,5,12,3,0,2
2069107,14,25,1999,2,"female",470,1658,431,1630,837,340,328,1290,509
2069110,19,8,1994,8,"male",196,647,470,60,75,60,43,0,32
2069137,28,10,1985,6,"female",348,45,34,12,22,12,12,0,10
2069165,54,19,1959,8,"male",1190,31,11,0,0,0,0,0,0
2069167,61,11,1952,6,"female",27,87,25,748,368,748,150,0,218
2069168,21,2,1992,6,"female",64,21,10,42,5,42,3,0,2
2069172,49,3,1964,8,"female",857,21,6,9,50,9,43,0,7
2069174,23,25,1990,9,"female",808,1020,667,226,543,203,388,23,155
2069184,20,18,1993,1,"male",511,24,9,0,1,0,1,0,0
2069191,43,25,1970,1,"female",408,1,1,3,4,3,4,0,0
2069220,25,25,1988,11,"male",359,152,117,3,0,3,0,0,0
2069244,15,10,1998,9,"male",106,48,37,0,0,0,0,0,0
2069276,53,25,1960,2,"male",564,56,26,3,7,0,1,3,6
2069295,38,3,1975,11,"male",618,39,13,1,1,1,0,0,1
2069316,36,1,1977,10,"male",368,40,35,232,112,232,93,0,19
2069326,35,5,1978,9,"female",271,107,69,92,8,0,4,92,4
2069335,30,16,1983,9,"female",176,51,34,234,30,234,16,0,14
2069348,23,22,1990,4,"male",337,73,40,8,45,8,24,0,21
2069352,54,17,1959,1,"female",870,61,46,16,6,0,3,16,3
2069360,23,1,1990,9,"male",92,97,95,22,3,22,1,0,2
2069370,46,17,1967,3,"male",385,95,53,32,13,0,4,32,9
2069375,19,5,1994,11,"female",256,329,255,19,72,19,23,0,49
2069433,50,22,1963,5,"female",1576,324,112,14,21,14,14,0,7
2069439,65,10,1948,11,"female",730,4,3,0,0,0,0,0,0
2069442,14,2,1999,2,"male",170,14,13,11,0,11,0,0,0
2069487,70,16,1943,9,"female",138,105,30,262,11,261,6,1,5
2069549,34,20,1979,9,"male",448,46,16,0,0,0,0,0,0
2069551,25,1,1988,1,"male",69,11,6,119,66,119,24,0,42
2069566,44,4,1969,2,"female",135,27,23,2,5,2,5,0,0
2069589,27,7,1986,2,"female",1320,115,50,545,768,299,396,246,372
2069606,25,7,1988,1,"female",270,36,3,31,11,31,11,0,0
2069635,59,11,1954,3,"female",843,146,77,284,173,0,50,284,123
2069677,18,31,1995,1,"male",66,33,29,3,7,3,5,0,2
2069680,108,4,1905,7,"female",1351,581,229,24,38,20,19,4,19
2069681,22,9,1991,6,"male",549,145,90,2,8,1,7,1,1
2069706,25,2,1988,8,"male",340,178,129,37,79,37,72,0,7
2069718,40,6,1973,6,"male",429,11,9,9,0,9,0,0,0
2069728,38,23,1975,1,"male",178,131,92,118,31,117,25,1,6
2069733,66,24,1947,10,NA,2231,80,43,44,221,19,110,25,111
2069734,18,2,1995,8,"male",224,16,15,0,0,0,0,0,0
2069761,35,10,1978,1,"male",273,10,10,0,0,0,0,0,0
2069772,20,17,1993,8,"male",754,152,104,3,7,3,7,0,0
2069799,48,5,1965,1,"female",1820,474,367,626,904,495,506,131,398
2069806,21,13,1992,5,"female",1309,673,210,90,366,5,188,85,178
2069810,22,16,1991,12,"female",452,241,161,37,122,37,59,0,63
2069817,62,12,1951,7,"female",1460,16,7,1,4,0,3,1,1
2069826,55,28,1958,10,"female",1428,48,15,37,55,18,25,19,30
2069827,25,1,1988,1,"male",281,1,0,0,0,0,0,0,0
2069833,18,31,1995,5,"female",412,156,82,25,31,25,19,0,12
2069865,14,1,1999,4,"male",138,59,44,10,3,9,1,1,2
2069867,40,21,1973,9,"male",676,92,36,0,2,0,0,0,2
2069869,17,19,1996,11,"female",97,182,139,59,44,59,35,0,9
2069890,57,14,1956,3,"male",397,40,27,52,13,0,7,52,6
2069893,23,3,1990,9,"male",579,151,45,71,41,71,40,0,1
2069926,25,12,1988,6,"male",128,32,32,1,0,0,0,1,0
2069957,17,5,1996,10,"male",353,86,50,3,12,3,10,0,2
2069961,56,27,1957,3,"male",177,12,6,1,0,0,0,1,0
2069962,65,25,1948,4,"male",565,72,30,324,146,0,53,324,93
2069981,103,4,1910,7,"female",635,204,112,527,136,527,107,0,29
2069984,38,13,1975,1,"male",528,3,3,18,6,17,6,1,0
2069989,25,1,1988,1,"male",294,138,100,11,1,11,1,0,0
2070005,64,30,1949,8,"male",282,152,61,0,0,0,0,0,0
2070014,108,26,1905,7,"male",1894,1027,467,3,0,3,0,0,0
2070022,21,10,1992,10,"male",525,211,121,2,0,2,0,0,0
2070035,58,26,1955,4,"male",1656,94,33,3062,200,3057,58,5,142
2070040,21,3,1992,5,"female",614,130,67,74,98,18,27,56,71
2070041,26,14,1987,4,"male",432,35,35,7,1,7,1,0,0
2070072,38,28,1975,8,"female",264,11,9,1,2,0,0,1,2
2070074,28,3,1985,9,"female",713,172,127,7,20,7,15,0,5
2070096,37,1,1976,1,"male",93,1,1,0,0,0,0,0,0
2070116,21,14,1992,10,"female",420,345,271,4,0,4,0,0,0
2070194,103,17,1910,3,"female",1438,107,65,351,145,351,115,0,30
2070224,42,27,1971,10,"male",150,44,40,44,14,44,14,0,0
2070266,33,29,1980,6,"male",394,100,61,15,12,0,6,15,6
2070275,28,12,1985,12,"female",109,16,6,0,0,0,0,0,0
2070305,26,4,1987,7,"male",487,96,21,8,10,4,5,4,5
2070311,64,4,1949,10,"female",94,95,65,3,16,0,4,3,12
2070328,68,12,1945,2,"female",1743,53,31,16,10,0,7,16,3
2070356,28,21,1985,12,"female",847,753,464,2612,1272,908,476,1704,796
2070362,52,23,1961,6,"male",323,14,9,0,0,0,0,0,0
2070366,25,1,1988,6,"male",248,13,12,16,0,16,0,0,0
2070383,67,4,1946,8,"male",352,115,88,13,27,0,12,13,15
2070399,16,10,1997,8,"male",42,1,0,0,0,0,0,0,0
2070442,44,9,1969,9,"male",700,72,51,15,18,15,5,0,13
2070478,73,12,1940,10,"female",1779,93,32,3,45,0,8,3,37
2070500,27,30,1986,9,"male",353,38,35,11,6,0,5,11,1
2070537,22,19,1991,11,"female",1458,1120,515,208,1093,127,656,81,437
2070587,21,4,1992,6,"male",381,116,96,8,23,8,9,0,14
2070616,30,19,1983,6,"male",168,32,24,1,0,1,0,0,0
2070632,20,6,1993,5,"male",162,48,24,436,80,436,64,0,16
2070645,17,22,1996,3,"female",415,379,160,303,33,296,27,7,6
2070681,20,31,1993,8,"female",23,23,21,335,91,8,35,327,56
2070689,47,22,1966,5,"male",10,32,30,1,11,1,5,0,6
2070707,43,12,1970,8,"male",534,50,26,14,6,14,6,0,0
2070713,59,25,1954,12,"male",1169,138,97,0,14,0,9,0,5
2070723,21,19,1992,9,"female",520,72,12,1,1,1,1,0,0
2070732,17,29,1996,4,"male",592,49,24,2,2,0,0,2,2
2070761,36,28,1977,9,"female",817,106,39,196,201,196,115,0,86
2070802,52,3,1961,12,"female",601,69,54,15,18,0,2,15,16
2070838,67,24,1946,11,"female",312,27,16,0,4,0,4,0,0
2070855,16,12,1997,9,"male",632,207,89,14,4,0,1,14,3
2070976,63,21,1950,8,"female",1160,60,26,0,0,0,0,0,0
2070995,16,15,1997,12,"female",1007,817,447,318,510,109,194,209,316
2071007,35,2,1978,6,"female",224,106,58,379,182,379,174,0,8
2071009,20,1,1993,6,"male",207,52,45,0,0,0,0,0,0
2071017,55,5,1958,3,"male",186,25,23,1,3,0,0,1,3
2071046,56,9,1957,11,"female",1117,92,15,32,8,32,8,0,0
2071063,18,4,1995,10,"female",557,49,33,0,0,0,0,0,0
2071066,46,4,1967,6,"male",370,1,1,16,0,0,0,16,0
2071083,20,9,1993,11,"female",76,201,188,207,129,17,115,190,14
2071091,23,15,1990,1,"male",127,3,2,4,1,4,1,0,0
2071109,31,21,1982,10,"female",412,87,52,86,55,24,35,62,20
2071119,50,13,1963,12,"male",254,12,12,0,0,0,0,0,0
2071129,37,25,1976,9,"male",578,106,57,0,0,0,0,0,0
2071203,20,12,1993,2,"female",215,139,115,64,38,64,30,0,8
2071231,23,20,1990,10,"male",173,47,28,3,42,0,4,3,38
2071277,17,23,1996,3,"male",806,247,118,120,12,120,9,0,3
2071296,18,11,1995,6,"male",115,38,36,0,0,0,0,0,0
2071305,23,10,1990,11,"male",104,62,58,3,0,3,0,0,0
2071334,16,19,1997,9,"male",1433,542,100,2,30,2,22,0,8
2071353,27,8,1986,6,"female",65,43,23,25,5,24,5,1,0
2071364,33,19,1980,1,"male",286,144,122,0,2,0,2,0,0
2071367,18,12,1995,7,"male",853,837,259,49,57,4,11,45,46
2071402,35,8,1978,8,"female",371,105,35,317,416,317,192,0,224
2071415,59,19,1954,3,"female",227,76,64,29,8,25,4,4,4
2071485,52,25,1961,11,"male",256,53,25,4,2,0,0,4,2
2071486,35,21,1978,8,"female",33,28,19,2,15,2,6,0,9
2071539,31,1,1982,7,"male",473,106,35,53,2,53,2,0,0
2071552,59,15,1954,8,"female",267,5,3,0,1,0,1,0,0
2071568,49,21,1964,7,"male",843,100,69,62,4,61,2,1,2
2071592,48,16,1965,7,"female",347,26,21,300,53,300,41,0,12
2071610,67,19,1946,3,"female",493,18,13,4,2,0,0,4,2
2071623,16,30,1997,3,"male",389,348,206,6,9,3,0,3,9
2071627,20,31,1993,12,"male",250,212,126,22,6,22,5,0,1
2071643,21,15,1992,7,"male",76,49,46,32,13,32,9,0,4
2071644,29,27,1984,10,"male",505,3,3,4,0,0,0,4,0
2071658,108,26,1905,3,"male",1786,415,334,18,1,18,0,0,1
2071670,33,6,1980,8,"female",559,36,15,2,0,0,0,2,0
2071676,21,2,1992,9,"female",458,309,77,1,4,0,0,1,4
2071731,20,17,1993,11,"male",543,112,46,72,22,72,20,0,2
2071756,19,23,1994,7,"male",73,51,40,0,0,0,0,0,0
2071810,75,25,1938,6,"female",1701,48,11,0,0,0,0,0,0
2071826,46,15,1967,7,"male",199,2,1,0,0,0,0,0,0
2071857,29,16,1984,7,"female",92,314,111,3173,1669,3173,1579,0,90
2071889,18,19,1995,5,"male",272,21,6,8,0,0,0,8,0
2071901,27,24,1986,8,"male",675,47,45,1,1,1,1,0,0
2071942,21,1,1992,5,"male",616,168,94,2,16,2,11,0,5
2071964,19,25,1994,7,"female",1617,368,114,213,483,129,298,84,185
2071983,35,22,1978,11,"male",344,63,28,74,8,74,6,0,2
2071987,27,5,1986,3,"female",96,85,26,2587,1342,2587,1014,0,328
2071988,45,19,1968,7,"female",250,69,62,3,10,3,0,0,10
2071993,15,6,1998,7,"male",462,137,83,36,37,11,24,25,13
2071998,25,1,1988,1,"female",79,6,2,0,0,0,0,0,0
2072031,27,10,1986,3,"female",111,273,217,133,804,35,364,98,440
2072036,16,18,1997,5,"male",427,139,120,148,0,147,0,1,0
2072044,49,21,1964,8,"female",1338,237,57,73,128,67,81,6,47
2072050,42,23,1971,8,"male",1460,554,297,24,56,24,24,0,32
2072062,36,1,1977,2,"male",167,33,32,2,8,2,7,0,1
2072064,18,14,1995,11,"female",466,16,12,3,0,3,0,0,0
2072095,73,26,1940,9,"male",992,18,7,13,12,0,1,13,11
2072106,17,16,1996,10,"female",345,478,392,0,0,0,0,0,0
2072112,54,23,1959,4,"male",172,146,78,7745,193,7745,107,0,86
2072121,26,10,1987,9,"male",630,82,52,2,12,2,8,0,4
2072126,29,27,1984,9,"male",644,21,0,0,0,0,0,0,0
2072128,25,14,1988,8,"female",378,43,43,0,0,0,0,0,0
2072130,18,24,1995,7,"male",336,533,280,654,845,623,336,31,509
2072145,26,6,1987,4,"male",306,36,18,11,1,8,1,3,0
2072195,53,9,1960,7,"female",868,78,51,44,46,41,15,3,31
2072207,20,12,1993,11,"female",409,92,81,10,16,2,9,8,7
2072219,18,1,1995,1,"male",586,1354,1017,126,140,125,131,1,9
2072226,26,2,1987,1,"male",240,92,51,0,4,0,0,0,4
2072277,44,1,1969,6,"male",282,49,37,135,1,0,0,135,1
2072339,30,28,1983,6,"female",880,58,20,51,69,51,60,0,9
2072354,25,19,1988,11,"male",100,68,65,12,5,12,5,0,0
2072373,30,11,1983,8,"female",671,50,35,250,41,249,16,1,25
2072383,46,21,1967,4,"male",180,47,20,326,10,326,9,0,1
2072418,43,5,1970,3,"female",217,99,42,208,82,208,46,0,36
2072421,27,25,1986,2,"male",382,141,68,8,14,8,6,0,8
2072446,76,27,1937,2,"male",1663,11,6,58,29,9,5,49,24
2072450,22,8,1991,12,"female",461,23,6,182,9,182,5,0,4
2072451,40,19,1973,12,"female",235,76,29,348,330,348,116,0,214
2072468,70,15,1943,3,"male",1536,98,36,32,206,32,129,0,77
2072475,23,1,1990,1,"male",636,526,459,95,60,83,29,12,31
2072485,103,18,1910,11,"male",542,317,198,2,18,2,15,0,3
2072510,32,19,1981,7,"male",566,64,48,17,1,16,0,1,1
2072511,59,5,1954,10,"female",1843,84,36,65,43,62,32,3,11
2072513,39,5,1974,11,"male",470,2,2,0,0,0,0,0,0
2072607,17,19,1996,2,"female",482,109,101,0,0,0,0,0,0
2072616,22,26,1991,10,"male",239,38,20,0,0,0,0,0,0
2072631,53,1,1960,5,"male",655,129,56,32,193,32,172,0,21
2072632,36,15,1977,8,"male",449,2856,1674,1532,3658,16,732,1516,2926
2072651,37,23,1976,2,"male",65,0,0,0,0,0,0,0,0
2072664,37,10,1976,8,"female",785,131,89,20,8,16,5,4,3
2072681,35,31,1978,1,"male",601,199,169,0,1,0,0,0,1
2072687,32,10,1981,11,"male",886,207,5,5,5,0,2,5,3
2072696,33,23,1980,2,"female",647,124,62,38,23,7,15,31,8
2072699,25,4,1988,11,"female",65,79,68,19,24,19,24,0,0
2072710,33,8,1980,5,"female",340,99,72,104,121,103,77,1,44
2072745,26,27,1987,11,"male",68,16,3,6,17,6,16,0,1
2072761,53,31,1960,10,NA,1346,73,25,1808,1566,1734,679,74,887
2072786,24,7,1989,7,"male",968,67,27,0,0,0,0,0,0
2072855,47,14,1966,6,"female",675,88,68,1,5,0,4,1,1
2072867,28,5,1985,12,"female",420,78,54,0,0,0,0,0,0
2072899,55,9,1958,2,"female",262,27,15,21,87,0,58,21,29
2072917,64,6,1949,6,"male",1615,155,114,1244,319,344,46,900,273
2072960,14,30,1999,4,"female",443,825,635,35,17,32,12,3,5
2072979,27,19,1986,4,"male",288,2,2,13,6,13,6,0,0
2072984,103,14,1910,2,"female",519,99,43,22,11,22,11,0,0
2072985,31,22,1982,8,"male",756,60,28,2,1,1,1,1,0
2073019,52,27,1961,2,"female",188,6,2,37,32,0,0,37,32
2073046,15,28,1998,8,NA,213,116,35,3,1,2,0,1,1
2073054,28,24,1985,12,"male",1064,26,19,1,0,1,0,0,0
2073061,23,7,1990,10,"female",393,158,36,17,30,17,14,0,16
2073091,20,12,1993,12,"male",287,43,33,88,0,88,0,0,0
2073107,30,28,1983,1,"male",34,265,57,20,449,20,353,0,96
2073132,49,9,1964,12,"female",164,3,2,3,2,0,0,3,2
2073140,18,9,1995,9,"male",138,859,837,0,1,0,1,0,0
2073169,18,16,1995,1,"male",416,59,48,1,1,1,0,0,1
2073187,50,15,1963,9,"female",469,53,39,25,50,25,40,0,10
2073198,45,26,1968,10,"male",425,5,3,0,1,0,0,0,1
2073211,65,3,1948,11,"female",473,16,12,88,64,88,52,0,12
2073221,32,1,1981,5,"male",15,24,18,1475,74,1474,71,1,3
2073223,28,1,1985,12,"female",377,5,4,0,0,0,0,0,0
2073245,17,2,1996,2,"male",466,98,39,0,0,0,0,0,0
2073252,44,13,1969,7,"male",369,15,9,3,0,1,0,2,0
2073272,18,22,1995,10,"male",214,309,210,2,0,2,0,0,0
2073274,32,22,1981,3,"female",1149,105,43,562,282,562,195,0,87
2073295,21,4,1992,9,"male",197,8,7,3,2,3,2,0,0
2073301,33,5,1980,12,"male",134,13,12,18,1,18,1,0,0
2073313,31,2,1982,4,"female",278,181,131,108,68,107,55,1,13
2073320,22,14,1991,12,"male",22,43,41,13,17,12,3,1,14
2073322,16,28,1997,6,"female",268,81,39,21,0,0,0,21,0
2073392,15,15,1998,10,"male",226,389,350,4,5,0,4,4,1
2073407,75,28,1938,7,"female",629,20,11,0,1,0,1,0,0
2073421,27,28,1986,2,"male",265,45,24,3,5,3,5,0,0
2073435,31,2,1982,1,"male",293,61,34,190,14,190,11,0,3
2073438,51,8,1962,12,"female",929,94,56,1,10,0,6,1,4
2073449,27,22,1986,1,"female",502,53,23,104,38,85,16,19,22
2073450,52,3,1961,12,"female",1335,289,85,294,566,294,353,0,213
2073460,56,5,1957,6,"female",773,12,6,0,0,0,0,0,0
2073470,52,3,1961,2,"female",250,7,7,1,0,1,0,0,0
2073495,16,5,1997,7,"female",284,102,88,7,10,7,3,0,7
2073496,52,30,1961,4,"female",374,55,36,12,3,0,0,12,3
2073544,28,13,1985,2,"male",336,67,35,7,1,7,1,0,0
2073552,33,20,1980,8,"male",435,4,3,5,2,0,0,5,2
2073583,16,12,1997,4,"female",480,16,14,0,0,0,0,0,0
2073587,31,14,1982,7,"female",1550,828,161,488,253,488,166,0,87
2073598,94,30,1919,12,"male",259,10,6,3,0,0,0,3,0
2073643,21,24,1992,4,"male",583,798,506,129,47,129,23,0,24
2073683,21,1,1992,1,"male",351,6,6,0,0,0,0,0,0
2073695,46,18,1967,12,"female",1446,7,4,2,14,2,4,0,10
2073708,21,20,1992,3,"female",331,80,56,5,8,5,8,0,0
2073721,66,3,1947,8,"female",600,25,15,55,5,0,2,55,3
2073730,32,22,1981,6,"female",96,96,66,207,395,77,270,130,125
2073780,23,3,1990,6,"male",413,29,15,68,14,0,0,68,14
2073785,36,20,1977,11,"male",444,24,17,0,0,0,0,0,0
2073789,17,3,1996,10,"male",480,204,99,50,65,48,29,2,36
2073805,23,12,1990,12,"male",452,74,52,5,2,5,2,0,0
2073815,23,12,1990,3,"female",374,9,6,207,32,190,20,17,12
2073830,15,4,1998,3,"female",853,248,156,303,742,75,338,228,404
2073844,27,10,1986,12,"male",99,79,64,7,24,7,19,0,5
2073855,29,23,1984,11,"male",1016,172,111,91,26,91,25,0,1
2073911,18,7,1995,6,"male",180,209,172,22,7,22,6,0,1
2073944,28,1,1985,1,"female",87,9,1,0,0,0,0,0,0
2073957,16,19,1997,11,"male",397,199,136,135,67,3,31,132,36
2073990,17,4,1996,1,"male",207,237,159,1510,1429,1184,877,326,552
2074014,23,25,1990,9,"female",718,342,277,1968,1133,883,454,1085,679
2074021,100,15,1913,12,"female",1714,294,178,72,79,72,76,0,3
2074066,39,22,1974,10,"female",1381,294,132,197,145,15,62,182,83
2074069,108,11,1905,7,"male",1501,1039,525,20,257,2,53,18,204
2074079,33,26,1980,12,"male",1081,183,74,1,0,0,0,1,0
2074086,17,12,1996,9,"female",828,288,211,136,33,93,23,43,10
2074091,24,26,1989,8,"female",697,13,9,0,0,0,0,0,0
2074095,18,10,1995,12,"male",407,113,64,21,8,15,6,6,2
2074097,38,28,1975,9,"male",713,12,6,1,1,1,1,0,0
2074113,21,25,1992,1,"female",220,205,94,24,13,24,13,0,0
2074117,36,13,1977,12,"female",378,42,16,102,20,102,11,0,9
2074160,24,18,1989,12,"male",296,56,26,7,1,0,1,7,0
2074165,77,31,1936,3,"male",1203,432,329,4,22,4,12,0,10
2074170,94,23,1919,5,"female",484,833,509,534,353,420,122,114,231
2074178,100,14,1913,5,"male",2273,593,438,70,41,3,6,67,35
2074184,46,18,1967,3,"male",1353,74,22,0,0,0,0,0,0
2074191,21,12,1992,3,"male",204,75,44,1,3,0,2,1,1
2074209,21,1,1992,1,"male",611,78,63,8,1,8,0,0,1
2074210,25,1,1988,2,"female",139,13,13,15,5,0,3,15,2
2074240,63,8,1950,11,"male",46,7,7,1,5,0,1,1,4
2074243,36,18,1977,2,"female",265,64,32,65,25,60,23,5,2
2074245,23,12,1990,9,"female",504,48,31,73,22,73,17,0,5
2074271,89,12,1924,6,"female",1587,179,69,6,33,0,2,6,31
2074284,28,7,1985,6,"male",699,23,18,0,0,0,0,0,0
2074295,23,9,1990,12,"female",773,372,253,224,197,171,110,53,87
2074327,29,10,1984,6,"male",1515,665,501,21,301,19,220,2,81
2074333,32,7,1981,7,"male",522,28,27,0,0,0,0,0,0
2074336,84,22,1929,11,"female",598,908,623,3529,1539,2447,1221,1082,318
2074365,62,11,1951,7,"male",994,92,36,1,2,0,2,1,0
2074386,61,22,1952,5,"male",857,185,45,36,58,3,43,33,15
2074389,53,3,1960,6,"female",266,17,10,16,16,16,14,0,2
2074429,20,15,1993,10,"male",513,48,38,27,4,27,2,0,2
2074432,18,9,1995,8,"female",22,172,30,29,34,29,23,0,11
2074436,18,12,1995,9,"male",453,8,2,7,0,0,0,7,0
2074462,29,3,1984,12,"female",284,151,142,76,38,76,35,0,3
2074487,17,31,1996,5,"female",5,4,4,0,0,0,0,0,0
2074506,21,11,1992,11,"female",346,466,161,179,630,179,547,0,83
2074576,19,4,1994,4,"male",0,0,0,0,0,0,0,0,0
2074582,51,2,1962,11,"male",67,3,2,1,0,0,0,1,0
2074609,19,7,1994,11,"female",332,26,9,0,0,0,0,0,0
2074621,26,10,1987,8,"male",146,97,33,3,10,3,7,0,3
2074644,17,16,1996,10,"male",280,84,31,35,30,0,29,35,1
2074652,35,11,1978,12,"male",406,38,31,0,1,0,1,0,0
2074670,26,9,1987,10,"male",579,0,0,0,0,0,0,0,0
2074687,27,8,1986,11,"male",415,76,39,55,73,55,57,0,16
2074704,43,5,1970,3,"male",659,131,98,69,21,69,15,0,6
2074730,16,7,1997,2,"female",425,301,25,1,2,0,1,1,1
2074737,53,24,1960,2,"female",638,99,48,10,24,3,7,7,17
2074751,24,12,1989,12,"male",89,15,14,0,2,0,1,0,1
2074790,38,18,1975,7,"female",663,307,170,409,528,403,412,6,116
2074833,23,14,1990,10,"male",394,4,3,0,0,0,0,0,0
2074834,16,25,1997,3,"male",343,75,53,30,4,11,2,19,2
2074845,23,9,1990,6,"female",721,692,353,151,173,145,63,6,110
2074848,25,1,1988,1,"male",437,85,78,0,15,0,6,0,9
2074858,80,15,1933,6,"male",1185,16,4,0,0,0,0,0,0
2074885,26,27,1987,7,"female",321,46,33,5,25,5,22,0,3
2074907,34,1,1979,9,"male",325,1155,1023,88,39,38,20,50,19
2074916,21,27,1992,11,"male",473,290,193,12,0,1,0,11,0
2074920,68,6,1945,12,"female",283,34,32,1142,981,1,101,1141,880
2074955,18,25,1995,9,"female",219,163,90,194,191,124,94,70,97
2074964,38,6,1975,9,"male",731,32,10,33,3,33,3,0,0
2074994,24,17,1989,1,"male",1269,747,403,22,5,21,0,1,5
2075011,49,13,1964,4,"female",580,299,160,1753,450,0,174,1753,276
2075025,108,25,1905,9,"male",1279,130,83,31,40,10,32,21,8
2075049,108,1,1905,12,"male",80,82,57,61,55,0,37,61,18
2075054,47,11,1966,9,"female",260,46,29,5,0,5,0,0,0
2075067,48,16,1965,11,"male",272,54,31,1,3,1,3,0,0
2075111,93,15,1920,1,"female",1288,233,196,12,21,0,3,12,18
2075129,18,7,1995,4,"female",333,692,339,294,400,197,237,97,163
2075130,18,9,1995,9,"female",535,2597,1052,1927,3924,1911,3148,16,776
2075137,19,12,1994,2,"male",432,46,17,0,0,0,0,0,0
2075143,40,5,1973,6,"female",611,45,11,25,8,23,3,2,5
2075161,53,4,1960,4,"female",352,11,1,1,0,0,0,1,0
2075196,30,3,1983,1,"male",274,112,106,0,0,0,0,0,0
2075197,26,14,1987,8,"male",452,135,91,34,23,1,12,33,11
2075204,15,12,1998,12,"male",297,355,183,3,0,2,0,1,0
2075205,14,5,1999,11,"male",381,102,47,2,0,1,0,1,0
2075207,15,26,1998,5,"male",307,308,289,4,1,4,0,0,1
2075221,25,16,1988,3,"male",476,112,85,16,19,16,10,0,9
2075239,46,18,1967,8,"female",523,107,56,222,341,136,266,86,75
2075319,42,6,1971,6,"female",118,33,23,3,1,3,1,0,0
2075323,50,2,1963,2,"male",1112,12,8,1,3,0,2,1,1
2075345,22,17,1991,8,"male",572,195,116,13,4,13,2,0,2
2075353,71,17,1942,11,"male",1017,29,11,6,8,6,4,0,4
2075403,29,9,1984,8,"male",706,97,52,0,0,0,0,0,0
2075408,61,12,1952,11,"male",209,52,37,38,30,38,25,0,5
2075415,44,16,1969,3,"male",669,0,0,0,0,0,0,0,0
2075417,16,12,1997,8,"male",404,115,84,0,0,0,0,0,0
2075441,27,19,1986,8,"female",708,37,9,2,15,2,10,0,5
2075450,24,21,1989,9,"male",62,42,36,4,0,4,0,0,0
2075476,18,5,1995,7,"male",105,201,180,6,2,6,1,0,1
2075492,54,16,1959,8,"female",803,93,46,177,303,165,164,12,139
2075521,38,20,1975,7,"female",437,81,38,305,201,282,151,23,50
2075530,20,3,1993,1,"male",652,188,166,53,2,41,2,12,0
2075537,51,14,1962,1,"female",750,29,22,1,0,1,0,0,0
2075580,19,4,1994,6,"male",314,150,128,25,0,15,0,10,0
2075596,68,23,1945,8,"female",1018,64,26,235,76,87,43,148,33
2075609,44,20,1969,11,"female",117,5,4,7,29,7,16,0,13
2075630,34,16,1979,7,"female",457,87,38,1,3,1,3,0,0
2075661,21,1,1992,5,"female",726,332,193,0,0,0,0,0,0
2075662,18,22,1995,9,"male",739,89,61,2,84,0,11,2,73
2075667,103,18,1910,9,"male",560,351,197,97,157,69,64,28,93
2075693,25,5,1988,1,"male",8,25,19,131,253,131,245,0,8
2075742,25,12,1988,1,"male",11,5,5,2,0,2,0,0,0
2075779,61,10,1952,9,"male",440,25,18,1,9,0,5,1,4
2075812,61,13,1952,5,"female",506,55,14,0,0,0,0,0,0
2075815,27,11,1986,7,"female",249,27,1,2,4,2,3,0,1
2075816,45,19,1968,6,"female",545,46,30,22,4,22,2,0,2
2075828,20,11,1993,5,"male",52,111,107,2,1,2,1,0,0
2075845,37,24,1976,10,"male",905,71,40,57,38,28,18,29,20
2075862,25,1,1988,1,"female",269,22,13,20,1,2,0,18,1
2075881,35,1,1978,7,"female",300,145,58,0,17,0,2,0,15
2075884,64,13,1949,7,"female",1070,25,17,13,0,0,0,13,0
2075889,42,18,1971,8,"female",524,68,38,233,88,228,68,5,20
2075919,25,20,1988,2,"female",35,20,15,60,30,60,30,0,0
2075923,30,4,1983,12,"female",400,60,35,23,34,23,11,0,23
2075936,71,12,1942,5,"female",921,10,5,0,0,0,0,0,0
2075949,23,16,1990,1,"male",1790,1172,530,410,488,84,272,326,216
2075973,16,16,1997,2,"male",426,517,492,60,14,60,12,0,2
2075993,16,11,1997,9,"male",393,235,156,31,4,0,3,31,1
2076005,22,10,1991,1,"male",111,19,8,6,2,0,1,6,1
2076034,41,9,1972,11,"female",140,19,12,3,0,3,0,0,0
2076045,108,24,1905,11,"female",1019,216,79,14,0,14,0,0,0
2076052,17,8,1996,2,"female",434,225,149,2,1,2,1,0,0
2076063,62,19,1951,8,"male",158,34,14,12,38,0,24,12,14
2076114,72,1,1941,2,"male",222,76,49,10,13,10,10,0,3
2076119,47,6,1966,8,"female",1788,207,101,459,442,459,417,0,25
2076124,32,1,1981,2,"male",628,19,12,0,0,0,0,0,0
2076139,34,3,1979,2,"male",214,13,8,0,0,0,0,0,0
2076160,55,18,1958,6,"male",153,40,32,49,10,0,3,49,7
2076178,18,1,1995,9,"male",24,23,18,0,0,0,0,0,0
2076188,33,1,1980,3,"female",367,0,0,0,0,0,0,0,0
2076189,25,27,1988,10,"male",562,296,238,0,16,0,14,0,2
2076296,64,28,1949,5,"female",428,12,11,3,2,0,0,3,2
2076304,67,6,1946,12,"female",170,44,33,4,2,4,1,0,1
2076306,100,1,1913,12,"male",1671,72,26,20,22,20,19,0,3
2076337,26,10,1987,11,"female",864,267,100,139,186,2,60,137,126
2076346,23,16,1990,7,"female",234,383,114,150,112,150,107,0,5
2076394,26,10,1987,8,"female",347,0,0,0,0,0,0,0,0
2076403,39,25,1974,7,"male",273,0,0,0,0,0,0,0,0
2076512,17,10,1996,2,"female",327,245,152,4,11,4,2,0,9
2076514,63,11,1950,11,"male",494,54,39,64,65,0,18,64,47
2076531,16,15,1997,6,"male",214,237,123,25,37,19,20,6,17
2076537,17,11,1996,12,"male",235,29,8,38,14,38,11,0,3
2076563,43,6,1970,7,"male",343,85,56,0,2,0,2,0,0
2076602,27,11,1986,10,"female",140,58,39,11,21,11,13,0,8
2076611,21,13,1992,2,"female",425,68,42,469,276,469,190,0,86
2076617,16,31,1997,1,"female",348,10,7,5,1,5,1,0,0
2076636,19,16,1994,5,"female",311,16,7,9,2,9,1,0,1
2076681,33,20,1980,8,"male",224,72,72,16,0,16,0,0,0
2076729,31,2,1982,1,"male",165,64,47,0,1,0,1,0,0
2076788,25,19,1988,2,"male",469,21,6,2,1,2,1,0,0
2076809,15,2,1998,1,"male",674,347,268,5,36,5,24,0,12
2076813,22,28,1991,8,"male",274,219,183,212,144,212,64,0,80
2076824,31,2,1982,1,"male",674,30,12,6,10,6,10,0,0
2076859,15,1,1998,6,"male",219,49,15,0,0,0,0,0,0
2076862,63,4,1950,10,"male",748,20,10,2,6,2,6,0,0
2076863,17,21,1996,6,"female",528,466,370,129,98,129,66,0,32
2076874,13,24,2000,4,"male",130,75,47,346,6,339,5,7,1
2076878,44,27,1969,12,"female",282,39,36,27,11,27,10,0,1
2076926,103,29,1910,8,"male",1024,2236,1632,1296,220,0,70,1296,150
2076944,29,16,1984,8,"female",831,680,444,101,109,101,42,0,67
2076975,19,3,1994,10,"female",512,786,237,232,595,61,308,171,287
2076979,37,4,1976,12,"male",585,51,31,125,170,125,137,0,33
2076995,16,16,1997,11,"female",94,98,54,0,6,0,2,0,4
2077010,23,22,1990,9,"male",766,70,31,12,47,12,45,0,2
2077017,24,17,1989,12,"male",178,90,70,0,6,0,6,0,0
2077079,37,18,1976,9,"female",58,4,1,65,17,0,0,65,17
2077084,18,6,1995,1,"male",843,210,157,0,1,0,1,0,0
2077111,37,22,1976,4,"female",508,51,26,132,12,0,2,132,10
2077135,26,14,1987,8,"male",532,40,11,7,12,7,12,0,0
2077151,26,2,1987,12,"female",275,8,4,1,0,1,0,0,0
2077154,44,25,1969,5,"female",217,85,67,99,135,11,32,88,103
2077161,21,17,1992,10,"male",116,125,74,36,86,31,60,5,26
2077165,58,20,1955,3,"female",1588,141,22,90,40,0,13,90,27
2077168,69,1,1944,4,"male",1838,39,28,0,13,0,9,0,4
2077176,23,27,1990,5,"male",589,301,139,58,24,0,10,58,14
2077184,26,23,1987,10,"female",779,46,27,50,14,50,10,0,4
2077210,16,9,1997,5,"female",393,301,230,674,159,664,125,10,34
2077227,52,15,1961,12,"female",290,102,86,32,46,1,31,31,15
2077242,69,21,1944,5,"female",559,39,16,8,36,8,27,0,9
2077245,27,22,1986,6,"male",27,2,2,2,0,0,0,2,0
2077283,95,8,1918,1,"female",270,273,158,35,66,35,62,0,4
2077287,14,7,1999,4,"male",385,201,100,115,73,115,60,0,13
2077291,22,8,1991,5,"male",116,110,26,8,0,8,0,0,0
2077305,23,18,1990,2,"male",193,22,17,0,2,0,1,0,1
2077424,49,7,1964,4,"male",348,13,5,9,63,5,30,4,33
2077445,20,29,1993,12,"male",18,7,6,1,0,1,0,0,0
2077463,50,22,1963,8,"male",1343,127,78,2,45,2,23,0,22
2077467,28,13,1985,8,"female",11,12,8,2,1,2,1,0,0
2077511,25,18,1988,8,"male",361,58,50,2,53,0,12,2,41
2077565,73,10,1940,2,"male",257,9,9,54,6,54,4,0,2
2077566,40,15,1973,1,"female",449,51,34,53,22,24,13,29,9
2077587,19,3,1994,3,"male",569,59,23,132,6,127,4,5,2
2077644,29,14,1984,4,"male",898,25,23,0,1,0,1,0,0
2077702,20,8,1993,9,"male",310,269,231,31,31,31,24,0,7
2077765,57,16,1956,12,"female",712,116,73,127,33,127,28,0,5
2077767,44,19,1969,4,"female",1381,131,26,570,956,475,585,95,371
2077770,26,1,1987,1,"male",120,27,23,26,6,17,2,9,4
2077800,22,13,1991,2,"male",384,83,66,0,5,0,4,0,1
2077803,47,23,1966,1,"female",442,253,149,86,50,86,44,0,6
2077810,31,1,1982,1,"female",475,16,11,29,25,13,0,16,25
2077840,15,22,1998,3,"male",213,205,158,0,0,0,0,0,0
2077861,20,1,1993,12,"female",334,10,7,2,0,2,0,0,0
2077886,51,10,1962,12,"female",1993,99,40,104,64,82,31,22,33
2077890,28,21,1985,6,"male",299,11,6,14,1,14,0,0,1
2077899,55,26,1958,3,"male",958,214,67,33,18,0,1,33,17
2077904,16,5,1997,10,"male",320,7,5,0,0,0,0,0,0
2077972,58,23,1955,11,"female",1898,94,34,28,8,28,4,0,4
2077990,59,25,1954,4,"female",1164,37,9,10,2,5,2,5,0
2078009,25,12,1988,1,"male",57,72,66,58,215,58,186,0,29
2078056,68,1,1945,1,"male",1271,420,142,8,48,6,11,2,37
2078061,56,19,1957,12,"female",336,207,125,1,20,0,8,1,12
2078086,103,1,1910,4,"female",429,73,56,1,0,1,0,0,0
2078100,32,8,1981,10,"female",485,302,179,495,350,282,219,213,131
2078103,43,29,1970,3,"male",139,60,35,7,6,7,6,0,0
2078111,69,30,1944,8,"female",656,20,9,29,13,0,8,29,5
2078116,39,6,1974,6,"male",302,16,10,22,30,1,0,21,30
2078137,19,13,1994,9,"male",110,10,9,23,3,23,3,0,0
2078151,21,6,1992,5,"female",262,71,62,3,26,3,16,0,10
2078191,33,1,1980,1,"male",640,20,19,0,1,0,0,0,1
2078210,73,24,1940,6,"female",1976,42,22,0,0,0,0,0,0
2078211,55,9,1958,4,"male",222,955,12,3,20,0,5,3,15
2078221,18,6,1995,7,"male",22,4,4,1,0,1,0,0,0
2078240,45,5,1968,4,"male",764,78,31,1,0,1,0,0,0
2078245,23,22,1990,8,"male",124,33,30,4,8,4,4,0,4
2078259,37,18,1976,8,"male",546,45,32,30,8,30,7,0,1
2078276,21,31,1992,3,"female",827,533,311,2,2,2,2,0,0
2078301,23,22,1990,3,"female",263,31,17,5,3,5,3,0,0
2078322,52,16,1961,11,"female",767,2,1,2,0,2,0,0,0
2078386,25,10,1988,9,"male",51,9,2,1,0,1,0,0,0
2078421,22,4,1991,2,"male",480,413,369,2,1,0,1,2,0
2078442,15,19,1998,5,"female",56,0,0,0,0,0,0,0,0
2078448,52,9,1961,2,"female",236,129,73,198,119,0,51,198,68
2078516,15,13,1998,2,"female",257,369,163,324,105,324,103,0,2
2078531,72,17,1941,12,"male",1313,358,237,201,28,78,7,123,21
2078533,82,22,1931,5,"female",609,32,25,22,25,0,10,22,15
2078562,108,22,1905,12,"male",1031,190,93,4,8,4,8,0,0
2078566,16,13,1997,12,"female",124,38,26,0,1,0,1,0,0
2078617,69,18,1944,9,"female",2211,241,107,146,174,146,129,0,45
2078629,18,31,1995,7,"male",97,151,130,11,9,11,9,0,0
2078636,108,6,1905,10,"female",814,293,132,682,129,91,32,591,97
2078709,24,25,1989,8,"male",686,240,156,72,61,72,59,0,2
2078716,108,20,1905,1,"male",1519,701,299,11,3,0,0,11,3
2078722,19,27,1994,8,"female",16,65,41,0,0,0,0,0,0
2078725,18,8,1995,11,"male",898,256,96,15,17,15,4,0,13
2078741,61,25,1952,3,"female",742,91,53,138,83,138,33,0,50
2078757,31,28,1982,2,"female",256,11,11,42,5,13,2,29,3
2078767,37,9,1976,2,"male",788,15,9,1,5,0,2,1,3
2078797,26,6,1987,4,"female",340,272,157,426,205,426,164,0,41
2078804,15,26,1998,9,"male",318,115,85,0,25,0,25,0,0
2078805,28,17,1985,12,"male",774,33,32,1,1,0,1,1,0
2078830,39,9,1974,3,"female",70,49,41,218,154,218,102,0,52
2078840,25,1,1988,5,"male",89,2,2,0,0,0,0,0,0
2078844,51,9,1962,8,"female",580,142,112,96,3,0,0,96,3
2078853,27,2,1986,2,"male",250,3,0,0,0,0,0,0,0
2078889,68,22,1945,5,"male",1022,912,796,1177,85,1177,71,0,14
2078894,102,11,1911,7,"male",2165,28,8,0,0,0,0,0,0
2078921,66,26,1947,6,"male",1230,236,36,3,1,0,1,3,0
2078963,36,15,1977,8,"male",334,133,65,252,55,0,21,252,34
2079017,13,13,2000,3,"male",182,78,52,0,0,0,0,0,0
2079033,26,31,1987,12,"female",422,231,21,0,0,0,0,0,0
2079034,34,10,1979,8,"male",253,63,48,6,4,6,3,0,1
2079040,83,27,1930,5,"male",183,385,275,129,18,129,14,0,4
2079064,61,10,1952,5,"male",794,103,33,0,1,0,1,0,0
2079080,15,13,1998,5,"male",189,31,20,1,0,1,0,0,0
2079099,28,10,1985,5,"female",724,267,156,853,601,620,435,233,166
2079104,18,9,1995,12,"male",46,7,7,0,0,0,0,0,0
2079114,39,13,1974,10,"male",1910,131,89,13,14,13,11,0,3
2079129,40,25,1973,10,"male",74,0,0,0,0,0,0,0,0
2079142,74,31,1939,5,"female",1768,228,91,707,114,707,71,0,43
2079190,72,20,1941,1,"male",432,106,69,46,88,31,37,15,51
2079214,21,8,1992,11,"female",476,105,42,135,19,135,18,0,1
2079216,86,12,1927,10,"female",2315,382,180,383,231,350,195,33,36
2079236,52,6,1961,3,"male",276,62,54,18,0,7,0,11,0
2079274,60,23,1953,6,"female",355,115,80,102,44,102,21,0,23
2079279,30,5,1983,7,"male",312,119,95,0,0,0,0,0,0
2079300,16,13,1997,9,"male",54,163,153,0,0,0,0,0,0
2079335,18,2,1995,11,"male",113,24,22,35,4,35,1,0,3
2079341,17,16,1996,8,"male",769,103,53,10,484,0,25,10,459
2079345,53,6,1960,9,"female",653,169,148,329,67,329,46,0,21
2079370,53,27,1960,2,"female",30,10,7,264,13,192,0,72,13
2079377,19,12,1994,7,"male",302,3,2,0,0,0,0,0,0
2079383,60,9,1953,2,"female",1467,84,57,11,1,11,1,0,0
2079396,58,2,1955,11,"female",1382,48,17,149,193,149,134,0,59
2079405,58,2,1955,7,"female",275,77,61,1832,374,1832,85,0,289
2079430,28,1,1985,3,"female",199,60,8,25,1,25,1,0,0
2079450,33,21,1980,1,"male",415,152,107,3,0,3,0,0,0
2079455,15,26,1998,7,"female",265,213,120,41,7,41,7,0,0
2079461,21,16,1992,9,"male",10,4,4,3,3,3,3,0,0
2079466,26,2,1987,2,"female",243,68,47,90,82,90,39,0,43
2079469,22,12,1991,12,"female",140,16,15,1,3,1,3,0,0
2079485,58,19,1955,1,"female",650,186,102,21,9,6,4,15,5
2079509,23,10,1990,1,"male",294,65,38,287,172,287,142,0,30
2079523,25,23,1988,7,"male",29,29,23,11,5,11,4,0,1
2079539,21,15,1992,9,"female",840,388,219,328,185,303,101,25,84
2079547,42,20,1971,7,"female",675,39,16,304,28,304,25,0,3
2079563,17,12,1996,6,"male",832,691,575,67,88,51,68,16,20
2079630,96,8,1917,9,"male",1860,383,164,1,11,1,9,0,2
2079632,43,2,1970,11,"male",420,6,4,4,0,4,0,0,0
2079637,41,13,1972,10,"male",237,75,32,0,0,0,0,0,0
2079646,108,25,1905,7,"female",1341,239,128,59,57,0,8,59,49
2079668,15,14,1998,4,"male",851,83,22,3,0,3,0,0,0
2079677,41,1,1972,11,"female",225,204,134,733,1157,733,939,0,218
2079689,43,23,1970,7,"female",188,27,11,2,6,2,5,0,1
2079691,49,22,1964,11,"female",1390,67,34,5,3,0,0,5,3
2079715,18,22,1995,5,"female",367,5,4,4,29,4,8,0,21
2079756,31,20,1982,6,"female",92,25,13,565,5,565,5,0,0
2079778,22,3,1991,7,"female",584,116,9,21,12,21,12,0,0
2079783,17,11,1996,10,"male",470,784,664,72,51,72,50,0,1
2079785,15,25,1998,7,"male",410,19,12,1,0,0,0,1,0
2079786,44,29,1969,6,"female",656,2,1,144,108,125,62,19,46
2079822,14,30,1999,9,"female",181,237,108,2,1,2,0,0,1
2079848,16,2,1997,12,"male",587,410,315,9,1,0,0,9,1
2079859,17,19,1996,11,"male",152,55,33,1,1,1,1,0,0
2079885,28,6,1985,11,"male",177,33,25,1,1,1,1,0,0
2079909,24,5,1989,5,"male",507,100,66,0,0,0,0,0,0
2079911,18,2,1995,6,"female",269,38,22,23,2,0,0,23,2
2079926,80,15,1933,1,"male",1075,244,84,1,2,0,0,1,2
2079934,45,12,1968,7,"male",858,110,58,115,195,17,86,98,109
2079939,16,5,1997,6,"male",50,27,22,90,34,28,29,62,5
2079988,58,15,1955,4,"male",663,45,31,339,100,294,78,45,22
2080003,20,20,1993,8,"female",655,356,131,278,370,114,112,164,258
2080033,55,4,1958,4,"female",348,23,19,6,4,0,1,6,3
2080038,30,7,1983,11,"female",242,2,2,34,5,34,4,0,1
2080047,113,1,1900,3,"female",1639,74,5,46,60,0,15,46,45
2080067,34,18,1979,5,"male",16,23,22,0,0,0,0,0,0
2080116,30,15,1983,4,"male",987,124,67,35,32,35,17,0,15
2080126,22,1,1991,1,"male",15,6,6,2,0,2,0,0,0
2080147,19,9,1994,10,"male",546,1144,712,95,59,51,33,44,26
2080151,19,8,1994,4,"female",1119,606,384,553,410,167,111,386,299
2080192,33,28,1980,10,"male",205,209,80,195,39,150,8,45,31
2080233,60,3,1953,3,"male",159,38,11,21,1,21,1,0,0
2080235,56,28,1957,3,"female",1562,743,309,1319,1363,1319,714,0,649
2080241,44,1,1969,6,"female",847,79,57,28,11,26,9,2,2
2080257,16,20,1997,6,"female",780,1503,916,238,583,59,500,179,83
2080267,17,13,1996,10,"male",76,4,3,0,1,0,1,0,0
2080283,61,15,1952,7,"female",1060,16,7,4,2,0,2,4,0
2080292,34,26,1979,6,"female",440,2,2,0,0,0,0,0,0
2080366,16,17,1997,2,"male",72,106,76,8,0,8,0,0,0
2080380,16,19,1997,11,"female",696,2524,751,935,1490,189,467,746,1023
2080383,66,15,1947,10,"female",69,23,11,27,6,27,6,0,0
2080439,39,8,1974,12,"female",152,40,34,154,9,154,6,0,3
2080495,65,5,1948,2,"male",1567,191,88,18,39,14,9,4,30
2080502,18,27,1995,6,"female",383,418,304,169,13,27,7,142,6
2080505,19,10,1994,11,"female",836,4568,1738,3946,3794,2,2412,3944,1382
2080522,32,28,1981,3,"female",586,60,21,37,6,37,5,0,1
2080530,52,29,1961,6,"female",1097,127,82,214,66,214,40,0,26
2080536,103,31,1910,12,"male",1300,1744,937,4307,2860,4307,1970,0,890
2080550,25,30,1988,8,"male",346,253,240,157,116,157,106,0,10
2080613,18,9,1995,9,"male",157,91,82,3,20,3,18,0,2
2080618,15,21,1998,5,"female",96,25,15,25,8,25,4,0,4
2080620,16,1,1997,3,"male",19,60,43,1,0,1,0,0,0
2080634,20,13,1993,4,"female",394,46,35,5,18,5,10,0,8
2080648,19,29,1994,8,"male",193,992,893,920,2395,366,514,554,1881
2080677,20,6,1993,8,"male",1118,1799,1171,38,58,31,51,7,7
2080693,63,20,1950,1,"male",1426,152,57,54,11,54,7,0,4
2080720,15,2,1998,5,"male",347,0,0,0,0,0,0,0,0
2080786,23,12,1990,11,"female",545,205,163,12,41,12,34,0,7
2080791,36,3,1977,1,"male",202,39,36,1,0,1,0,0,0
2080823,68,14,1945,10,"female",852,33,23,17,22,0,6,17,16
2080835,29,19,1984,5,"male",544,64,39,3,1,0,0,3,1
2080839,17,16,1996,9,"male",430,286,223,24,2,1,1,23,1
2080855,43,19,1970,5,"female",543,74,69,39,8,39,6,0,2
2080872,36,2,1977,8,"male",472,23,21,0,0,0,0,0,0
2080877,16,1,1997,1,"male",218,76,48,0,1,0,1,0,0
2080891,23,20,1990,6,"female",206,700,321,187,383,137,259,50,124
2080906,29,28,1984,2,"male",348,83,65,2,13,2,12,0,1
2080909,24,29,1989,8,"male",459,1,1,0,1,0,0,0,1
2080924,44,4,1969,4,"female",1577,50,26,499,196,483,144,16,52
2080950,51,9,1962,6,"female",1201,17,8,0,0,0,0,0,0
2080963,30,12,1983,8,"male",710,333,189,105,73,47,21,58,52
2081025,15,28,1998,7,"male",447,26,7,0,2,0,1,0,1
2081049,16,3,1997,9,"female",739,900,603,0,5,0,3,0,2
2081090,20,15,1993,11,"female",37,9,5,4,0,4,0,0,0
2081096,35,30,1978,12,"male",440,92,75,3,0,3,0,0,0
2081137,15,11,1998,11,"female",489,204,127,577,206,302,96,275,110
2081166,26,9,1987,2,"female",616,260,189,0,0,0,0,0,0
2081170,17,12,1996,1,"male",93,28,1,1,0,1,0,0,0
2081186,32,9,1981,6,"female",512,27,19,36,15,36,6,0,9
2081206,47,1,1966,2,"male",546,164,147,346,1,346,1,0,0
2081250,43,21,1970,1,"female",874,143,96,200,28,200,10,0,18
2081262,22,5,1991,7,"female",425,476,135,23,119,23,110,0,9
2081266,43,30,1970,5,"male",341,0,0,0,0,0,0,0,0
2081278,20,21,1993,4,"female",449,6,1,0,0,0,0,0,0
2081281,17,3,1996,9,"female",617,202,144,312,326,220,105,92,221
2081306,53,8,1960,3,"female",412,216,164,225,134,193,71,32,63
2081336,41,1,1972,10,"male",285,18,18,3,1,3,0,0,1
2081338,23,5,1990,1,"female",70,56,27,1,2,1,2,0,0
2081342,33,1,1980,1,"male",155,78,73,1,0,1,0,0,0
2081346,27,3,1986,6,"female",436,235,118,414,313,311,149,103,164
2081360,20,25,1993,12,"female",694,204,118,137,72,73,61,64,11
2081361,32,1,1981,1,"female",200,74,23,14,25,14,12,0,13
2081378,68,25,1945,4,"female",264,415,316,112,484,112,430,0,54
2081383,16,9,1997,4,"female",112,310,186,417,337,417,142,0,195
2081400,21,1,1992,4,"male",419,326,207,7,12,6,10,1,2
2081409,62,1,1951,7,"male",565,33,16,0,0,0,0,0,0
2081416,56,1,1957,5,"male",75,2,2,26,2,0,1,26,1
2081434,27,24,1986,6,"female",546,150,84,44,110,43,30,1,80
2081438,19,30,1994,12,"male",465,210,136,0,3,0,1,0,2
2081445,16,24,1997,5,"male",293,53,28,2,0,0,0,2,0
2081466,20,25,1993,11,"male",312,50,32,7,47,7,43,0,4
2081468,20,25,1993,8,"female",59,5,0,0,0,0,0,0,0
2081469,20,2,1993,4,"female",151,59,46,434,756,271,249,163,507
2081528,23,3,1990,2,"male",574,453,362,0,18,0,5,0,13
2081538,45,12,1968,3,"male",577,26,23,31,1,31,1,0,0
2081591,42,8,1971,9,"male",913,150,93,21,82,21,31,0,51
2081593,28,23,1985,6,"male",2,14,14,3,0,3,0,0,0
2081629,22,16,1991,6,"male",602,208,114,4,1,4,0,0,1
2081638,23,28,1990,2,"male",61,2,1,6,7,0,3,6,4
2081649,26,1,1987,8,"male",162,125,97,0,0,0,0,0,0
2081665,17,11,1996,12,"male",465,178,7,1,0,1,0,0,0
2081690,18,5,1995,4,"male",169,175,158,0,5,0,1,0,4
2081696,14,25,1999,9,"male",370,120,78,10,5,0,0,10,5
2081726,71,26,1942,7,"female",84,61,47,9,7,9,5,0,2
2081742,46,30,1967,12,"male",367,6,5,8,7,8,6,0,1
2081780,29,16,1984,11,"male",614,25,15,10,12,7,9,3,3
2081785,21,11,1992,4,"male",253,11,9,5,0,5,0,0,0
2081803,22,5,1991,5,"male",872,72,58,11,2,9,2,2,0
2081806,61,24,1952,1,"male",180,170,151,454,783,0,87,454,696
2081850,57,23,1956,10,"female",2112,69,38,175,122,22,32,153,90
2081890,65,29,1948,5,"female",698,142,67,158,272,0,45,158,227
2081913,18,26,1995,7,"female",132,386,306,660,384,660,344,0,40
2081943,68,4,1945,4,"female",541,2118,341,3996,18089,3505,11887,491,6202
2081983,48,2,1965,12,"male",519,29,17,6,0,0,0,6,0
2081991,37,26,1976,5,"female",381,28,22,15,0,0,0,15,0
2082015,17,9,1996,9,"female",301,71,41,1,65,1,27,0,38
2082026,17,10,1996,12,"female",443,14,10,44,30,44,26,0,4
2082063,63,7,1950,1,"female",661,12,6,21,18,0,4,21,14
2082096,21,30,1992,5,"female",317,88,55,24,20,0,4,24,16
2082102,21,29,1992,5,"female",461,74,44,78,1,78,1,0,0
2082115,23,20,1990,1,"male",634,348,282,42,25,42,20,0,5
2082116,54,16,1959,2,"female",642,44,34,1,6,0,2,1,4
2082123,27,17,1986,2,"male",260,40,21,3,21,0,17,3,4
2082129,47,23,1966,11,"female",2401,183,102,678,228,649,100,29,128
2082131,17,30,1996,9,"male",121,136,97,0,2,0,2,0,0
2082139,56,23,1957,6,"female",372,139,65,79,108,0,15,79,93
2082155,20,21,1993,7,"female",745,168,73,37,79,36,55,1,24
2082217,45,10,1968,7,"male",145,36,34,0,4,0,1,0,3
2082226,61,9,1952,10,"female",161,29,17,8,6,0,1,8,5
2082228,23,1,1990,1,"male",131,150,118,71,17,71,17,0,0
2082232,47,1,1966,9,"male",497,68,46,797,161,797,141,0,20
2082266,48,14,1965,10,"male",1102,22,9,0,2,0,2,0,0
2082301,27,10,1986,6,"male",616,77,38,71,5,71,4,0,1
2082337,20,30,1993,12,"female",301,259,78,8,33,8,18,0,15
2082338,28,10,1985,3,"male",593,193,130,9,5,5,2,4,3
2082361,36,29,1977,7,"female",415,1,1,0,0,0,0,0,0
2082469,61,24,1952,8,"female",614,18,6,9,0,0,0,9,0
2082471,23,8,1990,4,"male",75,148,145,7,4,7,3,0,1
2082473,22,12,1991,1,"male",27,36,36,0,1,0,1,0,0
2082510,20,22,1993,3,"female",649,83,14,0,13,0,6,0,7
2082520,20,9,1993,4,"male",410,75,42,1,0,1,0,0,0
2082555,15,29,1998,4,"male",453,172,123,1,3,1,1,0,2
2082584,15,31,1998,12,"male",620,149,101,11,0,10,0,1,0
2082658,36,19,1977,12,"female",487,72,37,162,0,162,0,0,0
2082663,20,8,1993,1,"female",285,98,48,1,4,1,4,0,0
2082683,14,1,1999,4,"female",191,513,130,86,199,43,171,43,28
2082729,28,2,1985,9,"male",614,135,103,87,1,67,1,20,0
2082731,58,2,1955,2,NA,1822,19,10,17,32,17,28,0,4
2082764,94,19,1919,3,"male",1487,197,116,1,0,1,0,0,0
2082776,28,14,1985,12,"male",441,106,92,0,6,0,6,0,0
2082795,17,25,1996,11,"female",625,1081,307,791,1185,699,599,92,586
2082831,27,10,1986,10,"female",229,25,8,2,7,2,6,0,1
2082832,16,16,1997,10,"female",283,756,228,16,24,16,15,0,9
2082838,60,22,1953,4,"male",678,218,182,31,18,28,10,3,8
2082950,30,1,1983,10,"female",274,0,0,0,1,0,0,0,1
2083007,65,31,1948,8,"female",91,56,55,9,4,0,3,9,1
2083014,15,2,1998,12,"male",319,129,10,3,1,3,1,0,0
2083015,61,28,1952,2,"male",599,11,6,0,0,0,0,0,0
2083032,46,10,1967,1,"male",1533,37,25,2,0,2,0,0,0
2083040,15,16,1998,10,"female",613,1118,308,228,349,51,164,177,185
2083042,52,13,1961,8,"female",1957,3970,1245,1201,2696,625,1215,576,1481
2083050,30,21,1983,1,"male",521,166,102,71,86,71,55,0,31
2083053,21,27,1992,11,"male",416,27,15,0,0,0,0,0,0
2083058,60,8,1953,9,"male",1439,7,5,0,3,0,0,0,3
2083074,20,15,1993,10,"male",9,10,10,134,9,121,7,13,2
2083115,52,10,1961,2,"male",544,111,45,3,0,0,0,3,0
2083123,18,23,1995,1,"female",396,129,113,476,380,211,210,265,170
2083125,42,4,1971,10,"female",103,762,646,243,201,95,82,148,119
2083126,22,17,1991,10,"male",312,300,217,548,643,500,486,48,157
2083131,21,26,1992,10,"female",120,5,5,0,0,0,0,0,0
2083138,22,1,1991,1,"male",204,91,87,0,0,0,0,0,0
2083169,58,26,1955,9,"male",639,9,5,0,2,0,1,0,1
2083182,27,23,1986,3,"male",553,145,33,0,10,0,3,0,7
2083195,19,1,1994,2,"male",522,452,386,228,193,228,179,0,14
2083234,14,11,1999,6,"female",383,226,133,219,0,200,0,19,0
2083239,42,4,1971,4,"male",486,11,6,1,0,1,0,0,0
2083258,20,1,1993,5,"female",181,11,5,1,2,0,0,1,2
2083280,61,28,1952,12,"male",621,86,64,13,3,0,0,13,3
2083294,41,28,1972,8,"female",212,264,158,57,272,44,100,13,172
2083304,24,3,1989,1,"male",57,7,7,0,0,0,0,0,0
2083408,43,30,1970,5,"female",157,109,75,1273,89,174,27,1099,62
2083416,39,20,1974,9,"male",616,2028,351,221,1087,143,357,78,730
2083419,25,19,1988,3,"male",211,12,4,3,0,3,0,0,0
2083427,14,31,1999,3,"female",491,164,78,3,2,2,2,1,0
2083457,60,17,1953,5,"male",304,31,26,2,1,0,0,2,1
2083493,55,25,1958,12,"female",492,105,63,1,4,0,0,1,4
2083573,21,5,1992,9,"male",347,160,76,33,97,33,93,0,4
2083581,47,15,1966,2,"female",1280,53,31,65,134,64,60,1,74
2083586,19,18,1994,11,"male",765,112,46,2,0,0,0,2,0
2083599,22,26,1991,12,"male",396,58,47,4,1,0,1,4,0
2083603,108,9,1905,4,"male",1316,806,560,1138,163,1138,141,0,22
2083628,45,5,1968,10,"female",613,294,227,145,29,145,22,0,7
2083676,51,25,1962,2,"male",572,29,15,17,5,0,0,17,5
2083706,14,3,1999,10,"female",336,3426,1073,405,762,405,671,0,91
2083708,38,22,1975,2,"female",240,119,74,2681,4648,271,1045,2410,3603
2083710,38,23,1975,12,"male",642,104,75,0,2,0,1,0,1
2083726,43,10,1970,3,"male",48,23,21,247,1,247,0,0,1
2083737,76,18,1937,2,"female",706,430,354,818,487,131,272,687,215
2083777,18,16,1995,12,"male",343,12,6,0,0,0,0,0,0
2083778,57,25,1956,2,"female",430,49,37,62,9,0,5,62,4
2083798,14,7,1999,1,"male",380,19,3,2,30,0,17,2,13
2083808,23,26,1990,9,"male",175,89,23,54,68,53,7,1,61
2083814,22,10,1991,10,"male",787,102,61,1,0,0,0,1,0
2083820,16,4,1997,9,"female",81,13,12,80,97,80,65,0,32
2083884,15,21,1998,3,"male",258,48,13,33,0,33,0,0,0
2083890,57,27,1956,4,"male",1477,82,55,20,62,13,34,7,28
2083916,19,11,1994,5,"male",446,299,203,131,97,26,75,105,22
2083931,50,18,1963,10,"female",159,44,36,19,38,19,30,0,8
2083942,21,29,1992,2,"male",335,24,17,78,34,62,14,16,20
2083960,18,12,1995,9,"male",143,51,37,0,4,0,4,0,0
2083965,57,5,1956,11,"male",299,27,9,11,0,11,0,0,0
2084023,13,24,2000,4,"male",152,28,28,0,0,0,0,0,0
2084032,22,2,1991,7,"male",218,227,195,4,8,0,1,4,7
2084049,61,15,1952,12,"female",133,142,124,80,94,80,53,0,41
2084050,26,8,1987,4,"male",142,45,38,251,384,246,284,5,100
2084052,15,16,1998,6,"female",423,1665,603,298,95,298,68,0,27
2084059,23,15,1990,2,"male",392,242,182,0,0,0,0,0,0
2084072,48,19,1965,11,"male",213,0,0,0,0,0,0,0,0
2084087,54,4,1959,2,"male",1261,57,20,10,14,10,10,0,4
2084125,30,13,1983,2,"female",509,53,24,50,74,50,67,0,7
2084139,21,6,1992,10,"female",407,226,78,2,5,2,4,0,1
2084141,15,10,1998,4,"male",127,82,75,0,124,0,19,0,105
2084144,48,21,1965,5,"male",690,366,307,77,403,8,164,69,239
2084153,113,8,1900,12,"male",1415,174,111,0,0,0,0,0,0
2084154,68,7,1945,8,"male",951,678,443,0,1,0,0,0,1
2084178,17,1,1996,1,"male",14,16,10,5,2,5,1,0,1
2084179,23,18,1990,6,"male",474,31,8,0,3,0,3,0,0
2084212,41,13,1972,5,"male",459,4,2,5,12,5,12,0,0
2084215,19,9,1994,10,"male",238,389,347,781,69,781,48,0,21
2084247,40,21,1973,2,"female",539,1,0,0,0,0,0,0,0
2084257,23,10,1990,10,"female",1116,650,448,36,12,15,4,21,8
2084269,39,1,1974,11,"male",492,20,15,1,3,1,3,0,0
2084320,19,31,1994,8,"female",461,523,371,112,477,112,436,0,41
2084324,21,20,1992,7,"male",145,276,252,49,30,49,16,0,14
2084327,14,7,1999,11,"male",70,44,22,4,4,4,3,0,1
2084334,24,4,1989,9,"female",244,198,48,123,40,123,21,0,19
2084349,37,7,1976,8,"male",104,168,168,70,2,70,2,0,0
2084360,26,28,1987,2,"female",813,65,47,0,0,0,0,0,0
2084404,37,10,1976,6,"female",178,163,131,763,477,763,283,0,194
2084417,26,16,1987,11,"male",402,7,5,0,0,0,0,0,0
2084432,28,20,1985,1,"male",160,297,165,50,8,50,6,0,2
2084445,25,1,1988,1,"male",401,4,4,0,0,0,0,0,0
2084491,19,16,1994,8,"female",15,1038,264,380,671,366,481,14,190
2084500,29,3,1984,11,"female",573,4,1,92,14,92,2,0,12
2084503,22,1,1991,1,"male",62,20,13,0,7,0,1,0,6
2084512,22,8,1991,7,"male",51,155,135,74,94,74,47,0,47
2084521,103,10,1910,5,"male",1227,419,217,18,43,4,21,14,22
2084525,108,28,1905,9,"female",95,436,151,214,439,3,384,211,55
2084540,23,2,1990,7,"female",400,45,30,59,34,0,19,59,15
2084554,32,3,1981,10,"female",169,116,103,0,0,0,0,0,0
2084565,25,1,1988,11,"male",577,5,3,2,0,2,0,0,0
2084572,55,21,1958,9,"male",797,177,80,96,88,96,81,0,7
2084591,62,7,1951,8,"male",717,142,38,29,18,7,11,22,7
2084611,18,3,1995,9,"female",437,652,356,3518,1631,3517,1051,1,580
2084626,18,1,1995,1,"female",63,34,28,352,30,352,28,0,2
2084628,22,24,1991,9,"female",398,1,1,2,2,2,2,0,0
2084645,14,1,1999,12,"male",225,488,310,57,46,16,30,41,16
2084656,24,27,1989,10,"female",476,50,1,0,0,0,0,0,0
2084664,14,13,1999,5,"female",137,771,681,85,198,85,129,0,69
2084671,42,29,1971,9,"male",1058,128,72,3,4,1,2,2,2
2084694,24,27,1989,4,"male",387,35,19,19,24,19,20,0,4
2084728,20,28,1993,3,"male",562,247,77,43,1,0,0,43,1
2084746,57,10,1956,7,"female",1184,83,62,15,6,15,3,0,3
2084758,19,3,1994,5,"male",66,1781,963,500,785,500,644,0,141
2084761,28,14,1985,2,"male",185,92,78,3,7,3,2,0,5
2084772,30,6,1983,10,"female",774,231,31,19,166,19,120,0,46
2084821,21,9,1992,9,"male",379,69,43,38,16,1,4,37,12
2084845,18,26,1995,7,"female",265,788,459,143,54,143,43,0,11
2084905,34,1,1979,1,"female",214,50,32,515,700,0,57,515,643
2084943,23,1,1990,1,"male",827,12,6,6,1,6,1,0,0
2084958,79,17,1934,1,"female",49,45,40,0,0,0,0,0,0
2084974,97,15,1916,12,"female",1819,570,216,3,5,0,2,3,3
2084975,24,16,1989,5,"female",34,7,7,10,21,10,21,0,0
2084981,43,27,1970,8,"male",498,0,0,0,0,0,0,0,0
2085025,32,28,1981,1,"female",235,307,204,162,67,3,5,159,62
2085034,57,13,1956,8,"male",1532,46,18,1,31,1,30,0,1
2085065,96,13,1917,12,"male",1167,206,115,47,163,47,139,0,24
2085123,54,25,1959,8,"female",299,76,63,508,259,508,181,0,78
2085156,18,14,1995,3,"female",363,56,47,642,420,620,346,22,74
2085200,61,24,1952,6,"female",136,15,14,10,2,10,1,0,1
2085211,34,2,1979,12,"female",1928,191,138,153,286,78,102,75,184
2085222,69,8,1944,1,"male",1683,41,12,16,17,0,8,16,9
2085228,83,10,1930,7,"male",744,179,159,7,2,7,2,0,0
2085229,33,22,1980,10,"male",283,197,125,8,7,6,1,2,6
2085236,16,6,1997,1,"male",13,24,3,8,10,3,1,5,9
2085254,23,17,1990,2,"female",120,42,38,9,10,0,1,9,9
2085256,35,28,1978,6,"female",257,36,33,2,0,0,0,2,0
2085281,18,22,1995,12,"female",241,67,49,0,0,0,0,0,0
2085298,72,9,1941,9,"female",1157,44,33,1,2,0,0,1,2
2085311,49,15,1964,8,"male",513,2,2,0,0,0,0,0,0
2085327,48,12,1965,5,"male",221,60,53,79,46,79,29,0,17
2085355,19,1,1994,1,"male",171,262,215,0,0,0,0,0,0
2085371,34,28,1979,11,"male",88,19,14,0,1,0,0,0,1
2085409,18,5,1995,4,"female",44,11,8,0,1,0,1,0,0
2085432,14,12,1999,8,"male",297,115,104,8,5,8,3,0,2
2085443,47,19,1966,5,"female",1531,181,97,96,124,86,87,10,37
2085463,21,1,1992,1,"female",655,1279,805,136,470,136,429,0,41
2085474,35,21,1978,10,"male",624,178,118,32,50,2,12,30,38
2085490,66,18,1947,7,"female",472,18,12,0,5,0,2,0,3
2085494,15,5,1998,6,"female",429,237,116,17,2,13,1,4,1
2085506,15,9,1998,6,"female",82,154,67,72,67,72,13,0,54
2085520,18,1,1995,12,"female",39,217,75,101,452,35,292,66,160
2085521,24,30,1989,4,"female",1663,2039,1100,1390,1546,932,1296,458,250
2085535,32,26,1981,3,"female",194,344,263,327,564,327,427,0,137
2085536,20,13,1993,2,"male",173,31,29,5,1,5,1,0,0
2085563,18,27,1995,11,"male",123,675,658,43,11,41,8,2,3
2085591,18,27,1995,5,"male",247,477,364,235,55,201,35,34,20
2085618,20,27,1993,8,"male",555,360,106,2,43,2,42,0,1
2085643,21,1,1992,10,"female",254,149,62,312,371,209,223,103,148
2085679,25,2,1988,6,"female",1887,306,167,389,238,71,117,318,121
2085682,24,8,1989,11,"male",118,55,47,3,14,0,10,3,4
2085703,14,19,1999,6,"male",73,32,26,3,0,3,0,0,0
2085710,18,1,1995,9,"male",110,15,7,0,3,0,3,0,0
2085716,19,5,1994,7,"male",459,2,2,0,0,0,0,0,0
2085733,18,7,1995,3,"male",329,232,183,38,11,23,7,15,4
2085766,15,28,1998,12,"female",497,501,366,58,196,45,87,13,109
2085785,39,28,1974,5,"male",355,34,21,0,0,0,0,0,0
2085798,21,25,1992,7,"female",629,3019,440,3,303,3,211,0,92
2085815,65,22,1948,10,"female",292,32,22,0,0,0,0,0,0
2085835,24,7,1989,1,"male",96,81,64,0,1,0,1,0,0
2085836,21,6,1992,11,"female",227,97,89,119,6,10,0,109,6
2085839,58,19,1955,5,"male",439,105,33,327,371,327,247,0,124
2085845,54,7,1959,8,"female",1496,23,12,28,2,5,0,23,2
2085848,14,10,1999,2,"female",202,1,1,41,1,0,0,41,1
2085862,20,16,1993,9,"female",660,739,353,11,57,11,27,0,30
2085866,37,28,1976,8,"male",1328,269,51,2,0,0,0,2,0
2085909,21,17,1992,7,"female",632,601,394,538,419,537,380,1,39
2085910,18,12,1995,8,"female",884,50,5,11,0,2,0,9,0
2085914,26,8,1987,8,"male",53,14,12,7,0,0,0,7,0
2085916,63,15,1950,2,"female",35,36,11,0,0,0,0,0,0
2085921,27,10,1986,10,"female",281,31,14,1,6,1,6,0,0
2086005,16,24,1997,9,"male",5,72,62,41,55,2,10,39,45
2086028,22,26,1991,3,"female",412,9,2,0,0,0,0,0,0
2086033,19,31,1994,8,"male",300,44,18,5,0,4,0,1,0
2086049,16,28,1997,5,"female",1135,1535,364,2203,3048,1901,2733,302,315
2086050,19,15,1994,3,"male",118,199,149,1222,509,513,272,709,237
2086071,59,3,1954,1,"female",943,114,52,294,178,0,17,294,161
2086236,17,1,1996,1,"female",882,3357,978,177,314,119,211,58,103
2086245,19,29,1994,12,"male",402,314,227,0,1,0,1,0,0
2086253,29,6,1984,5,"male",293,126,108,227,165,227,98,0,67
2086265,39,11,1974,4,"male",577,174,94,127,411,82,150,45,261
2086288,23,22,1990,2,"male",300,168,140,32,25,32,21,0,4
2086300,41,20,1972,4,"male",605,93,68,0,0,0,0,0,0
2086331,22,1,1991,1,"male",31,43,38,36,10,36,10,0,0
2086341,28,2,1985,12,"male",406,225,73,17,4,0,1,17,3
2086349,38,8,1975,2,"male",49,0,0,0,0,0,0,0,0
2086393,30,24,1983,5,"female",275,42,22,329,93,329,76,0,17
2086405,62,18,1951,4,"male",1438,208,96,303,436,131,176,172,260
2086406,59,25,1954,5,"female",1089,17,3,4,22,0,11,4,11
2086407,22,6,1991,11,"male",124,123,114,29,29,29,28,0,1
2086415,33,3,1980,7,"female",391,1,0,0,0,0,0,0,0
2086495,51,22,1962,6,"female",657,27,22,12,3,12,2,0,1
2086510,33,16,1980,7,"male",416,52,29,0,0,0,0,0,0
2086554,23,21,1990,5,"female",370,1,1,0,0,0,0,0,0
2086569,53,3,1960,11,"male",781,104,89,12,0,0,0,12,0
2086571,26,25,1987,5,"male",19,23,22,5,4,5,2,0,2
2086585,20,31,1993,8,"male",524,101,65,28,12,26,6,2,6
2086588,43,26,1970,8,"male",530,42,32,54,0,17,0,37,0
2086589,20,1,1993,1,"male",322,60,22,2,20,2,8,0,12
2086593,103,10,1910,10,"male",389,983,738,9,84,0,70,9,14
2086598,42,28,1971,6,"female",185,119,44,67,109,67,96,0,13
2086619,21,9,1992,6,"male",983,107,83,0,0,0,0,0,0
2086621,59,3,1954,6,"female",654,62,34,71,20,71,19,0,1
2086626,76,16,1937,1,"male",146,15,12,11,1,11,1,0,0
2086629,39,25,1974,8,"female",245,64,38,34,28,34,21,0,7
2086649,23,1,1990,1,"male",415,100,44,4463,20,4334,19,129,1
2086652,43,9,1970,2,"male",685,218,182,27,46,26,29,1,17
2086679,16,26,1997,10,"male",90,84,30,5,4,0,2,5,2
2086698,18,20,1995,12,"female",152,88,53,70,12,70,6,0,6
2086711,49,16,1964,12,"male",2048,61,10,5,0,1,0,4,0
2086749,99,19,1914,6,"female",2003,346,143,2,45,0,16,2,29
2086809,55,6,1958,4,"male",2017,131,63,6,64,6,19,0,45
2086813,44,25,1969,11,"female",1126,149,90,896,350,896,274,0,76
2086824,56,18,1957,2,"female",1406,177,50,214,625,214,255,0,370
2086829,23,13,1990,4,"female",356,3,3,1,0,1,0,0,0
2086837,20,14,1993,2,"male",1081,232,200,33,1,33,1,0,0
2086863,71,29,1942,12,"male",1409,50,33,9,2,0,0,9,2
2086872,14,15,1999,11,"female",247,236,161,0,0,0,0,0,0
2086893,25,4,1988,1,"male",679,5,4,1,1,1,0,0,1
2086897,31,15,1982,6,"male",168,26,21,0,0,0,0,0,0
2086919,34,15,1979,12,"female",483,30,13,97,96,97,61,0,35
2086927,19,18,1994,1,"male",897,470,288,251,156,208,86,43,70
2086960,26,15,1987,1,"female",195,74,62,32,3,32,1,0,2
2086977,30,6,1983,4,"male",587,181,112,10,10,1,4,9,6
2086978,22,11,1991,7,"male",276,123,75,6,2,6,2,0,0
2086982,20,19,1993,6,"male",793,80,73,2,0,0,0,2,0
2087028,48,9,1965,1,"male",262,5,4,0,1,0,1,0,0
2087042,19,8,1994,1,"male",286,739,480,3257,3037,3257,1809,0,1228
2087046,19,7,1994,1,"male",311,1062,779,2775,2483,2767,1479,8,1004
2087068,53,30,1960,8,"female",213,71,24,4,4,3,2,1,2
2087079,16,9,1997,11,"male",116,251,206,84,73,46,10,38,63
2087080,18,3,1995,4,"female",487,281,118,72,76,42,70,30,6
2087089,50,4,1963,1,"male",1489,92,48,125,100,124,22,1,78
2087095,49,18,1964,6,"male",642,98,14,3,1,3,1,0,0
2087107,49,26,1964,6,"male",2417,96,19,2,2,2,1,0,1
2087142,33,6,1980,12,"female",349,23,15,38,42,38,40,0,2
2087230,60,7,1953,11,"female",843,170,112,59,180,0,37,59,143
2087232,30,1,1983,1,"male",675,163,159,0,0,0,0,0,0
2087235,35,7,1978,6,"male",163,22,15,10,11,10,11,0,0
2087253,26,7,1987,8,"male",212,9,8,0,0,0,0,0,0
2087268,37,5,1976,2,"male",347,21,18,0,0,0,0,0,0
2087275,36,13,1977,8,"male",20,19,12,5,1,5,1,0,0
2087277,26,13,1987,11,"male",198,168,2,16,8,16,3,0,5
2087286,18,7,1995,3,"male",240,701,627,3,0,3,0,0,0
2087290,113,25,1900,2,"male",1324,93,39,36,19,0,11,36,8
2087326,57,10,1956,3,"female",514,31,23,839,18,839,8,0,10
2087363,22,10,1991,1,"male",407,116,71,119,9,119,7,0,2
2087369,67,9,1946,6,"male",180,386,314,254,77,233,19,21,58
2087376,17,2,1996,4,"female",279,94,75,89,11,89,11,0,0
2087382,32,1,1981,7,"female",659,256,197,7,8,7,7,0,1
2087409,21,27,1992,8,"male",714,56,29,0,0,0,0,0,0
2087517,23,19,1990,4,"male",384,106,67,0,8,0,2,0,6
2087523,16,1,1997,3,"female",236,296,80,0,22,0,1,0,21
2087538,22,13,1991,8,"female",99,41,25,26,44,26,30,0,14
2087567,16,20,1997,11,"male",236,43,31,0,3,0,3,0,0
2087571,71,24,1942,7,"female",553,92,43,23,9,0,2,23,7
2087593,19,27,1994,10,"male",172,1,0,5,0,5,0,0,0
2087598,81,18,1932,7,"female",1094,46,19,0,0,0,0,0,0
2087610,29,28,1984,11,"male",675,9,4,0,5,0,5,0,0
2087612,17,10,1996,12,"male",454,224,122,26,28,20,5,6,23
2087620,16,3,1997,3,"female",349,490,203,34,32,34,29,0,3
2087624,46,24,1967,7,"male",287,17,14,0,0,0,0,0,0
2087659,43,1,1970,1,"female",384,3,3,3,4,0,2,3,2
2087688,14,14,1999,1,"male",486,131,49,162,38,162,37,0,1
2087745,37,17,1976,7,"female",567,53,21,1,58,1,15,0,43
2087759,26,21,1987,11,"male",42,136,90,22,0,20,0,2,0
2087762,35,30,1978,5,"male",677,189,175,36,0,30,0,6,0
2087770,19,15,1994,7,"male",142,41,28,4,0,4,0,0,0
2087827,43,27,1970,4,"female",448,30,13,10,0,10,0,0,0
2087879,30,26,1983,7,"male",496,43,29,16,0,16,0,0,0
2087880,39,12,1974,9,"female",501,86,43,40,61,40,43,0,18
2087882,31,14,1982,7,"male",715,99,18,6,5,6,5,0,0
2087895,15,4,1998,6,"female",676,317,208,1360,697,119,235,1241,462
2087898,27,7,1986,9,"male",147,53,37,16,24,16,17,0,7
2087912,18,20,1995,9,"female",91,179,112,1,8,1,7,0,1
2087919,32,12,1981,12,"male",164,14,14,6,5,6,5,0,0
2087937,14,5,1999,5,"male",145,48,39,40,21,25,7,15,14
2087959,18,25,1995,2,"male",317,447,269,0,30,0,19,0,11
2087962,17,30,1996,3,"male",504,42,21,14,3,5,0,9,3
2087977,78,26,1935,8,"female",1196,145,87,124,155,0,78,124,77
2087992,24,1,1989,8,"male",608,156,51,5,16,5,14,0,2
2087994,19,24,1994,1,"male",387,158,97,2,36,1,27,1,9
2087995,27,25,1986,8,"female",2218,27,24,149,129,149,97,0,32
2088013,103,30,1910,10,"female",1019,154,75,46,45,46,42,0,3
2088026,30,12,1983,1,"male",409,22,19,10,8,0,2,10,6
2088034,58,28,1955,4,"female",1497,22,8,11,13,11,9,0,4
2088043,73,6,1940,10,"male",1042,39,25,9,11,9,7,0,4
2088046,46,10,1967,1,"female",79,92,69,1,1,0,1,1,0
2088063,46,29,1967,11,"female",160,8,5,0,0,0,0,0,0
2088065,55,28,1958,2,"male",835,120,36,525,13,489,3,36,10
2088126,24,16,1989,10,"male",277,97,67,2,1,2,1,0,0
2088139,45,1,1968,1,"male",423,105,90,0,0,0,0,0,0
2088146,18,25,1995,9,"male",476,118,75,84,19,10,12,74,7
2088149,20,3,1993,10,"female",700,3547,460,1,345,1,323,0,22
2088179,37,14,1976,11,"male",978,343,283,2,139,2,129,0,10
2088231,22,10,1991,11,"male",450,30,25,1,0,0,0,1,0
2088237,15,18,1998,3,"female",282,1989,439,1247,2820,698,858,549,1962
2088241,36,1,1977,1,"male",448,797,260,274,19,274,12,0,7
2088258,26,7,1987,5,"male",411,18,6,11,1,11,0,0,1
2088261,70,29,1943,10,"female",211,54,27,1179,353,0,74,1179,279
2088268,16,11,1997,10,"female",250,327,100,950,506,698,237,252,269
2088342,35,3,1978,9,"female",363,339,130,686,489,686,326,0,163
2088347,58,24,1955,1,"female",191,7,6,4,0,0,0,4,0
2088348,52,6,1961,5,"male",415,11,11,0,0,0,0,0,0
2088376,23,11,1990,5,"female",2042,438,195,239,369,226,264,13,105
2088381,15,18,1998,8,"male",705,178,121,2,38,2,36,0,2
2088392,68,17,1945,8,"male",523,39,20,6,64,6,59,0,5
2088395,36,25,1977,7,"male",270,69,43,38,9,38,9,0,0
2088409,70,14,1943,1,NA,1849,402,210,32,6,32,4,0,2
2088411,65,7,1948,11,"male",747,13,11,0,1,0,0,0,1
2088421,26,16,1987,9,"male",791,138,65,14,2,14,2,0,0
2088425,19,12,1994,9,"male",803,212,150,70,14,31,10,39,4
2088432,18,20,1995,6,"male",257,149,83,4,3,4,1,0,2
2088469,16,28,1997,8,"female",543,625,386,242,211,228,156,14,55
2088479,51,5,1962,3,"male",167,63,50,207,90,207,36,0,54
2088510,54,20,1959,10,"male",1722,62,11,0,1,0,1,0,0
2088542,75,9,1938,10,"male",2171,569,267,223,163,159,116,64,47
2088570,23,2,1990,2,"female",429,44,27,6,2,0,0,6,2
2088593,30,3,1983,2,"female",500,23,12,2,0,2,0,0,0
2088675,19,20,1994,4,"male",407,166,131,0,0,0,0,0,0
2088699,31,28,1982,12,"male",309,60,36,0,0,0,0,0,0
2088735,33,10,1980,8,"male",682,323,162,163,175,122,157,41,18
2088741,55,21,1958,7,"male",732,8,2,0,0,0,0,0,0
2088760,44,31,1969,10,"female",777,145,122,198,301,178,216,20,85
2088777,21,24,1992,5,"female",647,210,122,336,411,207,293,129,118
2088782,26,3,1987,8,"female",1669,4240,857,4794,28778,1153,20770,3641,8008
2088787,50,1,1963,11,"male",176,8,7,0,0,0,0,0,0
2088808,15,11,1998,12,"female",226,216,172,0,0,0,0,0,0
2088815,18,25,1995,8,"male",353,130,74,16,72,16,71,0,1
2088843,18,18,1995,5,"male",262,638,509,1203,198,450,148,753,50
2088845,19,30,1994,11,"male",653,325,195,118,21,118,7,0,14
2088855,16,10,1997,12,"female",348,593,92,194,341,132,127,62,214
2088893,31,28,1982,2,"female",489,10,3,6,23,1,20,5,3
2088905,59,22,1954,4,"female",378,71,64,327,121,0,76,327,45
2088920,62,14,1951,8,"female",496,238,111,562,118,0,30,562,88
2088950,108,1,1905,1,NA,1217,28,19,22,0,8,0,14,0
2088975,105,8,1908,10,"female",2296,349,79,17,146,17,133,0,13
2089018,108,23,1905,9,"male",451,488,435,9,1,9,1,0,0
2089021,22,24,1991,8,"male",111,208,189,0,19,0,0,0,19
2089041,25,21,1988,8,"male",544,266,236,65,35,65,35,0,0
2089077,19,14,1994,4,"male",433,1020,889,1549,667,1292,312,257,355
2089101,19,17,1994,8,"male",756,64,37,0,0,0,0,0,0
2089174,15,1,1998,1,"female",566,229,138,0,0,0,0,0,0
2089176,67,18,1946,12,"female",1787,124,81,1338,409,664,102,674,307
2089191,64,26,1949,10,"male",318,54,45,8,5,6,2,2,3
2089195,24,1,1989,1,"male",381,105,74,0,0,0,0,0,0
2089244,27,21,1986,9,"male",636,55,33,59,4,59,3,0,1
2089245,39,5,1974,11,"male",243,23,21,0,1,0,1,0,0
2089269,54,10,1959,10,"female",991,38,26,367,100,367,52,0,48
2089282,33,30,1980,5,"female",474,47,26,861,21,861,20,0,1
2089287,23,2,1990,11,"female",538,200,91,291,263,179,143,112,120
2089316,36,5,1977,1,"male",317,28,12,0,7,0,1,0,6
2089344,28,3,1985,6,"male",182,0,0,0,0,0,0,0,0
2089367,15,9,1998,6,"male",1152,1057,882,10,66,3,41,7,25
2089397,24,8,1989,2,"female",46,8,2,0,0,0,0,0,0
2089398,43,5,1970,1,"male",220,32,24,0,4,0,4,0,0
2089407,17,26,1996,3,"male",881,347,245,0,5,0,5,0,0
2089431,30,23,1983,12,"male",1159,29,13,0,1,0,1,0,0
2089432,15,12,1998,5,"male",276,4,0,0,0,0,0,0,0
2089453,30,17,1983,1,"female",1717,168,81,408,155,383,121,25,34
2089487,33,1,1980,1,"female",710,69,43,3,1,3,0,0,1
2089514,50,18,1963,10,"male",1374,202,92,38,122,1,72,37,50
2089537,24,13,1989,2,"male",446,18,10,24,4,24,4,0,0
2089539,74,17,1939,10,"male",969,14,8,0,0,0,0,0,0
2089544,108,1,1905,1,"male",1560,96,36,2,10,0,1,2,9
2089581,33,20,1980,5,"female",49,2,1,0,0,0,0,0,0
2089597,21,11,1992,5,"male",550,308,176,256,150,220,89,36,61
2089614,53,1,1960,10,"male",1266,354,302,26,7,26,6,0,1
2089629,24,12,1989,7,"male",336,64,21,1,1,1,1,0,0
2089638,65,5,1948,6,"female",1065,26,17,0,2,0,2,0,0
2089645,54,1,1959,5,"male",147,24,18,0,1,0,0,0,1
2089678,35,15,1978,4,"female",473,20,9,2,3,2,2,0,1
2089679,16,23,1997,8,"female",515,967,255,762,599,222,411,540,188
2089737,45,17,1968,5,"male",308,136,87,151,32,151,11,0,21
2089754,103,14,1910,1,"male",807,321,267,111,36,111,36,0,0
2089767,19,15,1994,11,"male",137,29,25,5,10,1,2,4,8
2089794,17,16,1996,11,"female",323,41,20,7,18,4,10,3,8
2089824,23,12,1990,11,"female",301,362,258,1,3,1,3,0,0
2089830,23,25,1990,12,"male",798,4217,1952,3,35,0,21,3,14
2089866,23,12,1990,1,"female",135,207,89,55,176,10,107,45,69
2089873,23,2,1990,6,"male",1543,631,343,82,102,64,51,18,51
2089897,22,4,1991,2,"male",551,450,360,38,8,37,4,1,4
2089901,19,22,1994,10,"male",690,115,72,109,35,78,23,31,12
2089904,35,7,1978,4,"male",578,42,10,45,125,45,96,0,29
2089909,17,1,1996,1,"female",164,55,31,3,13,3,0,0,13
2089916,15,24,1998,10,"male",252,3,2,3,0,3,0,0,0
2089923,18,5,1995,5,"male",532,2318,1754,515,527,318,478,197,49
2089937,22,2,1991,8,"male",503,55,37,10,8,10,5,0,3
2089972,19,25,1994,3,"male",186,238,129,315,129,315,117,0,12
2089973,67,25,1946,3,"male",105,22,20,5,13,5,13,0,0
2090004,24,15,1989,2,"female",760,146,65,3257,1222,3154,442,103,780
2090026,21,2,1992,1,"male",218,230,137,14,21,14,17,0,4
2090055,29,5,1984,1,"male",473,174,127,0,0,0,0,0,0
2090068,43,27,1970,3,"male",498,88,52,0,1,0,1,0,0
2090082,103,31,1910,12,"female",1549,457,189,1,0,1,0,0,0
2090087,69,13,1944,5,"male",173,79,66,5,4,5,4,0,0
2090094,51,10,1962,9,"female",235,18,13,12,21,0,2,12,19
2090100,69,15,1944,3,"female",838,45,28,0,0,0,0,0,0
2090108,30,3,1983,1,"male",618,134,52,225,126,225,124,0,2
2090112,52,12,1961,3,"male",584,90,39,84,157,0,39,84,118
2090120,29,22,1984,4,"male",408,184,94,0,1,0,1,0,0
2090124,24,23,1989,8,"male",64,43,9,5,1,5,0,0,1
2090146,64,5,1949,1,"male",239,65,57,17,4,17,4,0,0
2090148,28,10,1985,6,"male",343,26,13,2,2,2,0,0,2
2090209,53,21,1960,3,"male",103,23,18,28,39,0,7,28,32
2090211,23,27,1990,8,"male",618,105,78,1,0,1,0,0,0
2090212,80,29,1933,7,"female",1718,83,46,12,2,8,1,4,1
2090222,54,28,1959,12,"female",443,55,38,42,8,0,2,42,6
2090240,100,8,1913,10,"male",1591,89,23,30,21,30,16,0,5
2090241,26,18,1987,8,"male",338,518,474,38,0,38,0,0,0
2090274,20,8,1993,10,"male",208,104,58,10,64,10,48,0,16
2090283,66,15,1947,8,"male",337,39,38,6,0,0,0,6,0
2090302,37,25,1976,6,"female",726,72,55,0,7,0,3,0,4
2090313,25,18,1988,11,"female",811,249,114,62,12,62,8,0,4
2090366,31,5,1982,3,"male",1560,60,41,4,1,4,0,0,1
2090369,17,7,1996,6,"female",84,335,48,382,103,382,66,0,37
2090379,41,10,1972,1,"male",464,0,0,0,0,0,0,0,0
2090395,33,29,1980,9,"female",527,352,320,52,119,52,46,0,73
2090401,19,17,1994,10,"male",320,211,162,159,24,79,11,80,13
2090432,53,29,1960,7,"male",1695,81,26,1,0,0,0,1,0
2090433,33,9,1980,12,"male",384,89,48,3,3,3,0,0,3
2090456,28,8,1985,4,"male",983,29,29,0,0,0,0,0,0
2090463,20,12,1993,9,"male",776,208,167,92,7,83,5,9,2
2090467,25,27,1988,8,"female",295,95,35,494,190,494,154,0,36
2090476,67,17,1946,12,"male",1613,22,13,10,2,10,2,0,0
2090479,58,17,1955,2,"male",1201,58,22,6,4,0,1,6,3
2090541,17,15,1996,3,"male",639,695,508,344,378,38,222,306,156
2090566,19,16,1994,7,"female",286,46,9,0,0,0,0,0,0
2090570,101,4,1912,5,"male",1138,106,79,24,11,0,9,24,2
2090608,48,12,1965,6,"female",199,11,9,11,3,0,1,11,2
2090615,47,23,1966,9,"female",770,106,59,117,72,0,22,117,50
2090626,33,1,1980,5,"female",507,78,42,68,1,0,1,68,0
2090630,23,11,1990,3,"female",415,388,287,117,146,117,137,0,9
2090662,57,6,1956,1,"male",384,98,70,37,27,37,11,0,16
2090675,16,18,1997,2,"male",217,316,253,24,34,24,18,0,16
2090682,36,5,1977,5,"male",14,0,0,2,1,0,0,2,1
2090699,36,1,1977,1,"male",456,1,1,0,0,0,0,0,0
2090700,25,20,1988,12,"female",419,93,19,75,57,75,47,0,10
2090711,28,6,1985,8,"female",168,37,28,312,180,237,61,75,119
2090754,77,7,1936,6,"female",1355,54,34,4,2,0,2,4,0
2090812,30,14,1983,12,"female",217,44,13,47,9,47,8,0,1
2090839,41,27,1972,1,"female",1329,25,14,2018,244,1316,66,702,178
2090851,19,8,1994,3,"male",319,56,41,48,36,19,21,29,15
2090858,50,22,1963,3,"female",85,64,54,498,370,498,279,0,91
2090861,29,6,1984,4,"female",538,89,48,97,56,94,55,3,1
2090862,20,1,1993,1,"male",18,8,7,0,0,0,0,0,0
2090943,25,25,1988,12,"female",485,22,18,0,0,0,0,0,0
2090944,19,15,1994,9,"female",251,243,181,90,25,2,22,88,3
2090962,45,9,1968,2,"male",1022,105,28,17,20,17,10,0,10
2090988,21,15,1992,12,"male",466,164,104,0,0,0,0,0,0
2090990,90,2,1923,11,"male",104,60,53,14,20,0,16,14,4
2090995,25,11,1988,10,"male",333,56,49,35,0,34,0,1,0
2091005,25,9,1988,9,"female",355,149,91,77,52,77,30,0,22
2091008,108,22,1905,4,"female",1344,58,32,2,0,2,0,0,0
2091018,36,18,1977,5,"male",755,33,20,0,0,0,0,0,0
2091029,19,12,1994,5,"female",471,43,18,0,8,0,0,0,8
2091050,18,12,1995,10,"male",3,10,4,0,5,0,5,0,0
2091055,47,4,1966,10,"male",515,39,5,137,9,0,1,137,8
2091059,40,5,1973,9,"male",233,4,4,0,0,0,0,0,0
2091159,32,20,1981,8,"male",491,306,277,2,0,2,0,0,0
2091169,16,5,1997,9,"male",653,123,67,4,10,4,9,0,1
2091188,49,14,1964,12,"female",980,154,90,304,175,163,48,141,127
2091217,23,22,1990,2,"male",707,275,229,11,33,11,26,0,7
2091242,20,2,1993,6,"male",438,1127,789,31,13,31,12,0,1
2091255,21,20,1992,4,"male",177,104,93,0,0,0,0,0,0
2091258,33,29,1980,1,"male",200,47,22,13,2,13,1,0,1
2091267,101,7,1912,6,"female",652,284,80,35,42,4,3,31,39
2091283,73,16,1940,5,"female",894,42,17,3,1,0,0,3,1
2091304,18,1,1995,7,"male",494,37,22,92,2,92,1,0,1
2091307,19,23,1994,10,"male",1140,151,45,3,5,3,4,0,1
2091393,25,10,1988,4,"male",594,641,513,191,93,87,48,104,45
2091406,25,3,1988,10,"male",774,29,15,0,0,0,0,0,0
2091456,65,16,1948,1,"female",645,91,63,740,176,281,129,459,47
2091521,20,6,1993,8,"male",28,3,2,0,0,0,0,0,0
2091532,83,6,1930,8,"male",868,42,28,0,14,0,11,0,3
2091533,30,16,1983,5,"male",1488,43,14,4,16,4,16,0,0
2091575,16,21,1997,5,"female",417,432,268,1022,897,276,328,746,569
2091619,18,5,1995,5,"male",44,84,69,94,56,94,45,0,11
2091632,29,14,1984,1,"male",315,66,62,3,0,2,0,1,0
2091663,51,3,1962,4,"female",484,335,277,792,240,101,65,691,175
2091698,51,26,1962,6,"male",1773,67,38,6,16,2,1,4,15
2091703,40,16,1973,5,"male",440,53,28,7,32,7,22,0,10
2091704,16,29,1997,12,"male",357,50,31,0,0,0,0,0,0
2091722,34,5,1979,7,"female",304,19,18,0,0,0,0,0,0
2091724,27,22,1986,9,"male",108,1,1,0,0,0,0,0,0
2091725,19,5,1994,6,"female",155,35,25,5,18,0,2,5,16
2091734,35,4,1978,9,"male",68,1,1,0,0,0,0,0,0
2091744,27,12,1986,5,"male",545,77,58,0,0,0,0,0,0
2091747,23,1,1990,7,"male",303,67,40,19,3,8,3,11,0
2091753,22,2,1991,3,"male",323,74,50,11,1,11,1,0,0
2091759,18,31,1995,7,"male",150,95,76,22,11,22,8,0,3
2091762,108,27,1905,6,"male",1872,60,40,70,23,0,18,70,5
2091803,78,14,1935,12,"female",1560,83,57,29,17,0,4,29,13
2091823,15,6,1998,7,"female",82,70,40,113,222,113,107,0,115
2091826,24,4,1989,4,"male",208,78,70,0,1,0,1,0,0
2091885,16,6,1997,7,"female",654,915,367,888,749,423,605,465,144
2091928,33,31,1980,12,"female",859,279,199,3668,2444,499,1259,3169,1185
2091948,54,31,1959,10,"female",1346,54,14,23,9,0,2,23,7
2091950,40,26,1973,10,"male",1043,21,2,0,0,0,0,0,0
2091963,13,22,2000,9,"female",10,0,0,0,0,0,0,0,0
2091985,51,4,1962,1,"male",385,339,200,19,23,19,17,0,6
2092023,18,13,1995,2,"female",239,322,205,772,402,0,34,772,368
2092027,88,3,1925,3,"male",46,93,80,24,0,0,0,24,0
2092047,73,4,1940,8,"male",1108,42,6,5,1,2,1,3,0
2092062,30,21,1983,4,"male",254,392,293,18,27,16,19,2,8
2092065,22,4,1991,3,"male",448,74,47,12,25,2,9,10,16
2092072,17,28,1996,10,"female",668,555,414,1,0,0,0,1,0
2092090,48,15,1965,3,"male",360,4,3,0,0,0,0,0,0
2092101,30,21,1983,12,"female",399,162,90,499,117,331,40,168,77
2092103,25,9,1988,10,"female",184,38,32,18,17,18,13,0,4
2092105,17,18,1996,8,"male",667,59,36,29,48,23,47,6,1
2092130,22,10,1991,10,"male",52,21,9,3,2,3,1,0,1
2092149,28,27,1985,6,"male",132,5,5,0,0,0,0,0,0
2092166,60,19,1953,12,"male",141,0,0,0,0,0,0,0,0
2092169,22,11,1991,12,"female",573,28,24,12,11,12,11,0,0
2092181,24,12,1989,5,"male",210,17,15,0,0,0,0,0,0
2092195,71,22,1942,2,"female",1066,52,39,19,7,0,4,19,3
2092203,94,15,1919,8,NA,2411,262,113,111,42,4,21,107,21
2092243,23,13,1990,7,"male",194,40,39,41,9,41,9,0,0
2092258,32,8,1981,11,"male",1495,85,38,0,0,0,0,0,0
2092279,43,12,1970,1,"female",403,41,27,105,122,105,113,0,9
2092282,59,31,1954,5,"female",491,3,3,0,0,0,0,0,0
2092316,16,1,1997,8,"male",623,194,150,0,0,0,0,0,0
2092353,14,1,1999,1,"male",191,1,1,0,0,0,0,0,0
2092367,67,12,1946,7,"male",373,330,268,288,95,181,61,107,34
2092393,16,19,1997,12,"female",323,301,73,0,22,0,12,0,10
2092405,17,15,1996,4,"male",1225,58,11,2,5,2,2,0,3
2092407,54,10,1959,3,"female",56,33,32,1,7,0,6,1,1
2092420,63,28,1950,12,"male",1684,183,17,3,5,0,2,3,3
2092424,48,27,1965,2,"male",827,173,137,1,0,1,0,0,0
2092483,20,17,1993,12,"male",343,445,255,124,62,84,32,40,30
2092499,21,10,1992,3,"male",475,308,156,805,397,805,151,0,246
2092515,48,1,1965,12,"female",531,86,54,2,4,0,1,2,3
2092548,33,1,1980,6,"female",1421,331,170,1279,611,294,363,985,248
2092549,21,12,1992,2,"male",188,156,132,0,3,0,3,0,0
2092553,19,26,1994,8,"male",574,155,97,0,0,0,0,0,0
2092557,58,27,1955,9,"male",1797,64,36,0,0,0,0,0,0
2092574,33,30,1980,4,"male",111,36,23,6,10,4,3,2,7
2092625,21,22,1992,12,"male",361,285,120,8,4,0,0,8,4
2092631,20,1,1993,6,"male",593,702,293,3,46,3,45,0,1
2092654,25,2,1988,10,"male",693,339,217,42,106,40,74,2,32
2092677,17,5,1996,9,"male",1026,498,329,47,55,21,29,26,26
2092678,15,16,1998,5,"male",292,161,142,114,0,114,0,0,0
2092681,25,1,1988,1,"male",192,197,29,473,960,473,596,0,364
2092687,39,20,1974,6,"female",355,176,92,1598,1169,1598,894,0,275
2092698,36,3,1977,7,"male",663,13,11,0,0,0,0,0,0
2092739,53,14,1960,4,"female",835,75,40,285,209,41,149,244,60
2092763,31,13,1982,5,"male",461,68,39,8,0,8,0,0,0
2092764,44,29,1969,12,"male",609,1,0,0,0,0,0,0,0
2092774,38,20,1975,3,"male",626,73,39,3,12,3,12,0,0
2092776,54,6,1959,1,"male",710,258,135,311,503,255,163,56,340
2092779,33,14,1980,12,"female",856,34,15,86,98,86,45,0,53
2092788,23,3,1990,8,"male",152,211,192,4,20,4,18,0,2
2092794,18,9,1995,2,"male",43,12,10,38,25,38,13,0,12
2092797,46,5,1967,12,"male",495,25,21,0,0,0,0,0,0
2092807,23,3,1990,5,"male",141,35,20,1405,7,1405,6,0,1
2092835,69,1,1944,7,"female",1847,461,405,65,31,56,19,9,12
2092891,49,6,1964,6,"female",576,146,108,36,6,14,2,22,4
2092906,26,5,1987,10,"female",370,369,199,15,305,14,233,1,72
2092921,105,28,1908,12,"male",1816,680,400,8,4,8,3,0,1
2092940,59,23,1954,3,"male",1014,15,3,102,6,0,4,102,2
2092945,42,11,1971,11,"female",404,3,2,8,2,8,2,0,0
2092948,16,23,1997,3,"male",760,396,176,18,11,18,11,0,0
2092964,19,11,1994,1,"male",707,57,46,192,14,192,14,0,0
2092981,66,30,1947,9,"female",419,91,72,119,158,119,57,0,101
2092999,15,1,1998,6,"male",218,74,38,27,2,26,2,1,0
2093014,18,6,1995,6,"male",382,13,8,7,2,7,2,0,0
2093018,108,21,1905,6,"male",878,624,470,31,15,31,15,0,0
2093070,24,1,1989,10,"male",410,133,113,1,0,1,0,0,0
2093074,16,9,1997,4,"male",1150,82,12,11,0,11,0,0,0
2093128,72,19,1941,1,"female",1664,41,14,5,14,5,14,0,0
2093135,26,11,1987,9,"male",459,61,38,14,38,14,12,0,26
2093165,26,8,1987,8,"male",503,1,0,0,0,0,0,0,0
2093173,29,16,1984,4,"male",415,467,394,173,117,173,106,0,11
2093230,17,13,1996,7,"male",90,63,63,0,0,0,0,0,0
2093254,30,27,1983,9,"male",176,6,6,0,0,0,0,0,0
2093262,59,22,1954,9,"female",1702,61,36,110,29,109,20,1,9
2093266,21,4,1992,10,"female",342,8,5,0,0,0,0,0,0
2093276,18,1,1995,9,"male",32,14,13,0,0,0,0,0,0
2093279,56,11,1957,9,"male",446,175,96,18,53,0,5,18,48
2093299,34,7,1979,10,"male",707,142,89,3,6,3,4,0,2
2093302,21,9,1992,12,"female",553,243,123,4,6,4,6,0,0
2093335,70,9,1943,4,"female",1360,42,33,37,10,0,1,37,9
2093336,16,21,1997,12,"male",96,19,15,7,4,7,0,0,4
2093358,45,24,1968,4,"male",559,42,28,2,10,2,9,0,1
2093378,23,1,1990,1,"male",493,216,146,3,3,3,3,0,0
2093399,66,26,1947,3,"female",1440,72,28,6,1,2,0,4,1
2093438,57,26,1956,9,"female",651,174,84,212,260,212,201,0,59
2093454,14,25,1999,2,"male",197,35,31,26,12,26,12,0,0
2093483,53,16,1960,2,"male",130,4,1,0,0,0,0,0,0
2093492,102,20,1911,10,"female",1785,596,231,17,53,17,39,0,14
2093496,35,18,1978,9,"male",929,66,34,15,29,14,15,1,14
2093504,85,25,1928,10,"male",304,20,15,0,1,0,0,0,1
2093510,29,3,1984,4,"female",229,121,93,34,22,34,5,0,17
2093519,31,10,1982,12,"male",632,3,3,0,0,0,0,0,0
2093536,51,16,1962,12,"male",708,15,15,241,2,241,0,0,2
2093543,61,22,1952,11,"male",559,61,18,7,7,0,0,7,7
2093545,14,18,1999,2,"male",349,167,90,2,0,0,0,2,0
2093569,22,1,1991,9,"male",312,51,31,25,39,25,24,0,15
2093584,25,9,1988,7,"female",508,301,198,229,933,207,501,22,432
2093591,24,17,1989,1,"female",531,361,95,1086,182,1080,133,6,49
2093606,25,1,1988,3,"male",110,47,17,11,2,11,1,0,1
2093618,21,5,1992,1,"male",233,125,69,40,17,40,11,0,6
2093647,29,22,1984,9,"male",496,103,37,0,1,0,1,0,0
2093702,29,11,1984,1,"female",2112,1226,530,1431,969,1392,320,39,649
2093706,19,26,1994,6,"female",447,396,72,29,280,29,175,0,105
2093719,28,17,1985,1,"male",384,72,49,94,39,94,24,0,15
2093724,16,14,1997,4,"male",401,66,27,16,1,16,0,0,1
2093728,21,27,1992,11,"female",455,331,143,3,18,3,7,0,11
2093729,56,24,1957,9,"male",9,5,4,2,0,2,0,0,0
2093773,16,16,1997,3,"female",542,2824,1122,11506,9269,3177,5639,8329,3630
2093774,103,12,1910,2,"male",1223,306,197,5,2,5,1,0,1
2093810,21,15,1992,10,"male",207,18,17,0,0,0,0,0,0
2093815,23,5,1990,6,"male",841,113,56,0,0,0,0,0,0
2093863,19,3,1994,6,"male",619,73,32,1,0,1,0,0,0
2093875,24,8,1989,12,"female",721,246,138,116,27,116,22,0,5
2093915,32,2,1981,4,"male",1378,229,36,2,1,0,0,2,1
2093923,65,3,1948,5,"male",305,2,2,0,0,0,0,0,0
2093941,29,24,1984,9,"male",39,0,0,0,0,0,0,0,0
2093957,16,2,1997,4,"female",190,125,58,32,21,29,8,3,13
2093970,16,20,1997,7,"male",335,39,21,0,2,0,1,0,1
2093973,26,25,1987,12,"male",424,63,38,2,1,2,1,0,0
2093999,33,12,1980,9,"male",380,123,89,209,62,209,48,0,14
2094017,21,28,1992,7,"male",1311,620,364,1,1,1,1,0,0
2094049,33,17,1980,8,"female",647,64,35,86,32,86,28,0,4
2094089,51,21,1962,11,"male",288,1,1,0,0,0,0,0,0
2094097,21,11,1992,9,"male",457,33,22,0,4,0,4,0,0
2094110,27,28,1986,10,"male",302,194,37,0,0,0,0,0,0
2094111,27,9,1986,11,"male",730,28,4,1,0,1,0,0,0
2094123,36,7,1977,11,"male",278,100,78,65,39,65,34,0,5
2094131,75,4,1938,4,"male",293,141,112,10,1,0,0,10,1
2094132,18,4,1995,8,"female",172,139,68,1,1,1,1,0,0
2094140,26,6,1987,7,"male",379,246,147,1312,94,1312,87,0,7
2094199,57,14,1956,12,"female",1728,12,9,3,1,3,1,0,0
2094248,23,6,1990,5,"male",500,367,269,215,109,215,74,0,35
2094259,33,2,1980,2,"male",401,52,42,1,0,1,0,0,0
2094266,52,21,1961,6,"female",1550,227,141,21,33,21,23,0,10
2094291,57,20,1956,5,"male",1033,53,35,0,0,0,0,0,0
2094295,25,3,1988,3,"male",566,37,32,4,0,2,0,2,0
2094309,14,21,1999,9,"male",58,94,75,168,80,168,61,0,19
2094311,34,15,1979,8,"male",536,30,23,1,0,1,0,0,0
2094326,48,12,1965,10,"male",276,24,15,2,5,0,0,2,5
2094347,100,20,1913,3,"female",1139,484,302,65,75,40,62,25,13
2094354,22,29,1991,7,"male",144,15,9,2,2,2,1,0,1
2094366,30,3,1983,2,"female",1016,330,77,0,0,0,0,0,0
2094382,70,29,1943,3,"male",1368,680,454,139,201,139,175,0,26
2094386,108,12,1905,4,"female",102,30,20,7,11,5,6,2,5
2094393,46,17,1967,4,"male",287,32,29,9,1,9,0,0,1
2094440,59,2,1954,9,"female",747,63,25,52,21,16,13,36,8
2094457,54,1,1959,10,"male",18,1,1,1,1,0,0,1,1
2094465,61,23,1952,10,"male",26,14,11,9,1,9,0,0,1
2094467,80,4,1933,9,"female",1723,106,18,118,78,0,53,118,25
2094475,20,15,1993,4,"male",932,128,78,32,3,32,1,0,2
2094526,53,24,1960,6,"female",1987,122,54,80,37,78,27,2,10
2094560,100,26,1913,9,"male",1973,167,89,448,1329,170,412,278,917
2094561,25,15,1988,9,"male",150,142,123,493,140,493,117,0,23
2094589,17,26,1996,7,"male",438,483,205,184,292,42,86,142,206
2094598,49,24,1964,8,"female",672,35,5,39,5,39,5,0,0
2094630,26,13,1987,3,"female",108,10,7,0,0,0,0,0,0
2094637,57,1,1956,7,"male",1239,34,19,2,2,0,1,2,1
2094655,20,20,1993,1,"male",438,29,18,0,1,0,1,0,0
2094690,44,25,1969,4,"female",463,161,28,54,38,54,30,0,8
2094696,32,29,1981,6,"male",562,42,40,5,3,5,3,0,0
2094720,19,28,1994,3,"female",99,10,5,368,78,225,48,143,30
2094733,21,7,1992,1,"male",859,281,105,5,18,5,16,0,2
2094738,15,26,1998,7,"male",243,11,10,0,0,0,0,0,0
2094747,19,12,1994,4,"male",130,184,127,18,0,18,0,0,0
2094756,33,17,1980,1,"female",722,135,114,0,1,0,0,0,1
2094758,23,18,1990,11,"female",348,0,0,3,0,0,0,3,0
2094770,60,24,1953,2,"female",429,71,26,26,7,1,4,25,3
2094775,25,24,1988,1,"female",494,716,165,778,534,778,401,0,133
2094833,28,6,1985,6,"male",1520,29,13,4,23,3,7,1,16
2094840,43,8,1970,4,"female",1402,400,157,1265,827,704,483,561,344
2094853,39,7,1974,7,"male",522,87,48,0,1,0,1,0,0
2094861,33,13,1980,10,"female",845,257,88,82,206,71,71,11,135
2094862,40,22,1973,4,"male",39,21,19,640,52,640,32,0,20
2094865,49,13,1964,2,"male",197,32,23,1,1,0,0,1,1
2094877,37,14,1976,5,"male",353,9,3,11,10,11,8,0,2
2094904,100,31,1913,8,"female",1810,781,120,151,119,87,68,64,51
2094932,57,1,1956,4,"female",1235,48,28,90,5,70,4,20,1
2094940,19,7,1994,9,"male",129,161,82,36,22,20,21,16,1
2094952,49,1,1964,8,"male",813,31,23,23,0,0,0,23,0
2094977,26,1,1987,5,"male",367,5,2,0,0,0,0,0,0
2094988,76,10,1937,3,"male",1245,86,34,3,5,0,0,3,5
2095014,25,10,1988,2,"female",329,349,200,2,9,2,9,0,0
2095042,35,30,1978,5,"female",204,93,32,46,198,45,150,1,48
2095081,41,20,1972,4,"male",984,69,25,88,79,88,64,0,15
2095095,58,12,1955,8,"female",953,154,46,72,181,72,58,0,123
2095130,53,10,1960,11,"male",69,104,82,1058,155,1058,103,0,52
2095143,55,6,1958,8,"male",786,72,37,0,0,0,0,0,0
2095150,23,16,1990,8,"male",252,24,17,0,0,0,0,0,0
2095152,41,3,1972,9,"female",428,38,22,0,0,0,0,0,0
2095164,23,4,1990,2,"male",1399,317,144,0,1,0,1,0,0
2095165,34,29,1979,6,"female",330,28,21,26,8,26,5,0,3
2095169,52,17,1961,8,"female",2312,145,68,202,61,202,41,0,20
2095173,76,17,1937,10,"male",1166,28,13,1,3,0,2,1,1
2095187,26,8,1987,2,"male",274,64,57,0,0,0,0,0,0
2095198,26,16,1987,3,"male",341,16,10,11,2,11,0,0,2
2095222,24,30,1989,6,"male",435,254,165,931,111,931,63,0,48
2095225,68,17,1945,8,"male",1760,319,44,11,49,11,25,0,24
2095247,20,11,1993,9,"male",169,12,9,0,0,0,0,0,0
2095285,27,2,1986,3,"female",544,144,99,110,50,81,40,29,10
2095291,43,8,1970,4,"male",913,2,0,0,0,0,0,0,0
2095297,48,20,1965,8,"male",222,39,33,504,97,504,77,0,20
2095311,38,8,1975,12,"female",447,36,22,7,3,7,2,0,1
2095312,25,22,1988,8,"male",174,16,13,23,7,23,7,0,0
2095339,56,17,1957,10,"female",702,66,53,39,69,39,62,0,7
2095341,38,13,1975,11,"male",316,29,21,2,0,2,0,0,0
2095365,32,26,1981,8,"male",573,96,72,187,68,187,49,0,19
2095366,36,24,1977,3,"male",1332,44,2,0,1,0,1,0,0
2095369,19,18,1994,8,"female",494,1845,310,4,444,4,298,0,146
2095378,57,18,1956,5,"male",967,45,26,6,25,0,8,6,17
2095425,36,6,1977,10,"female",380,22,14,52,3,52,2,0,1
2095427,50,22,1963,7,"male",1581,906,403,63,8,0,6,63,2
2095515,23,1,1990,10,"male",220,44,27,0,3,0,0,0,3
2095519,31,10,1982,5,"male",289,27,23,0,0,0,0,0,0
2095567,24,26,1989,10,"male",371,92,85,0,0,0,0,0,0
2095592,36,19,1977,2,"female",864,207,95,394,360,394,236,0,124
2095595,21,31,1992,10,"female",93,61,46,209,88,208,47,1,41
2095612,23,10,1990,10,"male",1181,32,13,0,0,0,0,0,0
2095653,22,16,1991,7,"female",179,166,111,429,149,429,62,0,87
2095658,16,12,1997,5,"male",17,16,11,0,0,0,0,0,0
2095673,33,5,1980,8,"female",1108,372,223,1545,558,1529,163,16,395
2095679,68,17,1945,2,"male",24,26,14,5,2,5,2,0,0
2095701,16,9,1997,7,"male",272,25,15,0,1,0,1,0,0
2095752,72,27,1941,8,"female",749,13,12,2,0,0,0,2,0
2095762,66,3,1947,3,"female",331,55,46,4,2,1,2,3,0
2095778,29,8,1984,4,"male",177,19,12,10,6,10,3,0,3
2095781,20,1,1993,1,"male",451,7,7,10,2,10,2,0,0
2095794,31,1,1982,1,"female",658,40,13,0,1,0,0,0,1
2095829,55,12,1958,8,"male",361,8,8,0,0,0,0,0,0
2095849,39,8,1974,8,"male",401,0,0,0,0,0,0,0,0
2095857,95,8,1918,6,"female",2294,213,41,85,62,0,7,85,55
2095880,13,5,2000,1,"male",54,55,33,7,2,7,1,0,1
2095886,53,2,1960,9,"female",645,219,40,37,33,37,23,0,10
2095908,13,27,2000,2,"female",119,40,12,294,107,294,86,0,21
2095947,23,1,1990,11,"male",1086,422,289,56,7,56,7,0,0
2095950,65,21,1948,9,"male",244,116,76,0,0,0,0,0,0
2095962,35,12,1978,6,"male",275,1,0,0,0,0,0,0,0
2095963,60,26,1953,11,"male",951,25,19,0,2,0,2,0,0
2095975,28,19,1985,9,"male",193,70,47,5,0,5,0,0,0
2095981,22,19,1991,1,"male",251,307,252,1,0,1,0,0,0
2096014,57,10,1956,3,"female",1670,73,49,20,24,6,14,14,10
2096019,61,24,1952,11,"female",621,234,141,276,1398,191,635,85,763
2096032,18,30,1995,9,"male",175,161,114,29,6,0,2,29,4
2096058,30,25,1983,11,"male",542,1270,306,203,185,195,89,8,96
2096079,108,4,1905,10,"female",1478,93,70,160,132,0,17,160,115
2096082,108,28,1905,4,"female",1838,310,170,154,74,44,21,110,53
2096118,19,14,1994,9,"female",454,167,61,29,41,29,37,0,4
2096176,33,21,1980,5,"male",472,20,19,1,1,1,0,0,1
2096188,17,15,1996,4,"male",234,85,56,5,4,5,3,0,1
2096203,100,18,1913,10,"male",647,2645,2129,262,299,64,211,198,88
2096204,18,2,1995,12,"female",288,308,231,35,113,17,56,18,57
2096210,16,23,1997,7,"female",226,71,37,110,2,110,1,0,1
2096211,38,2,1975,5,"male",248,132,41,24,42,24,34,0,8
2096213,35,3,1978,11,"female",296,213,84,121,153,112,135,9,18
2096230,100,8,1913,9,"male",1194,123,53,161,12,160,11,1,1
2096249,46,3,1967,4,"male",230,12,6,0,0,0,0,0,0
2096255,27,4,1986,9,"female",188,8,6,0,0,0,0,0,0
2096303,20,1,1993,1,"male",136,51,49,11,8,11,8,0,0
2096304,33,29,1980,10,"male",608,81,44,14,6,14,6,0,0
2096333,28,3,1985,7,"male",447,0,0,0,0,0,0,0,0
2096337,24,23,1989,4,"male",40,2,1,17,1,11,0,6,1
2096349,38,10,1975,12,"male",453,33,23,24,5,0,1,24,4
2096364,21,4,1992,8,"female",259,147,99,4,30,2,9,2,21
2096379,22,21,1991,12,"female",27,53,36,13,38,12,17,1,21
2096383,46,3,1967,12,"male",181,6,5,0,0,0,0,0,0
2096390,45,10,1968,3,"male",23,46,45,109,56,6,8,103,48
2096401,67,27,1946,8,"male",438,332,78,70,44,6,16,64,28
2096405,53,16,1960,8,"female",279,39,29,0,0,0,0,0,0
2096411,29,29,1984,4,"female",231,9,5,8,11,8,11,0,0
2096423,20,10,1993,3,"female",359,116,84,77,17,77,5,0,12
2096443,29,30,1984,4,"female",198,140,111,14,1,14,1,0,0
2096458,33,10,1980,10,"male",280,82,75,0,0,0,0,0,0
2096478,52,28,1961,8,"female",1885,339,199,1189,420,836,108,353,312
2096490,51,1,1962,1,"female",45,30,18,16,28,0,2,16,26
2096515,59,6,1954,3,"female",439,19,17,156,3,142,3,14,0
2096523,108,3,1905,4,"male",1131,322,280,5,5,0,5,5,0
2096524,61,21,1952,3,"male",1049,62,41,111,57,32,44,79,13
2096531,103,1,1910,1,"male",490,197,39,0,1,0,0,0,1
2096613,15,12,1998,7,"female",841,274,161,153,33,7,2,146,31
2096615,15,10,1998,12,"male",226,34,7,0,0,0,0,0,0
2096633,48,4,1965,11,"female",378,65,45,19,28,19,22,0,6
2096634,61,7,1952,9,"male",1071,37,17,20,2,0,1,20,1
2096639,18,20,1995,2,"female",894,386,183,21,60,17,47,4,13
2096650,63,16,1950,11,"female",99,53,40,248,41,228,20,20,21
2096693,35,14,1978,10,"male",236,6,4,0,0,0,0,0,0
2096697,33,21,1980,6,"male",927,265,35,20,50,20,50,0,0
2096702,27,21,1986,3,"male",450,101,84,14,39,14,18,0,21
2096725,17,29,1996,6,"female",187,24,11,0,0,0,0,0,0
2096727,23,12,1990,12,"male",482,161,94,0,0,0,0,0,0
2096729,33,19,1980,3,"male",437,182,171,0,0,0,0,0,0
2096737,26,1,1987,1,"male",334,222,130,22,37,22,16,0,21
2096739,68,21,1945,8,"male",642,120,53,1,0,1,0,0,0
2096743,33,21,1980,10,"male",8,21,21,1,9,1,7,0,2
2096747,31,29,1982,7,"female",411,61,5,82,2,82,1,0,1
2096795,22,13,1991,1,"female",536,66,42,127,0,120,0,7,0
2096812,16,25,1997,11,"female",342,2944,1530,8257,3950,3061,2762,5196,1188
2096854,30,1,1983,4,"male",723,2,2,0,0,0,0,0,0
2096855,85,14,1928,1,"female",1411,15,5,0,3,0,1,0,2
2096924,23,3,1990,1,"female",344,132,114,31,66,31,49,0,17
2096935,53,16,1960,9,"female",612,6,3,0,0,0,0,0,0
2096948,65,7,1948,10,"female",474,34,18,0,0,0,0,0,0
2096976,14,5,1999,11,"female",350,852,556,755,799,181,400,574,399
2096982,26,18,1987,2,"male",513,1,1,9,0,0,0,9,0
2096990,22,26,1991,4,"male",137,115,79,9,16,7,7,2,9
2097007,16,10,1997,11,"female",634,557,453,20,32,20,13,0,19
2097008,24,10,1989,8,"male",242,184,165,0,44,0,22,0,22
2097019,29,7,1984,4,"female",290,273,89,4,43,4,41,0,2
2097021,21,18,1992,1,"female",368,902,153,138,221,138,157,0,64
2097040,23,4,1990,9,"male",507,202,106,139,17,0,6,139,11
2097103,20,17,1993,7,"male",327,169,83,1,7,1,4,0,3
2097104,25,26,1988,8,"female",163,0,0,0,1,0,1,0,0
2097137,21,14,1992,2,"male",670,361,213,0,0,0,0,0,0
2097139,67,16,1946,4,"male",123,1351,133,108,719,0,175,108,544
2097158,17,1,1996,6,"male",488,674,355,3,16,0,2,3,14
2097162,36,17,1977,7,"male",600,64,49,0,1,0,1,0,0
2097189,21,5,1992,2,"female",410,94,63,279,90,91,32,188,58
2097190,25,25,1988,2,"male",4,0,0,0,0,0,0,0,0
2097219,103,14,1910,10,"male",1357,1585,836,5,14,5,13,0,1
2097223,68,24,1945,11,"female",938,115,52,1315,259,0,36,1315,223
2097248,40,22,1973,10,"female",1383,104,56,24,63,24,26,0,37
2097267,27,18,1986,8,"female",232,498,78,33,62,33,27,0,35
2097273,20,1,1993,1,"male",473,75,64,98,12,98,3,0,9
2097277,49,7,1964,1,"male",159,237,222,0,7,0,4,0,3
2097297,17,20,1996,2,"male",275,74,62,0,0,0,0,0,0
2097312,22,12,1991,5,"male",317,421,278,18,427,18,309,0,118
2097328,17,9,1996,11,"female",500,308,220,446,232,371,153,75,79
2097359,36,23,1977,11,"male",592,49,23,0,4,0,2,0,2
2097384,26,21,1987,11,"male",641,194,120,0,3,0,1,0,2
2097400,20,10,1993,11,"male",408,28,19,0,0,0,0,0,0
2097407,53,23,1960,2,"male",431,149,103,11,11,0,1,11,10
2097421,16,7,1997,11,"male",85,158,134,911,24,911,10,0,14
2097423,17,23,1996,7,"male",487,205,146,3,4,3,0,0,4
2097455,14,12,1999,1,"male",461,1749,1667,21,13,21,9,0,4
2097467,18,5,1995,1,"male",304,496,402,292,85,292,43,0,42
2097474,40,10,1973,3,"female",485,149,74,358,142,358,108,0,34
2097476,41,20,1972,9,"male",390,50,28,1,0,0,0,1,0
2097479,40,9,1973,1,"male",246,31,19,11,1,11,0,0,1
2097491,58,25,1955,9,"female",1147,96,52,48,63,48,48,0,15
2097493,51,10,1962,6,"female",306,114,84,162,652,125,360,37,292
2097518,37,29,1976,9,"female",471,134,42,25,47,4,16,21,31
2097535,29,14,1984,6,"female",439,200,72,27,25,0,0,27,25
2097564,108,29,1905,11,"female",657,348,56,8,8,8,5,0,3
2097579,66,10,1947,4,"female",590,59,46,253,61,0,21,253,40
2097593,25,1,1988,2,"male",466,102,79,18,4,15,4,3,0
2097630,36,16,1977,8,"male",97,53,51,15,4,15,1,0,3
2097633,13,21,2000,3,"female",440,240,152,672,730,458,337,214,393
2097642,34,17,1979,6,"male",155,162,124,11,25,9,15,2,10
2097646,35,17,1978,3,"male",426,21,16,104,3,104,3,0,0
2097682,57,20,1956,5,"female",702,237,152,189,365,160,200,29,165
2097690,103,25,1910,1,"male",1223,262,225,6,29,6,22,0,7
2097702,18,30,1995,3,"male",706,9,5,0,0,0,0,0,0
2097712,23,10,1990,12,"female",1349,20,13,0,0,0,0,0,0
2097733,23,13,1990,2,"male",352,0,0,0,0,0,0,0,0
2097760,28,14,1985,5,"male",504,407,324,143,184,139,70,4,114
2097767,24,9,1989,8,"female",410,363,165,432,158,427,131,5,27
2097769,21,22,1992,1,"female",522,274,208,10,15,10,13,0,2
2097806,53,28,1960,10,"male",889,48,35,2,4,2,2,0,2
2097813,28,7,1985,4,"male",710,214,137,9,7,9,4,0,3
2097859,31,13,1982,8,"female",975,505,218,514,955,283,410,231,545
2097867,68,13,1945,9,"female",1131,25,9,10,7,0,1,10,6
2097904,22,30,1991,7,"male",450,19,14,0,3,0,1,0,2
2097906,32,1,1981,10,"male",444,49,26,4,0,0,0,4,0
2097940,30,4,1983,8,"male",422,103,85,0,0,0,0,0,0
2097953,17,21,1996,8,"male",694,259,161,0,0,0,0,0,0
2097961,18,15,1995,3,"male",436,136,107,1,1,0,0,1,1
2097967,14,21,1999,5,"male",9,10,10,0,0,0,0,0,0
2097989,41,5,1972,5,"female",614,128,83,87,155,87,146,0,9
2097990,57,16,1956,12,"female",1565,542,182,128,633,22,267,106,366
2097995,19,7,1994,6,"female",372,864,155,293,248,293,211,0,37
2098015,57,22,1956,11,"male",662,72,17,15,7,7,5,8,2
2098024,33,12,1980,10,"male",154,61,55,39,3,39,3,0,0
2098028,28,28,1985,11,"female",353,143,116,1,1,1,1,0,0
2098040,27,15,1986,9,"male",1029,93,37,0,0,0,0,0,0
2098057,75,3,1938,12,"female",481,12,7,0,0,0,0,0,0
2098066,19,1,1994,11,"male",792,30,17,0,21,0,12,0,9
2098118,23,15,1990,5,"male",34,37,24,4,8,4,6,0,2
2098167,67,5,1946,10,"female",1327,298,59,212,937,212,465,0,472
2098169,43,11,1970,3,"female",452,20,15,229,29,229,26,0,3
2098185,23,16,1990,12,"female",329,361,173,1,3,1,3,0,0
2098191,32,27,1981,10,"female",833,117,67,156,156,156,140,0,16
2098222,33,1,1980,1,"male",236,85,80,9,1,9,1,0,0
2098263,43,16,1970,9,"male",282,88,6,25,69,0,19,25,50
2098366,108,1,1905,1,"female",865,160,99,53,48,48,39,5,9
2098369,103,31,1910,8,"male",440,134,116,2,3,2,2,0,1
2098376,108,16,1905,10,"male",793,1410,1048,616,359,600,245,16,114
2098380,20,27,1993,9,"female",471,112,55,57,4,1,2,56,2
2098388,22,6,1991,8,"male",473,191,152,18,32,9,26,9,6
2098397,29,1,1984,8,"female",553,75,31,57,133,57,128,0,5
2098409,16,10,1997,2,"female",541,221,109,1010,451,23,64,987,387
2098431,47,22,1966,9,"male",473,10,5,0,0,0,0,0,0
2098478,30,5,1983,9,"female",226,64,35,4,7,4,7,0,0
2098517,18,23,1995,12,"male",346,30,21,8,2,0,0,8,2
2098533,15,30,1998,11,"female",197,61,35,5,1,5,1,0,0
2098537,43,16,1970,4,"male",628,0,0,0,0,0,0,0,0
2098579,33,31,1980,3,"male",594,580,539,3,0,3,0,0,0
2098590,43,16,1970,4,"male",75,32,12,18,17,18,9,0,8
2098595,22,4,1991,10,"male",52,78,40,6,5,6,5,0,0
2098612,49,22,1964,3,"male",752,197,147,211,60,174,22,37,38
2098613,36,11,1977,7,"male",272,40,29,666,506,128,285,538,221
2098651,23,20,1990,10,"male",910,203,96,23,53,23,38,0,15
2098659,19,29,1994,10,"female",243,378,302,659,1137,39,136,620,1001
2098670,32,9,1981,11,"male",299,9,7,3,0,0,0,3,0
2098704,33,13,1980,4,"male",86,7,7,0,0,0,0,0,0
2098711,27,22,1986,3,"male",1170,342,217,13,18,13,12,0,6
2098722,48,4,1965,4,"male",672,41,36,37,5,35,4,2,1
2098759,15,11,1998,6,"male",188,68,13,0,0,0,0,0,0
2098806,15,6,1998,8,"male",528,104,62,4,1,4,1,0,0
2098818,65,18,1948,2,"female",1022,25,5,7,2,4,2,3,0
2098825,102,1,1911,1,"female",636,11,5,1,1,0,1,1,0
2098838,41,8,1972,9,"female",242,5,4,8,5,8,2,0,3
2098857,47,21,1966,12,"male",628,46,35,16,15,0,1,16,14
2098869,16,27,1997,12,"male",144,90,78,9,9,9,7,0,2
2098875,15,20,1998,11,"female",98,130,61,0,0,0,0,0,0
2098883,39,2,1974,3,"male",507,1,1,0,0,0,0,0,0
2098908,27,24,1986,12,"male",134,0,0,0,0,0,0,0,0
2098916,53,12,1960,12,"female",1278,150,69,314,94,311,74,3,20
2098921,30,11,1983,9,"male",1344,77,47,68,19,68,14,0,5
2098928,17,1,1996,2,"female",37,196,24,93,206,54,126,39,80
2098973,30,24,1983,7,"male",354,42,23,167,1,167,0,0,1
2098981,36,25,1977,4,"male",1314,67,17,4,6,2,2,2,4
2099003,87,7,1926,7,"male",311,27,19,11,0,0,0,11,0
2099016,15,1,1998,5,"female",762,245,146,11,0,11,0,0,0
2099070,82,1,1931,8,"female",1772,37,14,1,0,0,0,1,0
2099071,30,8,1983,2,"male",985,88,72,0,1,0,1,0,0
2099076,73,29,1940,2,"male",1276,18,12,145,70,82,54,63,16
2099095,50,1,1963,1,"male",695,49,26,3,0,0,0,3,0
2099102,39,27,1974,12,"male",500,52,16,1,38,1,20,0,18
2099106,23,10,1990,8,"male",298,74,61,2,0,2,0,0,0
2099110,23,27,1990,12,"female",672,49,30,167,0,167,0,0,0
2099120,23,11,1990,7,"female",387,241,137,276,34,273,15,3,19
2099131,23,24,1990,8,"female",843,38,29,781,293,778,203,3,90
2099144,23,18,1990,9,"male",726,140,73,23,19,23,2,0,17
2099149,19,2,1994,5,"female",697,226,179,551,226,236,127,315,99
2099165,17,5,1996,2,"male",403,300,260,137,91,131,69,6,22
2099211,25,1,1988,1,"male",634,18,10,1,0,1,0,0,0
2099226,68,23,1945,7,"female",1884,280,137,73,105,68,45,5,60
2099227,20,6,1993,3,"female",702,30,10,11,0,11,0,0,0
2099256,18,30,1995,7,"male",544,1045,835,66,51,55,14,11,37
2099277,61,12,1952,12,"male",206,94,92,0,0,0,0,0,0
2099292,17,28,1996,2,"female",415,206,54,32,8,3,3,29,5
2099312,28,19,1985,7,"male",47,8,8,1,1,1,1,0,0
2099314,24,2,1989,7,"male",602,78,33,18,0,18,0,0,0
2099322,65,18,1948,3,"male",819,145,72,3407,1289,0,124,3407,1165
2099355,20,10,1993,11,"female",383,8,8,0,0,0,0,0,0
2099361,27,10,1986,12,"male",299,268,185,8,100,8,33,0,67
2099384,23,13,1990,6,"male",646,268,160,6,86,6,80,0,6
2099407,20,2,1993,2,"female",633,674,324,138,260,61,92,77,168
2099408,71,10,1942,4,"male",845,36,21,12,10,10,9,2,1
2099426,19,7,1994,3,"male",280,523,161,69,9,14,5,55,4
2099433,21,28,1992,12,"female",83,16,15,4,3,4,2,0,1
2099438,80,1,1933,1,"male",582,101,50,1,0,1,0,0,0
2099491,36,3,1977,2,"male",88,17,8,17,3,17,3,0,0
2099530,56,19,1957,6,"female",251,264,69,125,30,0,0,125,30
2099540,43,23,1970,7,"female",482,28,19,75,35,51,26,24,9
2099548,108,18,1905,3,"female",272,48,29,1,0,1,0,0,0
2099550,48,20,1965,11,"male",500,20,9,0,1,0,1,0,0
2099561,16,18,1997,5,"female",282,3792,581,2259,4788,1994,3587,265,1201
2099573,21,6,1992,6,"male",259,174,114,71,55,71,38,0,17
2099593,15,18,1998,3,"male",421,3,2,0,0,0,0,0,0
2099624,33,18,1980,10,"male",991,18,6,22,0,22,0,0,0
2099634,18,1,1995,1,"female",29,25,9,1,29,1,29,0,0
2099649,26,1,1987,6,"female",692,201,49,36,93,36,70,0,23
2099650,16,16,1997,5,"male",230,25,16,17,5,17,3,0,2
2099657,25,9,1988,2,"female",370,641,132,26,174,26,138,0,36
2099675,24,2,1989,3,"female",474,4,2,0,0,0,0,0,0
2099681,52,1,1961,10,"male",235,55,41,10,30,5,22,5,8
2099690,52,1,1961,8,"male",632,20,15,56,11,0,2,56,9
2099693,23,8,1990,5,"female",99,1,0,19,1,6,1,13,0
2099703,25,6,1988,12,"male",214,0,0,0,0,0,0,0,0
2099711,41,26,1972,3,"female",340,37,18,42,74,42,55,0,19
2099720,18,6,1995,2,"female",0,0,0,4,1,0,1,4,0
2099731,44,1,1969,8,"male",485,36,19,1,0,0,0,1,0
2099749,52,6,1961,2,"male",565,15,3,1,0,0,0,1,0
2099756,49,12,1964,3,"male",139,21,3,0,0,0,0,0,0
2099766,23,2,1990,1,"male",268,1,1,29,2,29,1,0,1
2099782,27,1,1986,1,"male",324,91,60,6,0,0,0,6,0
2099806,25,1,1988,4,"female",328,9,5,22,0,6,0,16,0
2099821,16,16,1997,4,"female",435,633,386,131,38,131,22,0,16
2099823,37,13,1976,5,"male",603,48,20,55,24,21,19,34,5
2099869,36,13,1977,5,"male",475,149,46,2,0,2,0,0,0
2099877,17,25,1996,10,"male",707,32,19,3,23,3,20,0,3
2099884,26,1,1987,1,"male",366,8,2,0,0,0,0,0,0
2099888,16,17,1997,9,"female",357,42,37,0,0,0,0,0,0
2099893,53,4,1960,10,"male",941,16,5,0,1,0,1,0,0
2099952,36,30,1977,12,"female",259,129,114,210,1,210,1,0,0
2099956,16,8,1997,8,"male",566,235,149,33,0,33,0,0,0
2099958,70,3,1943,8,"female",1078,591,195,7,9,7,9,0,0
2099973,45,25,1968,4,"male",13,29,28,0,30,0,15,0,15
2100003,38,7,1975,8,"female",276,97,65,21,64,21,49,0,15
2100005,35,15,1978,4,"female",1010,111,72,128,156,128,120,0,36
2100009,15,22,1998,7,"male",541,530,367,23,1,16,0,7,1
2100023,51,5,1962,7,"male",612,33,24,73,3,69,3,4,0
2100045,28,8,1985,10,"female",1629,348,208,857,961,620,464,237,497
2100048,24,5,1989,10,"male",522,124,28,14,12,14,8,0,4
2100067,83,14,1930,4,"female",602,46,15,96,25,2,5,94,20
2100109,24,26,1989,4,"male",467,63,33,0,3,0,2,0,1
2100112,102,2,1911,5,"male",1926,230,147,415,620,397,287,18,333
2100132,30,18,1983,9,"female",399,190,104,0,2,0,0,0,2
2100137,32,1,1981,1,"female",151,19,9,480,427,477,131,3,296
2100164,47,3,1966,2,"female",35,52,30,4,9,2,6,2,3
2100177,23,6,1990,3,"male",269,127,87,0,1,0,0,0,1
2100184,38,17,1975,12,"male",1154,6,3,0,0,0,0,0,0
2100191,20,13,1993,3,"female",205,279,78,45,314,44,283,1,31
2100201,103,10,1910,10,"male",442,169,135,64,41,64,28,0,13
2100254,52,21,1961,2,"female",1382,71,47,0,0,0,0,0,0
2100279,38,14,1975,5,"female",424,87,42,63,100,54,65,9,35
2100307,25,14,1988,11,"male",395,70,56,4,0,0,0,4,0
2100313,25,16,1988,6,"male",530,211,143,6,0,6,0,0,0
2100374,24,7,1989,3,"male",136,33,32,6,5,6,5,0,0
2100381,19,17,1994,2,"female",134,15,13,1,0,1,0,0,0
2100385,103,1,1910,10,"male",875,418,293,99,165,1,36,98,129
2100389,17,20,1996,5,"male",218,5,4,0,0,0,0,0,0
2100395,26,24,1987,11,"female",168,5,4,0,0,0,0,0,0
2100410,24,5,1989,4,"female",571,41,21,0,3,0,3,0,0
2100430,25,11,1988,2,"male",166,90,77,2,0,2,0,0,0
2100431,50,20,1963,6,"female",396,16,8,7,12,0,2,7,10
2100436,61,7,1952,6,"female",796,187,95,36,24,0,1,36,23
2100447,51,24,1962,10,"female",136,48,33,161,145,0,100,161,45
2100453,29,5,1984,8,"female",495,345,283,6,19,6,7,0,12
2100477,64,23,1949,11,"male",2022,62,44,0,0,0,0,0,0
2100478,39,14,1974,4,"male",316,38,15,6,1,0,1,6,0
2100484,75,11,1938,2,"male",398,36,26,34,7,34,6,0,1
2100486,21,20,1992,11,"female",317,58,34,322,132,322,119,0,13
2100522,30,23,1983,12,"male",16,8,6,0,0,0,0,0,0
2100534,36,6,1977,7,"male",203,3,0,5,0,4,0,1,0
2100544,24,25,1989,11,"female",119,113,40,26,10,26,7,0,3
2100547,34,11,1979,4,"male",1254,367,289,4,25,4,8,0,17
2100574,50,13,1963,7,"male",1986,12,6,0,0,0,0,0,0
2100589,20,23,1993,8,"male",287,100,46,0,0,0,0,0,0
2100599,42,31,1971,7,"male",310,2,2,0,0,0,0,0,0
2100636,15,10,1998,5,"female",341,1225,209,1,0,1,0,0,0
2100638,22,24,1991,2,"male",179,2,0,0,0,0,0,0,0
2100642,23,10,1990,10,"male",445,3,1,3,11,0,9,3,2
2100697,43,26,1970,10,"male",562,232,22,4,82,3,29,1,53
2100710,57,29,1956,8,"female",425,108,52,32,22,0,2,32,20
2100723,42,17,1971,7,"male",425,183,122,9,8,9,8,0,0
2100728,19,28,1994,5,"male",1037,1836,1030,147,125,137,101,10,24
2100732,53,18,1960,2,"female",1544,71,26,92,41,72,19,20,22
2100736,23,11,1990,8,"female",443,59,46,27,17,27,15,0,2
2100738,25,28,1988,2,"male",49,3,3,245,0,243,0,2,0
2100743,29,11,1984,11,"male",149,62,50,49,12,49,9,0,3
2100792,34,19,1979,3,"female",560,119,25,76,152,76,106,0,46
2100808,53,23,1960,3,"male",24,20,19,1,0,1,0,0,0
2100809,50,17,1963,9,"male",1355,102,51,8,34,6,15,2,19
2100823,20,1,1993,8,"male",474,921,857,644,75,4,59,640,16
2100825,49,17,1964,1,"female",299,0,0,0,0,0,0,0,0
2100852,40,1,1973,5,"male",365,181,133,0,0,0,0,0,0
2100857,54,15,1959,10,"female",1391,29,9,0,0,0,0,0,0
2100890,16,12,1997,4,"male",630,258,208,24,8,0,2,24,6
2100908,41,4,1972,8,"male",316,20,14,7,8,5,4,2,4
2100912,15,14,1998,1,"male",357,15,9,36,6,0,0,36,6
2100914,42,21,1971,9,"female",520,123,88,3,0,3,0,0,0
2100928,51,12,1962,5,"female",95,74,55,124,113,25,48,99,65
2100931,42,9,1971,10,"male",347,186,167,4,26,4,21,0,5
2100967,18,4,1995,5,"female",70,25,16,5,4,5,4,0,0
2100985,22,9,1991,10,"male",387,71,30,0,0,0,0,0,0
2100986,69,17,1944,10,"male",444,8,6,8,1,8,1,0,0
2100993,23,7,1990,10,"female",125,119,97,636,215,329,153,307,62
2101039,23,1,1990,1,"male",296,109,71,100,5,100,3,0,2
2101059,28,5,1985,5,"male",575,60,33,0,2,0,1,0,1
2101204,15,17,1998,3,"male",268,363,63,6,12,6,11,0,1
2101214,16,23,1997,12,"male",195,57,13,3,0,3,0,0,0
2101247,56,28,1957,10,"female",1377,32,22,113,68,95,64,18,4
2101298,33,25,1980,10,"male",555,1,1,0,0,0,0,0,0
2101308,24,17,1989,12,"female",117,39,36,0,0,0,0,0,0
2101321,27,7,1986,3,"male",207,67,53,10,7,10,6,0,1
2101322,42,5,1971,7,"female",23,3,3,0,0,0,0,0,0
2101350,39,18,1974,12,"male",532,24,9,28,2,28,2,0,0
2101407,24,20,1989,5,"female",232,108,85,38,11,38,8,0,3
2101422,33,9,1980,9,"female",798,148,76,18,35,3,23,15,12
2101429,57,2,1956,6,"female",170,50,22,814,176,814,128,0,48
2101435,106,30,1907,4,"male",34,5,1,5,6,0,3,5,3
2101444,71,20,1942,7,"male",191,98,62,22,66,0,35,22,31
2101446,34,22,1979,2,"male",142,36,16,0,0,0,0,0,0
2101448,63,17,1950,7,"female",575,89,81,2,0,0,0,2,0
2101473,40,15,1973,1,"male",203,172,130,0,3,0,2,0,1
2101475,23,1,1990,4,"male",325,39,34,0,0,0,0,0,0
2101492,24,28,1989,6,"male",196,31,26,45,4,45,2,0,2
2101504,60,25,1953,9,"female",529,51,17,1,7,1,6,0,1
2101524,21,23,1992,11,"male",296,59,40,184,19,183,12,1,7
2101538,30,1,1983,9,"male",1029,16,4,0,0,0,0,0,0
2101552,37,9,1976,7,"male",121,64,35,90,60,29,25,61,35
2101587,25,1,1988,1,"male",70,37,19,306,111,306,83,0,28
2101598,51,24,1962,10,"female",1344,1466,1036,2863,1338,1894,522,969,816
2101635,18,24,1995,2,"male",484,126,96,0,3,0,1,0,2
2101641,32,2,1981,8,"male",321,0,0,0,0,0,0,0,0
2101654,72,22,1941,7,"female",224,25,21,6,4,6,3,0,1
2101660,58,4,1955,1,"male",500,93,56,0,1,0,1,0,0
2101663,108,1,1905,1,"female",647,579,80,157,121,157,95,0,26
2101664,42,26,1971,2,"female",452,23,20,16,50,13,43,3,7
2101666,55,3,1958,12,"male",538,169,132,279,35,279,3,0,32
2101668,23,6,1990,3,"male",370,5,3,0,0,0,0,0,0
2101703,24,8,1989,12,"female",514,32,8,1,0,0,0,1,0
2101719,25,31,1988,12,"female",535,89,50,72,34,50,29,22,5
2101757,71,14,1942,12,"female",168,56,39,0,0,0,0,0,0
2101768,21,15,1992,6,"male",600,41,35,2,0,2,0,0,0
2101795,19,30,1994,4,"male",351,70,35,10,1,10,1,0,0
2101823,39,20,1974,10,"female",589,1,0,10,5,9,5,1,0
2101829,35,6,1978,8,"male",566,169,55,188,89,186,22,2,67
2101914,17,17,1996,2,"female",270,524,419,2477,1122,44,485,2433,637
2101940,29,5,1984,1,"male",279,10,8,0,0,0,0,0,0
2101947,34,22,1979,11,"male",66,12,10,0,0,0,0,0,0
2101948,35,6,1978,5,"male",346,42,33,0,0,0,0,0,0
2101959,20,20,1993,2,"male",735,35,21,1,1,1,0,0,1
2101965,34,13,1979,2,"male",37,28,16,129,0,129,0,0,0
2101984,95,6,1918,10,"male",1720,535,302,221,256,106,176,115,80
2101994,16,13,1997,5,"male",301,162,107,68,9,66,2,2,7
2102017,20,9,1993,8,"male",825,589,498,15,10,2,3,13,7
2102059,102,4,1911,5,"male",1908,1179,644,1,0,1,0,0,0
2102060,43,8,1970,6,"male",1472,52,7,0,3,0,3,0,0
2102090,47,11,1966,1,"female",1035,236,124,664,630,659,210,5,420
2102098,45,2,1968,11,"male",752,44,20,1,1,1,1,0,0
2102128,62,25,1951,11,"male",369,19,13,7,0,7,0,0,0
2102155,27,7,1986,11,"male",460,74,47,0,0,0,0,0,0
2102182,103,14,1910,1,"female",2277,563,435,295,213,256,84,39,129
2102183,27,18,1986,4,"male",607,61,42,1,6,0,4,1,2
2102195,22,30,1991,12,"female",444,126,91,24,23,20,9,4,14
2102219,50,17,1963,1,"female",348,22,16,2,8,0,6,2,2
2102356,22,11,1991,6,"female",1740,552,288,24,17,24,15,0,2
2102357,43,7,1970,7,"male",281,36,23,32,1,0,0,32,1
2102360,105,1,1908,1,"male",1345,1119,840,84,91,28,42,56,49
2102374,16,4,1997,4,"female",408,565,486,9,19,9,5,0,14
2102379,25,30,1988,10,"female",7,8,6,6,7,6,5,0,2
2102384,101,27,1912,10,"male",2340,151,30,196,153,101,80,95,73
2102387,47,14,1966,9,"male",1243,151,88,247,37,213,10,34,27
2102404,26,12,1987,2,"male",584,495,374,555,2029,69,702,486,1327
2102408,18,14,1995,1,"male",290,34,7,9,0,9,0,0,0
2102431,27,5,1986,2,"male",260,132,106,0,0,0,0,0,0
2102459,31,9,1982,10,"female",1884,994,542,2120,2373,391,1825,1729,548
2102469,85,19,1928,11,"male",1522,210,23,5,0,5,0,0,0
2102483,19,24,1994,12,"male",182,241,201,13,23,13,20,0,3
2102490,23,30,1990,8,"male",937,246,132,67,361,67,271,0,90
2102499,19,1,1994,12,"male",123,66,58,3,1,3,1,0,0
2102541,15,1,1998,5,"female",294,385,81,0,2,0,1,0,1
2102560,58,4,1955,11,"female",592,77,41,0,1,0,1,0,0
2102577,42,2,1971,8,"female",1999,439,323,284,504,234,363,50,141
2102604,25,1,1988,1,"male",237,26,20,1,0,1,0,0,0
2102659,57,19,1956,12,"male",1578,87,24,0,0,0,0,0,0
2102660,19,12,1994,5,"female",629,62,11,0,13,0,6,0,7
2102663,72,30,1941,12,"female",792,42,34,197,28,197,25,0,3
2102770,36,18,1977,5,"male",16,3,0,0,0,0,0,0,0
2102774,59,28,1954,6,"male",1071,34,17,3,2,3,2,0,0
2102780,77,24,1936,12,"female",731,26,13,1,8,0,4,1,4
2102785,18,30,1995,3,"male",88,9,6,0,0,0,0,0,0
2102800,33,19,1980,11,"male",37,30,30,4,20,4,14,0,6
2102812,88,11,1925,11,"female",434,171,99,25,8,25,5,0,3
2102836,23,10,1990,10,"female",583,246,89,72,35,71,32,1,3
2102846,17,8,1996,3,"male",450,170,72,21,18,21,15,0,3
2102848,35,10,1978,4,"female",480,101,63,320,221,304,191,16,30
2102867,52,21,1961,11,"female",1718,77,48,245,92,167,40,78,52
2102886,100,29,1913,1,"male",257,108,73,26,6,26,6,0,0
2102889,20,4,1993,7,"female",206,184,135,61,65,46,56,15,9
2102891,45,4,1968,5,"male",869,7,6,0,2,0,0,0,2
2102914,15,2,1998,4,"female",503,376,225,1018,232,940,210,78,22
2102930,15,6,1998,1,"female",680,2310,365,816,323,567,284,249,39
2102949,41,25,1972,3,"male",297,54,29,5,0,5,0,0,0
2102955,54,11,1959,6,"female",374,74,48,1159,59,613,26,546,33
2102959,63,1,1950,10,"male",456,75,52,76,35,0,14,76,21
2102979,31,31,1982,12,"male",413,3,0,6,13,0,4,6,9
2102999,35,30,1978,12,"male",129,18,17,0,0,0,0,0,0
2103044,23,8,1990,8,"male",695,820,486,1078,92,1078,92,0,0
2103062,20,17,1993,9,"male",602,95,66,9,5,9,5,0,0
2103073,20,12,1993,2,"female",461,6,3,0,0,0,0,0,0
2103101,33,10,1980,4,"female",613,6,3,0,0,0,0,0,0
2103109,18,25,1995,11,"female",823,135,68,82,128,78,106,4,22
2103123,27,1,1986,10,"male",159,51,28,6,29,6,10,0,19
2103136,39,29,1974,9,"male",135,2,2,0,0,0,0,0,0
2103163,94,18,1919,6,"female",784,199,104,215,129,90,61,125,68
2103175,28,19,1985,4,"female",653,143,46,200,181,200,181,0,0
2103185,18,17,1995,8,"male",403,308,47,1,13,1,11,0,2
2103193,30,1,1983,8,"male",208,150,124,0,9,0,8,0,1
2103217,28,22,1985,1,"male",203,68,58,0,0,0,0,0,0
2103218,17,25,1996,7,"female",104,3,1,5,18,0,2,5,16
2103239,29,14,1984,8,"male",339,4,3,5,0,5,0,0,0
2103256,43,20,1970,9,"male",478,20,7,243,15,243,12,0,3
2103324,17,17,1996,4,"male",65,116,104,0,3,0,1,0,2
2103328,19,4,1994,1,"male",348,249,133,0,35,0,29,0,6
2103388,16,29,1997,3,"male",232,228,115,0,0,0,0,0,0
2103398,35,22,1978,6,"female",506,24,3,1,1,0,0,1,1
2103414,108,30,1905,9,"female",136,20,15,97,55,9,9,88,46
2103422,33,31,1980,1,"male",877,216,100,1,0,1,0,0,0
2103465,66,25,1947,8,"male",798,94,67,45,1,45,1,0,0
2103471,18,18,1995,5,"male",220,10,5,0,0,0,0,0,0
2103491,17,29,1996,12,"female",462,46,28,1363,1134,97,256,1266,878
2103497,46,4,1967,1,"male",500,33,29,0,0,0,0,0,0
2103504,59,1,1954,10,"female",454,82,51,170,29,0,5,170,24
2103526,29,1,1984,1,"male",596,22,14,1,4,0,2,1,2
2103573,55,23,1958,10,"female",94,40,25,5,30,5,12,0,18
2103581,46,8,1967,7,"female",138,47,26,150,47,150,42,0,5
2103599,108,28,1905,5,"male",1074,150,110,107,9,95,7,12,2
2103649,18,10,1995,11,"male",875,98,52,10,2,10,2,0,0
2103651,41,17,1972,8,"female",188,0,0,0,0,0,0,0,0
2103664,24,7,1989,6,"female",180,165,118,682,63,682,43,0,20
2103669,24,25,1989,11,"male",305,83,74,7,1,7,0,0,1
2103673,104,23,1909,11,"male",1817,275,91,205,685,204,352,1,333
2103738,35,10,1978,5,"female",260,9,4,12,1,12,1,0,0
2103744,105,1,1908,8,NA,2160,16,7,65,22,37,16,28,6
2103754,55,7,1958,4,"male",374,17,4,2,5,0,5,2,0
2103783,78,25,1935,5,"female",1015,9,8,14,1,0,0,14,1
2103801,103,28,1910,2,"female",979,75,52,0,0,0,0,0,0
2103805,21,1,1992,11,"male",583,9,3,0,0,0,0,0,0
2103819,20,13,1993,10,"female",172,121,46,126,58,126,45,0,13
2103822,31,10,1982,9,"female",394,275,174,112,22,112,19,0,3
2103827,16,1,1997,9,"female",164,574,411,16,38,16,35,0,3
2103828,108,19,1905,12,"male",1202,69,39,3203,3454,2836,976,367,2478
2103853,16,1,1997,9,"male",216,27,11,0,0,0,0,0,0
2103889,29,31,1984,5,"female",842,105,44,1,0,1,0,0,0
2103903,15,16,1998,4,"female",613,1010,500,2070,2471,200,965,1870,1506
2103920,22,30,1991,1,"male",402,112,83,9,28,1,9,8,19
2103921,55,5,1958,7,"male",112,11,8,9,1,9,1,0,0
2103929,62,18,1951,11,"female",125,20,14,0,2,0,1,0,1
2103956,29,22,1984,11,"female",343,176,96,27,68,27,41,0,27
2103958,28,27,1985,10,"female",42,32,22,30,223,30,155,0,68
2104013,18,27,1995,11,"female",564,173,124,0,1,0,1,0,0
2104021,17,8,1996,2,"male",368,117,108,0,1,0,1,0,0
2104066,61,6,1952,7,"female",743,42,36,378,129,0,100,378,29
2104071,38,29,1975,1,"male",320,82,78,1,0,0,0,1,0
2104073,51,8,1962,2,"male",992,32,14,11,6,11,5,0,1
2104080,61,19,1952,3,"male",478,41,23,19,1,0,1,19,0
2104083,29,30,1984,11,"male",380,83,66,0,0,0,0,0,0
2104109,18,25,1995,10,"female",767,145,29,22,13,14,6,8,7
2104132,23,21,1990,1,"male",581,919,763,3,44,3,44,0,0
2104162,26,1,1987,12,"female",333,183,142,116,93,33,30,83,63
2104179,36,2,1977,8,"female",33,11,11,0,0,0,0,0,0
2104191,23,10,1990,10,"female",239,109,79,43,39,43,39,0,0
2104204,63,13,1950,8,"female",1466,126,78,58,85,56,37,2,48
2104215,15,14,1998,7,"male",425,331,285,0,0,0,0,0,0
2104233,44,1,1969,3,"male",86,1,0,12,0,0,0,12,0
2104238,42,22,1971,5,"male",382,45,39,91,18,91,18,0,0
2104250,103,8,1910,11,"male",412,258,145,21,0,21,0,0,0
2104258,19,18,1994,4,"female",451,136,77,158,48,158,35,0,13
2104275,20,23,1993,8,"male",969,355,242,1,0,1,0,0,0
2104298,71,24,1942,12,"female",83,2,2,106,27,104,27,2,0
2104340,36,1,1977,1,"male",491,103,39,1,9,1,4,0,5
2104344,53,12,1960,5,"female",1402,70,49,1437,187,1437,129,0,58
2104354,23,23,1990,3,"male",231,89,49,0,0,0,0,0,0
2104357,22,13,1991,8,"female",104,55,33,4,27,2,11,2,16
2104365,45,16,1968,5,"male",552,59,42,0,1,0,1,0,0
2104374,47,9,1966,8,"male",107,42,21,1,0,1,0,0,0
2104400,29,1,1984,8,"male",104,98,93,9,7,9,7,0,0
2104503,61,18,1952,9,"female",1099,55,28,63,4,58,3,5,1
2104527,64,11,1949,2,"female",129,10,8,1,0,1,0,0,0
2104554,74,3,1939,10,"female",236,51,40,189,35,0,14,189,21
2104562,31,14,1982,9,"male",364,145,56,0,12,0,6,0,6
2104566,45,11,1968,1,"male",989,110,78,0,28,0,23,0,5
2104570,21,11,1992,1,"male",231,35,4,2,2,2,1,0,1
2104653,15,14,1998,6,"female",321,610,462,567,284,68,199,499,85
2104657,53,9,1960,4,"female",357,149,27,482,253,482,116,0,137
2104672,25,22,1988,11,"male",735,57,32,4,10,4,10,0,0
2104682,15,11,1998,10,"female",386,462,350,142,19,101,12,41,7
2104693,58,27,1955,10,"female",522,57,47,53,23,53,12,0,11
2104701,53,24,1960,6,"female",922,216,112,1296,626,4,262,1292,364
2104769,15,7,1998,11,"female",173,357,75,87,112,80,68,7,44
2104780,35,19,1978,8,"male",366,8,5,0,0,0,0,0,0
2104786,90,11,1923,1,"male",726,106,85,256,155,256,147,0,8
2104820,54,1,1959,1,"male",702,29,19,1,5,0,2,1,3
2104821,17,29,1996,8,"male",94,27,23,71,3,59,0,12,3
2104825,26,1,1987,1,"male",271,75,41,3,0,3,0,0,0
2104879,49,8,1964,10,"male",283,69,18,552,368,552,290,0,78
2104903,60,19,1953,12,"male",434,363,269,253,226,253,129,0,97
2104919,63,11,1950,11,"female",660,37,23,8,4,0,2,8,2
2104935,72,4,1941,11,"male",1575,12,4,0,0,0,0,0,0
2104945,22,10,1991,4,"male",201,183,148,43,0,43,0,0,0
2104953,18,15,1995,10,"male",25,2,2,65,2,2,1,63,1
2105004,81,30,1932,12,"female",631,32,21,1,3,1,3,0,0
2105043,47,10,1966,5,"female",394,20,14,239,6,238,3,1,3
2105050,18,23,1995,9,"male",144,32,22,0,0,0,0,0,0
2105052,37,15,1976,5,"female",308,25,18,0,0,0,0,0,0
2105059,53,12,1960,7,"male",739,490,280,22,178,0,39,22,139
2105118,47,22,1966,8,"female",472,83,73,17,9,17,5,0,4
2105169,33,1,1980,1,"male",138,152,107,5,6,5,5,0,1
2105176,53,9,1960,9,"female",701,59,15,30,122,30,108,0,14
2105207,49,27,1964,4,"female",1299,125,65,683,476,4,170,679,306
2105244,45,25,1968,2,"female",501,81,39,0,0,0,0,0,0
2105257,24,26,1989,12,"male",764,0,0,0,0,0,0,0,0
2105263,28,9,1985,9,"male",954,39,28,66,37,64,30,2,7
2105294,23,1,1990,1,"male",369,131,56,3,23,3,10,0,13
2105295,44,6,1969,6,"female",505,75,6,0,1,0,1,0,0
2105307,17,8,1996,8,"male",168,17,15,0,0,0,0,0,0
2105311,23,1,1990,1,"male",602,440,170,8,16,0,10,8,6
2105336,31,9,1982,11,"female",376,2,2,0,0,0,0,0,0
2105344,19,12,1994,12,"male",432,1011,821,1,3,1,3,0,0
2105375,33,1,1980,1,"male",266,216,47,21,45,21,12,0,33
2105379,24,22,1989,7,"female",1305,284,184,6,62,6,46,0,16
2105400,74,14,1939,7,"male",26,2,2,0,0,0,0,0,0
2105419,19,2,1994,3,"male",568,39,15,13,4,8,4,5,0
2105454,30,2,1983,7,"male",579,76,18,8,8,8,5,0,3
2105461,69,21,1944,11,"male",752,20,4,0,0,0,0,0,0
2105482,59,19,1954,6,"male",684,954,629,671,499,671,297,0,202
2105489,23,9,1990,1,"male",113,38,23,55,17,31,6,24,11
2105505,42,19,1971,1,"male",59,33,20,0,9,0,5,0,4
2105542,14,9,1999,10,"male",721,64,8,2,0,2,0,0,0
2105572,20,13,1993,1,"male",959,4499,2501,1720,5895,232,4226,1488,1669
2105608,25,4,1988,10,"male",430,16,11,0,0,0,0,0,0
2105618,48,21,1965,1,"female",462,48,16,228,57,228,44,0,13
2105639,23,24,1990,4,"male",747,187,94,187,168,143,87,44,81
2105647,18,20,1995,2,"male",496,178,66,113,50,113,42,0,8
2105661,33,27,1980,11,"female",222,4,1,6,12,3,0,3,12
2105664,26,7,1987,8,"male",767,292,104,11,8,11,8,0,0
2105674,91,21,1922,1,"female",1281,421,133,10,108,10,76,0,32
2105695,22,8,1991,5,"female",334,7,5,8,1,8,0,0,1
2105775,108,1,1905,1,"male",94,12,9,64,5,0,0,64,5
2105795,15,2,1998,7,"male",119,30,5,2,0,2,0,0,0
2105863,25,8,1988,7,"female",559,337,153,95,20,0,17,95,3
2105886,25,25,1988,12,"male",586,206,101,0,2,0,2,0,0
2105913,26,15,1987,1,"male",27,2,2,1,0,0,0,1,0
2105926,20,6,1993,8,"male",376,378,324,16,10,16,6,0,4
2105964,22,30,1991,7,"female",451,119,41,4,4,4,4,0,0
2105985,37,30,1976,9,"male",256,1,0,0,0,0,0,0,0
2106002,13,25,2000,1,"male",165,164,146,380,424,365,356,15,68
2106044,60,29,1953,12,"female",404,580,505,245,22,241,18,4,4
2106062,21,1,1992,1,"male",211,189,98,7,10,7,7,0,3
2106083,59,11,1954,11,"male",742,55,44,0,0,0,0,0,0
2106086,37,27,1976,6,"male",443,132,78,353,0,353,0,0,0
2106104,15,7,1998,8,"female",454,57,42,0,4,0,4,0,0
2106115,26,2,1987,2,"female",317,213,52,0,0,0,0,0,0
2106153,22,20,1991,12,"male",286,194,117,8,7,7,4,1,3
2106154,59,22,1954,7,"female",1651,76,27,328,110,0,68,328,42
2106173,20,2,1993,11,"female",219,383,242,2044,1268,2044,957,0,311
2106178,16,27,1997,12,"male",49,8,6,1,0,1,0,0,0
2106179,32,23,1981,1,"female",282,93,70,183,139,173,96,10,43
2106197,25,8,1988,8,"male",434,65,58,4,0,0,0,4,0
2106198,22,26,1991,7,"female",410,21,7,125,35,125,11,0,24
2106237,25,8,1988,8,"male",74,8,6,5,2,5,1,0,1
2106271,23,15,1990,6,"male",411,34,31,535,0,535,0,0,0
2106300,108,3,1905,7,"female",547,196,65,27,16,27,15,0,1
2106307,22,18,1991,1,"male",203,38,11,1,41,0,12,1,29
2106309,45,25,1968,8,"male",586,30,22,6,0,3,0,3,0
2106322,29,9,1984,5,"female",1409,101,33,2,7,2,3,0,4
2106326,26,25,1987,8,"male",1252,216,122,3,5,3,3,0,2
2106383,33,10,1980,1,"female",174,37,19,0,4,0,0,0,4
2106386,30,28,1983,8,"male",513,448,372,136,246,136,201,0,45
2106393,54,1,1959,1,"female",870,0,0,0,0,0,0,0,0
2106450,16,8,1997,7,"female",228,115,87,0,0,0,0,0,0
2106454,22,22,1991,5,"male",701,253,202,0,1,0,1,0,0
2106455,57,23,1956,7,"female",1643,168,47,117,538,44,302,73,236
2106477,68,27,1945,5,"male",338,84,33,8,0,6,0,2,0
2106517,20,19,1993,3,"male",414,230,139,1,0,0,0,1,0
2106529,32,9,1981,1,"male",67,80,51,420,278,420,245,0,33
2106540,40,27,1973,7,"male",331,60,36,60,19,10,13,50,6
2106548,15,14,1998,5,"male",490,72,32,0,0,0,0,0,0
2106578,84,17,1929,2,"female",210,40,26,124,28,0,1,124,27
2106631,26,19,1987,12,"female",49,256,206,566,96,249,18,317,78
2106673,21,19,1992,8,"male",749,264,125,12,13,9,10,3,3
2106734,113,14,1900,1,"female",1820,84,40,40,2,40,2,0,0
2106742,37,13,1976,11,"female",230,71,50,9,1,9,1,0,0
2106756,39,8,1974,4,"female",646,26,18,0,0,0,0,0,0
2106763,34,7,1979,9,"male",340,39,33,6,2,0,1,6,1
2106775,49,15,1964,6,"female",1206,55,34,31,8,31,4,0,4
2106776,21,4,1992,6,"male",1103,2,2,0,0,0,0,0,0
2106794,14,21,1999,11,"male",73,14,11,0,0,0,0,0,0
2106798,22,26,1991,3,"male",407,75,55,0,0,0,0,0,0
2106820,18,21,1995,2,"female",233,15,11,104,6,68,4,36,2
2106824,41,24,1972,8,"male",320,32,13,8,0,8,0,0,0
2106924,33,3,1980,7,"female",194,63,36,2463,105,2463,60,0,45
2106932,40,26,1973,4,"male",94,44,29,123,20,123,20,0,0
2106946,51,6,1962,1,"female",509,370,293,638,703,625,501,13,202
2106964,60,31,1953,3,"male",983,14,11,6,3,0,1,6,2
2106994,37,27,1976,11,"male",101,81,45,67,217,35,167,32,50
2107019,40,25,1973,6,"male",143,14,5,13,10,13,8,0,2
2107035,22,1,1991,1,"male",295,35,18,102,82,102,70,0,12
2107044,74,10,1939,8,"female",1749,147,96,465,334,465,258,0,76
2107052,24,23,1989,2,"male",198,38,13,28,3,28,3,0,0
2107060,57,20,1956,7,"female",739,42,32,50,0,0,0,50,0
2107074,27,6,1986,6,"male",399,1101,881,112,84,112,59,0,25
2107078,20,10,1993,3,"male",396,356,312,42,5,42,5,0,0
2107087,40,11,1973,5,"male",236,0,0,25,0,25,0,0,0
2107100,23,21,1990,9,"male",549,247,207,41,29,0,2,41,27
2107105,35,29,1978,1,"male",572,85,62,4,5,1,2,3,3
2107130,100,23,1913,8,"female",1689,1222,175,788,1062,782,681,6,381
2107142,26,1,1987,9,"male",44,0,0,0,0,0,0,0,0
2107148,14,21,1999,11,"male",64,81,35,2,0,2,0,0,0
2107158,44,25,1969,4,"male",345,46,14,0,1,0,0,0,1
2107176,22,16,1991,12,"male",39,12,8,0,0,0,0,0,0
2107179,20,27,1993,9,"female",775,494,168,20,14,17,12,3,2
2107212,27,26,1986,8,"male",29,28,28,42,24,42,3,0,21
2107220,20,29,1993,12,"female",306,157,49,580,604,358,512,222,92
2107227,57,5,1956,5,"male",1734,67,28,8,0,0,0,8,0
2107244,27,20,1986,8,"male",71,41,37,1,32,1,27,0,5
2107324,31,23,1982,3,"female",408,1,1,0,0,0,0,0,0
2107329,23,29,1990,10,"male",27,8,5,24,0,24,0,0,0
2107344,23,25,1990,8,"male",495,2,1,12,21,0,2,12,19
2107381,16,6,1997,1,"male",191,4,4,2,1,2,1,0,0
2107422,30,3,1983,9,"male",659,241,177,2,6,2,4,0,2
2107432,19,30,1994,8,"male",13,17,16,10,7,10,6,0,1
2107497,53,12,1960,7,"female",1363,117,68,807,133,504,67,303,66
2107532,21,22,1992,9,"male",612,149,32,3,1,3,1,0,0
2107538,50,19,1963,4,"female",1558,704,461,4314,429,4314,364,0,65
2107554,108,29,1905,7,"female",2396,564,236,47,272,47,237,0,35
2107569,20,9,1993,9,"male",524,488,60,5,35,5,17,0,18
2107588,67,14,1946,10,"male",518,16,6,0,0,0,0,0,0
2107633,30,3,1983,5,"female",245,158,98,0,0,0,0,0,0
2107747,26,14,1987,7,"male",247,73,60,0,0,0,0,0,0
2107754,20,1,1993,1,"male",41,13,11,0,0,0,0,0,0
2107794,50,5,1963,6,"female",174,0,0,0,0,0,0,0,0
2107795,23,21,1990,10,"female",358,34,7,1,1,0,1,1,0
2107804,25,12,1988,8,"male",904,1311,916,2264,2280,2264,2056,0,224
2107811,28,1,1985,3,"female",383,15,10,3,0,3,0,0,0
2107813,48,28,1965,3,"male",262,102,79,245,113,245,91,0,22
2107866,68,12,1945,2,"male",360,0,0,0,0,0,0,0,0
2107875,17,19,1996,6,"female",48,86,51,1,18,1,18,0,0
2107897,15,8,1998,10,"female",488,494,264,0,0,0,0,0,0
2107908,20,28,1993,7,"male",396,152,70,11,3,11,3,0,0
2107914,25,10,1988,2,"female",239,296,77,219,380,88,329,131,51
2107947,33,11,1980,9,"female",608,173,112,280,209,151,40,129,169
2107948,62,10,1951,7,"male",1562,19,9,28,37,25,27,3,10
2107975,24,16,1989,5,"female",593,390,277,356,232,356,138,0,94
2108021,27,10,1986,10,"male",835,35,27,39,77,15,21,24,56
2108029,18,23,1995,3,"female",545,119,100,319,130,318,81,1,49
2108040,40,9,1973,5,"male",30,25,24,10,5,10,4,0,1
2108055,25,4,1988,12,"male",555,42,15,8,2,0,0,8,2
2108058,16,6,1997,7,"male",243,409,228,728,323,1,210,727,113
2108064,30,17,1983,1,"female",1537,158,97,0,1,0,1,0,0
2108067,64,9,1949,3,"male",394,27,21,2,3,0,1,2,2
2108070,91,28,1922,6,"male",1068,101,42,48,83,14,7,34,76
2108077,49,10,1964,11,"female",1587,188,109,1519,440,1464,246,55,194
2108095,61,23,1952,4,"male",316,30,17,11,0,0,0,11,0
2108097,64,8,1949,5,"female",300,4,2,1,0,1,0,0,0
2108100,58,21,1955,3,"female",285,20,12,8,0,0,0,8,0
2108118,33,1,1980,1,"male",436,13,7,0,1,0,0,0,1
2108122,51,23,1962,4,"female",1267,173,93,396,185,373,59,23,126
2108134,68,31,1945,1,"male",854,645,490,6,27,6,24,0,3
2108158,61,1,1952,8,"female",516,304,280,538,315,538,221,0,94
2108185,43,4,1970,12,"male",511,50,32,37,18,37,12,0,6
2108187,61,14,1952,4,"male",1693,38,30,1,3,1,3,0,0
2108199,20,4,1993,9,"female",212,255,87,57,118,57,59,0,59
2108212,38,22,1975,3,"male",513,28,19,2,6,2,6,0,0
2108256,24,1,1989,3,"female",380,70,66,8,1,6,0,2,1
2108259,21,26,1992,12,"male",751,200,54,1,9,0,2,1,7
2108262,20,23,1993,8,"female",332,59,13,214,20,214,18,0,2
2108281,49,11,1964,1,"male",149,63,50,8,2,8,0,0,2
2108285,25,7,1988,11,"female",640,72,51,3,6,3,5,0,1
2108291,22,10,1991,5,"male",326,41,34,0,0,0,0,0,0
2108297,52,22,1961,4,"female",842,21,11,18,20,18,8,0,12
2108329,68,21,1945,9,"male",301,1,1,0,1,0,1,0,0
2108355,35,3,1978,8,"male",101,19,19,0,0,0,0,0,0
2108366,37,11,1976,8,"male",197,40,27,6,2,6,1,0,1
2108379,108,17,1905,8,"female",1208,208,67,33,82,0,15,33,67
2108385,75,28,1938,5,"male",1024,9,3,0,1,0,0,0,1
2108401,94,21,1919,5,"female",367,59,37,676,197,676,169,0,28
2108402,37,1,1976,1,"male",314,4,2,0,0,0,0,0,0
2108432,48,2,1965,5,"male",955,43,29,27,16,0,5,27,11
2108435,41,18,1972,12,"female",622,86,67,4,1,4,1,0,0
2108442,35,18,1978,7,"female",637,143,53,2,28,2,28,0,0
2108444,40,6,1973,8,"male",161,26,16,4,0,1,0,3,0
2108456,17,26,1996,11,"male",37,76,60,123,0,2,0,121,0
2108482,36,26,1977,4,"male",115,31,21,1,28,1,22,0,6
2108489,61,6,1952,10,"female",1372,195,123,85,342,21,201,64,141
2108533,24,18,1989,9,"male",716,219,41,0,15,0,6,0,9
2108564,19,10,1994,1,"female",298,276,124,200,295,200,150,0,145
2108567,27,28,1986,8,"male",305,30,13,24,11,24,1,0,10
2108576,22,16,1991,8,"male",1490,458,182,69,522,46,209,23,313
2108584,15,3,1998,3,"male",415,477,293,507,658,0,313,507,345
2108585,107,18,1906,9,"female",5,41,33,16,16,0,9,16,7
2108619,23,20,1990,5,"male",212,228,95,0,0,0,0,0,0
2108673,14,20,1999,7,"male",130,175,152,0,0,0,0,0,0
2108675,49,4,1964,1,"female",359,43,37,1,0,1,0,0,0
2108697,24,6,1989,12,"male",320,448,414,26,27,26,23,0,4
2108752,25,5,1988,5,"male",226,60,29,17,5,17,5,0,0
2108753,20,16,1993,6,"male",465,327,208,28,106,11,40,17,66
2108756,85,1,1928,2,"female",1516,464,246,0,2,0,2,0,0
2108758,24,6,1989,7,"male",39,250,165,3146,3484,1230,2377,1916,1107
2108808,25,31,1988,5,"male",254,1,1,0,0,0,0,0,0
2108823,19,1,1994,1,"female",828,5,1,0,0,0,0,0,0
2108830,23,13,1990,10,"female",821,235,112,216,98,178,63,38,35
2108838,27,4,1986,8,"male",190,96,73,27,46,27,46,0,0
2108930,33,18,1980,3,"male",538,125,80,1,8,1,6,0,2
2108934,28,14,1985,2,"female",28,76,27,121,187,121,167,0,20
2108941,32,15,1981,4,"male",41,30,23,8,12,8,8,0,4
2108942,31,14,1982,12,"male",1605,140,53,0,1,0,0,0,1
2108945,43,17,1970,9,"male",487,217,173,1204,247,1204,183,0,64
2108979,102,19,1911,12,"male",754,4420,1284,3244,6855,1234,4520,2010,2335
2109029,21,11,1992,4,"female",599,141,57,90,21,83,20,7,1
2109074,62,17,1951,8,"male",93,32,28,127,65,127,33,0,32
2109101,26,21,1987,5,"female",320,23,15,69,21,64,19,5,2
2109112,14,26,1999,6,"male",579,152,64,17,0,13,0,4,0
2109118,17,30,1996,11,"male",646,33,23,0,1,0,1,0,0
2109119,51,11,1962,8,"female",1465,102,24,139,110,131,57,8,53
2109122,15,3,1998,2,"female",238,38,21,0,0,0,0,0,0
2109126,19,24,1994,12,"male",243,37,28,15,1,15,1,0,0
2109127,15,26,1998,3,"male",102,225,85,0,0,0,0,0,0
2109128,23,2,1990,8,"male",10,1,1,0,0,0,0,0,0
2109131,59,1,1954,1,"female",283,71,60,30,45,23,19,7,26
2109169,28,29,1985,1,"male",787,258,110,0,13,0,7,0,6
2109180,48,17,1965,1,NA,1820,43,19,123,9,123,7,0,2
2109182,23,30,1990,8,"male",576,383,331,2,7,0,2,2,5
2109184,54,20,1959,10,"male",218,16,12,0,0,0,0,0,0
2109221,20,4,1993,2,"female",150,28,18,185,15,185,15,0,0
2109222,16,1,1997,10,"male",230,139,78,30,10,11,2,19,8
2109237,19,8,1994,6,"male",543,167,39,15,4,6,0,9,4
2109238,38,3,1975,10,"female",758,95,35,23,100,21,60,2,40
2109254,108,27,1905,5,"male",1263,1261,1112,990,73,990,69,0,4
2109264,19,10,1994,4,"male",274,272,225,164,12,164,9,0,3
2109274,52,1,1961,3,"male",419,26,8,37,0,31,0,6,0
2109304,39,23,1974,1,"female",625,2,1,0,0,0,0,0,0
2109341,25,27,1988,11,"male",20,12,6,0,0,0,0,0,0
2109366,25,18,1988,10,"male",227,18,12,0,0,0,0,0,0
2109372,65,26,1948,5,"female",838,81,45,186,67,5,42,181,25
2109384,47,17,1966,4,"male",619,0,0,0,0,0,0,0,0
2109396,33,16,1980,1,"male",403,24,17,0,1,0,1,0,0
2109438,28,20,1985,5,"female",660,235,150,390,150,371,70,19,80
2109453,13,12,2000,2,"female",316,273,149,159,119,2,40,157,79
2109517,28,29,1985,9,"female",217,16,10,38,31,38,30,0,1
2109533,24,12,1989,6,"male",368,9,5,1,1,1,0,0,1
2109546,73,4,1940,9,"female",1458,22,9,1,1,0,0,1,1
2109586,23,16,1990,3,"male",153,29,21,5,2,0,0,5,2
2109592,58,13,1955,12,"female",304,51,34,128,59,0,51,128,8
2109626,51,28,1962,8,"male",978,52,22,0,0,0,0,0,0
2109644,28,10,1985,3,"male",576,88,47,37,0,37,0,0,0
2109646,55,27,1958,6,"female",1215,98,38,132,283,132,233,0,50
2109674,51,29,1962,8,"female",1280,354,235,2780,1497,1340,491,1440,1006
2109694,15,8,1998,9,"male",359,98,34,27,4,27,2,0,2
2109695,22,28,1991,7,"male",641,32,21,5,0,3,0,2,0
2109697,30,28,1983,2,"male",806,64,32,7,6,7,4,0,2
2109722,31,30,1982,3,"female",55,1,1,137,89,62,69,75,20
2109729,37,18,1976,4,"male",364,20,19,0,0,0,0,0,0
2109730,20,28,1993,5,"male",33,141,121,206,114,175,82,31,32
2109757,17,12,1996,9,"female",688,611,275,28,4,0,0,28,4
2109781,21,21,1992,7,"female",968,531,335,215,229,212,184,3,45
2109799,60,6,1953,5,"female",1411,39,24,14,6,0,4,14,2
2109815,50,21,1963,6,"female",2449,208,120,82,572,52,306,30,266
2109834,55,8,1958,5,"male",219,1,1,0,0,0,0,0,0
2109848,38,18,1975,1,"male",722,196,167,1,0,0,0,1,0
2109850,25,25,1988,3,"female",675,116,102,0,0,0,0,0,0
2109855,25,25,1988,11,"male",375,54,23,3,0,3,0,0,0
2109883,15,25,1998,1,"female",197,934,780,3,2,3,2,0,0
2109898,16,9,1997,7,"male",673,323,151,161,346,116,197,45,149
2109918,26,10,1987,12,"male",1410,215,123,25,38,25,33,0,5
2109921,60,10,1953,8,"female",1483,483,165,1114,693,323,266,791,427
2109935,23,7,1990,6,"female",861,456,201,285,228,167,132,118,96
2109937,19,15,1994,3,"female",6,16,15,0,0,0,0,0,0
2109944,21,6,1992,5,"female",764,1258,574,95,717,95,539,0,178
2109973,20,7,1993,5,"male",300,24,1,0,0,0,0,0,0
2109981,24,4,1989,9,"female",405,360,145,3,3,3,3,0,0
2109983,18,28,1995,2,"female",268,36,27,2,7,2,4,0,3
2110014,43,22,1970,10,"female",96,58,35,189,138,179,82,10,56
2110018,53,3,1960,9,"female",1603,177,39,6,19,2,13,4,6
2110039,19,26,1994,8,"female",1050,944,357,637,488,160,168,477,320
2110050,20,8,1993,5,"male",154,52,49,0,0,0,0,0,0
2110060,63,8,1950,3,"female",176,30,20,82,10,0,6,82,4
2110068,24,17,1989,11,"male",818,308,235,1,2,1,0,0,2
2110108,23,11,1990,11,"female",213,9,8,0,0,0,0,0,0
2110153,43,1,1970,12,"male",276,2,2,0,0,0,0,0,0
2110166,21,7,1992,6,"male",574,329,180,13,16,12,6,1,10
2110172,51,7,1962,10,"male",198,92,59,11,8,0,1,11,7
2110184,60,11,1953,11,"female",1709,118,58,36,81,36,56,0,25
2110193,18,27,1995,12,"male",715,0,0,0,0,0,0,0,0
2110234,33,19,1980,6,"male",370,25,18,0,0,0,0,0,0
2110240,19,5,1994,5,"male",75,10,9,0,1,0,0,0,1
2110252,30,2,1983,12,"male",588,105,65,1,0,1,0,0,0
2110253,61,26,1952,11,"female",708,72,49,185,48,185,43,0,5
2110262,103,11,1910,1,"male",1879,2871,2229,11,124,11,93,0,31
2110329,32,27,1981,4,"female",154,28,7,18,32,14,17,4,15
2110334,23,9,1990,12,"male",430,480,385,25,73,17,41,8,32
2110350,31,2,1982,1,"male",64,33,20,5,16,5,15,0,1
2110358,22,22,1991,10,"female",151,36,23,30,26,30,19,0,7
2110363,28,1,1985,7,"male",723,99,59,15,8,15,8,0,0
2110374,17,9,1996,12,"male",193,62,50,0,0,0,0,0,0
2110382,50,17,1963,6,"male",1846,35,10,1,0,0,0,1,0
2110392,62,11,1951,11,"female",1564,254,176,410,367,394,185,16,182
2110403,38,20,1975,4,"male",112,38,13,6,35,6,24,0,11
2110427,53,5,1960,7,"female",378,374,55,211,116,0,24,211,92
2110436,22,30,1991,12,"male",199,0,0,0,0,0,0,0,0
2110453,44,1,1969,10,"male",1842,115,95,29,47,23,30,6,17
2110470,103,18,1910,3,"male",1141,220,142,67,4,0,0,67,4
2110474,23,29,1990,10,"male",984,112,39,19,14,19,14,0,0
2110485,60,17,1953,5,"female",421,53,42,320,52,0,27,320,25
2110491,64,8,1949,8,"female",134,18,12,0,0,0,0,0,0
2110492,30,9,1983,8,"male",790,159,72,0,0,0,0,0,0
2110555,30,12,1983,8,"female",578,0,0,0,0,0,0,0,0
2110565,108,10,1905,3,"female",1173,128,74,12,1,1,0,11,1
2110568,15,8,1998,10,"male",463,28,17,3,0,3,0,0,0
2110578,58,19,1955,5,"male",269,41,32,3,5,0,1,3,4
2110600,61,19,1952,2,"male",1758,59,13,19,84,19,75,0,9
2110606,20,16,1993,11,"male",183,126,112,148,35,147,35,1,0
2110614,56,2,1957,9,"female",199,48,33,437,219,437,179,0,40
2110633,22,4,1991,2,"female",349,270,186,756,288,126,156,630,132
2110657,41,1,1972,12,"male",335,20,17,0,0,0,0,0,0
2110704,15,18,1998,11,"female",316,95,59,0,0,0,0,0,0
2110710,35,15,1978,10,"male",55,21,9,1,0,1,0,0,0
2110717,67,26,1946,10,"male",1639,108,39,0,0,0,0,0,0
2110725,25,8,1988,5,"male",853,103,60,9,4,0,1,9,3
2110742,68,13,1945,6,"female",2257,132,57,120,21,109,16,11,5
2110752,44,2,1969,5,"female",570,85,34,0,2,0,2,0,0
2110787,28,29,1985,3,"female",428,15,10,3,0,0,0,3,0
2110790,54,1,1959,1,"female",308,70,33,149,122,149,62,0,60
2110806,40,13,1973,10,"male",338,8,6,0,0,0,0,0,0
2110833,104,16,1909,1,"male",1004,90,39,488,222,481,159,7,63
2110843,62,17,1951,7,"male",532,43,24,38,8,9,6,29,2
2110867,21,7,1992,9,"female",282,254,184,45,57,45,39,0,18
2110873,48,16,1965,6,"male",77,20,14,2,2,2,0,0,2
2110895,24,13,1989,11,"male",270,8,5,0,0,0,0,0,0
2110931,54,6,1959,4,"female",452,49,24,0,0,0,0,0,0
2110966,23,30,1990,1,"male",805,100,53,0,8,0,5,0,3
2111022,21,25,1992,8,"male",649,268,183,0,1,0,0,0,1
2111035,28,5,1985,9,"female",156,198,67,94,92,94,83,0,9
2111048,24,23,1989,12,"female",796,551,376,428,652,100,291,328,361
2111087,52,30,1961,3,"female",931,403,229,368,369,368,80,0,289
2111088,21,24,1992,12,"male",344,458,390,333,209,333,196,0,13
2111094,30,18,1983,7,"male",262,226,187,52,42,52,26,0,16
2111102,38,1,1975,5,"male",757,117,71,2,8,1,8,1,0
2111156,20,15,1993,11,"female",332,188,67,18,0,0,0,18,0
2111190,108,20,1905,2,"female",2119,1627,682,23,106,23,99,0,7
2111204,52,29,1961,3,"male",519,243,161,517,898,404,633,113,265
2111245,15,6,1998,6,"male",1348,22,10,2,0,2,0,0,0
2111247,22,19,1991,9,"male",341,302,261,0,1,0,1,0,0
2111296,30,19,1983,5,"male",529,239,120,467,57,467,55,0,2
2111328,71,8,1942,7,"male",918,41,28,37,3,37,1,0,2
2111338,29,27,1984,12,"male",214,237,153,346,46,346,34,0,12
2111349,21,19,1992,11,"female",477,20,14,9,4,9,1,0,3
2111396,38,23,1975,7,"male",432,32,28,3,0,3,0,0,0
2111398,20,28,1993,6,"male",482,91,63,0,0,0,0,0,0
2111399,65,19,1948,9,"female",416,7,6,2,1,2,0,0,1
2111410,104,14,1909,3,"female",46,47,9,166,106,166,103,0,3
2111455,56,23,1957,2,"female",213,106,82,1348,982,0,245,1348,737
2111470,16,26,1997,2,"male",539,136,89,192,238,181,172,11,66
2111488,27,5,1986,1,"female",502,40,19,52,19,52,19,0,0
2111489,21,10,1992,2,"male",593,247,51,1,0,1,0,0,0
2111499,26,18,1987,7,"male",211,61,29,1,3,0,0,1,3
2111500,42,17,1971,9,"male",261,31,24,109,1,109,0,0,1
2111507,48,27,1965,5,"male",1666,552,114,167,449,167,174,0,275
2111522,60,27,1953,4,"male",309,36,20,3,1,0,0,3,1
2111541,26,18,1987,3,"female",720,187,127,25,2,16,1,9,1
2111553,22,1,1991,7,"female",429,25,10,4,2,4,0,0,2
2111567,71,10,1942,4,"female",355,24,13,911,60,0,39,911,21
2111569,15,12,1998,8,"female",577,830,560,351,193,0,71,351,122
2111585,47,21,1966,4,"male",287,26,25,0,0,0,0,0,0
2111597,32,9,1981,5,"male",177,42,25,121,58,113,53,8,5
2111601,26,12,1987,10,"male",566,131,65,112,82,107,65,5,17
2111632,59,24,1954,2,"female",1313,16,6,2,0,1,0,1,0
2111653,77,19,1936,6,"male",837,59,23,97,87,0,44,97,43
2111656,29,4,1984,5,"female",89,23,13,108,92,108,91,0,1
2111677,103,8,1910,5,"female",826,392,198,4,11,4,7,0,4
2111696,15,26,1998,6,"female",380,674,199,194,199,194,52,0,147
2111710,22,1,1991,1,"male",370,183,172,11,1,11,1,0,0
2111716,32,27,1981,4,"male",226,9,3,0,0,0,0,0,0
2111730,16,6,1997,1,"male",616,152,101,31,7,7,1,24,6
2111774,108,12,1905,6,"female",214,13,10,9,3,0,0,9,3
2111824,23,7,1990,11,"male",462,0,0,0,0,0,0,0,0
2111869,65,1,1948,4,"female",558,9,6,24,5,24,3,0,2
2111900,23,5,1990,2,"female",265,53,40,2,3,2,3,0,0
2111911,21,20,1992,11,"male",821,142,99,18,109,8,74,10,35
2111919,26,17,1987,8,"male",250,23,11,0,0,0,0,0,0
2111966,24,25,1989,2,"male",759,33,31,18,10,18,7,0,3
2111973,18,11,1995,8,"male",299,167,24,34,65,2,26,32,39
2112005,15,7,1998,2,"male",220,67,21,0,0,0,0,0,0
2112008,16,2,1997,3,"male",107,199,181,58,7,58,6,0,1
2112014,29,2,1984,11,"male",277,240,136,1,0,0,0,1,0
2112016,16,30,1997,7,"female",523,229,66,4,22,4,17,0,5
2112044,25,1,1988,1,"male",107,2,1,0,0,0,0,0,0
2112049,50,23,1963,6,"male",759,61,39,54,39,24,8,30,31
2112057,54,16,1959,3,"female",204,196,15,192,256,192,231,0,25
2112082,31,10,1982,4,"male",144,23,23,19,0,19,0,0,0
2112103,14,23,1999,1,"female",273,237,152,899,104,899,90,0,14
2112113,19,10,1994,10,"male",474,87,51,4,1,3,1,1,0
2112130,18,4,1995,3,"male",566,825,665,10,2,10,2,0,0
2112177,64,4,1949,2,"female",104,195,180,37,38,37,12,0,26
2112190,59,30,1954,3,"male",837,48,23,22,7,22,5,0,2
2112194,31,16,1982,10,"male",215,26,5,0,0,0,0,0,0
2112201,23,11,1990,2,"male",732,226,68,2,9,2,8,0,1
2112226,33,5,1980,10,"male",162,26,18,27,0,27,0,0,0
2112227,28,26,1985,6,"male",667,75,28,2,26,2,21,0,5
2112235,18,2,1995,4,"female",18,10,10,0,0,0,0,0,0
2112250,56,26,1957,8,"female",1578,71,26,155,352,31,215,124,137
2112254,15,4,1998,12,"female",471,306,211,747,455,0,34,747,421
2112277,21,11,1992,8,"female",1188,446,221,1552,2325,1257,1663,295,662
2112292,28,7,1985,7,"male",631,35,31,0,0,0,0,0,0
2112357,30,10,1983,9,"male",39,0,0,0,0,0,0,0,0
2112381,63,26,1950,1,"female",212,16,15,0,0,0,0,0,0
2112388,41,1,1972,1,"female",411,165,108,0,8,0,0,0,8
2112402,23,15,1990,11,"female",793,591,365,2775,1610,1721,899,1054,711
2112411,19,20,1994,7,"female",547,737,238,101,177,101,89,0,88
2112444,19,9,1994,3,"male",573,549,386,256,77,256,74,0,3
2112448,35,26,1978,11,"male",280,127,94,6,198,0,1,6,197
2112468,31,18,1982,3,"male",863,1,1,3,2,3,1,0,1
2112472,51,25,1962,9,"female",1294,253,66,146,291,25,84,121,207
2112477,33,28,1980,2,"male",578,144,116,0,0,0,0,0,0
2112487,62,29,1951,5,"female",1562,55,23,229,26,229,23,0,3
2112490,13,30,2000,1,"male",213,32,15,3,45,3,26,0,19
2112500,25,15,1988,8,"female",122,120,82,166,186,166,176,0,10
2112518,18,22,1995,3,"female",433,922,533,2035,2950,1467,1705,568,1245
2112522,15,19,1998,10,"male",119,25,11,1,0,1,0,0,0
2112564,20,29,1993,11,"male",445,146,111,666,30,666,9,0,21
2112586,49,31,1964,10,"male",851,2,2,0,0,0,0,0,0
2112590,49,17,1964,5,"male",350,140,86,207,94,101,41,106,53
2112624,19,26,1994,6,"male",619,176,57,2,9,2,9,0,0
2112627,23,9,1990,4,"male",603,2,0,0,0,0,0,0,0
2112630,18,12,1995,1,"female",342,513,96,2,24,2,18,0,6
2112642,14,18,1999,6,"female",399,90,85,1,0,0,0,1,0
2112656,59,14,1954,12,"male",252,16,11,0,1,0,0,0,1
2112661,46,26,1967,8,"female",468,21,13,0,0,0,0,0,0
2112679,30,2,1983,10,"female",509,100,10,17,0,17,0,0,0
2112700,15,4,1998,9,"female",296,88,51,18,19,3,5,15,14
2112705,75,8,1938,2,"male",1163,51,27,0,0,0,0,0,0
2112706,31,30,1982,4,"male",513,3696,2579,6448,3687,2768,3210,3680,477
2112713,62,11,1951,11,"female",228,37,23,4,8,4,5,0,3
2112739,15,4,1998,5,"male",420,160,110,59,27,59,18,0,9
2112756,18,17,1995,7,"male",109,270,172,98,140,75,63,23,77
2112762,23,16,1990,4,"male",492,70,44,0,0,0,0,0,0
2112766,23,21,1990,4,"male",1644,57,53,7,0,5,0,2,0
2112823,29,10,1984,4,"male",273,88,63,0,5,0,4,0,1
2112833,48,17,1965,1,"male",761,69,17,1,1,1,1,0,0
2112835,17,28,1996,6,"male",325,161,132,0,0,0,0,0,0
2112836,43,5,1970,10,"female",1656,662,486,2264,3400,1035,2168,1229,1232
2112855,56,21,1957,1,"female",324,33,23,53,17,53,17,0,0
2112867,34,30,1979,9,"female",362,16,8,0,15,0,5,0,10
2112874,23,27,1990,4,"male",959,121,101,0,0,0,0,0,0
2112889,21,20,1992,1,"male",446,229,168,1,11,1,8,0,3
2112900,38,8,1975,1,"male",1077,3105,1325,5,14,1,10,4,4
2112902,101,20,1912,11,"female",1586,1401,396,43,3,43,3,0,0
2112913,31,25,1982,12,"male",634,308,166,50,3,30,0,20,3
2112926,43,22,1970,5,"male",385,501,433,31,3,0,1,31,2
2112927,27,15,1986,10,"male",200,202,158,89,22,89,21,0,1
2112934,50,9,1963,6,"female",515,49,14,91,34,91,24,0,10
2112948,63,7,1950,6,"female",187,59,26,1,6,0,6,1,0
2112950,25,28,1988,6,"male",215,25,24,2,0,2,0,0,0
2112952,17,2,1996,2,"male",762,1180,969,50,114,50,101,0,13
2112976,19,13,1994,10,"female",420,495,421,2679,1069,1422,425,1257,644
2112993,31,29,1982,1,"female",358,413,354,739,504,23,318,716,186
2113010,70,4,1943,10,"female",1792,39,16,14,11,14,7,0,4
2113074,26,22,1987,1,"male",355,90,56,78,61,78,50,0,11
2113084,21,23,1992,12,"female",148,115,90,11,0,11,0,0,0
2113100,49,23,1964,9,"female",103,7,5,3,0,3,0,0,0
2113102,31,6,1982,6,"male",235,32,22,0,1,0,1,0,0
2113112,24,19,1989,5,"female",40,34,18,0,0,0,0,0,0
2113121,63,14,1950,1,"female",523,73,61,0,6,0,6,0,0
2113154,48,22,1965,7,"male",1013,15,5,0,0,0,0,0,0
2113177,18,3,1995,5,"female",388,698,130,1,9,1,1,0,8
2113178,20,26,1993,1,"female",261,17,11,0,0,0,0,0,0
2113188,60,7,1953,6,"male",827,68,4,1,36,1,33,0,3
2113191,48,25,1965,4,"male",1410,363,137,24,45,14,15,10,30
2113216,43,10,1970,10,"female",675,137,93,424,738,424,581,0,157
2113221,67,22,1946,3,"male",1173,123,95,0,0,0,0,0,0
2113242,38,4,1975,5,"male",160,3,1,14,0,14,0,0,0
2113243,39,1,1974,6,"female",282,7,4,1601,12,1601,10,0,2
2113247,21,7,1992,4,"male",582,527,481,101,26,80,21,21,5
2113316,16,29,1997,1,"male",311,180,94,76,5,35,2,41,3
2113324,26,1,1987,9,"female",300,132,16,35,83,35,71,0,12
2113331,50,21,1963,1,"female",683,67,32,3,16,2,8,1,8
2113339,32,7,1981,2,"female",343,1,1,0,0,0,0,0,0
2113343,103,14,1910,7,"male",1169,850,480,62,7,21,7,41,0
2113356,46,8,1967,4,"male",513,166,139,1,9,1,8,0,1
2113379,15,7,1998,5,"female",114,243,90,89,104,89,93,0,11
2113391,62,26,1951,12,"female",641,43,35,42,18,1,8,41,10
2113401,25,12,1988,8,"female",246,104,92,167,0,160,0,7,0
2113402,16,12,1997,9,"male",139,225,213,0,0,0,0,0,0
2113422,20,1,1993,1,"male",271,984,822,2186,1196,2028,1094,158,102
2113461,44,14,1969,10,"male",1805,105,41,24,2,13,1,11,1
2113476,62,16,1951,8,"male",698,92,67,3,13,0,1,3,12
2113491,19,3,1994,12,"male",218,64,50,2,1,2,1,0,0
2113499,39,4,1974,2,"female",567,61,31,5,23,5,23,0,0
2113528,33,23,1980,4,"male",1558,19,9,6,2,6,2,0,0
2113529,26,27,1987,10,"female",299,94,69,102,152,102,79,0,73
2113551,47,4,1966,10,"female",221,48,21,21,12,21,7,0,5
2113567,26,18,1987,5,"male",125,183,125,13,3,13,2,0,1
2113588,42,6,1971,12,"male",530,3,3,0,0,0,0,0,0
2113596,29,17,1984,9,"female",554,35,14,3,5,3,3,0,2
2113603,23,25,1990,11,"male",865,325,101,8,9,8,6,0,3
2113616,25,1,1988,1,"male",352,45,25,6,0,6,0,0,0
2113620,30,28,1983,7,"male",480,52,21,0,0,0,0,0,0
2113623,28,22,1985,4,"male",243,160,101,0,1,0,0,0,1
2113650,23,22,1990,4,"female",757,220,134,46,57,46,56,0,1
2113653,44,13,1969,2,"male",222,56,54,0,0,0,0,0,0
2113661,34,20,1979,8,"male",148,52,40,0,0,0,0,0,0
2113665,26,12,1987,5,"male",1101,315,139,64,19,64,10,0,9
2113685,19,25,1994,3,"female",551,195,134,0,0,0,0,0,0
2113710,37,9,1976,2,"male",757,39,39,2,0,0,0,2,0
2113720,21,8,1992,11,"female",88,15,13,8,0,8,0,0,0
2113774,20,13,1993,10,"male",340,44,34,5,5,5,5,0,0
2113793,55,23,1958,9,"female",140,17,12,42,0,0,0,42,0
2113814,53,20,1960,7,"male",2000,206,104,414,306,413,198,1,108
2113816,22,10,1991,9,"male",569,27,21,29,1,25,1,4,0
2113845,20,1,1993,1,"male",394,329,193,16,9,16,9,0,0
2113863,32,6,1981,7,"male",2,1,0,0,0,0,0,0,0
2113869,21,15,1992,7,"male",283,97,76,2,1,0,0,2,1
2113891,19,12,1994,10,"male",418,210,164,0,0,0,0,0,0
2113919,31,1,1982,2,"female",44,60,39,247,90,247,63,0,27
2113936,18,16,1995,12,"female",0,0,0,0,0,0,0,0,0
2113967,30,27,1983,7,"female",317,38,21,7,1,7,1,0,0
2113974,17,27,1996,4,"female",546,470,259,140,36,138,35,2,1
2114020,60,6,1953,5,"male",483,107,82,23,4,0,2,23,2
2114051,21,2,1992,12,"male",536,121,29,0,9,0,2,0,7
2114059,68,15,1945,4,"male",486,414,308,1,1,1,0,0,1
2114080,35,30,1978,1,"male",258,19,15,26,11,26,9,0,2
2114097,68,20,1945,6,"male",634,1367,1088,323,1175,323,690,0,485
2114123,23,1,1990,6,"male",928,364,66,8,7,8,7,0,0
2114124,27,1,1986,8,"male",813,66,53,0,3,0,2,0,1
2114126,26,17,1987,6,"male",666,261,190,40,96,40,77,0,19
2114174,14,22,1999,2,"female",260,399,150,3497,3422,3194,1266,303,2156
2114193,31,1,1982,1,"female",216,5,5,50,6,50,0,0,6
2114253,55,19,1958,4,"female",1088,10,3,8,4,0,2,8,2
2114277,40,5,1973,1,"male",974,3,1,0,0,0,0,0,0
2114303,41,21,1972,8,"female",1879,91,31,205,402,27,166,178,236
2114330,14,20,1999,9,"male",182,76,74,8,2,8,2,0,0
2114339,48,23,1965,5,"female",293,7,3,4,6,0,0,4,6
2114364,66,16,1947,11,"female",916,74,28,7,0,0,0,7,0
2114374,31,1,1982,7,"male",358,67,22,0,0,0,0,0,0
2114397,95,7,1918,3,"male",1596,443,263,17,12,17,9,0,3
2114407,62,18,1951,8,"male",727,39,29,10,3,10,3,0,0
2114437,42,10,1971,12,"female",301,76,61,50,12,22,3,28,9
2114439,15,16,1998,5,"male",861,969,784,32,31,2,12,30,19
2114444,22,19,1991,1,"male",294,121,82,0,0,0,0,0,0
2114452,18,28,1995,1,"female",160,62,14,63,45,37,39,26,6
2114485,22,7,1991,9,"female",684,758,430,90,407,63,99,27,308
2114486,19,2,1994,6,"female",998,525,148,30,591,30,533,0,58
2114496,31,22,1982,7,"female",372,121,66,6,9,5,3,1,6
2114505,68,14,1945,8,"male",1282,346,171,98,86,98,80,0,6
2114515,27,19,1986,12,"male",966,396,203,0,5,0,2,0,3
2114558,23,8,1990,4,"female",310,65,45,191,39,33,23,158,16
2114605,23,15,1990,3,"male",149,16,14,0,0,0,0,0,0
2114608,24,27,1989,3,"female",207,92,38,0,0,0,0,0,0
2114618,69,23,1944,2,"female",1605,44,19,269,82,0,22,269,60
2114622,19,22,1994,2,"male",487,33,14,0,0,0,0,0,0
2114637,53,7,1960,1,"male",64,3,2,0,0,0,0,0,0
2114638,24,6,1989,3,"male",117,2,2,9,8,0,2,9,6
2114641,31,14,1982,4,"male",291,15,7,0,0,0,0,0,0
2114660,55,25,1958,8,"male",1214,110,65,56,46,56,39,0,7
2114677,43,26,1970,7,"male",145,53,45,27,6,27,6,0,0
2114685,15,31,1998,8,"male",4,10,8,0,0,0,0,0,0
2114716,38,16,1975,3,"male",1183,124,51,55,75,55,47,0,28
2114732,19,28,1994,8,"male",427,2,2,1,0,1,0,0,0
2114739,79,2,1934,6,"male",303,197,120,125,41,0,6,125,35
2114743,54,16,1959,3,"female",1888,196,123,535,1793,535,961,0,832
2114768,23,8,1990,1,"female",275,18,6,35,25,0,9,35,16
2114778,41,11,1972,2,"male",289,11,11,26,3,24,2,2,1
2114789,27,17,1986,7,"female",234,36,28,4,8,4,6,0,2
2114791,33,9,1980,2,"female",262,33,30,10,0,3,0,7,0
2114817,29,23,1984,7,"male",254,35,28,2,0,2,0,0,0
2114846,68,3,1945,6,"male",679,43,27,7,2,7,2,0,0
2114847,37,20,1976,12,"female",116,35,25,0,0,0,0,0,0
2114850,22,9,1991,1,"female",720,238,185,190,575,181,448,9,127
2114856,101,11,1912,3,"male",296,176,90,0,0,0,0,0,0
2114865,27,24,1986,1,"female",96,328,286,581,578,476,338,105,240
2114881,31,6,1982,4,"male",318,59,49,13,93,9,65,4,28
2114910,19,29,1994,7,"female",650,141,59,1,0,1,0,0,0
2114946,23,10,1990,4,"female",449,105,77,1,1,1,1,0,0
2114965,19,19,1994,3,"male",92,64,52,69,29,62,20,7,9
2114975,18,2,1995,7,"male",576,171,135,65,46,5,13,60,33
2114979,108,1,1905,1,"female",1584,58,38,39,19,22,8,17,11
2115002,14,6,1999,4,"male",116,88,24,143,96,142,34,1,62
2115037,102,14,1911,4,"female",789,446,60,270,252,270,215,0,37
2115059,29,19,1984,11,"female",204,449,238,39,44,37,17,2,27
2115060,18,19,1995,8,"male",458,278,169,10,33,3,25,7,8
2115071,33,13,1980,7,"male",599,51,36,3,8,0,5,3,3
2115075,44,8,1969,8,"female",2398,132,68,220,130,101,48,119,82
2115095,33,15,1980,11,"female",171,70,40,40,62,40,48,0,14
2115115,62,16,1951,8,"female",1853,237,126,114,101,114,48,0,53
2115120,73,15,1940,9,"female",1165,45,22,8,6,8,4,0,2
2115131,52,12,1961,6,"female",516,9,1,2,1,0,1,2,0
2115136,15,24,1998,11,"male",565,81,24,34,50,20,18,14,32
2115141,55,4,1958,12,"male",1747,29,12,17,7,15,7,2,0
2115144,40,28,1973,3,"female",568,79,60,14,1,14,0,0,1
2115152,23,26,1990,1,"male",199,66,27,0,1,0,1,0,0
2115170,17,21,1996,10,"male",71,258,251,123,121,90,82,33,39
2115172,21,24,1992,1,"male",485,90,82,0,0,0,0,0,0
2115239,29,5,1984,5,"male",419,18,13,0,0,0,0,0,0
2115257,53,12,1960,2,"male",1489,41,21,8,1,2,0,6,1
2115292,43,14,1970,7,"male",524,29,8,0,0,0,0,0,0
2115337,27,15,1986,10,"male",296,0,0,12,0,12,0,0,0
2115400,60,22,1953,9,"male",144,12,10,0,0,0,0,0,0
2115401,16,9,1997,7,"female",584,4638,1033,2402,2947,2064,2582,338,365
2115427,23,5,1990,4,"female",123,96,72,416,456,156,142,260,314
2115428,26,8,1987,10,"male",447,16,11,6,0,6,0,0,0
2115431,100,10,1913,10,"male",1751,31,19,32,26,0,1,32,25
2115442,58,14,1955,12,"female",92,49,31,756,110,756,43,0,67
2115460,37,3,1976,10,"male",313,11,7,1,0,1,0,0,0
2115470,41,18,1972,5,"male",1449,26,13,0,0,0,0,0,0
2115475,31,13,1982,4,"female",532,782,433,44,418,44,328,0,90
2115479,103,3,1910,1,"male",1136,165,64,7,50,0,33,7,17
2115489,70,28,1943,4,"female",1471,38,15,75,90,73,29,2,61
2115497,46,3,1967,8,"male",501,33,27,6,0,6,0,0,0
2115568,72,13,1941,5,"female",112,23,15,154,62,0,45,154,17
2115596,39,10,1974,1,"female",373,235,220,16,13,12,9,4,4
2115626,71,26,1942,11,"male",871,24,12,3,4,3,3,0,1
2115643,52,22,1961,6,"female",54,16,11,22,24,0,0,22,24
2115650,47,7,1966,7,"female",936,292,159,5,38,5,29,0,9
2115756,18,24,1995,12,"female",340,250,154,351,324,183,62,168,262
2115760,69,8,1944,5,"male",718,89,79,1,0,0,0,1,0
2115767,19,17,1994,1,"female",706,347,277,808,144,563,27,245,117
2115768,28,7,1985,8,"male",96,39,27,0,1,0,0,0,1
2115774,48,24,1965,9,"female",1700,36,12,1,0,1,0,0,0
2115780,31,29,1982,1,"female",345,101,59,71,3,71,3,0,0
2115782,42,5,1971,11,"male",663,98,84,0,3,0,3,0,0
2115796,18,12,1995,10,"female",336,214,128,156,52,156,50,0,2
2115833,25,8,1988,12,"male",42,24,18,7,8,6,5,1,3
2115839,72,8,1941,10,"female",830,24,11,8,0,8,0,0,0
2115840,103,12,1910,5,"female",781,34,27,1,19,0,8,1,11
2115871,18,29,1995,12,"female",639,145,120,3,9,3,6,0,3
2115905,60,21,1953,2,"female",717,24,7,13,48,13,5,0,43
2115921,21,15,1992,12,"male",79,59,56,65,21,51,11,14,10
2115962,63,11,1950,7,"female",537,3,2,2,0,0,0,2,0
2116007,49,18,1964,2,"female",335,25,6,4,1,0,1,4,0
2116014,24,20,1989,6,"female",208,55,38,8,7,8,7,0,0
2116031,69,13,1944,3,"female",74,17,12,12,6,12,6,0,0
2116032,16,28,1997,3,"male",525,672,537,18,0,5,0,13,0
2116066,44,30,1969,11,"male",84,1,0,0,0,0,0,0,0
2116067,24,28,1989,9,"female",112,23,14,3,17,3,14,0,3
2116086,25,29,1988,12,"male",583,90,74,1,0,0,0,1,0
2116114,69,3,1944,6,"male",687,87,35,37,2,0,1,37,1
2116118,27,23,1986,3,"female",486,161,58,11,7,11,7,0,0
2116124,22,4,1991,10,"male",1295,708,286,5358,8712,31,3872,5327,4840
2116127,16,29,1997,5,"male",346,313,260,69,139,69,119,0,20
2116131,38,6,1975,6,"male",283,17,13,13,5,13,5,0,0
2116180,38,10,1975,8,"male",601,188,129,331,28,68,12,263,16
2116203,22,21,1991,6,"male",314,79,45,0,0,0,0,0,0
2116205,16,15,1997,10,"male",68,81,66,4,1,4,1,0,0
2116236,17,17,1996,4,"male",193,0,0,3,0,3,0,0,0
2116245,78,1,1935,7,"female",1443,189,94,144,42,101,39,43,3
2116250,51,6,1962,3,"male",273,10,7,3,0,0,0,3,0
2116253,25,1,1988,1,"male",1035,231,91,58,80,58,50,0,30
2116289,57,6,1956,6,"female",90,119,102,149,14,147,9,2,5
2116295,69,26,1944,10,"female",171,24,22,3,3,1,1,2,2
2116299,22,1,1991,10,"male",287,12,12,0,0,0,0,0,0
2116326,23,23,1990,3,"male",48,2,2,11,3,6,3,5,0
2116342,65,20,1948,2,"female",839,36,20,12,6,0,1,12,5
2116356,16,22,1997,8,"male",149,52,35,0,0,0,0,0,0
2116406,38,18,1975,11,"male",749,79,38,41,72,41,40,0,32
2116407,18,1,1995,1,"female",578,1288,434,2748,2882,2748,2422,0,460
2116429,54,25,1959,7,"female",580,64,14,193,4,0,3,193,1
2116430,66,10,1947,6,"female",490,63,32,336,37,336,23,0,14
2116462,22,2,1991,2,"male",526,86,59,4,13,4,6,0,7
2116512,63,18,1950,9,"male",776,51,7,75,64,0,23,75,41
2116556,31,22,1982,11,"male",1362,128,115,4,22,4,22,0,0
2116559,113,23,1900,12,"female",1656,100,24,477,117,477,75,0,42
2116608,31,28,1982,7,"male",293,73,53,217,94,203,62,14,32
2116612,55,7,1958,1,"male",49,0,0,0,0,0,0,0,0
2116630,16,19,1997,5,"male",51,197,43,27,28,27,26,0,2
2116635,22,4,1991,6,"male",154,112,96,0,0,0,0,0,0
2116636,30,11,1983,7,"male",771,67,34,44,16,43,14,1,2
2116640,51,30,1962,9,"female",990,172,50,470,284,335,126,135,158
2116649,16,16,1997,4,"male",426,1016,945,19,9,0,4,19,5
2116656,22,1,1991,1,"female",415,1,0,14,2,14,2,0,0
2116665,32,28,1981,9,"female",228,323,268,98,148,72,56,26,92
2116727,63,11,1950,3,NA,1736,28,7,2,3,2,3,0,0
2116745,19,16,1994,2,"female",336,137,69,10,1,0,0,10,1
2116751,46,6,1967,5,"male",638,69,18,25,33,25,30,0,3
2116757,20,21,1993,3,"male",279,12,6,0,0,0,0,0,0
2116759,108,25,1905,9,"female",1106,148,67,1,18,1,16,0,2
2116763,26,2,1987,5,"male",860,157,70,6,1,6,1,0,0
2116764,44,21,1969,1,"female",441,32,8,106,12,106,4,0,8
2116784,18,13,1995,4,"male",306,94,73,4,1,1,0,3,1
2116798,25,11,1988,11,"male",88,124,114,2,0,2,0,0,0
2116802,31,1,1982,3,"male",807,272,221,0,6,0,5,0,1
2116813,19,15,1994,5,"female",30,1,1,38,8,0,4,38,4
2116823,16,22,1997,12,"male",137,149,125,41,13,3,7,38,6
2116835,56,9,1957,5,"female",2381,112,33,51,45,7,25,44,20
2116857,20,29,1993,4,"female",61,13,3,0,12,0,5,0,7
2116861,18,21,1995,11,"female",288,447,289,74,14,13,2,61,12
2116871,28,1,1985,1,"female",127,1,1,1,0,1,0,0,0
2116918,28,8,1985,4,"male",680,136,53,0,46,0,42,0,4
2116949,23,19,1990,9,"female",447,97,8,8,0,8,0,0,0
2116952,20,8,1993,7,"female",627,134,93,0,0,0,0,0,0
2116967,25,16,1988,9,"male",872,30,18,1,0,0,0,1,0
2116978,26,15,1987,11,"female",146,76,53,0,3,0,0,0,3
2116998,23,1,1990,1,"female",138,33,27,18,1,18,1,0,0
2117000,16,15,1997,5,"male",506,203,132,31,7,17,6,14,1
2117020,18,11,1995,8,"female",351,2144,178,351,501,337,187,14,314
2117022,23,28,1990,5,"male",153,229,211,0,1570,0,822,0,748
2117039,33,4,1980,5,"female",547,57,46,10,0,10,0,0,0
2117085,15,1,1998,4,"male",513,2228,660,356,1323,56,1003,300,320
2117086,25,15,1988,10,"male",343,103,26,94,121,94,113,0,8
2117088,70,26,1943,5,"female",1130,63,33,3,0,2,0,1,0
2117102,18,30,1995,6,"male",591,22,14,0,0,0,0,0,0
2117134,16,29,1997,6,"female",425,409,186,14,32,14,28,0,4
2117155,27,4,1986,4,"male",120,83,47,728,1250,74,596,654,654
2117162,66,15,1947,7,"male",490,265,101,6,203,0,63,6,140
2117163,29,2,1984,7,"male",430,120,86,2,8,0,2,2,6
2117171,26,1,1987,1,"male",243,18,12,7,0,7,0,0,0
2117187,23,5,1990,8,"male",497,6,4,5,1,5,1,0,0
2117197,14,12,1999,6,"female",566,4615,1848,1257,4680,978,2034,279,2646
2117217,19,13,1994,1,"male",179,16,9,0,2,0,2,0,0
2117221,108,5,1905,9,"male",57,6,6,10,0,10,0,0,0
2117224,19,18,1994,11,"female",253,491,114,904,432,904,360,0,72
2117230,27,2,1986,2,"male",76,33,29,29,12,29,8,0,4
2117260,18,24,1995,10,"female",418,72,53,9,5,2,3,7,2
2117266,17,23,1996,3,"male",340,201,94,0,5,0,2,0,3
2117288,14,15,1999,12,"female",304,252,109,750,624,740,321,10,303
2117304,33,30,1980,8,"female",116,30,23,7,15,7,8,0,7
2117330,25,12,1988,7,"male",213,3,2,0,0,0,0,0,0
2117338,53,13,1960,6,"male",424,102,78,4,18,4,2,0,16
2117353,18,22,1995,4,"male",454,22,11,6,0,0,0,6,0
2117356,56,29,1957,10,"female",783,532,484,30,8,30,5,0,3
2117385,25,12,1988,12,"female",169,81,33,0,2,0,1,0,1
2117396,23,20,1990,4,"female",13,38,33,0,1,0,1,0,0
2117399,33,29,1980,5,"male",676,110,84,0,0,0,0,0,0
2117434,108,2,1905,8,"female",2654,949,355,93,30,84,27,9,3
2117438,26,1,1987,1,"male",509,150,90,29,23,15,15,14,8
2117456,18,10,1995,10,"male",518,178,134,0,0,0,0,0,0
2117458,46,13,1967,11,"male",667,224,175,0,1,0,1,0,0
2117460,33,1,1980,7,"female",1660,246,150,1232,979,1203,577,29,402
2117487,103,10,1910,2,"female",45,76,62,40,31,40,29,0,2
2117497,18,17,1995,10,"male",254,217,204,22,1,13,0,9,1
2117500,113,14,1900,2,"male",1221,356,184,37,62,37,51,0,11
2117582,27,14,1986,12,"female",654,33,6,0,1,0,0,0,1
2117584,49,5,1964,2,"female",1110,8,3,2,0,1,0,1,0
2117616,61,3,1952,2,"female",578,370,95,392,123,156,47,236,76
2117619,24,10,1989,1,"male",470,262,146,2329,514,2329,503,0,11
2117637,19,18,1994,4,"male",854,2001,540,567,5133,167,4436,400,697
2117654,28,7,1985,1,"male",472,1,1,0,0,0,0,0,0
2117675,17,7,1996,1,"male",419,425,309,638,272,60,83,578,189
2117680,33,5,1980,1,"female",717,41,23,88,40,88,33,0,7
2117692,53,19,1960,1,"female",506,46,24,133,37,0,17,133,20
2117697,30,20,1983,1,"female",1799,357,140,21,94,21,76,0,18
2117724,29,17,1984,5,"female",585,138,82,2,3,0,1,2,2
2117758,32,11,1981,3,"male",663,41,21,3,2,3,1,0,1
2117773,21,1,1992,1,"male",633,49,40,12,5,12,5,0,0
2117796,29,1,1984,1,"male",451,2,0,30,0,30,0,0,0
2117824,47,1,1966,11,"male",781,553,323,88,71,8,35,80,36
2117852,34,10,1979,5,"female",60,8,6,0,0,0,0,0,0
2117865,24,15,1989,2,"male",61,16,16,0,0,0,0,0,0
2117888,19,29,1994,10,"male",345,3620,1953,432,6373,432,4905,0,1468
2117894,27,8,1986,9,"male",675,197,124,3,1,3,1,0,0
2117919,32,16,1981,6,"male",764,63,48,0,0,0,0,0,0
2117958,108,17,1905,8,"male",1135,428,204,3,12,3,9,0,3
2117963,21,13,1992,4,"male",45,36,14,29,53,2,3,27,50
2118009,18,1,1995,2,"female",40,7,5,874,802,862,503,12,299
2118031,19,15,1994,9,"male",535,599,304,15,10,15,6,0,4
2118039,35,15,1978,10,"male",160,20,19,0,0,0,0,0,0
2118054,27,18,1986,11,"male",807,495,331,0,0,0,0,0,0
2118062,13,1,2000,1,"male",69,90,73,6,2,6,2,0,0
2118064,51,22,1962,12,"male",317,15,11,15,11,3,8,12,3
2118091,13,21,2000,7,"female",357,552,349,390,815,374,550,16,265
2118121,21,24,1992,10,"male",35,8,7,5,0,5,0,0,0
2118131,19,14,1994,8,"female",315,27,11,0,0,0,0,0,0
2118136,18,13,1995,12,"male",303,49,17,4,7,4,3,0,4
2118152,59,6,1954,1,"female",1188,93,67,71,69,70,36,1,33
2118158,35,3,1978,4,"male",1098,372,246,1,38,1,37,0,1
2118200,49,9,1964,7,"female",781,95,53,131,120,113,100,18,20
2118214,22,30,1991,11,"female",1335,129,49,742,1076,421,568,321,508
2118218,15,1,1998,9,"female",888,628,386,2844,1115,2221,606,623,509
2118249,60,22,1953,11,"female",1605,71,35,34,10,34,8,0,2
2118277,17,12,1996,6,"female",309,16,10,86,23,12,0,74,23
2118278,94,12,1919,10,"male",1317,871,436,315,96,315,77,0,19
2118340,25,17,1988,9,"female",443,100,52,31,46,25,42,6,4
2118383,63,30,1950,12,"male",431,46,37,5,4,3,2,2,2
2118402,33,1,1980,3,"female",25,46,30,634,185,629,148,5,37
2118408,47,3,1966,3,"male",26,4,4,6,2,6,2,0,0
2118433,37,8,1976,8,"female",126,29,18,162,12,132,7,30,5
2118436,63,5,1950,1,"male",41,34,8,0,5,0,2,0,3
2118463,35,29,1978,5,"male",167,37,32,2,8,2,1,0,7
2118497,18,21,1995,4,"male",506,153,74,0,45,0,13,0,32
2118548,53,22,1960,11,"female",244,31,21,33,10,33,9,0,1
2118570,28,14,1985,11,"female",198,58,7,2,4,2,4,0,0
2118571,15,6,1998,1,"female",481,35,23,0,0,0,0,0,0
2118616,24,19,1989,5,"male",96,43,39,0,0,0,0,0,0
2118631,50,10,1963,2,"female",627,33,19,55,9,55,8,0,1
2118643,21,28,1992,10,"female",628,375,46,456,443,45,242,411,201
2118652,24,31,1989,8,"female",337,181,40,63,56,63,54,0,2
2118653,40,20,1973,5,"female",202,47,19,36,125,36,119,0,6
2118687,37,22,1976,2,"male",1285,99,19,66,3,66,2,0,1
2118690,21,5,1992,2,"female",638,231,130,116,61,116,46,0,15
2118732,31,19,1982,11,"male",373,5,4,0,0,0,0,0,0
2118754,15,13,1998,1,"male",257,42,19,0,0,0,0,0,0
2118765,32,13,1981,1,"male",424,158,90,39,6,39,3,0,3
2118779,53,18,1960,9,"male",196,111,88,0,0,0,0,0,0
2118835,36,2,1977,10,"female",268,11,10,10,0,10,0,0,0
2118836,59,12,1954,11,"male",1022,39,19,12,100,0,7,12,93
2118837,22,30,1991,1,"male",320,42,25,0,0,0,0,0,0
2118888,63,5,1950,5,"female",984,161,134,403,648,249,334,154,314
2118890,57,17,1956,12,"female",958,62,28,96,56,2,6,94,50
2118895,33,8,1980,4,"female",626,65,38,29,4,2,1,27,3
2118905,25,8,1988,11,"female",67,17,13,0,0,0,0,0,0
2118935,18,30,1995,12,"male",183,83,59,3,2,1,1,2,1
2118936,27,29,1986,5,"male",669,31,13,69,18,15,2,54,16
2118953,48,22,1965,11,"male",459,0,0,0,2,0,1,0,1
2118956,37,19,1976,9,"male",269,4,0,0,0,0,0,0,0
2118958,27,12,1986,2,"male",609,68,33,0,0,0,0,0,0
2119011,53,13,1960,1,"female",1713,38,23,49,18,44,10,5,8
2119021,22,22,1991,10,"male",335,54,45,3,2,0,1,3,1
2119080,48,27,1965,7,"female",173,50,34,503,166,503,108,0,58
2119105,15,7,1998,3,"female",326,403,126,414,150,409,61,5,89
2119117,16,2,1997,8,"male",589,817,536,214,103,214,74,0,29
2119129,20,11,1993,6,"male",202,167,144,4,0,4,0,0,0
2119131,20,2,1993,12,"female",24,286,16,0,0,0,0,0,0
2119141,49,10,1964,12,"female",427,54,23,0,0,0,0,0,0
2119168,14,4,1999,7,"male",432,82,22,11,16,0,5,11,11
2119201,22,28,1991,2,"female",608,88,58,0,3,0,2,0,1
2119205,23,21,1990,4,"female",303,44,30,1981,3213,3,190,1978,3023
2119220,72,24,1941,1,"female",46,113,45,25,20,4,6,21,14
2119231,31,5,1982,12,"male",36,9,6,0,1,0,1,0,0
2119270,26,30,1987,12,"female",478,130,41,72,21,72,18,0,3
2119271,18,25,1995,5,"female",487,51,25,0,0,0,0,0,0
2119275,39,21,1974,5,"female",466,19,7,42,31,42,28,0,3
2119287,59,11,1954,11,"female",619,64,32,62,7,37,7,25,0
2119297,75,7,1938,10,"male",924,43,25,1,2,0,0,1,2
2119300,60,8,1953,9,"male",419,63,33,12,24,12,17,0,7
2119311,22,26,1991,4,"female",336,332,294,0,0,0,0,0,0
2119354,27,8,1986,3,"male",235,63,32,191,23,191,22,0,1
2119371,24,14,1989,9,"male",568,50,24,0,0,0,0,0,0
2119405,34,21,1979,2,"female",321,24,7,8,2,8,0,0,2
2119418,55,23,1958,1,"male",443,61,56,48,46,0,18,48,28
2119421,14,14,1999,11,"female",21,24,16,1,2,1,1,0,1
2119431,103,29,1910,12,"male",477,263,181,38,8,38,8,0,0
2119453,100,27,1913,6,"female",339,130,67,67,111,67,105,0,6
2119454,14,21,1999,4,"male",30,0,0,0,0,0,0,0,0
2119457,34,14,1979,9,"male",321,142,100,10,3,10,3,0,0
2119459,24,24,1989,3,"female",710,272,215,21,4,15,2,6,2
2119476,26,7,1987,11,"male",341,112,109,367,41,336,40,31,1
2119490,22,30,1991,1,"female",440,396,139,147,223,147,172,0,51
2119509,39,21,1974,3,"male",873,78,28,3,33,0,9,3,24
2119510,17,10,1996,5,"male",361,163,115,1,0,0,0,1,0
2119518,25,27,1988,8,"male",842,290,219,12,6,10,6,2,0
2119521,60,15,1953,6,"female",535,146,91,24,24,0,10,24,14
2119524,17,30,1996,9,"male",785,1053,804,0,0,0,0,0,0
2119525,77,20,1936,5,"female",264,39,19,97,20,25,18,72,2
2119564,31,16,1982,8,"female",269,3,3,0,0,0,0,0,0
2119573,24,25,1989,5,"male",68,30,20,2,6,2,2,0,4
2119575,70,24,1943,2,"female",828,372,136,681,620,25,229,656,391
2119633,17,3,1996,2,"female",508,218,149,162,101,30,50,132,51
2119716,108,18,1905,5,"female",96,584,428,667,745,188,513,479,232
2119728,33,15,1980,4,"male",387,132,115,105,116,105,90,0,26
2119739,31,22,1982,8,"male",829,622,446,69,27,69,26,0,1
2119757,66,12,1947,6,"male",367,20,16,0,0,0,0,0,0
2119786,31,28,1982,8,"male",393,101,71,2,4,2,4,0,0
2119798,39,4,1974,5,"female",81,32,19,57,15,57,13,0,2
2119799,19,17,1994,8,"male",258,40,39,0,8,0,7,0,1
2119827,23,20,1990,11,"male",133,68,43,0,1,0,1,0,0
2119829,27,17,1986,8,"male",579,54,52,39,26,39,26,0,0
2119848,103,3,1910,7,"male",1617,570,180,29,9,29,4,0,5
2119857,20,30,1993,11,"female",353,629,398,725,469,360,262,365,207
2119888,103,11,1910,5,"male",527,134,33,21,9,21,9,0,0
2119902,60,28,1953,12,"male",1429,148,81,25,20,25,18,0,2
2119903,53,3,1960,6,"female",917,261,137,182,187,130,106,52,81
2119907,33,6,1980,5,"male",1166,394,320,0,17,0,5,0,12
2119934,22,6,1991,4,"male",639,93,42,10,42,10,38,0,4
2119942,24,16,1989,9,"male",326,214,170,16,3,14,2,2,1
2119976,34,22,1979,11,"male",324,106,65,87,93,69,29,18,64
2120053,32,14,1981,2,"male",1345,202,70,9,23,9,23,0,0
2120079,20,15,1993,6,"male",471,59,8,2,3,2,3,0,0
2120106,45,26,1968,2,"male",1342,304,280,0,14,0,8,0,6
2120110,92,9,1921,3,"male",2196,300,192,20,42,0,4,20,38
2120149,22,13,1991,10,"male",91,48,40,8,0,4,0,4,0
2120151,20,1,1993,1,"male",82,2,2,1,3,1,3,0,0
2120163,24,9,1989,8,"male",811,231,204,0,0,0,0,0,0
2120166,16,21,1997,6,"female",580,47,5,0,0,0,0,0,0
2120172,14,6,1999,10,"male",118,128,72,12,8,12,6,0,2
2120204,21,21,1992,8,"female",743,1041,346,186,1224,99,588,87,636
2120205,70,22,1943,11,"female",1450,11,5,17,4,0,2,17,2
2120219,25,19,1988,7,"male",699,1,1,0,0,0,0,0,0
2120267,21,12,1992,5,"female",738,846,400,19,349,19,319,0,30
2120290,98,30,1915,5,"male",325,438,179,2,7,2,7,0,0
2120305,22,5,1991,7,"male",873,19,7,7,1,7,1,0,0
2120314,31,6,1982,1,"male",260,28,13,0,0,0,0,0,0
2120327,20,26,1993,1,"male",888,757,513,1,10,1,4,0,6
2120332,67,17,1946,11,"male",292,21,10,13,1,13,1,0,0
2120343,13,2,2000,1,"male",192,74,49,54,6,54,4,0,2
2120348,70,1,1943,1,"male",672,106,83,1,0,0,0,1,0
2120361,16,5,1997,3,"female",464,266,153,19,2,19,2,0,0
2120365,41,22,1972,9,"male",948,65,43,0,0,0,0,0,0
2120370,21,2,1992,3,"female",183,166,130,0,0,0,0,0,0
2120396,18,27,1995,7,"male",79,32,14,0,4,0,1,0,3
2120409,93,3,1920,11,"female",2211,312,181,138,77,94,33,44,44
2120422,17,18,1996,7,"female",858,835,386,178,124,159,74,19,50
2120443,92,17,1921,10,"male",958,438,257,56,921,56,746,0,175
2120455,19,6,1994,6,"female",250,37,14,21,13,21,8,0,5
2120475,34,12,1979,12,"female",21,1,1,0,0,0,0,0,0
2120485,16,27,1997,10,"male",69,19,14,2,8,0,7,2,1
2120487,18,27,1995,11,"female",210,255,217,26,26,21,5,5,21
2120500,28,21,1985,5,"female",279,200,173,362,253,358,176,4,77
2120501,68,12,1945,1,"female",1593,200,134,834,710,115,477,719,233
2120503,20,8,1993,11,"male",256,221,87,3,5,3,5,0,0
2120507,45,20,1968,11,"female",223,19,12,132,29,132,24,0,5
2120509,63,14,1950,8,"male",893,15,14,1,0,0,0,1,0
2120524,25,30,1988,7,"male",766,63,28,0,1,0,1,0,0
2120555,44,3,1969,7,"male",369,64,39,49,10,49,8,0,2
2120581,27,14,1986,4,"male",564,144,90,2,61,2,24,0,37
2120606,42,1,1971,1,"male",539,57,46,3,0,0,0,3,0
2120622,22,23,1991,10,"male",483,211,146,107,14,107,14,0,0
2120669,16,22,1997,12,"male",103,33,28,93,6,93,3,0,3
2120676,67,17,1946,7,"male",1150,42,24,9,1,0,0,9,1
2120677,52,21,1961,1,"male",1560,60,24,47,36,47,34,0,2
2120703,20,3,1993,11,"female",1950,84,22,31,60,3,36,28,24
2120711,34,10,1979,5,"female",337,174,133,3,7,3,7,0,0
2120719,108,30,1905,11,"male",889,219,105,310,5,15,4,295,1
2120728,20,15,1993,11,"female",1634,112,63,1142,558,588,133,554,425
2120729,24,10,1989,10,"male",274,206,92,11,6,8,6,3,0
2120739,108,1,1905,1,"female",202,9,4,9,5,7,3,2,2
2120749,34,21,1979,8,"male",440,7,6,68,7,68,4,0,3
2120752,54,20,1959,7,"male",402,4,4,1,0,0,0,1,0
2120763,51,12,1962,12,"male",663,3,0,0,0,0,0,0,0
2120764,85,22,1928,12,"female",2469,1002,538,95,97,42,40,53,57
2120766,36,4,1977,4,"male",277,110,96,14,11,14,9,0,2
2120780,46,17,1967,12,"female",473,37,26,0,9,0,5,0,4
2120791,103,30,1910,9,"male",635,214,129,44,43,44,24,0,19
2120815,39,25,1974,10,"male",727,18,11,0,0,0,0,0,0
2120822,65,11,1948,6,"male",1949,134,64,191,14,190,7,1,7
2120845,26,1,1987,1,"male",605,24,17,1,0,1,0,0,0
2120851,42,11,1971,7,"male",169,35,14,0,0,0,0,0,0
2120862,49,19,1964,12,"male",1761,285,198,25,8,24,5,1,3
2120893,19,11,1994,3,"female",418,250,122,2,0,0,0,2,0
2120898,19,31,1994,12,"male",44,84,70,4,0,4,0,0,0
2120900,18,15,1995,4,"female",894,584,337,635,676,525,217,110,459
2120904,19,5,1994,3,"male",91,41,38,6,1,6,1,0,0
2120914,28,28,1985,12,"male",391,79,60,2,1,2,1,0,0
2120941,108,6,1905,6,"female",1651,163,24,44,148,20,57,24,91
2120957,20,16,1993,3,"female",217,402,89,775,1101,775,801,0,300
2120961,92,12,1921,2,"female",1523,1163,1083,213,928,9,26,204,902
2120971,47,29,1966,3,"female",2179,132,51,703,811,492,402,211,409
2121008,33,18,1980,5,"male",414,33,14,26,9,20,9,6,0
2121027,32,2,1981,9,"female",461,257,192,191,280,191,196,0,84
2121038,27,3,1986,1,"female",449,51,26,1,1,1,1,0,0
2121040,43,18,1970,2,"female",106,79,73,5,29,5,26,0,3
2121048,22,10,1991,3,"male",417,125,28,0,1,0,0,0,1
2121073,21,29,1992,7,"male",521,27,14,8,0,8,0,0,0
2121078,25,1,1988,1,"male",55,3,3,0,0,0,0,0,0
2121081,16,17,1997,5,"female",419,391,125,0,0,0,0,0,0
2121090,20,2,1993,4,"male",250,118,62,1,0,0,0,1,0
2121091,19,25,1994,2,"male",287,17,13,1,0,0,0,1,0
2121106,43,15,1970,1,"male",648,10,5,0,0,0,0,0,0
2121117,17,1,1996,2,"female",21,12,12,0,0,0,0,0,0
2121140,103,27,1910,12,"female",836,270,36,4,15,4,9,0,6
2121148,21,17,1992,7,"male",82,150,129,0,1,0,0,0,1
2121150,28,19,1985,4,"female",372,129,56,303,89,303,81,0,8
2121152,36,11,1977,2,"female",596,163,54,225,316,225,181,0,135
2121157,22,12,1991,2,"male",973,494,353,0,9,0,9,0,0
2121181,18,15,1995,7,"male",244,10,10,0,0,0,0,0,0
2121183,19,8,1994,11,"male",338,33,8,1,0,0,0,1,0
2121190,17,23,1996,12,"female",600,158,56,0,2,0,1,0,1
2121204,68,8,1945,5,"male",467,28,17,3,0,0,0,3,0
2121215,108,26,1905,9,"male",299,369,267,1094,146,1065,64,29,82
2121221,27,10,1986,10,"female",291,117,78,203,22,198,9,5,13
2121251,28,5,1985,10,"male",240,0,0,0,0,0,0,0,0
2121358,16,4,1997,3,"male",520,136,91,1,0,1,0,0,0
2121365,103,1,1910,1,"male",545,1,1,0,0,0,0,0,0
2121402,71,7,1942,2,"female",695,20,12,0,0,0,0,0,0
2121410,14,18,1999,2,"female",224,692,542,290,289,193,204,97,85
2121416,99,26,1914,3,"male",23,69,37,7,4,7,4,0,0
2121427,29,20,1984,11,"male",305,48,25,12,0,12,0,0,0
2121434,17,20,1996,12,"male",248,23,19,0,0,0,0,0,0
2121518,65,30,1948,7,"female",1517,77,56,133,111,133,103,0,8
2121531,21,11,1992,3,"male",802,610,232,0,0,0,0,0,0
2121554,40,5,1973,8,"male",1006,10,0,15,2,11,2,4,0
2121563,27,24,1986,6,"male",137,6,6,0,0,0,0,0,0
2121569,19,15,1994,2,"female",471,259,160,669,109,36,92,633,17
2121571,25,17,1988,8,"male",297,43,25,0,1,0,1,0,0
2121614,15,6,1998,12,"male",201,156,130,0,0,0,0,0,0
2121637,22,1,1991,12,"female",344,275,207,0,5,0,1,0,4
2121662,48,19,1965,3,"male",1003,65,20,22,59,20,25,2,34
2121665,24,3,1989,5,"male",329,59,47,0,0,0,0,0,0
2121708,65,12,1948,2,"female",223,20,14,113,0,113,0,0,0
2121713,66,23,1947,3,"male",1320,97,13,12,17,0,9,12,8
2121718,19,15,1994,6,"male",822,109,75,119,26,118,20,1,6
2121730,57,13,1956,4,"female",950,491,172,2846,1212,2722,388,124,824
2121731,66,26,1947,7,"female",307,29,19,53,7,0,2,53,5
2121735,53,12,1960,1,"female",638,88,23,321,19,14,11,307,8
2121741,28,6,1985,6,"male",254,64,19,0,16,0,7,0,9
2121747,23,1,1990,1,"female",1488,534,131,41,184,41,152,0,32
2121754,46,1,1967,8,"male",362,67,65,2,5,2,5,0,0
2121762,32,4,1981,5,"female",100,16,15,7,0,7,0,0,0
2121772,25,1,1988,1,"male",213,35,14,7,1,7,1,0,0
2121773,33,14,1980,2,"female",78,0,0,0,0,0,0,0,0
2121782,21,21,1992,12,"female",3,4,4,0,4,0,3,0,1
2121788,63,1,1950,12,"male",342,15,14,16,4,16,4,0,0
2121792,20,14,1993,4,"male",510,575,38,8032,2653,6144,1108,1888,1545
2121793,20,10,1993,5,"female",389,309,227,42,199,20,130,22,69
2121795,44,11,1969,12,"male",532,21,7,19,0,19,0,0,0
2121804,22,19,1991,11,"female",962,56,43,836,1002,236,320,600,682
2121826,31,11,1982,1,"male",736,224,51,3,0,3,0,0,0
2121839,39,17,1974,2,"female",77,29,24,90,7,0,0,90,7
2121847,19,12,1994,9,"male",137,5,3,0,0,0,0,0,0
2121875,18,12,1995,4,"female",113,258,151,2276,2123,2159,1369,117,754
2121908,15,2,1998,1,"male",459,13,8,0,3,0,0,0,3
2121913,41,28,1972,10,"male",290,24,22,2,0,2,0,0,0
2121942,64,12,1949,11,"female",1132,69,30,4,9,0,3,4,6
2121965,65,19,1948,11,"female",475,110,88,158,188,0,19,158,169
2122017,25,30,1988,12,"male",229,95,54,0,50,0,29,0,21
2122038,26,19,1987,4,"male",399,79,29,7,14,7,6,0,8
2122058,39,26,1974,12,"female",368,32,15,1,1,1,1,0,0
2122068,17,8,1996,9,"male",14,0,0,0,0,0,0,0,0
2122099,20,7,1993,3,"female",34,37,29,1,14,1,6,0,8
2122103,23,1,1990,1,"female",368,170,148,0,15,0,3,0,12
2122107,26,11,1987,7,"male",423,253,164,17,1,1,0,16,1
2122126,21,4,1992,7,"male",1210,192,171,0,10,0,0,0,10
2122129,68,1,1945,2,"female",1557,27,16,18,2,18,0,0,2
2122151,24,21,1989,9,"female",724,71,36,165,97,115,50,50,47
2122153,31,18,1982,8,"male",525,60,46,87,13,0,2,87,11
2122156,17,11,1996,5,"male",384,170,147,0,0,0,0,0,0
2122162,53,19,1960,8,"female",1374,9,6,3,9,0,2,3,7
2122169,20,13,1993,10,"female",36,124,123,37,1,37,1,0,0
2122174,17,15,1996,3,"female",656,205,115,915,695,149,206,766,489
2122185,42,9,1971,2,"male",603,64,54,2,4,2,3,0,1
2122202,25,21,1988,12,"male",189,399,285,2,2,2,2,0,0
2122217,15,6,1998,11,"male",190,15,6,0,0,0,0,0,0
2122224,60,15,1953,11,"male",555,76,43,0,5,0,3,0,2
2122233,16,12,1997,9,"male",88,1,1,0,0,0,0,0,0
2122244,16,1,1997,1,"male",321,226,187,2,12,2,8,0,4
2122261,28,16,1985,11,"male",360,65,33,12,1,4,0,8,1
2122270,21,21,1992,2,"female",322,41,26,409,207,405,140,4,67
2122278,25,1,1988,1,"female",1,1,1,0,18,0,6,0,12
2122281,62,22,1951,7,"male",1357,152,54,10,32,0,18,10,14
2122302,35,27,1978,5,"male",62,1,0,16,4,0,0,16,4
2122318,35,16,1978,4,"female",457,347,213,2805,1683,2007,883,798,800
2122319,85,30,1928,5,"female",1349,54,29,0,0,0,0,0,0
2122338,50,29,1963,3,"male",198,10,9,7,0,7,0,0,0
2122363,23,27,1990,9,"male",497,202,126,0,16,0,15,0,1
2122370,51,22,1962,5,"female",474,445,187,195,128,192,65,3,63
2122371,54,2,1959,4,"female",115,189,69,543,68,543,42,0,26
2122373,14,25,1999,9,"female",77,300,53,19,8,19,8,0,0
2122394,25,13,1988,8,"female",456,71,38,7,0,7,0,0,0
2122396,16,24,1997,4,"male",626,387,191,1066,2168,822,1392,244,776
2122467,25,11,1988,2,"male",207,31,9,0,0,0,0,0,0
2122484,33,12,1980,3,"female",235,222,63,196,110,185,64,11,46
2122530,30,30,1983,1,"male",89,32,24,6,18,6,8,0,10
2122537,22,12,1991,3,"female",429,57,56,0,0,0,0,0,0
2122611,90,2,1923,11,NA,1960,5,4,33,12,2,0,31,12
2122613,29,19,1984,11,"female",257,55,24,25,9,25,9,0,0
2122671,66,15,1947,10,"female",677,20,15,86,18,86,14,0,4
2122676,56,27,1957,7,"male",1161,24,10,0,0,0,0,0,0
2122677,14,23,1999,8,"male",113,115,83,2,0,2,0,0,0
2122693,58,1,1955,2,"female",529,7,6,6,1,6,0,0,1
2122701,45,1,1968,12,"female",404,3,3,1,1,0,0,1,1
2122707,25,25,1988,9,"male",126,80,78,24,8,0,1,24,7
2122722,46,13,1967,9,"male",599,140,57,0,0,0,0,0,0
2122727,19,11,1994,11,"male",622,1562,1009,1,0,1,0,0,0
2122729,46,1,1967,1,"male",519,39,35,2,0,2,0,0,0
2122738,30,12,1983,5,"male",230,57,42,74,25,74,22,0,3
2122746,27,21,1986,10,"female",542,5,3,1,4,1,4,0,0
2122747,24,9,1989,3,"male",553,80,16,37,29,37,29,0,0
2122776,25,26,1988,4,"female",111,224,27,6,2,0,0,6,2
2122785,23,1,1990,5,"male",860,286,223,74,111,74,87,0,24
2122824,23,13,1990,2,"male",465,137,57,95,144,82,79,13,65
2122825,20,12,1993,2,"female",608,328,298,57,15,26,2,31,13
2122836,31,27,1982,12,"female",158,47,40,0,0,0,0,0,0
2122893,18,23,1995,10,"female",485,21,6,0,0,0,0,0,0
2122914,18,5,1995,12,"male",180,395,332,4,3,4,3,0,0
2122917,103,2,1910,9,"female",604,30,28,82,4,82,4,0,0
2122932,45,1,1968,12,"female",668,89,58,0,0,0,0,0,0
2122964,21,21,1992,3,"female",670,2,1,1,0,1,0,0,0
2123021,45,18,1968,10,"female",427,107,67,25,34,0,1,25,33
2123022,22,4,1991,3,"female",198,60,37,226,48,225,30,1,18
2123060,64,4,1949,6,"male",496,22,12,0,0,0,0,0,0
2123079,25,2,1988,3,"male",1134,85,50,0,1,0,1,0,0
2123091,39,1,1974,2,"female",1012,103,64,127,193,127,154,0,39
2123100,93,22,1920,2,"female",1054,497,292,0,12,0,2,0,10
2123103,21,8,1992,11,"male",440,145,114,9,22,9,19,0,3
2123115,14,10,1999,5,"male",440,139,52,16,7,0,0,16,7
2123118,25,5,1988,7,"male",513,781,531,0,2,0,2,0,0
2123135,31,12,1982,4,"male",205,30,15,4,7,4,6,0,1
2123148,18,10,1995,10,"male",367,155,119,246,16,246,15,0,1
2123161,108,27,1905,3,"male",1313,171,39,158,24,158,12,0,12
2123176,14,13,1999,4,"female",255,56,28,0,1,0,0,0,1
2123181,17,30,1996,8,"male",559,51,41,5,3,5,2,0,1
2123198,27,10,1986,2,"male",688,100,66,15,8,3,5,12,3
2123200,18,24,1995,11,"female",27,70,52,3,7,3,6,0,1
2123201,79,5,1934,9,"female",334,7,5,0,1,0,0,0,1
2123227,31,22,1982,7,"male",745,1,0,0,0,0,0,0,0
2123232,20,28,1993,9,"female",265,344,175,702,448,685,299,17,149
2123271,25,20,1988,7,"female",1305,32,16,11,46,11,42,0,4
2123278,68,8,1945,10,"male",945,435,292,9,25,5,17,4,8
2123305,16,7,1997,1,"female",518,132,22,0,0,0,0,0,0
2123339,17,15,1996,12,"female",280,279,129,515,501,515,264,0,237
2123400,34,21,1979,10,"female",328,23,15,9,20,9,10,0,10
2123405,15,24,1998,11,"female",67,894,622,1421,1622,1344,1014,77,608
2123431,23,19,1990,4,"female",402,262,154,10,6,4,0,6,6
2123435,54,2,1959,4,"male",660,21,20,1,0,0,0,1,0
2123522,15,21,1998,10,"female",277,80,42,73,21,24,12,49,9
2123558,56,21,1957,5,"male",1580,210,123,30,5,30,5,0,0
2123575,18,26,1995,10,"male",417,18,6,0,0,0,0,0,0
2123609,24,29,1989,1,"male",4,4,3,3,1,3,0,0,1
2123626,32,21,1981,4,"male",159,14,12,0,1,0,0,0,1
2123634,27,14,1986,8,"male",422,283,250,4,4,4,2,0,2
2123646,18,1,1995,4,"female",566,5,0,0,0,0,0,0,0
2123665,64,14,1949,10,"male",654,186,121,37,24,31,17,6,7
2123696,31,9,1982,9,"male",948,162,109,0,0,0,0,0,0
2123702,30,31,1983,3,"male",373,116,89,33,5,33,3,0,2
2123730,50,20,1963,5,"female",725,128,88,55,12,48,9,7,3
2123802,28,12,1985,1,"male",332,6,6,2,0,2,0,0,0
2123807,40,20,1973,5,"male",360,39,13,89,39,84,24,5,15
2123823,14,15,1999,6,"male",426,200,133,0,0,0,0,0,0
2123833,32,19,1981,4,"male",424,48,26,24,8,24,8,0,0
2123837,40,8,1973,10,"male",127,42,27,24,65,24,63,0,2
2123890,33,17,1980,12,"male",280,11,0,1,0,1,0,0,0
2123891,25,30,1988,6,"male",232,222,151,28,2,28,2,0,0
2123920,22,21,1991,7,"male",556,11,4,3,0,3,0,0,0
2123927,44,17,1969,11,"male",279,81,30,12,5,10,4,2,1
2123943,23,17,1990,1,"male",193,96,88,0,9,0,3,0,6
2123944,56,18,1957,6,"female",1888,174,55,250,415,224,352,26,63
2123946,29,10,1984,11,"male",445,97,51,23,8,23,4,0,4
2123959,16,14,1997,6,"male",393,99,60,7,0,7,0,0,0
2123961,16,1,1997,3,"male",638,320,208,1,8,1,5,0,3
2123980,32,8,1981,5,"male",181,113,92,268,121,268,85,0,36
2124058,18,24,1995,7,"male",552,18,13,5,0,0,0,5,0
2124059,45,30,1968,4,"male",556,193,73,67,41,67,24,0,17
2124063,23,9,1990,2,"male",1182,52,16,1,2,1,1,0,1
2124070,21,4,1992,7,"female",483,236,119,0,25,0,12,0,13
2124074,40,3,1973,3,"male",22,17,9,26,31,9,21,17,10
2124078,29,17,1984,6,"female",234,350,132,2838,1349,2834,1076,4,273
2124095,51,8,1962,6,"female",671,24,12,23,32,23,16,0,16
2124140,45,13,1968,12,"male",138,72,72,0,3,0,3,0,0
2124142,21,1,1992,9,"female",807,350,172,15,41,12,11,3,30
2124155,18,9,1995,6,"male",628,254,118,12,2,12,2,0,0
2124174,33,15,1980,10,"male",73,8,7,0,0,0,0,0,0
2124197,34,5,1979,9,"female",703,274,111,0,0,0,0,0,0
2124203,25,19,1988,6,"male",403,43,38,1,11,1,10,0,1
2124204,54,22,1959,6,"male",8,0,0,0,0,0,0,0,0
2124207,46,25,1967,7,"male",123,186,133,5,10,0,3,5,7
2124209,34,11,1979,11,"male",67,351,261,4,2,4,1,0,1
2124216,32,14,1981,1,"male",522,27,14,0,0,0,0,0,0
2124223,24,7,1989,9,"female",60,316,130,22,43,22,41,0,2
2124237,19,26,1994,6,"female",170,129,79,24,30,22,23,2,7
2124267,44,17,1969,9,"male",403,1,1,7,1,7,1,0,0
2124274,25,30,1988,12,"male",649,68,62,14,12,14,12,0,0
2124310,108,1,1905,1,"male",1201,123,75,4,0,0,0,4,0
2124312,18,23,1995,2,"male",1091,152,114,6,1,6,1,0,0
2124323,21,25,1992,12,"male",669,0,0,0,0,0,0,0,0
2124331,21,29,1992,2,"male",561,225,207,0,0,0,0,0,0
2124335,53,26,1960,10,"female",522,65,48,72,48,11,19,61,29
2124346,48,18,1965,5,"male",606,143,36,14,1,14,1,0,0
2124356,62,20,1951,11,"female",997,65,43,105,73,6,56,99,17
2124381,25,10,1988,11,"male",389,221,188,0,0,0,0,0,0
2124384,15,24,1998,7,"female",215,2539,122,280,6004,255,2374,25,3630
2124411,33,21,1980,10,"female",291,36,15,517,229,448,117,69,112
2124427,103,3,1910,3,"female",965,111,36,48,334,34,172,14,162
2124448,23,20,1990,4,"male",417,277,35,0,0,0,0,0,0
2124461,53,21,1960,8,"female",1336,182,103,34,159,3,76,31,83
2124470,25,8,1988,6,"female",73,337,69,679,1444,326,1148,353,296
2124472,26,1,1987,1,"male",440,72,67,0,8,0,2,0,6
2124497,30,13,1983,3,"male",389,72,42,6,7,6,3,0,4
2124511,29,28,1984,10,"male",109,77,72,18,22,18,20,0,2
2124518,25,7,1988,4,"male",249,162,149,5,7,5,2,0,5
2124528,53,3,1960,3,"male",804,2,2,0,0,0,0,0,0
2124562,19,1,1994,1,"male",284,21,6,7,2,0,0,7,2
2124565,22,17,1991,2,"male",386,142,44,26,73,26,73,0,0
2124567,94,22,1919,4,"female",1525,498,221,194,150,194,74,0,76
2124600,108,22,1905,2,"male",1624,599,271,4,1,4,1,0,0
2124657,56,8,1957,3,"female",364,3,1,24,0,22,0,2,0
2124680,46,8,1967,6,"male",686,24,13,12,0,12,0,0,0
2124702,50,8,1963,12,"female",1173,272,213,1236,900,845,238,391,662
2124707,47,4,1966,5,"female",464,16,7,7,0,7,0,0,0
2124709,16,4,1997,3,"male",219,80,48,445,168,295,75,150,93
2124741,24,2,1989,6,"female",439,155,83,1289,1810,1046,1355,243,455
2124770,20,25,1993,1,"female",350,600,256,11,11,11,6,0,5
2124788,103,12,1910,11,"female",651,154,103,2,3,2,3,0,0
2124791,56,16,1957,10,"female",281,71,55,1,64,0,12,1,52
2124792,48,10,1965,8,"female",733,499,197,505,1089,501,246,4,843
2124805,24,19,1989,7,"female",554,305,252,62,133,62,108,0,25
2124825,53,20,1960,12,"male",797,27,25,6,0,1,0,5,0
2124826,30,23,1983,4,"male",67,32,20,24,16,10,9,14,7
2124833,15,5,1998,7,"male",553,192,122,1,2,0,2,1,0
2124841,46,2,1967,1,"male",476,187,86,58,81,53,29,5,52
2124869,20,4,1993,7,"female",67,85,80,5,8,5,8,0,0
2124870,19,10,1994,10,"male",568,307,143,0,5,0,5,0,0
2124873,107,30,1906,12,"male",1807,294,76,0,36,0,20,0,16
2124879,50,9,1963,5,"female",1631,100,51,205,56,46,3,159,53
2124882,33,29,1980,9,"male",579,181,134,5,119,5,69,0,50
2124883,34,24,1979,9,"female",260,31,26,70,7,70,2,0,5
2124890,41,3,1972,12,"male",399,17,15,0,0,0,0,0,0
2124910,41,17,1972,6,"female",237,62,43,371,227,175,105,196,122
2124919,103,18,1910,1,"female",1492,488,141,69,198,68,132,1,66
2124936,29,4,1984,4,"male",962,172,120,77,6,77,5,0,1
2124945,66,10,1947,1,"male",63,71,54,6,6,0,3,6,3
2124960,14,6,1999,4,"female",135,283,130,6514,5721,3289,3075,3225,2646
2124986,25,1,1988,1,"male",273,76,74,1,1,1,1,0,0
2125005,44,17,1969,12,"male",194,31,30,3,0,0,0,3,0
2125017,59,22,1954,1,"male",110,19,10,67,121,52,109,15,12
2125022,36,1,1977,5,"female",387,0,0,10,0,0,0,10,0
2125026,53,6,1960,9,"male",673,10,7,0,0,0,0,0,0
2125052,30,6,1983,5,"female",599,73,36,90,39,89,36,1,3
2125068,26,10,1987,8,"female",368,285,105,1,0,1,0,0,0
2125072,27,10,1986,5,"male",60,38,21,0,0,0,0,0,0
2125083,41,1,1972,1,"male",629,153,87,72,58,72,50,0,8
2125085,20,11,1993,9,"male",670,84,51,2,0,2,0,0,0
2125150,19,17,1994,11,"male",244,25,5,17,2,17,2,0,0
2125176,24,25,1989,1,"male",461,89,39,14,20,14,18,0,2
2125180,65,8,1948,8,"male",457,148,104,2735,645,1430,483,1305,162
2125183,18,4,1995,6,"female",897,2564,599,431,684,431,619,0,65
2125196,43,20,1970,2,"male",1207,2,1,5,2,5,2,0,0
2125204,29,24,1984,3,"male",397,7,5,10,1,0,0,10,1
2125220,37,15,1976,6,"female",393,69,56,170,131,164,80,6,51
2125221,41,26,1972,6,"female",29,10,8,1,3,0,2,1,1
2125233,43,20,1970,10,"female",97,43,31,1334,254,1334,182,0,72
2125236,78,25,1935,7,"female",1590,53,24,288,44,1,35,287,9
2125237,31,13,1982,5,"female",373,51,17,0,3,0,1,0,2
2125248,108,26,1905,3,"male",109,0,0,0,0,0,0,0,0
2125251,58,15,1955,10,"female",378,63,45,818,703,807,371,11,332
2125337,21,10,1992,2,"male",71,6,5,0,0,0,0,0,0
2125390,73,29,1940,4,"male",604,13,10,8,1,0,0,8,1
2125410,32,11,1981,4,"female",319,286,51,42,96,42,88,0,8
2125429,27,13,1986,3,"male",101,22,11,0,0,0,0,0,0
2125452,80,23,1933,3,"male",1189,1700,1267,1123,499,1123,468,0,31
2125469,22,4,1991,11,"female",324,184,113,17,161,8,62,9,99
2125472,16,27,1997,5,"male",336,46,9,2,2,2,2,0,0
2125494,17,1,1996,1,"male",135,23,13,0,0,0,0,0,0
2125495,25,1,1988,1,"male",136,4,3,18,2,0,1,18,1
2125497,68,9,1945,11,"male",2017,162,44,0,0,0,0,0,0
2125543,23,13,1990,3,"female",477,90,53,9,1,0,0,9,1
2125546,23,20,1990,3,"female",363,408,242,97,88,30,34,67,54
2125557,44,12,1969,7,"female",840,60,20,15,31,0,8,15,23
2125591,18,13,1995,11,"male",161,27,22,4,0,4,0,0,0
2125635,51,4,1962,6,"male",487,62,35,9,9,9,9,0,0
2125689,22,29,1991,3,"male",653,154,79,247,178,221,138,26,40
2125693,25,21,1988,10,"male",364,346,224,1,1,1,1,0,0
2125695,31,21,1982,8,"male",286,6,0,0,0,0,0,0,0
2125725,53,20,1960,5,"male",572,243,174,421,166,175,93,246,73
2125743,52,15,1961,12,"male",194,7,7,1,3,0,1,1,2
2125768,48,22,1965,4,"female",625,2,1,0,0,0,0,0,0
2125832,23,3,1990,1,"female",88,108,39,572,356,572,314,0,42
2125842,17,29,1996,8,"female",704,2449,860,460,639,438,390,22,249
2125848,26,7,1987,7,"female",1602,568,251,124,129,98,81,26,48
2125854,22,23,1991,3,"male",563,219,130,0,0,0,0,0,0
2125860,67,24,1946,12,"male",316,0,0,0,0,0,0,0,0
2125862,103,23,1910,5,"male",676,296,191,59,46,55,17,4,29
2125877,26,9,1987,4,"female",305,55,30,61,2,61,2,0,0
2125887,52,27,1961,2,"female",1033,94,35,37,33,0,11,37,22
2125907,103,26,1910,1,"male",1460,237,83,1,0,1,0,0,0
2125921,107,8,1906,2,"male",5,180,175,269,549,152,272,117,277
2125933,20,12,1993,8,"female",316,168,101,145,32,63,26,82,6
2125962,42,26,1971,11,"male",1796,261,44,3,2,3,2,0,0
2125984,103,12,1910,6,"male",691,145,104,5,1,5,1,0,0
2125985,18,24,1995,1,"female",454,70,41,86,120,30,58,56,62
2126011,17,12,1996,7,"male",481,110,73,43,16,0,3,43,13
2126077,18,22,1995,10,"male",142,257,223,24,17,20,16,4,1
2126095,45,11,1968,12,"male",936,162,92,42,2,34,1,8,1
2126105,28,12,1985,2,"male",295,40,15,0,5,0,0,0,5
2126120,47,20,1966,12,"female",914,158,51,1870,482,1092,238,778,244
2126134,14,28,1999,10,"male",35,68,49,1,0,0,0,1,0
2126136,60,9,1953,12,"female",2334,395,231,40,61,2,33,38,28
2126141,38,14,1975,10,"male",378,62,47,2,2,0,0,2,2
2126182,17,28,1996,9,"male",564,180,95,22,6,22,3,0,3
2126205,17,25,1996,11,"female",1358,591,395,1335,288,1316,223,19,65
2126232,14,16,1999,4,"male",118,151,109,19,241,5,86,14,155
2126242,23,27,1990,5,"male",387,3,3,0,0,0,0,0,0
2126252,57,27,1956,5,"male",573,253,124,0,1,0,1,0,0
2126267,108,14,1905,11,"male",216,118,96,30,8,0,8,30,0
2126268,38,7,1975,3,"female",25,5,3,9,1,9,1,0,0
2126276,31,4,1982,1,"female",582,352,137,481,501,479,331,2,170
2126287,23,26,1990,6,"male",749,12,9,22,0,21,0,1,0
2126289,25,30,1988,3,"male",58,1,1,5,0,5,0,0,0
2126306,99,26,1914,11,"male",779,76,30,1,13,1,8,0,5
2126355,50,8,1963,12,"male",937,52,47,63,65,49,28,14,37
2126356,15,22,1998,4,"male",118,18,14,5,0,5,0,0,0
2126360,36,19,1977,2,"female",476,268,164,10,643,10,569,0,74
2126376,56,5,1957,6,"female",688,174,67,73,1119,73,881,0,238
2126377,24,11,1989,8,"male",265,8,5,0,0,0,0,0,0
2126387,16,23,1997,3,"male",325,423,226,100,5,0,0,100,5
2126405,68,11,1945,9,"male",889,40,32,3,0,0,0,3,0
2126413,27,7,1986,3,"female",509,19,18,0,0,0,0,0,0
2126417,18,9,1995,2,"male",15,53,17,23,10,23,7,0,3
2126420,22,4,1991,1,"male",301,182,166,24,9,24,4,0,5
2126467,49,28,1964,1,"female",530,468,326,40,140,34,64,6,76
2126482,17,3,1996,8,"female",524,86,39,25,62,13,24,12,38
2126514,41,11,1972,6,"female",240,147,114,162,74,162,39,0,35
2126539,28,21,1985,6,"male",200,19,15,0,0,0,0,0,0
2126549,75,24,1938,6,"male",523,211,177,4,47,0,10,4,37
2126553,36,3,1977,7,"female",446,100,44,5,7,5,2,0,5
2126621,26,21,1987,3,"male",459,20,18,8,1,8,1,0,0
2126671,31,14,1982,10,"female",784,69,54,6,0,6,0,0,0
2126692,18,28,1995,4,"female",475,66,33,3,1,3,1,0,0
2126698,58,15,1955,2,"female",561,37,29,95,86,66,57,29,29
2126710,18,6,1995,8,"female",792,659,259,210,29,210,17,0,12
2126719,20,22,1993,5,"male",758,362,224,11,0,9,0,2,0
2126741,25,1,1988,1,"male",214,206,188,363,190,363,178,0,12
2126773,15,16,1998,10,"male",247,722,599,308,374,44,233,264,141
2126786,23,18,1990,2,"male",568,105,91,4,1,4,1,0,0
2126795,16,13,1997,11,"female",259,201,55,23,122,23,50,0,72
2126797,19,16,1994,10,"female",195,688,165,221,403,175,250,46,153
2126801,29,20,1984,3,"female",61,5,5,20,4,20,4,0,0
2126808,73,1,1940,4,"male",1627,16,7,14,50,14,48,0,2
2126864,21,8,1992,5,"male",2,2,1,0,0,0,0,0,0
2126886,38,28,1975,7,"male",488,123,56,3,1,3,1,0,0
2126898,44,5,1969,10,"male",1859,148,79,25,51,25,30,0,21
2126912,48,1,1965,3,"male",798,33,10,0,2,0,2,0,0
2126927,39,2,1974,6,"male",767,68,52,176,88,176,78,0,10
2126928,19,13,1994,7,"male",31,2,2,17,0,16,0,1,0
2126936,20,6,1993,9,"male",403,1012,813,466,89,466,81,0,8
2126959,26,9,1987,8,"female",126,115,32,91,34,91,32,0,2
2126986,57,29,1956,2,"female",1210,67,26,85,7,85,6,0,1
2127005,24,30,1989,5,"male",664,150,94,2,0,2,0,0,0
2127034,22,18,1991,11,"female",633,717,285,2594,761,2579,409,15,352
2127068,21,2,1992,5,"male",85,6,5,2,2,2,0,0,2
2127074,21,7,1992,10,"male",374,112,48,17,43,17,27,0,16
2127081,24,3,1989,5,"female",17,25,1,0,0,0,0,0,0
2127099,25,1,1988,1,"male",1154,1,1,2,0,2,0,0,0
2127110,43,18,1970,7,"female",464,450,339,832,469,77,73,755,396
2127116,30,17,1983,9,"male",583,213,101,8,4,0,3,8,1
2127130,25,1,1988,1,"male",21,2,0,0,0,0,0,0,0
2127147,24,15,1989,11,"female",348,201,117,1,5,1,5,0,0
2127157,26,5,1987,2,"male",727,74,31,0,0,0,0,0,0
2127196,20,7,1993,3,"male",30,4,4,0,1,0,1,0,0
2127209,15,19,1998,8,"male",258,202,140,321,39,263,27,58,12
2127217,21,1,1992,1,"male",143,62,57,0,0,0,0,0,0
2127219,25,1,1988,1,"male",211,193,111,17,9,17,8,0,1
2127220,27,3,1986,5,"female",426,184,107,3499,2543,3499,1698,0,845
2127223,22,27,1991,12,"female",277,214,82,4,16,4,8,0,8
2127226,61,12,1952,4,"female",345,31,22,0,14,0,5,0,9
2127229,19,11,1994,9,"male",361,6,3,0,0,0,0,0,0
2127230,23,14,1990,11,"female",274,321,97,4,1,4,1,0,0
2127252,17,12,1996,12,"male",3,75,75,31,3,31,2,0,1
2127258,102,29,1911,9,"female",738,588,415,280,250,206,85,74,165
2127261,21,1,1992,1,"male",450,69,25,1,0,1,0,0,0
2127276,56,22,1957,2,"female",1803,51,18,8,9,8,4,0,5
2127282,57,16,1956,2,"male",183,106,81,13,23,13,19,0,4
2127294,48,1,1965,5,"male",1335,229,98,0,0,0,0,0,0
2127301,18,7,1995,1,"male",162,145,109,2,0,2,0,0,0
2127304,108,29,1905,5,"male",362,58,40,66,39,66,31,0,8
2127318,22,20,1991,1,"female",550,89,47,161,46,161,44,0,2
2127347,27,4,1986,9,"male",1392,286,227,194,215,166,95,28,120
2127383,66,5,1947,6,"male",1439,10,2,0,1,0,1,0,0
2127394,20,26,1993,1,"male",710,201,183,11,3,11,1,0,2
2127397,48,30,1965,1,"male",807,238,139,0,2,0,0,0,2
2127422,31,1,1982,2,"female",389,53,5,1,1,1,1,0,0
2127432,24,13,1989,7,"male",188,115,114,25,10,16,8,9,2
2127443,61,27,1952,10,"female",77,11,3,1,0,1,0,0,0
2127445,42,28,1971,7,"female",174,96,44,116,135,65,76,51,59
2127462,21,1,1992,1,"male",87,156,96,472,293,318,161,154,132
2127503,35,13,1978,9,"male",146,24,9,56,95,56,84,0,11
2127527,63,4,1950,3,"female",1559,85,36,19,2,0,1,19,1
2127552,103,12,1910,8,"female",1534,69,28,61,23,61,6,0,17
2127584,36,19,1977,7,"male",776,1,0,0,0,0,0,0,0
2127615,24,24,1989,4,"male",434,261,190,0,0,0,0,0,0
2127664,20,17,1993,5,"male",290,85,63,834,574,808,415,26,159
2127671,63,10,1950,1,"male",79,48,32,18,10,18,2,0,8
2127696,59,1,1954,1,"male",357,24,21,0,38,0,2,0,36
2127722,64,17,1949,3,"female",2265,45,15,1,34,1,20,0,14
2127730,20,20,1993,1,"female",187,23,15,102,156,102,76,0,80
2127754,32,1,1981,1,"male",315,60,51,117,162,116,105,1,57
2127804,34,16,1979,6,"male",121,50,42,42,323,42,317,0,6
2127813,19,8,1994,12,"male",216,155,76,42,6,42,5,0,1
2127880,18,25,1995,6,"female",651,1215,870,43,181,43,147,0,34
2127896,25,31,1988,7,"male",1368,138,30,0,0,0,0,0,0
2127905,50,10,1963,12,"male",246,241,217,0,108,0,85,0,23
2127910,22,8,1991,7,"male",373,40,25,14,18,1,11,13,7
2127919,69,18,1944,3,"female",1146,240,175,1868,1714,56,1266,1812,448
2127925,19,13,1994,1,"male",87,85,55,0,1,0,1,0,0
2127927,54,20,1959,7,"female",1818,225,145,375,75,305,67,70,8
2127931,57,29,1956,12,"male",444,211,143,2,90,0,15,2,75
2127949,28,7,1985,10,"male",239,121,76,0,0,0,0,0,0
2127954,30,20,1983,10,"male",106,20,8,125,58,125,37,0,21
2127960,24,30,1989,10,"male",254,2,1,0,0,0,0,0,0
2127989,44,31,1969,12,"female",413,42,32,35,15,34,13,1,2
2128032,19,1,1994,7,"male",424,170,128,26,8,0,3,26,5
2128042,84,2,1929,10,"male",637,159,121,21,14,21,14,0,0
2128053,56,15,1957,9,NA,1538,75,50,91,73,85,64,6,9
2128063,53,14,1960,1,"male",779,33,21,1997,477,1997,348,0,129
2128082,15,12,1998,7,"female",327,178,76,860,260,723,149,137,111
2128083,22,27,1991,9,"male",449,89,48,0,4,0,4,0,0
2128105,72,20,1941,2,"female",182,38,17,1,2,1,2,0,0
2128120,51,13,1962,5,"female",2109,172,48,1352,814,1329,349,23,465
2128134,38,24,1975,4,"male",278,24,6,0,5,0,4,0,1
2128158,28,31,1985,10,"male",570,29,25,5,5,5,5,0,0
2128167,52,4,1961,8,"female",553,11,7,2,1,0,1,2,0
2128278,75,10,1938,2,"female",1014,32,21,1,14,0,13,1,1
2128284,16,11,1997,11,"female",20,114,92,48,2,48,1,0,1
2128292,25,1,1988,1,"male",162,49,26,0,0,0,0,0,0
2128302,67,28,1946,10,"female",837,106,56,6,31,0,11,6,20
2128303,21,30,1992,5,"male",1079,95,24,5,11,1,2,4,9
2128311,23,1,1990,1,"male",521,193,170,1,2,0,2,1,0
2128334,26,11,1987,5,"female",22,88,85,12,28,12,25,0,3
2128335,35,1,1978,8,"male",230,107,64,11,14,2,6,9,8
2128351,25,1,1988,11,"male",259,124,110,0,0,0,0,0,0
2128352,53,29,1960,12,"male",493,311,231,5,6,0,6,5,0
2128357,17,24,1996,7,"female",569,615,232,27,395,15,140,12,255
2128378,22,2,1991,2,"male",283,266,178,26,2,3,1,23,1
2128379,18,18,1995,5,"male",244,245,45,16,51,16,29,0,22
2128405,65,30,1948,3,"female",1956,381,197,1212,2583,0,685,1212,1898
2128443,17,17,1996,3,"male",171,382,81,20,3,20,3,0,0
2128453,68,26,1945,3,"female",352,846,483,183,74,183,65,0,9
2128455,60,12,1953,10,"male",388,196,151,0,0,0,0,0,0
2128473,54,19,1959,2,"male",436,10,6,0,2,0,0,0,2
2128526,20,8,1993,8,"female",590,651,203,48,167,48,157,0,10
2128529,71,6,1942,4,"female",179,203,117,101,75,101,48,0,27
2128553,19,6,1994,3,"male",643,160,89,9,107,4,50,5,57
2128570,51,25,1962,7,"female",364,66,48,273,218,79,93,194,125
2128592,16,9,1997,7,"male",810,146,106,0,0,0,0,0,0
2128661,18,28,1995,10,"female",78,192,149,0,0,0,0,0,0
2128666,43,5,1970,10,"male",680,29,17,0,0,0,0,0,0
2128694,34,28,1979,5,"male",325,53,26,0,1,0,0,0,1
2128706,15,9,1998,9,"female",287,1857,237,0,1,0,1,0,0
2128767,52,10,1961,5,"male",125,16,14,0,3,0,2,0,1
2128769,38,10,1975,4,"female",210,28,24,9,4,9,4,0,0
2128785,16,27,1997,5,"female",612,1199,727,2261,1145,1767,667,494,478
2128786,49,13,1964,10,"female",716,103,61,99,68,93,55,6,13
2128821,18,1,1995,1,"female",2,19,14,155,119,36,24,119,95
2128859,20,13,1993,11,"male",588,117,68,7,13,7,9,0,4
2128862,24,2,1989,2,"male",584,82,59,0,0,0,0,0,0
2128873,14,6,1999,6,"male",55,265,236,0,0,0,0,0,0
2128881,17,6,1996,7,"female",154,25,17,580,13,580,9,0,4
2128886,22,12,1991,3,"male",160,289,235,120,196,120,97,0,99
2128948,35,1,1978,3,"male",513,34,11,19,12,19,12,0,0
2129031,67,1,1946,9,"male",1636,54,25,0,0,0,0,0,0
2129046,51,16,1962,4,"male",335,0,0,0,0,0,0,0,0
2129047,30,3,1983,12,"female",469,40,30,27,47,27,43,0,4
2129061,16,25,1997,11,"female",289,218,118,155,85,155,76,0,9
2129064,18,20,1995,7,"female",395,500,434,376,253,104,160,272,93
2129072,32,10,1981,2,"male",535,263,46,0,49,0,43,0,6
2129092,25,10,1988,3,"male",350,48,14,4,5,4,4,0,1
2129157,50,9,1963,3,"female",1370,42,21,10,15,3,1,7,14
2129159,33,25,1980,3,"female",251,24,14,8,0,0,0,8,0
2129160,31,4,1982,12,"male",425,93,56,66,12,66,7,0,5
2129165,52,12,1961,5,"female",514,15,7,31,6,31,1,0,5
2129175,56,14,1957,6,"male",237,3,2,0,0,0,0,0,0
2129191,29,23,1984,8,"male",179,38,18,5,8,4,3,1,5
2129214,83,30,1930,8,"male",1661,981,230,0,0,0,0,0,0
2129264,27,22,1986,4,"male",22,24,23,3,9,0,8,3,1
2129289,19,17,1994,4,"female",502,452,170,875,630,875,609,0,21
2129290,84,12,1929,7,"male",1151,592,340,12,44,5,9,7,35
2129294,18,16,1995,12,"male",227,107,94,0,22,0,8,0,14
2129303,14,17,1999,8,"male",68,253,244,27,16,6,10,21,6
2129305,43,27,1970,7,"male",752,163,110,79,10,79,5,0,5
2129308,19,12,1994,9,"male",560,59,29,340,45,340,31,0,14
2129324,28,16,1985,2,"female",437,0,0,0,0,0,0,0,0
2129329,68,21,1945,3,"female",639,1228,231,1861,1760,1861,1589,0,171
2129351,56,16,1957,2,"male",1007,31,21,1,2,0,0,1,2
2129356,61,4,1952,7,"female",915,55,39,29,38,29,22,0,16
2129375,19,18,1994,6,"male",139,50,36,0,0,0,0,0,0
2129384,61,27,1952,5,"male",465,9,3,0,0,0,0,0,0
2129392,26,1,1987,1,"male",108,160,131,129,87,129,74,0,13
2129398,47,26,1966,3,"female",1960,198,98,1700,85,1700,61,0,24
2129408,32,9,1981,6,"male",159,134,103,60,1,60,1,0,0
2129444,25,17,1988,7,"male",530,171,82,5,16,5,16,0,0
2129474,58,12,1955,9,"male",879,96,61,51,1,2,1,49,0
2129482,17,4,1996,7,"male",388,0,0,0,0,0,0,0,0
2129502,24,4,1989,3,"male",252,308,76,12,0,12,0,0,0
2129513,51,3,1962,4,"male",244,70,50,158,51,157,40,1,11
2129521,108,21,1905,2,"female",1494,1525,712,71,24,0,6,71,18
2129538,27,2,1986,8,"male",186,1,1,0,0,0,0,0,0
2129539,53,25,1960,8,"female",1378,93,53,151,11,151,8,0,3
2129559,22,10,1991,6,"male",637,370,241,21,21,21,20,0,1
2129560,26,1,1987,1,"male",309,32,19,0,3,0,3,0,0
2129590,52,14,1961,12,"male",411,44,17,5,12,5,8,0,4
2129597,18,11,1995,12,"male",104,64,59,4,12,0,3,4,9
2129604,28,8,1985,8,"male",534,494,458,22,3,22,3,0,0
2129610,21,26,1992,8,"male",211,10,7,0,0,0,0,0,0
2129611,57,18,1956,5,"male",154,122,121,94,71,4,27,90,44
2129624,36,13,1977,11,"female",22,2,2,5,1,5,1,0,0
2129646,38,10,1975,3,"male",379,55,31,97,22,9,3,88,19
2129675,18,10,1995,8,"female",41,27,11,8,20,8,13,0,7
2129676,51,10,1962,8,"male",1221,81,31,7,2,0,0,7,2
2129687,28,1,1985,1,"male",468,94,72,46,3,46,3,0,0
2129695,108,31,1905,12,"female",346,304,60,8,61,8,47,0,14
2129709,30,10,1983,2,"female",779,486,259,1086,1608,1074,1253,12,355
2129711,31,12,1982,10,"female",298,252,208,1044,540,1042,362,2,178
2129744,46,3,1967,3,"female",571,35,20,205,120,179,50,26,70
2129748,23,17,1990,11,"female",445,296,220,28,90,28,31,0,59
2129756,37,14,1976,10,"female",411,51,27,0,4,0,4,0,0
2129760,16,6,1997,2,"male",486,946,512,372,472,372,411,0,61
2129773,35,12,1978,9,"male",294,45,33,22,3,22,3,0,0
2129780,70,2,1943,10,"female",434,23,17,47,11,0,0,47,11
2129796,104,2,1909,7,"female",1916,310,102,409,77,0,59,409,18
2129814,26,4,1987,12,"male",549,23,14,2,0,0,0,2,0
2129882,23,26,1990,7,"female",845,399,180,22,85,22,68,0,17
2129901,21,11,1992,1,"female",316,276,174,117,272,59,62,58,210
2129907,22,10,1991,5,"female",506,13,3,36,29,36,11,0,18
2129973,81,16,1932,11,"male",730,316,229,114,4,0,0,114,4
2129999,103,2,1910,2,"male",710,246,157,0,2,0,2,0,0
2130024,67,22,1946,10,"male",152,278,147,72,17,53,12,19,5
2130046,28,15,1985,4,"male",889,311,228,398,123,397,73,1,50
2130053,22,13,1991,9,"male",777,170,116,1,13,0,0,1,13
2130060,23,20,1990,3,"male",589,96,29,127,27,127,20,0,7
2130062,65,11,1948,6,"female",1631,357,174,153,66,0,28,153,38
2130063,34,14,1979,5,"male",402,66,48,62,2,62,2,0,0
2130065,32,8,1981,2,"male",317,216,163,371,39,0,1,371,38
2130070,52,15,1961,4,"female",625,45,25,0,0,0,0,0,0
2130088,19,30,1994,9,"male",235,77,62,21,1,21,1,0,0
2130103,16,9,1997,1,"female",1169,454,150,2375,946,1844,347,531,599
2130111,15,5,1998,8,"male",654,251,117,0,1,0,1,0,0
2130198,24,5,1989,10,"male",217,62,37,27,3,27,3,0,0
2130234,17,28,1996,1,"male",250,56,45,2,0,0,0,2,0
2130253,27,14,1986,2,"female",433,25,17,18,54,3,21,15,33
2130260,14,25,1999,5,"female",15,148,137,622,220,576,132,46,88
2130279,15,27,1998,10,"female",340,106,66,520,183,444,95,76,88
2130289,17,28,1996,1,"female",305,534,363,4,179,3,56,1,123
2130340,36,5,1977,9,"male",646,211,103,292,4,264,3,28,1
2130400,24,14,1989,7,"male",705,150,66,3,3,3,3,0,0
2130402,55,8,1958,1,"female",204,24,15,11,16,8,7,3,9
2130422,28,20,1985,6,"male",341,232,198,0,1,0,1,0,0
2130430,26,17,1987,3,"male",358,29,18,48,5,48,5,0,0
2130438,28,24,1985,3,"female",418,512,413,216,236,216,161,0,75
2130453,20,28,1993,10,"female",231,380,30,0,2,0,2,0,0
2130484,18,22,1995,9,"male",10,21,16,4,1,0,1,4,0
2130520,28,11,1985,3,"male",221,148,106,56,28,56,19,0,9
2130584,19,21,1994,5,"male",22,146,143,11,9,7,8,4,1
2130588,24,5,1989,6,"male",830,2,1,0,2,0,1,0,1
2130650,20,28,1993,10,"male",438,612,440,19,22,17,17,2,5
2130679,45,14,1968,7,"female",903,24,17,40,124,0,36,40,88
2130684,14,4,1999,1,"male",102,156,83,6,76,6,68,0,8
2130694,18,9,1995,4,"female",291,16,10,6,6,6,4,0,2
2130696,29,3,1984,9,"female",322,22,11,0,0,0,0,0,0
2130709,28,19,1985,8,"female",712,38,0,0,0,0,0,0,0
2130746,30,5,1983,4,"male",496,204,136,89,624,63,579,26,45
2130758,32,5,1981,12,"female",317,25,23,0,0,0,0,0,0
2130784,27,11,1986,12,"male",466,112,98,21,30,18,26,3,4
2130791,80,2,1933,5,"male",1683,1,1,0,0,0,0,0,0
2130818,26,27,1987,10,"male",347,160,76,6,115,6,108,0,7
2130822,20,28,1993,5,"female",397,35,19,19,13,0,3,19,10
2130829,60,25,1953,4,"male",1213,91,52,29,137,0,68,29,69
2130842,27,25,1986,7,"male",308,177,40,3,11,2,7,1,4
2130849,32,26,1981,11,"male",575,71,59,28,0,28,0,0,0
2130854,16,19,1997,8,"male",307,265,168,87,0,2,0,85,0
2130855,19,1,1994,1,"male",508,229,169,319,73,147,52,172,21
2130873,55,19,1958,11,"male",342,56,46,2,7,0,5,2,2
2130899,36,20,1977,12,"female",83,37,23,216,51,216,38,0,13
2130916,20,16,1993,7,"male",711,352,303,1,1,1,0,0,1
2130934,65,29,1948,5,"male",1111,79,34,15,131,0,92,15,39
2130937,26,22,1987,9,"male",1272,429,230,0,3,0,3,0,0
2130966,21,15,1992,12,"male",309,241,117,11,3,11,2,0,1
2130968,24,28,1989,2,"male",307,200,133,0,6,0,6,0,0
2131014,25,7,1988,9,"male",672,131,49,38,69,10,41,28,28
2131040,23,8,1990,4,"male",377,7,4,0,0,0,0,0,0
2131056,36,8,1977,6,"female",458,26,16,0,0,0,0,0,0
2131080,54,27,1959,2,"male",1365,8,3,1,0,0,0,1,0
2131124,14,7,1999,1,"female",303,103,51,153,151,6,112,147,39
2131144,37,19,1976,11,"female",314,285,195,105,336,80,131,25,205
2131150,28,26,1985,6,"male",456,67,24,44,40,44,31,0,9
2131202,15,13,1998,1,"male",49,14,13,8,0,1,0,7,0
2131206,18,28,1995,6,"male",328,50,28,0,0,0,0,0,0
2131219,21,26,1992,6,"male",1437,1,1,0,0,0,0,0,0
2131255,57,15,1956,9,"male",655,2,2,2,1,0,1,2,0
2131288,48,26,1965,10,"female",342,101,44,34,235,34,142,0,93
2131294,51,2,1962,1,"female",379,250,88,59,33,59,12,0,21
2131320,21,4,1992,8,"female",285,4,2,0,0,0,0,0,0
2131322,45,27,1968,5,"female",743,389,120,145,509,113,146,32,363
2131429,18,25,1995,12,"female",199,227,62,115,44,100,26,15,18
2131472,28,20,1985,7,"male",651,96,73,0,0,0,0,0,0
2131474,15,1,1998,12,"female",559,1226,860,1049,623,1049,557,0,66
2131482,49,22,1964,10,"female",474,49,38,0,0,0,0,0,0
2131495,19,14,1994,5,"male",309,239,132,50,32,50,31,0,1
2131499,41,3,1972,1,"male",287,16,15,0,0,0,0,0,0
2131538,58,10,1955,1,"male",1039,30,16,26,43,23,23,3,20
2131568,21,5,1992,2,"male",33,20,15,3,33,3,21,0,12
2131583,108,10,1905,8,"female",1933,143,92,591,265,62,101,529,164
2131619,28,29,1985,12,"male",667,186,87,20,4,15,4,5,0
2131638,23,14,1990,4,"male",640,127,47,2,5,2,4,0,1
2131640,29,11,1984,4,"male",382,23,14,0,5,0,4,0,1
2131675,48,28,1965,2,"male",346,19,16,2,4,0,4,2,0
2131722,15,8,1998,12,"female",658,355,240,39,2,2,1,37,1
2131739,17,26,1996,7,"male",272,3,3,0,0,0,0,0,0
2131746,66,21,1947,4,"male",1914,106,24,6,22,6,12,0,10
2131753,48,2,1965,2,"male",529,64,23,1,0,1,0,0,0
2131771,19,1,1994,9,"female",349,707,84,0,4,0,3,0,1
2131776,69,28,1944,4,"male",89,26,9,11,0,11,0,0,0
2131799,20,2,1993,12,"female",417,196,127,7,0,1,0,6,0
2131814,103,12,1910,4,"female",560,1319,898,7674,10608,7674,9979,0,629
2131838,30,14,1983,2,"female",559,74,24,2,2,2,2,0,0
2131858,26,31,1987,10,"male",101,3,2,0,3,0,0,0,3
2131863,33,28,1980,2,"male",243,89,73,18,3,18,2,0,1
2131888,21,2,1992,11,"male",309,110,85,3,6,0,5,3,1
2131894,18,15,1995,12,"male",185,163,105,14,0,14,0,0,0
2131898,17,28,1996,10,"male",258,10,7,0,0,0,0,0,0
2131902,18,26,1995,9,"female",391,26,25,0,0,0,0,0,0
2131923,24,12,1989,2,"male",415,150,120,0,0,0,0,0,0
2131926,60,20,1953,6,"male",94,10,9,0,0,0,0,0,0
2131927,18,26,1995,4,"male",358,86,55,0,5,0,4,0,1
2131934,23,4,1990,10,"male",949,145,109,20,1,6,0,14,1
2131972,108,9,1905,2,"female",52,204,175,22,95,5,76,17,19
2131973,23,5,1990,8,"male",1014,31,13,251,236,152,146,99,90
2131990,26,14,1987,6,"female",180,200,53,1,5,1,3,0,2
2132007,46,1,1967,7,"male",529,6,3,0,1,0,1,0,0
2132021,20,18,1993,3,"male",142,51,36,12,10,1,8,11,2
2132027,23,3,1990,3,"female",281,8,6,5,15,0,8,5,7
2132029,24,22,1989,4,"female",383,74,35,94,47,94,30,0,17
2132033,16,14,1997,1,"male",212,3869,565,252,407,252,337,0,70
2132061,44,3,1969,1,"female",302,5,2,2,5,0,4,2,1
2132069,18,26,1995,9,"male",535,443,309,12,13,11,8,1,5
2132081,63,5,1950,10,"female",462,16,12,27,17,27,15,0,2
2132104,19,25,1994,11,"female",439,200,116,4,5,1,1,3,4
2132140,28,11,1985,7,"female",9,26,25,18,7,0,0,18,7
2132147,23,12,1990,6,"male",31,161,153,3,7,3,7,0,0
2132175,27,11,1986,11,"male",591,143,44,17,18,17,13,0,5
2132226,69,21,1944,10,"female",565,132,70,124,200,0,39,124,161
2132261,55,14,1958,4,"female",747,144,111,160,59,113,14,47,45
2132310,55,14,1958,6,"female",1487,74,44,70,18,38,17,32,1
2132374,61,8,1952,7,"male",1642,64,7,1,2,1,2,0,0
2132381,18,17,1995,4,"male",550,87,19,2,1,2,1,0,0
2132389,32,14,1981,3,"male",81,56,35,35,2,35,0,0,2
2132453,14,25,1999,10,"female",102,10,8,610,102,608,89,2,13
2132454,51,6,1962,1,"male",1256,45,13,12,6,12,3,0,3
2132467,33,16,1980,11,"male",833,60,10,79,21,79,3,0,18
2132481,42,11,1971,3,"male",317,71,33,1,35,1,31,0,4
2132484,53,13,1960,6,"male",332,24,20,1,0,1,0,0,0
2132493,52,30,1961,6,"male",13,0,0,88,66,0,16,88,50
2132498,15,24,1998,9,"male",93,468,425,37,87,12,58,25,29
2132506,53,15,1960,6,"female",541,48,27,1,5,0,5,1,0
2132537,17,16,1996,4,"male",60,5,5,4,0,4,0,0,0
2132546,18,19,1995,12,"male",252,0,0,5,0,5,0,0,0
2132589,21,28,1992,12,"female",1018,98,77,51,98,23,77,28,21
2132606,24,11,1989,10,"male",396,30,24,0,0,0,0,0,0
2132624,23,14,1990,4,"male",1571,51,19,191,24,149,15,42,9
2132634,24,17,1989,2,"female",305,73,45,19,0,19,0,0,0
2132667,37,14,1976,6,"male",1555,367,175,1321,1210,191,497,1130,713
2132726,18,1,1995,1,"male",240,45,25,40,2,0,1,40,1
2132734,93,18,1920,5,"male",829,392,292,2465,903,2465,738,0,165
2132744,55,6,1958,6,"male",733,16,13,0,0,0,0,0,0
2132749,14,15,1999,2,"female",355,312,147,449,561,405,373,44,188
2132767,18,16,1995,1,"male",173,24,22,2,0,0,0,2,0
2132778,49,29,1964,7,"male",357,115,86,114,12,114,4,0,8
2132805,18,17,1995,2,"female",594,141,93,100,40,88,25,12,15
2132828,19,29,1994,7,"female",589,162,57,0,0,0,0,0,0
2132829,25,28,1988,4,"male",654,736,229,118,302,19,152,99,150
2132875,44,22,1969,12,"male",32,38,29,50,54,49,43,1,11
2132904,80,13,1933,12,"female",1387,180,108,128,64,22,15,106,49
2132906,20,1,1993,11,"female",680,3273,775,228,1226,228,1011,0,215
2132908,16,5,1997,6,"male",491,161,139,0,0,0,0,0,0
2132962,24,3,1989,10,"female",379,257,204,1,0,1,0,0,0
2132963,50,14,1963,8,"male",405,35,23,1,2,0,1,1,1
2132964,32,10,1981,10,"male",164,0,0,0,0,0,0,0,0
2133016,52,5,1961,5,"male",38,8,6,3,1,3,1,0,0
2133017,31,14,1982,6,"male",105,1,1,11,0,11,0,0,0
2133018,31,25,1982,9,"male",407,126,106,70,50,70,47,0,3
2133037,16,23,1997,8,"female",256,441,266,94,209,43,37,51,172
2133058,38,10,1975,10,"male",306,2,1,0,0,0,0,0,0
2133087,27,22,1986,10,"male",531,97,89,0,0,0,0,0,0
2133118,108,31,1905,8,"male",448,646,324,1842,2119,1739,1297,103,822
2133161,49,6,1964,4,"male",461,119,85,8,0,0,0,8,0
2133176,22,28,1991,12,"male",318,170,124,40,22,40,21,0,1
2133187,74,15,1939,11,"female",453,28,19,0,0,0,0,0,0
2133196,53,24,1960,11,"male",190,35,2,1,5,1,5,0,0
2133238,103,28,1910,8,"male",589,471,431,4,5,2,5,2,0
2133265,17,3,1996,10,"male",384,55,10,0,6,0,5,0,1
2133268,26,25,1987,6,"female",1672,334,197,244,528,217,246,27,282
2133285,30,8,1983,1,"male",47,11,7,67,75,67,17,0,58
2133311,49,29,1964,3,"female",589,145,62,11,19,0,7,11,12
2133338,20,5,1993,9,"male",624,2,2,21,8,21,8,0,0
2133340,50,14,1963,11,"male",267,117,110,9,1,9,1,0,0
2133359,51,23,1962,5,"male",125,33,24,0,1,0,1,0,0
2133369,22,2,1991,6,"male",60,60,32,9,6,9,6,0,0
2133380,22,4,1991,11,"female",896,301,246,134,135,88,61,46,74
2133392,76,7,1937,11,"male",606,77,45,1,15,0,4,1,11
2133394,53,28,1960,11,"female",1828,205,132,1260,765,953,351,307,414
2133420,34,3,1979,2,"female",284,22,10,118,107,91,65,27,42
2133422,22,19,1991,1,"male",318,121,92,0,1,0,1,0,0
2133444,17,8,1996,4,"male",165,87,63,26,36,18,17,8,19
2133456,15,18,1998,7,"male",311,473,436,2,12,2,3,0,9
2133477,52,6,1961,10,"male",489,92,7,99,40,93,22,6,18
2133492,24,19,1989,9,"female",283,247,129,30,88,30,79,0,9
2133529,60,17,1953,2,"male",1732,40,15,17,12,1,6,16,6
2133595,18,1,1995,1,"female",419,172,56,0,1,0,1,0,0
2133611,20,16,1993,5,"male",579,92,65,10,0,9,0,1,0
2133621,25,3,1988,3,"male",88,42,24,0,9,0,9,0,0
2133628,28,2,1985,2,"male",175,2,1,6,18,0,3,6,15
2133632,23,1,1990,1,"male",91,69,44,22,2,22,2,0,0
2133635,65,27,1948,5,"female",869,43,20,8,2,0,0,8,2
2133652,20,17,1993,12,"female",355,111,54,13,36,13,27,0,9
2133666,38,23,1975,12,"female",963,183,102,27,54,23,27,4,27
2133674,29,10,1984,9,"male",38,6,3,2,0,2,0,0,0
2133681,55,27,1958,4,"male",386,51,48,0,5,0,5,0,0
2133710,46,15,1967,7,"female",572,95,37,38,6,28,3,10,3
2133721,17,12,1996,1,"male",683,126,88,44,14,27,7,17,7
2133725,22,11,1991,7,"female",472,175,76,23,108,6,59,17,49
2133775,45,5,1968,7,"male",336,145,136,1,7,1,7,0,0
2133790,55,3,1958,10,"male",979,22,15,1,0,1,0,0,0
2133801,59,29,1954,8,"male",322,0,0,0,0,0,0,0,0
2133823,17,11,1996,1,"male",599,62,26,0,1,0,1,0,0
2133841,16,1,1997,1,"female",0,0,0,4,3,0,0,4,3
2133857,15,23,1998,4,"male",324,281,22,49,10,49,10,0,0
2133869,18,24,1995,2,"female",66,174,24,118,194,118,151,0,43
2133877,105,5,1908,8,"male",1181,783,585,315,209,315,75,0,134
2133885,23,10,1990,1,"female",178,73,34,2,0,2,0,0,0
2133888,47,7,1966,3,"female",1296,186,84,103,292,71,193,32,99
2133920,58,19,1955,2,"female",438,48,30,81,28,81,11,0,17
2133923,58,19,1955,7,"male",111,65,48,32,59,32,30,0,29
2133945,27,8,1986,4,"male",388,40,29,0,0,0,0,0,0
2134019,18,12,1995,2,"female",186,385,111,196,76,10,14,186,62
2134037,36,3,1977,9,"male",700,69,43,4,1,0,0,4,1
2134044,28,11,1985,1,"male",605,164,65,178,11,178,10,0,1
2134076,25,22,1988,8,"male",219,372,303,113,112,113,98,0,14
2134084,28,10,1985,4,"male",186,1,1,0,0,0,0,0,0
2134105,107,10,1906,7,"female",2249,561,454,1087,1051,0,587,1087,464
2134106,20,15,1993,7,"female",372,38,3,13,41,13,39,0,2
2134115,31,27,1982,12,"male",132,3,2,7,12,0,8,7,4
2134124,23,5,1990,5,"male",59,1,1,0,0,0,0,0,0
2134146,49,31,1964,7,"male",577,56,29,94,172,94,60,0,112
2134171,16,1,1997,6,"female",384,51,42,146,15,0,4,146,11
2134186,20,8,1993,4,"female",213,509,269,926,561,165,253,761,308
2134217,56,11,1957,7,"male",699,144,105,19,2,0,0,19,2
2134218,31,1,1982,1,"female",195,3,3,1,0,1,0,0,0
2134225,20,7,1993,8,"male",668,226,135,46,22,46,11,0,11
2134236,23,21,1990,10,"male",213,28,27,14,3,14,3,0,0
2134240,30,7,1983,11,"male",438,36,16,0,0,0,0,0,0
2134271,57,10,1956,2,"male",1476,45,19,0,0,0,0,0,0
2134294,20,8,1993,8,"male",508,31,19,2,9,2,8,0,1
2134295,52,12,1961,12,"male",313,39,28,5,4,1,1,4,3
2134310,13,7,2000,1,"male",247,47,27,11,3,1,3,10,0
2134315,65,3,1948,1,"female",611,64,26,0,2,0,2,0,0
2134326,45,16,1968,8,"female",1025,3144,1172,431,640,256,285,175,355
2134338,67,18,1946,11,"male",118,6,5,0,0,0,0,0,0
2134339,67,1,1946,1,"male",65,209,189,77,26,0,9,77,17
2134341,19,31,1994,3,"male",523,73,45,0,0,0,0,0,0
2134352,91,2,1922,12,"male",1524,561,217,0,2,0,1,0,1
2134357,15,31,1998,8,"male",91,64,52,2,33,2,27,0,6
2134358,30,4,1983,3,"male",627,49,42,3,63,3,41,0,22
2134407,20,18,1993,9,"female",604,647,438,1289,781,1161,179,128,602
2134413,26,9,1987,12,"male",365,123,86,0,0,0,0,0,0
2134416,57,15,1956,12,"female",1112,51,19,1,2,1,2,0,0
2134453,25,27,1988,2,"female",42,25,19,0,0,0,0,0,0
2134488,108,27,1905,5,"female",1367,222,159,270,62,5,43,265,19
2134493,20,12,1993,12,"female",363,225,85,86,175,52,82,34,93
2134507,14,7,1999,8,"female",124,37,30,0,1,0,1,0,0
2134518,17,25,1996,9,"male",541,335,261,4,2,4,0,0,2
2134559,26,27,1987,11,"male",561,281,137,1031,326,988,189,43,137
2134571,23,2,1990,1,"male",556,50,29,149,40,11,19,138,21
2134587,18,28,1995,11,"male",393,217,188,2,12,2,10,0,2
2134651,27,17,1986,2,"male",326,1,1,0,0,0,0,0,0
2134665,31,21,1982,7,"male",297,59,51,1,1,0,0,1,1
2134693,108,14,1905,8,"male",1825,24,13,0,0,0,0,0,0
2134717,28,26,1985,7,"male",103,66,56,15,27,15,22,0,5
2134743,47,2,1966,2,"male",326,119,75,4,15,4,13,0,2
2134746,23,1,1990,5,"male",391,98,63,5,4,5,4,0,0
2134765,50,11,1963,3,"female",683,304,225,49,351,5,42,44,309
2134781,15,26,1998,9,"female",171,64,59,18,0,18,0,0,0
2134801,52,8,1961,8,"male",482,2,1,3,0,0,0,3,0
2134857,29,3,1984,12,"male",1057,124,25,0,5,0,4,0,1
2134882,16,4,1997,11,"male",429,358,255,16,9,0,3,16,6
2134927,29,5,1984,2,"male",51,23,22,2,1,2,1,0,0
2134939,19,9,1994,10,"male",1247,600,369,65,90,65,60,0,30
2134952,34,16,1979,7,"female",430,51,27,23,36,23,21,0,15
2134976,19,20,1994,12,"female",115,479,366,284,560,198,227,86,333
2134988,77,25,1936,12,"female",1546,116,3,2,5,0,1,2,4
2135058,61,20,1952,1,"male",632,106,46,18,6,1,0,17,6
2135100,21,8,1992,5,"female",587,272,194,93,22,85,20,8,2
2135113,21,4,1992,6,"female",372,314,95,107,300,107,155,0,145
2135122,23,5,1990,4,"male",5,0,0,0,0,0,0,0,0
2135146,16,2,1997,6,"male",216,150,93,0,3,0,3,0,0
2135154,44,23,1969,4,"male",402,10,4,30,7,0,6,30,1
2135223,14,10,1999,10,"male",320,349,307,0,3,0,3,0,0
2135232,38,15,1975,5,"male",443,11,5,0,0,0,0,0,0
2135282,22,15,1991,7,"male",116,10,6,0,0,0,0,0,0
2135292,25,1,1988,1,"female",13,23,12,20,9,20,9,0,0
2135301,41,21,1972,10,"male",667,49,36,4,10,0,4,4,6
2135302,21,27,1992,4,"male",267,1874,564,4080,5791,3148,3798,932,1993
2135399,81,20,1932,6,"male",48,27,22,12,20,12,20,0,0
2135402,32,30,1981,7,"female",398,337,273,102,87,102,33,0,54
2135403,112,30,1901,12,"female",1645,433,199,31,28,16,8,15,20
2135462,20,12,1993,2,"male",16,14,13,5,5,0,0,5,5
2135466,23,14,1990,8,"male",488,170,98,2,3,0,1,2,2
2135470,33,1,1980,7,"male",15,71,7,0,1,0,1,0,0
2135493,25,8,1988,8,"female",251,94,36,371,58,370,44,1,14
2135497,26,24,1987,10,"male",342,32,24,92,5,92,5,0,0
2135517,18,19,1995,5,"female",319,126,71,1,2,1,1,0,1
2135549,34,5,1979,7,"male",103,44,34,36,13,36,13,0,0
2135566,101,21,1912,12,"male",829,301,237,0,4,0,2,0,2
2135612,28,22,1985,3,"female",435,147,114,276,129,271,75,5,54
2135643,52,2,1961,5,"female",408,3,0,0,0,0,0,0,0
2135648,15,2,1998,5,"female",614,2907,866,667,528,666,256,1,272
2135656,38,1,1975,1,"male",170,30,22,55,28,55,23,0,5
2135668,108,1,1905,1,"male",138,67,56,182,107,182,81,0,26
2135703,47,2,1966,3,"female",29,11,5,0,0,0,0,0,0
2135707,39,1,1974,4,"male",732,64,46,1,0,1,0,0,0
2135728,15,1,1998,1,"female",295,1,0,0,0,0,0,0,0
2135730,23,8,1990,7,"female",207,65,40,95,31,95,26,0,5
2135740,46,23,1967,3,"female",345,137,122,717,48,717,37,0,11
2135754,19,10,1994,10,"male",352,290,215,25,14,25,11,0,3
2135764,62,14,1951,9,"female",354,35,19,128,18,128,4,0,14
2135787,29,2,1984,10,"male",748,295,184,19,12,19,12,0,0
2135798,41,1,1972,11,"female",426,34,14,33,10,0,3,33,7
2135823,21,2,1992,2,"male",83,89,88,0,0,0,0,0,0
2135827,52,20,1961,9,"female",687,74,39,53,97,3,52,50,45
2135829,17,10,1996,12,"male",1047,643,288,3,225,3,66,0,159
2135831,39,23,1974,1,"male",275,50,17,2,0,2,0,0,0
2135832,41,14,1972,11,"male",1052,29,14,51,42,51,41,0,1
2135838,29,5,1984,3,"female",376,59,33,0,5,0,2,0,3
2135846,25,1,1988,1,"male",93,3,1,7,2,7,2,0,0
2135865,56,18,1957,3,"male",1009,295,171,31,20,30,15,1,5
2135881,63,24,1950,8,"female",673,42,13,19,12,0,2,19,10
2135908,46,24,1967,2,"male",109,24,14,26,12,26,7,0,5
2135913,27,10,1986,12,"male",452,48,26,0,0,0,0,0,0
2135936,23,11,1990,5,"female",262,88,23,0,28,0,3,0,25
2135953,35,26,1978,12,"female",277,69,50,67,8,58,7,9,1
2135959,49,31,1964,10,"male",544,94,41,842,478,0,9,842,469
2135987,31,15,1982,8,"male",391,14,9,0,0,0,0,0,0
2135992,103,17,1910,8,"male",1264,554,174,71,16,1,5,70,11
2136040,31,4,1982,2,"female",281,39,16,47,21,46,19,1,2
2136053,67,12,1946,1,"female",1051,29,5,0,3,0,2,0,1
2136099,36,10,1977,8,"male",78,21,18,13,3,13,3,0,0
2136120,20,13,1993,6,"male",436,235,135,1,2,0,0,1,2
2136143,21,16,1992,10,"male",779,69,31,3,14,1,8,2,6
2136168,27,4,1986,12,"male",35,0,0,0,2,0,2,0,0
2136172,24,9,1989,3,"female",963,367,204,187,96,186,59,1,37
2136213,21,9,1992,5,"male",876,425,224,2,4,2,3,0,1
2136218,19,8,1994,8,"male",557,819,626,188,121,188,99,0,22
2136261,45,10,1968,8,"female",263,60,37,11,4,7,0,4,4
2136289,18,2,1995,8,"male",410,690,567,541,284,523,131,18,153
2136290,67,24,1946,1,"female",998,10,7,4,16,4,16,0,0
2136293,21,25,1992,3,"female",338,801,381,181,88,181,74,0,14
2136306,16,1,1997,7,"male",295,378,234,85,80,85,38,0,42
2136337,60,1,1953,4,"female",1468,118,63,38,16,0,2,38,14
2136351,53,5,1960,6,"female",1843,64,11,30,113,1,39,29,74
2136388,39,18,1974,3,"male",500,14,1,5,1,0,0,5,1
2136392,18,25,1995,7,"female",175,15,8,0,4,0,2,0,2
2136401,63,8,1950,6,"male",776,37,23,5,0,0,0,5,0
2136407,38,8,1975,12,"male",494,89,77,7,12,7,2,0,10
2136414,29,27,1984,3,"male",19,3,3,0,0,0,0,0,0
2136415,37,17,1976,2,"female",326,76,60,1,31,1,10,0,21
2136446,34,28,1979,12,"female",619,3,1,1,0,1,0,0,0
2136449,51,21,1962,10,"female",577,95,9,516,292,431,229,85,63
2136457,59,29,1954,5,"male",726,28,13,0,0,0,0,0,0
2136507,23,2,1990,4,"male",340,11,9,48,1,44,0,4,1
2136516,17,6,1996,6,"male",396,807,597,1838,736,1819,578,19,158
2136517,51,21,1962,12,"female",445,27,15,48,43,43,16,5,27
2136528,55,24,1958,6,"female",446,94,63,195,40,0,29,195,11
2136580,45,6,1968,1,"male",382,1,0,0,0,0,0,0,0
2136591,39,22,1974,6,"male",607,82,48,3,0,3,0,0,0
2136595,39,17,1974,11,"male",297,53,44,2,0,2,0,0,0
2136648,22,30,1991,12,"male",104,10,7,0,2,0,0,0,2
2136660,16,28,1997,9,"female",614,672,342,2105,2892,1552,2056,553,836
2136692,53,30,1960,4,"female",437,25,16,0,0,0,0,0,0
2136711,75,2,1938,6,"male",257,4,3,0,1,0,1,0,0
2136740,24,31,1989,7,"female",291,237,95,34,50,34,21,0,29
2136779,28,15,1985,5,"male",113,3,3,2,0,2,0,0,0
2136808,24,30,1989,3,"female",642,152,70,52,26,52,19,0,7
2136822,103,31,1910,12,"male",658,377,218,111,75,111,56,0,19
2136826,52,25,1961,8,"male",240,20,16,31,28,0,6,31,22
2136842,58,12,1955,12,"female",1574,57,35,19,16,19,6,0,10
2136845,15,11,1998,4,"female",51,95,15,24,20,24,17,0,3
2136867,51,19,1962,5,"male",128,74,33,17,48,17,35,0,13
2136919,22,28,1991,10,"female",403,667,261,2344,2646,2255,1657,89,989
2136944,33,20,1980,10,"male",443,10,10,0,0,0,0,0,0
2136959,49,10,1964,4,"male",517,37,21,8,102,8,90,0,12
2136961,32,3,1981,2,"male",1059,958,752,2,9,1,9,1,0
2136971,15,25,1998,11,"female",576,910,319,23,183,9,55,14,128
2136984,16,19,1997,9,"female",189,73,52,3,1,0,1,3,0
2136985,19,19,1994,11,"male",156,105,68,22,0,22,0,0,0
2137014,68,27,1945,1,"male",1218,45,25,14,6,14,6,0,0
2137018,30,3,1983,4,"male",750,159,116,114,69,68,60,46,9
2137022,68,11,1945,1,"male",1938,31,13,1,11,0,5,1,6
2137105,73,22,1940,10,"male",1111,209,128,63,91,63,54,0,37
2137119,49,14,1964,2,"female",1301,22,3,71,34,71,26,0,8
2137125,38,10,1975,10,"male",1041,35,23,1,2,0,1,1,1
2137126,47,25,1966,12,"male",581,39,38,19,0,0,0,19,0
2137140,14,21,1999,3,"male",50,25,24,1,0,1,0,0,0
2137141,25,4,1988,6,"male",168,185,151,3,6,3,1,0,5
2137175,37,12,1976,11,"female",47,12,6,24,36,20,19,4,17
2137191,19,22,1994,9,"male",257,24,18,143,3,143,0,0,3
2137224,25,26,1988,7,"male",124,5,5,12,2,12,0,0,2
2137232,16,23,1997,9,"male",34,97,96,2,0,2,0,0,0
2137248,21,9,1992,8,"male",391,103,95,346,41,299,5,47,36
2137272,40,18,1973,5,"male",477,48,47,0,1,0,1,0,0
2137291,58,26,1955,7,"male",44,0,0,3,2,3,2,0,0
2137303,28,30,1985,9,"female",270,8,5,4,0,4,0,0,0
2137314,69,19,1944,12,"female",1396,45,25,19,0,0,0,19,0
2137360,29,5,1984,11,"male",712,2,1,1,0,1,0,0,0
2137365,108,29,1905,8,"male",1476,158,81,0,1,0,1,0,0
2137368,16,29,1997,3,"female",206,38,35,200,27,0,12,200,15
2137369,72,20,1941,10,"female",1760,553,243,237,292,8,57,229,235
2137382,17,15,1996,6,"male",599,57,44,218,34,0,1,218,33
2137422,20,19,1993,6,"female",592,443,317,6,86,4,24,2,62
2137433,31,16,1982,1,"male",306,44,19,0,0,0,0,0,0
2137441,51,30,1962,11,"male",369,335,302,6,9,0,5,6,4
2137454,25,8,1988,8,"male",622,279,146,260,184,260,107,0,77
2137460,33,19,1980,7,"male",276,158,93,133,133,133,114,0,19
2137471,53,9,1960,2,"female",994,57,21,15,1,12,1,3,0
2137501,65,1,1948,3,"female",1465,29,7,0,1,0,1,0,0
2137514,62,12,1951,12,"male",418,27,8,0,0,0,0,0,0
2137529,33,17,1980,4,"male",184,2,0,0,0,0,0,0,0
2137568,24,9,1989,10,"male",269,194,139,70,38,70,26,0,12
2137574,14,15,1999,12,"female",126,1,1,0,0,0,0,0,0
2137609,23,18,1990,3,"female",289,59,30,8,8,8,4,0,4
2137619,25,1,1988,1,"male",34,0,0,9,16,9,13,0,3
2137620,31,21,1982,11,"female",292,50,40,69,45,27,20,42,25
2137625,60,21,1953,12,"female",1296,67,37,22,10,21,5,1,5
2137663,18,28,1995,8,"male",178,11,7,0,1,0,1,0,0
2137677,13,2,2000,3,"female",225,231,98,15,12,15,8,0,4
2137679,28,15,1985,10,"male",432,88,42,5,8,5,8,0,0
2137681,20,17,1993,11,"male",310,75,27,35,17,13,15,22,2
2137687,69,29,1944,1,"female",1456,412,276,728,293,681,277,47,16
2137691,60,8,1953,9,"female",554,34,21,0,0,0,0,0,0
2137694,28,11,1985,5,"male",635,20,18,24,42,9,19,15,23
2137700,20,15,1993,6,"female",102,55,39,12,4,12,4,0,0
2137710,30,19,1983,2,"female",274,1,0,0,0,0,0,0,0
2137712,62,8,1951,9,NA,2171,47,7,2,6,1,2,1,4
2137715,26,15,1987,3,"female",1013,4604,726,1171,2050,10,653,1161,1397
2137724,72,30,1941,3,"male",691,23,9,0,12,0,10,0,2
2137726,40,11,1973,5,"female",403,61,36,0,0,0,0,0,0
2137728,25,21,1988,2,"male",239,12,6,3,0,3,0,0,0
2137743,39,14,1974,11,"female",526,125,59,45,37,45,30,0,7
2137757,20,8,1993,11,"female",410,114,49,63,53,25,33,38,20
2137766,25,9,1988,12,"male",58,14,7,3,8,3,2,0,6
2137774,36,19,1977,10,"female",827,70,24,9,36,8,15,1,21
2137790,17,4,1996,4,"female",469,180,86,531,444,524,201,7,243
2137813,52,20,1961,10,"female",345,1,1,0,0,0,0,0,0
2137867,54,30,1959,11,"female",228,79,42,1019,138,1019,99,0,39
2137872,18,1,1995,12,"female",783,357,270,84,310,48,178,36,132
2137884,18,16,1995,7,"female",213,182,142,41,108,30,21,11,87
2137899,42,6,1971,12,"male",666,213,75,158,1,158,1,0,0
2137913,55,6,1958,5,"female",1091,25,11,0,0,0,0,0,0
2137944,103,27,1910,9,"male",1053,632,528,0,1,0,1,0,0
2137946,29,1,1984,1,"male",375,7,5,1,0,1,0,0,0
2137958,54,27,1959,10,"female",137,57,37,1,9,1,8,0,1
2137966,47,1,1966,1,"male",475,110,74,10,42,10,34,0,8
2137975,34,12,1979,7,"male",333,48,22,2,3,0,1,2,2
2138014,53,25,1960,12,"male",1509,10,4,0,0,0,0,0,0
2138024,15,3,1998,8,"female",471,118,81,15,1,1,0,14,1
2138048,20,14,1993,4,"female",947,211,80,0,6,0,4,0,2
2138051,25,12,1988,5,"female",1976,257,153,166,168,166,145,0,23
2138052,45,10,1968,11,"male",767,6,3,0,0,0,0,0,0
2138067,36,18,1977,5,"male",633,236,113,12,4,12,4,0,0
2138075,17,4,1996,8,"male",336,52,23,39,86,39,82,0,4
2138078,24,18,1989,11,"male",350,0,0,0,0,0,0,0,0
2138084,18,12,1995,7,"male",435,756,627,93,93,81,47,12,46
2138093,54,19,1959,6,"female",1517,70,48,5,6,5,4,0,2
2138094,18,30,1995,12,"male",241,149,29,163,361,158,334,5,27
2138103,73,14,1940,3,"female",619,19,13,0,0,0,0,0,0
2138118,41,15,1972,11,"male",1363,496,206,102,15,99,14,3,1
2138122,15,19,1998,2,"male",424,88,53,14,1,0,0,14,1
2138128,14,12,1999,7,"male",444,25,18,0,0,0,0,0,0
2138208,31,10,1982,1,"male",806,13,5,1,0,1,0,0,0
2138238,22,28,1991,6,"female",547,160,138,218,76,217,71,1,5
2138250,103,1,1910,1,"male",474,94,54,2,11,2,11,0,0
2138260,26,21,1987,5,"female",400,104,66,188,195,188,142,0,53
2138297,47,22,1966,4,"male",890,61,40,0,0,0,0,0,0
2138345,22,7,1991,11,"female",215,8,4,0,0,0,0,0,0
2138348,40,10,1973,12,"male",321,34,16,1,2,1,2,0,0
2138364,31,23,1982,6,"male",727,31,7,0,0,0,0,0,0
2138365,19,6,1994,6,"male",292,168,142,44,48,44,47,0,1
2138421,55,1,1958,5,"male",285,20,8,12,4,10,3,2,1
2138458,23,16,1990,10,"male",654,260,138,4,2,2,0,2,2
2138459,26,1,1987,1,"male",406,125,81,2,1,2,1,0,0
2138477,26,3,1987,3,"female",330,971,536,1137,1599,1137,998,0,601
2138498,58,16,1955,10,"female",321,35,11,1,4,1,3,0,1
2138506,16,14,1997,10,"female",89,96,92,0,0,0,0,0,0
2138510,62,28,1951,3,"female",840,40,26,30,17,14,15,16,2
2138559,26,1,1987,1,"male",31,39,22,7,2,7,2,0,0
2138572,103,1,1910,7,"male",793,63,31,3,1,3,1,0,0
2138592,32,8,1981,8,"male",1263,219,107,28,22,28,12,0,10
2138599,29,7,1984,1,"male",220,51,24,0,0,0,0,0,0
2138619,21,1,1992,1,"male",1,19,19,5,2,2,0,3,2
2138632,42,17,1971,4,"female",487,111,84,131,41,131,36,0,5
2138638,65,10,1948,4,"female",1559,96,35,224,120,7,79,217,41
2138670,44,6,1969,3,"male",1118,164,70,5,3,5,2,0,1
2138672,47,9,1966,1,"female",403,34,20,126,72,126,55,0,17
2138686,19,3,1994,2,"male",362,74,41,27,39,27,32,0,7
2138728,48,13,1965,11,"female",265,14,6,7,6,7,3,0,3
2138732,17,5,1996,3,"male",442,313,89,7,4,7,4,0,0
2138749,64,21,1949,6,"male",518,32,10,0,5,0,5,0,0
2138764,70,28,1943,3,"female",1078,17,9,8,7,8,6,0,1
2138778,23,12,1990,8,"male",128,261,232,0,9,0,7,0,2
2138779,19,8,1994,2,"male",527,156,80,2,0,2,0,0,0
2138786,16,16,1997,1,"female",415,300,100,55,14,0,8,55,6
2138795,18,1,1995,1,"male",282,135,85,10,5,9,4,1,1
2138809,14,16,1999,7,"female",454,307,255,15,9,15,6,0,3
2138843,58,22,1955,10,"male",788,78,17,136,235,45,82,91,153
2138847,53,24,1960,7,"female",142,44,32,29,68,18,49,11,19
2138849,18,22,1995,2,"male",10,37,28,25,4,25,4,0,0
2138882,27,9,1986,12,"female",465,235,214,86,11,67,2,19,9
2138894,37,14,1976,2,"female",671,240,104,0,4,0,2,0,2
2138906,58,8,1955,5,"female",654,41,30,402,64,22,11,380,53
2138912,29,13,1984,8,"female",371,61,39,12,12,12,11,0,1
2138919,33,5,1980,11,"male",277,49,32,60,21,0,10,60,11
2138940,15,22,1998,7,"female",545,283,207,919,144,329,67,590,77
2138942,66,9,1947,11,"female",1938,103,50,376,411,0,46,376,365
2138963,19,27,1994,12,"male",273,157,49,47,1,47,1,0,0
2138965,27,16,1986,10,"male",264,5,4,7,21,7,17,0,4
2138977,61,9,1952,8,"female",796,48,32,0,0,0,0,0,0
2139021,91,10,1922,7,"male",462,759,521,2032,1355,2032,1306,0,49
2139022,19,5,1994,11,"male",458,1040,954,0,55,0,30,0,25
2139043,31,24,1982,11,"female",530,42,24,4,6,4,1,0,5
2139068,23,4,1990,5,"male",84,77,70,97,5,97,3,0,2
2139091,41,21,1972,2,"female",448,21,19,54,6,54,4,0,2
2139115,19,18,1994,10,"female",411,106,43,5,70,5,29,0,41
2139133,34,21,1979,8,"female",667,106,63,53,37,45,14,8,23
2139163,19,20,1994,1,"male",328,341,297,0,0,0,0,0,0
2139190,43,9,1970,4,"female",691,13,7,25,7,0,1,25,6
2139213,21,2,1992,11,"female",221,24,19,0,0,0,0,0,0
2139218,25,14,1988,12,"male",266,23,18,0,0,0,0,0,0
2139247,16,1,1997,8,"male",80,136,113,2,0,2,0,0,0
2139284,58,16,1955,10,"male",1093,102,53,0,1,0,1,0,0
2139299,28,1,1985,1,"male",1089,71,53,1,26,1,22,0,4
2139302,32,31,1981,1,"male",191,81,72,78,213,69,49,9,164
2139307,39,21,1974,2,"male",248,49,44,3,4,3,2,0,2
2139318,54,18,1959,10,"female",1471,123,54,19,23,14,12,5,11
2139325,25,1,1988,1,"male",292,55,23,53,17,53,17,0,0
2139328,17,10,1996,2,"male",170,447,377,341,84,254,64,87,20
2139337,24,5,1989,10,"male",873,134,67,79,81,65,46,14,35
2139360,103,20,1910,3,"female",186,594,366,107,291,64,118,43,173
2139487,23,6,1990,5,"male",272,83,36,18,0,0,0,18,0
2139506,19,13,1994,6,"female",312,200,141,12,26,12,11,0,15
2139529,103,2,1910,9,"male",1200,157,80,221,178,221,135,0,43
2139543,28,13,1985,12,"female",731,152,68,43,6,43,5,0,1
2139551,41,7,1972,4,"male",434,55,22,0,2,0,2,0,0
2139556,22,17,1991,10,"male",142,205,161,26,114,26,37,0,77
2139595,52,9,1961,1,"female",41,37,17,26,36,26,31,0,5
2139604,68,20,1945,12,"female",1400,448,176,128,64,127,38,1,26
2139620,16,4,1997,3,"male",26,16,13,0,3,0,1,0,2
2139647,27,1,1986,2,"female",21,1,0,8,9,8,9,0,0
2139678,23,16,1990,9,"female",615,552,271,128,132,128,92,0,40
2139698,68,15,1945,8,"male",445,44,27,0,0,0,0,0,0
2139714,35,26,1978,5,"female",257,85,45,257,278,257,196,0,82
2139745,26,3,1987,1,"male",365,875,646,866,266,188,156,678,110
2139755,35,22,1978,7,"male",1174,1627,702,194,1105,110,545,84,560
2139765,68,17,1945,8,"male",112,20,18,10,16,10,15,0,1
2139773,21,5,1992,5,"male",562,48,31,1,0,1,0,0,0
2139780,29,20,1984,4,"male",628,152,100,103,51,103,48,0,3
2139822,34,5,1979,5,"male",36,0,0,0,0,0,0,0,0
2139824,94,30,1919,5,"male",547,171,124,21,36,10,30,11,6
2139846,47,1,1966,1,"female",310,43,17,0,0,0,0,0,0
2139858,38,15,1975,8,"male",522,69,45,89,58,89,40,0,18
2139869,35,10,1978,6,"male",226,19,10,1,28,0,9,1,19
2139882,19,18,1994,10,"female",463,695,366,366,362,284,175,82,187
2139885,47,19,1966,6,"male",607,161,128,0,2,0,2,0,0
2139907,47,7,1966,11,"female",2315,117,55,134,154,95,113,39,41
2139918,57,2,1956,12,"male",495,48,38,119,56,84,42,35,14
2139944,23,13,1990,3,"male",630,388,295,0,0,0,0,0,0
2139971,52,4,1961,2,"female",538,40,39,5,0,0,0,5,0
2139987,14,31,1999,1,"male",190,7,7,0,0,0,0,0,0
2139996,50,17,1963,1,"male",899,73,12,8,13,8,10,0,3
2140005,75,7,1938,7,"male",718,231,46,0,1,0,0,0,1
2140069,48,30,1965,10,"male",152,1,1,0,0,0,0,0,0
2140073,18,15,1995,8,"male",304,63,37,0,0,0,0,0,0
2140123,15,11,1998,4,"female",276,1122,324,2927,1966,2786,1491,141,475
2140137,16,14,1997,1,"female",434,257,200,100,346,35,255,65,91
2140152,14,26,1999,8,"male",209,89,70,24,1,24,1,0,0
2140157,29,27,1984,1,"female",440,115,65,106,141,106,90,0,51
2140201,28,5,1985,5,"male",59,59,49,54,88,54,80,0,8
2140270,14,9,1999,1,"female",977,772,188,1414,1047,544,821,870,226
2140319,18,18,1995,4,"female",70,102,84,1366,1541,314,316,1052,1225
2140332,49,23,1964,7,"female",512,10,8,361,1,361,1,0,0
2140362,38,6,1975,6,"female",1758,114,40,157,113,153,71,4,42
2140395,17,1,1996,1,"female",301,50,36,288,67,186,23,102,44
2140396,62,13,1951,10,"female",929,91,71,341,74,341,42,0,32
2140407,56,26,1957,7,"male",487,94,81,186,32,177,22,9,10
2140418,24,9,1989,9,"male",543,131,71,31,7,10,4,21,3
2140423,36,24,1977,11,"female",626,151,106,620,235,588,145,32,90
2140435,18,3,1995,1,"male",106,34,30,0,0,0,0,0,0
2140453,63,17,1950,1,"male",1027,49,27,0,18,0,9,0,9
2140479,70,23,1943,10,"female",1215,34,16,97,81,82,55,15,26
2140534,34,5,1979,8,"female",12,0,0,0,0,0,0,0,0
2140542,23,13,1990,4,"male",268,1,1,0,0,0,0,0,0
2140555,18,12,1995,3,"male",186,1,0,0,0,0,0,0,0
2140556,23,5,1990,12,"male",531,66,63,0,0,0,0,0,0
2140579,24,11,1989,8,"male",28,0,0,0,0,0,0,0,0
2140599,22,4,1991,9,"male",305,271,239,9,1,9,0,0,1
2140601,15,13,1998,12,"male",272,16,13,0,1,0,1,0,0
2140631,40,18,1973,6,"female",673,121,105,21,11,11,9,10,2
2140642,46,19,1967,1,"male",1423,4615,702,840,1896,347,772,493,1124
2140652,33,1,1980,1,"male",40,11,8,13,0,13,0,0,0
2140656,16,25,1997,4,"male",296,39,33,0,45,0,38,0,7
2140658,27,29,1986,6,"male",1222,366,248,4948,3653,956,1654,3992,1999
2140669,18,11,1995,2,"female",214,130,99,0,0,0,0,0,0
2140708,103,28,1910,7,"female",617,433,281,698,200,683,181,15,19
2140715,48,21,1965,11,"female",769,45,10,277,15,5,8,272,7
2140735,13,1,2000,1,"male",27,8,8,13,5,13,5,0,0
2140738,31,9,1982,1,"male",195,6,4,0,0,0,0,0,0
2140754,38,16,1975,10,"female",161,5,3,0,0,0,0,0,0
2140757,45,15,1968,12,"male",1711,68,20,2,2,2,2,0,0
2140762,35,1,1978,1,"female",231,16,8,375,30,375,24,0,6
2140777,17,13,1996,1,"male",376,3513,359,172,208,172,193,0,15
2140784,38,12,1975,7,"male",160,51,43,48,15,1,4,47,11
2140828,33,1,1980,1,"male",31,74,62,1,1,1,1,0,0
2140839,26,12,1987,2,"male",448,125,93,0,0,0,0,0,0
2140857,66,11,1947,12,"male",474,171,75,95,86,0,24,95,62
2140881,24,29,1989,10,"male",321,130,116,1,5,0,0,1,5
2140891,28,1,1985,4,"female",458,80,54,44,38,44,31,0,7
2140894,24,12,1989,2,"female",1108,178,56,1,28,1,10,0,18
2140909,19,1,1994,1,"female",182,20,13,3,8,2,8,1,0
2140929,63,20,1950,1,"female",1621,152,44,10,3,10,2,0,1
2140935,18,7,1995,1,"male",271,70,25,11,46,0,14,11,32
2140941,29,3,1984,4,"male",271,24,14,0,1,0,1,0,0
2140971,65,10,1948,2,"male",962,34,20,3,7,3,7,0,0
2140976,64,13,1949,12,"female",324,50,37,36,5,36,3,0,2
2140977,24,6,1989,11,"female",488,61,40,1,0,1,0,0,0
2140981,32,25,1981,1,"female",1350,592,323,26,317,22,250,4,67
2141000,21,6,1992,1,"male",820,206,105,14,44,12,28,2,16
2141017,20,27,1993,5,"male",407,694,632,692,368,0,116,692,252
2141031,54,28,1959,12,"female",678,185,146,4234,504,4234,431,0,73
2141046,66,1,1947,1,"male",1537,122,19,6,2,0,2,6,0
2141074,25,6,1988,5,"male",664,19,16,9,0,9,0,0,0
2141078,18,26,1995,2,"female",195,67,55,73,60,44,16,29,44
2141082,25,26,1988,4,"male",878,221,156,5,31,5,13,0,18
2141089,46,20,1967,10,"female",1647,1083,423,544,1219,372,695,172,524
2141117,35,17,1978,12,"female",395,363,77,231,314,20,53,211,261
2141132,62,11,1951,6,"male",1793,70,27,11,8,8,2,3,6
2141134,62,24,1951,6,"male",665,14,3,0,0,0,0,0,0
2141140,50,25,1963,5,"female",1713,94,23,107,53,107,45,0,8
2141146,19,3,1994,8,"male",0,0,0,0,0,0,0,0,0
2141170,23,1,1990,1,"female",552,503,373,7,17,7,14,0,3
2141174,16,10,1997,4,"male",432,2593,165,402,272,402,264,0,8
2141177,33,7,1980,9,"female",959,6,4,0,0,0,0,0,0
2141185,28,27,1985,12,"female",313,42,38,1,3,1,2,0,1
2141227,22,11,1991,8,"male",428,70,54,53,66,53,35,0,31
2141258,37,16,1976,1,"female",52,83,51,163,72,163,33,0,39
2141265,24,16,1989,10,"male",148,4,4,3,0,0,0,3,0
2141278,17,18,1996,6,"female",500,42,14,0,1,0,1,0,0
2141296,48,1,1965,1,"male",173,6,6,3,3,2,2,1,1
2141319,73,30,1940,5,"male",1435,34,16,0,1,0,1,0,0
2141340,19,3,1994,4,"female",259,135,32,13,76,13,72,0,4
2141361,38,20,1975,2,"female",268,83,62,31,31,27,5,4,26
2141363,96,1,1917,1,"male",969,45,35,504,153,9,104,495,49
2141366,21,8,1992,8,"female",337,135,76,49,65,49,54,0,11
2141406,25,29,1988,5,"male",1177,513,327,154,100,152,62,2,38
2141425,106,20,1907,4,"male",25,88,86,109,4,109,2,0,2
2141436,32,14,1981,11,"male",228,195,133,281,119,281,118,0,1
2141441,50,1,1963,8,"male",70,59,44,127,24,127,15,0,9
2141448,27,20,1986,6,"male",212,14,13,3,0,3,0,0,0
2141452,21,29,1992,5,"female",388,139,109,43,74,39,48,4,26
2141463,15,6,1998,11,"female",474,485,336,15,41,0,7,15,34
2141467,58,12,1955,7,"male",1185,530,382,602,209,1,13,601,196
2141492,30,6,1983,9,"female",222,86,48,2,0,2,0,0,0
2141496,52,27,1961,9,"male",510,15,6,0,0,0,0,0,0
2141497,20,16,1993,7,"female",1319,1118,485,107,256,88,194,19,62
2141512,58,19,1955,3,"male",143,12,11,48,13,0,2,48,11
2141516,20,24,1993,8,"female",390,252,215,2,3,0,1,2,2
2141519,16,22,1997,5,"male",52,19,7,0,0,0,0,0,0
2141533,25,29,1988,4,"female",77,0,0,0,0,0,0,0,0
2141539,23,27,1990,9,"female",344,339,270,265,343,214,126,51,217
2141552,21,2,1992,4,"female",524,32,30,0,0,0,0,0,0
2141556,25,8,1988,8,"male",418,176,161,73,4,73,4,0,0
2141566,14,7,1999,6,"female",318,333,271,97,147,90,117,7,30
2141567,21,29,1992,4,"male",480,150,52,11,20,11,17,0,3
2141573,28,28,1985,2,"female",473,41,30,1,0,0,0,1,0
2141589,22,11,1991,11,"male",138,33,18,7,3,7,3,0,0
2141603,21,20,1992,6,"male",130,222,176,10,26,1,12,9,14
2141604,13,20,2000,1,"male",260,178,140,39,10,0,0,39,10
2141608,13,30,2000,7,"male",81,257,146,30,0,10,0,20,0
2141630,21,17,1992,6,"male",217,222,180,312,44,312,36,0,8
2141631,25,9,1988,9,"male",431,27,25,179,4,179,4,0,0
2141637,56,11,1957,6,"female",784,38,17,2,3,0,2,2,1
2141654,70,24,1943,2,"female",1580,71,29,4,7,0,4,4,3
2141665,25,1,1988,8,"female",691,128,78,586,178,586,171,0,7
2141670,103,15,1910,8,"male",671,72,66,0,0,0,0,0,0
2141692,80,27,1933,11,"female",929,4514,286,424,220,424,173,0,47
2141745,17,4,1996,4,"female",597,1264,241,121,319,121,243,0,76
2141781,25,9,1988,5,"male",607,118,76,41,10,40,6,1,4
2141786,27,11,1986,12,"female",885,218,125,2,0,0,0,2,0
2141792,70,9,1943,11,"male",345,4,2,36,2,36,1,0,1
2141793,20,2,1993,1,"female",397,220,115,1,3,1,2,0,1
2141796,23,26,1990,5,"female",134,183,77,7,17,7,7,0,10
2141820,42,14,1971,11,"female",616,18,9,0,0,0,0,0,0
2141830,49,21,1964,8,"female",1493,46,28,6,2,4,2,2,0
2141832,44,12,1969,6,"female",1072,33,16,308,286,249,264,59,22
2141838,18,13,1995,7,"male",377,241,198,4,2,3,1,1,1
2141872,30,10,1983,8,"female",344,34,17,2,0,2,0,0,0
2141881,18,3,1995,4,"male",391,265,164,21,108,21,88,0,20
2141900,20,17,1993,5,"female",1366,2801,510,3,346,3,294,0,52
2141932,48,5,1965,3,"male",823,382,123,10,39,5,14,5,25
2141936,16,20,1997,9,"male",287,88,58,1,14,0,10,1,4
2141947,53,27,1960,10,"male",1789,37,16,4,6,4,1,0,5
2141977,18,2,1995,8,"male",387,149,131,0,0,0,0,0,0
2141993,54,15,1959,4,"female",341,39,27,104,93,101,55,3,38
2142000,28,22,1985,5,"male",270,11,9,0,0,0,0,0,0
2142003,24,2,1989,7,"male",455,58,32,8,5,8,3,0,2
2142022,29,4,1984,12,"male",263,21,14,5,0,5,0,0,0
2142052,66,2,1947,5,"female",2335,19,2,8,0,8,0,0,0
2142110,17,28,1996,3,"male",203,36,30,265,36,265,19,0,17
2142157,19,4,1994,9,"male",168,318,168,479,792,318,509,161,283
2142176,74,16,1939,10,"male",1401,48,31,2,9,2,5,0,4
2142187,59,9,1954,9,"female",1533,29,16,604,112,604,56,0,56
2142193,17,30,1996,6,"male",511,500,376,417,355,417,235,0,120
2142201,22,23,1991,11,"female",295,21,0,0,0,0,0,0,0
2142228,54,5,1959,7,"female",439,37,25,167,136,154,116,13,20
2142236,43,20,1970,1,"male",193,2,1,0,0,0,0,0,0
2142237,34,21,1979,6,"male",376,33,15,43,50,31,50,12,0
2142261,25,1,1988,5,"male",153,66,58,5,1,5,1,0,0
2142272,15,10,1998,3,"female",230,75,32,0,1,0,1,0,0
2142311,25,25,1988,7,"male",266,80,61,2,9,2,8,0,1
2142320,21,4,1992,4,"female",251,367,323,445,346,439,260,6,86
2142364,51,10,1962,4,"male",361,16,16,0,0,0,0,0,0
2142411,27,30,1986,3,"female",202,30,15,46,51,15,31,31,20
2142416,25,1,1988,5,"female",205,57,47,0,2,0,1,0,1
2142434,15,14,1998,8,"male",388,513,432,461,935,224,421,237,514
2142442,42,30,1971,10,"male",856,33,9,1,2,1,0,0,2
2142485,61,28,1952,10,"male",590,113,56,164,76,164,69,0,7
2142486,27,4,1986,1,"male",400,32,25,0,0,0,0,0,0
2142487,35,13,1978,9,"male",567,198,67,526,392,489,307,37,85
2142499,18,22,1995,2,"male",150,31,15,10,2,6,0,4,2
2142513,58,5,1955,2,"female",1721,66,8,253,28,0,15,253,13
2142527,27,6,1986,7,"male",187,128,90,0,58,0,21,0,37
2142557,24,22,1989,10,"male",844,39,22,9,38,9,22,0,16
2142568,81,27,1932,3,"male",1832,16,10,22,8,0,7,22,1
2142577,27,24,1986,4,"male",216,16,7,0,0,0,0,0,0
2142592,17,5,1996,6,"female",438,317,176,120,42,27,21,93,21
2142608,30,10,1983,7,"male",725,346,242,2,0,2,0,0,0
2142658,67,31,1946,5,"male",410,21,6,0,0,0,0,0,0
2142660,17,17,1996,2,"female",141,389,92,1135,719,1130,520,5,199
2142665,19,13,1994,4,"female",366,581,439,90,109,90,50,0,59
2142682,60,2,1953,4,"female",602,121,81,56,25,56,10,0,15
2142691,41,24,1972,6,"male",1001,196,83,0,0,0,0,0,0
2142720,56,23,1957,6,"male",342,74,25,1,4,0,4,1,0
2142726,21,20,1992,12,"male",82,37,30,0,0,0,0,0,0
2142728,43,22,1970,11,"male",1529,31,13,21,1,2,1,19,0
2142739,27,6,1986,6,"male",235,24,19,3,6,3,3,0,3
2142777,23,28,1990,11,"male",633,111,66,50,23,50,22,0,1
2142805,102,11,1911,11,"male",623,94,55,0,59,0,27,0,32
2142811,19,12,1994,2,"male",259,346,263,7,3,7,2,0,1
2142817,18,19,1995,4,"male",240,72,57,2,0,2,0,0,0
2142852,18,25,1995,5,"male",407,979,671,0,0,0,0,0,0
2142864,15,18,1998,6,"female",71,101,90,55,29,55,28,0,1
2142885,24,22,1989,2,"male",205,26,20,0,0,0,0,0,0
2142920,25,22,1988,1,"female",375,152,109,170,237,168,96,2,141
2142923,62,20,1951,7,"female",789,73,50,63,9,56,8,7,1
2142932,20,30,1993,12,"male",109,38,30,1,2,1,2,0,0
2142943,33,14,1980,11,"female",1303,234,171,227,144,227,120,0,24
2142958,68,3,1945,4,"male",2242,193,94,629,487,162,215,467,272
2142960,49,2,1964,4,"male",753,43,24,0,1,0,0,0,1
2142975,33,5,1980,1,"male",735,99,20,51,110,51,84,0,26
2142987,18,27,1995,2,"male",149,15,8,7,0,7,0,0,0
2142988,16,3,1997,9,"male",197,4190,1170,230,1703,133,1339,97,364
2143016,27,7,1986,2,"male",147,60,54,11,12,11,11,0,1
2143034,27,22,1986,10,"male",400,68,58,2,22,2,7,0,15
2143039,14,14,1999,9,"female",376,333,175,17,10,15,3,2,7
2143047,22,9,1991,2,"male",270,17,14,0,0,0,0,0,0
2143055,22,11,1991,5,"male",613,69,47,133,65,56,24,77,41
2143069,28,27,1985,3,"female",315,14,3,0,0,0,0,0,0
2143083,37,7,1976,4,"male",271,0,0,0,0,0,0,0,0
2143097,15,4,1998,1,"male",39,29,24,1,0,0,0,1,0
2143142,15,2,1998,3,"female",193,0,0,0,0,0,0,0,0
2143146,25,26,1988,7,"female",437,240,196,0,0,0,0,0,0
2143149,15,23,1998,5,"female",103,54,40,20,5,20,4,0,1
2143164,38,1,1975,1,"male",297,31,30,0,1,0,0,0,1
2143171,27,27,1986,9,"female",532,80,60,62,52,54,27,8,25
2143172,22,21,1991,4,"female",523,170,91,6,0,6,0,0,0
2143175,28,7,1985,11,"male",411,1,0,0,0,0,0,0,0
2143196,38,12,1975,2,"female",456,132,84,214,46,185,37,29,9
2143210,33,10,1980,5,"male",300,69,29,23,45,23,9,0,36
2143248,45,21,1968,10,"male",1362,44,9,17,10,12,4,5,6
2143259,46,24,1967,9,"female",250,87,62,175,155,163,42,12,113
2143276,61,26,1952,6,"male",570,13,8,0,0,0,0,0,0
2143283,27,3,1986,7,"male",498,47,37,0,0,0,0,0,0
2143303,27,18,1986,3,"male",220,74,29,0,14,0,11,0,3
2143319,16,4,1997,5,"male",145,7,7,2,1,0,0,2,1
2143320,61,7,1952,12,"female",766,108,77,71,43,71,42,0,1
2143342,67,12,1946,7,"male",1,2,2,1,0,1,0,0,0
2143361,22,18,1991,5,"female",337,515,247,833,1275,833,954,0,321
2143376,33,19,1980,8,"female",19,26,22,9,64,5,37,4,27
2143380,74,18,1939,12,"male",432,29,26,0,0,0,0,0,0
2143394,17,26,1996,6,"male",562,243,106,1,0,1,0,0,0
2143414,38,1,1975,5,"female",41,11,10,340,99,0,25,340,74
2143421,60,17,1953,3,"male",1025,14,7,23,12,18,11,5,1
2143437,19,2,1994,4,"male",523,112,66,2,2,0,1,2,1
2143440,17,13,1996,10,"female",331,258,145,156,172,156,128,0,44
2143451,33,19,1980,10,"male",350,15,12,77,62,0,0,77,62
2143491,37,1,1976,1,"male",578,186,120,553,34,504,25,49,9
2143495,20,14,1993,7,"female",1124,724,354,660,852,540,726,120,126
2143503,34,26,1979,2,"male",44,31,13,1,1,1,1,0,0
2143520,67,31,1946,7,"female",1853,28,23,53,30,16,7,37,23
2143586,51,11,1962,2,"female",1554,114,62,671,370,671,245,0,125
2143587,59,24,1954,4,"male",101,31,21,31,0,31,0,0,0
2143641,55,9,1958,1,"female",699,88,16,4,2,1,1,3,1
2143644,56,25,1957,9,"male",98,0,0,0,0,0,0,0,0
2143647,28,12,1985,12,"male",529,71,35,13,5,13,5,0,0
2143665,27,22,1986,6,"male",389,56,29,67,0,19,0,48,0
2143678,23,7,1990,10,"male",407,71,32,0,0,0,0,0,0
2143686,18,20,1995,10,"male",157,224,107,99,44,99,25,0,19
2143694,20,8,1993,5,"female",241,102,52,117,84,83,31,34,53
2143696,13,1,2000,1,"male",81,0,0,0,0,0,0,0,0
2143761,36,14,1977,2,"male",358,96,39,1,0,1,0,0,0
2143768,44,5,1969,2,"male",333,25,13,1,2,0,2,1,0
2143879,19,23,1994,8,"male",328,227,169,203,82,203,27,0,55
2143886,19,18,1994,9,"female",310,29,17,112,20,112,20,0,0
2143898,16,4,1997,3,"male",185,24,16,0,0,0,0,0,0
2143914,30,3,1983,9,"female",326,95,64,35,25,13,9,22,16
2143920,22,15,1991,10,"female",399,17,10,0,1,0,1,0,0
2143921,108,2,1905,4,"male",80,114,90,3,24,0,7,3,17
2143930,61,3,1952,3,"male",464,90,87,178,25,178,22,0,3
2143933,29,7,1984,4,"male",368,49,35,179,6,179,4,0,2
2143935,54,13,1959,1,"male",552,5,1,0,0,0,0,0,0
2143944,62,31,1951,8,"female",103,137,96,10,1,9,0,1,1
2143949,36,21,1977,3,"female",416,309,218,190,239,190,141,0,98
2143980,27,7,1986,7,"male",254,0,0,0,0,0,0,0,0
2144002,63,11,1950,1,"female",48,30,15,51,2,0,1,51,1
2144036,32,20,1981,8,"female",286,2,0,0,0,0,0,0,0
2144039,51,15,1962,9,"male",489,2,1,0,1,0,1,0,0
2144040,29,13,1984,5,"male",254,35,28,0,0,0,0,0,0
2144042,15,19,1998,5,"male",236,53,43,1,0,0,0,1,0
2144043,26,30,1987,3,"male",578,321,177,46,9,46,5,0,4
2144045,63,21,1950,5,"male",2219,42,8,0,0,0,0,0,0
2144079,41,12,1972,9,"male",255,7,1,0,0,0,0,0,0
2144104,15,21,1998,9,"female",476,2430,2177,390,1613,194,1163,196,450
2144139,18,10,1995,1,"male",640,233,137,93,79,34,36,59,43
2144151,15,8,1998,10,"male",371,3,1,2,1,0,0,2,1
2144164,21,23,1992,1,"male",69,17,14,6,0,6,0,0,0
2144212,55,2,1958,7,"male",186,69,33,22,18,0,7,22,11
2144218,18,13,1995,7,"male",263,315,263,425,67,320,57,105,10
2144234,37,1,1976,1,"female",171,69,37,27,41,27,40,0,1
2144309,86,16,1927,1,"female",1379,52,12,1,3,0,2,1,1
2144333,25,31,1988,5,"male",38,38,31,0,2,0,0,0,2
2144346,61,13,1952,8,"female",1290,32,19,50,5,0,3,50,2
2144353,16,7,1997,10,"male",216,218,196,0,0,0,0,0,0
2144366,22,8,1991,4,"female",334,340,265,79,368,44,151,35,217
2144371,25,1,1988,1,"male",64,146,117,11,1,11,1,0,0
2144381,23,9,1990,4,"male",78,20,8,2,2,2,2,0,0
2144393,37,6,1976,1,"male",382,2,2,0,0,0,0,0,0
2144407,35,17,1978,6,"female",744,87,43,10,5,10,5,0,0
2144420,18,3,1995,4,"male",164,62,49,0,0,0,0,0,0
2144442,44,19,1969,11,"male",227,40,19,4,8,4,3,0,5
2144484,22,9,1991,10,"male",371,104,49,0,0,0,0,0,0
2144495,28,27,1985,4,"female",1177,194,127,52,99,52,85,0,14
2144524,23,27,1990,9,"male",551,582,329,1,8,1,4,0,4
2144529,18,1,1995,4,"male",304,177,116,12,16,8,4,4,12
2144536,51,23,1962,10,"male",333,46,36,182,67,154,36,28,31
2144541,20,9,1993,9,"male",207,137,110,8,0,0,0,8,0
2144565,16,5,1997,3,"male",389,216,177,71,1,0,0,71,1
2144589,18,1,1995,8,"male",74,91,71,207,285,207,236,0,49
2144640,29,30,1984,11,"male",87,15,6,0,0,0,0,0,0
2144646,28,17,1985,7,"male",718,16,10,0,0,0,0,0,0
2144652,31,31,1982,5,"female",198,24,12,4,8,0,8,4,0
2144699,45,17,1968,12,"male",719,107,53,72,62,48,50,24,12
2144737,68,25,1945,11,"female",1023,44,11,9,26,9,9,0,17
2144758,25,4,1988,4,"male",342,92,56,1,0,1,0,0,0
2144788,37,25,1976,1,"female",777,171,115,137,294,75,253,62,41
2144790,24,23,1989,9,"male",562,138,69,11,3,11,1,0,2
2144808,22,2,1991,5,"male",284,185,80,5,0,5,0,0,0
2144859,57,12,1956,12,"female",535,30,16,11,1,5,1,6,0
2144880,71,12,1942,12,"male",746,104,46,6,32,1,14,5,18
2144892,26,18,1987,12,"male",527,94,83,134,13,134,11,0,2
2144893,29,29,1984,3,"female",70,15,2,2,1,2,1,0,0
2144913,31,3,1982,10,"male",221,35,19,0,0,0,0,0,0
2144964,24,22,1989,5,"male",63,49,10,0,1,0,1,0,0
2144976,48,1,1965,1,"male",1907,64,36,84,87,70,69,14,18
2145013,15,8,1998,2,"female",520,53,26,0,0,0,0,0,0
2145079,28,7,1985,8,"male",254,205,183,1,2,1,1,0,1
2145083,21,8,1992,8,"female",653,327,197,0,0,0,0,0,0
2145094,16,5,1997,6,"female",736,370,312,1148,341,193,118,955,223
2145097,30,26,1983,11,"female",72,39,26,90,49,90,41,0,8
2145122,26,13,1987,6,"male",491,224,207,23,78,23,74,0,4
2145138,20,30,1993,6,"male",266,49,30,20,15,20,14,0,1
2145176,106,17,1907,6,"male",190,58,33,42,3,42,0,0,3
2145184,31,17,1982,11,"male",94,0,0,0,0,0,0,0,0
2145185,28,8,1985,10,"female",212,105,72,268,201,268,158,0,43
2145200,75,1,1938,1,"male",22,18,16,0,0,0,0,0,0
2145218,25,22,1988,12,"male",406,485,401,716,284,220,177,496,107
2145223,33,1,1980,1,"male",40,2,1,0,0,0,0,0,0
2145237,20,12,1993,12,"male",576,1103,905,709,419,709,337,0,82
2145240,18,2,1995,4,"female",321,326,138,371,510,371,495,0,15
2145261,49,6,1964,1,"female",95,2,2,0,0,0,0,0,0
2145274,45,27,1968,9,"male",27,1,1,0,0,0,0,0,0
2145295,53,1,1960,5,"female",264,17,12,143,43,141,22,2,21
2145298,108,28,1905,12,"male",1641,911,553,2,9,2,6,0,3
2145305,22,29,1991,11,"male",377,79,47,17,7,17,2,0,5
2145337,82,11,1931,7,"female",1520,53,19,125,6,4,1,121,5
2145371,17,14,1996,4,"male",275,133,82,0,0,0,0,0,0
2145372,16,30,1997,10,"male",128,71,62,18,8,18,7,0,1
2145377,34,12,1979,8,"female",129,109,60,245,73,245,66,0,7
2145396,51,9,1962,3,"female",292,27,16,4,0,4,0,0,0
2145410,19,10,1994,10,"male",1830,182,127,31,13,27,12,4,1
2145433,47,14,1966,9,"male",485,117,89,5,9,0,0,5,9
2145451,37,22,1976,11,"female",637,298,213,46,33,46,17,0,16
2145454,51,23,1962,6,"female",823,76,26,952,92,770,59,182,33
2145482,24,14,1989,2,"female",16,26,26,5,9,5,7,0,2
2145492,59,26,1954,3,"male",381,70,65,72,9,9,4,63,5
2145504,32,3,1981,6,"male",366,43,34,10,16,2,14,8,2
2145522,49,28,1964,8,"male",1485,260,82,3,0,2,0,1,0
2145532,67,1,1946,9,"female",274,152,51,166,23,53,13,113,10
2145546,19,19,1994,8,"male",119,1,1,0,0,0,0,0,0
2145564,15,11,1998,3,"male",602,566,286,9,126,8,39,1,87
2145619,30,6,1983,12,"male",783,1,1,1,0,0,0,1,0
2145627,23,12,1990,12,"male",794,379,284,62,3,43,2,19,1
2145631,53,18,1960,12,"male",377,30,13,65,27,65,18,0,9
2145642,16,28,1997,6,"male",258,281,178,109,16,39,7,70,9
2145692,21,8,1992,1,"male",39,27,20,96,4,96,0,0,4
2145693,34,25,1979,4,"female",85,17,10,24,0,16,0,8,0
2145745,46,20,1967,5,"male",307,136,48,30,41,30,34,0,7
2145757,23,13,1990,11,"male",535,90,10,24,34,24,25,0,9
2145760,48,1,1965,8,"male",78,50,46,2,1,2,1,0,0
2145781,61,7,1952,9,"female",1151,46,20,5,44,5,30,0,14
2145793,26,20,1987,5,"male",453,895,850,329,66,221,58,108,8
2145854,18,26,1995,1,"male",215,28,21,72,4,12,0,60,4
2145860,22,5,1991,1,"male",520,56,44,1,0,0,0,1,0
2145890,25,10,1988,11,"male",104,67,41,192,29,192,18,0,11
2145896,63,15,1950,9,"male",1565,47,11,0,4,0,4,0,0
2145900,27,12,1986,11,"male",700,28,11,1,0,0,0,1,0
2145922,43,10,1970,10,"male",1586,29,7,4,40,4,23,0,17
2145945,53,27,1960,7,"female",607,173,139,65,3,0,1,65,2
2145955,23,8,1990,4,"male",239,79,26,3,5,3,5,0,0
2145994,22,10,1991,11,"male",195,88,56,818,969,54,459,764,510
2146013,14,21,1999,5,"male",468,360,271,6,7,0,5,6,2
2146051,21,22,1992,4,"male",401,55,43,0,0,0,0,0,0
2146077,17,16,1996,6,"female",19,42,35,12,0,8,0,4,0
2146096,61,28,1952,9,"female",1043,53,26,113,89,112,86,1,3
2146108,24,21,1989,4,"male",601,65,15,9,17,9,17,0,0
2146138,24,6,1989,4,"male",352,84,72,4,0,4,0,0,0
2146143,43,5,1970,7,"female",185,38,27,20,7,20,1,0,6
2146157,20,9,1993,4,"female",726,109,47,47,42,47,41,0,1
2146165,18,4,1995,10,"male",516,166,122,1,2,1,2,0,0
2146171,102,4,1911,6,"female",1582,730,394,44,42,44,37,0,5
2146177,33,27,1980,11,"male",667,5,4,0,0,0,0,0,0
2146184,58,16,1955,11,"female",304,35,18,0,2,0,0,0,2
2146194,28,23,1985,9,"male",653,141,119,2,0,0,0,2,0
2146212,39,25,1974,12,"female",582,5,1,0,0,0,0,0,0
2146242,30,14,1983,12,"male",285,174,129,18,24,0,7,18,17
2146262,61,4,1952,3,"female",1261,94,54,51,17,27,9,24,8
2146270,66,18,1947,7,"male",455,178,89,0,2,0,1,0,1
2146293,17,23,1996,6,"female",1408,1032,522,4,5,3,5,1,0
2146305,43,7,1970,8,"female",251,87,52,40,23,40,18,0,5
2146311,20,27,1993,8,"female",144,270,113,169,281,169,254,0,27
2146319,24,10,1989,5,"male",345,102,67,33,230,33,164,0,66
2146325,54,21,1959,2,"male",278,61,35,1,5,1,5,0,0
2146385,19,14,1994,11,"female",460,152,40,14,10,14,10,0,0
2146405,18,1,1995,12,"male",194,32,27,0,0,0,0,0,0
2146406,13,2,2000,2,"male",0,0,0,1,0,0,0,1,0
2146417,28,12,1985,10,"male",137,1,1,0,0,0,0,0,0
2146424,16,13,1997,1,"male",623,454,418,0,1,0,1,0,0
2146439,23,1,1990,1,"male",349,74,70,4,5,4,4,0,1
2146452,19,4,1994,1,"male",383,228,199,5,0,5,0,0,0
2146454,49,16,1964,3,"female",708,421,175,1252,786,12,326,1240,460
2146480,68,17,1945,8,"male",868,187,110,0,1,0,1,0,0
2146518,23,12,1990,5,"female",971,26,20,2097,358,2064,139,33,219
2146524,56,2,1957,7,"female",523,22,18,88,3,0,0,88,3
2146559,18,3,1995,10,"female",825,227,93,844,1091,775,592,69,499
2146568,55,29,1958,9,"male",1017,195,167,42,35,0,11,42,24
2146600,32,25,1981,10,"male",563,13,7,29,13,3,7,26,6
2146615,51,3,1962,3,"male",1489,47,32,0,2,0,0,0,2
2146625,15,16,1998,2,"male",663,36,25,2,0,0,0,2,0
2146626,18,15,1995,6,"male",377,69,53,0,0,0,0,0,0
2146632,106,5,1907,2,"male",1703,148,7,0,0,0,0,0,0
2146645,52,30,1961,3,"female",1611,97,42,34,106,34,80,0,26
2146747,62,12,1951,9,"female",976,368,321,234,40,229,31,5,9
2146767,21,23,1992,1,"male",255,1,1,16,3,2,2,14,1
2146785,27,26,1986,5,"female",454,284,226,192,69,1,48,191,21
2146790,58,7,1955,8,"female",863,38,17,43,36,16,26,27,10
2146812,62,27,1951,6,"female",1117,91,43,1,13,0,4,1,9
2146816,14,8,1999,8,"female",216,13,9,0,0,0,0,0,0
2146826,26,19,1987,7,"male",631,43,1,0,11,0,8,0,3
2146846,23,30,1990,11,"male",973,99,41,2,0,0,0,2,0
2146852,17,21,1996,9,"female",259,350,314,52,153,44,70,8,83
2146934,18,3,1995,9,"female",250,50,35,2,8,0,2,2,6
2147021,64,13,1949,6,"female",306,12,8,1,0,1,0,0,0
2147056,41,5,1972,5,"male",249,90,82,0,0,0,0,0,0
2147079,20,14,1993,2,"male",18,91,87,8,22,6,20,2,2
2147080,21,20,1992,10,"male",124,62,54,0,1,0,1,0,0
2147089,28,2,1985,7,"male",307,151,147,0,0,0,0,0,0
2147120,26,31,1987,10,"male",209,75,34,138,145,138,110,0,35
2147202,35,24,1978,11,"male",301,30,22,2,0,0,0,2,0
2147239,22,4,1991,4,"male",426,19,13,1,1,1,0,0,1
2147246,26,30,1987,3,"male",458,202,159,42,6,7,2,35,4
2147252,36,12,1977,10,"male",265,130,90,1,3,0,2,1,1
2147259,15,1,1998,1,"male",760,1809,1114,1,0,0,0,1,0
2147268,93,30,1920,4,"female",175,41,34,46,23,6,18,40,5
2147269,47,3,1966,1,"male",1576,30,19,26,29,26,19,0,10
2147294,48,14,1965,5,"male",986,690,470,6,0,4,0,2,0
2147308,47,10,1966,4,"female",879,74,40,47,2,42,2,5,0
2147313,25,2,1988,10,"female",345,89,72,12,17,9,5,3,12
2147332,49,25,1964,4,"female",90,19,14,8,13,8,8,0,5
2147343,19,10,1994,10,"male",123,40,36,1,1,1,1,0,0
2147376,21,29,1992,4,"female",35,35,20,2,5,2,5,0,0
2147381,32,1,1981,1,"male",285,129,123,287,72,287,24,0,48
2147387,14,17,1999,1,"male",273,44,41,0,3,0,3,0,0
2147391,17,21,1996,2,"female",194,398,227,854,297,854,291,0,6
2147402,23,13,1990,1,"female",319,387,259,37,57,37,47,0,10
2147427,65,29,1948,4,"female",1250,154,56,93,276,93,184,0,92
2147444,25,8,1988,10,"male",219,208,164,13,27,13,21,0,6
2147449,15,10,1998,10,"female",503,269,95,8,2,8,2,0,0
2147471,16,19,1997,9,"female",512,529,194,2,1,2,1,0,0
2147521,39,16,1974,10,"male",152,1,0,0,0,0,0,0,0
2147547,36,2,1977,9,"male",280,47,31,121,21,121,3,0,18
2147554,64,2,1949,9,"female",965,460,176,3,9,0,8,3,1
2147566,108,1,1905,1,"male",1606,31,20,8,6,0,2,8,4
2147608,54,16,1959,10,"male",308,42,32,4,11,0,5,4,6
2147619,22,22,1991,7,"female",366,100,64,0,0,0,0,0,0
2147664,25,8,1988,8,"female",343,131,42,31,75,23,34,8,41
2147670,53,30,1960,7,"female",1328,98,44,358,163,269,41,89,122
2147687,32,17,1981,7,"male",261,15,9,14,70,14,69,0,1
2147708,18,29,1995,10,"female",378,1692,751,173,1553,173,1428,0,125
2147714,18,7,1995,5,"male",237,75,54,0,0,0,0,0,0
2147754,33,1,1980,1,"female",334,0,0,0,0,0,0,0,0
2147790,33,13,1980,12,"female",214,32,19,326,119,326,83,0,36
2147822,30,5,1983,2,"male",1007,11,2,0,0,0,0,0,0
2147840,41,6,1972,1,"male",624,59,55,42,10,42,8,0,2
2147843,52,14,1961,12,"male",617,69,51,50,13,50,8,0,5
2147846,17,6,1996,1,"male",193,17,15,0,0,0,0,0,0
2147847,50,28,1963,8,"female",565,389,197,79,125,3,32,76,93
2147848,47,30,1966,3,"female",129,2,2,0,0,0,0,0,0
2147862,105,15,1908,2,"female",1083,829,617,230,318,230,237,0,81
2147871,105,18,1908,6,"female",76,109,97,3,31,3,29,0,2
2147891,16,18,1997,6,"female",246,699,387,92,54,92,40,0,14
2147945,47,5,1966,11,"male",681,1337,916,1250,397,1250,297,0,100
2147948,19,6,1994,6,"male",394,314,252,1,0,1,0,0,0
2147962,23,14,1990,8,"female",641,185,59,1038,46,1038,41,0,5
2148004,39,19,1974,10,"female",507,73,40,530,78,530,78,0,0
2148010,31,1,1982,1,"female",2268,435,316,879,660,752,493,127,167
2148021,53,17,1960,10,"male",582,72,41,0,2,0,0,0,2
2148023,80,13,1933,4,"female",1104,758,387,1338,879,261,458,1077,421
2148026,22,10,1991,12,"female",826,252,105,40,101,40,94,0,7
2148054,52,13,1961,2,"male",143,40,34,10,12,2,8,8,4
2148137,24,23,1989,7,"male",210,8,5,8,4,0,2,8,2
2148153,58,31,1955,1,"male",1163,384,300,9,0,0,0,9,0
2148196,16,11,1997,10,"male",979,645,335,1,35,0,12,1,23
2148230,26,24,1987,9,"male",21,31,20,46,79,37,75,9,4
2148237,28,6,1985,6,"female",51,773,170,3542,2366,3542,1959,0,407
2148258,22,25,1991,11,"female",259,183,134,863,122,799,94,64,28
2148259,25,2,1988,11,"female",281,52,36,1816,77,1816,50,0,27
2148279,26,11,1987,9,"female",487,116,46,83,13,83,8,0,5
2148296,29,15,1984,2,"female",687,269,121,75,109,33,45,42,64
2148299,22,7,1991,5,"male",725,230,152,0,0,0,0,0,0
2148318,37,31,1976,10,"female",575,141,71,139,197,139,108,0,89
2148335,105,13,1908,9,"male",1384,190,46,0,1,0,1,0,0
2148349,42,12,1971,8,"female",256,42,31,3,1,3,1,0,0
2148355,18,12,1995,6,"male",130,90,48,12,39,12,23,0,16
2148369,108,1,1905,1,"male",2333,272,83,2,15,2,3,0,12
2148374,21,26,1992,3,"male",566,64,47,0,0,0,0,0,0
2148388,17,1,1996,12,"female",246,307,223,136,253,130,154,6,99
2148397,32,10,1981,11,"male",307,74,49,2,2,0,0,2,2
2148430,25,14,1988,7,"male",587,105,83,0,0,0,0,0,0
2148449,58,12,1955,7,"male",420,75,58,130,32,26,15,104,17
2148463,103,28,1910,2,"male",898,323,169,10,13,10,13,0,0
2148496,34,1,1979,5,"male",603,170,53,1,3,1,2,0,1
2148503,27,25,1986,4,"male",345,78,58,162,186,83,156,79,30
2148517,55,30,1958,11,"male",536,29,14,0,0,0,0,0,0
2148524,69,4,1944,4,"male",62,22,10,34,9,34,3,0,6
2148537,18,20,1995,2,"female",595,595,239,185,192,185,110,0,82
2148541,26,12,1987,3,"male",374,299,228,20,28,20,17,0,11
2148601,23,1,1990,10,"male",758,347,79,11,24,0,13,11,11
2148608,37,6,1976,2,"male",915,205,122,5,12,5,10,0,2
2148615,33,10,1980,1,"male",330,64,43,45,0,45,0,0,0
2148624,17,22,1996,8,"male",441,9,5,6,0,6,0,0,0
2148638,32,18,1981,9,"male",561,288,239,54,203,54,200,0,3
2148661,27,17,1986,12,"male",745,253,237,2,10,2,6,0,4
2148662,18,13,1995,8,"male",259,506,386,2231,1164,262,550,1969,614
2148667,19,18,1994,8,"male",15,27,15,46,49,46,35,0,14
2148675,66,25,1947,2,"male",1098,39,21,4,1,4,1,0,0
2148685,25,2,1988,11,"male",827,352,65,95,43,93,37,2,6
2148691,56,26,1957,5,"female",332,79,54,489,96,32,43,457,53
2148714,24,12,1989,9,"female",668,174,133,182,112,182,105,0,7
2148733,34,9,1979,7,"male",191,135,68,8,3,8,1,0,2
2148744,46,21,1967,7,"female",231,66,34,10,10,10,3,0,7
2148814,48,7,1965,8,"female",834,27,13,0,0,0,0,0,0
2148822,16,15,1997,1,"female",1000,302,154,306,249,39,103,267,146
2148849,50,21,1963,9,"female",579,13,5,10,0,10,0,0,0
2148852,49,25,1964,2,"female",986,668,387,881,763,298,107,583,656
2148881,22,7,1991,1,"male",576,974,886,0,19,0,15,0,4
2148902,24,2,1989,3,"female",29,38,16,26,37,1,13,25,24
2148905,42,25,1971,1,"female",703,54,17,107,75,107,55,0,20
2148925,23,7,1990,7,"male",149,53,50,3,1,1,1,2,0
2148951,58,17,1955,10,"male",549,285,47,89,54,0,12,89,42
2148965,40,8,1973,4,"male",1146,80,53,12,1,12,1,0,0
2148975,15,8,1998,6,"male",189,547,440,2944,1376,299,500,2645,876
2148978,51,9,1962,1,"male",261,74,52,0,0,0,0,0,0
2148981,39,1,1974,9,"male",418,96,69,242,1,242,0,0,1
2148989,15,24,1998,1,"female",68,224,149,1,3,1,2,0,1
2149012,20,12,1993,10,"male",327,265,220,47,72,47,63,0,9
2149030,19,11,1994,3,"male",425,232,60,157,72,126,28,31,44
2149038,56,5,1957,2,"male",259,90,47,5,31,5,11,0,20
2149070,25,30,1988,6,"male",1154,0,0,0,0,0,0,0,0
2149104,26,4,1987,3,"male",624,88,57,0,0,0,0,0,0
2149129,40,12,1973,3,"male",208,128,67,5,10,0,1,5,9
2149167,47,18,1966,5,"male",203,51,37,135,25,122,6,13,19
2149190,21,23,1992,6,"male",73,45,41,31,0,28,0,3,0
2149221,31,5,1982,9,"female",477,43,27,7,43,6,26,1,17
2149225,34,6,1979,6,"male",297,43,32,3,3,3,3,0,0
2149230,27,9,1986,12,"female",693,537,359,454,402,454,207,0,195
2149247,53,11,1960,11,"male",102,29,26,0,0,0,0,0,0
2149264,37,20,1976,4,"male",273,311,177,155,275,152,236,3,39
2149288,26,5,1987,9,"female",120,312,83,559,402,559,301,0,101
2149317,24,15,1989,7,"male",134,51,22,1,3,1,3,0,0
2149337,49,14,1964,2,"male",984,1,0,0,0,0,0,0,0
2149394,43,16,1970,4,"female",481,28,14,92,10,0,4,92,6
2149437,41,24,1972,11,"male",331,189,145,15,8,15,7,0,1
2149439,46,18,1967,8,"male",312,106,75,69,55,0,36,69,19
2149444,28,2,1985,4,"male",364,73,52,10,13,10,13,0,0
2149448,52,22,1961,3,"female",440,14,10,85,25,18,22,67,3
2149484,44,1,1969,9,"male",265,0,0,0,0,0,0,0,0
2149499,74,6,1939,5,"female",729,139,132,0,1,0,0,0,1
2149517,31,8,1982,2,"male",172,15,14,319,0,319,0,0,0
2149528,16,13,1997,2,"female",322,326,161,811,585,444,158,367,427
2149536,51,11,1962,9,"male",1922,31,9,0,0,0,0,0,0
2149538,18,21,1995,3,"male",414,180,172,0,0,0,0,0,0
2149540,24,19,1989,8,"female",117,14,8,269,61,38,12,231,49
2149594,28,8,1985,3,"male",45,11,11,33,2,31,1,2,1
2149625,70,31,1943,12,"male",155,5,4,6,4,4,3,2,1
2149627,29,21,1984,3,"male",543,133,78,0,5,0,4,0,1
2149639,53,5,1960,11,"female",398,3,3,2,0,2,0,0,0
2149676,33,1,1980,1,"female",199,28,7,0,2,0,1,0,1
2149711,19,25,1994,6,"male",528,248,191,0,0,0,0,0,0
2149752,36,4,1977,4,"male",341,99,59,5,1,0,1,5,0
2149769,26,1,1987,1,"female",461,174,102,3,2,3,2,0,0
2149784,54,5,1959,6,"female",496,20,9,0,0,0,0,0,0
2149801,15,22,1998,11,"female",351,362,161,1,37,1,15,0,22
2149833,17,30,1996,8,"male",274,17,10,0,0,0,0,0,0
2149844,104,14,1909,2,"male",1175,478,259,2,4,0,3,2,1
2149853,60,18,1953,10,"female",419,52,41,10,6,0,3,10,3
2149860,17,21,1996,3,"male",906,415,176,93,106,93,68,0,38
2149866,108,11,1905,8,"male",284,65,30,100,48,99,33,1,15
2149911,23,1,1990,12,"male",371,122,76,1,0,1,0,0,0
2149945,56,26,1957,11,"female",527,81,52,37,37,37,28,0,9
2149947,47,18,1966,3,"female",197,69,35,12,20,12,15,0,5
2149968,21,20,1992,5,"male",407,43,29,263,240,263,103,0,137
2149985,21,15,1992,2,"male",246,177,98,10,92,10,54,0,38
2149986,103,10,1910,12,"male",558,16,9,4,0,4,0,0,0
2150011,45,17,1968,6,"female",245,34,19,115,82,115,50,0,32
2150030,21,8,1992,5,"male",449,123,90,0,1,0,1,0,0
2150070,38,26,1975,3,"male",61,2,2,1,0,1,0,0,0
2150081,23,4,1990,12,"male",277,391,308,222,429,222,357,0,72
2150088,36,4,1977,6,"male",458,38,33,1,19,1,15,0,4
2150112,21,19,1992,3,"male",172,33,26,8,4,8,0,0,4
2150131,22,1,1991,1,"male",324,83,80,0,0,0,0,0,0
2150140,28,30,1985,9,"male",839,107,28,1,0,1,0,0,0
2150148,28,23,1985,6,"male",708,28,15,9,20,0,11,9,9
2150200,103,10,1910,12,"female",401,161,94,41,7,41,6,0,1
2150204,20,6,1993,1,"female",684,2,0,71,0,71,0,0,0
2150208,20,11,1993,12,"female",508,135,20,202,250,202,179,0,71
2150235,20,3,1993,4,"male",415,336,220,4,4,4,0,0,4
2150238,20,24,1993,12,"male",458,58,41,1,3,0,1,1,2
2150259,23,17,1990,11,"male",342,7,4,1,0,0,0,1,0
2150267,33,18,1980,5,"female",869,128,37,32,6,30,4,2,2
2150286,20,29,1993,1,"male",416,105,83,60,1,5,1,55,0
2150301,23,12,1990,1,"male",259,146,87,19,7,19,5,0,2
2150310,56,11,1957,7,"female",568,37,25,3,2,0,2,3,0
2150311,24,1,1989,1,"male",24,4,4,11,1,11,1,0,0
2150337,14,26,1999,5,"male",74,24,23,1,0,1,0,0,0
2150392,18,15,1995,5,"male",56,32,30,75,1,75,1,0,0
2150407,16,26,1997,8,"male",309,36,34,44,29,44,19,0,10
2150434,36,14,1977,4,"female",285,445,381,1028,589,761,488,267,101
2150451,32,25,1981,12,"male",405,171,146,3,7,0,5,3,2
2150508,22,3,1991,5,"male",381,211,135,107,84,107,70,0,14
2150510,24,3,1989,12,"male",188,82,43,15,13,15,11,0,2
2150518,71,14,1942,11,"male",1871,128,51,0,4,0,3,0,1
2150530,24,6,1989,9,"male",710,218,143,19,29,10,22,9,7
2150534,18,18,1995,12,"male",1685,123,49,5,0,5,0,0,0
2150543,99,12,1914,2,"female",422,65,34,95,34,95,32,0,2
2150547,71,10,1942,3,"male",1513,598,334,134,261,124,149,10,112
2150556,80,29,1933,10,"female",1053,315,147,705,193,629,116,76,77
2150569,20,27,1993,2,"female",480,45,33,75,5,75,4,0,1
2150594,62,17,1951,7,"female",200,28,16,49,4,49,4,0,0
2150612,49,4,1964,2,"male",546,10,7,0,0,0,0,0,0
2150669,17,1,1996,8,"female",293,881,574,204,394,97,243,107,151
2150695,26,12,1987,2,"male",232,1,0,0,0,0,0,0,0
2150733,20,27,1993,4,"female",244,41,27,0,3,0,2,0,1
2150745,21,1,1992,2,"male",194,41,26,0,2,0,2,0,0
2150768,43,5,1970,11,"male",356,0,0,0,0,0,0,0,0
2150777,108,7,1905,8,"female",95,41,20,0,1,0,1,0,0
2150789,44,23,1969,3,"female",634,75,29,267,219,61,149,206,70
2150800,87,8,1926,6,"female",1733,83,23,16,31,5,13,11,18
2150801,108,16,1905,2,"female",285,817,495,1265,989,1163,643,102,346
2150812,38,16,1975,11,"male",107,6,5,10,0,6,0,4,0
2150826,58,19,1955,10,"male",164,2,1,0,0,0,0,0,0
2150829,43,26,1970,2,"female",250,103,47,5,10,5,4,0,6
2150831,18,28,1995,4,"female",613,442,388,0,0,0,0,0,0
2150837,23,1,1990,1,"male",458,8,2,0,0,0,0,0,0
2150879,108,15,1905,2,"male",763,88,66,109,9,109,7,0,2
2150882,22,25,1991,5,"female",197,37,23,2,42,2,36,0,6
2150887,18,16,1995,7,"female",94,37,27,5,38,5,11,0,27
2150953,15,20,1998,7,"male",73,0,0,0,0,0,0,0,0
2150954,34,24,1979,2,"male",424,277,137,266,250,266,214,0,36
2150967,29,1,1984,7,"male",413,60,37,2,0,2,0,0,0
2150978,23,1,1990,1,"female",99,3,3,0,0,0,0,0,0
2150979,16,8,1997,10,"male",325,19,10,9,3,9,3,0,0
2150986,108,28,1905,3,"female",1970,169,98,114,68,0,30,114,38
2151007,57,30,1956,10,"male",1459,23,5,102,77,102,45,0,32
2151024,23,9,1990,2,"female",29,1,0,0,0,0,0,0,0
2151037,30,17,1983,11,"male",395,86,76,7,0,3,0,4,0
2151049,50,16,1963,1,"male",301,2,2,0,0,0,0,0,0
2151054,25,1,1988,1,"male",18,1,1,0,0,0,0,0,0
2151091,19,26,1994,7,"female",993,277,114,5393,2792,2523,1067,2870,1725
2151095,18,7,1995,7,"male",347,348,291,4,0,4,0,0,0
2151102,19,30,1994,5,"female",146,139,69,103,57,103,55,0,2
2151122,104,9,1909,5,"female",1634,295,228,72,108,0,15,72,93
2151137,61,22,1952,10,"male",567,40,13,0,0,0,0,0,0
2151167,21,26,1992,2,"male",556,110,80,0,0,0,0,0,0
2151168,58,10,1955,10,"female",339,47,31,89,199,89,132,0,67
2151178,65,22,1948,11,"female",580,227,135,222,127,0,38,222,89
2151201,18,23,1995,5,"female",608,138,60,0,1,0,1,0,0
2151213,59,2,1954,9,"male",176,46,37,22,1,22,1,0,0
2151229,20,6,1993,11,"female",1434,1273,456,331,126,301,81,30,45
2151231,23,21,1990,7,"male",138,289,259,1,1,1,0,0,1
2151233,38,24,1975,3,"male",201,51,31,2,15,2,9,0,6
2151244,108,3,1905,11,"male",81,190,170,1,2,0,1,1,1
2151269,27,2,1986,2,"male",304,71,49,20,27,20,21,0,6
2151270,69,14,1944,8,"male",912,16,10,2,3,0,2,2,1
2151278,25,20,1988,1,"male",438,226,179,58,37,50,27,8,10
2151281,106,18,1907,2,"female",1868,604,308,858,812,837,506,21,306
2151292,108,4,1905,1,"male",1486,393,208,26,20,18,8,8,12
2151302,20,21,1993,7,"female",578,134,37,128,27,128,22,0,5
2151324,58,18,1955,1,"female",398,417,350,988,206,20,109,968,97
2151336,24,17,1989,1,"male",549,256,107,0,0,0,0,0,0
2151343,14,18,1999,7,"female",985,491,86,513,323,438,113,75,210
2151353,60,1,1953,4,"male",17,22,15,2,4,0,2,2,2
2151362,29,4,1984,8,"female",468,694,284,57,161,57,140,0,21
2151370,61,30,1952,11,"male",1046,125,86,0,0,0,0,0,0
2151390,24,17,1989,12,"male",548,176,97,6,2,6,1,0,1
2151401,63,16,1950,12,"male",320,90,69,642,300,0,17,642,283
2151414,19,2,1994,4,"female",274,128,58,0,0,0,0,0,0
2151421,25,19,1988,11,"female",338,320,62,27,85,27,85,0,0
2151424,56,4,1957,2,"male",1542,9,5,1,0,0,0,1,0
2151461,52,16,1961,7,"female",280,35,24,2644,432,2644,326,0,106
2151494,47,4,1966,10,"male",483,40,27,18,7,18,6,0,1
2151496,32,3,1981,9,"male",250,162,134,0,18,0,18,0,0
2151521,31,24,1982,7,"male",514,47,12,7,20,1,6,6,14
2151557,45,14,1968,12,"female",1166,4,2,0,0,0,0,0,0
2151569,18,19,1995,7,"male",202,49,41,19,18,19,4,0,14
2151575,68,17,1945,8,"male",37,123,101,1732,334,1732,324,0,10
2151592,18,1,1995,9,"female",660,478,265,869,741,867,557,2,184
2151612,25,5,1988,8,"female",679,77,30,142,47,135,15,7,32
2151623,108,29,1905,4,"female",1266,406,88,8,1,8,1,0,0
2151638,16,29,1997,1,"female",984,16,3,3,0,3,0,0,0
2151661,81,31,1932,7,"female",1515,161,78,27,180,0,134,27,46
2151667,19,13,1994,11,"female",227,260,61,22,101,22,66,0,35
2151720,28,15,1985,9,"female",356,10,8,1,1,0,0,1,1
2151746,45,12,1968,3,"male",201,1,1,0,0,0,0,0,0
2151814,67,10,1946,2,"male",1461,16,4,0,0,0,0,0,0
2151867,23,12,1990,11,"female",84,29,17,0,0,0,0,0,0
2151879,19,18,1994,6,"male",547,87,64,66,63,49,22,17,41
2151903,59,13,1954,8,"female",750,1,1,0,0,0,0,0,0
2151963,60,24,1953,5,"female",383,30,20,25,8,0,6,25,2
2151968,18,17,1995,4,"male",202,38,27,1,0,1,0,0,0
2151973,27,6,1986,12,"male",49,63,14,34,6,34,5,0,1
2151988,23,1,1990,4,"male",101,13,11,17,12,17,6,0,6
2152009,24,21,1989,2,"female",594,182,93,695,1183,533,690,162,493
2152021,47,5,1966,10,"female",486,236,79,218,88,2,23,216,65
2152052,53,30,1960,6,"male",874,136,97,1,5,1,5,0,0
2152069,92,13,1921,2,"female",1524,69,33,3,6,0,0,3,6
2152114,73,26,1940,6,"male",147,410,270,304,478,191,211,113,267
2152136,71,5,1942,12,"male",1066,92,67,0,0,0,0,0,0
2152149,53,21,1960,6,"female",879,163,74,988,302,956,152,32,150
2152160,65,24,1948,8,"male",1546,152,67,155,88,111,45,44,43
2152198,26,3,1987,12,"male",252,53,51,1,0,1,0,0,0
2152208,13,5,2000,6,"male",11,0,0,1,0,1,0,0,0
2152209,57,31,1956,5,"male",301,24,16,14,0,8,0,6,0
2152231,23,15,1990,1,"male",997,72,36,0,2,0,2,0,0
2152247,65,29,1948,4,"male",51,40,35,0,0,0,0,0,0
2152251,108,21,1905,9,"male",726,152,62,3,4,0,4,3,0
2152259,103,1,1910,10,"male",963,869,729,290,81,290,69,0,12
2152267,27,12,1986,7,"male",593,493,423,11,1,11,1,0,0
2152286,25,30,1988,1,"male",497,9,4,0,0,0,0,0,0
2152290,51,20,1962,10,"female",221,105,89,0,0,0,0,0,0
2152302,19,5,1994,8,"male",587,352,220,12,29,11,3,1,26
2152357,113,14,1900,11,"female",1643,745,280,0,11,0,4,0,7
2152391,28,5,1985,3,"male",285,8,0,0,0,0,0,0,0
2152401,44,24,1969,1,"male",263,110,103,42,0,42,0,0,0
2152429,53,22,1960,8,"male",1016,399,274,48,39,48,36,0,3
2152434,52,28,1961,1,"male",430,19,8,13,15,0,4,13,11
2152437,85,5,1928,3,"male",1580,32,6,0,0,0,0,0,0
2152481,22,7,1991,1,"male",304,64,44,0,1,0,0,0,1
2152521,20,5,1993,10,"male",179,82,59,3,4,3,3,0,1
2152525,18,5,1995,9,"male",165,37,34,1,0,1,0,0,0
2152531,42,10,1971,12,"female",486,69,51,38,44,38,43,0,1
2152542,16,6,1997,4,"female",281,258,76,6,110,6,101,0,9
2152554,29,25,1984,12,"male",804,28,16,155,48,155,38,0,10
2152570,15,4,1998,9,"male",31,19,16,1,0,1,0,0,0
2152574,83,30,1930,4,"female",1559,746,210,361,450,0,155,361,295
2152577,39,14,1974,4,"female",541,19,10,0,1,0,0,0,1
2152589,33,13,1980,5,"female",406,295,239,28,44,28,16,0,28
2152603,18,3,1995,12,"female",508,651,93,75,284,75,277,0,7
2152623,21,27,1992,7,"male",688,302,185,188,310,53,77,135,233
2152624,19,1,1994,5,"male",73,16,14,1,0,1,0,0,0
2152640,26,5,1987,2,"female",339,133,56,212,61,212,41,0,20
2152646,14,26,1999,2,"male",668,404,248,1406,1067,215,556,1191,511
2152684,55,7,1958,6,"male",1461,131,38,9,69,1,40,8,29
2152733,59,24,1954,5,"male",740,194,66,70,34,0,23,70,11
2152739,31,13,1982,9,"male",559,154,128,249,163,151,152,98,11
2152748,28,30,1985,6,"female",68,41,31,43,10,39,9,4,1
2152770,23,2,1990,10,"female",231,379,193,1947,1363,1324,348,623,1015
2152773,24,11,1989,3,"male",255,8,1,0,7,0,7,0,0
2152783,20,3,1993,3,"male",108,5,3,2,0,2,0,0,0
2152788,55,4,1958,3,"female",2128,197,123,47,21,28,18,19,3
2152810,60,10,1953,9,"male",406,39,27,25,12,25,8,0,4
2152816,63,24,1950,8,"female",1669,16,12,0,0,0,0,0,0
2152820,23,14,1990,2,"male",343,114,41,8,2,6,1,2,1
2152844,23,15,1990,8,"male",197,51,45,26,3,0,0,26,3
2152858,23,12,1990,8,"female",648,474,257,4,3,1,0,3,3
2152861,42,15,1971,7,"male",277,1,0,0,0,0,0,0,0
2152873,22,2,1991,6,"female",209,10,5,488,318,488,210,0,108
2152877,23,12,1990,9,"male",676,18,9,0,3,0,3,0,0
2152907,19,12,1994,11,"female",431,7,5,4,0,3,0,1,0
2152919,28,12,1985,12,"male",511,111,22,3,24,3,12,0,12
2152926,108,1,1905,1,"male",959,66,41,18,1,14,1,4,0
2152929,15,9,1998,11,"female",94,204,185,0,2,0,1,0,1
2152960,27,10,1986,5,"male",1009,115,90,0,0,0,0,0,0
2153034,19,23,1994,3,"female",326,445,100,165,24,165,13,0,11
2153058,32,2,1981,3,"male",39,14,8,2,6,2,6,0,0
2153096,58,13,1955,9,"female",862,42,22,27,30,12,20,15,10
2153119,40,18,1973,6,"female",146,1,1,5,1,0,1,5,0
2153131,78,17,1935,6,"female",2083,456,243,1093,804,916,214,177,590
2153132,57,19,1956,9,"female",88,57,40,108,168,108,125,0,43
2153140,33,13,1980,2,"male",385,0,0,0,0,0,0,0,0
2153147,17,10,1996,7,"male",616,748,528,4,11,4,7,0,4
2153150,16,1,1997,1,"male",29,0,0,0,0,0,0,0,0
2153154,23,2,1990,9,"male",221,96,64,10,53,10,42,0,11
2153183,41,6,1972,3,"male",302,52,36,17,0,14,0,3,0
2153185,29,2,1984,2,"male",487,8,6,10,4,0,0,10,4
2153189,21,11,1992,10,"female",525,204,57,300,204,294,82,6,122
2153198,27,15,1986,2,"male",27,5,3,0,0,0,0,0,0
2153221,55,27,1958,6,"male",448,57,39,7,22,0,12,7,10
2153222,13,16,2000,1,"female",154,22,16,4,9,4,3,0,6
2153256,24,29,1989,12,"female",320,361,128,14,65,14,58,0,7
2153259,45,8,1968,8,"male",280,49,35,7,17,1,14,6,3
2153261,26,14,1987,9,"female",485,250,99,1,9,1,6,0,3
2153305,25,2,1988,11,"male",294,5,4,0,0,0,0,0,0
2153307,35,17,1978,9,"female",577,46,13,0,3,0,2,0,1
2153309,19,24,1994,11,"female",495,386,310,263,185,263,122,0,63
2153322,69,13,1944,8,"female",667,52,26,0,1,0,1,0,0
2153358,55,24,1958,9,"male",561,23,19,26,24,26,23,0,1
2153385,15,15,1998,12,"female",79,2,2,0,0,0,0,0,0
2153391,20,15,1993,3,"female",601,874,112,947,917,889,374,58,543
2153406,25,12,1988,8,"male",865,1,1,0,0,0,0,0,0
2153430,30,29,1983,7,"female",522,117,72,20,8,0,5,20,3
2153431,14,30,1999,5,"female",512,470,87,9,20,9,18,0,2
2153441,59,2,1954,9,"female",501,43,13,0,0,0,0,0,0
2153507,24,9,1989,7,"female",665,158,74,34,66,34,47,0,19
2153513,23,18,1990,1,"male",609,157,136,0,8,0,8,0,0
2153525,26,5,1987,11,"female",429,147,105,12,16,5,14,7,2
2153529,16,17,1997,12,"male",285,314,152,3,3,3,2,0,1
2153561,108,30,1905,9,"male",906,305,134,95,18,95,17,0,1
2153588,59,29,1954,12,"female",1490,35,11,0,1,0,1,0,0
2153599,47,24,1966,2,"male",422,280,268,8,31,3,26,5,5
2153608,26,1,1987,1,"male",923,19,10,24,6,16,2,8,4
2153632,20,3,1993,4,"male",1175,145,51,12,10,0,4,12,6
2153640,23,19,1990,12,"male",403,83,63,0,0,0,0,0,0
2153711,74,28,1939,2,"female",922,26,13,0,0,0,0,0,0
2153716,46,1,1967,4,"female",472,282,174,45,34,1,4,44,30
2153728,58,1,1955,12,"male",196,225,166,164,47,164,30,0,17
2153736,61,30,1952,6,"female",1122,138,88,104,91,33,41,71,50
2153737,68,23,1945,3,"male",1552,123,65,29,38,29,29,0,9
2153772,32,5,1981,3,"female",560,142,66,95,91,95,87,0,4
2153789,24,6,1989,10,"female",194,90,73,46,33,46,27,0,6
2153790,31,14,1982,7,"male",144,27,27,4,0,4,0,0,0
2153812,95,11,1918,12,"male",1780,159,88,53,24,53,14,0,10
2153816,21,25,1992,1,"male",209,83,54,11,34,0,5,11,29
2153840,18,5,1995,3,"male",360,2,2,0,0,0,0,0,0
2153912,66,29,1947,4,"female",499,119,67,1,4,0,0,1,4
2153927,64,25,1949,2,"male",551,4,3,48,31,48,14,0,17
2153938,66,7,1947,1,"female",499,79,70,2,4,0,2,2,2
2153940,33,21,1980,9,"male",424,570,491,120,422,69,266,51,156
2153941,30,3,1983,3,"male",9,53,45,3,11,3,6,0,5
2153948,31,21,1982,7,"male",730,37,2,0,3,0,1,0,2
2153952,74,20,1939,12,"female",746,14,7,82,48,0,17,82,31
2153970,17,2,1996,2,"female",399,95,76,48,50,15,24,33,26
2153985,27,6,1986,1,"male",489,24,15,0,61,0,15,0,46
2153987,16,17,1997,8,"female",200,126,81,208,159,89,70,119,89
2154014,21,6,1992,9,"female",177,312,215,15,49,15,23,0,26
2154029,46,8,1967,8,"male",350,277,52,421,21,421,18,0,3
2154033,59,10,1954,9,"male",423,5,4,6,1,2,0,4,1
2154051,71,17,1942,2,"female",1736,99,30,60,35,60,14,0,21
2154057,103,26,1910,12,"male",869,495,370,454,479,10,147,444,332
2154067,19,22,1994,4,"female",210,140,116,540,167,488,100,52,67
2154070,31,27,1982,8,"male",185,116,107,0,1,0,0,0,1
2154075,22,25,1991,4,"female",189,195,194,1,0,1,0,0,0
2154076,31,25,1982,1,"male",637,72,38,0,0,0,0,0,0
2154103,21,10,1992,12,"female",410,3,3,35,9,35,9,0,0
2154106,14,6,1999,2,"male",388,875,720,2,38,2,30,0,8
2154139,19,11,1994,7,"male",119,75,37,22,0,22,0,0,0
2154140,17,6,1996,9,"male",424,755,461,316,246,35,149,281,97
2154143,21,12,1992,5,"male",626,20,19,0,0,0,0,0,0
2154150,23,10,1990,10,"male",78,24,24,0,1,0,1,0,0
2154169,59,22,1954,7,"male",258,23,21,1,0,0,0,1,0
2154177,14,1,1999,1,"male",109,80,76,0,3,0,3,0,0
2154184,18,30,1995,1,"male",316,3,1,1,0,1,0,0,0
2154198,29,20,1984,4,"male",34,21,12,5,16,5,16,0,0
2154206,19,22,1994,10,"male",424,72,50,11,12,1,2,10,10
2154212,28,4,1985,12,"male",151,37,12,1,9,1,9,0,0
2154214,23,13,1990,12,"male",835,296,158,1,4,1,4,0,0
2154215,22,17,1991,5,"female",447,495,129,3572,329,3572,286,0,43
2154244,67,11,1946,10,"female",1976,20,11,68,40,65,30,3,10
2154304,23,16,1990,12,"female",584,200,22,1,7,1,4,0,3
2154305,17,14,1996,7,"male",531,217,137,18,5,0,3,18,2
2154329,59,27,1954,5,"male",688,51,10,5,1,5,1,0,0
2154332,28,10,1985,5,"female",559,19,8,23,2,13,1,10,1
2154351,26,27,1987,10,"male",173,170,104,199,95,199,52,0,43
2154376,40,3,1973,5,"male",163,121,28,932,415,837,140,95,275
2154394,33,23,1980,5,"female",529,37,21,0,0,0,0,0,0
2154423,46,17,1967,7,"female",257,12,2,68,10,47,10,21,0
2154457,46,15,1967,9,"male",895,7,5,0,0,0,0,0,0
2154465,18,6,1995,5,"female",362,877,316,0,0,0,0,0,0
2154485,25,6,1988,4,"female",793,289,209,458,125,320,56,138,69
2154488,52,16,1961,10,"male",421,51,47,17,4,17,3,0,1
2154556,68,9,1945,11,"female",842,86,28,3,9,3,9,0,0
2154571,30,3,1983,9,"female",936,312,222,84,48,22,12,62,36
2154572,23,4,1990,8,"male",433,197,181,37,40,36,38,1,2
2154612,47,9,1966,4,"female",1843,169,86,510,332,57,154,453,178
2154622,20,25,1993,7,"male",200,23,20,0,0,0,0,0,0
2154645,21,21,1992,5,"male",488,290,139,18,13,18,11,0,2
2154708,98,2,1915,1,"male",654,10,7,45,1,32,1,13,0
2154725,18,23,1995,3,"female",287,1190,155,243,204,4,158,239,46
2154738,17,8,1996,11,"female",357,425,246,242,61,242,59,0,2
2154741,35,21,1978,10,"female",805,303,238,281,355,281,316,0,39
2154770,18,27,1995,9,"female",1029,387,227,933,1028,446,591,487,437
2154787,108,13,1905,4,"male",1003,32,24,8,6,8,6,0,0
2154815,44,4,1969,7,"male",603,131,21,9,0,0,0,9,0
2154826,93,7,1920,6,"female",1546,370,148,185,30,148,17,37,13
2154833,18,12,1995,10,"male",281,300,72,59,86,41,72,18,14
2154869,18,4,1995,11,"female",15,0,0,0,0,0,0,0,0
2154870,17,22,1996,2,"male",437,81,67,0,18,0,16,0,2
2154889,26,1,1987,1,"male",572,90,90,2,0,2,0,0,0
2154894,35,29,1978,8,"male",1519,179,19,8,4,8,3,0,1
2154903,19,14,1994,2,"male",528,420,178,91,20,91,20,0,0
2154907,26,10,1987,2,"male",73,43,33,3,3,1,0,2,3
2154923,56,26,1957,11,"male",1322,225,41,19,20,10,8,9,12
2154936,17,13,1996,9,"male",476,180,110,13,6,13,6,0,0
2154941,63,9,1950,6,"male",936,88,62,2,3,0,3,2,0
2154958,21,2,1992,11,"female",495,398,296,342,402,342,306,0,96
2154962,66,28,1947,2,"male",1668,79,11,9,8,9,2,0,6
2154985,42,26,1971,9,"male",290,120,47,8,23,8,18,0,5
2154996,17,2,1996,5,"male",134,109,81,4,8,4,8,0,0
2155050,25,1,1988,1,"male",166,0,0,0,0,0,0,0,0
2155052,15,27,1998,6,"male",214,1822,444,551,222,246,70,305,152
2155055,58,20,1955,2,"male",1618,86,48,8,17,0,4,8,13
2155100,23,15,1990,7,"male",489,58,51,4,2,4,2,0,0
2155106,18,29,1995,1,"male",21,35,11,40,49,40,47,0,2
2155151,66,8,1947,2,"male",1025,78,54,2,0,0,0,2,0
2155152,49,25,1964,7,"male",27,12,12,1,0,1,0,0,0
2155169,54,24,1959,3,"female",453,0,0,0,0,0,0,0,0
2155179,21,25,1992,5,"male",316,593,501,0,0,0,0,0,0
2155183,40,25,1973,10,"female",61,35,21,66,26,66,17,0,9
2155190,38,15,1975,2,"male",70,19,14,25,97,25,80,0,17
2155216,59,16,1954,5,"male",437,54,11,1,2,1,1,0,1
2155232,21,22,1992,2,"male",101,47,11,1,0,1,0,0,0
2155235,52,3,1961,8,"male",1784,54,15,20,51,20,39,0,12
2155279,29,12,1984,5,"female",445,9,7,0,0,0,0,0,0
2155289,20,24,1993,7,"female",444,70,28,4,3,4,3,0,0
2155305,39,15,1974,9,"female",204,46,22,8,18,8,16,0,2
2155364,16,17,1997,9,"male",390,1099,701,719,1943,70,654,649,1289
2155400,59,24,1954,8,"male",547,77,57,40,21,23,14,17,7
2155435,47,23,1966,10,"female",18,23,13,84,24,84,10,0,14
2155460,26,4,1987,6,"male",54,29,21,6,4,6,3,0,1
2155477,19,26,1994,2,"male",940,137,56,185,15,183,8,2,7
2155520,19,11,1994,2,"female",617,19,6,34,0,16,0,18,0
2155539,29,28,1984,12,"female",450,126,79,0,1,0,1,0,0
2155540,15,11,1998,11,"female",173,59,55,0,9,0,4,0,5
2155541,19,6,1994,9,"male",354,451,380,0,0,0,0,0,0
2155558,38,12,1975,9,"female",276,57,51,269,597,268,563,1,34
2155572,59,19,1954,11,"female",994,87,40,123,19,2,6,121,13
2155590,37,14,1976,6,"female",183,16,5,168,12,79,5,89,7
2155614,16,28,1997,7,"female",900,1507,240,48,34,26,18,22,16
2155658,16,12,1997,6,"male",142,0,0,0,0,0,0,0,0
2155667,54,4,1959,1,"female",1645,49,27,120,18,16,5,104,13
2155684,43,4,1970,7,"male",60,18,17,13,10,7,3,6,7
2155693,21,10,1992,6,"male",132,157,72,0,4,0,4,0,0
2155697,16,16,1997,5,"male",470,66,49,9,0,9,0,0,0
2155698,31,10,1982,9,"male",345,7,2,0,0,0,0,0,0
2155738,21,1,1992,10,"male",668,2601,2074,9,55,9,40,0,15
2155740,61,1,1952,7,"male",206,61,38,2,83,0,27,2,56
2155750,41,4,1972,11,"male",300,66,58,5,31,1,8,4,23
2155768,34,8,1979,9,"female",582,46,27,83,135,83,134,0,1
2155774,21,5,1992,7,"male",132,19,15,25,23,25,23,0,0
2155779,108,13,1905,10,"male",1535,386,230,80,32,63,10,17,22
2155826,46,25,1967,9,"female",768,71,44,147,36,147,32,0,4
2155828,27,4,1986,8,"male",274,651,548,306,296,306,208,0,88
2155840,70,9,1943,7,"male",365,82,65,167,304,0,150,167,154
2155852,17,15,1996,8,"male",333,153,129,0,0,0,0,0,0
2155856,39,22,1974,4,"male",574,103,32,10,32,10,30,0,2
2155862,29,22,1984,7,"female",393,112,19,1,5,1,0,0,5
2155873,25,1,1988,1,"male",294,21,15,0,6,0,2,0,4
2155876,84,18,1929,3,"female",620,34,20,20,4,0,2,20,2
2155905,21,11,1992,9,"male",912,124,114,70,1487,22,1362,48,125
2155922,46,28,1967,2,"female",177,43,22,48,62,31,16,17,46
2155989,19,23,1994,10,"male",245,294,270,178,86,178,50,0,36
2156026,14,12,1999,10,"female",61,34,13,51,19,51,8,0,11
2156028,19,27,1994,2,"female",407,50,27,7,5,7,5,0,0
2156058,39,2,1974,10,"female",665,32,18,12,8,11,7,1,1
2156080,23,1,1990,1,"male",175,73,60,2,3,2,2,0,1
2156087,23,28,1990,3,"male",721,160,125,16,0,16,0,0,0
2156090,18,5,1995,12,"female",360,131,51,0,0,0,0,0,0
2156093,45,3,1968,5,"female",1382,226,73,21,4,21,2,0,2
2156105,40,15,1973,8,"female",616,2,0,0,0,0,0,0,0
2156131,20,23,1993,6,"male",176,28,22,8,26,1,13,7,13
2156133,23,7,1990,5,"male",453,29,12,1,0,0,0,1,0
2156135,54,14,1959,1,"male",737,159,95,242,111,0,9,242,102
2156138,20,9,1993,2,"male",13,30,21,1,0,1,0,0,0
2156160,16,14,1997,2,"male",637,128,112,0,0,0,0,0,0
2156161,30,8,1983,10,"female",473,27,12,145,98,140,76,5,22
2156175,33,28,1980,5,"male",295,65,37,2,12,2,11,0,1
2156187,16,20,1997,7,"male",261,149,88,70,36,47,25,23,11
2156188,45,22,1968,12,"male",505,0,0,0,0,0,0,0,0
2156215,14,21,1999,2,"female",166,281,203,768,428,768,237,0,191
2156225,34,25,1979,8,"male",121,24,22,34,1,31,0,3,1
2156229,62,23,1951,2,"male",514,13,13,6,0,6,0,0,0
2156240,22,27,1991,7,"female",198,10,9,104,44,62,30,42,14
2156247,16,17,1997,6,"female",179,543,62,22,437,20,335,2,102
2156296,17,14,1996,9,"female",431,99,70,0,7,0,6,0,1
2156305,22,21,1991,9,"male",584,127,81,4,9,4,9,0,0
2156352,26,15,1987,2,"male",480,115,36,35,70,19,41,16,29
2156386,43,1,1970,12,"male",143,25,23,1,1,1,1,0,0
2156396,29,11,1984,2,"female",723,226,199,789,436,789,416,0,20
2156399,23,1,1990,9,"male",383,15,10,1,0,1,0,0,0
2156424,23,4,1990,7,"male",411,674,626,1,0,1,0,0,0
2156427,25,10,1988,9,"male",1005,781,458,117,377,41,176,76,201
2156431,21,22,1992,9,"female",235,88,66,3,5,3,3,0,2
2156439,18,21,1995,1,"male",228,186,130,4,4,2,1,2,3
2156456,53,27,1960,7,"male",280,15,10,43,19,0,17,43,2
2156480,23,1,1990,6,"female",373,54,36,0,43,0,27,0,16
2156498,59,3,1954,6,"female",2025,155,95,93,12,86,4,7,8
2156515,29,16,1984,8,"male",960,107,36,0,2,0,2,0,0
2156518,19,30,1994,10,"male",545,734,580,4,15,4,12,0,3
2156521,108,24,1905,1,"female",360,50,20,27,6,27,6,0,0
2156548,23,18,1990,7,"male",463,74,37,0,2,0,2,0,0
2156557,25,13,1988,6,"male",256,25,6,2,0,0,0,2,0
2156565,40,28,1973,10,"male",1122,49,45,0,0,0,0,0,0
2156581,57,1,1956,7,"male",694,8,5,0,0,0,0,0,0
2156611,37,11,1976,2,"male",301,31,14,8,1,7,0,1,1
2156614,25,17,1988,1,"female",147,151,47,75,173,75,94,0,79
2156622,24,23,1989,2,"male",262,4,2,27,11,0,3,27,8
2156625,71,20,1942,5,"female",520,56,31,82,39,0,16,82,23
2156626,113,27,1900,7,"female",1755,281,181,536,186,0,12,536,174
2156636,21,1,1992,1,"female",1292,0,0,0,0,0,0,0,0
2156645,22,27,1991,10,"male",688,22,13,6,8,6,6,0,2
2156650,22,26,1991,6,"male",487,96,33,0,10,0,1,0,9
2156662,45,8,1968,12,"male",512,75,41,12,2,0,2,12,0
2156669,26,6,1987,4,"male",373,106,91,59,51,59,49,0,2
2156718,20,15,1993,6,"male",593,63,34,9,71,9,40,0,31
2156736,16,9,1997,1,"male",460,121,54,0,2,0,1,0,1
2156755,22,13,1991,8,"male",339,150,125,0,1,0,0,0,1
2156776,17,27,1996,8,"male",294,340,226,207,27,207,26,0,1
2156788,15,3,1998,2,"male",521,107,53,0,1,0,1,0,0
2156811,27,16,1986,6,"female",340,124,42,0,0,0,0,0,0
2156812,34,18,1979,11,"male",559,104,46,281,54,281,48,0,6
2156824,33,1,1980,1,"male",46,17,17,0,1,0,0,0,1
2156834,28,10,1985,11,"male",574,134,90,3,8,3,4,0,4
2156840,38,9,1975,6,"female",240,20,17,172,11,169,5,3,6
2156861,18,2,1995,10,"female",494,934,361,4757,5310,596,1468,4161,3842
2156867,31,27,1982,8,"male",1754,263,202,2881,1341,0,371,2881,970
2156869,22,16,1991,11,"male",390,71,58,0,2,0,2,0,0
2156896,21,21,1992,6,"male",582,417,332,27,83,4,76,23,7
2156910,19,3,1994,5,"female",450,697,253,373,625,98,392,275,233
2156933,47,1,1966,1,"female",261,7,7,0,0,0,0,0,0
2156941,38,2,1975,2,"female",335,9,8,0,4,0,4,0,0
2156943,32,17,1981,3,"male",1149,155,62,0,1,0,1,0,0
2156958,27,5,1986,8,"female",209,30,15,22,13,22,9,0,4
2156965,18,20,1995,6,"female",1368,1807,856,2407,2911,1112,2088,1295,823
2157029,19,30,1994,9,"female",51,61,43,37,27,37,15,0,12
2157042,18,15,1995,10,"male",499,34,20,0,0,0,0,0,0
2157050,23,15,1990,2,"male",1044,707,321,59,100,6,38,53,62
2157091,30,4,1983,10,"male",392,21,3,7,10,7,9,0,1
2157097,21,2,1992,2,"male",293,98,78,0,0,0,0,0,0
2157099,54,16,1959,7,"female",644,1,1,0,0,0,0,0,0
2157107,30,15,1983,5,"female",329,48,42,25,9,25,9,0,0
2157115,35,24,1978,3,"female",276,102,45,33,57,33,25,0,32
2157118,95,4,1918,2,"male",1136,252,140,21,6,21,4,0,2
2157124,23,1,1990,1,"female",137,212,94,673,415,673,396,0,19
2157183,47,3,1966,2,"female",1221,71,44,2,6,2,5,0,1
2157187,18,24,1995,5,"female",266,245,90,47,164,28,68,19,96
2157205,41,20,1972,2,"male",122,71,63,289,12,286,6,3,6
2157218,30,7,1983,12,"female",179,17,16,104,167,81,84,23,83
2157223,18,13,1995,10,"male",414,979,575,961,969,955,619,6,350
2157248,18,15,1995,5,"male",218,869,595,9,4,9,4,0,0
2157272,44,6,1969,10,"female",1678,172,52,600,180,589,138,11,42
2157282,42,10,1971,9,"female",1614,144,109,1,2,1,2,0,0
2157339,76,9,1937,6,"male",716,281,179,62,9,0,8,62,1
2157344,108,13,1905,7,"female",978,471,245,654,916,654,772,0,144
2157369,22,21,1991,5,"male",1499,1644,628,1,1,0,0,1,1
2157372,42,17,1971,8,"female",82,40,34,17,21,17,19,0,2
2157375,22,12,1991,12,"male",570,72,41,2,0,2,0,0,0
2157386,64,17,1949,4,"male",257,26,22,150,42,0,21,150,21
2157407,25,9,1988,4,"female",438,293,222,81,71,30,14,51,57
2157410,24,25,1989,11,"male",621,589,437,6,1,0,0,6,1
2157432,13,7,2000,3,"male",28,34,25,2,1,2,1,0,0
2157435,33,6,1980,9,"female",352,101,82,823,674,822,625,1,49
2157438,62,7,1951,8,"female",216,56,45,32,3,32,3,0,0
2157464,66,17,1947,12,"female",724,37,13,29,7,22,4,7,3
2157467,23,26,1990,8,"male",158,118,55,33,94,33,82,0,12
2157486,52,18,1961,6,"male",415,4,1,0,0,0,0,0,0
2157537,26,18,1987,1,"male",555,24,19,47,14,34,10,13,4
2157539,16,13,1997,12,"female",160,349,159,9,18,9,11,0,7
2157547,66,16,1947,3,"female",2012,1567,1237,12566,4846,3296,3024,9270,1822
2157557,62,14,1951,9,"male",1756,85,52,25,20,12,13,13,7
2157558,61,23,1952,8,"female",415,93,78,1,2,0,1,1,1
2157568,28,24,1985,9,"male",45,34,23,42,8,42,8,0,0
2157577,39,9,1974,4,"male",312,2,0,0,0,0,0,0,0
2157593,26,1,1987,1,"male",59,18,15,33,104,33,55,0,49
2157615,29,4,1984,3,"male",369,143,122,0,40,0,2,0,38
2157620,20,17,1993,11,"female",516,224,73,1,0,1,0,0,0
2157624,19,7,1994,7,"male",251,18,14,0,6,0,0,0,6
2157653,63,23,1950,1,"male",730,24,12,0,0,0,0,0,0
2157708,33,1,1980,1,"female",421,111,69,2,0,0,0,2,0
2157710,25,1,1988,9,"male",432,150,54,536,473,250,168,286,305
2157715,64,20,1949,11,"male",919,21,10,16,6,16,4,0,2
2157720,19,26,1994,10,"male",453,28,17,4,1,0,0,4,1
2157724,23,17,1990,2,"male",55,0,0,0,6,0,0,0,6
2157726,51,24,1962,9,"female",730,133,87,6,13,6,12,0,1
2157727,25,1,1988,1,"male",205,9,6,2,2,2,2,0,0
2157731,41,31,1972,10,"female",2040,49,26,17,0,17,0,0,0
2157744,61,9,1952,4,"male",1080,13,9,12,3,12,1,0,2
2157751,37,12,1976,11,"male",33,16,7,0,0,0,0,0,0
2157758,20,16,1993,10,"female",205,145,87,7,5,7,1,0,4
2157773,38,11,1975,4,"male",415,58,36,133,8,133,6,0,2
2157777,16,19,1997,4,"male",197,31,24,14,19,14,3,0,16
2157856,24,17,1989,1,"male",197,14,11,4,1,0,0,4,1
2157872,108,1,1905,1,"male",110,45,33,67,22,0,5,67,17
2157898,20,26,1993,9,"male",111,168,143,8,8,8,7,0,1
2157909,53,29,1960,10,"female",117,40,29,25,44,0,9,25,35
2157935,16,8,1997,7,"female",288,258,170,1370,1493,1217,893,153,600
2157945,17,17,1996,9,"male",151,87,58,17,17,17,8,0,9
2157965,25,19,1988,8,"male",297,97,31,10,1,0,0,10,1
2157988,14,27,1999,12,"male",11,46,18,10,4,10,3,0,1
2157989,93,23,1920,11,"male",611,142,79,199,51,199,33,0,18
2158003,18,8,1995,8,"male",323,72,58,0,1,0,0,0,1
2158020,35,7,1978,8,"female",418,74,48,290,50,290,34,0,16
2158031,43,20,1970,4,"female",232,20,14,75,19,8,8,67,11
2158061,22,21,1991,4,"female",561,397,209,21,21,21,15,0,6
2158092,60,3,1953,5,"female",197,8,7,4,1,4,1,0,0
2158099,53,5,1960,12,"female",227,48,36,385,22,385,15,0,7
2158123,47,23,1966,11,"female",719,179,68,531,269,388,118,143,151
2158128,67,10,1946,9,"female",1285,64,33,0,3,0,3,0,0
2158129,32,18,1981,7,"female",687,7,6,134,29,134,6,0,23
2158143,20,11,1993,8,"male",315,34,18,0,0,0,0,0,0
2158148,21,7,1992,8,"male",295,201,105,653,48,653,43,0,5
2158170,19,28,1994,12,"female",295,127,73,2,2,2,1,0,1
2158181,94,19,1919,5,"male",729,456,374,48,3,0,0,48,3
2158184,108,6,1905,2,"female",1431,68,33,150,49,150,40,0,9
2158191,21,18,1992,4,"female",376,194,74,3,52,0,18,3,34
2158204,53,22,1960,1,"male",235,42,32,2,25,2,12,0,13
2158239,18,22,1995,1,"male",444,100,60,61,123,61,115,0,8
2158241,27,7,1986,7,"female",592,78,47,7,1,7,1,0,0
2158249,21,31,1992,1,"male",448,63,15,7,2,7,0,0,2
2158262,19,29,1994,10,"male",680,130,61,127,52,117,23,10,29
2158269,18,7,1995,1,"male",79,112,55,0,2,0,2,0,0
2158273,30,10,1983,3,"male",263,2,2,0,0,0,0,0,0
2158296,64,17,1949,4,"female",612,23,7,2,1,0,1,2,0
2158316,99,13,1914,12,"male",789,81,60,0,0,0,0,0,0
2158325,35,26,1978,2,"male",239,9,4,5,0,5,0,0,0
2158328,23,9,1990,6,"female",1306,2,0,0,0,0,0,0,0
2158339,31,1,1982,1,"male",117,46,26,0,4,0,1,0,3
2158352,60,13,1953,8,"female",1745,455,199,472,528,472,279,0,249
2158360,22,9,1991,4,"female",614,749,444,969,750,967,505,2,245
2158367,16,9,1997,12,"male",1017,506,218,2,0,2,0,0,0
2158370,23,31,1990,3,"male",160,3,2,0,0,0,0,0,0
2158379,15,13,1998,3,"male",363,918,809,878,546,296,342,582,204
2158381,50,3,1963,10,"male",573,21,10,12,2,0,1,12,1
2158387,19,19,1994,10,"male",643,266,174,1,1,0,1,1,0
2158392,57,23,1956,9,"female",284,33,15,66,29,63,20,3,9
2158400,19,30,1994,1,"male",367,53,30,0,0,0,0,0,0
2158406,24,19,1989,11,"female",242,134,91,24,0,19,0,5,0
2158414,60,15,1953,8,"female",636,71,48,41,6,18,5,23,1
2158420,55,7,1958,6,"male",313,25,20,30,7,30,5,0,2
2158464,17,22,1996,5,"male",671,839,565,193,223,190,76,3,147
2158511,83,4,1930,9,"male",815,146,109,18,0,18,0,0,0
2158534,23,22,1990,10,"male",537,101,65,1,0,1,0,0,0
2158566,83,18,1930,2,"female",1636,72,15,34,50,0,19,34,31
2158581,57,1,1956,11,"female",100,46,38,94,11,94,7,0,4
2158610,15,12,1998,7,"female",285,43,28,69,12,69,12,0,0
2158631,39,23,1974,1,"female",172,39,24,95,36,34,12,61,24
2158651,16,27,1997,11,"female",519,154,101,17,33,9,22,8,11
2158653,27,22,1986,11,"male",422,200,139,41,70,41,59,0,11
2158659,18,15,1995,7,"male",1364,159,35,63,0,60,0,3,0
2158661,19,2,1994,3,"female",212,287,93,44,55,44,33,0,22
2158711,53,1,1960,2,"female",162,41,19,9,24,0,18,9,6
2158724,33,13,1980,1,"female",182,0,0,0,0,0,0,0,0
2158762,47,28,1966,7,"male",558,88,62,26,4,26,3,0,1
2158769,25,1,1988,1,"male",508,63,49,2,0,0,0,2,0
2158778,101,21,1912,11,"female",2255,214,158,111,4,24,3,87,1
2158781,18,16,1995,5,"female",526,563,210,217,132,210,89,7,43
2158792,28,29,1985,9,"female",1338,164,66,175,216,175,161,0,55
2158809,30,18,1983,6,"female",567,136,33,10,1,10,0,0,1
2158823,27,5,1986,12,"female",228,69,19,42,35,0,4,42,31
2158830,14,18,1999,12,"male",199,7,2,12,1,0,0,12,1
2158841,65,2,1948,8,"male",167,24,15,0,1,0,0,0,1
2158865,25,18,1988,1,"male",430,97,90,68,28,68,18,0,10
2158913,15,14,1998,4,"male",337,534,389,52,11,46,7,6,4
2158933,28,2,1985,7,"male",658,30,19,38,20,37,12,1,8
2158942,32,14,1981,12,"male",525,34,33,0,1,0,0,0,1
2158945,29,2,1984,2,"male",493,142,85,0,0,0,0,0,0
2158955,23,1,1990,1,"male",178,71,61,0,0,0,0,0,0
2158967,22,11,1991,9,"female",667,221,70,15,118,15,50,0,68
2158968,22,4,1991,2,"male",454,204,123,1,32,0,5,1,27
2158971,16,15,1997,12,"female",239,99,67,14,11,14,10,0,1
2158975,33,5,1980,5,"male",184,14,4,0,1,0,0,0,1
2158989,52,30,1961,9,"male",413,29,27,0,0,0,0,0,0
2158992,50,1,1963,7,"male",369,24,17,0,2,0,2,0,0
2159000,25,13,1988,8,"male",486,379,333,0,2,0,2,0,0
2159008,108,3,1905,11,"male",1913,701,524,1042,152,608,59,434,93
2159009,18,5,1995,9,"female",184,213,98,122,270,116,157,6,113
2159059,108,22,1905,11,"male",1034,900,361,468,261,467,226,1,35
2159073,21,8,1992,12,"female",1125,220,88,189,154,189,123,0,31
2159075,69,9,1944,2,"female",805,368,279,2511,2347,1036,924,1475,1423
2159125,38,12,1975,12,"female",908,311,205,53,92,53,56,0,36
2159144,50,9,1963,11,"male",684,73,19,91,86,1,29,90,57
2159146,40,20,1973,1,"female",697,1,1,46,71,34,44,12,27
2159161,18,2,1995,4,"male",212,21,16,0,2,0,1,0,1
2159162,28,30,1985,12,"male",2,0,0,2,2,0,0,2,2
2159175,25,3,1988,4,"male",229,21,21,2,0,2,0,0,0
2159176,33,6,1980,11,"male",576,153,146,1,5,1,5,0,0
2159223,40,8,1973,1,"male",476,97,65,1,1,1,1,0,0
2159241,30,19,1983,12,"male",285,35,30,1,0,1,0,0,0
2159246,16,5,1997,5,"male",10,1,0,0,2,0,2,0,0
2159248,21,3,1992,3,"male",258,34,22,1,1,1,0,0,1
2159251,25,17,1988,12,"male",347,110,53,51,30,51,19,0,11
2159281,57,18,1956,1,"female",647,41,27,35,122,1,78,34,44
2159287,51,4,1962,8,"male",271,38,28,6,1,6,1,0,0
2159317,45,10,1968,2,"female",717,126,72,253,168,6,67,247,101
2159347,35,10,1978,1,"male",73,46,42,8,0,8,0,0,0
2159349,94,17,1919,8,"male",137,778,726,224,160,224,136,0,24
2159351,17,8,1996,1,"male",817,670,452,9,86,9,64,0,22
2159352,59,8,1954,2,"male",1908,11,4,0,0,0,0,0,0
2159364,22,8,1991,2,"male",425,4,2,0,0,0,0,0,0
2159383,31,14,1982,2,"male",440,128,122,8,3,6,1,2,2
2159394,32,6,1981,12,"male",949,75,35,2,11,2,8,0,3
2159411,22,1,1991,6,"male",42,10,10,0,0,0,0,0,0
2159415,80,13,1933,12,"male",254,48,41,0,0,0,0,0,0
2159439,17,5,1996,12,"female",402,1010,139,630,155,429,93,201,62
2159442,23,20,1990,10,"male",218,84,68,1,8,0,5,1,3
2159451,18,1,1995,1,"male",414,43,23,31,1,13,1,18,0
2159482,20,11,1993,11,"female",539,349,105,2,108,2,77,0,31
2159497,48,5,1965,1,"female",119,18,12,234,145,234,131,0,14
2159510,21,11,1992,7,"male",522,147,72,0,2,0,2,0,0
2159521,56,18,1957,3,"female",1607,85,22,15,1,15,1,0,0
2159524,67,27,1946,6,"female",1479,97,51,23,37,23,17,0,20
2159551,15,6,1998,10,"male",267,406,175,49,45,39,21,10,24
2159556,103,5,1910,1,"male",900,471,319,206,385,134,266,72,119
2159610,27,21,1986,7,"male",360,151,124,1,0,0,0,1,0
2159629,15,7,1998,6,"male",413,52,49,0,67,0,20,0,47
2159644,32,5,1981,5,"female",38,5,4,11,1,11,1,0,0
2159648,30,29,1983,12,"female",210,3,2,14,0,0,0,14,0
2159661,45,30,1968,11,"female",136,54,37,0,0,0,0,0,0
2159708,98,30,1915,5,"female",1379,677,150,26,13,26,10,0,3
2159722,23,5,1990,4,"male",192,38,27,4,2,4,2,0,0
2159743,52,10,1961,6,"female",1454,56,32,133,196,133,140,0,56
2159756,25,20,1988,8,"female",260,7,4,18,6,18,4,0,2
2159781,14,1,1999,9,"female",673,248,185,22,2,22,1,0,1
2159790,32,1,1981,1,"male",670,68,41,0,1,0,0,0,1
2159801,20,6,1993,7,"female",195,21,11,0,0,0,0,0,0
2159809,50,10,1963,2,"male",498,0,0,0,0,0,0,0,0
2159815,14,29,1999,12,"female",247,1,1,26,0,26,0,0,0
2159834,103,13,1910,3,"female",440,188,93,12,434,12,336,0,98
2159843,18,8,1995,7,"female",210,1719,945,450,2170,273,1200,177,970
2159864,17,31,1996,10,"male",36,17,11,42,6,42,5,0,1
2159870,28,14,1985,2,"female",892,0,0,0,0,0,0,0,0
2159871,15,26,1998,11,"male",856,296,138,101,30,101,16,0,14
2159884,19,12,1994,7,"male",57,43,34,2,2,2,2,0,0
2159904,24,1,1989,1,"female",233,10,6,42,6,33,4,9,2
2159911,32,12,1981,9,"male",1340,120,100,1,0,0,0,1,0
2159934,19,25,1994,1,"male",17,20,19,2,2,2,1,0,1
2159954,24,19,1989,1,"male",259,111,61,0,21,0,11,0,10
2159961,63,10,1950,11,"female",1301,26,8,205,15,205,12,0,3
2159981,28,25,1985,11,"female",399,362,321,379,749,265,472,114,277
2160015,21,18,1992,2,"male",233,15,12,1,0,1,0,0,0
2160029,29,20,1984,11,"male",1152,25,9,2,6,2,1,0,5
2160030,60,19,1953,2,"male",668,137,106,2,4,0,3,2,1
2160035,16,30,1997,4,"male",180,77,61,16,5,13,5,3,0
2160065,28,25,1985,7,"male",1153,196,87,3,0,1,0,2,0
2160075,18,10,1995,2,"male",353,93,50,1,0,0,0,1,0
2160083,19,4,1994,9,"male",129,37,33,4,5,4,4,0,1
2160137,74,29,1939,9,"male",339,73,61,17,3,17,1,0,2
2160177,18,14,1995,3,"male",62,1,1,0,0,0,0,0,0
2160224,49,9,1964,1,"female",33,183,163,73,23,22,7,51,16
2160226,26,20,1987,6,"male",7,14,14,42,4,42,4,0,0
2160351,17,24,1996,3,"female",301,221,52,1,0,1,0,0,0
2160369,52,20,1961,4,"female",2175,158,56,385,270,345,152,40,118
2160372,22,14,1991,7,"male",632,72,38,1,0,1,0,0,0
2160374,26,1,1987,1,"female",872,252,148,304,673,197,278,107,395
2160439,108,5,1905,9,"male",598,325,256,4,12,4,12,0,0
2160489,17,1,1996,1,"male",232,318,138,19,36,19,28,0,8
2160499,90,8,1923,5,"male",2352,338,149,4,10,0,8,4,2
2160501,68,25,1945,11,"male",2366,100,50,19,36,14,21,5,15
2160507,21,28,1992,3,"male",99,81,17,7,2,3,0,4,2
2160511,53,25,1960,6,"female",731,64,34,332,76,0,10,332,66
2160531,22,17,1991,10,"female",449,1,1,0,0,0,0,0,0
2160550,19,9,1994,6,"female",444,3,3,25,31,0,4,25,27
2160571,103,9,1910,7,"female",315,110,50,1,4,1,1,0,3
2160577,57,19,1956,9,"female",574,54,21,9,6,0,2,9,4
2160607,19,2,1994,2,"male",442,440,364,2,17,2,13,0,4
2160608,36,23,1977,6,"female",601,224,134,1,13,1,7,0,6
2160619,25,20,1988,12,"male",237,44,15,1,0,1,0,0,0
2160643,24,8,1989,1,"male",137,34,24,1,5,0,2,1,3
2160668,78,16,1935,7,"female",121,71,57,33,19,16,13,17,6
2160683,27,26,1986,7,"female",536,74,51,11,0,11,0,0,0
2160691,16,5,1997,11,"male",546,171,147,42,9,41,9,1,0
2160702,30,13,1983,12,"male",371,2,1,0,0,0,0,0,0
2160716,17,13,1996,11,"female",246,149,28,0,1,0,0,0,1
2160732,24,2,1989,7,"female",559,436,252,40,94,24,46,16,48
2160734,27,1,1986,6,"male",352,4,3,7,0,7,0,0,0
2160760,64,28,1949,8,"female",31,41,24,10,15,10,13,0,2
2160762,14,20,1999,6,"male",362,87,80,1,0,1,0,0,0
2160783,62,14,1951,4,"female",274,16,8,0,1,0,1,0,0
2160845,71,12,1942,3,"male",1533,411,200,17,2,17,0,0,2
2160865,48,27,1965,2,"male",320,25,12,4,23,0,9,4,14
2160892,18,7,1995,10,"female",275,352,144,26,72,26,56,0,16
2160905,51,19,1962,11,"female",1533,159,101,337,115,257,66,80,49
2160937,30,14,1983,9,"male",0,0,0,0,0,0,0,0,0
2160948,64,10,1949,10,"female",985,51,31,0,1,0,0,0,1
2160957,21,5,1992,6,"female",197,44,28,0,0,0,0,0,0
2160960,36,27,1977,7,"male",298,0,0,0,0,0,0,0,0
2160961,54,18,1959,9,"female",1678,234,90,51,263,51,164,0,99
2160989,20,1,1993,1,"male",35,19,11,0,0,0,0,0,0
2160991,13,6,2000,5,"male",168,204,72,4,17,4,13,0,4
2161001,22,27,1991,6,"male",164,35,26,12,0,12,0,0,0
2161035,23,8,1990,10,"male",213,65,38,44,8,44,7,0,1
2161050,18,27,1995,11,"male",188,48,37,0,1,0,0,0,1
2161062,16,30,1997,1,"female",720,2357,472,69,159,4,118,65,41
2161113,49,13,1964,5,"male",471,19,9,2,0,2,0,0,0
2161126,62,5,1951,5,"male",418,2,2,0,0,0,0,0,0
2161131,36,2,1977,7,"female",120,16,14,8,1,0,0,8,1
2161240,20,14,1993,2,"male",823,694,593,14,65,14,55,0,10
2161265,19,14,1994,1,"male",17,33,3,6,6,6,4,0,2
2161269,37,5,1976,2,"female",452,188,118,900,0,900,0,0,0
2161300,26,29,1987,3,"male",374,52,20,35,70,28,22,7,48
2161324,33,3,1980,6,"female",1012,5,5,1,0,0,0,1,0
2161334,41,1,1972,1,"male",159,50,39,5,72,5,36,0,36
2161374,18,1,1995,1,"male",295,202,188,6,1,1,1,5,0
2161378,22,16,1991,9,"female",71,166,108,143,244,114,214,29,30
2161409,20,23,1993,8,"male",87,150,64,35,134,35,89,0,45
2161450,19,26,1994,10,"male",230,108,39,2,5,2,2,0,3
2161526,29,18,1984,12,"female",479,0,0,0,0,0,0,0,0
2161572,18,6,1995,9,"male",386,246,144,104,79,66,28,38,51
2161579,20,25,1993,3,"male",549,118,43,3,2,0,1,3,1
2161582,44,12,1969,2,"male",377,17,9,121,119,121,74,0,45
2161619,15,11,1998,5,"female",225,47,20,18,57,18,32,0,25
2161632,23,16,1990,6,"male",217,161,135,20,6,20,1,0,5
2161641,59,10,1954,3,"female",1376,56,35,156,16,0,10,156,6
2161669,19,10,1994,11,"male",245,305,247,124,3,124,3,0,0
2161673,23,1,1990,12,"female",220,26,19,312,385,305,144,7,241
2161729,29,10,1984,12,"male",355,28,17,13,27,13,25,0,2
2161734,63,15,1950,4,"female",280,32,29,0,0,0,0,0,0
2161755,18,31,1995,12,"male",714,46,42,2,1,0,0,2,1
2161769,28,17,1985,1,"female",429,109,38,106,153,106,125,0,28
2161770,106,7,1907,10,"female",404,1313,185,44,34,44,26,0,8
2161779,21,7,1992,11,"female",848,135,43,3,4,3,4,0,0
2161810,22,26,1991,5,"female",414,700,165,411,617,395,526,16,91
2161813,18,29,1995,1,"female",516,43,13,64,3,22,3,42,0
2161816,22,14,1991,6,"male",1056,161,36,12,19,12,18,0,1
2161847,23,6,1990,2,"male",586,132,77,43,0,43,0,0,0
2161890,30,13,1983,10,"female",289,71,29,2,32,1,22,1,10
2161910,26,16,1987,9,"male",42,3,3,0,0,0,0,0,0
2161929,34,31,1979,7,"female",215,46,34,377,94,377,70,0,24
2161939,29,1,1984,6,"male",240,56,43,0,0,0,0,0,0
2161959,14,6,1999,3,"male",6,38,34,1,3,0,1,1,2
2161978,77,20,1936,8,"female",1426,44,21,3,36,0,26,3,10
2162013,22,23,1991,7,"male",472,146,70,3,2,3,2,0,0
2162048,19,24,1994,9,"male",315,158,18,18,10,18,10,0,0
2162052,103,20,1910,11,"male",412,415,308,8,1,6,0,2,1
2162055,18,28,1995,4,"male",329,224,147,505,472,505,252,0,220
2162063,18,10,1995,8,"female",350,835,562,522,431,522,361,0,70
2162067,20,22,1993,6,"male",367,24,8,0,0,0,0,0,0
2162070,49,23,1964,6,"female",192,45,19,50,30,50,5,0,25
2162129,20,21,1993,1,"male",1465,42,27,5,0,5,0,0,0
2162135,20,19,1993,5,"male",209,194,141,4,5,0,1,4,4
2162149,24,20,1989,7,"male",86,169,149,131,75,129,64,2,11
2162165,23,22,1990,6,"female",421,51,43,0,0,0,0,0,0
2162168,23,15,1990,7,"male",611,126,73,0,0,0,0,0,0
2162219,49,20,1964,6,"female",2257,52,24,8,23,4,15,4,8
2162241,17,18,1996,3,"male",273,91,78,2,4,1,2,1,2
2162244,21,16,1992,5,"female",64,186,169,766,371,417,174,349,197
2162247,23,22,1990,1,"male",10,6,6,0,0,0,0,0,0
2162272,37,1,1976,7,"male",1244,0,0,4,0,0,0,4,0
2162285,18,17,1995,8,"male",280,262,223,1,1,1,0,0,1
2162325,35,23,1978,3,"male",411,144,89,468,115,468,89,0,26
2162339,41,21,1972,2,"female",775,95,66,131,18,131,8,0,10
2162348,30,29,1983,9,"female",622,150,120,7,4,7,3,0,1
2162376,14,21,1999,8,"female",461,1018,172,207,597,207,332,0,265
2162384,23,2,1990,1,"male",571,0,0,0,0,0,0,0,0
2162386,15,10,1998,4,"female",459,999,693,81,374,41,242,40,132
2162395,65,23,1948,1,"female",2124,119,61,31,5,31,3,0,2
2162398,22,24,1991,1,"male",557,371,330,10,13,9,13,1,0
2162406,58,6,1955,5,"female",880,79,59,776,185,745,118,31,67
2162452,34,26,1979,4,"female",261,304,175,25,38,25,18,0,20
2162471,22,3,1991,3,"male",99,10,6,0,0,0,0,0,0
2162479,34,1,1979,2,"male",618,174,101,250,141,250,93,0,48
2162481,29,23,1984,11,"female",122,10,0,1,2,1,1,0,1
2162482,35,17,1978,6,"male",1471,86,17,0,0,0,0,0,0
2162504,17,9,1996,8,"male",324,130,13,166,1,166,0,0,1
2162523,53,14,1960,7,"female",1760,124,52,184,181,162,117,22,64
2162538,22,1,1991,3,"female",334,19,13,1,1,1,1,0,0
2162540,37,28,1976,9,"female",466,51,21,73,87,73,78,0,9
2162583,40,28,1973,4,"male",549,66,44,0,0,0,0,0,0
2162603,56,9,1957,2,"female",1567,113,29,1243,135,1238,101,5,34
2162620,53,22,1960,2,"male",299,87,74,52,5,52,5,0,0
2162621,18,13,1995,2,"male",478,263,211,30,2,30,2,0,0
2162625,25,25,1988,3,"female",367,20,14,31,29,23,21,8,8
2162644,52,23,1961,6,"female",1559,178,88,359,233,355,132,4,101
2162676,32,2,1981,12,"male",199,43,40,2,0,2,0,0,0
2162723,53,6,1960,3,"female",313,20,15,57,16,50,5,7,11
2162741,33,17,1980,3,"male",431,451,347,215,540,215,415,0,125
2162744,24,13,1989,12,"female",312,233,174,461,474,43,52,418,422
2162755,111,1,1902,1,NA,2269,148,53,93,90,30,41,63,49
2162779,18,26,1995,10,"male",296,129,96,912,39,912,36,0,3
2162801,32,25,1981,5,"male",605,671,554,449,35,448,24,1,11
2162816,14,2,1999,1,"male",413,149,32,13,11,13,5,0,6
2162845,19,7,1994,5,"male",608,252,94,4,0,4,0,0,0
2162872,31,18,1982,2,"male",554,77,16,1,5,1,2,0,3
2162906,60,13,1953,6,"female",1295,27,24,2,7,2,5,0,2
2162949,60,18,1953,12,"male",14,16,14,3,2,0,2,3,0
2162956,20,30,1993,3,"male",57,20,13,38,19,38,13,0,6
2162975,108,2,1905,4,"female",1014,990,244,12,14,12,14,0,0
2162982,31,30,1982,6,"female",290,31,23,26,5,0,1,26,4
2162989,39,2,1974,9,"male",862,117,45,34,34,34,26,0,8
2162998,21,1,1992,1,"female",5,0,0,0,0,0,0,0,0
2163001,62,1,1951,9,"female",811,65,41,8,10,0,8,8,2
2163008,19,2,1994,3,"male",163,125,66,0,0,0,0,0,0
2163010,22,24,1991,2,"male",1169,505,375,0,0,0,0,0,0
2163036,27,16,1986,11,"male",344,5,5,15,14,0,10,15,4
2163037,29,5,1984,12,"male",294,28,28,0,3,0,2,0,1
2163051,36,3,1977,7,"male",37,41,25,160,97,53,14,107,83
2163069,39,4,1974,10,"female",243,41,14,444,26,248,17,196,9
2163071,37,26,1976,1,"male",112,1,1,3,6,1,2,2,4
2163080,41,25,1972,3,"male",545,42,41,29,2,0,0,29,2
2163081,23,10,1990,11,"male",668,170,86,6,0,6,0,0,0
2163114,32,7,1981,8,"male",318,47,29,9,0,9,0,0,0
2163142,19,7,1994,3,"female",196,19,13,73,46,3,3,70,43
2163146,57,27,1956,7,"female",1040,67,39,0,0,0,0,0,0
2163160,62,18,1951,9,"female",160,46,34,572,78,445,61,127,17
2163162,14,25,1999,8,"male",252,263,179,105,14,86,12,19,2
2163177,74,22,1939,7,"male",275,35,19,2,2,0,0,2,2
2163215,14,1,1999,9,"male",208,323,185,18,24,13,20,5,4
2163237,17,25,1996,1,"female",539,287,202,2,5,2,1,0,4
2163263,19,1,1994,12,"male",378,805,649,5,10,5,8,0,2
2163276,103,7,1910,2,"female",669,712,404,30,57,30,52,0,5
2163280,25,24,1988,6,"female",672,97,25,3,11,3,9,0,2
2163288,17,21,1996,2,"male",459,238,115,32,37,3,11,29,26
2163293,68,17,1945,8,"male",331,432,268,0,0,0,0,0,0
2163317,23,6,1990,12,"male",554,65,48,9,10,9,10,0,0
2163350,54,12,1959,8,"male",420,37,19,7,2,0,2,7,0
2163353,72,14,1941,8,"male",944,68,38,0,132,0,12,0,120
2163357,19,14,1994,8,"male",422,297,254,65,32,53,5,12,27
2163360,52,14,1961,11,"male",503,40,24,6,1,6,0,0,1
2163365,67,21,1946,4,"female",1803,25,7,10,0,0,0,10,0
2163381,58,11,1955,11,"male",1573,282,144,9,1,2,1,7,0
2163391,35,23,1978,7,"male",674,78,54,1,0,1,0,0,0
2163399,21,5,1992,1,"female",1570,1149,503,364,487,156,384,208,103
2163406,14,20,1999,10,"female",349,152,105,0,1,0,0,0,1
2163413,22,12,1991,7,"female",108,9,8,117,54,0,38,117,16
2163418,16,31,1997,7,"male",586,252,56,1,10,1,7,0,3
2163435,17,4,1996,5,"female",353,210,64,194,597,194,341,0,256
2163441,25,4,1988,1,"male",198,4,1,0,1,0,1,0,0
2163449,42,8,1971,10,"female",1154,305,183,430,1396,139,1087,291,309
2163454,69,10,1944,11,"female",1605,22,7,0,0,0,0,0,0
2163457,32,13,1981,11,"male",500,42,20,5,12,5,9,0,3
2163465,40,16,1973,1,"female",507,208,150,291,308,291,299,0,9
2163475,19,6,1994,5,"female",16,244,181,88,116,33,69,55,47
2163500,20,16,1993,11,"male",443,7,4,0,0,0,0,0,0
2163512,108,16,1905,9,"female",988,39,23,1,0,0,0,1,0
2163514,17,5,1996,5,"male",1006,654,403,229,1224,160,786,69,438
2163517,16,30,1997,11,"female",50,46,35,2,7,2,2,0,5
2163532,59,23,1954,10,"male",1248,58,28,0,0,0,0,0,0
2163547,20,1,1993,1,"female",530,16,6,57,65,0,1,57,64
2163548,41,17,1972,8,"female",279,31,13,37,5,11,1,26,4
2163557,19,21,1994,8,"male",482,52,40,29,9,29,8,0,1
2163558,36,1,1977,8,"female",17,0,0,0,0,0,0,0,0
2163564,23,28,1990,2,"female",723,3,0,15,4,4,3,11,1
2163565,19,10,1994,6,"male",4,14,14,2,1,2,1,0,0
2163566,23,3,1990,8,"female",433,8,7,469,0,469,0,0,0
2163569,55,13,1958,7,"female",184,67,48,269,150,269,97,0,53
2163583,26,12,1987,9,"male",592,816,742,55,10,50,9,5,1
2163586,34,24,1979,1,"male",495,54,35,0,0,0,0,0,0
2163614,66,5,1947,12,"female",188,3,3,0,0,0,0,0,0
2163678,53,20,1960,5,"male",573,270,51,3,167,0,92,3,75
2163680,21,3,1992,9,"female",402,157,46,36,22,36,14,0,8
2163682,23,18,1990,1,"male",835,828,455,9,51,3,17,6,34
2163707,36,5,1977,1,"male",179,21,20,0,0,0,0,0,0
2163721,62,10,1951,4,"female",1499,135,70,59,59,0,32,59,27
2163756,23,20,1990,11,"female",340,37,32,603,77,602,74,1,3
2163779,59,19,1954,8,"female",1610,40,24,15,27,15,22,0,5
2163781,46,3,1967,10,"female",186,30,25,511,24,272,2,239,22
2163787,32,23,1981,2,"male",230,49,39,50,4,50,3,0,1
2163813,16,19,1997,2,"female",183,270,202,524,355,523,226,1,129
2163827,23,19,1990,4,"male",1440,1142,846,2,3,2,2,0,1
2163850,17,8,1996,1,"male",13,39,38,2,6,0,3,2,3
2163855,59,16,1954,3,"female",361,45,36,114,0,0,0,114,0
2163862,15,17,1998,3,"male",129,148,128,126,8,6,2,120,6
2163872,68,23,1945,8,"female",1711,126,74,74,24,0,12,74,12
2163894,43,10,1970,11,"female",527,8,2,134,67,130,47,4,20
2163900,19,6,1994,4,"male",27,24,13,2,10,2,9,0,1
2163907,28,4,1985,11,"male",260,46,26,0,6,0,1,0,5
2163933,63,1,1950,1,"male",245,44,42,6,36,0,33,6,3
2163934,15,8,1998,11,"male",395,279,125,60,69,43,29,17,40
2163944,48,27,1965,9,"female",754,37,23,121,74,121,41,0,33
2163945,42,7,1971,11,"female",434,22,13,2,0,0,0,2,0
2163950,25,1,1988,1,"male",46,1,1,1,45,1,36,0,9
2163962,26,6,1987,10,"female",226,59,29,8,0,8,0,0,0
2164001,18,1,1995,1,"female",48,40,3,0,1,0,1,0,0
2164049,48,14,1965,8,"female",520,8,3,100,2,0,0,100,2
2164051,40,15,1973,10,"male",383,5,1,0,0,0,0,0,0
2164056,18,19,1995,10,"male",430,79,56,15,3,14,2,1,1
2164067,21,6,1992,6,"male",317,148,86,7,20,0,5,7,15
2164119,60,12,1953,1,"female",583,42,39,2,0,2,0,0,0
2164128,15,5,1998,5,"male",175,211,167,7,51,7,20,0,31
2164135,26,28,1987,10,"male",392,75,39,61,92,52,45,9,47
2164140,26,7,1987,7,"male",379,75,61,404,347,296,199,108,148
2164147,18,21,1995,7,"male",22,184,154,67,38,67,34,0,4
2164150,39,26,1974,9,"male",512,32,15,0,21,0,16,0,5
2164204,25,22,1988,4,"female",445,204,98,92,162,85,125,7,37
2164238,16,2,1997,11,"male",567,210,168,0,0,0,0,0,0
2164309,18,5,1995,10,"male",770,255,204,0,13,0,9,0,4
2164311,17,16,1996,12,"female",495,476,268,1,4,0,1,1,3
2164338,56,28,1957,8,NA,2244,621,266,257,210,156,150,101,60
2164375,63,10,1950,7,"female",1714,195,149,2,5,0,1,2,4
2164403,49,31,1964,12,"female",401,7,5,10,0,10,0,0,0
2164428,16,18,1997,1,"male",397,262,237,145,15,115,15,30,0
2164439,17,11,1996,8,"female",46,21,17,19,36,19,23,0,13
2164441,25,19,1988,8,"female",463,32,22,0,0,0,0,0,0
2164469,25,1,1988,1,"female",252,7,7,56,0,29,0,27,0
2164482,63,30,1950,11,"male",826,108,58,3,3,0,3,3,0
2164573,36,11,1977,2,"female",198,80,65,2,36,2,29,0,7
2164590,34,9,1979,8,"male",22,0,0,0,0,0,0,0,0
2164601,19,18,1994,10,"male",462,401,274,45,77,45,64,0,13
2164629,23,28,1990,12,"female",610,202,66,49,65,34,26,15,39
2164634,28,10,1985,9,"male",677,108,52,1,0,0,0,1,0
2164664,21,14,1992,7,"male",520,692,621,5,7,5,4,0,3
2164673,70,20,1943,4,"female",1424,60,34,38,23,38,23,0,0
2164700,113,25,1900,6,"male",1740,1709,1381,10,95,6,51,4,44
2164702,19,22,1994,2,"male",765,354,187,156,64,155,22,1,42
2164703,17,6,1996,1,"male",68,9,6,1,0,1,0,0,0
2164711,17,1,1996,1,"male",74,130,117,645,332,645,214,0,118
2164730,37,29,1976,6,"male",1193,53,17,40,5,40,4,0,1
2164733,23,2,1990,2,"male",735,167,121,5,0,5,0,0,0
2164790,18,14,1995,6,"male",923,1910,494,615,5645,18,4269,597,1376
2164793,45,1,1968,5,"male",37,8,6,6,3,6,3,0,0
2164814,43,1,1970,1,"male",46,18,16,13,8,9,5,4,3
2164816,32,2,1981,5,"male",610,71,61,1,0,1,0,0,0
2164843,25,10,1988,11,"male",26,9,4,64,61,50,51,14,10
2164847,65,4,1948,8,"male",648,50,23,22,28,0,20,22,8
2164850,34,8,1979,7,"male",448,77,66,0,2,0,2,0,0
2164863,19,18,1994,5,"male",195,413,283,7,21,3,4,4,17
2164894,16,16,1997,1,"male",108,180,152,1,6,1,6,0,0
2164901,108,8,1905,7,NA,1651,634,454,1362,1886,757,722,605,1164
2164904,27,28,1986,7,"male",489,274,217,8,8,0,2,8,6
2164932,31,4,1982,6,"female",1750,304,173,264,283,117,170,147,113
2164934,41,18,1972,4,"male",326,117,80,753,587,753,525,0,62
2164977,62,7,1951,4,"female",761,31,17,83,15,83,6,0,9
2164988,62,14,1951,1,"male",2239,39,30,36,154,36,119,0,35
2165012,42,4,1971,12,"male",711,29,13,5,4,0,3,5,1
2165013,16,19,1997,9,"female",591,82,54,105,21,105,14,0,7
2165015,16,26,1997,12,"male",17,4,4,0,0,0,0,0,0
2165022,30,29,1983,10,"female",302,100,21,45,131,35,67,10,64
2165034,15,12,1998,7,"male",320,23,17,35,2,3,2,32,0
2165047,46,3,1967,8,"male",652,47,34,14,18,14,9,0,9
2165066,31,31,1982,3,"male",184,298,283,72,45,72,19,0,26
2165068,44,1,1969,4,"female",682,57,30,174,24,168,6,6,18
2165100,68,17,1945,8,"male",225,448,273,4423,889,4419,530,4,359
2165106,32,11,1981,5,"female",741,297,152,82,45,82,26,0,19
2165109,31,22,1982,6,"male",454,34,19,33,11,33,4,0,7
2165114,38,23,1975,12,"male",175,64,44,0,6,0,6,0,0
2165121,16,19,1997,4,"male",22,4,2,5,16,2,1,3,15
2165125,16,4,1997,3,"female",734,2066,1388,16,699,16,606,0,93
2165136,71,15,1942,12,"female",2030,67,40,75,13,48,9,27,4
2165148,14,8,1999,6,"male",249,21,8,16,1,16,1,0,0
2165165,32,20,1981,2,"male",707,2,2,0,0,0,0,0,0
2165173,14,22,1999,1,"male",104,0,0,1,0,0,0,1,0
2165182,19,22,1994,1,"male",254,142,108,183,86,181,62,2,24
2165211,58,1,1955,8,"male",300,39,27,24,1,24,1,0,0
2165216,38,1,1975,12,"male",1242,9,2,18,0,0,0,18,0
2165242,24,14,1989,9,"male",336,136,49,12,24,12,17,0,7
2165247,29,30,1984,9,"male",922,93,71,22,1,22,1,0,0
2165275,22,3,1991,9,"male",226,193,145,3,1,3,1,0,0
2165289,19,17,1994,9,"female",333,1537,614,12,355,4,298,8,57
2165328,21,27,1992,7,"male",259,75,34,149,126,149,122,0,4
2165334,19,2,1994,2,"female",567,161,82,79,1,79,1,0,0
2165343,20,30,1993,1,"male",508,0,0,0,0,0,0,0,0
2165395,70,5,1943,10,"female",1305,63,28,5,15,3,10,2,5
2165429,63,22,1950,12,"female",1998,260,117,225,46,196,25,29,21
2165441,38,31,1975,5,"male",646,133,46,82,380,82,300,0,80
2165449,108,2,1905,6,"male",1278,117,38,111,13,111,12,0,1
2165456,23,25,1990,10,"female",142,45,22,99,65,99,53,0,12
2165457,45,29,1968,2,"female",1679,147,83,900,493,764,210,136,283
2165470,25,31,1988,12,"male",54,87,72,0,0,0,0,0,0
2165483,63,5,1950,5,"female",1537,1634,89,65,70,65,55,0,15
2165487,49,24,1964,1,"male",285,78,20,16,8,16,5,0,3
2165553,17,30,1996,4,"female",319,274,258,3,0,0,0,3,0
2165633,34,13,1979,2,"male",762,59,32,0,0,0,0,0,0
2165649,25,19,1988,8,"male",1046,251,203,636,47,478,42,158,5
2165656,54,19,1959,9,"female",1504,227,59,674,83,671,32,3,51
2165669,16,7,1997,5,"female",665,40,34,0,0,0,0,0,0
2165675,68,7,1945,5,"female",680,450,133,1384,1121,0,189,1384,932
2165676,20,13,1993,6,"female",149,75,63,2,0,2,0,0,0
2165709,23,24,1990,5,"female",338,1124,363,399,360,399,318,0,42
2165715,16,20,1997,3,"female",583,1021,683,127,109,2,10,125,99
2165716,58,2,1955,10,"male",175,65,57,3,1,3,1,0,0
2165785,20,7,1993,2,"male",170,12,6,0,0,0,0,0,0
2165799,44,27,1969,11,"female",548,55,29,268,217,187,103,81,114
2165814,40,22,1973,4,"female",172,75,44,30,10,30,10,0,0
2165817,15,17,1998,5,"male",21,0,0,0,0,0,0,0,0
2165818,21,13,1992,4,"female",36,115,112,127,152,112,46,15,106
2165821,61,2,1952,12,"male",357,2,1,0,0,0,0,0,0
2165824,19,28,1994,1,"female",44,104,94,488,219,431,115,57,104
2165840,26,20,1987,8,"male",79,61,57,6,1,6,1,0,0
2165854,32,7,1981,4,"male",775,55,23,81,71,77,44,4,27
2165858,42,23,1971,4,"male",879,35,14,0,0,0,0,0,0
2165876,23,17,1990,11,"male",492,199,142,6,17,6,15,0,2
2165892,36,23,1977,10,"male",206,6,2,1,0,1,0,0,0
2165896,31,7,1982,6,"female",569,5,2,6,2,6,2,0,0
2165912,18,11,1995,8,"female",356,184,108,0,0,0,0,0,0
2165949,23,15,1990,12,"female",560,970,478,445,980,237,611,208,369
2165958,24,8,1989,12,"male",1635,493,131,26,55,11,33,15,22
2166026,19,23,1994,5,"male",360,374,237,858,1034,725,822,133,212
2166043,72,30,1941,3,"female",391,22,21,0,1,0,1,0,0
2166064,26,27,1987,8,"male",549,371,274,52,57,52,38,0,19
2166096,30,25,1983,4,"female",513,88,47,14,20,0,12,14,8
2166102,30,12,1983,4,"male",55,1,0,1,0,1,0,0,0
2166104,22,4,1991,3,"female",837,291,58,8,0,8,0,0,0
2166124,44,20,1969,5,"female",545,56,29,497,526,453,445,44,81
2166133,59,19,1954,12,"female",892,43,18,7,0,7,0,0,0
2166164,23,7,1990,12,"male",310,50,39,28,11,28,7,0,4
2166211,27,22,1986,6,"female",396,75,27,7,2,7,1,0,1
2166224,52,23,1961,8,"male",1068,170,72,250,224,250,205,0,19
2166236,21,10,1992,11,"female",200,96,46,58,59,22,16,36,43
2166288,31,2,1982,1,"female",308,58,30,125,117,125,88,0,29
2166291,15,4,1998,3,"male",573,4,2,0,0,0,0,0,0
2166382,15,16,1998,3,"male",861,304,131,0,6,0,6,0,0
2166383,23,16,1990,8,"male",545,1435,1285,146,74,146,65,0,9
2166387,85,1,1928,9,"female",259,757,671,125,117,125,106,0,11
2166398,15,20,1998,3,"male",263,213,153,79,2,0,0,79,2
2166405,33,1,1980,1,"male",285,5,5,238,30,0,0,238,30
2166407,37,30,1976,9,"female",180,66,40,364,121,364,115,0,6
2166415,108,25,1905,9,"female",1592,262,40,44,5,0,0,44,5
2166423,66,16,1947,11,"male",893,29,15,1,2,0,1,1,1
2166447,21,23,1992,2,"male",491,229,156,42,36,41,25,1,11
2166481,24,22,1989,3,"female",274,74,58,15,35,15,21,0,14
2166492,22,12,1991,12,"female",28,1,1,0,0,0,0,0,0
2166502,22,13,1991,9,"male",332,404,233,567,761,553,612,14,149
2166506,25,4,1988,4,"male",378,975,759,213,79,213,73,0,6
2166525,17,25,1996,3,"female",347,224,175,655,47,649,17,6,30
2166527,18,15,1995,1,"female",384,7,4,0,0,0,0,0,0
2166606,39,27,1974,3,"male",418,33,26,56,2,0,0,56,2
2166633,15,6,1998,5,"female",83,60,18,73,5,73,3,0,2
2166664,42,30,1971,6,"female",236,46,27,66,37,66,26,0,11
2166665,23,21,1990,10,"female",218,149,62,91,38,91,34,0,4
2166688,19,1,1994,1,"male",543,231,136,37,12,0,1,37,11
2166698,37,28,1976,6,"male",181,28,11,29,12,25,10,4,2
2166732,17,19,1996,8,"male",483,43,39,533,43,406,27,127,16
2166746,51,28,1962,2,"male",591,18,16,0,2,0,2,0,0
2166771,25,15,1988,5,"female",15,26,16,41,50,41,29,0,21
2166804,66,30,1947,7,"female",89,34,14,49,2,49,1,0,1
2166807,17,25,1996,7,"male",58,56,31,26,5,0,1,26,4
2166813,107,20,1906,10,"female",1286,295,63,63,55,0,19,63,36
2166838,26,1,1987,11,"male",227,0,0,0,0,0,0,0,0
2166865,65,15,1948,2,"female",1139,5,2,5,0,5,0,0,0
2166868,20,26,1993,4,"female",537,578,277,921,878,14,420,907,458
2166871,32,16,1981,10,"male",218,219,203,0,1,0,0,0,1
2166918,65,6,1948,9,"male",525,331,258,1,5,0,1,1,4
2166919,45,25,1968,12,"male",8,1,0,0,0,0,0,0,0
2166931,24,19,1989,4,"male",233,29,24,247,45,247,45,0,0
2166941,68,17,1945,8,"male",150,98,90,958,224,958,215,0,9
2166950,27,1,1986,9,"female",887,823,377,194,791,194,632,0,159
2166959,58,19,1955,11,"female",383,17,13,10,0,1,0,9,0
2166972,18,6,1995,8,"male",551,18,17,0,1,0,1,0,0
2167068,108,26,1905,9,"female",96,369,337,194,240,31,149,163,91
2167082,30,3,1983,1,"female",605,91,40,89,0,8,0,81,0
2167085,89,30,1924,12,"male",1018,165,67,79,58,0,17,79,41
2167095,30,5,1983,5,"male",356,5,5,0,0,0,0,0,0
2167097,52,22,1961,6,"male",856,1,1,0,0,0,0,0,0
2167170,25,1,1988,1,"male",165,32,27,14,3,14,3,0,0
2167171,68,17,1945,5,"female",1490,780,428,6,3,6,2,0,1
2167183,19,6,1994,4,"female",457,118,67,0,0,0,0,0,0
2167199,19,22,1994,1,"male",404,37,23,4,2,4,2,0,0
2167230,37,1,1976,1,"female",371,49,33,17,110,17,81,0,29
2167253,39,23,1974,6,"male",149,6,5,0,0,0,0,0,0
2167257,29,31,1984,12,"male",150,88,73,322,21,0,11,322,10
2167336,57,20,1956,12,"female",342,48,31,2,5,0,0,2,5
2167372,27,27,1986,7,"female",236,360,175,13,40,13,29,0,11
2167383,57,23,1956,12,"male",1177,26,19,62,6,7,5,55,1
2167402,21,10,1992,8,"male",449,122,108,0,0,0,0,0,0
2167404,27,28,1986,11,"male",988,198,112,5,0,5,0,0,0
2167422,78,9,1935,6,"female",75,20,20,3,2,0,1,3,1
2167447,25,7,1988,8,"male",388,177,161,0,16,0,16,0,0
2167449,21,16,1992,11,"male",339,185,125,0,0,0,0,0,0
2167458,16,27,1997,9,"male",27,33,24,1,22,1,22,0,0
2167478,29,3,1984,4,"male",373,516,327,603,646,603,605,0,41
2167479,19,19,1994,4,"male",363,40,23,4,4,0,0,4,4
2167507,20,8,1993,1,"male",1012,826,456,0,4,0,3,0,1
2167511,23,11,1990,9,"male",409,203,143,110,20,110,8,0,12
2167526,22,13,1991,8,"male",104,44,42,59,33,48,13,11,20
2167538,18,17,1995,9,"female",216,83,38,0,1,0,0,0,1
2167545,36,1,1977,7,"male",264,78,38,5,0,0,0,5,0
2167547,24,6,1989,7,"male",416,21,8,0,0,0,0,0,0
2167585,78,9,1935,3,"male",196,2,1,0,0,0,0,0,0
2167613,19,13,1994,5,"male",268,255,229,5,6,3,5,2,1
2167615,20,24,1993,2,"male",96,71,41,1,16,1,9,0,7
2167629,15,24,1998,9,"female",245,217,121,846,582,46,243,800,339
2167640,34,24,1979,5,"female",368,20,11,39,0,39,0,0,0
2167655,23,5,1990,2,"male",168,55,43,53,29,1,13,52,16
2167676,78,15,1935,11,"female",59,8,8,0,0,0,0,0,0
2167685,19,19,1994,10,"male",197,15,11,5,1,0,1,5,0
2167692,45,15,1968,2,"male",440,65,13,15,3,15,2,0,1
2167695,20,1,1993,1,"male",505,613,510,514,70,514,62,0,8
2167719,16,3,1997,10,"male",456,171,37,4,11,4,6,0,5
2167727,17,15,1996,12,"male",27,112,105,27,17,27,12,0,5
2167730,24,20,1989,5,"female",731,303,113,184,53,184,53,0,0
2167733,26,5,1987,11,"male",427,39,3,0,0,0,0,0,0
2167748,25,10,1988,3,"female",749,162,102,284,3,284,3,0,0
2167765,22,10,1991,1,"female",563,249,194,462,331,289,155,173,176
2167827,52,27,1961,6,"female",56,98,71,310,201,310,52,0,149
2167851,94,19,1919,8,"male",1451,489,450,38,73,36,31,2,42
2167855,49,20,1964,8,"male",75,3,3,9,5,0,1,9,4
2167890,29,2,1984,1,"female",143,18,5,36,71,36,44,0,27
2167906,23,1,1990,1,"female",281,2,2,0,0,0,0,0,0
2167916,15,11,1998,2,"male",163,18,13,0,0,0,0,0,0
2167930,25,26,1988,8,"male",525,207,137,4,0,4,0,0,0
2167936,63,25,1950,7,"male",1858,15,6,0,3,0,0,0,3
2167942,54,17,1959,5,"male",9,7,6,3,0,3,0,0,0
2167980,31,5,1982,12,"male",341,110,81,25,12,25,9,0,3
2168008,26,30,1987,11,"female",262,27,16,2,3,2,3,0,0
2168040,15,11,1998,11,"female",331,201,51,0,0,0,0,0,0
2168092,31,9,1982,7,"male",113,27,19,0,0,0,0,0,0
2168112,21,6,1992,3,"male",121,1,1,0,0,0,0,0,0
2168149,19,24,1994,8,"female",529,103,64,67,51,67,40,0,11
2168164,50,12,1963,1,"male",745,83,46,82,25,82,8,0,17
2168173,17,10,1996,4,"female",262,703,213,714,528,714,328,0,200
2168188,108,25,1905,1,"male",1164,651,368,1039,34,1039,29,0,5
2168189,43,2,1970,5,"male",29,13,12,0,0,0,0,0,0
2168203,59,4,1954,9,"male",834,185,178,0,2,0,2,0,0
2168231,20,5,1993,12,"male",508,234,188,11,26,0,9,11,17
2168245,37,24,1976,11,"female",591,22,8,1,1,0,1,1,0
2168276,20,27,1993,9,"male",233,230,213,2,39,2,36,0,3
2168299,36,26,1977,6,"female",399,48,20,23,36,23,35,0,1
2168340,15,27,1998,7,"male",18,128,28,13,0,13,0,0,0
2168344,14,21,1999,6,"female",390,293,176,121,136,115,69,6,67
2168367,28,9,1985,7,"male",653,38,22,8,8,4,5,4,3
2168372,29,21,1984,3,"female",157,45,24,1,3,1,2,0,1
2168387,33,2,1980,4,"female",669,93,45,1,19,1,10,0,9
2168412,22,6,1991,11,"female",95,112,54,468,66,379,49,89,17
2168437,28,12,1985,3,"female",369,33,27,91,19,91,14,0,5
2168447,23,24,1990,6,"male",248,16,9,9,25,0,7,9,18
2168475,29,23,1984,7,"male",550,139,73,169,126,169,35,0,91
2168477,17,31,1996,1,"male",279,210,35,26,5,6,0,20,5
2168552,75,7,1938,3,"female",930,98,65,1,1,1,1,0,0
2168558,15,6,1998,3,"female",74,838,445,54,109,54,86,0,23
2168597,50,13,1963,1,"male",311,3,1,0,0,0,0,0,0
2168617,13,16,2000,4,"male",189,228,166,545,58,542,21,3,37
2168633,87,5,1926,7,"male",809,329,219,9,1,8,1,1,0
2168658,44,26,1969,2,"female",1607,323,99,18,14,18,13,0,1
2168671,19,15,1994,2,"male",685,147,117,477,26,467,22,10,4
2168686,84,30,1929,9,"male",1116,659,355,112,57,0,7,112,50
2168691,60,4,1953,4,"female",1192,13,6,1,4,1,4,0,0
2168712,61,22,1952,4,"female",1337,112,55,14,9,0,1,14,8
2168716,25,1,1988,1,"male",90,74,26,2,19,2,2,0,17
2168728,14,18,1999,8,"male",4,5,5,11,2,11,2,0,0
2168730,29,3,1984,5,"male",1514,458,237,6,20,6,16,0,4
2168737,37,18,1976,7,"female",1902,243,60,358,305,113,116,245,189
2168760,29,12,1984,9,"female",938,258,119,329,290,289,223,40,67
2168762,21,4,1992,2,"male",629,140,75,15,3,0,1,15,2
2168769,54,24,1959,5,"male",563,93,56,0,0,0,0,0,0
2168798,15,9,1998,8,"male",208,133,94,235,86,186,70,49,16
2168818,28,30,1985,1,"female",314,61,22,3,12,3,12,0,0
2168845,29,29,1984,8,"male",219,49,47,6,3,6,3,0,0
2168849,50,11,1963,10,"female",461,52,28,40,106,40,66,0,40
2168857,60,25,1953,8,"female",1762,76,29,50,32,50,16,0,16
2168866,26,6,1987,8,"male",267,32,12,0,0,0,0,0,0
2168871,16,14,1997,2,"female",792,218,121,761,736,184,266,577,470
2168888,33,30,1980,12,"male",32,2,1,0,0,0,0,0,0
2168894,65,11,1948,5,"male",928,59,44,27,5,21,3,6,2
2168930,52,27,1961,8,"female",232,12,11,14,3,14,3,0,0
2169003,20,21,1993,4,"female",563,176,109,13,7,0,2,13,5
2169017,18,1,1995,2,"male",796,644,236,884,451,864,344,20,107
2169033,61,5,1952,8,"female",1477,38,31,45,11,41,7,4,4
2169034,21,2,1992,4,"male",20,47,45,3,4,3,3,0,1
2169074,20,22,1993,11,"male",880,50,20,2,0,0,0,2,0
2169077,61,14,1952,11,"female",404,37,30,0,0,0,0,0,0
2169085,52,29,1961,4,"female",354,300,158,39,19,39,5,0,14
2169129,52,13,1961,4,"female",285,32,18,10,12,0,10,10,2
2169143,17,11,1996,11,"female",552,1,1,0,0,0,0,0,0
2169199,57,13,1956,7,"female",39,40,30,16,0,16,0,0,0
2169231,31,28,1982,2,"male",1549,60,8,0,0,0,0,0,0
2169270,49,21,1964,6,"male",662,45,30,0,1,0,1,0,0
2169278,22,15,1991,12,"female",134,67,18,0,0,0,0,0,0
2169289,68,3,1945,2,"female",564,586,220,84,74,84,64,0,10
2169293,26,23,1987,11,"male",307,42,38,0,0,0,0,0,0
2169311,34,24,1979,1,"female",195,97,68,1,0,0,0,1,0
2169335,19,5,1994,12,"female",576,1073,465,309,432,41,230,268,202
2169336,16,16,1997,1,"male",775,1338,1147,2118,3215,407,1604,1711,1611
2169348,54,6,1959,8,"male",52,44,42,30,1,0,0,30,1
2169349,18,23,1995,3,"female",241,312,203,225,434,225,197,0,237
2169356,46,17,1967,12,"male",250,27,18,12,2,4,1,8,1
2169359,22,12,1991,4,"female",104,41,3,2,6,2,5,0,1
2169367,14,30,1999,10,"male",554,408,287,813,265,747,201,66,64
2169413,30,22,1983,12,"male",202,113,79,18,18,18,15,0,3
2169451,21,2,1992,6,"male",253,142,107,10,2,10,2,0,0
2169499,18,23,1995,8,"female",340,232,89,952,1111,435,286,517,825
2169517,16,19,1997,11,"male",9,2,1,1,0,1,0,0,0
2169610,31,6,1982,8,"female",410,98,63,241,16,241,13,0,3
2169616,22,20,1991,3,"male",42,15,11,56,16,56,7,0,9
2169632,30,14,1983,12,"female",534,229,147,868,453,868,422,0,31
2169700,23,26,1990,10,"female",137,220,100,184,273,156,178,28,95
2169735,36,7,1977,4,"female",418,13,10,7,0,7,0,0,0
2169747,21,11,1992,10,"male",302,5,2,41,13,41,13,0,0
2169749,22,19,1991,11,"male",669,2,1,0,0,0,0,0,0
2169750,29,9,1984,10,"male",154,0,0,0,0,0,0,0,0
2169763,43,28,1970,10,"female",196,66,48,13,1,0,1,13,0
2169775,21,7,1992,9,"male",417,55,44,194,12,194,11,0,1
2169817,39,12,1974,4,"male",441,80,39,0,0,0,0,0,0
2169859,16,20,1997,4,"female",435,126,81,296,288,100,162,196,126
2169861,40,5,1973,4,"female",290,1,1,4,0,3,0,1,0
2169886,24,6,1989,9,"male",158,130,111,408,241,408,205,0,36
2169899,22,20,1991,12,"male",206,326,286,124,194,124,159,0,35
2169902,52,6,1961,6,"male",567,81,71,76,27,27,10,49,17
2169906,15,14,1998,6,"female",27,0,0,0,0,0,0,0,0
2169907,24,5,1989,5,"male",302,149,105,119,154,119,117,0,37
2169922,48,2,1965,5,"male",328,49,36,0,10,0,2,0,8
2169932,18,6,1995,2,"female",607,45,14,0,2,0,2,0,0
2169936,28,9,1985,4,"male",599,421,373,1,13,1,11,0,2
2169955,27,3,1986,3,"female",38,63,57,34,16,17,6,17,10
2170012,15,9,1998,6,"male",370,46,33,10,20,10,18,0,2
2170084,29,6,1984,5,"female",369,156,115,341,190,216,11,125,179
2170089,46,28,1967,8,"male",646,43,33,47,37,47,32,0,5
2170161,25,1,1988,2,"male",42,69,17,27,0,27,0,0,0
2170170,18,5,1995,9,"male",93,169,99,1,0,1,0,0,0
2170172,62,21,1951,10,"female",1823,368,193,1058,657,413,364,645,293
2170210,22,1,1991,2,"male",885,212,141,46,109,46,93,0,16
2170211,24,21,1989,7,"male",174,37,34,31,30,31,26,0,4
2170219,75,27,1938,9,"female",588,21,13,142,41,0,2,142,39
2170231,18,4,1995,5,"male",347,1780,1344,1761,2225,1722,1953,39,272
2170268,78,7,1935,10,"female",446,63,45,41,23,39,21,2,2
2170284,32,31,1981,8,"male",360,1,1,0,0,0,0,0,0
2170333,22,15,1991,6,"female",241,69,45,11,25,11,25,0,0
2170352,37,17,1976,10,"male",302,115,71,1,5,1,3,0,2
2170354,17,21,1996,2,"female",492,15,14,0,4,0,3,0,1
2170396,32,12,1981,11,"male",391,55,29,2,8,1,3,1,5
2170398,40,19,1973,10,"male",273,25,24,0,0,0,0,0,0
2170410,50,9,1963,9,"male",1068,60,33,0,0,0,0,0,0
2170413,48,23,1965,10,"female",258,16,7,145,60,145,47,0,13
2170427,26,11,1987,1,"female",138,72,46,4,1,4,1,0,0
2170474,26,8,1987,12,"male",142,2,2,253,148,196,48,57,100
2170491,21,29,1992,4,"male",219,291,250,92,80,86,46,6,34
2170499,25,1,1988,1,"male",41,10,8,0,0,0,0,0,0
2170502,20,30,1993,10,"female",562,815,504,96,303,51,180,45,123
2170520,21,14,1992,5,"male",3,1,1,5,1,0,0,5,1
2170532,36,25,1977,11,"male",133,135,32,55,54,55,36,0,18
2170535,18,15,1995,9,"male",506,683,588,3,0,3,0,0,0
2170576,38,29,1975,7,"female",121,61,47,507,44,460,19,47,25
2170592,22,22,1991,10,"male",135,31,5,18,9,18,9,0,0
2170637,35,11,1978,8,"female",481,22,12,0,0,0,0,0,0
2170667,26,10,1987,10,"male",379,3,3,0,0,0,0,0,0
2170722,39,30,1974,12,"male",185,19,18,0,0,0,0,0,0
2170728,29,1,1984,6,"male",1295,40,35,0,5,0,2,0,3
2170747,53,19,1960,9,"female",1399,295,170,882,878,873,629,9,249
2170752,15,9,1998,1,"male",118,136,119,1,18,1,6,0,12
2170783,97,15,1916,10,"male",1882,248,189,19,0,0,0,19,0
2170810,103,16,1910,6,"male",649,1060,901,618,197,618,178,0,19
2170832,19,5,1994,4,"male",619,166,132,2,0,2,0,0,0
2170887,108,24,1905,10,"male",1339,42,31,0,0,0,0,0,0
2170902,47,6,1966,3,"female",140,210,114,240,80,240,62,0,18
2170954,27,16,1986,1,"male",365,788,467,182,554,35,165,147,389
2170973,24,12,1989,1,"male",383,5,2,7,1,7,1,0,0
2170995,64,1,1949,10,"female",685,18,7,104,50,0,0,104,50
2171033,23,1,1990,7,"female",387,12,9,129,134,20,67,109,67
2171080,22,8,1991,2,"female",334,233,129,88,106,77,43,11,63
2171148,17,22,1996,1,"male",297,160,106,0,0,0,0,0,0
2171157,69,19,1944,12,"female",162,54,34,20,24,20,23,0,1
2171167,19,31,1994,8,"female",118,225,116,7,22,7,16,0,6
2171178,27,18,1986,2,"male",439,410,301,12,49,3,36,9,13
2171190,68,16,1945,2,"female",221,250,66,19,12,0,9,19,3
2171197,30,9,1983,7,"male",542,80,35,3,3,0,0,3,3
2171225,108,14,1905,8,"male",202,233,146,15,4,2,4,13,0
2171233,76,10,1937,9,"female",1934,76,41,9,20,0,8,9,12
2171280,113,1,1900,4,"female",1816,64,12,2,7,0,5,2,2
2171307,16,10,1997,1,"male",774,475,269,68,31,65,10,3,21
2171329,17,1,1996,6,"male",165,236,106,42,170,42,70,0,100
2171335,25,1,1988,8,"male",24,7,7,1,0,1,0,0,0
2171353,23,25,1990,9,"male",509,2,2,0,0,0,0,0,0
2171364,27,8,1986,9,"male",928,251,181,4,4,4,3,0,1
2171422,77,9,1936,5,"female",1268,46,22,0,0,0,0,0,0
2171439,33,4,1980,4,"male",340,2,2,52,4,52,4,0,0
2171444,108,1,1905,1,"male",1605,242,115,6,13,2,12,4,1
2171470,23,23,1990,10,"male",692,181,111,1,80,0,47,1,33
2171489,30,12,1983,2,"female",259,94,77,47,112,47,94,0,18
2171493,30,25,1983,1,"male",716,61,29,1,3,1,2,0,1
2171568,34,24,1979,4,"male",363,90,72,70,11,70,10,0,1
2171571,19,19,1994,1,"female",49,435,25,58,108,58,72,0,36
2171572,47,2,1966,12,"male",1473,21,5,0,3,0,3,0,0
2171575,33,16,1980,6,"female",240,10,4,100,61,99,24,1,37
2171603,78,20,1935,11,"male",1044,45,9,625,156,6,8,619,148
2171615,18,31,1995,3,"female",593,8,8,0,0,0,0,0,0
2171618,63,20,1950,4,"male",85,23,10,0,3,0,3,0,0
2171670,22,10,1991,2,"male",605,157,136,0,0,0,0,0,0
2171679,25,23,1988,1,"female",946,601,387,390,510,87,127,303,383
2171680,16,3,1997,2,"female",860,1312,437,388,461,262,257,126,204
2171724,28,25,1985,10,"male",28,0,0,0,0,0,0,0,0
2171784,20,10,1993,6,"female",387,121,96,2,0,2,0,0,0
2171795,25,1,1988,1,"male",283,12,12,0,0,0,0,0,0
2171810,27,2,1986,4,"female",1396,157,72,72,119,71,109,1,10
2171813,14,1,1999,1,"male",91,32,25,0,0,0,0,0,0
2171841,17,4,1996,5,"male",566,1907,1263,308,68,308,61,0,7
2171853,74,12,1939,2,"male",1048,19,17,2,2,2,2,0,0
2171898,56,29,1957,9,"female",1605,23,6,10,2,10,2,0,0
2171909,30,28,1983,10,"male",573,135,124,0,15,0,9,0,6
2171935,23,17,1990,6,"male",139,59,53,12,2,12,2,0,0
2171941,18,20,1995,8,"male",108,51,39,2,19,1,17,1,2
2171980,33,15,1980,4,"male",494,0,0,0,0,0,0,0,0
2172019,13,23,2000,3,"female",70,314,131,430,364,422,260,8,104
2172022,28,21,1985,1,"female",290,26,7,113,70,112,60,1,10
2172033,23,3,1990,2,"male",108,123,87,91,123,30,27,61,96
2172040,51,10,1962,2,"male",215,26,18,17,0,0,0,17,0
2172054,26,28,1987,4,"female",200,38,11,58,42,58,42,0,0
2172119,21,6,1992,8,"male",558,8,5,0,0,0,0,0,0
2172128,71,24,1942,10,"female",1133,43,17,1,15,0,8,1,7
2172130,15,23,1998,6,"male",465,403,338,2,20,2,13,0,7
2172166,18,11,1995,8,"female",457,329,260,58,22,34,8,24,14
2172230,19,14,1994,3,"female",518,443,259,19,40,19,39,0,1
2172247,22,26,1991,7,"female",569,208,99,51,82,25,3,26,79
2172253,16,12,1997,7,"female",213,1,1,5937,320,5704,122,233,198
2172260,49,1,1964,12,"male",153,19,15,10,0,10,0,0,0
2172262,19,22,1994,12,"male",462,27,14,190,5,190,5,0,0
2172270,28,10,1985,10,"male",249,0,0,0,0,0,0,0,0
2172294,106,4,1907,2,"male",547,183,133,91,23,4,6,87,17
2172310,19,20,1994,2,"male",373,920,868,63,23,0,14,63,9
2172319,20,19,1993,4,"male",595,447,406,32,31,32,21,0,10
2172448,81,20,1932,4,"female",74,70,67,25,11,25,11,0,0
2172451,64,15,1949,12,"female",1086,39,18,42,32,39,16,3,16
2172458,18,22,1995,7,"male",163,309,236,203,22,177,9,26,13
2172486,33,1,1980,1,"female",338,1,1,0,0,0,0,0,0
2172488,61,12,1952,5,"male",621,73,48,0,0,0,0,0,0
2172493,19,21,1994,7,"female",2020,123,75,350,291,206,98,144,193
2172500,70,17,1943,11,"female",2388,130,41,582,243,0,139,582,104
2172588,28,10,1985,7,"male",509,420,408,106,22,0,6,106,16
2172611,51,1,1962,1,"female",170,26,6,994,15,0,1,994,14
2172620,22,24,1991,9,"female",1992,430,330,255,174,245,167,10,7
2172624,113,8,1900,4,"female",1330,254,96,78,17,24,5,54,12
2172651,22,15,1991,8,"male",352,361,324,4,35,4,32,0,3
2172691,23,16,1990,1,"male",281,101,61,6,2,6,2,0,0
2172726,33,8,1980,6,"male",370,15,15,109,28,109,28,0,0
2172732,13,1,2000,1,"male",232,1,1,0,0,0,0,0,0
2172756,46,5,1967,5,"male",270,41,27,7,2,7,1,0,1
2172777,94,11,1919,1,"male",1281,303,146,12,0,12,0,0,0
2172790,61,4,1952,12,"female",1689,101,61,510,393,496,241,14,152
2172793,19,30,1994,11,"female",282,7,5,22,4,22,4,0,0
2172823,28,10,1985,2,"male",276,44,30,19,5,0,1,19,4
2172840,18,2,1995,5,"male",107,6,6,0,0,0,0,0,0
2172841,44,24,1969,7,"female",894,53,32,0,0,0,0,0,0
2172850,25,30,1988,5,"female",343,13,9,0,2,0,1,0,1
2172895,60,18,1953,12,"male",65,2,1,1,0,1,0,0,0
2172896,26,20,1987,5,"female",614,20,7,0,0,0,0,0,0
2172946,21,8,1992,12,"male",26,40,35,1,0,1,0,0,0
2172947,23,5,1990,8,"male",427,143,95,38,5,38,5,0,0
2172957,54,6,1959,10,"male",1402,34,14,29,19,0,1,29,18
2172970,29,31,1984,3,"male",825,234,179,15,18,14,8,1,10
2172974,17,9,1996,11,"female",564,130,29,119,12,119,12,0,0
2173008,70,19,1943,3,"female",1502,14,11,54,6,7,0,47,6
2173012,23,29,1990,3,"female",507,204,90,207,232,168,150,39,82
2173017,26,9,1987,5,"female",561,136,66,12,40,10,18,2,22
2173047,23,1,1990,1,"male",32,135,133,6,8,6,5,0,3
2173054,19,12,1994,10,"male",754,1357,624,126,362,81,280,45,82
2173081,21,2,1992,4,"male",126,4,4,0,0,0,0,0,0
2173126,18,2,1995,3,"male",423,109,89,0,0,0,0,0,0
2173141,32,15,1981,12,"male",1402,28,21,1,9,1,6,0,3
2173151,36,6,1977,11,"male",230,115,91,29,4,29,3,0,1
2173153,18,8,1995,3,"female",596,49,38,8,0,8,0,0,0
2173167,17,18,1996,1,"male",75,55,50,14,2,0,1,14,1
2173177,27,10,1986,10,"male",142,238,213,61,112,61,46,0,66
2173184,20,31,1993,8,"male",429,80,35,9,2,9,1,0,1
2173192,46,14,1967,8,"male",480,211,187,76,111,57,83,19,28
2173205,21,10,1992,1,"male",453,158,85,3,7,3,5,0,2
2173216,23,1,1990,1,"female",1301,75,26,91,9,63,4,28,5
2173236,23,26,1990,10,"female",646,542,256,0,2,0,2,0,0
2173258,20,27,1993,9,"male",172,549,369,153,139,153,115,0,24
2173274,19,23,1994,10,"male",590,301,249,11,82,11,56,0,26
2173290,19,17,1994,9,"male",165,36,35,0,0,0,0,0,0
2173329,59,2,1954,5,"female",1849,1837,949,1947,2133,229,549,1718,1584
2173356,23,19,1990,8,"male",664,458,352,628,135,628,97,0,38
2173397,14,13,1999,4,"male",159,99,78,2,3,2,1,0,2
2173398,32,20,1981,8,"male",376,78,59,138,46,138,42,0,4
2173444,64,6,1949,5,"male",1425,194,132,25,13,0,7,25,6
2173460,108,21,1905,9,"male",415,55,12,9,99,0,66,9,33
2173490,22,13,1991,9,"male",324,38,31,66,15,60,11,6,4
2173500,25,2,1988,6,"male",577,203,112,11,8,11,8,0,0
2173505,56,26,1957,1,"female",120,101,11,1481,145,25,48,1456,97
2173541,30,5,1983,11,"male",764,227,155,88,30,27,18,61,12
2173543,51,9,1962,11,"male",1838,144,103,15,8,15,6,0,2
2173545,18,13,1995,10,"female",277,96,35,10,6,0,2,10,4
2173551,108,17,1905,3,"male",975,604,360,170,192,72,34,98,158
2173583,20,19,1993,12,"male",267,1,0,11,0,11,0,0,0
2173634,25,5,1988,9,"female",246,62,43,1,4,1,2,0,2
2173643,23,12,1990,6,"female",473,16,8,0,2,0,2,0,0
2173673,41,22,1972,11,"female",459,14,7,31,19,31,12,0,7
2173683,17,30,1996,6,"male",19,20,15,12,4,11,3,1,1
2173684,13,2,2000,9,"male",60,1,1,4,2,4,2,0,0
2173728,55,31,1958,5,"female",648,50,39,11,36,11,28,0,8
2173730,24,7,1989,9,"male",486,7,5,0,0,0,0,0,0
2173742,19,12,1994,11,"male",753,574,262,23,7,23,4,0,3
2173744,17,26,1996,6,"male",396,510,459,0,55,0,41,0,14
2173772,21,8,1992,1,"male",216,333,267,88,143,51,95,37,48
2173780,18,4,1995,6,"male",224,112,79,1,0,0,0,1,0
2173835,57,29,1956,4,"female",747,44,20,0,0,0,0,0,0
2173949,47,31,1966,3,"male",214,37,27,31,2,31,2,0,0
2173991,23,18,1990,11,"male",222,164,84,32,5,32,2,0,3
2174002,67,26,1946,12,"male",1572,176,33,964,125,427,42,537,83
2174006,89,12,1924,6,"female",782,165,66,96,25,12,16,84,9
2174026,16,19,1997,11,"female",519,389,266,60,67,59,56,1,11
2174029,23,29,1990,10,"female",795,3993,198,2112,4548,1946,2375,166,2173
2174048,108,30,1905,10,"female",2290,243,115,314,324,281,156,33,168
2174049,19,1,1994,6,"female",152,32,4,1,0,1,0,0,0
2174069,59,29,1954,7,"female",1588,91,53,94,56,0,4,94,52
2174070,25,21,1988,5,"female",14,2,2,0,0,0,0,0,0
2174074,63,27,1950,7,"male",140,11,9,4,4,4,4,0,0
2174107,29,12,1984,5,"female",446,397,325,830,173,821,144,9,29
2174118,16,12,1997,7,"female",679,273,161,79,104,79,100,0,4
2174120,51,10,1962,7,"female",778,741,452,298,1252,295,820,3,432
2174127,69,26,1944,3,"female",124,29,19,42,10,0,4,42,6
2174137,108,25,1905,3,"male",585,373,295,6,41,0,41,6,0
2174138,17,18,1996,12,"male",437,22,17,0,0,0,0,0,0
2174148,30,12,1983,12,"female",1050,210,61,0,1,0,1,0,0
2174180,26,11,1987,6,"female",404,78,49,325,122,325,84,0,38
2174191,19,18,1994,12,"male",288,113,89,6,11,0,6,6,5
2174289,50,14,1963,2,"female",704,1,0,0,0,0,0,0,0
2174317,36,7,1977,4,"female",589,135,57,46,12,46,10,0,2
2174354,51,5,1962,8,"male",704,163,154,91,54,60,49,31,5
2174362,61,22,1952,3,"male",1874,85,43,3,18,3,7,0,11
2174368,70,4,1943,8,"male",1182,15,10,7,3,7,0,0,3
2174373,28,17,1985,5,"male",242,20,11,11,3,11,0,0,3
2174388,39,22,1974,7,"female",815,16,7,73,3,72,3,1,0
2174389,62,16,1951,3,"male",1446,12,9,1,5,1,5,0,0
2174440,21,1,1992,3,"male",403,72,39,41,10,41,5,0,5
2174457,22,26,1991,11,"female",377,283,175,3,48,3,36,0,12
2174475,22,7,1991,11,"male",129,90,72,8,5,8,3,0,2
2174514,24,9,1989,8,"male",823,2,2,1,0,0,0,1,0
2174524,52,8,1961,11,"female",1401,491,204,526,163,522,99,4,64
2174542,108,9,1905,2,"female",1790,30,22,12,8,0,3,12,5
2174576,16,22,1997,1,"male",580,67,52,0,3,0,3,0,0
2174591,20,11,1993,7,"male",1026,314,243,214,135,213,112,1,23
2174594,26,1,1987,1,"male",61,107,102,0,0,0,0,0,0
2174602,16,16,1997,7,"female",385,286,115,19,16,19,11,0,5
2174628,35,20,1978,3,"male",281,4,2,24,4,0,0,24,4
2174637,29,12,1984,3,"male",151,29,22,0,2,0,2,0,0
2174663,19,31,1994,1,"female",381,685,232,7,11,7,10,0,1
2174668,14,30,1999,4,"female",235,172,119,65,13,0,4,65,9
2174729,43,1,1970,8,"female",499,17,11,70,29,0,4,70,25
2174736,19,29,1994,4,"male",623,327,212,0,0,0,0,0,0
2174780,53,17,1960,11,"male",142,68,57,5,26,5,20,0,6
2174810,93,1,1920,2,"female",640,788,295,198,214,10,61,188,153
2174825,33,1,1980,5,"male",485,275,222,157,43,157,32,0,11
2174833,34,15,1979,6,"female",373,26,25,9,0,0,0,9,0
2174836,75,3,1938,1,"male",1742,278,41,0,26,0,17,0,9
2174856,27,8,1986,7,"male",310,5,4,0,0,0,0,0,0
2174862,32,1,1981,11,"female",436,78,24,2,5,2,4,0,1
2174872,43,26,1970,7,"female",638,60,20,16,15,16,11,0,4
2174873,33,2,1980,2,"male",740,19,16,12,9,12,1,0,8
2174883,21,5,1992,11,"male",574,1,0,0,0,0,0,0,0
2174888,28,26,1985,12,"female",667,1142,260,44,68,29,40,15,28
2174892,18,7,1995,1,"female",1547,663,313,321,228,288,91,33,137
2174908,21,1,1992,1,"male",202,27,0,0,0,0,0,0,0
2174915,108,9,1905,8,"male",1463,1692,431,392,192,187,107,205,85
2174925,47,11,1966,2,"male",375,16,10,0,0,0,0,0,0
2174932,41,20,1972,6,"male",209,47,44,0,0,0,0,0,0
2174966,29,3,1984,2,"male",1538,295,218,1,1,1,1,0,0
2175001,17,1,1996,10,"male",433,372,247,409,16,342,11,67,5
2175005,15,2,1998,10,"female",254,369,169,738,733,594,360,144,373
2175048,30,12,1983,5,"female",62,31,22,0,0,0,0,0,0
2175067,75,1,1938,11,"male",1831,38,10,5,1,0,0,5,1
2175090,51,29,1962,7,"female",224,26,20,1,4,0,1,1,3
2175095,21,26,1992,2,"male",1033,1224,895,26,0,0,0,26,0
2175132,50,14,1963,7,"female",128,21,18,117,1,117,1,0,0
2175134,38,20,1975,6,"female",414,255,155,42,264,41,241,1,23
2175149,20,4,1993,1,"male",582,172,115,0,0,0,0,0,0
2175161,108,12,1905,11,"male",69,169,154,56,18,0,5,56,13
2175164,27,8,1986,4,"female",59,290,31,29,6,29,4,0,2
2175173,50,12,1963,9,"female",1001,137,64,50,54,46,28,4,26
2175174,57,2,1956,11,"female",590,108,58,5,27,0,8,5,19
2175182,58,8,1955,1,"male",303,27,24,2,7,0,0,2,7
2175193,108,14,1905,8,"male",419,464,379,1190,2301,1174,2120,16,181
2175240,18,1,1995,1,"male",208,4,1,82,10,0,0,82,10
2175245,18,7,1995,2,"male",186,792,576,4,45,4,37,0,8
2175262,41,6,1972,9,"male",814,149,88,0,0,0,0,0,0
2175277,75,1,1938,3,"female",128,29,25,65,12,0,4,65,8
2175307,23,14,1990,4,"male",495,50,24,1,12,1,11,0,1
2175308,19,4,1994,9,"male",158,58,14,1,1,1,0,0,1
2175312,25,1,1988,7,"male",157,42,33,9,32,9,29,0,3
2175335,60,20,1953,10,"female",408,148,31,289,125,25,101,264,24
2175352,39,24,1974,2,"female",500,24,20,14,9,13,4,1,5
2175410,54,31,1959,3,"female",1641,371,175,351,308,351,203,0,105
2175427,20,19,1993,12,"male",782,30,0,0,2,0,1,0,1
2175428,54,18,1959,5,"male",732,56,45,148,0,148,0,0,0
2175445,16,5,1997,9,"male",52,61,60,1,0,0,0,1,0
2175447,24,11,1989,1,"male",81,97,82,985,460,985,389,0,71
2175485,38,23,1975,4,"male",432,89,25,15,88,15,38,0,50
2175487,23,9,1990,7,"male",1551,308,178,115,85,2,39,113,46
2175505,24,23,1989,1,"male",187,172,169,3,4,3,3,0,1
2175513,48,2,1965,11,"male",376,4,4,1,0,1,0,0,0
2175522,51,4,1962,6,"female",807,48,26,315,67,0,15,315,52
2175539,60,12,1953,11,"male",1592,586,194,980,1164,97,510,883,654
2175574,51,24,1962,9,"female",486,140,36,17,1,17,0,0,1
2175585,43,28,1970,8,"male",458,39,16,25,5,25,1,0,4
2175597,57,10,1956,6,"male",144,95,73,11,2,11,0,0,2
2175618,108,1,1905,11,"female",59,54,50,76,29,76,25,0,4
2175662,13,8,2000,4,"male",403,137,87,2,0,0,0,2,0
2175670,25,27,1988,5,"male",393,2,2,0,0,0,0,0,0
2175694,20,13,1993,6,"female",559,503,361,29,66,29,50,0,16
2175695,52,21,1961,4,"male",1210,231,170,4,95,4,76,0,19
2175698,28,17,1985,8,"male",539,346,302,16,89,16,74,0,15
2175702,23,23,1990,11,"female",165,145,133,206,68,206,46,0,22
2175723,38,28,1975,12,"male",1841,103,18,4,0,4,0,0,0
2175762,16,9,1997,7,"male",328,507,312,647,134,124,49,523,85
2175862,17,10,1996,9,"male",136,53,48,2,0,1,0,1,0
2175870,49,31,1964,3,"male",264,170,84,39,44,8,24,31,20
2175872,15,23,1998,3,"male",300,4,4,0,0,0,0,0,0
2175883,20,9,1993,4,"female",418,222,198,1,0,1,0,0,0
2175915,14,2,1999,10,"female",285,45,21,106,14,48,3,58,11
2175924,94,5,1919,11,"female",1129,968,100,272,203,105,136,167,67
2175926,27,16,1986,4,"female",470,42,23,0,0,0,0,0,0
2175928,31,27,1982,8,"female",665,1,0,1,2,0,0,1,2
2175931,108,1,1905,1,"male",1531,229,126,16,4,0,3,16,1
2175941,26,19,1987,11,"female",314,109,80,2,1,2,1,0,0
2175953,94,9,1919,11,"female",1499,52,19,27,0,27,0,0,0
2175961,77,18,1936,5,"male",141,408,365,891,450,891,386,0,64
2175992,58,10,1955,10,"male",503,281,49,253,22,0,1,253,21
2176009,26,1,1987,1,"male",319,8,5,0,0,0,0,0,0
2176011,20,25,1993,4,"male",135,169,134,0,0,0,0,0,0
2176026,72,1,1941,7,"male",398,31,17,51,18,49,10,2,8
2176028,33,31,1980,10,"male",182,80,61,6,2,6,2,0,0
2176059,78,28,1935,8,"female",1960,123,84,4,0,0,0,4,0
2176069,26,20,1987,5,"male",188,106,84,1,1,1,0,0,1
2176083,19,7,1994,11,"female",630,113,50,292,313,100,199,192,114
2176092,58,8,1955,12,"female",1664,23,12,93,81,86,70,7,11
2176115,29,13,1984,4,"female",655,222,196,44,30,18,8,26,22
2176117,100,4,1913,12,"male",162,66,62,0,0,0,0,0,0
2176123,30,17,1983,4,"male",952,46,27,19,62,19,58,0,4
2176145,29,7,1984,3,"female",18,18,17,1,1,0,1,1,0
2176191,30,18,1983,5,"male",471,128,92,3,2,3,0,0,2
2176204,19,24,1994,10,"female",594,92,35,2,8,2,3,0,5
2176259,51,3,1962,2,"male",77,38,35,4,4,1,4,3,0
2176268,25,1,1988,1,"male",122,64,39,14,2,14,2,0,0
2176300,21,7,1992,9,"male",248,103,74,8,6,8,5,0,1
2176354,46,15,1967,2,"female",359,389,309,424,161,3,57,421,104
2176363,62,13,1951,8,"male",725,53,29,1,1,0,0,1,1
2176379,47,9,1966,4,"female",608,1124,950,4452,1399,4439,943,13,456
2176428,16,24,1997,4,"male",451,91,87,151,24,151,14,0,10
2176476,37,19,1976,1,"male",141,24,18,37,10,37,5,0,5
2176486,35,20,1978,4,"female",274,72,52,174,143,0,42,174,101
2176502,25,5,1988,3,"male",40,0,0,0,0,0,0,0,0
2176537,81,9,1932,4,"female",5,17,9,6,10,1,8,5,2
2176572,50,27,1963,6,"female",252,25,13,278,24,278,4,0,20
2176608,32,21,1981,6,"female",536,65,34,21,141,21,138,0,3
2176611,27,19,1986,5,"male",14,21,21,0,0,0,0,0,0
2176644,28,19,1985,10,"female",245,140,46,0,0,0,0,0,0
2176690,34,6,1979,10,"male",154,296,275,825,198,825,185,0,13
2176704,103,11,1910,10,"male",1487,405,162,1355,848,129,253,1226,595
2176719,59,29,1954,1,"female",751,78,47,45,25,0,8,45,17
2176739,42,5,1971,7,"male",148,50,33,114,102,114,68,0,34
2176761,26,13,1987,6,"male",183,264,249,3,23,3,23,0,0
2176817,36,11,1977,9,"male",503,11,2,0,0,0,0,0,0
2176824,16,10,1997,1,"female",412,59,33,187,119,187,102,0,17
2176826,19,17,1994,12,"male",304,0,0,0,0,0,0,0,0
2176849,26,4,1987,4,"male",1271,81,41,4,1,4,1,0,0
2176862,34,17,1979,4,"female",1365,237,117,120,90,120,87,0,3
2176872,82,6,1931,7,"female",1563,79,18,145,23,0,7,145,16
2176879,22,5,1991,10,"female",419,626,432,56,370,56,324,0,46
2176880,20,9,1993,6,"male",662,111,31,17,14,17,14,0,0
2176889,53,28,1960,2,"female",1085,195,130,2086,1098,0,287,2086,811
2176895,23,31,1990,10,"male",404,115,112,20,5,20,5,0,0
2176903,52,15,1961,9,"female",186,62,35,4,12,1,1,3,11
2176917,38,1,1975,5,"male",191,69,41,1,13,1,8,0,5
2176924,28,13,1985,10,"female",402,322,255,250,212,134,62,116,150
2176935,56,14,1957,6,"male",458,27,21,7,0,7,0,0,0
2176952,43,8,1970,7,"female",1003,227,129,2649,2369,2649,1317,0,1052
2176954,26,28,1987,9,"female",303,39,25,3,7,1,3,2,4
2176965,22,23,1991,6,"male",300,333,308,0,0,0,0,0,0
2177048,39,26,1974,9,"female",293,9,6,0,0,0,0,0,0
2177050,58,26,1955,12,"female",269,56,33,20,15,2,10,18,5
2177064,17,29,1996,8,"male",163,75,66,9,0,9,0,0,0
2177096,16,6,1997,12,"male",558,1094,839,1138,263,1138,225,0,38
2177110,48,11,1965,5,"female",230,214,141,35,18,34,7,1,11
2177114,23,14,1990,7,"female",35,100,71,137,97,137,80,0,17
2177123,16,16,1997,9,"female",312,929,377,955,830,953,651,2,179
2177140,40,11,1973,2,"male",880,34,13,6,2,6,0,0,2
2177149,29,6,1984,8,"female",849,977,678,280,512,57,137,223,375
2177153,21,17,1992,1,"male",223,12,7,0,0,0,0,0,0
2177154,16,21,1997,2,"male",920,273,153,1,3,1,2,0,1
2177156,56,24,1957,1,"male",689,186,115,8,9,8,9,0,0
2177165,47,17,1966,9,"male",510,200,80,150,167,150,137,0,30
2177206,62,18,1951,2,"female",647,12,12,1,8,0,7,1,1
2177226,24,3,1989,1,"female",149,71,47,188,48,41,33,147,15
2177228,54,30,1959,3,"female",265,24,13,2,14,0,3,2,11
2177233,33,28,1980,4,"male",339,79,66,49,115,49,85,0,30
2177252,15,22,1998,4,"male",321,897,660,1075,967,1003,708,72,259
2177263,13,1,2000,3,"male",215,361,259,28,9,28,6,0,3
2177272,23,1,1990,7,"female",70,28,21,26,50,24,37,2,13
2177288,33,29,1980,7,"female",465,84,43,0,17,0,10,0,7
2177305,40,14,1973,8,"female",747,101,54,154,25,148,23,6,2
2177343,29,18,1984,2,"female",1338,252,98,223,327,126,254,97,73
2177389,22,11,1991,6,"male",741,255,234,1,0,1,0,0,0
2177427,38,30,1975,12,"male",243,0,0,0,0,0,0,0,0
2177430,14,10,1999,10,"male",350,300,98,23,9,23,6,0,3
2177433,18,3,1995,3,"male",76,140,136,2,1,0,1,2,0
2177445,61,18,1952,3,"female",172,12,7,6,1,5,1,1,0
2177448,16,4,1997,1,"male",283,210,44,0,1,0,1,0,0
2177523,24,12,1989,3,"male",56,18,17,17,13,17,12,0,1
2177524,25,19,1988,6,"male",175,66,47,1,0,1,0,0,0
2177547,30,5,1983,11,"male",164,132,91,4,10,4,10,0,0
2177588,26,6,1987,5,"female",191,582,238,4,12,0,4,4,8
2177645,23,1,1990,1,"male",313,2,1,0,0,0,0,0,0
2177669,49,27,1964,1,"male",408,147,96,4,9,0,0,4,9
2177679,75,14,1938,11,"female",950,9,1,1,8,0,6,1,2
2177685,25,26,1988,3,"female",451,17,2,0,3,0,1,0,2
2177713,48,30,1965,11,"female",80,168,146,71,16,71,11,0,5
2177816,22,18,1991,5,"male",449,111,44,20,18,20,11,0,7
2177844,19,1,1994,1,"male",196,182,172,4,0,0,0,4,0
2177849,18,2,1995,5,"female",767,1059,229,1754,4434,678,1294,1076,3140
2177851,35,1,1978,5,"male",185,39,31,2,0,2,0,0,0
2177855,52,26,1961,6,"male",893,86,49,1,4,1,4,0,0
2177858,15,8,1998,10,"male",5,41,23,2,0,2,0,0,0
2177887,68,4,1945,5,"male",155,130,44,0,1,0,1,0,0
2177908,60,16,1953,8,"male",626,106,55,24,5,0,2,24,3
2177918,18,17,1995,4,"male",505,645,599,51,150,51,115,0,35
2177928,60,22,1953,3,"female",13,30,24,28,54,28,38,0,16
2177939,40,17,1973,2,"female",248,4,3,1,0,1,0,0,0
2177941,25,7,1988,6,"female",1111,46,36,2,4,2,4,0,0
2177945,113,10,1900,10,"male",1418,655,172,148,542,43,337,105,205
2178003,18,24,1995,10,"male",234,86,30,0,1,0,1,0,0
2178005,43,12,1970,1,"male",360,20,19,2,1,0,0,2,1
2178013,45,1,1968,5,"male",743,26,4,5,2,5,2,0,0
2178037,19,12,1994,11,"female",373,38,31,0,0,0,0,0,0
2178059,60,21,1953,9,"female",1851,43,13,132,48,6,19,126,29
2178090,25,1,1988,1,"male",440,14,9,3,0,1,0,2,0
2178133,21,2,1992,8,"female",255,584,327,24,195,21,105,3,90
2178136,24,30,1989,11,"male",597,143,103,0,0,0,0,0,0
2178147,80,1,1933,8,"female",794,264,95,0,0,0,0,0,0
2178160,35,3,1978,12,"male",236,2,2,33,11,0,0,33,11
2178176,26,3,1987,5,"male",359,10,9,2,0,2,0,0,0
2178180,29,1,1984,1,"female",326,94,50,1,0,1,0,0,0
2178194,25,22,1988,11,"male",212,156,133,0,1,0,1,0,0
2178232,19,23,1994,3,"male",308,1,1,2,0,0,0,2,0
2178259,45,21,1968,5,"female",438,37,25,26,63,0,3,26,60
2178270,59,15,1954,4,"female",319,67,43,146,2,146,2,0,0
2178291,18,23,1995,11,"male",139,504,453,93,94,93,84,0,10
2178321,50,10,1963,4,"male",840,262,186,152,154,64,89,88,65
2178340,44,6,1969,11,"male",315,57,32,209,169,196,151,13,18
2178368,89,11,1924,12,"male",1923,312,155,34,57,24,15,10,42
2178409,103,14,1910,9,"male",808,290,128,1,32,1,23,0,9
2178412,42,27,1971,3,"female",586,99,55,42,13,11,1,31,12
2178413,45,27,1968,11,"male",410,204,104,86,65,43,53,43,12
2178414,23,28,1990,2,"male",946,99,22,2,1,0,1,2,0
2178422,63,22,1950,12,"male",439,7,4,1,0,0,0,1,0
2178431,19,11,1994,2,"male",213,116,106,54,3,47,2,7,1
2178444,29,8,1984,5,"male",460,0,0,0,0,0,0,0,0
2178459,23,27,1990,10,"male",535,142,118,150,37,80,19,70,18
2178460,44,14,1969,1,"female",291,56,30,0,0,0,0,0,0
2178468,31,17,1982,9,"male",327,6,2,7,1,7,1,0,0
2178482,18,9,1995,2,"female",437,1822,870,3181,5459,2413,3432,768,2027
2178519,32,16,1981,9,"female",326,105,92,37,11,37,4,0,7
2178526,15,11,1998,9,"male",321,400,305,22,29,3,5,19,24
2178543,20,8,1993,6,"male",426,185,144,62,12,19,6,43,6
2178550,42,14,1971,4,"male",171,47,8,1,8,0,7,1,1
2178556,29,1,1984,8,"female",121,38,18,1270,27,1270,20,0,7
2178563,101,10,1912,10,"male",1715,228,121,43,25,4,14,39,11
2178583,15,10,1998,1,"male",97,99,57,6,1,3,0,3,1
2178594,13,24,2000,4,"female",82,20,17,2,5,2,5,0,0
2178605,55,15,1958,8,"female",638,108,55,0,0,0,0,0,0
2178636,83,19,1930,10,"female",1339,15,0,0,0,0,0,0,0
2178668,23,1,1990,1,"male",178,26,18,3,0,0,0,3,0
2178681,18,21,1995,1,"female",561,883,303,177,252,120,97,57,155
2178705,36,20,1977,9,"female",211,18,12,6,0,6,0,0,0
2178726,34,3,1979,5,"male",493,10,9,0,0,0,0,0,0
2178736,74,9,1939,11,"female",1118,67,50,203,27,203,16,0,11
2178756,64,2,1949,5,"male",420,28,19,3,1,0,0,3,1
2178771,14,31,1999,12,"male",37,128,26,61,19,58,18,3,1
2178802,16,28,1997,10,"female",594,746,497,96,60,7,18,89,42
2178814,39,9,1974,4,"male",638,3,2,0,0,0,0,0,0
2178827,26,20,1987,5,"male",1033,29,22,18,4,18,1,0,3
2178844,108,22,1905,8,"female",181,18,15,0,0,0,0,0,0
2178856,61,20,1952,1,"female",586,79,47,23,117,23,56,0,61
2178857,23,5,1990,5,"female",402,247,35,0,0,0,0,0,0
2178860,76,25,1937,12,"male",1325,20,16,1,1,0,1,1,0
2178890,49,12,1964,2,"male",213,5,5,1,1,1,1,0,0
2178897,78,2,1935,10,"female",154,4,3,0,0,0,0,0,0
2178899,98,18,1915,4,"female",409,1656,84,4149,2577,4149,1929,0,648
2178900,68,14,1945,11,"male",347,662,563,8,13,6,11,2,2
2178906,60,11,1953,9,"male",1856,11,4,0,0,0,0,0,0
2178929,16,2,1997,11,"male",358,262,205,2,1,0,1,2,0
2178958,46,1,1967,5,"male",292,59,34,41,37,38,17,3,20
2178983,23,29,1990,8,"male",386,33,30,0,9,0,6,0,3
2179001,42,20,1971,2,"female",604,81,51,0,4,0,4,0,0
2179003,30,16,1983,4,"female",355,7,3,0,0,0,0,0,0
2179075,73,8,1940,2,"female",1139,16,8,3,2,0,1,3,1
2179084,15,24,1998,7,"male",16,29,20,1,5,1,4,0,1
2179087,25,1,1988,1,"male",164,46,30,3,4,3,2,0,2
2179113,40,22,1973,2,"male",382,32,3,0,0,0,0,0,0
2179144,51,17,1962,9,"female",1072,170,80,26,181,10,39,16,142
2179184,62,28,1951,4,"male",194,0,0,0,0,0,0,0,0
2179200,26,19,1987,8,"male",22,22,20,57,1,0,0,57,1
2179210,65,23,1948,4,"female",780,324,239,89,164,0,65,89,99
2179217,19,16,1994,6,"male",562,7,2,0,0,0,0,0,0
2179222,21,1,1992,5,"male",388,6,5,0,0,0,0,0,0
2179259,55,27,1958,5,"female",1076,62,33,45,30,45,15,0,15
2179318,15,5,1998,6,"male",270,210,34,186,97,186,71,0,26
2179324,63,12,1950,9,"male",1810,16,7,4,1,1,0,3,1
2179343,15,27,1998,4,"male",186,54,46,19,30,19,18,0,12
2179348,107,5,1906,2,"male",1451,65,10,43,1,2,1,41,0
2179357,45,19,1968,9,"male",876,106,82,640,9,640,7,0,2
2179385,56,16,1957,4,"male",173,11,4,9,12,9,12,0,0
2179394,108,1,1905,12,"male",1116,527,304,80,392,80,361,0,31
2179423,30,21,1983,10,"female",559,185,98,2,9,2,8,0,1
2179445,20,24,1993,12,"female",355,152,93,16,15,16,15,0,0
2179477,20,1,1993,1,"male",24,103,95,56,2,56,2,0,0
2179507,45,8,1968,11,"male",656,53,31,12,1,12,0,0,1
2179520,19,6,1994,1,"male",538,18,15,0,1,0,0,0,1
2179533,25,23,1988,4,"male",204,87,65,1,1,1,1,0,0
2179538,32,13,1981,4,"male",382,8,5,0,0,0,0,0,0
2179565,19,10,1994,8,"male",244,236,212,1,0,1,0,0,0
2179604,24,10,1989,5,"female",279,58,36,0,0,0,0,0,0
2179620,18,22,1995,4,"female",300,349,189,17,12,17,8,0,4
2179626,20,9,1993,6,"male",945,515,318,2,0,2,0,0,0
2179649,70,4,1943,6,"female",1524,35,19,0,1,0,0,0,1
2179666,45,25,1968,7,"male",405,64,27,9,10,9,5,0,5
2179667,15,22,1998,9,"female",795,1586,705,1378,1743,529,1011,849,732
2179684,21,5,1992,3,"male",631,88,16,0,0,0,0,0,0
2179710,24,9,1989,12,"female",559,130,8,4,0,4,0,0,0
2179743,24,12,1989,5,"female",692,98,40,41,13,41,11,0,2
2179756,103,12,1910,1,"female",82,421,382,33,43,33,43,0,0
2179781,52,24,1961,8,"male",1717,565,315,967,3014,378,1778,589,1236
2179803,56,9,1957,9,"female",2267,121,51,373,374,373,325,0,49
2179821,60,29,1953,9,"female",565,15,10,0,0,0,0,0,0
2179839,41,1,1972,1,"male",32,9,7,0,0,0,0,0,0
2179871,33,2,1980,7,"male",147,6,1,4,6,4,6,0,0
2179872,31,9,1982,9,"male",704,544,294,30,51,30,32,0,19
2179880,28,27,1985,10,"male",290,35,29,32,34,29,18,3,16
2179896,16,28,1997,4,"female",66,0,0,0,0,0,0,0,0
2179932,30,28,1983,3,"female",150,14,9,21,33,20,25,1,8
2179982,32,1,1981,3,"female",632,1,0,15,0,15,0,0,0
2179984,72,8,1941,5,"male",1329,133,61,30,13,1,5,29,8
2179999,66,20,1947,12,"female",449,69,57,1,6,0,1,1,5
2180015,49,18,1964,5,"male",1320,2036,1588,940,503,215,251,725,252
2180017,25,4,1988,4,"female",359,79,48,135,81,60,68,75,13
2180019,67,4,1946,8,"female",713,172,145,86,28,0,10,86,18
2180027,18,20,1995,11,"male",510,145,63,73,42,73,23,0,19
2180042,18,6,1995,11,"male",43,189,158,3,51,3,37,0,14
2180073,26,11,1987,5,"male",594,28,18,12,45,12,37,0,8
2180100,22,15,1991,4,"female",613,9,7,64,4,0,4,64,0
2180107,62,2,1951,9,"female",1323,63,38,1,2,1,2,0,0
2180109,20,23,1993,9,"male",557,549,322,0,15,0,5,0,10
2180133,23,12,1990,2,"female",26,3,3,0,0,0,0,0,0
2180149,19,10,1994,6,"male",1032,260,188,0,0,0,0,0,0
2180161,18,10,1995,12,"male",210,173,86,124,35,124,23,0,12
2180162,27,29,1986,8,"male",519,15,12,0,0,0,0,0,0
2180167,108,12,1905,3,"male",389,84,77,0,0,0,0,0,0
2180171,25,30,1988,10,"female",354,77,44,11,7,11,7,0,0
2180175,17,10,1996,6,"female",430,1,1,0,0,0,0,0,0
2180247,18,10,1995,7,"female",286,3,2,0,0,0,0,0,0
2180253,25,9,1988,10,"female",21,24,15,5,3,5,3,0,0
2180262,70,23,1943,6,"female",355,20,16,6,8,6,3,0,5
2180268,27,7,1986,1,"female",707,293,199,221,346,165,137,56,209
2180270,108,1,1905,1,"male",1236,155,60,394,40,0,9,394,31
2180281,43,12,1970,12,"female",1248,245,176,1074,694,406,290,668,404
2180300,44,3,1969,12,"male",338,67,66,19,7,19,5,0,2
2180356,25,4,1988,9,"male",59,3,1,0,0,0,0,0,0
2180364,20,27,1993,9,"female",694,288,152,460,434,391,264,69,170
2180369,26,1,1987,1,"female",578,0,0,0,0,0,0,0,0
2180374,24,25,1989,8,"male",526,2,1,0,0,0,0,0,0
2180390,20,21,1993,12,"female",327,161,122,30,30,9,19,21,11
2180393,42,13,1971,12,"male",35,25,18,2,0,0,0,2,0
2180406,30,17,1983,10,"male",519,43,16,4,0,4,0,0,0
2180415,21,21,1992,9,"female",1457,473,82,160,802,158,661,2,141
2180424,25,17,1988,6,"female",431,321,283,432,1021,429,834,3,187
2180502,50,22,1963,7,"female",900,24,14,2,0,2,0,0,0
2180518,53,2,1960,5,"male",867,42,23,4,0,3,0,1,0
2180520,19,15,1994,1,"female",305,48,36,117,13,117,3,0,10
2180560,63,3,1950,8,"male",1178,18,4,16,3,0,1,16,2
2180617,15,22,1998,8,"male",184,150,142,43,0,0,0,43,0
2180622,24,2,1989,2,"male",219,106,92,0,0,0,0,0,0
2180623,18,23,1995,8,"male",587,22,21,61,72,58,15,3,57
2180635,45,24,1968,5,"male",349,15,14,10,5,10,2,0,3
2180649,21,2,1992,1,"male",28,2,1,0,0,0,0,0,0
2180673,44,3,1969,12,"female",186,52,30,3,0,3,0,0,0
2180701,23,16,1990,6,"female",742,102,46,410,160,0,56,410,104
2180702,76,12,1937,1,"female",1105,69,21,72,56,0,33,72,23
2180705,54,26,1959,7,"female",381,162,103,35,1,0,0,35,1
2180715,31,17,1982,10,"female",570,147,84,16,33,0,9,16,24
2180754,13,8,2000,8,"male",528,198,88,11,50,9,33,2,17
2180783,27,12,1986,2,"male",295,29,18,5,4,5,1,0,3
2180803,15,8,1998,12,"female",12,6,6,0,0,0,0,0,0
2180812,17,8,1996,1,"female",163,526,369,2016,817,42,554,1974,263
2180877,47,17,1966,6,"male",318,146,115,0,0,0,0,0,0
2180881,46,22,1967,5,"male",792,275,216,1,0,1,0,0,0
2180884,24,3,1989,11,"female",447,118,72,1,2,1,1,0,1
2180910,30,12,1983,4,"female",404,142,129,6,9,5,1,1,8
2180925,17,4,1996,7,"female",154,222,213,301,221,301,217,0,4
2180945,28,1,1985,6,"male",439,87,54,1886,794,1886,476,0,318
2180946,64,12,1949,7,"male",1377,8,3,0,0,0,0,0,0
2180974,68,16,1945,9,"male",990,22,8,5,2,0,0,5,2
2180979,19,20,1994,9,"male",804,371,260,0,1,0,0,0,1
2181004,19,5,1994,2,"male",753,21,14,14,0,14,0,0,0
2181007,50,15,1963,2,"male",319,57,35,2,7,2,4,0,3
2181010,16,15,1997,11,"male",34,115,114,3,1,2,1,1,0
2181011,50,28,1963,10,"male",430,2,2,0,0,0,0,0,0
2181019,51,25,1962,6,"male",266,237,166,76,11,76,8,0,3
2181022,15,23,1998,1,"male",98,22,17,0,0,0,0,0,0
2181090,61,15,1952,11,"male",429,26,9,0,4,0,3,0,1
2181095,28,24,1985,6,"female",482,119,89,2,5,2,3,0,2
2181116,25,23,1988,6,"female",285,40,14,0,26,0,23,0,3
2181149,27,24,1986,4,"female",1241,292,148,32,2,2,0,30,2
2181186,43,25,1970,11,"male",573,496,330,30,128,18,38,12,90
2181259,13,24,2000,3,"male",101,30,20,2,4,2,0,0,4
2181269,28,3,1985,3,"male",437,1,1,0,0,0,0,0,0
2181273,31,13,1982,2,"male",1003,9,7,0,0,0,0,0,0
2181289,35,17,1978,3,"female",378,103,75,489,60,489,11,0,49
2181314,29,16,1984,3,"male",462,41,20,61,18,61,16,0,2
2181323,28,2,1985,2,"male",383,60,30,1,6,1,5,0,1
2181325,26,11,1987,2,"male",487,53,12,0,1,0,0,0,1
2181361,16,15,1997,1,"female",14,25,22,1,0,1,0,0,0
2181396,20,15,1993,7,"male",566,528,461,4,2,4,1,0,1
2181411,16,30,1997,12,"female",385,221,87,249,147,8,35,241,112
2181415,33,15,1980,7,"female",90,0,0,0,0,0,0,0,0
2181428,63,20,1950,1,"female",2035,56,26,14,1,14,1,0,0
2181440,17,2,1996,2,"male",386,140,112,0,0,0,0,0,0
2181465,20,15,1993,11,"male",442,209,154,1487,1257,1449,521,38,736
2181486,61,28,1952,9,"male",537,145,67,252,104,245,41,7,63
2181502,43,18,1970,3,"male",754,60,43,33,21,33,10,0,11
2181533,50,1,1963,5,"female",938,2,1,2,0,0,0,2,0
2181548,51,20,1962,4,"male",383,30,16,0,0,0,0,0,0
2181574,30,1,1983,1,"male",835,32,20,0,0,0,0,0,0
2181579,50,13,1963,4,"female",1658,209,135,385,188,298,92,87,96
2181587,99,13,1914,12,"male",1080,376,168,183,59,183,37,0,22
2181588,23,11,1990,8,"female",19,117,4,76,118,76,77,0,41
2181590,108,19,1905,12,"male",13,21,17,0,1,0,0,0,1
2181604,18,16,1995,3,"male",23,0,0,0,0,0,0,0,0
2181606,40,21,1973,12,"male",119,113,98,176,2,176,2,0,0
2181610,49,12,1964,10,"male",802,156,67,25,12,0,3,25,9
2181634,50,21,1963,8,"female",1053,39,17,35,12,35,12,0,0
2181637,66,16,1947,2,"male",662,23,15,0,0,0,0,0,0
2181651,37,10,1976,4,"male",135,36,27,6,1,0,1,6,0
2181712,44,6,1969,11,"female",141,9,3,0,2,0,1,0,1
2181750,31,23,1982,5,"male",464,38,24,0,0,0,0,0,0
2181793,20,15,1993,5,"male",252,196,93,2,2,1,1,1,1
2181794,15,21,1998,2,"male",220,107,67,2,0,2,0,0,0
2181803,42,14,1971,7,"female",517,0,0,0,0,0,0,0,0
2181819,54,2,1959,9,"female",1004,255,110,2323,740,0,306,2323,434
2181825,16,23,1997,3,"male",217,412,391,219,14,219,14,0,0
2181836,20,17,1993,7,"male",56,286,278,156,242,156,193,0,49
2181866,22,10,1991,1,"female",177,38,17,2,5,2,2,0,3
2181868,17,7,1996,7,"male",114,12,9,4,0,4,0,0,0
2181890,30,2,1983,9,"male",27,29,23,41,56,4,4,37,52
2181891,23,28,1990,8,"male",330,116,82,9,12,9,9,0,3
2181897,21,7,1992,7,"male",714,226,116,8,1,7,1,1,0
2181913,49,16,1964,8,"male",1007,259,167,34,0,31,0,3,0
2181932,35,3,1978,11,"female",247,126,73,151,163,151,97,0,66
2181944,74,1,1939,9,"male",923,50,35,125,74,125,29,0,45
2181951,17,19,1996,9,"female",40,7,2,3,1,3,1,0,0
2181959,18,19,1995,1,"male",249,135,95,0,0,0,0,0,0
2181968,24,22,1989,7,"male",262,2,1,1,0,1,0,0,0
2182017,57,6,1956,8,"male",573,20,14,1,0,1,0,0,0
2182031,23,17,1990,6,"male",177,13,6,0,0,0,0,0,0
2182038,17,11,1996,10,"male",384,267,59,0,0,0,0,0,0
2182052,17,13,1996,7,"male",125,22,20,10,16,10,9,0,7
2182061,15,24,1998,4,"female",347,5,5,0,0,0,0,0,0
2182086,14,15,1999,9,"male",280,54,35,2,1,2,1,0,0
2182095,16,6,1997,10,"male",588,559,471,1,21,1,18,0,3
2182113,68,26,1945,6,"male",149,109,88,0,0,0,0,0,0
2182115,26,6,1987,11,"male",358,36,16,1,264,0,61,1,203
2182122,47,2,1966,3,"female",332,58,36,71,156,52,119,19,37
2182123,33,6,1980,4,"male",178,42,34,0,15,0,12,0,3
2182135,33,10,1980,10,"male",613,13,12,0,0,0,0,0,0
2182165,51,22,1962,2,"male",370,297,243,563,74,407,37,156,37
2182173,30,23,1983,3,"male",599,0,0,0,0,0,0,0,0
2182206,28,16,1985,8,"male",331,75,49,8,1,8,1,0,0
2182224,19,30,1994,5,"male",1666,248,147,41,22,41,16,0,6
2182238,18,24,1995,9,"male",119,361,295,0,56,0,30,0,26
2182247,22,16,1991,7,"female",92,620,532,121,493,121,463,0,30
2182336,27,3,1986,10,"female",416,153,89,455,203,0,34,455,169
2182338,69,14,1944,6,"male",400,25,11,1,2,1,2,0,0
2182342,15,24,1998,11,"female",162,158,97,40,42,0,20,40,22
2182353,65,1,1948,3,"female",22,31,18,2,9,0,5,2,4
2182370,30,17,1983,3,"female",302,335,123,428,219,30,189,398,30
2182469,81,18,1932,1,"female",497,16,11,1,0,1,0,0,0
2182478,20,8,1993,4,"male",155,172,93,0,3,0,0,0,3
2182507,20,23,1993,1,"female",432,1,0,0,0,0,0,0,0
2182512,27,20,1986,12,"male",72,19,15,1,0,0,0,1,0
2182521,85,21,1928,5,"male",1082,1954,1185,610,663,580,580,30,83
2182544,19,29,1994,4,"male",312,24,24,1,0,0,0,1,0
2182572,21,10,1992,12,"female",76,18,14,1,0,1,0,0,0
2182601,25,10,1988,6,"male",309,26,12,0,0,0,0,0,0
2182609,25,19,1988,5,"male",586,116,61,9,8,9,4,0,4
2182616,22,1,1991,1,"male",760,1932,1068,8,60,6,27,2,33
2182619,14,17,1999,5,"female",171,1020,330,208,703,143,467,65,236
2182655,20,19,1993,10,"male",638,1116,554,343,208,343,194,0,14
2182701,67,12,1946,1,"female",260,107,69,24,31,17,21,7,10
2182732,23,5,1990,4,"male",175,78,63,0,0,0,0,0,0
2182750,55,8,1958,12,"male",1685,53,25,5,2,2,1,3,1
2182790,18,1,1995,1,"male",401,212,167,1,9,1,9,0,0
2182816,20,19,1993,9,"female",354,394,238,169,102,169,28,0,74
2182838,20,20,1993,8,"male",353,318,249,111,169,96,75,15,94
2182840,26,31,1987,8,"female",628,78,39,39,32,39,31,0,1
2182846,27,6,1986,4,"male",412,54,41,12,28,12,12,0,16
2182882,38,6,1975,5,"male",410,6,4,1,0,1,0,0,0
2182900,22,14,1991,3,"male",406,210,90,0,0,0,0,0,0
2182908,17,13,1996,11,"male",519,115,98,32,0,27,0,5,0
2182911,23,1,1990,5,"female",607,78,19,53,114,32,22,21,92
2182916,96,1,1917,1,"female",568,556,79,337,550,337,495,0,55
2182942,20,4,1993,2,"male",473,83,39,0,0,0,0,0,0
2182949,23,1,1990,10,"male",464,52,39,20,0,19,0,1,0
2182953,24,1,1989,4,"female",602,76,60,3,3,3,3,0,0
2182958,14,23,1999,1,"male",36,54,24,44,3,1,0,43,3
2182977,64,7,1949,7,"female",515,82,73,1,9,0,4,1,5
2182981,24,17,1989,4,"male",431,8,2,0,0,0,0,0,0
2182992,63,14,1950,9,"male",1769,44,7,0,0,0,0,0,0
2183080,103,18,1910,11,"female",365,642,224,28,66,28,61,0,5
2183105,40,12,1973,9,"male",671,107,61,2,6,2,5,0,1
2183109,26,21,1987,5,"male",189,47,23,26,24,26,19,0,5
2183114,52,14,1961,9,"female",1007,22,8,67,35,67,20,0,15
2183177,27,3,1986,6,"male",190,33,23,0,0,0,0,0,0
2183201,58,12,1955,7,"male",547,220,140,30,68,0,13,30,55
2183224,68,7,1945,7,"female",540,62,33,1,0,1,0,0,0
2183234,26,1,1987,2,"male",149,6,4,0,0,0,0,0,0
2183255,112,1,1901,1,"male",2100,158,65,0,2,0,2,0,0
2183259,22,19,1991,1,"male",637,42,28,3,15,3,13,0,2
2183296,18,17,1995,3,"female",153,99,87,5,49,2,4,3,45
2183300,73,16,1940,12,"female",90,49,31,0,0,0,0,0,0
2183339,17,27,1996,8,"female",800,682,568,2130,1237,1855,522,275,715
2183344,28,30,1985,1,"male",466,289,229,310,928,50,460,260,468
2183365,67,23,1946,8,"female",487,72,50,1,33,0,24,1,9
2183367,22,18,1991,10,"male",195,41,24,0,0,0,0,0,0
2183384,31,9,1982,7,"male",612,124,91,2,10,2,6,0,4
2183398,25,16,1988,5,"female",16,31,29,17,13,17,12,0,1
2183454,26,22,1987,10,"male",532,18,10,0,0,0,0,0,0
2183458,28,3,1985,1,"male",374,184,112,111,24,111,19,0,5
2183475,39,27,1974,11,"female",699,532,404,671,621,671,509,0,112
2183491,17,1,1996,10,"male",51,27,25,6,0,6,0,0,0
2183552,16,11,1997,8,"female",390,0,0,0,0,0,0,0,0
2183584,113,1,1900,1,"male",1173,542,332,4,130,0,27,4,103
2183619,33,1,1980,1,"male",342,26,16,1,0,1,0,0,0
2183628,18,1,1995,2,"male",166,1,1,10,0,10,0,0,0
2183634,80,8,1933,7,"male",728,15,14,0,0,0,0,0,0
2183668,63,26,1950,9,"female",697,51,35,9,7,2,2,7,5
2183694,46,3,1967,4,"male",475,253,215,0,0,0,0,0,0
2183698,30,1,1983,1,"male",227,755,123,464,1021,464,900,0,121
2183711,18,21,1995,11,"male",294,30,23,1,0,1,0,0,0
2183728,16,21,1997,7,"male",320,47,36,0,0,0,0,0,0
2183732,40,13,1973,4,"female",328,26,15,75,15,50,12,25,3
2183737,19,29,1994,3,"male",342,79,52,7,2,7,1,0,1
2183743,38,13,1975,3,"male",621,1,0,0,0,0,0,0,0
2183751,55,30,1958,5,"male",1576,46,26,20,11,3,9,17,2
2183776,18,29,1995,8,"female",350,1567,40,15,6,15,4,0,2
2183783,25,10,1988,5,"male",433,157,136,132,151,87,59,45,92
2183787,30,28,1983,2,"female",187,138,112,161,159,161,51,0,108
2183818,26,1,1987,8,"male",206,261,61,339,400,326,202,13,198
2183826,20,28,1993,10,"male",247,145,64,310,102,310,73,0,29
2183842,17,3,1996,11,"male",175,32,25,0,0,0,0,0,0
2183865,17,2,1996,5,"female",560,802,499,105,149,40,50,65,99
2183867,26,9,1987,8,"male",793,95,61,0,0,0,0,0,0
2183893,94,12,1919,9,"male",980,310,206,15,5,15,5,0,0
2183899,24,10,1989,6,"female",193,141,6,11,5,0,5,11,0
2183913,36,3,1977,9,"female",596,26,8,951,1173,818,150,133,1023
2183927,18,28,1995,10,"female",703,52,47,614,94,614,91,0,3
2183937,17,20,1996,9,"female",424,188,84,261,256,70,41,191,215
2184025,26,11,1987,11,"male",5,1,1,0,0,0,0,0,0
2184099,103,23,1910,11,"male",975,713,466,123,147,89,123,34,24
2184113,58,26,1955,3,"male",671,34,24,27,3,27,3,0,0
2184139,19,6,1994,10,"female",237,205,116,370,342,80,123,290,219
2184147,59,1,1954,12,"male",739,42,28,11,28,0,5,11,23
2184173,103,17,1910,10,"male",1161,634,233,91,268,79,179,12,89
2184200,19,29,1994,6,"male",359,54,39,7,3,7,3,0,0
2184203,66,25,1947,6,"male",2031,193,84,0,0,0,0,0,0
2184209,18,18,1995,11,"male",184,1,0,0,0,0,0,0,0
2184238,56,24,1957,5,"female",462,58,25,303,148,0,96,303,52
2184239,55,8,1958,4,"female",1114,129,73,25,54,25,23,0,31
2184245,24,8,1989,1,"male",56,15,9,0,0,0,0,0,0
2184248,16,1,1997,2,"female",94,95,57,65,16,65,11,0,5
2184289,22,22,1991,5,"female",469,157,25,34,81,34,43,0,38
2184299,33,5,1980,3,"male",423,101,57,73,34,73,20,0,14
2184318,24,22,1989,3,"female",362,103,48,72,9,72,8,0,1
2184336,21,16,1992,6,"male",443,93,52,27,3,0,1,27,2
2184337,28,1,1985,12,"male",626,141,58,0,0,0,0,0,0
2184343,17,19,1996,10,"male",161,10,9,4,0,0,0,4,0
2184362,27,29,1986,10,"male",313,11,7,0,2,0,1,0,1
2184376,26,20,1987,6,"female",368,60,47,245,321,245,269,0,52
2184400,68,25,1945,11,"female",523,22,3,8,3,0,0,8,3
2184424,56,22,1957,7,"male",120,13,10,1,1,0,1,1,0
2184455,21,9,1992,6,"male",340,151,64,12,4,0,3,12,1
2184472,69,20,1944,3,"female",1426,34,16,5,9,0,2,5,7
2184478,55,1,1958,3,"male",1159,93,44,0,77,0,50,0,27
2184482,74,12,1939,8,"male",55,49,39,0,1,0,1,0,0
2184493,36,29,1977,1,"female",294,146,48,610,152,597,136,13,16
2184503,27,25,1986,1,"male",87,11,7,1,0,1,0,0,0
2184504,23,18,1990,3,"female",222,9,2,37,31,37,11,0,20
2184539,34,23,1979,2,"male",196,172,120,1,16,1,13,0,3
2184584,27,18,1986,6,"male",260,31,14,14,15,4,7,10,8
2184587,23,3,1990,7,"female",420,85,66,37,0,20,0,17,0
2184593,18,13,1995,10,"male",391,79,74,3,2,0,0,3,2
2184600,38,7,1975,7,"female",154,36,18,96,5,0,2,96,3
2184666,42,3,1971,10,"female",346,23,14,55,32,55,29,0,3
2184684,67,11,1946,8,"male",96,28,18,49,3,0,2,49,1
2184700,20,13,1993,12,"male",17,1,0,1,1,0,1,1,0
2184707,44,12,1969,7,"male",73,0,0,0,0,0,0,0,0
2184727,21,9,1992,10,"female",273,81,27,182,234,182,177,0,57
2184787,34,9,1979,4,"male",785,161,128,4,0,0,0,4,0
2184789,19,2,1994,12,"female",349,40,22,0,0,0,0,0,0
2184836,70,8,1943,8,"male",1509,37,12,0,1,0,1,0,0
2184876,30,1,1983,1,"female",454,37,16,2,4,0,0,2,4
2184880,78,17,1935,5,"male",789,38,24,0,0,0,0,0,0
2184892,15,16,1998,7,"female",233,520,140,1128,2391,973,1222,155,1169
2184913,103,8,1910,10,"female",1115,62,32,21,20,21,20,0,0
2184928,73,24,1940,10,"female",1864,163,97,54,150,51,112,3,38
2184934,103,9,1910,4,"female",960,1014,165,0,0,0,0,0,0
2184975,19,28,1994,9,"male",300,220,146,56,6,56,5,0,1
2184988,20,1,1993,10,"male",44,60,44,10,10,10,4,0,6
2185030,18,19,1995,2,"female",10,0,0,0,0,0,0,0,0
2185036,35,26,1978,8,"male",217,77,69,0,1,0,0,0,1
2185049,103,4,1910,4,"male",1598,780,396,104,289,23,163,81,126
2185053,15,11,1998,3,"male",397,188,162,171,5,171,4,0,1
2185100,42,8,1971,11,"male",463,61,27,2,12,2,11,0,1
2185198,52,9,1961,4,"female",342,85,77,13,7,2,4,11,3
2185205,59,21,1954,4,"male",371,108,20,0,0,0,0,0,0
2185211,40,16,1973,8,"male",195,0,0,0,0,0,0,0,0
2185226,72,16,1941,9,"male",655,30,23,0,0,0,0,0,0
2185247,29,25,1984,8,"male",251,251,178,8,5,8,5,0,0
2185260,48,13,1965,3,"female",138,18,6,135,79,135,59,0,20
2185270,20,7,1993,1,"female",272,23,15,279,180,90,89,189,91
2185281,54,4,1959,3,"female",1448,915,660,391,901,391,795,0,106
2185283,35,2,1978,2,"male",411,32,11,0,0,0,0,0,0
2185293,19,4,1994,10,"male",308,310,206,145,111,145,78,0,33
2185318,39,24,1974,9,"male",466,6,4,1,0,0,0,1,0
2185326,18,3,1995,7,"female",336,0,0,0,0,0,0,0,0
2185328,15,9,1998,5,"male",90,8,7,0,0,0,0,0,0
2185331,18,25,1995,12,"female",27,6,3,0,0,0,0,0,0
2185332,16,22,1997,5,"female",39,158,35,2328,1176,1678,628,650,548
2185337,55,3,1958,3,"female",1556,137,74,996,405,996,282,0,123
2185351,64,8,1949,4,"female",2098,307,123,1071,160,127,57,944,103
2185359,18,9,1995,9,"male",55,120,74,151,189,100,156,51,33
2185372,14,24,1999,3,"male",416,157,75,3,1,2,1,1,0
2185376,33,30,1980,1,"female",732,237,206,283,257,283,195,0,62
2185395,43,25,1970,6,"female",567,0,0,0,0,0,0,0,0
2185398,19,5,1994,1,"male",665,108,100,1,0,1,0,0,0
2185404,66,27,1947,1,"female",1665,129,91,211,50,210,32,1,18
2185422,51,5,1962,7,"male",117,96,62,20,25,20,15,0,10
2185438,32,27,1981,4,"male",1141,61,55,0,0,0,0,0,0
2185440,19,11,1994,12,"male",589,156,124,80,17,42,10,38,7
2185445,26,19,1987,10,"female",274,99,70,1,1,1,1,0,0
2185454,62,6,1951,11,"female",1489,268,29,572,72,570,41,2,31
2185474,19,27,1994,3,"male",580,34,18,0,0,0,0,0,0
2185509,17,2,1996,5,"female",416,247,61,19,121,19,77,0,44
2185512,47,3,1966,1,"male",2244,55,17,11,1,11,1,0,0
2185523,18,27,1995,11,"male",561,33,22,3,2,3,1,0,1
2185547,76,18,1937,6,"female",50,48,32,25,103,0,53,25,50
2185593,35,26,1978,5,"male",361,130,82,5,23,5,19,0,4
2185599,21,25,1992,3,"male",406,126,43,2,0,1,0,1,0
2185611,20,28,1993,8,"female",346,20,9,2,6,2,2,0,4
2185628,68,5,1945,9,"female",442,26,5,9,4,0,1,9,3
2185645,14,8,1999,10,"male",550,56,29,12,9,0,0,12,9
2185652,25,11,1988,12,"female",28,12,9,1,1,1,1,0,0
2185659,14,17,1999,8,"male",230,182,11,5,0,5,0,0,0
2185698,23,21,1990,9,"male",666,357,256,4,0,3,0,1,0
2185703,20,28,1993,8,"female",154,15,7,1,3,1,3,0,0
2185711,17,3,1996,11,"male",486,116,70,0,0,0,0,0,0
2185726,17,26,1996,1,"female",173,137,19,0,0,0,0,0,0
2185727,53,18,1960,11,"female",157,149,137,1,29,0,6,1,23
2185730,19,21,1994,5,"male",254,60,52,2,5,1,3,1,2
2185745,66,30,1947,1,"female",457,119,75,1,3,0,2,1,1
2185782,23,9,1990,6,"male",1535,497,302,17,3,3,0,14,3
2185826,24,9,1989,3,"female",64,38,9,66,28,66,17,0,11
2185833,35,18,1978,10,"male",530,40,22,28,22,28,15,0,7
2185856,51,18,1962,6,"female",263,134,108,3,9,3,9,0,0
2185860,21,10,1992,4,"male",513,59,27,0,9,0,4,0,5
2185891,15,7,1998,1,"male",138,239,87,24,42,24,36,0,6
2185915,17,30,1996,11,"male",417,585,226,859,1417,857,1386,2,31
2185918,21,4,1992,8,"male",10,21,12,1,3,1,3,0,0
2185937,22,19,1991,11,"female",920,219,119,50,12,50,12,0,0
2185963,18,31,1995,3,"female",326,733,33,0,0,0,0,0,0
2185971,48,29,1965,5,"male",480,100,34,63,37,0,19,63,18
2185972,55,6,1958,5,"female",1613,81,51,9,10,1,3,8,7
2185986,23,20,1990,6,"male",146,61,51,5,27,5,23,0,4
2185995,17,8,1996,8,"male",306,110,77,2,0,2,0,0,0
2185997,29,5,1984,5,"male",157,6,3,0,0,0,0,0,0
2186016,33,15,1980,8,"male",343,119,86,66,32,5,19,61,13
2186021,25,3,1988,4,"male",96,20,19,0,0,0,0,0,0
2186038,73,9,1940,10,"male",742,49,13,61,4,0,2,61,2
2186053,36,14,1977,3,"male",136,7,6,5,0,5,0,0,0
2186091,18,5,1995,9,"female",469,104,52,616,224,484,97,132,127
2186123,14,15,1999,11,"male",522,234,172,50,8,1,2,49,6
2186130,27,9,1986,8,"male",600,653,553,91,578,91,471,0,107
2186146,28,13,1985,2,"male",893,97,21,1,1,1,1,0,0
2186169,41,16,1972,6,"male",394,109,46,10,65,10,25,0,40
2186187,15,15,1998,11,"female",455,107,75,236,233,6,134,230,99
2186238,108,1,1905,1,"male",2398,205,55,3,6,0,5,3,1
2186257,24,18,1989,9,"female",660,231,216,714,300,170,134,544,166
2186260,17,25,1996,3,"male",127,16,13,0,0,0,0,0,0
2186269,108,28,1905,11,"female",1813,51,23,43,3,0,1,43,2
2186300,19,18,1994,3,"male",181,102,67,2,2,2,0,0,2
2186319,56,13,1957,4,"female",415,79,73,340,24,340,12,0,12
2186349,33,5,1980,10,"female",123,142,32,398,179,398,109,0,70
2186364,56,13,1957,12,"female",325,28,21,32,5,0,3,32,2
2186367,25,2,1988,1,"male",286,192,190,0,0,0,0,0,0
2186368,15,8,1998,9,"male",459,345,307,8,12,8,7,0,5
2186370,101,24,1912,9,"male",363,124,110,438,1,28,1,410,0
2186374,24,17,1989,10,"male",263,138,121,9,12,8,10,1,2
2186392,14,12,1999,3,"male",37,3,2,1,0,1,0,0,0
2186396,17,18,1996,7,"female",111,96,67,393,11,393,10,0,1
2186411,33,26,1980,6,"male",466,99,56,12,64,12,25,0,39
2186418,37,2,1976,3,"female",287,14,11,8,26,8,24,0,2
2186432,45,12,1968,4,"male",350,42,30,50,13,20,4,30,9
2186446,44,3,1969,8,"female",162,944,814,1260,423,935,322,325,101
2186482,37,18,1976,1,"female",272,9,9,57,24,57,19,0,5
2186544,52,10,1961,7,"female",363,50,31,11,30,9,25,2,5
2186561,15,11,1998,1,"female",164,27,23,70,13,30,2,40,11
2186628,62,16,1951,2,"female",358,484,345,106,173,0,60,106,113
2186639,35,30,1978,1,"female",92,66,56,727,231,726,180,1,51
2186668,47,12,1966,6,"female",602,16,5,0,1,0,1,0,0
2186672,76,16,1937,8,"male",113,69,65,1,0,0,0,1,0
2186683,25,24,1988,4,"male",1316,250,140,12,92,12,87,0,5
2186706,36,27,1977,11,"male",535,18,7,0,1,0,1,0,0
2186718,13,4,2000,6,"male",13,9,7,1,0,1,0,0,0
2186770,37,3,1976,2,"male",65,3,2,9,0,2,0,7,0
2186789,13,30,2000,5,"female",34,0,0,0,0,0,0,0,0
2186830,95,7,1918,10,"female",1143,315,107,5,35,5,26,0,9
2186863,42,20,1971,10,"female",212,71,43,34,19,0,12,34,7
2186904,28,1,1985,9,"female",1157,218,75,127,95,58,49,69,46
2186915,25,28,1988,10,"male",568,123,101,15,12,15,2,0,10
2186959,20,20,1993,5,"female",309,168,142,44,22,44,22,0,0
2186966,37,30,1976,10,"male",711,148,58,144,70,144,35,0,35
2186976,39,1,1974,9,"male",85,22,21,8,2,8,2,0,0
2186981,27,11,1986,4,"male",250,115,59,21,50,20,13,1,37
2187011,34,18,1979,3,"female",333,163,69,358,131,358,112,0,19
2187034,31,27,1982,8,"male",28,10,10,2,1,2,1,0,0
2187036,56,11,1957,3,"female",1128,52,37,166,54,115,18,51,36
2187077,15,8,1998,1,"female",548,281,203,2,4,2,3,0,1
2187115,61,5,1952,11,"female",1534,127,54,39,1,24,0,15,1
2187129,58,6,1955,5,"female",1205,219,128,32,179,32,160,0,19
2187134,22,10,1991,1,"male",140,10,6,12,6,12,6,0,0
2187171,24,28,1989,3,"male",724,175,92,0,8,0,4,0,4
2187174,23,19,1990,5,"male",754,169,72,1,10,0,4,1,6
2187194,48,10,1965,6,"male",140,1,0,0,0,0,0,0,0
2187206,20,9,1993,6,"female",285,555,406,213,54,213,44,0,10
2187211,16,20,1997,6,"male",28,8,8,0,22,0,14,0,8
2187225,18,2,1995,4,"male",454,59,37,0,0,0,0,0,0
2187246,50,15,1963,10,"male",1348,65,32,25,51,25,45,0,6
2187252,30,1,1983,5,"female",219,4,1,0,0,0,0,0,0
2187268,52,8,1961,8,"male",164,1,0,30,66,0,5,30,61
2187313,17,10,1996,10,"male",10,1,1,41,11,36,2,5,9
2187354,20,28,1993,8,"male",868,185,134,4,0,0,0,4,0
2187358,93,2,1920,3,"female",1162,277,109,129,149,5,28,124,121
2187395,22,10,1991,11,"male",170,45,35,0,8,0,4,0,4
2187411,21,13,1992,9,"female",472,158,31,196,59,196,35,0,24
2187468,23,7,1990,7,"female",112,60,40,5,0,5,0,0,0
2187470,23,22,1990,5,"female",530,3,2,0,0,0,0,0,0
2187474,48,27,1965,2,"female",333,278,253,324,384,313,257,11,127
2187484,18,27,1995,7,"male",102,29,24,0,3,0,3,0,0
2187487,17,2,1996,1,"female",50,455,138,690,412,169,149,521,263
2187500,16,21,1997,10,"male",518,406,327,186,32,116,16,70,16
2187515,30,3,1983,1,"male",528,107,87,0,0,0,0,0,0
2187530,40,17,1973,9,"female",50,28,21,7,27,7,7,0,20
2187539,58,27,1955,12,"male",335,76,56,58,10,58,10,0,0
2187568,51,10,1962,4,"female",497,4,3,0,0,0,0,0,0
2187591,32,28,1981,8,"male",563,201,90,3,11,3,4,0,7
2187614,57,29,1956,12,"female",597,139,125,76,28,1,1,75,27
2187633,103,10,1910,2,"female",539,466,372,3,16,1,14,2,2
2187635,46,5,1967,9,"female",916,51,14,0,0,0,0,0,0
2187674,47,10,1966,7,"male",124,465,448,466,220,196,157,270,63
2187678,28,14,1985,12,"male",236,1,1,0,0,0,0,0,0
2187709,20,3,1993,1,"male",193,4,2,0,0,0,0,0,0
2187737,51,11,1962,11,"male",950,162,135,85,47,65,32,20,15
2187751,19,28,1994,10,"female",340,91,62,1,14,1,8,0,6
2187765,66,15,1947,8,"male",1698,72,14,25,92,24,55,1,37
2187791,62,24,1951,10,"male",721,126,79,2156,67,2156,37,0,30
2187800,40,14,1973,8,"male",226,41,16,15,25,15,10,0,15
2187802,33,31,1980,8,"male",336,91,85,3,0,0,0,3,0
2187808,15,28,1998,4,"female",613,4681,907,292,1388,69,866,223,522
2187809,22,12,1991,4,"male",29,123,108,44,52,44,49,0,3
2187820,73,12,1940,5,"male",478,84,22,115,101,34,81,81,20
2187825,19,18,1994,4,"female",326,331,110,857,1794,761,843,96,951
2187846,15,18,1998,4,"male",856,76,34,22,2,22,2,0,0
2187854,25,20,1988,4,"female",183,132,94,79,107,75,56,4,51
2187895,67,20,1946,11,"male",1314,276,202,6915,910,0,308,6915,602
2187899,35,2,1978,10,"female",128,276,257,49,55,49,33,0,22
2187920,18,25,1995,9,"female",570,3475,546,233,1576,233,1456,0,120
2187925,18,14,1995,5,"male",29,20,15,163,20,163,17,0,3
2187930,19,24,1994,7,"male",708,422,205,233,53,226,36,7,17
2187935,53,12,1960,7,"male",559,258,205,556,1483,136,766,420,717
2187936,71,11,1942,11,"female",675,33,16,3,11,0,7,3,4
2187939,54,11,1959,10,"female",579,27,17,19,22,18,13,1,9
2187941,18,9,1995,3,"male",293,256,235,95,12,0,3,95,9
2187950,69,15,1944,4,"male",92,26,18,53,23,48,18,5,5
2187951,108,25,1905,2,"male",2318,563,242,69,89,69,72,0,17
2187968,34,5,1979,2,"male",283,107,27,110,13,78,3,32,10
2187979,25,15,1988,1,"female",199,199,101,0,3,0,2,0,1
2188045,49,22,1964,5,"female",230,65,26,16,16,16,4,0,12
2188047,67,20,1946,1,"female",1038,104,63,87,139,0,60,87,79
2188052,59,1,1954,12,"male",1037,22,12,4,2,0,0,4,2
2188079,30,30,1983,8,"male",445,214,165,3,9,0,2,3,7
2188093,22,29,1991,7,"male",482,27,13,1,0,1,0,0,0
2188131,54,23,1959,9,"male",1275,123,55,0,0,0,0,0,0
2188134,59,13,1954,11,"male",636,10,7,0,0,0,0,0,0
2188156,27,7,1986,12,"male",168,91,84,87,73,87,72,0,1
2188160,29,26,1984,3,"female",337,97,44,88,70,88,62,0,8
2188161,108,19,1905,12,"male",125,31,30,18,2,0,1,18,1
2188166,25,25,1988,9,"male",21,0,0,0,0,0,0,0,0
2188174,22,1,1991,1,"male",286,24,16,18,10,18,8,0,2
2188211,25,1,1988,1,"male",194,30,27,5,3,5,3,0,0
2188213,22,31,1991,7,"male",720,166,22,1,0,1,0,0,0
2188214,38,18,1975,8,"male",190,25,11,0,0,0,0,0,0
2188251,24,2,1989,7,"male",127,21,12,0,0,0,0,0,0
2188253,49,26,1964,9,"female",622,44,8,128,28,0,16,128,12
2188264,24,4,1989,3,"male",152,291,141,457,1022,130,309,327,713
2188272,108,12,1905,9,"male",1302,277,112,122,63,122,45,0,18
2188291,17,7,1996,12,"male",4,41,41,9,0,9,0,0,0
2188317,103,29,1910,8,"female",1957,76,39,44,24,0,1,44,23
2188334,52,2,1961,9,"female",182,78,55,9,11,0,3,9,8
2188353,25,5,1988,10,"male",114,21,10,3,1,3,0,0,1
2188365,74,31,1939,7,"female",775,30,4,1,1,0,1,1,0
2188369,24,23,1989,2,"male",211,108,56,7,9,7,9,0,0
2188377,54,4,1959,5,"female",1356,62,29,66,73,31,62,35,11
2188386,20,8,1993,3,"male",614,196,123,0,0,0,0,0,0
2188412,74,7,1939,3,"female",1895,98,28,30,3,2,2,28,1
2188426,21,23,1992,4,"female",407,712,358,811,787,245,173,566,614
2188467,43,20,1970,1,"male",780,174,89,60,158,34,111,26,47
2188480,60,9,1953,4,"female",896,64,37,450,52,87,35,363,17
2188490,103,21,1910,8,"male",733,732,300,874,750,874,616,0,134
2188492,17,26,1996,1,"female",209,242,133,22,3,22,0,0,3
2188511,49,26,1964,10,"male",17,3,2,0,0,0,0,0,0
2188521,28,26,1985,11,"male",145,127,93,13,22,13,7,0,15
2188534,21,17,1992,7,"male",96,112,94,47,44,47,27,0,17
2188537,26,5,1987,1,"male",225,112,52,66,111,66,67,0,44
2188558,53,5,1960,1,"male",919,132,78,173,263,84,194,89,69
2188589,46,1,1967,1,"male",163,28,8,47,37,0,15,47,22
2188598,16,24,1997,5,"male",373,317,88,36,3,0,1,36,2
2188601,19,1,1994,1,"male",191,3,1,1,1,0,0,1,1
2188606,108,9,1905,10,"female",1085,205,66,0,0,0,0,0,0
2188633,20,17,1993,2,"female",343,134,54,1,64,1,35,0,29
2188645,44,2,1969,4,"female",184,5,4,0,0,0,0,0,0
2188688,18,20,1995,2,"male",248,190,163,28,7,28,5,0,2
2188692,27,20,1986,5,"female",775,607,322,0,0,0,0,0,0
2188697,52,10,1961,10,"male",254,26,16,1,0,1,0,0,0
2188712,37,23,1976,3,"female",376,16,5,6,3,0,0,6,3
2188732,36,4,1977,2,"male",729,76,14,1,4,1,4,0,0
2188794,64,5,1949,5,"female",522,16,3,1,7,0,1,1,6
2188798,38,29,1975,7,"male",415,1,1,44,3,44,3,0,0
2188820,64,23,1949,5,"male",1725,20,8,4,3,1,0,3,3
2188824,18,5,1995,10,"male",381,407,300,186,685,186,515,0,170
2188847,15,10,1998,1,"female",160,233,157,6,21,6,9,0,12
2188848,61,10,1952,2,"male",454,12,5,0,0,0,0,0,0
2188851,17,22,1996,12,"male",183,185,102,3,0,3,0,0,0
2188854,14,2,1999,5,"female",364,206,32,1042,61,1042,48,0,13
2188889,18,5,1995,10,"female",76,14,8,0,0,0,0,0,0
2188903,15,30,1998,8,"male",555,355,266,263,32,258,27,5,5
2188918,55,17,1958,9,"female",627,313,217,63,87,63,56,0,31
2188919,107,4,1906,5,"male",1010,87,68,0,0,0,0,0,0
2188934,76,17,1937,9,"female",272,114,80,55,39,20,12,35,27
2188957,24,12,1989,11,"female",679,93,31,0,1,0,1,0,0
2188990,103,12,1910,6,"male",517,301,223,0,0,0,0,0,0
2189024,18,25,1995,4,"male",735,1998,703,1760,1584,584,736,1176,848
2189026,20,18,1993,2,"female",557,351,219,382,288,323,215,59,73
2189043,16,20,1997,12,"female",665,582,417,977,673,297,454,680,219
2189091,44,8,1969,9,"male",938,64,45,4,2,4,1,0,1
2189094,95,21,1918,9,"male",1205,144,16,35,24,0,1,35,23
2189117,19,6,1994,7,"male",358,329,239,0,6,0,2,0,4
2189166,103,12,1910,8,"female",726,79,44,6,3,6,1,0,2
2189173,51,11,1962,10,"male",488,591,213,815,2118,815,1846,0,272
2189184,47,26,1966,8,"male",685,103,32,170,83,170,48,0,35
2189195,27,2,1986,4,"male",881,394,347,6,20,6,15,0,5
2189227,108,23,1905,7,"female",1055,8,6,1,0,1,0,0,0
2189241,20,7,1993,7,"female",10,5,4,0,0,0,0,0,0
2189246,26,28,1987,4,"male",178,94,66,114,14,114,3,0,11
2189256,34,28,1979,10,"male",362,53,34,48,60,48,47,0,13
2189278,30,20,1983,8,"male",256,150,109,55,93,55,86,0,7
2189282,22,17,1991,7,"male",571,289,136,135,42,117,27,18,15
2189292,46,21,1967,5,"female",1617,107,35,11,34,11,20,0,14
2189293,18,8,1995,3,"male",583,675,493,368,423,368,390,0,33
2189296,21,4,1992,2,"female",636,451,267,460,637,272,504,188,133
2189324,15,14,1998,1,"male",842,108,30,0,0,0,0,0,0
2189351,20,12,1993,12,"female",763,1931,1021,2108,2481,2001,1105,107,1376
2189378,28,23,1985,12,"male",253,22,14,39,0,39,0,0,0
2189396,45,1,1968,9,"male",656,52,16,0,0,0,0,0,0
2189410,28,6,1985,6,"female",883,51,14,1,3,1,3,0,0
2189420,61,1,1952,6,"female",1354,557,266,245,500,19,253,226,247
2189435,75,28,1938,5,"male",513,19,12,2,5,0,4,2,1
2189442,19,5,1994,12,"female",506,32,23,132,6,123,5,9,1
2189446,67,30,1946,11,"male",1230,61,27,2,50,0,33,2,17
2189472,66,24,1947,7,"female",822,51,29,18,3,18,3,0,0
2189512,21,23,1992,10,"female",646,59,53,0,0,0,0,0,0
2189517,35,9,1978,11,"male",406,352,41,89,40,53,32,36,8
2189521,38,20,1975,2,"male",362,57,43,39,7,0,1,39,6
2189525,25,27,1988,1,"female",285,74,59,79,61,79,24,0,37
2189530,20,7,1993,3,"male",77,89,36,1,5,1,5,0,0
2189557,46,12,1967,2,"female",159,16,12,0,0,0,0,0,0
2189570,19,12,1994,4,"male",161,75,74,0,0,0,0,0,0
2189571,73,6,1940,11,"male",1451,180,45,2,0,0,0,2,0
2189574,34,1,1979,1,"male",195,278,240,16,11,8,6,8,5
2189589,25,26,1988,12,"male",292,3,2,0,0,0,0,0,0
2189603,52,6,1961,1,"male",122,14,11,1,0,0,0,1,0
2189604,45,25,1968,10,"male",372,21,14,17,2,0,0,17,2
2189611,42,17,1971,9,"female",490,11,6,8,0,8,0,0,0
2189621,17,17,1996,1,"female",626,541,219,1168,1453,1168,1321,0,132
2189628,27,6,1986,6,"male",433,52,40,0,0,0,0,0,0
2189633,45,10,1968,2,"male",293,37,24,25,3,0,1,25,2
2189642,67,10,1946,11,"female",673,129,116,0,8,0,6,0,2
2189651,20,23,1993,2,"male",579,118,100,0,0,0,0,0,0
2189652,16,2,1997,2,"male",440,363,316,2,1,2,0,0,1
2189665,40,26,1973,2,"female",1617,660,371,139,609,110,533,29,76
2189666,60,14,1953,10,"female",1829,72,31,1,9,0,3,1,6
2189667,56,25,1957,10,"female",928,33,18,8,19,0,8,8,11
2189673,14,11,1999,8,"female",115,319,216,567,788,548,390,19,398
2189685,22,27,1991,12,"female",1344,196,55,6,0,2,0,4,0
2189705,38,9,1975,2,"male",913,43,21,0,0,0,0,0,0
2189706,26,22,1987,4,NA,240,65,33,24,62,24,57,0,5
2189710,103,3,1910,2,"male",646,571,333,193,226,14,67,179,159
2189762,53,26,1960,6,"female",17,49,42,13,65,9,27,4,38
2189765,21,1,1992,1,"male",337,7,7,15,0,15,0,0,0
2189843,15,24,1998,11,"female",291,650,193,3098,164,3081,144,17,20
2189845,69,16,1944,3,"male",1188,26,12,0,0,0,0,0,0
2189858,55,14,1958,10,"male",516,6,6,0,0,0,0,0,0
2189864,32,13,1981,12,"male",345,138,119,0,3,0,1,0,2
2189883,55,2,1958,2,"female",63,154,61,112,26,112,24,0,2
2189898,15,12,1998,7,"female",58,82,23,0,2,0,1,0,1
2189905,26,7,1987,6,"male",531,148,111,1,51,1,30,0,21
2189980,20,15,1993,5,"female",207,282,75,11,11,11,11,0,0
2189982,29,23,1984,1,"male",526,90,21,20,86,20,76,0,10
2190003,66,7,1947,3,"female",1113,5,2,0,0,0,0,0,0
2190007,56,6,1957,8,"male",64,65,44,10,4,0,0,10,4
2190022,63,4,1950,7,"female",1475,371,201,25,346,25,149,0,197
2190036,16,26,1997,9,"female",146,309,286,84,10,72,5,12,5
2190080,33,13,1980,12,"male",432,198,190,1,0,1,0,0,0
2190084,21,31,1992,8,"male",433,163,138,476,333,415,71,61,262
2190133,18,11,1995,1,"male",251,323,260,7,2,1,1,6,1
2190192,36,14,1977,5,"male",400,30,22,0,2,0,2,0,0
2190219,16,13,1997,9,"male",392,67,36,0,0,0,0,0,0
2190225,67,9,1946,1,"male",1755,22,4,1,21,0,2,1,19
2190231,31,14,1982,12,"male",71,235,172,414,71,414,57,0,14
2190249,31,28,1982,9,"male",7,0,0,0,0,0,0,0,0
2190264,18,5,1995,10,"female",787,198,12,0,0,0,0,0,0
2190271,21,11,1992,11,"male",426,84,58,20,30,20,18,0,12
2190296,17,25,1996,12,"male",25,134,131,1,5,0,3,1,2
2190314,17,18,1996,4,"male",198,66,53,0,6,0,2,0,4
2190343,25,10,1988,1,"male",134,7,5,16,2,16,2,0,0
2190354,44,1,1969,1,"male",249,51,20,1,0,1,0,0,0
2190366,23,19,1990,7,"male",805,36,30,3,1,3,1,0,0
2190371,19,28,1994,11,"female",367,265,202,33,32,6,7,27,25
2190401,15,11,1998,3,"male",430,65,27,20,3,20,3,0,0
2190468,93,5,1920,10,"female",403,227,109,44,11,44,4,0,7
2190477,30,29,1983,3,"male",271,33,22,48,141,48,94,0,47
2190490,21,15,1992,8,"female",368,198,135,676,136,628,97,48,39
2190542,18,25,1995,12,"male",945,63,31,5,0,5,0,0,0
2190546,19,26,1994,6,"male",409,45,28,0,1,0,1,0,0
2190564,34,18,1979,9,"male",563,80,64,14,3,11,2,3,1
2190568,17,26,1996,9,"male",507,103,77,170,50,25,17,145,33
2190569,32,24,1981,4,"female",879,33,15,2,0,2,0,0,0
2190595,18,25,1995,1,"female",254,298,238,1,0,1,0,0,0
2190599,43,15,1970,9,"female",444,67,19,26,10,26,9,0,1
2190605,29,6,1984,1,"male",645,207,140,2,0,0,0,2,0
2190624,20,7,1993,1,"male",160,7,5,0,0,0,0,0,0
2190627,21,13,1992,10,"male",1111,176,91,7,1,7,1,0,0
2190665,31,17,1982,3,"male",637,17,8,4,0,4,0,0,0
2190678,15,14,1998,6,"female",266,25,13,5,2,0,2,5,0
2190694,55,24,1958,6,"male",611,223,129,2,5,0,0,2,5
2190702,24,23,1989,7,"male",257,159,113,0,0,0,0,0,0
2190704,30,13,1983,2,"male",178,306,281,619,367,229,142,390,225
2190707,31,27,1982,7,"male",223,105,64,29,16,0,9,29,7
2190732,27,7,1986,12,"male",80,59,56,0,0,0,0,0,0
2190749,23,8,1990,8,"female",473,96,11,0,4,0,3,0,1
2190754,14,26,1999,10,"male",134,34,23,0,0,0,0,0,0
2190760,17,28,1996,10,"male",198,201,159,0,13,0,13,0,0
2190761,44,18,1969,9,"male",533,90,52,172,77,172,62,0,15
2190767,24,15,1989,6,"male",510,79,33,0,4,0,2,0,2
2190775,93,1,1920,1,"male",635,56,45,12,2,0,0,12,2
2190781,25,11,1988,5,"male",330,25,21,591,40,591,34,0,6
2190798,33,1,1980,1,"male",461,7,3,14,0,14,0,0,0
2190850,19,8,1994,2,"male",597,235,119,437,281,395,192,42,89
2190853,38,13,1975,2,"male",434,39,15,2,4,2,1,0,3
2190872,21,5,1992,5,"male",349,492,368,4,445,3,274,1,171
2190878,25,6,1988,8,"male",471,69,53,7,17,7,15,0,2
2190883,20,12,1993,1,"male",26,155,60,134,192,130,122,4,70
2190906,33,11,1980,4,"female",303,17,3,494,179,454,53,40,126
2190920,20,30,1993,9,"male",558,498,226,105,113,105,108,0,5
2190921,25,6,1988,1,"male",278,0,0,0,0,0,0,0,0
2190940,72,7,1941,2,"female",2194,47,25,35,2,5,1,30,1
2190968,18,17,1995,3,"female",424,308,160,9,0,0,0,9,0
2190996,18,25,1995,1,"male",66,58,42,49,29,16,19,33,10
2190999,33,26,1980,4,"male",311,3,1,0,0,0,0,0,0
2191014,20,5,1993,8,"female",1015,2565,1071,10020,16336,6631,9790,3389,6546
2191015,28,19,1985,6,"male",349,35,16,1,0,1,0,0,0
2191049,30,28,1983,6,"female",371,146,51,0,0,0,0,0,0
2191057,17,3,1996,10,"female",487,641,427,31,159,25,55,6,104
2191084,42,19,1971,12,"male",180,224,195,723,165,687,141,36,24
2191105,18,9,1995,11,"female",247,25,14,93,176,85,144,8,32
2191122,30,25,1983,12,"male",397,15,8,3,10,3,10,0,0
2191123,38,1,1975,2,"female",229,63,47,73,58,73,32,0,26
2191126,19,14,1994,12,"female",500,1351,1052,0,5,0,2,0,3
2191127,26,1,1987,1,"male",513,141,114,0,0,0,0,0,0
2191136,21,3,1992,2,"male",5,2,0,0,0,0,0,0,0
2191145,27,15,1986,7,"male",1118,125,54,0,0,0,0,0,0
2191156,48,26,1965,11,"male",444,111,33,8,19,8,17,0,2
2191169,63,30,1950,8,"male",493,4,0,0,0,0,0,0,0
2191188,89,24,1924,2,"female",1493,13,9,38,12,38,9,0,3
2191231,47,19,1966,1,"female",345,8,4,1,4,0,1,1,3
2191252,84,19,1929,5,"male",311,60,38,8,10,0,1,8,9
2191276,30,22,1983,8,"male",513,162,107,200,8,200,7,0,1
2191289,68,17,1945,8,"male",1425,180,49,18,7,18,7,0,0
2191303,33,1,1980,1,"male",428,107,70,0,0,0,0,0,0
2191306,64,19,1949,6,"female",812,43,29,11,9,0,5,11,4
2191318,23,1,1990,3,"male",628,118,65,0,0,0,0,0,0
2191329,27,15,1986,4,"male",406,111,80,121,34,121,16,0,18
2191341,26,14,1987,4,"male",157,64,61,2,15,2,7,0,8
2191366,50,22,1963,10,"male",1363,149,66,6,25,1,7,5,18
2191370,24,12,1989,12,"male",389,621,555,31,171,31,153,0,18
2191391,94,16,1919,6,"male",2132,278,154,18,4,1,1,17,3
2191433,27,14,1986,8,"male",987,459,246,2,18,2,17,0,1
2191439,14,1,1999,1,"male",5,9,9,1,15,1,15,0,0
2191441,18,17,1995,11,"female",409,5,1,0,1,0,1,0,0
2191474,22,29,1991,7,"male",162,53,40,0,6,0,1,0,5
2191484,24,20,1989,3,"female",325,120,54,53,24,53,14,0,10
2191493,73,13,1940,8,"female",1582,326,89,13,39,1,26,12,13
2191496,55,24,1958,2,"male",435,75,36,0,2,0,1,0,1
2191516,36,7,1977,2,"female",1722,222,149,103,171,87,101,16,70
2191527,19,6,1994,3,"male",260,109,71,3,0,3,0,0,0
2191587,23,1,1990,1,"male",652,2,2,0,0,0,0,0,0
2191589,28,1,1985,9,"male",678,143,125,0,0,0,0,0,0
2191636,18,28,1995,4,"male",607,1115,891,1,4,1,4,0,0
2191648,44,26,1969,7,"female",385,21,12,40,2,1,1,39,1
2191684,30,30,1983,6,"female",208,74,47,3,73,3,34,0,39
2191719,26,7,1987,5,"male",445,2,2,1,0,0,0,1,0
2191743,33,20,1980,8,"male",333,148,54,0,0,0,0,0,0
2191779,17,15,1996,11,"female",738,881,536,47,103,47,89,0,14
2191792,23,23,1990,7,"male",479,3,3,0,0,0,0,0,0
2191811,56,22,1957,5,"male",1171,26,7,2,3,2,2,0,1
2191813,44,2,1969,12,"male",735,2,0,0,0,0,0,0,0
2191828,47,27,1966,10,"male",975,82,60,4,1,4,1,0,0
2191854,32,12,1981,11,"female",568,65,20,0,7,0,7,0,0
2191873,14,20,1999,9,"male",477,294,115,40,38,37,23,3,15
2191877,71,30,1942,5,"female",1105,31,23,30,2,0,1,30,1
2191888,58,14,1955,10,"female",862,70,22,11,7,0,0,11,7
2191906,54,24,1959,11,"male",159,49,29,72,126,0,52,72,74
2191927,32,18,1981,7,"male",345,203,117,0,2,0,2,0,0
2191933,23,22,1990,7,"male",246,4,2,0,0,0,0,0,0
2191945,108,3,1905,5,"female",551,493,270,159,77,159,64,0,13
2191979,53,21,1960,9,"female",1864,271,137,19,26,6,11,13,15
2191988,37,18,1976,11,"male",696,63,42,0,1,0,1,0,0
2192017,21,4,1992,3,"female",1124,384,199,24,40,24,33,0,7
2192048,36,24,1977,1,"female",360,36,28,492,150,461,41,31,109
2192074,16,12,1997,9,"female",691,393,170,197,283,164,176,33,107
2192112,24,22,1989,4,"female",204,98,35,3,0,3,0,0,0
2192126,26,1,1987,1,"male",321,83,56,2265,49,2265,37,0,12
2192144,108,7,1905,5,"male",514,916,756,769,321,4,88,765,233
2192145,27,15,1986,1,"female",743,116,42,33,31,33,26,0,5
2192153,24,5,1989,4,"male",103,13,11,0,0,0,0,0,0
2192161,61,31,1952,3,"female",222,271,251,1315,263,0,43,1315,220
2192228,70,20,1943,8,"female",1521,75,37,39,29,25,26,14,3
2192231,73,9,1940,12,"female",972,69,47,56,28,0,4,56,24
2192232,26,20,1987,8,"male",477,74,44,4,6,4,6,0,0
2192246,18,28,1995,6,"male",710,524,361,572,573,572,297,0,276
2192248,20,26,1993,5,"female",421,485,227,349,339,268,137,81,202
2192252,54,13,1959,2,"male",1056,32,17,31,1,31,0,0,1
2192259,29,15,1984,10,"male",687,105,76,14,22,14,10,0,12
2192278,108,16,1905,7,"female",849,598,115,7,22,7,20,0,2
2192288,14,2,1999,3,"female",513,383,107,0,2,0,2,0,0
2192316,35,29,1978,10,"female",127,62,51,45,33,29,21,16,12
2192341,21,7,1992,10,"male",445,239,123,3,12,3,9,0,3
2192349,23,11,1990,12,"male",4,0,0,0,0,0,0,0,0
2192356,15,19,1998,3,"male",24,0,0,0,0,0,0,0,0
2192385,15,7,1998,1,"female",103,87,79,566,12,560,11,6,1
2192387,16,5,1997,5,"male",30,3,3,3,0,3,0,0,0
2192435,21,17,1992,10,"female",202,3,3,5,4,0,4,5,0
2192438,105,2,1908,4,"male",1726,574,294,54,3,19,2,35,1
2192460,63,4,1950,2,"male",1788,7,0,0,0,0,0,0,0
2192510,14,17,1999,4,"male",670,238,62,18,137,6,55,12,82
2192515,79,18,1934,7,"female",1713,123,44,13,7,3,5,10,2
2192521,77,5,1936,10,"female",1624,73,40,2,3,0,0,2,3
2192522,22,28,1991,5,"male",119,68,42,2,21,1,16,1,5
2192538,20,24,1993,9,"female",580,86,65,53,55,43,35,10,20
2192560,24,5,1989,7,"female",812,208,41,14,68,14,61,0,7
2192606,31,9,1982,11,"male",664,178,151,4,4,4,4,0,0
2192608,57,10,1956,7,"female",1024,126,37,269,90,160,55,109,35
2192625,21,14,1992,1,"male",345,139,80,2,4,2,2,0,2
2192658,53,13,1960,10,"female",354,176,132,58,43,58,36,0,7
2192680,17,2,1996,6,"female",422,112,15,1,1,1,0,0,1
2192702,63,23,1950,6,"female",433,49,18,0,16,0,11,0,5
2192713,43,30,1970,9,"female",703,150,24,12,7,12,7,0,0
2192715,23,21,1990,12,"male",456,222,199,236,12,236,12,0,0
2192723,31,19,1982,5,"female",488,56,37,16,9,16,9,0,0
2192729,58,20,1955,5,"female",476,32,20,139,21,139,12,0,9
2192741,23,11,1990,5,"male",153,23,20,0,0,0,0,0,0
2192752,23,2,1990,8,"male",274,22,15,16,6,16,5,0,1
2192753,32,3,1981,5,"female",255,94,66,47,7,0,2,47,5
2192756,20,18,1993,8,"female",606,126,52,65,97,65,42,0,55
2192768,67,1,1946,1,"male",1843,65,28,7,1,7,0,0,1
2192769,45,23,1968,2,"female",371,0,0,0,0,0,0,0,0
2192849,18,23,1995,2,"female",657,97,21,0,0,0,0,0,0
2192877,55,26,1958,5,"female",430,97,77,422,368,311,234,111,134
2192882,22,5,1991,4,"male",290,15,10,0,2,0,1,0,1
2192904,18,10,1995,9,"male",556,308,83,15,9,15,9,0,0
2192932,21,19,1992,8,"male",655,197,93,4,3,4,2,0,1
2192937,31,7,1982,6,"male",781,156,137,1,1,0,1,1,0
2192970,59,13,1954,2,"male",425,13,10,0,1,0,0,0,1
2192987,31,26,1982,4,"male",323,65,45,1,0,0,0,1,0
2192996,25,1,1988,1,"female",474,318,110,6,17,6,11,0,6
2193005,58,25,1955,10,"female",553,289,157,1136,663,1136,331,0,332
2193027,62,14,1951,2,"male",144,50,31,600,145,600,135,0,10
2193056,16,11,1997,9,"female",437,746,409,119,65,119,38,0,27
2193059,28,1,1985,1,"female",351,6,3,0,1,0,0,0,1
2193068,56,12,1957,3,"male",408,91,55,1,6,0,2,1,4
2193090,26,5,1987,8,"male",1226,105,34,416,63,252,7,164,56
2193114,16,2,1997,6,"male",297,1,0,1,0,1,0,0,0
2193131,73,8,1940,4,"male",1095,47,16,0,7,0,7,0,0
2193145,108,22,1905,4,"male",356,297,257,243,33,1,29,242,4
2193148,24,12,1989,6,"male",252,36,32,1,0,1,0,0,0
2193156,45,16,1968,1,"male",597,24,10,1,2,1,2,0,0
2193157,49,8,1964,4,"male",790,39,15,0,0,0,0,0,0
2193175,28,24,1985,10,"female",303,2,2,56,3,48,2,8,1
2193190,26,29,1987,8,"female",83,196,91,235,120,235,96,0,24
2193200,24,2,1989,11,"female",268,54,17,1,1,1,1,0,0
2193209,19,25,1994,2,"female",715,22,12,0,1,0,1,0,0
2193210,14,18,1999,9,"male",379,276,155,104,99,104,67,0,32
2193222,44,21,1969,12,"male",523,58,24,0,0,0,0,0,0
2193232,57,5,1956,9,"female",1392,251,119,93,75,91,72,2,3
2193243,28,20,1985,1,"female",771,172,125,177,93,177,38,0,55
2193268,29,13,1984,8,"male",421,32,13,0,0,0,0,0,0
2193273,29,27,1984,4,"male",299,500,439,7,65,7,55,0,10
2193371,96,18,1917,9,"female",98,5,2,2,1,0,0,2,1
2193408,59,20,1954,8,"female",948,161,71,38,20,32,3,6,17
2193411,22,2,1991,10,"male",1030,554,295,98,45,33,4,65,41
2193465,45,26,1968,6,"female",251,29,15,0,1,0,1,0,0
2193468,101,10,1912,12,"male",1085,98,29,82,42,2,22,80,20
2193473,35,30,1978,7,"male",128,5,3,0,0,0,0,0,0
2193485,18,1,1995,1,"male",159,265,242,2,2,2,1,0,1
2193499,19,6,1994,1,"male",725,282,97,20,102,20,51,0,51
2193522,14,24,1999,2,"male",531,191,149,1,4,1,4,0,0
2193538,31,15,1982,2,"female",495,62,38,3,11,3,5,0,6
2193542,46,29,1967,8,"male",361,300,242,16,29,16,11,0,18
